tile_id,n_reduce_rows_num,max_row_length,min_row_length,avg_row_length,variance,start_row,end_row
0,108,11,1,4.74,4.91,1654479,1654587
1,96,15,0,5.33,7.72,1654587,1654683
2,97,23,0,5.28,12.12,1654682,1654779
3,103,14,1,4.97,7.89,1654778,1654881
4,85,21,1,6.02,12.73,1654880,1654965
5,106,12,1,4.83,6.10,1654964,1655070
6,100,11,1,5.12,6.51,1655069,1655169
7,106,13,0,4.83,5.88,1655168,1655274
8,106,18,0,4.83,9.46,1655273,1655379
9,102,16,0,5.02,10.94,1655378,1655480
10,158,12,0,3.24,5.88,1655479,1655637
11,118,18,0,4.34,9.31,1655636,1655754
12,114,11,0,4.49,8.04,1655753,1655867
13,101,22,0,5.07,9.99,1655866,1655967
14,103,21,0,4.97,9.80,1655967,1656070
15,108,14,1,4.74,6.08,1656069,1656177
16,92,16,1,5.57,6.77,1656176,1656268
17,104,16,1,4.92,8.84,1656268,1656372
18,114,15,1,4.49,6.62,1656372,1656486
19,109,13,0,4.70,6.93,1656485,1656594
20,94,19,1,5.45,7.40,1656594,1656688
21,106,18,0,4.83,10.14,1656687,1656793
22,192,10,0,2.67,4.40,1656792,1656984
23,116,16,1,4.41,6.78,1656983,1657099
24,121,14,0,4.23,7.04,1657098,1657219
25,108,12,0,4.74,6.80,1657218,1657326
26,102,13,1,5.02,7.06,1657325,1657427
27,103,14,1,4.97,7.89,1657427,1657530
28,103,14,1,4.97,6.30,1657529,1657632
29,100,13,0,5.12,6.77,1657631,1657731
30,99,21,1,5.17,9.01,1657730,1657829
31,100,18,1,5.12,8.91,1657828,1657928
32,112,14,0,4.57,5.62,1657927,1658039
33,101,15,0,5.07,6.94,1658038,1658139
34,108,14,0,4.74,8.04,1658139,1658247
35,148,12,0,3.46,7.19,1658246,1658394
36,144,18,0,3.56,10.00,1658393,1658537
37,126,13,0,4.06,8.66,1658536,1658662
38,100,22,0,5.12,8.83,1658661,1658761
39,110,17,0,4.65,7.43,1658760,1658870
40,101,11,1,5.07,6.30,1658869,1658970
41,105,15,0,4.88,10.53,1658969,1659074
42,129,12,0,3.97,8.46,1659073,1659202
43,111,20,0,4.61,9.41,1659202,1659313
44,131,14,0,3.91,5.79,1659313,1659444
45,124,13,1,4.13,4.42,1659444,1659568
46,108,12,1,4.74,6.51,1659567,1659675
47,116,20,1,4.41,7.86,1659674,1659790
48,102,17,0,5.02,8.02,1659789,1659891
49,95,16,1,5.39,9.71,1659890,1659985
50,103,13,0,4.97,6.73,1659985,1660088
51,106,14,1,4.83,5.08,1660087,1660193
52,111,14,0,4.61,6.78,1660192,1660303
53,98,14,0,5.22,8.52,1660302,1660400
54,101,11,1,5.07,5.59,1660399,1660500
55,151,16,0,3.39,6.78,1660499,1660650
56,119,17,0,4.30,9.30,1660649,1660768
57,129,14,0,3.97,6.28,1660767,1660896
58,116,15,1,4.41,7.57,1660896,1661012
59,97,11,0,5.28,6.28,1661011,1661108
60,104,17,0,4.92,8.78,1661107,1661211
61,93,24,2,5.51,9.50,1661211,1661304
62,109,15,1,4.70,6.27,1661303,1661412
63,112,11,1,4.57,5.57,1661411,1661523
64,108,10,1,4.74,4.34,1661522,1661630
65,105,14,0,4.88,8.45,1661629,1661734
66,97,17,1,5.28,8.02,1661733,1661830
67,111,13,0,4.61,8.58,1661829,1661940
68,154,11,0,3.32,7.57,1661939,1662093
69,112,14,0,4.57,8.98,1662093,1662205
70,115,14,0,4.45,6.60,1662204,1662319
71,121,19,0,4.23,8.87,1662318,1662439
72,104,13,1,4.92,6.67,1662439,1662543
73,93,14,0,5.51,9.00,1662542,1662635
74,113,13,0,4.53,4.80,1662635,1662748
75,99,12,1,5.17,5.88,1662748,1662847
76,102,16,0,5.02,8.25,1662846,1662948
77,105,12,1,4.88,6.17,1662947,1663052
78,99,14,1,5.17,6.73,1663052,1663151
79,111,14,0,4.61,7.66,1663150,1663261
80,103,17,1,4.97,8.84,1663260,1663363
81,89,15,0,5.75,11.15,1663362,1663451
82,143,15,0,3.58,8.03,1663450,1663593
83,155,16,0,3.30,8.62,1663592,1663747
84,106,14,0,4.83,8.27,1663746,1663852
85,118,11,1,4.34,5.12,1663851,1663969
86,107,14,0,4.79,7.44,1663968,1664075
87,102,15,0,5.02,7.82,1664074,1664176
88,92,15,1,5.57,8.94,1664175,1664267
89,108,11,1,4.74,5.27,1664267,1664375
90,100,15,0,5.12,7.85,1664374,1664474
91,135,14,0,3.79,8.86,1664473,1664608
92,113,12,0,4.53,7.97,1664607,1664720
93,116,16,0,4.41,8.83,1664720,1664836
94,108,11,0,4.74,4.90,1664835,1664943
95,97,12,1,5.28,7.38,1664943,1665040
96,92,23,1,5.57,12.81,1665039,1665131
97,101,16,1,5.07,8.12,1665130,1665231
98,111,12,1,4.61,5.07,1665230,1665341
99,117,14,0,4.38,6.61,1665341,1665458
100,102,17,0,5.02,9.74,1665457,1665559
101,140,14,0,3.66,9.63,1665558,1665698
102,122,15,0,4.20,8.34,1665697,1665819
103,120,13,1,4.27,5.53,1665818,1665938
104,95,19,1,5.39,9.35,1665937,1666032
105,114,11,0,4.49,7.09,1666031,1666145
106,95,13,1,5.39,8.45,1666144,1666239
107,98,12,1,5.22,6.93,1666238,1666336
108,103,15,1,4.97,7.64,1666336,1666439
109,106,11,1,4.83,5.41,1666438,1666544
110,104,13,0,4.92,6.74,1666543,1666647
111,100,15,0,5.12,9.53,1666646,1666746
112,93,23,0,5.51,12.47,1666746,1666839
113,154,12,0,3.32,7.41,1666838,1666992
114,102,15,0,5.02,7.29,1666991,1667093
115,123,10,0,4.16,5.11,1667092,1667215
116,105,12,1,4.88,6.15,1667214,1667319
117,114,12,0,4.49,7.11,1667318,1667432
118,88,15,0,5.82,8.81,1667431,1667519
119,100,13,1,5.12,7.91,1667518,1667618
120,92,13,1,5.57,7.98,1667617,1667709
121,100,19,0,5.12,7.87,1667708,1667808
122,110,16,0,4.65,7.06,1667807,1667917
123,102,13,1,5.02,6.67,1667916,1668018
124,95,14,0,5.39,8.91,1668017,1668112
125,107,15,0,4.79,10.02,1668111,1668218
126,156,18,0,3.28,8.81,1668217,1668373
127,118,11,0,4.34,7.14,1668372,1668490
128,115,14,1,4.45,7.93,1668489,1668604
129,105,15,0,4.88,8.47,1668603,1668708
130,102,14,1,5.02,7.31,1668708,1668810
131,111,12,1,4.61,5.93,1668809,1668920
132,97,14,1,5.28,6.37,1668919,1669016
133,99,21,1,5.17,10.28,1669015,1669114
134,105,19,1,4.88,7.25,1669113,1669218
135,105,16,1,4.88,7.14,1669217,1669322
136,107,12,0,4.79,7.03,1669322,1669429
137,98,14,1,5.22,9.07,1669428,1669526
138,86,18,0,5.95,9.77,1669526,1669612
139,179,11,0,2.86,5.96,1669611,1669790
140,128,14,0,4.00,9.59,1669789,1669917
141,104,15,1,4.92,6.90,1669916,1670020
142,127,9,0,4.03,5.05,1670020,1670147
143,100,15,1,5.12,7.31,1670146,1670246
144,86,17,1,5.95,9.86,1670245,1670331
145,104,17,0,4.92,6.36,1670330,1670434
146,103,12,1,4.97,7.78,1670434,1670537
147,101,15,1,5.07,7.65,1670537,1670638
148,94,15,0,5.45,8.16,1670637,1670731
149,97,15,1,5.28,7.81,1670730,1670827
150,94,18,0,5.45,10.65,1670826,1670920
151,109,15,0,4.70,7.06,1670919,1671028
152,94,22,1,5.45,11.95,1671027,1671121
153,111,14,0,4.61,8.04,1671120,1671231
154,178,17,0,2.88,6.38,1671230,1671408
155,113,14,0,4.53,6.87,1671407,1671520
156,102,14,1,5.02,8.35,1671519,1671621
157,122,16,0,4.20,8.16,1671620,1671742
158,107,13,1,4.79,6.62,1671741,1671848
159,106,13,1,4.83,6.25,1671847,1671953
160,104,11,0,4.92,6.05,1671952,1672056
161,106,13,0,4.83,6.42,1672056,1672162
162,104,11,1,4.92,5.53,1672161,1672265
163,87,13,0,5.89,7.78,1672264,1672351
164,116,11,0,4.41,6.26,1672350,1672466
165,91,16,1,5.63,10.76,1672465,1672556
166,104,15,1,4.92,8.34,1672555,1672659
167,119,20,0,4.30,9.93,1672658,1672777
168,160,12,0,3.20,7.76,1672776,1672936
169,110,13,1,4.65,7.48,1672935,1673045
170,121,11,0,4.23,6.56,1673044,1673165
171,114,11,0,4.49,6.41,1673165,1673279
172,104,15,1,4.92,7.49,1673278,1673382
173,104,22,1,4.92,7.74,1673381,1673485
174,90,15,2,5.69,8.88,1673485,1673575
175,96,12,1,5.33,6.03,1673574,1673670
176,100,14,1,5.12,8.37,1673669,1673769
177,100,13,1,5.12,6.37,1673769,1673869
178,106,11,0,4.83,6.31,1673868,1673974
179,95,17,1,5.39,9.94,1673973,1674068
180,98,11,0,5.22,6.91,1674067,1674165
181,116,12,0,4.41,6.55,1674164,1674280
182,154,15,0,3.32,7.78,1674279,1674433
183,103,15,0,4.97,8.51,1674433,1674536
184,116,14,0,4.41,6.93,1674536,1674652
185,103,15,1,4.97,9.66,1674651,1674754
186,104,15,1,4.92,9.22,1674754,1674858
187,89,14,1,5.75,10.10,1674857,1674946
188,92,16,0,5.57,8.88,1674945,1675037
189,103,14,0,4.97,6.82,1675036,1675139
190,106,13,1,4.83,7.24,1675138,1675244
191,104,20,0,4.92,10.72,1675243,1675347
192,108,18,0,4.74,8.88,1675346,1675454
193,174,10,0,2.94,4.62,1675453,1675627
194,133,14,0,3.85,8.47,1675626,1675759
195,119,13,0,4.30,7.37,1675759,1675878
196,107,10,1,4.79,4.54,1675877,1675984
197,85,17,1,6.02,10.82,1675983,1676068
198,107,12,0,4.79,5.59,1676067,1676174
199,83,17,1,6.17,11.90,1676174,1676257
200,108,15,1,4.74,7.47,1676256,1676364
201,105,18,1,4.88,9.38,1676363,1676468
202,105,11,0,4.88,6.30,1676467,1676572
203,106,12,0,4.83,7.31,1676572,1676678
204,104,16,1,4.92,8.59,1676677,1676781
205,115,13,0,4.45,7.03,1676781,1676896
206,176,15,0,2.91,6.88,1676895,1677071
207,115,15,0,4.45,10.37,1677070,1677185
208,113,19,0,4.53,8.13,1677185,1677298
209,101,15,1,5.07,7.87,1677297,1677398
210,102,15,0,5.02,8.63,1677397,1677499
211,101,14,0,5.07,6.44,1677498,1677599
212,102,12,1,5.02,5.90,1677598,1677700
213,95,13,1,5.39,7.29,1677700,1677795
214,107,12,0,4.79,6.32,1677795,1677902
215,131,13,0,3.91,4.46,1677901,1678032
216,109,13,0,4.70,6.74,1678031,1678140
217,168,15,0,3.05,6.00,1678139,1678307
218,122,15,0,4.20,7.55,1678306,1678428
219,131,11,0,3.91,5.73,1678428,1678559
220,115,12,1,4.45,7.73,1678559,1678674
221,99,13,1,5.17,6.32,1678674,1678773
222,97,15,0,5.28,9.81,1678772,1678869
223,98,12,1,5.22,5.26,1678868,1678966
224,96,17,1,5.33,10.70,1678965,1679061
225,96,14,1,5.33,7.10,1679060,1679156
226,97,19,1,5.28,8.49,1679156,1679253
227,111,15,1,4.61,7.34,1679253,1679364
228,87,17,1,5.89,9.83,1679363,1679450
229,103,13,0,4.97,8.05,1679449,1679552
230,178,12,0,2.88,6.85,1679551,1679729
231,129,18,0,3.97,7.92,1679728,1679857
232,121,12,0,4.23,6.05,1679856,1679977
233,105,11,1,4.88,6.95,1679976,1680081
234,104,15,0,4.92,9.49,1680080,1680184
235,96,11,0,5.33,6.87,1680183,1680279
236,105,13,1,4.88,6.47,1680279,1680384
237,98,16,1,5.22,8.89,1680383,1680481
238,104,13,1,4.92,7.36,1680480,1680584
239,114,14,1,4.49,5.74,1680583,1680697
240,93,16,1,5.51,9.95,1680696,1680789
241,98,17,0,5.22,12.05,1680788,1680886
242,119,16,0,4.30,10.38,1680885,1681004
243,148,18,0,3.46,8.72,1681003,1681151
244,100,11,1,5.12,5.61,1681150,1681250
245,103,20,1,4.97,8.22,1681249,1681352
246,102,18,1,5.02,8.49,1681351,1681453
247,112,20,0,4.57,10.28,1681452,1681564
248,95,15,1,5.39,7.71,1681563,1681658
249,93,13,1,5.51,10.03,1681657,1681750
250,110,12,1,4.65,4.39,1681750,1681860
251,106,11,1,4.83,5.59,1681859,1681965
252,110,14,0,4.65,9.19,1681965,1682075
253,106,14,0,4.83,10.39,1682075,1682181
254,174,11,0,2.94,5.56,1682180,1682354
255,114,12,0,4.49,6.13,1682354,1682468
256,132,14,0,3.88,6.80,1682467,1682599
257,105,11,0,4.88,5.58,1682598,1682703
258,101,20,1,5.07,10.54,1682702,1682803
259,108,19,1,4.74,8.17,1682802,1682910
260,85,18,1,6.02,8.31,1682909,1682994
261,95,11,1,5.39,5.65,1682993,1683088
262,98,17,1,5.22,8.77,1683087,1683185
263,98,19,1,5.22,8.17,1683184,1683282
264,105,12,1,4.88,5.75,1683281,1683386
265,110,14,0,4.65,8.32,1683385,1683495
266,110,16,0,4.65,9.01,1683494,1683604
267,158,14,0,3.24,7.11,1683603,1683761
268,98,15,0,5.22,10.28,1683760,1683858
269,112,16,1,4.57,8.73,1683857,1683969
270,101,13,0,5.07,6.58,1683968,1684069
271,108,12,1,4.74,7.36,1684068,1684176
272,105,18,1,4.88,8.68,1684176,1684281
273,90,14,1,5.69,9.13,1684280,1684370
274,101,15,1,5.07,7.89,1684369,1684470
275,99,21,1,5.17,10.36,1684469,1684568
276,107,12,1,4.79,5.42,1684567,1684674
277,100,19,1,5.12,9.17,1684673,1684773
278,105,13,0,4.88,9.25,1684772,1684877
279,157,19,0,3.26,9.59,1684877,1685034
280,100,29,0,5.12,18.33,1685034,1685134
281,114,12,0,4.49,7.34,1685134,1685248
282,118,14,0,4.34,7.00,1685247,1685365
283,109,11,1,4.70,5.84,1685364,1685473
284,98,15,1,5.22,7.73,1685473,1685571
285,112,15,0,4.57,7.99,1685570,1685682
286,97,15,1,5.28,8.94,1685681,1685778
287,100,14,0,5.12,8.37,1685777,1685877
288,93,11,1,5.51,5.11,1685877,1685970
289,108,13,1,4.74,6.17,1685970,1686078
290,98,21,0,5.22,9.81,1686077,1686175
291,99,24,0,5.17,11.46,1686174,1686273
292,159,12,0,3.22,6.61,1686272,1686431
293,106,14,0,4.83,10.78,1686431,1686537
294,109,12,0,4.70,5.61,1686536,1686645
295,106,14,0,4.83,6.31,1686644,1686750
296,107,14,0,4.79,8.54,1686749,1686856
297,106,17,0,4.83,7.50,1686856,1686962
298,96,18,1,5.33,7.35,1686961,1687057
299,100,13,0,5.12,7.23,1687056,1687156
300,99,16,0,5.17,6.69,1687155,1687254
301,111,13,0,4.61,6.11,1687253,1687364
302,98,15,1,5.22,7.56,1687363,1687461
303,98,18,0,5.22,10.79,1687460,1687558
304,106,14,0,4.83,8.22,1687557,1687663
305,172,18,0,2.98,7.87,1687662,1687834
306,103,18,0,4.97,9.27,1687833,1687936
307,115,13,1,4.45,6.63,1687935,1688050
308,95,18,1,5.39,8.62,1688049,1688144
309,104,14,1,4.92,8.26,1688143,1688247
310,101,14,0,5.07,6.94,1688246,1688347
311,109,11,0,4.70,5.92,1688346,1688455
312,110,15,0,4.65,8.21,1688455,1688565
313,98,15,1,5.22,9.40,1688565,1688663
314,130,11,0,3.94,7.30,1688662,1688792
315,149,15,0,3.44,9.00,1688791,1688940
316,110,11,1,4.65,6.03,1688939,1689049
317,130,13,0,3.94,7.15,1689049,1689179
318,104,12,1,4.92,8.13,1689178,1689282
319,103,19,1,4.97,10.84,1689281,1689384
320,92,29,0,5.57,12.90,1689383,1689475
321,102,15,1,5.02,7.65,1689474,1689576
322,99,16,1,5.17,8.89,1689575,1689674
323,92,12,1,5.57,7.81,1689673,1689765
324,103,15,0,4.97,9.21,1689764,1689867
325,97,15,0,5.28,8.41,1689866,1689963
326,175,13,0,2.93,6.56,1689963,1690138
327,111,18,0,4.61,8.54,1690138,1690249
328,104,13,1,4.92,7.19,1690249,1690353
329,101,13,1,5.07,7.43,1690352,1690453
330,90,37,0,5.69,22.30,1690452,1690542
331,94,14,0,5.45,9.95,1690542,1690636
332,100,19,1,5.12,8.27,1690635,1690735
333,107,18,1,4.79,7.78,1690734,1690841
334,92,17,0,5.57,10.31,1690840,1690932
335,108,18,0,4.74,9.80,1690931,1691039
336,128,21,0,4.00,11.95,1691038,1691166
337,90,14,0,5.69,7.30,1691165,1691255
338,130,11,0,3.94,4.43,1691254,1691384
339,103,12,0,4.97,7.31,1691384,1691487
340,107,14,1,4.79,7.89,1691486,1691593
341,104,17,1,4.92,8.15,1691592,1691696
342,104,19,1,4.92,7.71,1691696,1691800
343,105,15,0,4.88,7.58,1691800,1691905
344,97,12,1,5.28,7.00,1691904,1692001
345,105,17,0,4.88,10.30,1692000,1692105
346,165,12,0,3.10,7.07,1692104,1692269
347,103,28,0,4.97,11.95,1692268,1692371
348,113,15,0,4.53,7.97,1692370,1692483
349,98,36,0,5.22,15.68,1692483,1692581
350,103,16,0,4.97,9.29,1692580,1692683
351,90,24,1,5.69,10.41,1692683,1692773
352,94,15,0,5.45,6.33,1692772,1692866
353,96,14,0,5.33,8.28,1692866,1692962
354,94,12,1,5.45,6.55,1692961,1693055
355,93,13,0,5.51,7.63,1693054,1693147
356,92,14,0,5.57,10.01,1693147,1693239
357,104,14,0,4.92,7.90,1693239,1693343
358,155,12,0,3.30,7.48,1693342,1693497
359,125,15,0,4.10,7.53,1693496,1693621
360,94,16,0,5.45,10.72,1693620,1693714
361,93,12,1,5.51,7.05,1693713,1693806
362,90,16,1,5.69,10.21,1693805,1693895
363,100,15,1,5.12,6.73,1693894,1693994
364,107,13,0,4.79,9.57,1693993,1694100
365,99,16,1,5.17,9.21,1694099,1694198
366,160,15,0,3.20,8.89,1694197,1694357
367,108,21,0,4.74,8.56,1694356,1694464
368,121,11,0,4.23,7.04,1694463,1694584
369,113,26,0,4.53,9.45,1694583,1694696
370,93,17,0,5.51,10.16,1694696,1694789
371,109,12,1,4.70,5.83,1694788,1694897
372,101,12,1,5.07,5.93,1694896,1694997
373,100,16,1,5.12,7.77,1694996,1695096
374,92,15,1,5.57,7.40,1695095,1695187
375,109,13,1,4.70,6.39,1695186,1695295
376,98,15,0,5.22,9.44,1695294,1695392
377,125,14,0,4.10,8.82,1695392,1695517
378,116,21,0,4.41,11.16,1695516,1695632
379,127,15,0,4.03,6.31,1695631,1695758
380,102,19,1,5.02,8.59,1695757,1695859
381,102,11,0,5.02,6.27,1695859,1695961
382,98,12,0,5.22,8.32,1695960,1696058
383,92,19,1,5.57,10.48,1696057,1696149
384,105,19,1,4.88,7.71,1696148,1696253
385,95,14,0,5.39,7.35,1696252,1696347
386,121,11,0,4.23,6.41,1696347,1696468
387,129,16,0,3.97,10.81,1696467,1696596
388,89,13,0,5.75,10.32,1696595,1696684
389,115,17,0,4.45,7.64,1696683,1696798
390,122,14,0,4.20,6.03,1696798,1696920
391,98,17,1,5.22,9.36,1696919,1697017
392,113,11,0,4.53,5.01,1697016,1697129
393,96,15,1,5.33,8.20,1697129,1697225
394,99,13,1,5.17,5.92,1697224,1697323
395,111,13,1,4.61,6.31,1697323,1697434
396,109,23,1,4.70,10.12,1697433,1697542
397,109,12,0,4.70,7.17,1697541,1697650
398,106,21,0,4.83,9.59,1697649,1697755
399,110,14,0,4.65,7.52,1697754,1697864
400,138,23,0,3.71,11.31,1697863,1698001
401,124,15,0,4.13,6.50,1698000,1698124
402,110,11,0,4.65,6.32,1698123,1698233
403,105,17,1,4.88,9.29,1698232,1698337
404,83,24,1,6.17,17.75,1698336,1698419
405,102,12,1,5.02,4.78,1698418,1698520
406,97,14,0,5.28,6.43,1698519,1698616
407,99,14,1,5.17,5.76,1698615,1698714
408,107,12,1,4.79,7.53,1698713,1698820
409,92,16,1,5.57,11.20,1698819,1698911
410,102,14,0,5.02,8.20,1698910,1699012
411,166,21,0,3.08,7.98,1699011,1699177
412,112,24,0,4.57,15.73,1699176,1699288
413,104,13,0,4.92,7.61,1699287,1699391
414,116,13,0,4.41,7.28,1699391,1699507
415,100,14,0,5.12,8.95,1699506,1699606
416,97,23,1,5.28,11.40,1699605,1699702
417,99,16,0,5.17,7.76,1699701,1699800
418,94,12,1,5.45,6.06,1699800,1699894
419,98,15,0,5.22,7.91,1699894,1699992
420,102,12,1,5.02,8.41,1699991,1700093
421,101,14,1,5.07,7.81,1700092,1700193
422,100,14,0,5.12,8.69,1700192,1700292
423,93,18,0,5.51,11.37,1700291,1700384
424,96,22,0,5.33,13.74,1700383,1700479
425,127,15,0,4.03,9.70,1700478,1700605
426,145,16,0,3.53,9.77,1700604,1700749
427,103,14,1,4.97,6.59,1700748,1700851
428,126,13,0,4.06,5.52,1700851,1700977
429,103,13,1,4.97,8.11,1700976,1701079
430,96,12,1,5.33,5.85,1701078,1701174
431,100,14,0,5.12,8.91,1701174,1701274
432,93,21,0,5.51,9.97,1701273,1701366
433,87,17,2,5.89,7.46,1701365,1701452
434,96,12,0,5.33,7.91,1701451,1701547
435,108,14,1,4.74,6.67,1701546,1701654
436,107,12,1,4.79,7.51,1701653,1701760
437,92,20,0,5.57,12.53,1701760,1701852
438,156,13,0,3.28,7.64,1701851,1702007
439,113,17,0,4.53,11.06,1702006,1702119
440,99,14,0,5.17,7.66,1702118,1702217
441,128,11,0,4.00,4.95,1702217,1702345
442,119,12,0,4.30,6.85,1702345,1702464
443,107,12,1,4.79,8.28,1702463,1702570
444,106,13,0,4.83,6.93,1702569,1702675
445,104,13,1,4.92,7.13,1702674,1702778
446,85,18,1,6.02,11.55,1702777,1702862
447,101,12,1,5.07,6.08,1702861,1702962
448,94,11,1,5.45,4.48,1702961,1703055
449,96,15,1,5.33,7.26,1703054,1703150
450,96,12,1,5.33,7.60,1703149,1703245
451,112,13,0,4.57,6.76,1703244,1703356
452,105,14,0,4.88,7.75,1703355,1703460
453,90,25,1,5.69,12.55,1703460,1703550
454,94,15,0,5.45,10.44,1703549,1703643
455,160,11,0,3.20,5.94,1703642,1703802
456,134,14,0,3.82,9.71,1703801,1703935
457,113,17,0,4.53,11.59,1703934,1704047
458,118,12,0,4.34,6.46,1704046,1704164
459,98,14,0,5.22,8.05,1704164,1704262
460,84,17,1,6.10,10.49,1704261,1704345
461,112,15,0,4.57,6.87,1704344,1704456
462,95,12,1,5.39,6.47,1704455,1704550
463,86,14,1,5.95,8.56,1704549,1704635
464,97,14,1,5.28,9.58,1704635,1704732
465,94,14,1,5.45,9.44,1704731,1704825
466,91,15,0,5.63,8.21,1704824,1704915
467,99,14,1,5.17,8.65,1704914,1705013
468,104,16,1,4.92,7.65,1705012,1705116
469,109,12,1,4.70,6.96,1705115,1705224
470,105,14,0,4.88,9.06,1705223,1705328
471,95,17,0,5.39,12.60,1705327,1705422
472,111,18,0,4.61,8.47,1705421,1705532
473,115,14,0,4.45,7.05,1705532,1705647
474,124,14,0,4.13,8.37,1705646,1705770
475,104,13,0,4.92,5.76,1705769,1705873
476,89,18,1,5.75,12.88,1705872,1705961
477,101,15,0,5.07,8.76,1705961,1706062
478,101,14,0,5.07,6.08,1706061,1706162
479,102,21,0,5.02,8.63,1706162,1706264
480,85,17,0,6.02,10.49,1706263,1706348
481,105,14,0,4.88,7.71,1706348,1706453
482,98,15,1,5.22,6.30,1706452,1706550
483,104,14,0,4.92,7.36,1706549,1706653
484,90,19,1,5.69,10.28,1706652,1706742
485,164,16,0,3.12,8.44,1706741,1706905
486,144,11,0,3.56,6.89,1706904,1707048
487,124,13,0,4.13,8.39,1707047,1707171
488,102,12,0,5.02,8.63,1707170,1707272
489,120,11,0,4.27,6.33,1707271,1707391
490,96,12,0,5.33,8.45,1707390,1707486
491,99,13,1,5.17,8.10,1707486,1707585
492,115,11,0,4.45,5.78,1707584,1707699
493,88,18,1,5.82,9.65,1707698,1707786
494,90,14,2,5.69,6.70,1707785,1707875
495,97,17,1,5.28,10.12,1707874,1707971
496,94,24,0,5.45,12.29,1707970,1708064
497,96,19,0,5.33,10.33,1708063,1708159
498,106,11,1,4.83,5.80,1708159,1708265
499,119,14,0,4.30,6.14,1708264,1708383
500,91,18,1,5.63,11.95,1708382,1708473
501,105,19,0,4.88,12.78,1708473,1708578
502,155,12,0,3.30,7.37,1708577,1708732
503,104,17,0,4.92,11.42,1708731,1708835
504,123,12,0,4.16,6.93,1708834,1708957
505,120,12,0,4.27,6.40,1708956,1709076
506,97,11,1,5.28,6.51,1709075,1709172
507,90,17,1,5.69,10.61,1709171,1709261
508,111,20,1,4.61,9.44,1709260,1709371
509,95,17,0,5.39,7.90,1709370,1709465
510,90,15,1,5.69,7.10,1709465,1709555
511,84,13,1,6.10,7.40,1709554,1709638
512,102,12,1,5.02,6.18,1709637,1709739
513,101,15,1,5.07,8.06,1709739,1709840
514,123,12,0,4.16,5.88,1709839,1709962
515,101,12,1,5.07,7.45,1709961,1710062
516,154,13,0,3.32,8.54,1710061,1710215
517,111,14,0,4.61,14.06,1710214,1710325
518,105,16,0,4.88,11.65,1710325,1710430
519,99,19,0,5.17,12.02,1710429,1710528
520,128,12,0,4.00,6.92,1710527,1710655
521,107,16,0,4.79,8.24,1710655,1710762
522,105,15,1,4.88,7.67,1710761,1710866
523,102,22,1,5.02,8.61,1710865,1710967
524,88,19,1,5.82,9.22,1710966,1711054
525,102,15,0,5.02,7.88,1711053,1711155
526,84,24,1,6.10,15.56,1711154,1711238
527,98,16,1,5.22,6.99,1711237,1711335
528,102,25,0,5.02,10.08,1711334,1711436
529,119,11,0,4.30,6.14,1711435,1711554
530,96,17,0,5.33,12.22,1711553,1711649
531,113,17,0,4.53,7.58,1711648,1711761
532,107,11,0,4.79,6.41,1711760,1711867
533,118,16,0,4.34,12.80,1711867,1711985
534,106,11,1,4.83,6.22,1711984,1712090
535,110,11,1,4.65,6.68,1712089,1712199
536,131,11,0,3.91,5.43,1712198,1712329
537,93,23,0,5.51,10.12,1712329,1712422
538,87,22,2,5.89,12.86,1712421,1712508
539,116,10,0,4.41,4.85,1712508,1712624
540,92,13,1,5.57,7.48,1712623,1712715
541,94,14,1,5.45,7.40,1712715,1712809
542,104,13,1,4.92,7.57,1712808,1712912
543,85,15,1,6.02,10.00,1712911,1712996
544,94,16,1,5.45,7.82,1712995,1713089
545,95,16,1,5.39,7.99,1713089,1713184
546,119,12,0,4.30,6.38,1713184,1713303
547,113,18,0,4.53,8.30,1713302,1713415
548,163,14,0,3.14,6.93,1713414,1713577
549,119,18,0,4.30,11.59,1713577,1713696
550,134,12,0,3.82,6.94,1713695,1713829
551,109,20,1,4.70,8.08,1713828,1713937
552,102,14,0,5.02,8.65,1713937,1714039
553,90,15,1,5.69,8.88,1714038,1714128
554,118,18,1,4.34,6.12,1714127,1714245
555,87,19,1,5.89,13.21,1714244,1714331
556,92,16,1,5.57,8.57,1714330,1714422
557,87,18,1,5.89,11.09,1714422,1714509
558,93,12,1,5.51,5.93,1714508,1714601
559,115,16,0,4.45,8.18,1714600,1714715
560,96,14,1,5.33,7.62,1714715,1714811
561,95,19,1,5.39,11.29,1714810,1714905
562,93,24,1,5.51,11.33,1714904,1714997
563,129,19,0,3.97,10.39,1714996,1715125
564,157,13,0,3.26,6.96,1715124,1715281
565,113,15,0,4.53,9.47,1715280,1715393
566,103,14,1,4.97,6.20,1715392,1715495
567,116,13,0,4.41,6.48,1715494,1715610
568,96,20,0,5.33,10.72,1715610,1715706
569,100,17,1,5.12,10.31,1715705,1715805
570,93,14,0,5.51,6.21,1715805,1715898
571,94,17,0,5.45,8.99,1715897,1715991
572,97,11,1,5.28,6.49,1715990,1716087
573,110,13,0,4.65,5.57,1716086,1716196
574,102,14,1,5.02,7.29,1716195,1716297
575,98,14,0,5.22,6.60,1716297,1716395
576,104,15,0,4.92,10.15,1716395,1716499
577,174,22,0,2.94,7.46,1716498,1716672
578,118,22,0,4.34,13.94,1716672,1716790
579,109,13,0,4.70,8.34,1716789,1716898
580,116,18,0,4.41,8.67,1716897,1717013
581,99,12,1,5.17,7.11,1717013,1717112
582,105,12,1,4.88,6.17,1717111,1717216
583,90,14,0,5.69,8.97,1717216,1717306
584,96,18,1,5.33,10.72,1717306,1717402
585,98,14,0,5.22,6.19,1717401,1717499
586,90,15,1,5.69,8.37,1717498,1717588
587,91,14,1,5.63,7.09,1717587,1717678
588,103,16,0,4.97,6.49,1717677,1717780
589,100,14,0,5.12,7.77,1717779,1717879
590,110,13,0,4.65,8.28,1717878,1717988
591,100,13,0,5.12,9.03,1717987,1718087
592,144,18,0,3.56,9.54,1718086,1718230
593,80,21,1,6.40,16.32,1718229,1718309
594,97,18,0,5.28,9.69,1718308,1718405
595,126,15,0,4.06,7.71,1718404,1718530
596,113,17,1,4.53,7.56,1718529,1718642
597,107,16,1,4.79,7.42,1718641,1718748
598,103,18,0,4.97,9.04,1718747,1718850
599,88,15,0,5.82,7.47,1718850,1718938
600,87,15,1,5.89,8.70,1718938,1719025
601,103,16,1,4.97,7.27,1719024,1719127
602,99,24,1,5.17,9.98,1719126,1719225
603,104,14,0,4.92,7.28,1719224,1719328
604,98,20,0,5.22,10.70,1719327,1719425
605,100,16,0,5.12,12.01,1719424,1719524
606,114,16,0,4.49,8.18,1719523,1719637
607,176,15,0,2.91,6.93,1719637,1719813
608,116,20,0,4.41,14.76,1719812,1719928
609,108,12,0,4.74,8.25,1719927,1720035
610,119,19,0,4.30,6.87,1720035,1720154
611,99,16,1,5.17,7.21,1720153,1720252
612,104,26,0,4.92,12.72,1720251,1720355
613,101,22,1,5.07,8.72,1720354,1720455
614,96,14,1,5.33,7.31,1720454,1720550
615,84,22,2,6.10,14.21,1720549,1720633
616,99,15,1,5.17,7.39,1720632,1720731
617,105,16,1,4.88,6.81,1720730,1720835
618,101,15,0,5.07,8.84,1720834,1720935
619,102,14,0,5.02,11.69,1720934,1721036
620,104,14,0,4.92,9.34,1721035,1721139
621,167,12,0,3.07,5.82,1721138,1721305
622,131,14,0,3.91,11.21,1721304,1721435
623,118,14,0,4.34,6.94,1721434,1721552
624,125,14,0,4.10,6.77,1721551,1721676
625,104,18,0,4.92,8.07,1721675,1721779
626,106,14,0,4.83,7.44,1721778,1721884
627,96,23,1,5.33,15.41,1721883,1721979
628,90,17,1,5.69,7.97,1721978,1722068
629,100,12,1,5.12,6.69,1722068,1722168
630,94,14,2,5.45,7.59,1722167,1722261
631,90,22,1,5.69,12.88,1722260,1722350
632,95,20,1,5.39,9.80,1722349,1722444
633,104,13,1,4.92,6.11,1722443,1722547
634,91,33,0,5.63,25.82,1722546,1722637
635,99,14,0,5.17,9.21,1722636,1722735
636,170,12,0,3.01,5.32,1722734,1722904
637,130,16,0,3.94,9.12,1722904,1723034
638,109,11,0,4.70,8.25,1723033,1723142
639,112,13,0,4.57,7.87,1723141,1723253
640,92,13,1,5.57,8.09,1723253,1723345
641,96,13,1,5.33,7.35,1723344,1723440
642,97,19,0,5.28,8.78,1723440,1723537
643,88,18,1,5.82,12.01,1723536,1723624
644,113,12,1,4.53,5.49,1723623,1723736
645,101,19,0,5.07,10.34,1723735,1723836
646,796,21,0,0.64,3.58,1723835,1724631
647,106,14,0,4.83,7.12,1724631,1724737
648,105,19,0,4.88,10.09,1724736,1724841
649,94,18,1,5.45,8.33,1724840,1724934
650,99,18,1,5.17,7.98,1724934,1725033
651,98,18,1,5.22,8.89,1725032,1725130
652,89,18,0,5.75,11.04,1725129,1725218
653,94,12,1,5.45,7.20,1725217,1725311
654,100,24,1,5.12,11.35,1725310,1725410
655,110,13,0,4.65,8.28,1725409,1725519
656,180,11,0,2.84,4.75,1725518,1725698
657,133,17,0,3.85,9.30,1725698,1725831
658,98,16,1,5.22,10.09,1725830,1725928
659,114,21,0,4.49,8.71,1725927,1726041
660,98,21,0,5.22,10.34,1726040,1726138
661,94,15,1,5.45,9.25,1726137,1726231
662,93,17,1,5.51,9.56,1726230,1726323
663,94,14,1,5.45,8.44,1726323,1726417
664,98,18,1,5.22,10.01,1726416,1726514
665,104,15,1,4.92,6.99,1726514,1726618
666,109,19,0,4.70,10.39,1726618,1726727
667,98,14,1,5.22,8.03,1726726,1726824
668,141,17,0,3.63,8.39,1726823,1726964
669,174,16,0,2.94,7.76,1726963,1727137
670,103,17,0,4.97,13.15,1727136,1727239
671,125,12,0,4.10,6.60,1727238,1727363
672,115,15,1,4.45,5.81,1727362,1727477
673,99,12,1,5.17,6.57,1727476,1727575
674,85,17,1,6.02,8.56,1727575,1727660
675,98,12,1,5.22,5.52,1727659,1727757
676,105,12,0,4.88,5.56,1727756,1727861
677,115,21,0,4.45,8.40,1727861,1727976
678,100,14,0,5.12,8.61,1727975,1728075
679,174,16,0,2.94,7.58,1728074,1728248
680,151,15,0,3.39,7.96,1728247,1728398
681,103,16,0,4.97,8.92,1728397,1728500
682,121,11,0,4.23,5.33,1728499,1728620
683,90,17,1,5.69,9.88,1728619,1728709
684,105,13,0,4.88,8.83,1728708,1728813
685,94,15,1,5.45,7.65,1728812,1728906
686,98,12,0,5.22,7.60,1728905,1729003
687,91,14,0,5.63,6.54,1729002,1729093
688,99,17,0,5.17,7.84,1729092,1729191
689,100,15,1,5.12,7.87,1729190,1729290
690,94,21,0,5.45,12.82,1729290,1729384
691,105,11,1,4.88,6.55,1729383,1729488
692,184,12,0,2.78,6.95,1729488,1729672
693,119,16,0,4.30,9.69,1729671,1729790
694,116,14,0,4.41,8.00,1729789,1729905
695,111,16,0,4.61,8.67,1729904,1730015
696,89,16,0,5.75,8.91,1730014,1730103
697,100,13,1,5.12,7.55,1730102,1730202
698,88,15,1,5.82,9.99,1730201,1730289
699,93,15,0,5.51,7.91,1730288,1730381
700,96,16,0,5.33,8.95,1730380,1730476
701,103,14,0,4.97,7.85,1730475,1730578
702,93,16,0,5.51,7.73,1730578,1730671
703,96,20,0,5.33,10.58,1730670,1730766
704,112,12,0,4.57,7.89,1730765,1730877
705,150,13,0,3.41,7.43,1730876,1731026
706,92,13,0,5.57,8.85,1731025,1731117
707,108,15,1,4.74,7.34,1731116,1731224
708,113,12,0,4.53,6.04,1731223,1731336
709,101,13,1,5.07,8.46,1731335,1731436
710,101,15,0,5.07,8.98,1731435,1731536
711,96,23,1,5.33,9.51,1731535,1731631
712,96,13,1,5.33,6.43,1731630,1731726
713,101,15,0,5.07,9.79,1731726,1731827
714,113,14,1,4.53,6.82,1731826,1731939
715,97,24,0,5.28,11.73,1731938,1732035
716,124,15,0,4.13,8.74,1732034,1732158
717,116,14,0,4.41,8.10,1732157,1732273
718,109,15,0,4.70,9.51,1732272,1732381
719,111,15,1,4.61,6.76,1732380,1732491
720,115,17,0,4.45,8.07,1732490,1732605
721,92,14,0,5.57,8.29,1732604,1732696
722,106,18,0,4.83,9.25,1732695,1732801
723,98,12,1,5.22,5.24,1732800,1732898
724,86,19,1,5.95,10.11,1732897,1732983
725,97,19,1,5.28,9.83,1732982,1733079
726,100,11,1,5.12,5.03,1733078,1733178
727,106,14,1,4.83,6.29,1733177,1733283
728,114,13,0,4.49,6.93,1733282,1733396
729,137,22,0,3.74,11.74,1733396,1733533
730,97,12,0,5.28,6.94,1733532,1733629
731,124,11,0,4.13,4.87,1733628,1733752
732,119,15,0,4.30,7.32,1733751,1733870
733,103,15,0,4.97,7.68,1733869,1733972
734,92,12,1,5.57,6.68,1733971,1734063
735,92,13,0,5.57,10.18,1734062,1734154
736,88,15,1,5.82,8.35,1734153,1734241
737,98,17,1,5.22,8.05,1734241,1734339
738,93,22,0,5.51,9.95,1734338,1734431
739,96,13,1,5.33,7.12,1734430,1734526
740,116,13,0,4.41,5.69,1734525,1734641
741,102,11,1,5.02,7.00,1734640,1734742
742,139,10,0,3.68,7.11,1734741,1734880
743,122,13,0,4.20,9.21,1734879,1735001
744,114,19,0,4.49,7.83,1735000,1735114
745,96,15,1,5.33,8.70,1735114,1735210
746,97,12,1,5.28,7.75,1735209,1735306
747,113,12,1,4.53,6.82,1735305,1735418
748,91,18,1,5.63,10.52,1735417,1735508
749,98,12,1,5.22,6.62,1735507,1735605
750,97,13,1,5.28,7.48,1735605,1735702
751,99,13,1,5.17,6.71,1735701,1735800
752,102,13,0,5.02,6.84,1735800,1735902
753,104,15,0,4.92,10.13,1735901,1736005
754,139,14,0,3.68,8.23,1736004,1736143
755,115,18,0,4.45,9.48,1736142,1736257
756,96,17,1,5.33,9.83,1736256,1736352
757,127,13,0,4.03,6.68,1736351,1736478
758,98,14,1,5.22,5.44,1736478,1736576
759,114,14,1,4.49,6.21,1736575,1736689
760,91,14,0,5.63,9.03,1736688,1736779
761,90,19,0,5.69,11.46,1736778,1736868
762,100,20,1,5.12,11.33,1736867,1736967
763,95,27,1,5.39,12.93,1736966,1737061
764,114,14,0,4.49,7.32,1737060,1737174
765,95,14,0,5.39,7.65,1737173,1737268
766,99,22,0,5.17,12.18,1737267,1737366
767,136,16,0,3.76,9.19,1737365,1737501
768,122,14,0,4.20,8.70,1737500,1737622
769,111,14,1,4.61,8.08,1737621,1737732
770,123,14,0,4.16,6.88,1737731,1737854
771,100,16,0,5.12,8.61,1737853,1737953
772,108,15,1,4.74,8.36,1737952,1738060
773,104,15,1,4.92,7.36,1738059,1738163
774,97,16,0,5.28,8.06,1738162,1738259
775,104,17,1,4.92,6.96,1738258,1738362
776,101,13,1,5.07,6.58,1738361,1738462
777,104,13,1,4.92,6.38,1738462,1738566
778,100,14,1,5.12,8.95,1738565,1738665
779,96,14,0,5.33,8.51,1738664,1738760
780,128,17,0,4.00,10.72,1738759,1738887
781,109,21,0,4.70,11.11,1738886,1738995
782,106,14,0,4.83,7.20,1738994,1739100
783,120,13,0,4.27,6.75,1739100,1739220
784,94,17,0,5.45,9.44,1739219,1739313
785,86,15,1,5.95,10.56,1739312,1739398
786,105,17,1,4.88,7.86,1739398,1739503
787,84,17,0,6.10,9.90,1739502,1739586
788,101,13,1,5.07,6.82,1739585,1739686
789,102,12,1,5.02,7.86,1739685,1739787
790,91,14,1,5.63,6.96,1739786,1739877
791,101,15,1,5.07,6.34,1739877,1739978
792,117,14,0,4.38,6.92,1739977,1740094
793,113,13,0,4.53,7.88,1740094,1740207
794,142,18,0,3.61,9.49,1740206,1740348
795,95,18,0,5.39,11.35,1740347,1740442
796,118,12,0,4.34,6.77,1740441,1740559
797,121,13,0,4.23,6.52,1740559,1740680
798,102,13,1,5.02,6.49,1740679,1740781
799,92,18,0,5.57,8.64,1740780,1740872
800,102,22,1,5.02,8.53,1740871,1740973
801,93,19,0,5.51,9.11,1740972,1741065
802,90,18,0,5.69,12.48,1741064,1741154
803,96,13,1,5.33,6.62,1741153,1741249
804,96,14,1,5.33,7.64,1741248,1741344
805,108,13,0,4.74,7.01,1741344,1741452
806,94,16,1,5.45,9.84,1741451,1741545
807,97,25,1,5.28,12.53,1741544,1741641
808,140,19,0,3.66,9.95,1741640,1741780
809,94,21,1,5.45,12.78,1741780,1741874
810,121,11,0,4.23,5.86,1741873,1741994
811,119,12,0,4.30,5.91,1741994,1742113
812,84,25,1,6.10,12.44,1742112,1742196
813,98,14,1,5.22,8.79,1742196,1742294
814,88,17,1,5.82,8.67,1742293,1742381
815,92,15,1,5.57,7.46,1742380,1742472
816,90,13,0,5.69,7.81,1742471,1742561
817,107,14,0,4.79,7.10,1742560,1742667
818,113,16,0,4.53,7.88,1742666,1742779
819,91,13,1,5.63,6.56,1742779,1742870
820,92,17,1,5.57,9.12,1742870,1742962
821,123,11,0,4.16,8.18,1742961,1743084
822,157,11,0,3.26,6.17,1743083,1743240
823,104,18,0,4.92,9.82,1743239,1743343
824,124,13,1,4.13,7.05,1743342,1743466
825,111,16,0,4.61,8.56,1743465,1743576
826,90,14,1,5.69,7.90,1743575,1743665
827,111,13,0,4.61,6.76,1743665,1743776
828,86,17,1,5.95,9.97,1743776,1743862
829,95,14,1,5.39,6.97,1743861,1743956
830,90,18,1,5.69,8.97,1743955,1744045
831,93,13,1,5.51,7.80,1744044,1744137
832,98,17,1,5.22,9.42,1744136,1744234
833,97,18,1,5.28,11.42,1744233,1744330
834,99,13,0,5.17,8.20,1744329,1744428
835,127,16,0,4.03,8.58,1744427,1744554
836,157,13,0,3.26,7.12,1744554,1744711
837,83,22,0,6.17,21.15,1744711,1744794
838,113,13,0,4.53,6.66,1744793,1744906
839,121,11,0,4.23,4.57,1744906,1745027
840,102,17,0,5.02,8.35,1745026,1745128
841,96,15,1,5.33,8.89,1745127,1745223
842,89,21,1,5.75,11.98,1745222,1745311
843,89,19,0,5.75,9.04,1745310,1745399
844,91,18,1,5.63,9.22,1745398,1745489
845,94,14,1,5.45,6.99,1745488,1745582
846,92,19,1,5.57,10.09,1745582,1745674
847,112,14,0,4.57,6.42,1745674,1745786
848,98,17,0,5.22,11.17,1745785,1745883
849,165,12,0,3.10,7.81,1745882,1746047
850,129,12,0,3.97,7.02,1746046,1746175
851,101,21,1,5.07,10.50,1746175,1746276
852,108,11,0,4.74,6.75,1746275,1746383
853,101,13,1,5.07,7.27,1746382,1746483
854,97,19,1,5.28,11.09,1746482,1746579
855,103,16,1,4.97,8.65,1746578,1746681
856,82,24,1,6.24,13.62,1746681,1746763
857,91,13,1,5.63,6.83,1746762,1746853
858,92,14,2,5.57,7.35,1746852,1746944
859,98,14,0,5.22,6.95,1746944,1747042
860,108,13,1,4.74,6.53,1747041,1747149
861,103,18,0,4.97,9.66,1747148,1747251
862,100,16,1,5.12,7.81,1747250,1747350
863,91,17,0,5.63,14.10,1747349,1747440
864,120,13,0,4.27,7.20,1747439,1747559
865,176,11,0,2.91,6.42,1747558,1747734
866,102,16,1,5.02,9.76,1747733,1747835
867,117,13,1,4.38,6.44,1747835,1747952
868,95,15,0,5.39,9.80,1747951,1748046
869,88,26,0,5.82,12.76,1748045,1748133
870,103,12,1,4.97,6.53,1748133,1748236
871,80,19,1,6.40,13.19,1748235,1748315
872,89,16,1,5.75,8.30,1748314,1748403
873,86,14,2,5.95,6.79,1748402,1748488
874,106,15,1,4.83,7.12,1748488,1748594
875,100,14,1,5.12,6.27,1748594,1748694
876,108,18,0,4.74,8.08,1748694,1748802
877,98,18,1,5.22,8.28,1748801,1748899
878,105,13,0,4.88,8.24,1748898,1749003
879,156,16,0,3.28,9.75,1749002,1749158
880,98,19,0,5.22,15.17,1749158,1749256
881,93,17,1,5.51,8.83,1749255,1749348
882,114,11,1,4.49,6.48,1749347,1749461
883,95,20,1,5.39,12.68,1749460,1749555
884,104,15,0,4.92,7.46,1749554,1749658
885,91,22,1,5.63,9.07,1749657,1749748
886,96,11,0,5.33,7.89,1749747,1749843
887,93,15,1,5.51,8.34,1749842,1749935
888,93,19,0,5.51,9.67,1749934,1750027
889,104,16,0,4.92,8.97,1750027,1750131
890,95,15,0,5.39,12.28,1750130,1750225
891,110,14,0,4.65,7.03,1750224,1750334
892,189,11,0,2.71,4.93,1750333,1750522
893,107,20,0,4.79,14.86,1750521,1750628
894,102,13,0,5.02,7.67,1750627,1750729
895,119,15,0,4.30,8.55,1750729,1750848
896,100,14,0,5.12,7.93,1750847,1750947
897,107,13,0,4.79,6.79,1750946,1751053
898,86,18,1,5.95,9.42,1751052,1751138
899,92,18,1,5.57,9.83,1751137,1751229
900,97,18,1,5.28,8.86,1751228,1751325
901,106,16,1,4.83,7.05,1751325,1751431
902,108,12,0,4.74,7.10,1751430,1751538
903,107,11,1,4.79,6.80,1751538,1751645
904,88,17,0,5.82,12.15,1751644,1751732
905,101,13,0,5.07,7.87,1751731,1751832
906,171,14,0,2.99,6.09,1751832,1752003
907,106,18,0,4.83,12.65,1752003,1752109
908,90,14,1,5.69,9.46,1752108,1752198
909,122,14,0,4.20,7.52,1752197,1752319
910,97,16,1,5.28,8.76,1752318,1752415
911,93,13,1,5.51,7.97,1752414,1752507
912,102,14,0,5.02,8.22,1752506,1752608
913,94,14,1,5.45,7.37,1752607,1752701
914,93,17,0,5.51,11.24,1752700,1752793
915,93,15,0,5.51,10.77,1752792,1752885
916,112,11,0,4.57,6.69,1752884,1752996
917,108,14,0,4.74,7.84,1752995,1753103
918,107,16,0,4.79,7.89,1753102,1753209
919,94,17,0,5.45,11.29,1753208,1753302
920,183,11,0,2.80,4.61,1753302,1753485
921,128,36,0,4.00,17.62,1753485,1753613
922,80,14,1,6.40,11.22,1753612,1753692
923,109,17,0,4.70,11.70,1753691,1753800
924,109,13,0,4.70,5.92,1753799,1753908
925,96,15,0,5.33,9.14,1753907,1754003
926,101,16,1,5.07,9.55,1754002,1754103
927,88,14,1,5.82,8.29,1754102,1754190
928,82,14,1,6.24,9.09,1754189,1754271
929,90,24,1,5.69,13.04,1754271,1754361
930,106,16,1,4.83,8.41,1754360,1754466
931,92,19,0,5.57,14.90,1754465,1754557
932,101,15,0,5.07,9.79,1754556,1754657
933,95,14,0,5.39,8.34,1754656,1754751
934,153,12,0,3.35,7.01,1754751,1754904
935,125,21,0,4.10,10.31,1754904,1755029
936,114,15,0,4.49,8.55,1755028,1755142
937,97,19,1,5.28,9.23,1755141,1755238
938,103,23,0,4.97,9.52,1755237,1755340
939,104,15,0,4.92,8.76,1755339,1755443
940,94,13,0,5.45,8.20,1755443,1755537
941,97,14,1,5.28,7.64,1755536,1755633
942,82,22,2,6.24,13.18,1755632,1755714
943,95,12,1,5.39,7.48,1755714,1755809
944,96,13,0,5.33,7.74,1755808,1755904
945,87,19,1,5.89,10.63,1755904,1755991
946,99,13,1,5.17,8.16,1755990,1756089
947,103,14,0,4.97,9.97,1756088,1756191
948,95,14,0,5.39,8.60,1756190,1756285
949,89,26,1,5.75,12.30,1756284,1756373
950,177,12,0,2.89,5.84,1756372,1756549
951,113,24,0,4.53,13.79,1756548,1756661
952,95,29,0,5.39,12.93,1756660,1756755
953,119,11,0,4.30,6.19,1756755,1756874
954,107,14,0,4.79,8.02,1756873,1756980
955,94,13,2,5.45,6.01,1756979,1757073
956,82,29,1,6.24,20.21,1757072,1757154
957,88,12,1,5.82,7.92,1757153,1757241
958,100,12,0,5.12,7.17,1757240,1757340
959,101,18,0,5.07,8.50,1757339,1757440
960,104,17,1,4.92,8.67,1757439,1757543
961,108,12,0,4.74,7.01,1757542,1757650
962,113,15,0,4.53,9.54,1757649,1757762
963,170,16,0,3.01,6.87,1757761,1757931
964,123,27,0,4.16,13.00,1757930,1758053
965,103,13,0,4.97,6.86,1758052,1758155
966,108,15,0,4.74,7.90,1758154,1758262
967,96,18,1,5.33,8.74,1758261,1758357
968,102,18,1,5.02,8.04,1758356,1758458
969,100,12,1,5.12,6.11,1758457,1758557
970,100,13,1,5.12,7.41,1758556,1758656
971,103,14,0,4.97,6.61,1758655,1758758
972,93,22,1,5.51,11.35,1758757,1758850
973,102,16,0,5.02,8.67,1758849,1758951
974,106,22,1,4.83,8.95,1758950,1759056
975,112,10,0,4.57,6.33,1759055,1759167
976,162,17,0,3.16,6.02,1759166,1759328
977,98,14,0,5.22,8.52,1759327,1759425
978,118,13,1,4.34,6.99,1759425,1759543
979,114,15,1,4.49,6.50,1759542,1759656
980,102,13,1,5.02,8.14,1759655,1759757
981,93,13,1,5.51,7.20,1759756,1759849
982,108,15,0,4.74,8.06,1759848,1759956
983,89,13,0,5.75,9.80,1759955,1760044
984,87,13,0,5.89,9.21,1760043,1760130
985,104,12,0,4.92,6.99,1760130,1760234
986,93,20,0,5.51,11.73,1760233,1760326
987,91,15,0,5.63,8.28,1760325,1760416
988,92,26,0,5.57,14.35,1760415,1760507
989,101,16,0,5.07,9.41,1760506,1760607
990,149,19,0,3.44,10.92,1760606,1760755
991,94,22,0,5.45,12.25,1760755,1760849
992,107,17,1,4.79,9.78,1760848,1760955
993,115,14,0,4.45,8.60,1760954,1761069
994,98,16,0,5.22,6.97,1761068,1761166
995,101,16,0,5.07,7.43,1761165,1761266
996,104,23,1,4.92,12.86,1761265,1761369
997,92,15,2,5.57,8.68,1761368,1761460
998,92,12,1,5.57,7.85,1761459,1761551
999,97,13,0,5.28,7.79,1761550,1761647
1000,90,21,1,5.69,12.64,1761646,1761736
1001,100,16,1,5.12,9.67,1761735,1761835
1002,98,11,0,5.22,7.46,1761834,1761932
1003,99,17,0,5.17,10.12,1761931,1762030
1004,96,16,1,5.33,9.22,1762029,1762125
1005,103,12,0,4.97,8.26,1762124,1762227
1006,153,12,0,3.35,6.51,1762226,1762379
1007,131,17,0,3.91,10.04,1762379,1762510
1008,88,15,0,5.82,12.72,1762509,1762597
1009,102,14,1,5.02,8.16,1762596,1762698
1010,105,17,1,4.88,6.87,1762698,1762803
1011,100,17,1,5.12,7.99,1762803,1762903
1012,80,19,1,6.40,15.09,1762903,1762983
1013,97,20,0,5.28,8.45,1762982,1763079
1014,101,14,1,5.07,8.24,1763078,1763179
1015,82,17,1,6.24,11.09,1763178,1763260
1016,98,13,1,5.22,6.30,1763259,1763357
1017,97,17,1,5.28,11.17,1763356,1763453
1018,102,15,0,5.02,9.69,1763452,1763554
1019,147,15,0,3.48,8.49,1763553,1763700
1020,102,23,0,5.02,19.94,1763699,1763801
1021,101,17,0,5.07,9.45,1763800,1763901
1022,124,11,0,4.13,5.85,1763900,1764024
1023,99,15,1,5.17,8.95,1764023,1764122
1024,106,16,0,4.83,7.99,1764121,1764227
1025,82,15,1,6.24,8.57,1764226,1764308
1026,89,19,1,5.75,9.96,1764307,1764396
1027,92,23,1,5.57,12.22,1764395,1764487
1028,82,19,1,6.24,13.31,1764486,1764568
1029,95,19,1,5.39,10.89,1764568,1764663
1030,83,18,0,6.17,11.88,1764662,1764745
1031,145,17,0,3.53,8.88,1764744,1764889
1032,133,18,0,3.85,9.36,1764889,1765022
1033,85,20,1,6.02,13.15,1765021,1765106
1034,113,32,0,4.53,13.01,1765106,1765219
1035,95,22,0,5.39,9.54,1765219,1765314
1036,88,15,1,5.82,7.65,1765314,1765402
1037,98,17,0,5.22,8.38,1765401,1765499
1038,92,15,1,5.57,7.59,1765499,1765591
1039,102,11,1,5.02,7.00,1765590,1765692
1040,100,28,0,5.12,11.91,1765691,1765791
1041,104,13,0,4.92,6.24,1765791,1765895
1042,105,14,0,4.88,6.60,1765894,1765999
1043,99,18,0,5.17,10.22,1765998,1766097
1044,130,15,0,3.94,10.04,1766096,1766226
1045,118,18,0,4.34,9.56,1766225,1766343
1046,122,15,0,4.20,7.75,1766342,1766464
1047,112,13,0,4.57,6.92,1766463,1766575
1048,92,11,1,5.57,7.07,1766574,1766666
1049,93,15,0,5.51,8.87,1766665,1766758
1050,88,15,1,5.82,7.94,1766758,1766846
1051,92,14,1,5.57,8.05,1766846,1766938
1052,104,14,1,4.92,8.57,1766937,1767041
1053,89,14,0,5.75,11.74,1767040,1767129
1054,105,15,0,4.88,12.20,1767128,1767233
1055,123,16,0,4.16,11.39,1767232,1767355
1056,108,16,0,4.74,10.10,1767354,1767462
1057,112,20,1,4.57,9.60,1767461,1767573
1058,88,14,1,5.82,8.74,1767572,1767660
1059,97,14,1,5.28,7.73,1767659,1767756
1060,92,14,0,5.57,8.16,1767755,1767847
1061,105,14,0,4.88,8.39,1767846,1767951
1062,95,19,1,5.39,12.15,1767950,1768045
1063,109,20,1,4.70,8.74,1768044,1768153
1064,100,18,0,5.12,11.31,1768152,1768252
1065,129,21,0,3.97,13.04,1768251,1768380
1066,149,20,0,3.44,10.26,1768379,1768528
1067,88,21,0,5.82,15.47,1768527,1768615
1068,127,12,0,4.03,6.27,1768614,1768741
1069,83,17,1,6.17,10.67,1768740,1768823
1070,92,15,1,5.57,9.20,1768822,1768914
1071,92,13,1,5.57,8.05,1768913,1769005
1072,92,13,0,5.57,8.31,1769004,1769096
1073,99,11,1,5.17,7.33,1769095,1769194
1074,99,14,1,5.17,7.17,1769193,1769292
1075,98,15,0,5.22,8.81,1769292,1769390
1076,99,16,0,5.17,9.54,1769389,1769488
1077,98,17,0,5.22,10.17,1769487,1769585
1078,172,13,0,2.98,6.34,1769584,1769756
1079,102,18,0,5.02,11.74,1769755,1769857
1080,127,11,0,4.03,5.64,1769856,1769983
1081,93,30,1,5.51,13.17,1769982,1770075
1082,103,14,1,4.97,7.23,1770074,1770177
1083,94,15,1,5.45,6.72,1770177,1770271
1084,90,12,0,5.69,7.17,1770271,1770361
1085,101,16,0,5.07,7.67,1770360,1770461
1086,104,21,0,4.92,10.72,1770460,1770564
1087,99,28,0,5.17,14.32,1770563,1770662
1088,84,30,1,6.10,15.35,1770661,1770745
1089,134,13,0,3.82,9.70,1770745,1770879
1090,115,46,0,4.45,25.76,1770878,1770993
1091,107,12,0,4.79,8.45,1770992,1771099
1092,117,13,1,4.38,7.00,1771099,1771216
1093,93,16,0,5.51,8.92,1771215,1771308
1094,93,24,1,5.51,12.87,1771308,1771401
1095,97,14,0,5.28,6.82,1771400,1771497
1096,77,21,1,6.65,14.70,1771496,1771573
1097,88,15,1,5.82,8.40,1771572,1771660
1098,92,20,0,5.57,9.20,1771659,1771751
1099,104,14,1,4.92,7.69,1771750,1771854
1100,87,17,1,5.89,12.65,1771853,1771940
1101,86,18,0,5.95,13.07,1771939,1772025
1102,137,15,0,3.74,9.55,1772024,1772161
1103,123,15,0,4.16,10.25,1772160,1772283
1104,115,15,0,4.45,5.74,1772282,1772397
1105,116,20,0,4.41,9.04,1772396,1772512
1106,91,15,1,5.63,7.57,1772511,1772602
1107,111,14,1,4.61,6.51,1772601,1772712
1108,86,22,1,5.95,9.30,1772711,1772797
1109,95,13,0,5.39,7.61,1772796,1772891
1110,79,25,0,6.48,19.11,1772890,1772969
1111,93,22,1,5.51,13.09,1772968,1773061
1112,97,15,1,5.28,7.93,1773061,1773158
1113,102,17,0,5.02,8.74,1773157,1773259
1114,101,19,0,5.07,11.11,1773258,1773359
1115,95,20,1,5.39,11.50,1773359,1773454
1116,155,11,0,3.30,6.82,1773453,1773608
1117,97,15,0,5.28,13.83,1773607,1773704
1118,109,13,1,4.70,7.04,1773704,1773813
1119,109,13,0,4.70,6.74,1773812,1773921
1120,95,14,1,5.39,9.27,1773920,1774015
1121,94,16,1,5.45,8.23,1774015,1774109
1122,106,14,1,4.83,6.10,1774108,1774214
1123,94,13,1,5.45,6.29,1774213,1774307
1124,92,17,1,5.57,9.96,1774306,1774398
1125,93,16,2,5.51,9.35,1774398,1774491
1126,103,14,1,4.97,8.49,1774490,1774593
1127,95,15,1,5.39,8.83,1774592,1774687
1128,106,16,0,4.83,11.07,1774686,1774792
1129,137,16,0,3.74,8.75,1774791,1774928
1130,109,29,0,4.70,13.39,1774928,1775037
1131,117,13,0,4.38,7.26,1775036,1775153
1132,113,14,1,4.53,6.39,1775152,1775265
1133,91,15,1,5.63,10.52,1775264,1775355
1134,102,15,1,5.02,8.29,1775354,1775456
1135,95,12,1,5.39,6.87,1775455,1775550
1136,92,18,1,5.57,9.22,1775549,1775641
1137,94,14,1,5.45,6.89,1775640,1775734
1138,99,17,0,5.17,9.64,1775733,1775832
1139,102,18,0,5.02,10.96,1775831,1775933
1140,98,15,0,5.22,9.07,1775932,1776030
1141,136,15,0,3.76,7.84,1776029,1776165
1142,117,20,0,4.38,12.76,1776164,1776281
1143,104,17,0,4.92,7.24,1776280,1776384
1144,101,15,0,5.07,8.18,1776383,1776484
1145,88,15,1,5.82,7.99,1776483,1776571
1146,101,17,1,5.07,5.97,1776571,1776672
1147,96,18,1,5.33,12.03,1776671,1776767
1148,95,15,1,5.39,7.84,1776766,1776861
1149,86,13,1,5.95,7.39,1776860,1776946
1150,94,20,1,5.45,15.27,1776945,1777039
1151,81,20,0,6.32,15.25,1777038,1777119
1152,109,18,0,4.70,7.68,1777118,1777227
1153,144,13,0,3.56,7.27,1777226,1777370
1154,135,14,0,3.79,8.71,1777370,1777505
1155,112,11,1,4.57,6.03,1777505,1777617
1156,118,11,0,4.34,5.78,1777617,1777735
1157,89,19,1,5.75,11.33,1777734,1777823
1158,105,13,1,4.88,6.30,1777823,1777928
1159,92,15,0,5.57,8.85,1777927,1778019
1160,104,12,0,4.92,8.40,1778018,1778122
1161,91,14,0,5.63,9.20,1778121,1778212
1162,108,13,0,4.74,6.17,1778212,1778320
1163,118,11,0,4.34,7.16,1778319,1778437
1164,142,19,0,3.61,9.21,1778437,1778579
1165,121,17,0,4.23,9.50,1778579,1778700
1166,103,14,0,4.97,8.94,1778699,1778802
1167,121,11,0,4.23,5.60,1778801,1778922
1168,101,15,0,5.07,10.52,1778921,1779022
1169,92,22,1,5.57,12.40,1779021,1779113
1170,98,15,0,5.22,8.30,1779113,1779211
1171,92,17,1,5.57,9.31,1779210,1779302
1172,86,19,2,5.95,9.37,1779302,1779388
1173,95,15,0,5.39,9.27,1779387,1779482
1174,97,16,1,5.28,8.76,1779481,1779578
1175,94,23,0,5.45,14.50,1779577,1779671
1176,88,19,0,5.82,12.35,1779670,1779758
1177,148,15,0,3.46,8.69,1779757,1779905
1178,123,16,0,4.16,10.38,1779904,1780027
1179,106,11,1,4.83,6.07,1780026,1780132
1180,98,21,1,5.22,14.70,1780131,1780229
1181,106,11,0,4.83,4.82,1780229,1780335
1182,99,17,1,5.17,7.84,1780334,1780433
1183,86,13,1,5.95,9.53,1780432,1780518
1184,100,16,1,5.12,6.53,1780517,1780617
1185,94,19,1,5.45,10.03,1780616,1780710
1186,97,23,1,5.28,9.69,1780709,1780806
1187,110,13,0,4.65,6.95,1780805,1780915
1188,99,19,0,5.17,9.03,1780914,1781013
1189,100,19,0,5.12,11.61,1781013,1781113
1190,138,16,0,3.71,8.39,1781113,1781251
1191,134,14,0,3.82,6.48,1781250,1781384
1192,104,13,1,4.92,7.47,1781383,1781487
1193,124,13,0,4.13,7.31,1781486,1781610
1194,96,15,1,5.33,6.85,1781609,1781705
1195,102,19,1,5.02,7.98,1781704,1781806
1196,94,18,0,5.45,11.01,1781805,1781899
1197,92,15,1,5.57,8.90,1781898,1781990
1198,104,13,0,4.92,6.97,1781989,1782093
1199,92,15,1,5.57,8.03,1782092,1782184
1200,99,15,0,5.17,9.72,1782183,1782282
1201,97,12,0,5.28,9.31,1782282,1782379
1202,146,13,0,3.51,7.10,1782378,1782524
1203,124,14,0,4.13,8.56,1782523,1782647
1204,100,16,1,5.12,7.71,1782646,1782746
1205,104,21,0,4.92,10.38,1782745,1782849
1206,106,19,1,4.83,10.39,1782848,1782954
1207,91,14,1,5.63,6.32,1782953,1783044
1208,99,14,1,5.17,7.56,1783043,1783142
1209,96,16,1,5.33,8.58,1783141,1783237
1210,89,15,1,5.75,7.11,1783236,1783325
1211,96,23,1,5.33,11.91,1783325,1783421
1212,101,16,0,5.07,7.31,1783420,1783521
1213,101,11,0,5.07,8.72,1783521,1783622
1214,126,16,0,4.06,10.74,1783621,1783747
1215,120,18,0,4.27,12.31,1783746,1783866
1216,100,12,1,5.12,8.05,1783865,1783965
1217,115,13,0,4.45,6.32,1783964,1784079
1218,109,13,1,4.70,7.18,1784078,1784187
1219,91,16,0,5.63,7.95,1784187,1784278
1220,95,18,1,5.39,9.77,1784277,1784372
1221,86,13,0,5.95,8.18,1784372,1784458
1222,94,15,0,5.45,9.14,1784457,1784551
1223,88,20,1,5.82,10.26,1784550,1784638
1224,110,16,1,4.65,6.99,1784637,1784747
1225,91,13,0,5.63,7.33,1784746,1784837
1226,90,25,0,5.69,19.21,1784836,1784926
1227,107,12,0,4.79,5.55,1784925,1785032
1228,143,21,0,3.58,10.33,1785031,1785174
1229,119,15,0,4.30,9.56,1785173,1785292
1230,109,14,0,4.70,7.83,1785291,1785400
1231,104,11,1,4.92,5.97,1785399,1785503
1232,82,27,0,6.24,15.31,1785502,1785584
1233,112,14,0,4.57,5.64,1785584,1785696
1234,90,13,1,5.69,8.24,1785695,1785785
1235,91,17,1,5.63,7.18,1785784,1785875
1236,92,12,0,5.57,7.03,1785874,1785966
1237,96,14,1,5.33,6.97,1785966,1786062
1238,104,15,0,4.92,8.99,1786061,1786165
1239,92,12,0,5.57,7.51,1786165,1786257
1240,99,18,0,5.17,7.72,1786256,1786355
1241,152,14,0,3.37,7.50,1786354,1786506
1242,119,16,0,4.30,13.37,1786505,1786624
1243,116,12,0,4.41,6.02,1786623,1786739
1244,106,20,0,4.83,10.84,1786738,1786844
1245,88,16,1,5.82,10.31,1786844,1786932
1246,99,17,1,5.17,7.19,1786932,1787031
1247,91,18,0,5.63,7.95,1787030,1787121
1248,91,16,1,5.63,9.05,1787120,1787211
1249,89,18,1,5.75,9.35,1787211,1787300
1250,92,22,0,5.57,10.03,1787300,1787392
1251,101,15,0,5.07,8.30,1787391,1787492
1252,97,17,0,5.28,9.27,1787491,1787588
1253,107,14,0,4.79,7.72,1787587,1787694
1254,154,19,0,3.32,8.09,1787693,1787847
1255,123,18,0,4.16,10.95,1787846,1787969
1256,105,12,0,4.88,6.89,1787968,1788073
1257,98,14,1,5.22,8.46,1788072,1788170
1258,101,18,1,5.07,10.34,1788170,1788271
1259,100,20,1,5.12,9.43,1788270,1788370
1260,89,17,2,5.75,8.68,1788370,1788459
1261,86,26,1,5.95,12.56,1788459,1788545
1262,93,17,1,5.51,10.25,1788544,1788637
1263,91,17,0,5.63,9.27,1788637,1788728
1264,106,15,0,4.83,6.48,1788727,1788833
1265,101,16,0,5.07,9.37,1788833,1788934
1266,138,11,0,3.71,7.00,1788933,1789071
1267,112,24,0,4.57,16.28,1789070,1789182
1268,113,9,0,4.53,3.91,1789181,1789294
1269,109,13,1,4.70,7.75,1789293,1789402
1270,88,18,1,5.82,11.90,1789401,1789489
1271,107,12,1,4.79,6.54,1789488,1789595
1272,95,16,0,5.39,8.03,1789594,1789689
1273,91,14,0,5.63,9.09,1789688,1789779
1274,99,12,0,5.17,7.27,1789779,1789878
1275,102,18,1,5.02,8.10,1789877,1789979
1276,95,14,0,5.39,9.44,1789978,1790073
1277,91,16,0,5.63,12.08,1790072,1790163
1278,171,11,0,2.99,5.87,1790162,1790333
1279,133,17,0,3.85,9.62,1790332,1790465
1280,112,11,0,4.57,5.83,1790464,1790576
1281,118,11,0,4.34,5.95,1790575,1790693
1282,98,15,0,5.22,7.48,1790692,1790790
1283,97,20,0,5.28,9.79,1790789,1790886
1284,89,18,1,5.75,7.40,1790885,1790974
1285,102,15,0,5.02,8.06,1790973,1791075
1286,94,22,1,5.45,9.69,1791074,1791168
1287,95,18,0,5.39,13.54,1791168,1791263
1288,106,13,0,4.83,7.31,1791262,1791368
1289,101,15,0,5.07,8.14,1791367,1791468
1290,130,18,0,3.94,10.77,1791467,1791597
1291,123,21,0,4.16,14.45,1791596,1791719
1292,104,14,0,4.92,8.32,1791718,1791822
1293,120,15,0,4.27,8.86,1791821,1791941
1294,94,18,0,5.45,10.12,1791940,1792034
1295,109,14,0,4.70,7.24,1792033,1792142
1296,90,22,1,5.69,9.44,1792141,1792231
1297,91,22,1,5.63,11.86,1792230,1792321
1298,95,17,1,5.39,10.85,1792320,1792415
1299,96,14,0,5.33,8.70,1792414,1792510
1300,107,14,0,4.79,7.53,1792510,1792617
1301,104,21,1,4.92,8.09,1792616,1792720
1302,102,21,0,5.02,11.27,1792719,1792821
1303,154,14,0,3.32,8.19,1792820,1792974
1304,105,13,0,4.88,10.07,1792973,1793078
1305,117,14,0,4.38,6.34,1793077,1793194
1306,112,12,0,4.57,6.71,1793193,1793305
1307,80,18,1,6.40,9.86,1793304,1793384
1308,103,14,1,4.97,7.78,1793383,1793486
1309,91,14,1,5.63,7.99,1793485,1793576
1310,82,23,1,6.24,14.06,1793576,1793658
1311,104,11,0,4.92,5.67,1793657,1793761
1312,110,15,0,4.65,8.30,1793760,1793870
1313,98,16,0,5.22,9.03,1793869,1793967
1314,100,14,0,5.12,11.23,1793966,1794066
1315,137,11,0,3.74,6.60,1794065,1794202
1316,115,17,0,4.45,10.63,1794201,1794316
1317,106,11,1,4.83,6.84,1794316,1794422
1318,114,22,0,4.49,11.16,1794421,1794535
1319,105,21,1,4.88,8.53,1794535,1794640
1320,85,19,1,6.02,11.69,1794640,1794725
1321,90,16,0,5.69,12.04,1794725,1794815
1322,101,14,1,5.07,7.21,1794814,1794915
1323,92,19,1,5.57,11.33,1794914,1795006
1324,92,17,1,5.57,8.40,1795005,1795097
1325,106,19,1,4.83,8.82,1795096,1795202
1326,94,23,0,5.45,11.74,1795201,1795295
1327,104,13,0,4.92,7.96,1795294,1795398
1328,124,15,0,4.13,9.24,1795397,1795521
1329,131,23,0,3.91,14.77,1795521,1795652
1330,102,15,0,5.02,9.49,1795651,1795753
1331,102,22,0,5.02,9.63,1795752,1795854
1332,94,15,1,5.45,8.89,1795853,1795947
1333,86,27,1,5.95,14.11,1795946,1796032
1334,88,15,0,5.82,10.08,1796031,1796119
1335,103,13,0,4.97,7.48,1796118,1796221
1336,111,13,0,4.61,6.94,1796220,1796331
1337,105,14,0,4.88,8.34,1796331,1796436
1338,149,15,0,3.44,9.87,1796435,1796584
1339,132,18,0,3.88,12.56,1796583,1796715
1340,105,24,0,4.88,13.67,1796715,1796820
1341,102,15,0,5.02,8.02,1796819,1796921
1342,140,11,0,3.66,4.10,1796921,1797061
1343,98,20,1,5.22,12.79,1797060,1797158
1344,98,15,1,5.22,9.30,1797157,1797255
1345,87,19,1,5.89,11.32,1797254,1797341
1346,103,17,1,4.97,8.53,1797341,1797444
1347,100,13,1,5.12,6.47,1797443,1797543
1348,102,14,1,5.02,8.27,1797542,1797644
1349,94,17,0,5.45,10.93,1797643,1797737
1350,103,19,0,4.97,14.01,1797736,1797839
1351,133,17,0,3.85,10.01,1797838,1797971
1352,120,18,0,4.27,12.75,1797970,1798090
1353,96,13,0,5.33,7.87,1798089,1798185
1354,118,14,0,4.34,7.04,1798184,1798302
1355,109,16,1,4.70,6.38,1798301,1798410
1356,89,17,1,5.75,10.41,1798409,1798498
1357,101,15,1,5.07,7.53,1798497,1798598
1358,87,20,0,5.89,11.44,1798597,1798684
1359,83,23,1,6.17,16.21,1798683,1798766
1360,96,13,1,5.33,8.87,1798765,1798861
1361,103,16,0,4.97,7.76,1798860,1798963
1362,92,17,0,5.57,9.68,1798962,1799054
1363,95,12,0,5.39,8.87,1799053,1799148
1364,125,22,0,4.10,12.01,1799147,1799272
1365,132,15,0,3.88,9.82,1799271,1799403
1366,99,12,0,5.17,6.63,1799402,1799501
1367,106,15,0,4.83,7.56,1799501,1799607
1368,91,19,0,5.63,10.85,1799606,1799697
1369,98,21,0,5.22,12.13,1799696,1799794
1370,98,16,1,5.22,8.11,1799793,1799891
1371,87,16,1,5.89,9.55,1799891,1799978
1372,98,17,0,5.22,8.58,1799977,1800075
1373,102,15,0,5.02,9.25,1800074,1800176
1374,107,13,1,4.79,7.46,1800175,1800282
1375,108,38,0,4.74,20.38,1800282,1800390
1376,131,22,0,3.91,11.96,1800389,1800520
1377,102,16,0,5.02,8.10,1800519,1800621
1378,107,24,0,4.79,12.77,1800620,1800727
1379,101,16,1,5.07,7.79,1800726,1800827
1380,92,13,1,5.57,7.46,1800826,1800918
1381,94,15,1,5.45,7.80,1800917,1801011
1382,95,22,0,5.39,11.73,1801010,1801105
1383,86,12,1,5.95,6.67,1801104,1801190
1384,96,21,0,5.33,13.99,1801190,1801286
1385,93,17,0,5.51,12.36,1801285,1801378
1386,140,18,0,3.66,8.44,1801378,1801518
1387,113,13,0,4.53,7.95,1801517,1801630
1388,115,15,0,4.45,8.14,1801629,1801744
1389,92,15,1,5.57,8.51,1801743,1801835
1390,94,13,1,5.45,9.14,1801834,1801928
1391,87,17,1,5.89,8.35,1801927,1802014
1392,93,12,0,5.51,7.84,1802014,1802107
1393,94,17,1,5.45,7.57,1802107,1802201
1394,110,16,1,4.65,7.61,1802201,1802311
1395,102,12,0,5.02,8.57,1802311,1802413
1396,145,14,0,3.53,9.01,1802413,1802558
1397,107,17,1,4.79,9.38,1802557,1802664
1398,101,25,0,5.07,14.04,1802664,1802765
1399,85,26,0,6.02,15.81,1802764,1802849
1400,92,20,1,5.57,10.07,1802848,1802940
1401,92,13,1,5.57,6.98,1802940,1803032
1402,90,22,1,5.69,11.97,1803031,1803121
1403,88,20,1,5.82,10.38,1803120,1803208
1404,97,16,0,5.28,8.90,1803208,1803305
1405,97,15,0,5.28,11.71,1803304,1803401
1406,133,14,0,3.85,7.87,1803401,1803534
1407,109,14,0,4.70,7.53,1803534,1803643
1408,108,18,1,4.74,8.41,1803642,1803750
1409,96,18,1,5.33,10.06,1803750,1803846
1410,102,16,1,5.02,7.10,1803846,1803948
1411,94,15,0,5.45,8.08,1803947,1804041
1412,92,14,1,5.57,8.48,1804040,1804132
1413,109,14,1,4.70,8.28,1804131,1804240
1414,103,13,0,4.97,7.02,1804239,1804342
1415,125,13,0,4.10,7.85,1804342,1804467
1416,110,16,0,4.65,11.84,1804467,1804577
1417,89,14,0,5.75,11.74,1804577,1804666
1418,111,17,0,4.61,7.17,1804665,1804776
1419,108,11,0,4.74,6.75,1804775,1804883
1420,77,15,2,6.65,7.45,1804882,1804959
1421,95,19,0,5.39,11.44,1804959,1805054
1422,99,11,1,5.17,5.50,1805053,1805152
1423,104,13,0,4.92,7.61,1805151,1805255
1424,97,16,0,5.28,8.94,1805255,1805352
1425,138,14,0,3.71,8.39,1805352,1805490
1426,109,17,0,4.70,11.51,1805489,1805598
1427,109,17,0,4.70,10.34,1805598,1805707
1428,107,12,0,4.79,6.37,1805706,1805813
1429,97,12,1,5.28,6.72,1805812,1805909
1430,77,22,0,6.65,15.37,1805908,1805985
1431,96,12,1,5.33,7.58,1805985,1806081
1432,88,16,1,5.82,9.65,1806081,1806169
1433,101,12,0,5.07,8.88,1806168,1806269
1434,98,15,0,5.22,7.38,1806269,1806367
1435,147,15,0,3.48,8.63,1806366,1806513
1436,113,18,0,4.53,14.71,1806512,1806625
1437,115,11,0,4.45,6.11,1806625,1806740
1438,112,13,0,4.57,6.74,1806740,1806852
1439,95,14,1,5.39,8.95,1806851,1806946
1440,105,12,1,4.88,6.76,1806945,1807050
1441,95,13,1,5.39,8.26,1807049,1807144
1442,95,14,0,5.39,8.57,1807143,1807238
1443,98,15,0,5.22,7.95,1807237,1807335
1444,101,16,0,5.07,9.63,1807334,1807435
1445,89,16,0,5.75,11.49,1807434,1807523
1446,107,20,0,4.79,12.30,1807523,1807630
1447,136,17,0,3.76,12.19,1807629,1807765
1448,96,16,0,5.33,9.10,1807764,1807860
1449,100,13,0,5.12,7.43,1807859,1807959
1450,112,15,1,4.57,7.49,1807959,1808071
1451,95,13,0,5.39,8.45,1808070,1808165
1452,96,14,0,5.33,7.85,1808164,1808260
1453,92,21,1,5.57,11.20,1808259,1808351
1454,86,21,1,5.95,10.67,1808350,1808436
1455,99,12,1,5.17,6.99,1808435,1808534
1456,88,23,0,5.82,14.26,1808533,1808621
1457,101,20,0,5.07,10.58,1808620,1808721
1458,90,23,0,5.69,13.37,1808720,1808810
1459,159,17,0,3.22,7.18,1808809,1808968
1460,101,39,0,5.07,23.43,1808968,1809069
1461,108,11,1,4.74,6.49,1809068,1809176
1462,117,10,0,4.38,5.16,1809176,1809293
1463,97,21,1,5.28,10.96,1809292,1809389
1464,87,18,1,5.89,8.77,1809388,1809475
1465,89,15,1,5.75,6.37,1809474,1809563
1466,97,11,1,5.28,5.64,1809562,1809659
1467,102,17,1,5.02,7.55,1809658,1809760
1468,97,16,1,5.28,9.87,1809759,1809856
1469,95,20,1,5.39,10.22,1809856,1809951
1470,96,37,0,5.33,20.08,1809950,1810046
1471,141,16,0,3.63,7.51,1810045,1810186
1472,122,15,0,4.20,7.45,1810185,1810307
1473,92,15,0,5.57,8.85,1810306,1810398
1474,112,13,0,4.57,7.89,1810397,1810509
1475,93,19,0,5.51,12.10,1810509,1810602
1476,99,18,0,5.17,11.94,1810601,1810700
1477,86,18,1,5.95,8.86,1810699,1810785
1478,92,12,1,5.57,6.96,1810784,1810876
1479,96,14,0,5.33,8.33,1810875,1810971
1480,96,15,1,5.33,6.95,1810970,1811066
1481,106,13,0,4.83,7.24,1811065,1811171
1482,105,14,0,4.88,8.38,1811170,1811275
1483,135,11,0,3.79,6.36,1811274,1811409
1484,139,11,0,3.68,7.42,1811408,1811547
1485,106,13,0,4.83,7.50,1811546,1811652
1486,104,25,1,4.92,11.61,1811651,1811755
1487,105,14,1,4.88,6.79,1811755,1811860
1488,75,55,1,6.83,42.44,1811860,1811935
1489,107,14,1,4.79,7.14,1811934,1812041
1490,86,13,1,5.95,7.42,1812040,1812126
1491,92,15,0,5.57,9.90,1812125,1812217
1492,79,15,1,6.48,12.22,1812216,1812295
1493,97,54,0,5.28,32.78,1812294,1812391
1494,86,17,1,5.95,9.70,1812390,1812476
1495,94,24,0,5.45,14.25,1812475,1812569
1496,91,14,0,5.63,9.62,1812569,1812660
1497,125,18,0,4.10,12.20,1812660,1812785
1498,130,12,0,3.94,6.97,1812784,1812914
1499,122,12,0,4.20,5.35,1812914,1813036
1500,109,14,0,4.70,5.95,1813035,1813144
1501,94,18,1,5.45,8.67,1813143,1813237
1502,98,17,0,5.22,9.26,1813236,1813334
1503,88,18,1,5.82,10.76,1813333,1813421
1504,86,12,1,5.95,6.79,1813421,1813507
1505,107,11,1,4.79,5.81,1813506,1813613
1506,93,14,1,5.51,7.82,1813613,1813706
1507,103,14,1,4.97,8.77,1813705,1813808
1508,102,12,0,5.02,6.78,1813807,1813909
1509,149,27,0,3.44,10.89,1813908,1814057
1510,116,16,0,4.41,9.91,1814056,1814172
1511,104,13,0,4.92,7.80,1814171,1814275
1512,104,13,0,4.92,7.96,1814274,1814378
1513,96,13,1,5.33,6.12,1814377,1814473
1514,86,16,1,5.95,10.11,1814472,1814558
1515,100,14,0,5.12,8.83,1814557,1814657
1516,90,22,1,5.69,11.01,1814656,1814746
1517,85,20,0,6.02,11.06,1814745,1814830
1518,101,14,0,5.07,7.57,1814829,1814930
1519,97,16,1,5.28,9.93,1814929,1815026
1520,93,12,1,5.51,8.10,1815025,1815118
1521,92,12,0,5.57,9.31,1815117,1815209
1522,127,16,0,4.03,10.16,1815208,1815335
1523,111,15,0,4.61,9.61,1815334,1815445
1524,107,17,1,4.79,9.70,1815444,1815551
1525,113,12,1,4.53,4.99,1815550,1815663
1526,98,18,0,5.22,9.89,1815662,1815760
1527,93,23,1,5.51,12.59,1815759,1815852
1528,101,15,1,5.07,9.00,1815851,1815952
1529,85,15,1,6.02,7.72,1815951,1816036
1530,87,16,1,5.89,11.25,1816035,1816122
1531,106,15,1,4.83,7.88,1816122,1816228
1532,105,14,0,4.88,6.87,1816227,1816332
1533,97,15,0,5.28,7.81,1816331,1816428
1534,101,15,1,5.07,6.84,1816427,1816528
1535,114,24,0,4.49,15.39,1816528,1816642
1536,129,24,0,3.97,12.96,1816642,1816771
1537,99,27,0,5.17,14.53,1816770,1816869
1538,108,19,1,4.74,8.99,1816868,1816976
1539,102,19,0,5.02,9.16,1816975,1817077
1540,100,12,1,5.12,6.57,1817076,1817176
1541,103,17,1,4.97,8.90,1817175,1817278
1542,82,15,2,6.24,9.28,1817278,1817360
1543,106,11,0,4.83,6.84,1817359,1817465
1544,94,13,0,5.45,6.12,1817464,1817558
1545,96,17,1,5.33,6.70,1817557,1817653
1546,82,19,1,6.24,14.57,1817652,1817734
1547,93,16,1,5.51,8.31,1817733,1817826
1548,103,15,0,4.97,7.68,1817825,1817928
1549,153,16,0,3.35,9.47,1817927,1818080
1550,115,13,0,4.45,9.50,1818079,1818194
1551,118,13,0,4.34,6.33,1818193,1818311
1552,103,17,0,4.97,7.58,1818310,1818413
1553,93,18,1,5.51,8.19,1818412,1818505
1554,102,12,1,5.02,5.47,1818504,1818606
1555,80,21,1,6.40,13.37,1818605,1818685
1556,97,12,1,5.28,6.51,1818684,1818781
1557,83,19,1,6.17,10.98,1818780,1818863
1558,98,16,1,5.22,8.58,1818862,1818960
1559,92,23,1,5.57,12.62,1818959,1819051
1560,105,20,0,4.88,12.07,1819050,1819155
1561,85,29,1,6.02,13.51,1819154,1819239
1562,132,24,0,3.88,12.29,1819238,1819370
1563,120,16,0,4.27,10.85,1819370,1819490
1564,114,11,0,4.49,6.00,1819489,1819603
1565,94,24,1,5.45,14.80,1819603,1819697
1566,109,14,0,4.70,7.79,1819696,1819805
1567,90,17,1,5.69,13.13,1819805,1819895
1568,93,12,1,5.51,9.15,1819894,1819987
1569,92,12,0,5.57,7.25,1819986,1820078
1570,91,18,1,5.63,10.06,1820078,1820169
1571,83,15,1,6.17,8.36,1820168,1820251
1572,107,16,0,4.79,9.51,1820250,1820357
1573,94,13,0,5.45,7.74,1820356,1820450
1574,95,18,0,5.39,11.00,1820449,1820544
1575,81,19,0,6.32,13.67,1820543,1820624
1576,130,13,0,3.94,7.80,1820624,1820754
1577,100,27,0,5.12,15.55,1820753,1820853
1578,110,13,0,4.65,7.79,1820852,1820962
1579,103,16,1,4.97,9.43,1820961,1821064
1580,99,25,1,5.17,9.48,1821063,1821162
1581,95,14,1,5.39,10.34,1821161,1821256
1582,98,16,1,5.22,7.52,1821255,1821353
1583,81,16,1,6.32,10.05,1821352,1821433
1584,90,20,0,5.69,10.06,1821432,1821522
1585,89,11,1,5.75,6.70,1821521,1821610
1586,99,14,1,5.17,7.52,1821609,1821708
1587,103,16,0,4.97,7.58,1821707,1821810
1588,102,11,1,5.02,6.88,1821809,1821911
1589,114,15,0,4.49,8.76,1821910,1822024
1590,131,17,0,3.91,9.47,1822023,1822154
1591,126,15,0,4.06,8.41,1822153,1822279
1592,94,12,0,5.45,7.63,1822279,1822373
1593,112,17,0,4.57,8.78,1822372,1822484
1594,103,17,1,4.97,7.54,1822483,1822586
1595,83,22,1,6.17,15.54,1822585,1822668
1596,108,11,1,4.74,5.30,1822667,1822775
1597,85,16,0,6.02,9.53,1822775,1822860
1598,96,17,1,5.33,10.01,1822859,1822955
1599,104,22,0,4.92,10.90,1822954,1823058
1600,98,16,0,5.22,9.09,1823057,1823155
1601,84,17,1,6.10,8.21,1823154,1823238
1602,96,15,1,5.33,7.56,1823237,1823333
1603,100,12,0,5.12,7.99,1823332,1823432
1604,141,14,0,3.63,9.01,1823431,1823572
1605,93,19,1,5.51,13.24,1823572,1823665
1606,97,12,1,5.28,8.35,1823664,1823761
1607,114,34,0,4.49,16.07,1823760,1823874
1608,91,20,0,5.63,9.99,1823873,1823964
1609,89,12,1,5.75,8.14,1823963,1824052
1610,104,13,0,4.92,7.76,1824051,1824155
1611,86,22,2,5.95,13.28,1824154,1824240
1612,97,12,1,5.28,6.74,1824240,1824337
1613,98,11,1,5.22,6.44,1824336,1824434
1614,80,24,1,6.40,13.84,1824433,1824513
1615,97,16,0,5.28,9.09,1824513,1824610
1616,107,20,0,4.79,8.39,1824609,1824716
1617,117,12,0,4.38,8.03,1824715,1824832
1618,135,14,0,3.79,8.67,1824831,1824966
1619,90,25,0,5.69,16.13,1824965,1825055
1620,100,11,0,5.12,7.97,1825054,1825154
1621,96,30,1,5.33,17.03,1825153,1825249
1622,92,21,1,5.57,10.53,1825248,1825340
1623,103,13,1,4.97,7.19,1825340,1825443
1624,104,25,0,4.92,12.59,1825442,1825546
1625,92,14,1,5.57,9.09,1825546,1825638
1626,90,14,0,5.69,8.73,1825637,1825727
1627,80,48,2,6.40,29.29,1825726,1825806
1628,93,15,1,5.51,8.96,1825806,1825899
1629,114,12,0,4.49,5.64,1825898,1826012
1630,101,45,0,5.07,21.69,1826011,1826112
1631,98,18,0,5.22,13.46,1826111,1826209
1632,166,22,0,3.08,9.26,1826208,1826374
1633,102,23,0,5.02,13.43,1826373,1826475
1634,103,14,0,4.97,7.89,1826475,1826578
1635,109,32,1,4.70,17.20,1826577,1826686
1636,105,17,0,4.88,8.11,1826685,1826790
1637,108,11,1,4.74,7.32,1826789,1826897
1638,101,18,1,5.07,8.74,1826896,1826997
1639,96,15,1,5.33,6.28,1826996,1827092
1640,94,13,1,5.45,7.55,1827091,1827185
1641,98,16,1,5.22,8.40,1827184,1827282
1642,107,22,0,4.79,9.53,1827281,1827388
1643,91,20,0,5.63,14.06,1827387,1827478
1644,101,22,0,5.07,11.00,1827477,1827578
1645,113,15,0,4.53,11.74,1827577,1827690
1646,121,65,0,4.23,41.35,1827689,1827810
1647,88,17,0,5.82,8.85,1827810,1827898
1648,124,13,0,4.13,5.92,1827897,1828021
1649,112,18,1,4.57,8.46,1828021,1828133
1650,90,15,0,5.69,10.70,1828132,1828222
1651,104,27,0,4.92,13.34,1828221,1828325
1652,89,17,0,5.75,10.12,1828324,1828413
1653,80,19,2,6.40,9.01,1828413,1828493
1654,91,15,1,5.63,8.54,1828492,1828583
1655,95,12,0,5.39,7.46,1828582,1828677
1656,102,13,0,5.02,8.47,1828676,1828778
1657,100,17,0,5.12,10.59,1828777,1828877
1658,107,15,0,4.79,8.64,1828876,1828983
1659,100,16,0,5.12,10.23,1828982,1829082
1660,146,15,0,3.51,7.93,1829081,1829227
1661,101,20,1,5.07,12.66,1829227,1829328
1662,108,15,0,4.74,8.32,1829327,1829435
1663,101,20,1,5.07,10.60,1829434,1829535
1664,90,18,0,5.69,9.99,1829534,1829624
1665,86,23,0,5.95,16.56,1829624,1829710
1666,99,14,1,5.17,7.19,1829709,1829808
1667,87,18,2,5.89,8.93,1829807,1829894
1668,89,13,1,5.75,8.37,1829893,1829982
1669,95,17,1,5.39,9.69,1829981,1830076
1670,99,15,0,5.17,9.92,1830075,1830174
1671,100,17,0,5.12,10.47,1830173,1830273
1672,97,13,0,5.28,8.72,1830272,1830369
1673,105,20,0,4.88,13.77,1830368,1830473
1674,122,16,0,4.20,10.19,1830473,1830595
1675,112,15,0,4.57,12.41,1830594,1830706
1676,103,14,0,4.97,7.62,1830705,1830808
1677,114,14,0,4.49,8.72,1830808,1830922
1678,106,16,0,4.83,8.33,1830921,1831027
1679,95,13,0,5.39,9.14,1831027,1831122
1680,107,12,1,4.79,7.29,1831121,1831228
1681,89,17,0,5.75,10.32,1831227,1831316
1682,91,24,0,5.63,14.19,1831315,1831406
1683,85,18,0,6.02,9.51,1831405,1831490
1684,88,18,1,5.82,10.49,1831489,1831577
1685,95,21,1,5.39,9.33,1831576,1831671
1686,100,16,0,5.12,8.87,1831670,1831770
1687,103,16,1,4.97,7.87,1831769,1831872
1688,123,15,0,4.16,10.25,1831871,1831994
1689,127,13,0,4.03,9.09,1831994,1832121
1690,100,15,0,5.12,9.87,1832120,1832220
1691,126,13,0,4.06,6.57,1832219,1832345
1692,105,14,0,4.88,7.18,1832345,1832450
1693,94,15,1,5.45,8.72,1832449,1832543
1694,103,19,1,4.97,11.23,1832542,1832645
1695,86,13,1,5.95,7.28,1832644,1832730
1696,93,20,1,5.51,8.81,1832729,1832822
1697,90,13,1,5.69,6.68,1832821,1832911
1698,95,28,1,5.39,13.59,1832910,1833005
1699,105,14,0,4.88,9.40,1833004,1833109
1700,92,20,0,5.57,10.48,1833108,1833200
1701,102,12,0,5.02,7.94,1833200,1833302
1702,112,13,0,4.57,8.96,1833301,1833413
1703,110,24,0,4.65,19.32,1833412,1833522
1704,98,14,1,5.22,9.50,1833521,1833619
1705,107,11,1,4.79,5.78,1833618,1833725
1706,108,14,0,4.74,7.71,1833724,1833832
1707,86,21,1,5.95,12.02,1833832,1833918
1708,94,17,0,5.45,9.65,1833917,1834011
1709,85,17,1,6.02,7.18,1834010,1834095
1710,90,12,1,5.69,6.79,1834095,1834185
1711,95,21,1,5.39,10.22,1834185,1834280
1712,114,13,0,4.49,7.50,1834280,1834394
1713,91,21,1,5.63,13.75,1834393,1834484
1714,101,13,0,5.07,7.17,1834483,1834584
1715,125,14,0,4.10,8.79,1834583,1834708
1716,108,15,0,4.74,11.16,1834707,1834815
1717,90,14,0,5.69,11.61,1834814,1834904
1718,121,11,0,4.23,6.64,1834903,1835024
1719,108,19,0,4.74,11.56,1835023,1835131
1720,110,14,0,4.65,6.37,1835131,1835241
1721,89,19,1,5.75,13.80,1835240,1835329
1722,99,15,1,5.17,6.49,1835328,1835427
1723,94,14,1,5.45,8.82,1835426,1835520
1724,94,18,1,5.45,8.48,1835519,1835613
1725,87,16,1,5.89,10.08,1835612,1835699
1726,105,14,0,4.88,6.78,1835698,1835803
1727,107,15,0,4.79,7.44,1835802,1835909
1728,105,16,0,4.88,9.88,1835908,1836013
1729,89,16,0,5.75,10.46,1836012,1836101
1730,119,17,0,4.30,13.67,1836100,1836219
1731,109,18,0,4.70,13.55,1836218,1836327
1732,107,12,0,4.79,6.79,1836327,1836434
1733,116,15,0,4.41,8.73,1836434,1836550
1734,104,14,0,4.92,8.17,1836550,1836654
1735,94,15,1,5.45,9.25,1836653,1836747
1736,87,15,1,5.89,10.93,1836746,1836833
1737,112,13,1,4.57,6.35,1836832,1836944
1738,88,14,1,5.82,8.19,1836943,1837031
1739,90,22,0,5.69,12.10,1837030,1837120
1740,80,15,0,6.40,11.54,1837119,1837199
1741,93,19,1,5.51,9.82,1837199,1837292
1742,89,17,1,5.75,9.17,1837291,1837380
1743,92,20,0,5.57,13.72,1837379,1837471
1744,109,13,0,4.70,9.72,1837471,1837580
1745,93,15,1,5.51,8.47,1837579,1837672
1746,133,14,0,3.85,8.65,1837671,1837804
1747,99,17,0,5.17,9.92,1837803,1837902
1748,95,18,0,5.39,12.01,1837901,1837996
1749,102,16,0,5.02,8.61,1837995,1838097
1750,93,14,1,5.51,8.25,1838096,1838189
1751,108,16,1,4.74,7.60,1838188,1838296
1752,87,23,1,5.89,13.83,1838295,1838382
1753,91,11,2,5.63,6.52,1838381,1838472
1754,100,15,0,5.12,8.67,1838471,1838571
1755,99,14,1,5.17,7.78,1838570,1838669
1756,106,17,0,4.83,9.97,1838669,1838775
1757,89,18,0,5.75,11.26,1838774,1838863
1758,103,15,1,4.97,9.15,1838863,1838966
1759,98,13,1,5.22,8.13,1838965,1839063
1760,124,17,0,4.13,12.84,1839062,1839186
1761,111,14,0,4.61,9.01,1839185,1839296
1762,96,17,1,5.33,10.26,1839295,1839391
1763,100,21,0,5.12,11.33,1839390,1839490
1764,93,18,1,5.51,9.33,1839489,1839582
1765,91,20,0,5.63,12.15,1839581,1839672
1766,97,15,1,5.28,7.58,1839671,1839768
1767,87,24,1,5.89,11.69,1839767,1839854
1768,91,14,1,5.63,8.98,1839853,1839944
1769,102,13,0,5.02,8.02,1839943,1840045
1770,87,20,1,5.89,14.08,1840044,1840131
1771,100,16,0,5.12,8.35,1840130,1840230
1772,91,18,1,5.63,10.45,1840229,1840320
1773,95,25,0,5.39,12.36,1840319,1840414
1774,127,14,0,4.03,7.43,1840413,1840540
1775,124,23,0,4.13,11.76,1840539,1840663
1776,103,15,1,4.97,8.16,1840662,1840765
1777,131,15,0,3.91,6.07,1840764,1840895
1778,100,16,0,5.12,9.29,1840894,1840994
1779,97,16,1,5.28,9.29,1840993,1841090
1780,88,21,1,5.82,12.31,1841089,1841177
1781,93,19,0,5.51,8.03,1841176,1841269
1782,94,15,0,5.45,9.61,1841268,1841362
1783,97,14,1,5.28,8.24,1841361,1841458
1784,96,20,1,5.33,10.76,1841457,1841553
1785,92,26,1,5.57,12.62,1841552,1841644
1786,95,39,1,5.39,20.20,1841643,1841738
1787,106,12,0,4.83,10.67,1841738,1841844
1788,119,17,0,4.30,9.14,1841843,1841962
1789,102,17,0,5.02,11.84,1841961,1842063
1790,121,13,0,4.23,6.19,1842062,1842183
1791,117,14,0,4.38,7.55,1842182,1842299
1792,92,14,1,5.57,9.48,1842298,1842390
1793,80,26,1,6.40,15.49,1842389,1842469
1794,112,20,0,4.57,7.98,1842468,1842580
1795,100,14,1,5.12,8.61,1842580,1842680
1796,98,15,0,5.22,6.81,1842679,1842777
1797,95,15,0,5.39,8.17,1842777,1842872
1798,84,14,0,6.10,10.49,1842871,1842955
1799,97,15,0,5.28,10.08,1842954,1843051
1800,104,13,0,4.92,8.19,1843050,1843154
1801,128,14,0,4.00,9.52,1843153,1843281
1802,119,16,0,4.30,10.75,1843281,1843400
1803,104,17,0,4.92,8.55,1843399,1843503
1804,104,15,0,4.92,8.72,1843502,1843606
1805,119,14,0,4.30,6.92,1843606,1843725
1806,85,34,1,6.02,19.72,1843724,1843809
1807,102,13,1,5.02,6.31,1843808,1843910
1808,92,15,1,5.57,8.68,1843909,1844001
1809,94,14,1,5.45,6.12,1844000,1844094
1810,85,25,1,6.02,13.51,1844094,1844179
1811,103,15,1,4.97,6.28,1844178,1844281
1812,101,14,0,5.07,8.84,1844280,1844381
1813,86,15,0,5.95,11.88,1844380,1844466
1814,117,25,0,4.38,11.53,1844465,1844582
1815,93,24,1,5.51,15.22,1844581,1844674
1816,137,14,0,3.74,7.87,1844673,1844810
1817,109,12,0,4.70,9.72,1844809,1844918
1818,114,20,1,4.49,7.25,1844917,1845031
1819,120,11,1,4.27,4.50,1845030,1845150
1820,95,18,1,5.39,12.05,1845149,1845244
1821,85,22,1,6.02,14.59,1845243,1845328
1822,101,13,1,5.07,7.37,1845327,1845428
1823,88,21,1,5.82,11.29,1845427,1845515
1824,92,13,0,5.57,8.27,1845514,1845606
1825,78,22,1,6.56,16.22,1845605,1845683
1826,86,12,1,5.95,7.35,1845683,1845769
1827,105,16,0,4.88,10.47,1845769,1845874
1828,86,16,2,5.95,9.60,1845873,1845959
1829,102,13,1,5.02,7.20,1845958,1846060
1830,93,19,0,5.51,13.37,1846059,1846152
1831,119,17,0,4.30,8.75,1846152,1846271
1832,107,16,0,4.79,9.46,1846270,1846377
1833,116,11,0,4.41,5.73,1846377,1846493
1834,106,15,1,4.83,8.33,1846492,1846598
1835,89,25,0,5.75,15.44,1846598,1846687
1836,113,12,0,4.53,5.81,1846686,1846799
1837,89,14,1,5.75,7.40,1846798,1846887
1838,97,15,1,5.28,7.60,1846886,1846983
1839,91,17,1,5.63,8.01,1846982,1847073
1840,102,14,1,5.02,8.33,1847072,1847174
1841,95,36,0,5.39,18.64,1847173,1847268
1842,85,18,1,6.02,10.14,1847268,1847353
1843,135,24,0,3.79,10.65,1847353,1847488
1844,106,17,0,4.83,13.86,1847487,1847593
1845,108,20,0,4.74,10.36,1847592,1847700
1846,104,16,1,4.92,6.57,1847699,1847803
1847,92,21,0,5.57,12.62,1847802,1847894
1848,104,22,0,4.92,11.11,1847894,1847998
1849,85,15,1,6.02,8.87,1847997,1848082
1850,94,16,1,5.45,8.33,1848081,1848175
1851,109,13,0,4.70,6.83,1848175,1848284
1852,91,12,0,5.63,9.73,1848283,1848374
1853,87,19,0,5.89,12.86,1848373,1848460
1854,115,17,0,4.45,12.42,1848459,1848574
1855,121,25,0,4.23,15.90,1848574,1848695
1856,98,15,0,5.22,9.66,1848694,1848792
1857,116,16,0,4.41,6.60,1848792,1848908
1858,113,15,1,4.53,8.69,1848907,1849020
1859,99,13,0,5.17,8.14,1849019,1849118
1860,76,20,1,6.74,12.90,1849117,1849193
1861,97,17,0,5.28,9.19,1849192,1849289
1862,112,13,0,4.57,6.80,1849288,1849400
1863,103,14,1,4.97,9.04,1849400,1849503
1864,92,20,0,5.57,14.33,1849502,1849594
1865,115,19,0,4.45,14.77,1849593,1849708
1866,98,12,0,5.22,7.26,1849707,1849805
1867,120,19,0,4.27,6.70,1849805,1849925
1868,95,14,1,5.39,8.45,1849925,1850020
1869,102,13,1,5.02,7.61,1850019,1850121
1870,87,18,1,5.89,7.07,1850120,1850207
1871,89,14,1,5.75,9.17,1850206,1850295
1872,97,20,0,5.28,9.58,1850294,1850391
1873,105,16,0,4.88,10.07,1850390,1850495
1874,107,23,0,4.79,13.81,1850494,1850601
1875,111,19,0,4.61,14.63,1850601,1850712
1876,106,14,1,4.83,7.71,1850711,1850817
1877,115,14,0,4.45,9.19,1850816,1850931
1878,101,13,0,5.07,7.97,1850930,1851031
1879,91,19,1,5.63,11.18,1851031,1851122
1880,95,14,1,5.39,6.30,1851122,1851217
1881,96,14,1,5.33,8.16,1851216,1851312
1882,87,17,0,5.89,15.25,1851311,1851398
1883,91,16,0,5.63,9.00,1851397,1851488
1884,115,24,0,4.45,16.21,1851487,1851602
1885,112,16,0,4.57,10.58,1851601,1851713
1886,123,11,0,4.16,5.99,1851712,1851835
1887,98,15,0,5.22,9.48,1851834,1851932
1888,95,14,1,5.39,7.82,1851931,1852026
1889,93,22,0,5.51,13.05,1852025,1852118
1890,77,24,1,6.65,14.93,1852118,1852195
1891,86,50,1,5.95,30.72,1852195,1852281
1892,101,14,0,5.07,8.60,1852280,1852381
1893,98,17,1,5.22,10.66,1852380,1852478
1894,123,14,0,4.16,6.97,1852477,1852600
1895,104,14,0,4.92,11.36,1852599,1852703
1896,112,11,0,4.57,5.41,1852702,1852814
1897,103,11,0,4.97,6.49,1852813,1852916
1898,88,18,1,5.82,12.99,1852915,1853003
1899,95,16,0,5.39,9.23,1853002,1853097
1900,96,12,1,5.33,6.91,1853096,1853192
1901,88,12,0,5.82,8.94,1853191,1853279
1902,98,24,1,5.22,11.05,1853278,1853376
1903,84,34,1,6.10,31.18,1853375,1853459
1904,122,12,0,4.20,7.45,1853458,1853580
1905,115,17,0,4.45,10.39,1853579,1853694
1906,107,16,1,4.79,7.53,1853693,1853800
1907,108,12,0,4.74,6.54,1853799,1853907
1908,88,21,0,5.82,11.92,1853906,1853994
1909,103,14,1,4.97,7.33,1853993,1854096
1910,95,12,0,5.39,7.56,1854095,1854190
1911,93,15,1,5.51,8.83,1854190,1854283
1912,110,20,0,4.65,8.39,1854282,1854392
1913,88,23,1,5.82,13.81,1854391,1854479
1914,109,16,0,4.70,11.44,1854479,1854588
1915,134,17,0,3.82,9.37,1854588,1854722
1916,118,11,0,4.34,6.66,1854721,1854839
1917,87,17,0,5.89,12.95,1854838,1854925
1918,100,17,1,5.12,9.23,1854925,1855025
1919,88,17,0,5.82,9.90,1855024,1855112
1920,84,15,0,6.10,7.18,1855112,1855196
1921,92,25,1,5.57,11.29,1855196,1855288
1922,97,15,0,5.28,8.49,1855287,1855384
1923,97,16,0,5.28,8.80,1855383,1855480
1924,117,21,0,4.38,12.63,1855479,1855596
1925,119,21,0,4.30,10.01,1855595,1855714
1926,124,27,1,4.13,8.58,1855714,1855838
1927,98,14,1,5.22,5.46,1855838,1855936
1928,103,15,1,4.97,8.24,1855935,1856038
1929,98,13,1,5.22,5.99,1856037,1856135
1930,102,19,0,5.02,8.41,1856135,1856237
1931,103,16,1,4.97,7.06,1856236,1856339
1932,100,16,1,5.12,10.59,1856338,1856438
1933,95,15,0,5.39,9.48,1856437,1856532
1934,102,18,0,5.02,10.49,1856531,1856633
1935,159,22,0,3.22,8.59,1856633,1856792
1936,106,14,1,4.83,7.46,1856791,1856897
1937,121,15,1,4.23,6.62,1856896,1857017
1938,100,16,0,5.12,9.41,1857016,1857116
1939,105,16,0,4.88,8.81,1857115,1857220
1940,86,18,0,5.95,10.32,1857220,1857306
1941,88,13,1,5.82,9.04,1857305,1857393
1942,103,12,1,4.97,6.36,1857393,1857496
1943,103,15,0,4.97,7.83,1857495,1857598
1944,96,25,0,5.33,15.12,1857598,1857694
1945,102,15,1,5.02,8.49,1857693,1857795
1946,146,19,0,3.51,11.07,1857795,1857941
1947,100,25,0,5.12,15.63,1857940,1858040
1948,114,20,0,4.49,10.57,1858039,1858153
1949,126,13,0,4.06,6.96,1858153,1858279
1950,93,17,1,5.51,8.38,1858278,1858371
1951,96,19,1,5.33,9.49,1858370,1858466
1952,100,12,1,5.12,6.37,1858465,1858565
1953,88,19,1,5.82,9.79,1858564,1858652
1954,91,22,1,5.63,10.37,1858651,1858742
1955,94,21,0,5.45,16.01,1858741,1858835
1956,99,15,0,5.17,11.41,1858834,1858933
1957,99,18,0,5.17,11.56,1858932,1859031
1958,133,14,0,3.85,8.07,1859030,1859163
1959,121,14,0,4.23,10.01,1859162,1859283
1960,117,12,0,4.38,6.78,1859282,1859399
1961,119,14,0,4.30,6.83,1859398,1859517
1962,92,13,0,5.57,7.25,1859516,1859608
1963,92,27,0,5.57,16.51,1859607,1859699
1964,107,14,1,4.79,7.12,1859698,1859805
1965,90,19,0,5.69,10.21,1859804,1859894
1966,88,15,1,5.82,7.51,1859893,1859981
1967,104,11,1,4.92,4.36,1859980,1860084
1968,98,16,0,5.22,9.70,1860083,1860181
1969,83,13,1,6.17,11.25,1860181,1860264
1970,91,19,0,5.63,13.05,1860264,1860355
1971,130,16,0,3.94,8.75,1860354,1860484
1972,115,19,0,4.45,13.08,1860483,1860598
1973,117,18,0,4.38,8.08,1860597,1860714
1974,107,11,0,4.79,6.39,1860713,1860820
1975,90,12,1,5.69,7.19,1860819,1860909
1976,98,14,0,5.22,10.58,1860908,1861006
1977,87,14,1,5.89,9.87,1861005,1861092
1978,88,18,2,5.82,7.56,1861091,1861179
1979,118,17,0,4.34,7.31,1861178,1861296
1980,91,22,0,5.63,12.63,1861295,1861386
1981,102,18,0,5.02,12.14,1861386,1861488
1982,94,21,0,5.45,13.55,1861487,1861581
1983,149,19,0,3.44,9.27,1861580,1861729
1984,100,18,0,5.12,12.89,1861729,1861829
1985,130,11,0,3.94,5.69,1861828,1861958
1986,96,42,0,5.33,21.26,1861957,1862053
1987,87,35,1,5.89,20.49,1862052,1862139
1988,101,16,0,5.07,8.32,1862138,1862239
1989,92,12,2,5.57,5.48,1862238,1862330
1990,79,15,0,6.48,10.25,1862329,1862408
1991,116,11,0,4.41,5.16,1862408,1862524
1992,102,13,0,5.02,8.96,1862523,1862625
1993,97,33,0,5.28,15.13,1862624,1862721
1994,114,16,0,4.49,9.83,1862720,1862834
1995,114,13,0,4.49,8.95,1862834,1862948
1996,106,12,0,4.83,9.80,1862947,1863053
1997,114,13,0,4.49,7.23,1863053,1863167
1998,104,13,1,4.92,6.82,1863166,1863270
1999,93,23,1,5.51,10.85,1863269,1863362
2000,81,17,0,6.32,10.42,1863361,1863442
2001,97,22,1,5.28,10.02,1863441,1863538
2002,85,12,2,6.02,7.22,1863537,1863622
2003,91,15,1,5.63,9.62,1863621,1863712
2004,90,22,1,5.69,10.41,1863711,1863801
2005,107,13,0,4.79,6.86,1863800,1863907
2006,96,21,0,5.33,9.10,1863906,1864002
2007,90,16,0,5.69,10.81,1864002,1864092
2008,115,26,0,4.45,10.16,1864091,1864206
2009,101,23,0,5.07,15.07,1864205,1864306
2010,127,13,0,4.03,6.66,1864305,1864432
2011,95,22,0,5.39,10.30,1864431,1864526
2012,82,16,0,6.24,10.67,1864525,1864607
2013,96,15,1,5.33,9.43,1864606,1864702
2014,90,12,1,5.69,7.86,1864701,1864791
2015,84,15,2,6.10,11.68,1864790,1864874
2016,91,28,1,5.63,17.90,1864873,1864964
2017,104,19,0,4.92,11.28,1864963,1865067
2018,87,15,0,5.89,8.63,1865066,1865153
2019,92,21,0,5.57,11.75,1865152,1865244
2020,121,19,0,4.23,11.17,1865244,1865365
2021,124,19,0,4.13,11.89,1865365,1865489
2022,119,11,0,4.30,6.68,1865488,1865607
2023,96,12,0,5.33,6.78,1865606,1865702
2024,103,11,1,4.97,6.09,1865701,1865804
2025,105,15,1,4.88,8.78,1865803,1865908
2026,87,14,1,5.89,9.48,1865908,1865995
2027,87,15,0,5.89,8.49,1865994,1866081
2028,96,15,1,5.33,8.95,1866080,1866176
2029,93,12,1,5.51,8.57,1866175,1866268
2030,96,15,0,5.33,9.93,1866267,1866363
2031,112,14,0,4.57,10.49,1866362,1866474
2032,100,27,0,5.12,18.95,1866473,1866573
2033,102,19,0,5.02,9.39,1866572,1866674
2034,117,13,0,4.38,6.05,1866674,1866791
2035,88,14,1,5.82,9.10,1866790,1866878
2036,91,14,0,5.63,8.45,1866877,1866968
2037,93,17,0,5.51,9.69,1866967,1867060
2038,89,30,1,5.75,13.78,1867059,1867148
2039,92,23,1,5.57,11.92,1867148,1867240
2040,104,17,0,4.92,9.46,1867239,1867343
2041,92,18,1,5.57,9.72,1867342,1867434
2042,103,13,0,4.97,10.05,1867434,1867537
2043,121,13,0,4.23,7.42,1867536,1867657
2044,109,18,0,4.70,11.07,1867656,1867765
2045,110,12,0,4.65,6.74,1867764,1867874
2046,97,22,1,5.28,9.73,1867873,1867970
2047,95,18,1,5.39,10.49,1867969,1868064
2048,101,13,0,5.07,6.80,1868063,1868164
2049,97,15,1,5.28,5.93,1868163,1868260
2050,94,11,0,5.45,8.01,1868259,1868353
2051,93,16,1,5.51,10.08,1868353,1868446
2052,96,16,0,5.33,12.39,1868445,1868541
2053,106,16,0,4.83,10.16,1868541,1868647
2054,103,70,0,4.97,49.58,1868646,1868749
2055,115,17,0,4.45,13.15,1868748,1868863
2056,96,25,1,5.33,14.85,1868862,1868958
2057,109,13,0,4.70,9.09,1868957,1869066
2058,109,13,0,4.70,7.17,1869066,1869175
2059,109,18,0,4.70,7.50,1869174,1869283
2060,103,13,0,4.97,6.90,1869282,1869385
2061,78,24,1,6.56,13.50,1869384,1869462
2062,102,16,0,5.02,6.51,1869461,1869563
2063,101,13,0,5.07,7.23,1869562,1869663
2064,77,15,1,6.65,9.76,1869662,1869739
2065,108,19,1,4.74,7.17,1869738,1869846
2066,102,16,1,5.02,12.51,1869845,1869947
2067,86,15,0,5.95,11.00,1869946,1870032
2068,125,15,0,4.10,8.39,1870032,1870157
2069,115,17,0,4.45,10.87,1870156,1870271
2070,96,11,1,5.33,7.85,1870270,1870366
2071,130,11,0,3.94,5.26,1870365,1870495
2072,118,14,0,4.34,6.48,1870494,1870612
2073,91,16,1,5.63,9.66,1870612,1870703
2074,97,17,1,5.28,9.64,1870702,1870799
2075,84,16,1,6.10,9.90,1870798,1870882
2076,94,18,1,5.45,10.33,1870881,1870975
2077,88,15,1,5.82,8.33,1870974,1871062
2078,92,32,1,5.57,17.66,1871061,1871153
2079,99,15,1,5.17,7.05,1871152,1871251
2080,110,12,0,4.65,6.14,1871250,1871360
2081,85,20,1,6.02,15.03,1871359,1871444
2082,95,24,0,5.39,12.95,1871443,1871538
2083,114,17,0,4.49,11.95,1871537,1871651
2084,117,15,0,4.38,9.26,1871650,1871767
2085,111,15,0,4.61,10.53,1871767,1871878
2086,108,17,0,4.74,8.73,1871877,1871985
2087,100,15,1,5.12,7.75,1871984,1872084
2088,95,14,1,5.39,8.68,1872083,1872178
2089,86,15,0,5.95,7.81,1872178,1872264
2090,88,21,1,5.82,9.76,1872263,1872351
2091,83,17,1,6.17,11.44,1872350,1872433
2092,91,15,1,5.63,8.67,1872432,1872523
2093,106,15,1,4.83,6.78,1872522,1872628
2094,94,17,1,5.45,8.65,1872627,1872721
2095,83,26,1,6.17,16.81,1872720,1872803
2096,119,13,0,4.30,9.10,1872802,1872921
2097,135,15,0,3.79,7.63,1872920,1873055
2098,113,15,1,4.53,7.66,1873055,1873168
2099,93,14,1,5.51,8.08,1873167,1873260
2100,108,13,1,4.74,6.99,1873259,1873367
2101,90,16,1,5.69,8.64,1873366,1873456
2102,86,16,1,5.95,13.46,1873455,1873541
2103,107,12,0,4.79,6.79,1873540,1873647
2104,101,13,1,5.07,8.01,1873646,1873747
2105,92,15,0,5.57,11.94,1873746,1873838
2106,86,15,0,5.95,9.97,1873837,1873923
2107,126,18,0,4.06,10.36,1873922,1874048
2108,117,12,0,4.38,6.76,1874047,1874164
2109,124,10,1,4.13,4.34,1874163,1874287
2110,100,11,1,5.12,7.11,1874286,1874386
2111,96,18,1,5.33,11.33,1874385,1874481
2112,97,21,1,5.28,9.40,1874480,1874577
2113,89,16,1,5.75,11.08,1874576,1874665
2114,88,23,1,5.82,12.83,1874664,1874752
2115,100,15,0,5.12,9.21,1874752,1874852
2116,104,14,1,4.92,7.24,1874851,1874955
2117,82,17,1,6.24,11.67,1874954,1875036
2118,100,20,1,5.12,11.37,1875035,1875135
2119,119,12,0,4.30,8.56,1875134,1875253
2120,136,18,0,3.76,9.06,1875252,1875388
2121,114,14,0,4.49,6.20,1875387,1875501
2122,109,14,0,4.70,7.72,1875500,1875609
2123,93,15,1,5.51,8.34,1875609,1875702
2124,94,19,1,5.45,8.78,1875701,1875795
2125,90,15,0,5.69,8.39,1875794,1875884
2126,84,23,2,6.10,12.51,1875883,1875967
2127,91,17,1,5.63,8.08,1875966,1876057
2128,91,19,1,5.63,13.11,1876057,1876148
2129,102,20,0,5.02,10.18,1876148,1876250
2130,122,13,0,4.20,9.96,1876249,1876371
2131,119,24,0,4.30,11.30,1876371,1876490
2132,110,24,0,4.65,12.23,1876489,1876599
2133,116,16,0,4.41,7.02,1876598,1876714
2134,103,13,1,4.97,7.23,1876713,1876816
2135,98,34,1,5.22,18.13,1876815,1876913
2136,95,17,1,5.39,8.49,1876912,1877007
2137,81,16,1,6.32,9.70,1877006,1877087
2138,95,16,1,5.39,6.64,1877086,1877181
2139,113,13,1,4.53,6.59,1877180,1877293
2140,94,17,1,5.45,10.69,1877292,1877386
2141,95,17,0,5.39,10.93,1877385,1877480
2142,96,22,1,5.33,11.47,1877480,1877576
2143,154,19,0,3.32,8.02,1877575,1877729
2144,99,18,0,5.17,9.84,1877728,1877827
2145,115,14,0,4.45,8.00,1877826,1877941
2146,88,16,0,5.82,11.15,1877940,1878028
2147,105,13,1,4.88,6.41,1878027,1878132
2148,92,14,1,5.57,8.57,1878131,1878223
2149,79,18,2,6.48,9.62,1878222,1878301
2150,93,14,1,5.51,7.13,1878301,1878394
2151,110,15,1,4.65,8.57,1878393,1878503
2152,89,19,1,5.75,10.46,1878502,1878591
2153,94,22,0,5.45,12.33,1878591,1878685
2154,112,16,0,4.57,10.94,1878684,1878796
2155,145,13,0,3.53,8.35,1878796,1878941
2156,133,12,0,3.85,5.99,1878940,1879073
2157,82,30,1,6.24,16.53,1879072,1879154
2158,92,19,1,5.57,10.31,1879153,1879245
2159,106,17,0,4.83,7.24,1879244,1879350
2160,78,21,0,6.56,14.58,1879349,1879427
2161,87,14,0,5.89,10.26,1879427,1879514
2162,85,18,1,6.02,12.42,1879513,1879598
2163,100,22,1,5.12,7.91,1879598,1879698
2164,109,13,0,4.70,7.31,1879697,1879806
2165,103,13,0,4.97,8.14,1879805,1879908
2166,118,23,0,4.34,12.19,1879907,1880025
2167,105,16,0,4.88,12.70,1880025,1880130
2168,114,14,0,4.49,6.58,1880129,1880243
2169,104,22,1,4.92,8.99,1880243,1880347
2170,91,17,1,5.63,12.74,1880346,1880437
2171,100,12,1,5.12,6.75,1880436,1880536
2172,94,17,0,5.45,7.89,1880535,1880629
2173,85,16,1,6.02,10.71,1880628,1880713
2174,99,15,1,5.17,10.24,1880712,1880811
2175,91,18,0,5.63,13.86,1880811,1880902
2176,89,14,0,5.75,9.17,1880901,1880990
2177,109,25,0,4.70,14.83,1880989,1881098
2178,122,18,0,4.20,14.13,1881098,1881220
2179,103,13,0,4.97,8.30,1881219,1881322
2180,107,18,1,4.79,11.10,1881321,1881428
2181,106,12,1,4.83,6.67,1881427,1881533
2182,98,23,1,5.22,9.91,1881532,1881630
2183,101,18,1,5.07,9.45,1881629,1881730
2184,83,18,0,6.17,11.80,1881729,1881812
2185,81,17,1,6.32,10.19,1881811,1881892
2186,99,14,1,5.17,7.74,1881891,1881990
2187,94,11,1,5.45,7.16,1881989,1882083
2188,92,15,1,5.57,10.05,1882082,1882174
2189,120,13,0,4.27,7.51,1882174,1882294
2190,127,20,0,4.03,12.98,1882293,1882420
2191,116,20,0,4.41,10.36,1882419,1882535
2192,107,15,0,4.79,8.06,1882535,1882642
2193,102,16,0,5.02,9.94,1882641,1882743
2194,90,22,1,5.69,10.68,1882742,1882832
2195,93,15,1,5.51,9.28,1882831,1882924
2196,79,37,2,6.48,20.65,1882923,1883002
2197,79,22,1,6.48,14.91,1883001,1883080
2198,96,18,1,5.33,9.14,1883079,1883175
2199,110,14,0,4.65,7.83,1883174,1883284
2200,92,18,1,5.57,10.12,1883283,1883375
2201,94,21,1,5.45,12.57,1883374,1883468
2202,123,20,0,4.16,10.74,1883467,1883590
2203,119,18,0,4.30,11.74,1883589,1883708
2204,122,18,0,4.20,9.83,1883707,1883829
2205,113,20,0,4.53,8.51,1883828,1883941
2206,87,20,0,5.89,14.63,1883940,1884027
2207,99,17,1,5.17,8.75,1884027,1884126
2208,92,20,1,5.57,11.59,1884125,1884217
2209,92,16,1,5.57,6.46,1884216,1884308
2210,109,13,1,4.70,4.39,1884307,1884416
2211,94,22,0,5.45,13.03,1884415,1884509
2212,100,13,1,5.12,8.81,1884508,1884608
2213,106,17,0,4.83,11.67,1884607,1884713
2214,105,33,0,4.88,18.09,1884713,1884818
2215,99,14,0,5.17,11.07,1884817,1884916
2216,121,12,1,4.23,6.66,1884916,1885037
2217,103,17,1,4.97,8.20,1885036,1885139
2218,113,12,1,4.53,4.99,1885138,1885251
2219,93,12,1,5.51,6.19,1885250,1885343
2220,88,29,0,5.82,16.88,1885342,1885430
2221,101,14,0,5.07,7.57,1885430,1885531
2222,112,13,0,4.57,6.62,1885530,1885642
2223,98,14,1,5.22,8.83,1885641,1885739
2224,94,18,1,5.45,9.40,1885738,1885832
2225,118,16,0,4.34,10.00,1885831,1885949
2226,83,19,1,6.17,14.89,1885948,1886031
2227,126,11,0,4.06,6.41,1886031,1886157
2228,114,17,0,4.49,8.67,1886156,1886270
2229,95,20,1,5.39,11.37,1886269,1886364
2230,91,16,1,5.63,8.94,1886363,1886454
2231,107,13,0,4.79,7.31,1886453,1886560
2232,85,26,0,6.02,14.00,1886559,1886644
2233,92,18,0,5.57,10.66,1886644,1886736
2234,81,15,1,6.32,10.93,1886735,1886816
2235,107,11,1,4.79,6.00,1886815,1886922
2236,102,17,1,5.02,9.47,1886921,1887023
2237,90,16,1,5.69,8.88,1887022,1887112
2238,105,18,0,4.88,14.78,1887111,1887216
2239,117,15,0,4.38,9.36,1887215,1887332
2240,115,13,0,4.45,6.23,1887331,1887446
2241,113,13,1,4.53,6.82,1887445,1887558
2242,96,14,1,5.33,8.01,1887557,1887653
2243,105,15,0,4.88,9.31,1887652,1887757
2244,81,14,1,6.32,9.16,1887757,1887838
2245,86,20,0,5.95,11.35,1887837,1887923
2246,87,22,1,5.89,11.39,1887923,1888010
2247,98,17,0,5.22,8.32,1888010,1888108
2248,103,15,0,4.97,8.94,1888107,1888210
2249,97,14,0,5.28,9.85,1888209,1888306
2250,92,17,0,5.57,11.25,1888305,1888397
2251,127,18,0,4.03,9.95,1888397,1888524
2252,121,13,0,4.23,8.69,1888523,1888644
2253,119,13,0,4.30,5.77,1888643,1888762
2254,100,15,0,5.12,8.85,1888761,1888861
2255,111,13,0,4.61,6.44,1888860,1888971
2256,103,18,1,4.97,10.13,1888970,1889073
2257,86,21,0,5.95,13.49,1889072,1889158
2258,84,15,1,6.10,11.66,1889157,1889241
2259,101,14,0,5.07,8.18,1889240,1889341
2260,104,15,1,4.92,7.03,1889340,1889444
2261,93,23,1,5.51,16.12,1889443,1889536
2262,102,14,0,5.02,8.31,1889535,1889637
2263,109,12,0,4.70,8.36,1889636,1889745
2264,119,17,0,4.30,10.82,1889744,1889863
2265,105,15,1,4.88,7.58,1889862,1889967
2266,114,22,0,4.49,11.88,1889966,1890080
2267,87,18,1,5.89,10.17,1890079,1890166
2268,101,16,1,5.07,7.13,1890165,1890266
2269,99,15,1,5.17,6.55,1890265,1890364
2270,83,15,1,6.17,10.50,1890363,1890446
2271,86,15,1,5.95,10.88,1890445,1890531
2272,91,16,0,5.63,11.42,1890530,1890621
2273,107,16,1,4.79,7.35,1890620,1890727
2274,93,17,1,5.51,11.24,1890726,1890819
2275,92,15,0,5.57,10.42,1890818,1890910
2276,114,14,0,4.49,10.51,1890910,1891024
2277,131,16,0,3.91,9.72,1891023,1891154
2278,119,11,1,4.30,5.17,1891153,1891272
2279,104,18,1,4.92,10.88,1891272,1891376
2280,92,13,0,5.57,8.07,1891375,1891467
2281,97,20,1,5.28,9.91,1891467,1891564
2282,81,19,1,6.32,9.95,1891563,1891644
2283,86,28,1,5.95,14.90,1891643,1891729
2284,86,22,1,5.95,12.67,1891728,1891814
2285,99,15,0,5.17,6.71,1891813,1891912
2286,91,19,0,5.63,11.09,1891911,1892002
2287,98,19,0,5.22,12.64,1892001,1892099
2288,95,16,0,5.39,10.64,1892099,1892194
2289,131,15,0,3.91,9.24,1892193,1892324
2290,95,17,0,5.39,12.43,1892323,1892418
2291,103,20,0,4.97,12.71,1892418,1892521
2292,124,13,0,4.13,6.89,1892520,1892644
2293,101,15,0,5.07,8.46,1892643,1892744
2294,102,18,1,5.02,7.06,1892743,1892845
2295,105,14,1,4.88,7.63,1892844,1892949
2296,75,20,0,6.83,11.72,1892949,1893024
2297,95,17,1,5.39,10.47,1893023,1893118
2298,99,15,1,5.17,9.37,1893117,1893216
2299,93,16,1,5.51,9.35,1893215,1893308
2300,99,18,0,5.17,10.40,1893307,1893406
2301,99,17,0,5.17,12.67,1893406,1893505
2302,115,15,0,4.45,11.38,1893504,1893619
2303,104,17,0,4.92,12.55,1893618,1893722
2304,118,15,0,4.34,9.73,1893721,1893839
2305,120,12,0,4.27,5.68,1893839,1893959
2306,97,14,1,5.28,8.14,1893958,1894055
2307,97,16,1,5.28,7.48,1894055,1894152
2308,93,15,1,5.51,9.56,1894151,1894244
2309,86,17,1,5.95,12.44,1894243,1894329
2310,83,13,1,6.17,8.12,1894328,1894411
2311,90,18,1,5.69,9.66,1894410,1894500
2312,88,18,1,5.82,12.04,1894499,1894587
2313,112,12,0,4.57,7.30,1894586,1894698
2314,90,23,1,5.69,10.77,1894697,1894787
2315,102,19,0,5.02,10.90,1894786,1894888
2316,119,19,0,4.30,11.89,1894887,1895006
2317,102,18,0,5.02,12.02,1895005,1895107
2318,109,17,0,4.70,11.73,1895106,1895215
2319,107,18,0,4.79,9.25,1895214,1895321
2320,104,14,0,4.92,7.96,1895320,1895424
2321,81,24,1,6.32,19.53,1895423,1895504
2322,102,14,1,5.02,8.78,1895503,1895605
2323,81,17,1,6.32,11.65,1895604,1895685
2324,96,20,0,5.33,9.99,1895684,1895780
2325,86,23,2,5.95,11.51,1895780,1895866
2326,96,17,1,5.33,11.97,1895865,1895961
2327,99,23,0,5.17,11.09,1895960,1896059
2328,110,14,0,4.65,8.77,1896058,1896168
2329,96,12,1,5.33,9.47,1896167,1896263
2330,111,16,0,4.61,8.69,1896263,1896374
2331,100,16,0,5.12,13.71,1896374,1896474
2332,114,13,0,4.49,7.41,1896473,1896587
2333,109,33,1,4.70,13.09,1896587,1896696
2334,107,20,0,4.79,8.64,1896696,1896803
2335,88,22,0,5.82,11.54,1896803,1896891
2336,111,14,1,4.61,6.89,1896891,1897002
2337,80,21,1,6.40,13.01,1897001,1897081
2338,91,15,0,5.63,9.33,1897080,1897171
2339,93,14,0,5.51,5.82,1897170,1897263
2340,99,14,1,5.17,8.69,1897262,1897361
2341,102,16,0,5.02,10.16,1897360,1897462
2342,96,14,0,5.33,10.45,1897461,1897557
2343,100,19,0,5.12,11.85,1897557,1897657
2344,120,19,0,4.27,12.98,1897657,1897777
2345,101,43,0,5.07,27.63,1897777,1897878
2346,100,17,1,5.12,10.55,1897877,1897977
2347,115,16,0,4.45,8.63,1897977,1898092
2348,95,19,1,5.39,9.75,1898092,1898187
2349,92,24,1,5.57,13.51,1898186,1898278
2350,108,22,0,4.74,10.10,1898277,1898385
2351,93,20,1,5.51,9.73,1898384,1898477
2352,87,24,0,5.89,12.01,1898477,1898564
2353,87,18,1,5.89,10.61,1898563,1898650
2354,87,18,1,5.89,12.33,1898649,1898736
2355,98,19,0,5.22,10.17,1898735,1898833
2356,93,48,0,5.51,27.99,1898832,1898925
2357,105,17,0,4.88,9.94,1898925,1899030
2358,124,17,0,4.13,9.24,1899029,1899153
2359,102,19,0,5.02,11.27,1899152,1899254
2360,125,14,0,4.10,5.48,1899253,1899378
2361,110,13,1,4.65,7.46,1899377,1899487
2362,103,12,0,4.97,6.49,1899486,1899589
2363,101,17,1,5.07,9.51,1899588,1899689
2364,90,14,1,5.69,8.53,1899688,1899778
2365,94,12,1,5.45,6.89,1899777,1899871
2366,100,11,1,5.12,6.23,1899870,1899970
2367,92,21,1,5.57,11.07,1899969,1900061
2368,91,20,2,5.63,9.55,1900060,1900151
2369,98,18,0,5.22,13.58,1900150,1900248
2370,96,13,1,5.33,8.06,1900247,1900343
2371,118,23,0,4.34,13.48,1900342,1900460
2372,107,14,0,4.79,9.79,1900460,1900567
2373,112,20,0,4.57,11.91,1900566,1900678
2374,114,16,0,4.49,7.71,1900677,1900791
2375,108,19,1,4.74,7.88,1900790,1900898
2376,88,16,1,5.82,12.17,1900897,1900985
2377,87,17,1,5.89,9.73,1900984,1901071
2378,101,17,1,5.07,8.20,1901071,1901172
2379,83,14,2,6.17,7.54,1901171,1901254
2380,101,21,1,5.07,9.75,1901253,1901354
2381,88,15,1,5.82,8.74,1901353,1901441
2382,80,25,1,6.40,15.54,1901440,1901520
2383,103,17,0,4.97,8.51,1901519,1901622
2384,92,15,1,5.57,8.46,1901621,1901713
2385,98,16,0,5.22,6.81,1901712,1901810
2386,97,21,0,5.28,14.74,1901809,1901906
2387,125,21,0,4.10,13.13,1901905,1902030
2388,105,16,0,4.88,10.58,1902029,1902134
2389,108,16,0,4.74,9.06,1902134,1902242
2390,111,13,1,4.61,7.55,1902242,1902353
2391,112,12,0,4.57,7.17,1902352,1902464
2392,94,22,1,5.45,13.08,1902464,1902558
2393,89,17,0,5.75,10.73,1902557,1902646
2394,92,13,0,5.57,12.03,1902645,1902737
2395,96,24,0,5.33,12.16,1902736,1902832
2396,86,14,1,5.95,7.42,1902831,1902917
2397,90,13,1,5.69,8.99,1902916,1903006
2398,95,22,0,5.39,11.52,1903005,1903100
2399,95,17,0,5.39,12.66,1903099,1903194
2400,108,11,0,4.74,7.28,1903193,1903301
2401,96,19,0,5.33,10.39,1903301,1903397
2402,103,14,0,4.97,8.55,1903397,1903500
2403,85,19,1,6.02,12.63,1903499,1903584
2404,124,16,0,4.13,10.45,1903583,1903707
2405,119,14,0,4.30,11.20,1903706,1903825
2406,114,11,1,4.49,5.83,1903824,1903938
2407,114,12,1,4.49,7.14,1903937,1904051
2408,97,13,0,5.28,6.65,1904051,1904148
2409,90,18,1,5.69,8.97,1904147,1904237
2410,97,17,1,5.28,10.82,1904236,1904333
2411,91,18,1,5.63,11.60,1904332,1904423
2412,84,26,1,6.10,15.68,1904422,1904506
2413,88,20,0,5.82,11.58,1904505,1904593
2414,90,14,1,5.69,7.84,1904592,1904682
2415,107,16,0,4.79,7.85,1904681,1904788
2416,91,23,0,5.63,12.81,1904787,1904878
2417,81,18,0,6.32,13.30,1904877,1904958
2418,109,23,0,4.70,14.01,1904957,1905066
2419,138,23,0,3.71,14.44,1905065,1905203
2420,101,16,0,5.07,10.24,1905202,1905303
2421,104,13,0,4.92,7.99,1905302,1905406
2422,127,14,0,4.03,7.50,1905405,1905532
2423,99,18,1,5.17,9.80,1905531,1905630
2424,95,14,1,5.39,7.35,1905629,1905724
2425,101,14,1,5.07,8.84,1905723,1905824
2426,80,15,1,6.40,8.76,1905823,1905903
2427,85,20,1,6.02,11.79,1905902,1905987
2428,91,24,1,5.63,12.89,1905986,1906077
2429,92,17,1,5.57,9.42,1906077,1906169
2430,94,15,0,5.45,8.46,1906168,1906262
2431,91,17,0,5.63,10.52,1906261,1906352
2432,94,13,1,5.45,8.74,1906352,1906446
2433,95,18,1,5.39,7.69,1906445,1906540
2434,87,25,1,5.89,13.71,1906540,1906627
2435,134,12,0,3.82,7.67,1906626,1906760
2436,109,19,0,4.70,15.17,1906759,1906868
2437,106,15,0,4.83,7.42,1906867,1906973
2438,108,12,1,4.74,7.60,1906972,1907080
2439,112,16,0,4.57,10.41,1907079,1907191
2440,95,16,0,5.39,10.39,1907191,1907286
2441,86,17,1,5.95,8.88,1907285,1907371
2442,118,11,0,4.34,4.97,1907371,1907489
2443,89,20,0,5.75,13.04,1907488,1907577
2444,86,19,1,5.95,11.23,1907576,1907662
2445,85,14,1,6.02,7.43,1907662,1907747
2446,92,24,1,5.57,9.48,1907746,1907838
2447,91,12,1,5.63,5.66,1907837,1907928
2448,103,15,1,4.97,8.49,1907927,1908030
2449,108,22,1,4.74,9.49,1908029,1908137
2450,93,20,1,5.51,10.81,1908137,1908230
2451,91,15,1,5.63,8.92,1908230,1908321
2452,101,19,0,5.07,12.48,1908321,1908422
2453,124,16,0,4.13,8.50,1908421,1908545
2454,129,13,0,3.97,10.57,1908544,1908673
2455,108,13,0,4.74,7.16,1908672,1908780
2456,107,26,0,4.79,12.73,1908779,1908886
2457,98,17,1,5.22,8.54,1908885,1908983
2458,84,19,1,6.10,12.90,1908983,1909067
2459,102,22,0,5.02,11.35,1909067,1909169
2460,90,18,1,5.69,10.88,1909168,1909258
2461,78,18,1,6.56,13.04,1909257,1909335
2462,94,14,1,5.45,9.37,1909334,1909428
2463,97,19,0,5.28,9.56,1909427,1909524
2464,95,14,1,5.39,9.67,1909523,1909618
2465,106,18,1,4.83,8.31,1909617,1909723
2466,116,11,0,4.41,6.48,1909722,1909838
2467,104,14,0,4.92,8.63,1909838,1909942
2468,87,19,1,5.89,11.53,1909941,1910028
2469,133,19,0,3.85,10.59,1910027,1910160
2470,113,16,0,4.53,11.13,1910159,1910272
2471,120,16,0,4.27,9.73,1910271,1910391
2472,115,11,0,4.45,6.04,1910390,1910505
2473,95,14,1,5.39,8.20,1910504,1910599
2474,95,13,1,5.39,6.89,1910598,1910693
2475,115,13,0,4.45,5.97,1910692,1910807
2476,80,17,0,6.40,9.94,1910807,1910887
2477,94,14,1,5.45,7.74,1910887,1910981
2478,96,17,0,5.33,8.47,1910980,1911076
2479,94,22,1,5.45,11.14,1911075,1911169
2480,103,17,0,4.97,9.25,1911168,1911271
2481,104,15,0,4.92,8.28,1911270,1911374
2482,98,15,1,5.22,9.52,1911373,1911471
2483,98,16,1,5.22,9.15,1911470,1911568
2484,114,21,0,4.49,13.81,1911567,1911681
2485,103,17,0,4.97,11.21,1911681,1911784
2486,134,15,0,3.82,9.33,1911784,1911918
2487,110,13,0,4.65,7.43,1911918,1912028
2488,117,14,0,4.38,8.18,1912027,1912144
2489,109,14,1,4.70,6.85,1912143,1912252
2490,99,20,0,5.17,9.11,1912252,1912351
2491,106,15,1,4.83,7.18,1912351,1912457
2492,82,19,0,6.24,14.09,1912457,1912539
2493,89,17,1,5.75,10.43,1912538,1912627
2494,100,18,0,5.12,9.31,1912627,1912727
2495,97,16,0,5.28,9.50,1912726,1912823
2496,96,14,1,5.33,10.06,1912822,1912918
2497,97,14,0,5.28,8.68,1912917,1913014
2498,120,16,0,4.27,8.70,1913013,1913133
2499,121,19,0,4.23,14.44,1913133,1913254
2500,125,13,1,4.10,5.80,1913253,1913378
2501,109,12,0,4.70,6.74,1913378,1913487
2502,99,17,1,5.17,8.47,1913486,1913585
2503,105,13,0,4.88,7.67,1913584,1913689
2504,88,23,1,5.82,12.24,1913688,1913776
2505,78,22,1,6.56,11.91,1913776,1913854
2506,96,17,1,5.33,9.51,1913853,1913949
2507,100,32,0,5.12,15.41,1913948,1914048
2508,91,19,0,5.63,12.63,1914047,1914138
2509,104,19,0,4.92,10.11,1914137,1914241
2510,120,17,0,4.27,11.60,1914241,1914361
2511,115,24,0,4.45,13.71,1914360,1914475
2512,113,17,1,4.53,7.86,1914475,1914588
2513,114,18,0,4.49,9.29,1914588,1914702
2514,92,24,0,5.57,10.75,1914701,1914793
2515,104,17,0,4.92,8.61,1914792,1914896
2516,85,28,1,6.02,15.74,1914895,1914980
2517,98,15,0,5.22,10.21,1914979,1915077
2518,92,14,1,5.57,8.59,1915077,1915169
2519,97,18,0,5.28,13.17,1915168,1915265
2520,73,22,1,7.01,17.71,1915264,1915337
2521,105,17,0,4.88,8.93,1915336,1915441
2522,125,20,0,4.10,11.85,1915440,1915565
2523,107,17,0,4.79,13.10,1915564,1915671
2524,99,21,0,5.17,11.66,1915670,1915769
2525,114,18,0,4.49,8.88,1915768,1915882
2526,99,28,1,5.17,12.16,1915881,1915980
2527,104,20,1,4.92,8.01,1915980,1916084
2528,102,14,0,5.02,6.92,1916083,1916185
2529,83,18,1,6.17,9.88,1916184,1916267
2530,100,19,1,5.12,10.79,1916266,1916366
2531,89,13,1,5.75,8.05,1916365,1916454
2532,97,14,0,5.28,8.10,1916454,1916551
2533,94,16,1,5.45,8.80,1916550,1916644
2534,112,16,0,4.57,9.16,1916643,1916755
2535,122,19,0,4.20,11.63,1916754,1916876
2536,107,25,0,4.79,15.72,1916875,1916982
2537,123,11,0,4.16,5.70,1916982,1917105
2538,108,28,1,4.74,13.91,1917104,1917212
2539,105,15,0,4.88,6.28,1917211,1917316
2540,107,14,1,4.79,7.63,1917315,1917422
2541,82,18,1,6.24,10.11,1917421,1917503
2542,90,20,1,5.69,11.28,1917502,1917592
2543,91,18,1,5.63,10.19,1917591,1917682
2544,96,26,1,5.33,12.58,1917681,1917777
2545,104,18,0,4.92,10.38,1917777,1917881
2546,91,24,1,5.63,16.34,1917880,1917971
2547,93,16,1,5.51,12.14,1917970,1918063
2548,122,16,0,4.20,12.32,1918062,1918184
2549,104,14,0,4.92,7.80,1918183,1918287
2550,103,16,0,4.97,10.51,1918286,1918389
2551,98,15,1,5.22,8.99,1918388,1918486
2552,89,19,1,5.75,12.86,1918485,1918574
2553,88,20,0,5.82,13.79,1918573,1918661
2554,91,21,0,5.63,13.09,1918660,1918751
2555,88,19,1,5.82,10.35,1918750,1918838
2556,95,17,1,5.39,9.23,1918837,1918932
2557,97,23,1,5.28,11.17,1918931,1919028
2558,97,13,0,5.28,8.37,1919027,1919124
2559,101,18,0,5.07,11.07,1919123,1919224
2560,143,17,0,3.58,8.86,1919224,1919367
2561,112,17,0,4.57,10.23,1919366,1919478
2562,105,20,1,4.88,8.97,1919477,1919582
2563,100,12,1,5.12,7.63,1919581,1919681
2564,96,15,0,5.33,7.76,1919680,1919776
2565,90,19,1,5.69,10.75,1919775,1919865
2566,90,26,1,5.69,13.66,1919865,1919955
2567,93,17,1,5.51,10.59,1919955,1920048
2568,80,35,1,6.40,22.69,1920047,1920127
2569,121,12,0,4.23,7.65,1920126,1920247
2570,94,13,0,5.45,9.18,1920246,1920340
2571,125,21,0,4.10,10.76,1920339,1920464
2572,97,25,0,5.28,9.97,1920463,1920560
2573,83,20,1,6.17,11.97,1920559,1920642
2574,88,17,1,5.82,13.33,1920641,1920729
2575,90,17,1,5.69,10.44,1920728,1920818
2576,91,18,1,5.63,8.72,1920817,1920908
2577,89,25,1,5.75,11.78,1920908,1920997
2578,104,18,0,4.92,10.63,1920996,1921100
2579,82,16,1,6.24,10.14,1921099,1921181
2580,111,20,0,4.61,12.92,1921180,1921291
2581,116,16,0,4.41,12.16,1921290,1921406
2582,121,21,0,4.23,10.77,1921405,1921526
2583,87,23,0,5.89,13.80,1921525,1921612
2584,90,18,1,5.69,13.33,1921611,1921701
2585,89,20,1,5.75,7.96,1921700,1921789
2586,88,15,1,5.82,7.79,1921788,1921876
2587,104,15,1,4.92,8.69,1921875,1921979
2588,103,15,0,4.97,10.36,1921978,1922081
2589,114,17,0,4.49,11.09,1922080,1922194
2590,127,24,0,4.03,14.11,1922193,1922320
2591,106,19,1,4.83,11.54,1922319,1922425
2592,115,13,0,4.45,6.91,1922424,1922539
2593,90,23,1,5.69,14.57,1922539,1922629
2594,98,14,0,5.22,10.58,1922628,1922726
2595,92,19,1,5.57,6.81,1922725,1922817
2596,86,19,1,5.95,13.07,1922816,1922902
2597,97,15,1,5.28,9.83,1922901,1922998
2598,100,19,0,5.12,9.03,1922997,1923097
2599,102,36,0,5.02,18.22,1923097,1923199
2600,125,18,0,4.10,8.05,1923198,1923323
2601,117,15,0,4.38,7.53,1923322,1923439
2602,103,15,0,4.97,8.94,1923439,1923542
2603,89,15,1,5.75,12.37,1923541,1923630
2604,94,20,1,5.45,10.23,1923629,1923723
2605,100,13,0,5.12,8.53,1923722,1923822
2606,93,17,0,5.51,9.28,1923821,1923914
2607,98,16,0,5.22,9.01,1923913,1924011
2608,95,14,0,5.39,9.50,1924010,1924105
2609,116,17,0,4.41,11.50,1924104,1924220
2610,101,24,0,5.07,12.14,1924219,1924320
2611,124,12,0,4.13,7.29,1924320,1924444
2612,114,13,0,4.49,6.02,1924443,1924557
2613,95,22,0,5.39,11.31,1924556,1924651
2614,85,30,1,6.02,14.05,1924651,1924736
2615,90,12,1,5.69,9.26,1924736,1924826
2616,90,25,1,5.69,9.97,1924825,1924915
2617,99,14,0,5.17,8.93,1924915,1925014
2618,98,17,1,5.22,12.77,1925014,1925112
2619,107,26,0,4.79,14.36,1925111,1925218
2620,122,14,0,4.20,10.81,1925217,1925339
2621,114,18,0,4.49,9.95,1925338,1925452
2622,94,18,1,5.45,11.44,1925451,1925545
2623,93,18,1,5.51,9.78,1925544,1925637
2624,91,19,1,5.63,11.22,1925636,1925727
2625,88,13,1,5.82,7.42,1925726,1925814
2626,93,17,1,5.51,11.00,1925813,1925906
2627,107,18,1,4.79,8.84,1925905,1926012
2628,98,15,0,5.22,11.83,1926012,1926110
2629,100,23,1,5.12,12.99,1926109,1926209
2630,112,13,0,4.57,10.23,1926208,1926320
2631,120,17,1,4.27,7.56,1926319,1926439
2632,103,30,0,4.97,13.80,1926439,1926542
2633,88,41,1,5.82,23.22,1926541,1926629
2634,102,19,1,5.02,11.45,1926628,1926730
2635,81,15,1,6.32,11.11,1926729,1926810
2636,92,14,0,5.57,9.46,1926809,1926901
2637,95,15,1,5.39,7.50,1926900,1926995
2638,108,11,0,4.74,6.47,1926994,1927102
2639,84,18,0,6.10,10.92,1927101,1927185
2640,109,18,0,4.70,10.43,1927184,1927293
2641,131,14,0,3.91,10.13,1927293,1927424
2642,114,16,0,4.49,7.44,1927424,1927538
2643,116,19,1,4.41,9.95,1927537,1927653
2644,93,13,0,5.51,8.62,1927652,1927745
2645,105,16,0,4.88,10.45,1927744,1927849
2646,90,15,0,5.69,8.21,1927848,1927938
2647,85,15,0,6.02,8.99,1927938,1928023
2648,94,14,1,5.45,7.35,1928022,1928116
2649,101,25,1,5.07,11.99,1928115,1928216
2650,85,21,1,6.02,11.08,1928215,1928300
2651,89,17,0,5.75,11.44,1928299,1928388
2652,119,12,0,4.30,11.15,1928388,1928507
2653,103,14,1,4.97,9.10,1928506,1928609
2654,126,11,0,4.06,5.84,1928609,1928735
2655,102,21,1,5.02,12.25,1928734,1928836
2656,104,16,1,4.92,7.96,1928836,1928940
2657,88,18,1,5.82,12.31,1928939,1929027
2658,92,14,1,5.57,7.53,1929026,1929118
2659,83,19,1,6.17,11.73,1929117,1929200
2660,104,20,1,4.92,9.22,1929199,1929303
2661,95,16,0,5.39,13.65,1929302,1929397
2662,99,27,0,5.17,15.35,1929396,1929495
2663,107,22,0,4.79,12.26,1929494,1929601
2664,96,15,0,5.33,10.99,1929600,1929696
2665,110,22,0,4.65,10.79,1929695,1929805
2666,89,18,0,5.75,12.34,1929804,1929893
2667,94,21,1,5.45,13.74,1929892,1929986
2668,97,14,1,5.28,8.70,1929985,1930082
2669,97,20,1,5.28,9.58,1930081,1930178
2670,91,13,1,5.63,6.89,1930178,1930269
2671,94,14,0,5.45,9.48,1930268,1930362
2672,108,18,0,4.74,8.84,1930361,1930469
2673,86,17,1,5.95,13.53,1930469,1930555
2674,93,30,0,5.51,15.73,1930554,1930647
2675,113,21,0,4.53,13.66,1930646,1930759
2676,96,26,1,5.33,16.08,1930758,1930854
2677,118,16,1,4.34,9.97,1930853,1930971
2678,97,15,1,5.28,9.29,1930970,1931067
2679,102,12,1,5.02,8.74,1931066,1931168
2680,83,17,1,6.17,12.12,1931168,1931251
2681,81,19,1,6.32,12.44,1931250,1931331
2682,96,14,1,5.33,8.03,1931330,1931426
2683,82,23,1,6.24,15.06,1931425,1931507
2684,94,20,1,5.45,11.76,1931506,1931600
2685,92,21,0,5.57,14.18,1931599,1931691
2686,85,16,1,6.02,11.98,1931690,1931775
2687,133,17,0,3.85,11.11,1931774,1931907
2688,106,31,0,4.83,16.25,1931907,1932013
2689,121,12,0,4.23,6.49,1932013,1932134
2690,97,14,1,5.28,6.74,1932133,1932230
2691,95,15,2,5.39,6.07,1932229,1932324
2692,105,19,1,4.88,13.02,1932323,1932428
2693,76,25,1,6.74,17.19,1932427,1932503
2694,96,12,0,5.33,7.70,1932503,1932599
2695,86,18,1,5.95,8.67,1932598,1932684
2696,97,18,0,5.28,8.53,1932684,1932781
2697,87,18,0,5.89,16.10,1932780,1932867
2698,88,18,0,5.82,13.47,1932866,1932954
2699,116,19,0,4.41,12.05,1932953,1933069
2700,105,22,0,4.88,16.01,1933068,1933173
2701,117,14,1,4.38,7.57,1933172,1933289
2702,108,12,1,4.74,7.08,1933288,1933396
2703,105,19,1,4.88,9.38,1933395,1933500
2704,77,19,1,6.65,13.45,1933499,1933576
2705,94,23,0,5.45,10.61,1933576,1933670
2706,93,15,1,5.51,7.67,1933669,1933762
2707,113,11,1,4.53,6.53,1933761,1933874
2708,92,36,1,5.57,26.38,1933874,1933966
2709,91,16,0,5.63,11.53,1933965,1934056
2710,115,18,0,4.45,9.57,1934055,1934170
2711,121,14,0,4.23,8.89,1934169,1934290
2712,106,11,0,4.83,6.65,1934289,1934395
2713,102,22,1,5.02,15.82,1934394,1934496
2714,97,15,1,5.28,8.98,1934496,1934593
2715,89,26,0,5.75,19.69,1934592,1934681
2716,85,17,0,6.02,14.73,1934680,1934765
2717,87,16,1,5.89,9.53,1934765,1934852
2718,93,18,1,5.51,9.24,1934851,1934944
2719,88,28,1,5.82,17.92,1934944,1935032
2720,92,26,1,5.57,14.46,1935032,1935124
2721,96,18,0,5.33,11.41,1935123,1935219
2722,122,22,0,4.20,12.75,1935218,1935340
2723,141,13,0,3.63,7.65,1935339,1935480
2724,123,14,1,4.16,6.36,1935479,1935602
2725,91,26,0,5.63,12.61,1935601,1935692
2726,87,18,1,5.89,13.64,1935691,1935778
2727,98,19,0,5.22,8.13,1935777,1935875
2728,81,14,1,6.32,10.00,1935874,1935955
2729,88,20,0,5.82,12.26,1935954,1936042
2730,91,21,1,5.63,12.65,1936041,1936132
2731,101,21,1,5.07,10.32,1936132,1936233
2732,94,27,0,5.45,20.50,1936233,1936327
2733,92,23,1,5.57,13.07,1936326,1936418
2734,94,24,0,5.45,15.91,1936417,1936511
2735,121,23,0,4.23,12.82,1936511,1936632
2736,104,16,0,4.92,8.19,1936631,1936735
2737,97,18,1,5.28,10.53,1936734,1936831
2738,93,16,1,5.51,9.63,1936831,1936924
2739,95,22,1,5.39,11.92,1936923,1937018
2740,75,22,0,6.83,16.44,1937017,1937092
2741,84,17,1,6.10,8.99,1937091,1937175
2742,93,18,0,5.51,10.29,1937174,1937267
2743,93,15,0,5.51,9.35,1937266,1937359
2744,90,26,0,5.69,14.35,1937358,1937448
2745,106,13,0,4.83,7.33,1937448,1937554
2746,111,20,0,4.61,12.15,1937553,1937664
2747,104,14,0,4.92,10.40,1937663,1937767
2748,114,15,0,4.49,8.02,1937767,1937881
2749,111,20,0,4.61,9.80,1937881,1937992
2750,102,12,1,5.02,7.88,1937991,1938093
2751,95,16,1,5.39,9.90,1938092,1938187
2752,91,18,0,5.63,13.27,1938186,1938277
2753,89,12,1,5.75,7.89,1938277,1938366
2754,103,29,0,4.97,10.55,1938365,1938468
2755,97,17,1,5.28,8.63,1938468,1938565
2756,101,16,0,5.07,11.11,1938564,1938665
2757,103,24,0,4.97,13.48,1938664,1938767
2758,125,23,0,4.10,15.17,1938766,1938891
2759,93,20,0,5.51,15.33,1938890,1938983
2760,125,12,0,4.10,7.32,1938982,1939107
2761,102,16,0,5.02,7.80,1939107,1939209
2762,113,13,1,4.53,6.97,1939208,1939321
2763,82,20,0,6.24,11.96,1939320,1939402
2764,87,18,0,5.89,10.49,1939401,1939488
2765,97,11,1,5.28,5.69,1939487,1939584
2766,100,21,0,5.12,13.47,1939583,1939683
2767,91,20,0,5.63,16.43,1939683,1939774
2768,83,21,0,6.17,17.20,1939774,1939857
2769,100,19,0,5.12,15.23,1939856,1939956
2770,108,16,0,4.74,11.21,1939955,1940063
2771,114,21,0,4.49,10.43,1940063,1940177
2772,107,17,0,4.79,10.26,1940176,1940283
2773,93,20,1,5.51,11.26,1940282,1940375
2774,94,18,1,5.45,11.03,1940374,1940468
2775,81,18,1,6.32,14.00,1940467,1940548
2776,102,16,0,5.02,9.57,1940548,1940650
2777,88,16,1,5.82,9.60,1940650,1940738
2778,109,19,0,4.70,8.21,1940737,1940846
2779,100,14,0,5.12,10.09,1940846,1940946
2780,92,15,0,5.57,10.85,1940945,1941037
2781,103,15,0,4.97,12.55,1941036,1941139
2782,113,21,0,4.53,12.09,1941138,1941251
2783,113,13,0,4.53,8.69,1941250,1941363
2784,108,15,1,4.74,8.21,1941362,1941470
2785,85,28,1,6.02,16.14,1941469,1941554
2786,102,15,1,5.02,7.39,1941553,1941655
2787,85,16,1,6.02,11.29,1941654,1941739
2788,84,17,1,6.10,14.23,1941738,1941822
2789,81,40,1,6.32,26.49,1941821,1941902
2790,108,12,0,4.74,6.67,1941901,1942009
2791,93,26,0,5.51,15.24,1942008,1942101
2792,95,21,0,5.39,12.24,1942100,1942195
2793,123,20,0,4.16,12.32,1942194,1942317
2794,113,16,0,4.53,10.73,1942316,1942429
2795,106,19,0,4.83,9.12,1942428,1942534
2796,108,17,1,4.74,9.01,1942533,1942641
2797,97,14,0,5.28,7.64,1942640,1942737
2798,86,18,0,5.95,11.25,1942736,1942822
2799,86,17,1,5.95,10.46,1942822,1942908
2800,93,31,1,5.51,16.06,1942908,1943001
2801,108,17,1,4.74,8.25,1943000,1943108
2802,92,25,0,5.57,16.83,1943107,1943199
2803,88,16,1,5.82,13.69,1943198,1943286
2804,120,17,0,4.27,12.08,1943285,1943405
2805,105,16,0,4.88,9.94,1943404,1943509
2806,123,15,0,4.16,8.72,1943508,1943631
2807,120,11,0,4.27,5.60,1943630,1943750
2808,94,17,1,5.45,8.46,1943749,1943843
2809,100,15,1,5.12,9.65,1943843,1943943
2810,82,14,0,6.24,11.48,1943942,1944024
2811,87,19,1,5.89,9.69,1944024,1944111
2812,88,47,1,5.82,24.08,1944110,1944198
2813,99,13,1,5.17,7.64,1944197,1944296
2814,88,22,1,5.82,13.76,1944295,1944383
2815,95,20,0,5.39,11.44,1944382,1944477
2816,123,19,0,4.16,8.30,1944476,1944599
2817,114,31,0,4.49,16.99,1944598,1944712
2818,118,17,0,4.34,10.90,1944711,1944829
2819,106,20,1,4.83,8.50,1944828,1944934
2820,97,21,1,5.28,12.55,1944933,1945030
2821,91,17,0,5.63,12.10,1945029,1945120
2822,88,19,1,5.82,12.17,1945119,1945207
2823,100,11,1,5.12,6.13,1945206,1945306
2824,99,20,0,5.17,9.92,1945305,1945404
2825,90,29,0,5.69,16.73,1945403,1945493
2826,90,17,0,5.69,12.57,1945492,1945582
2827,82,17,1,6.24,12.62,1945581,1945663
2828,132,13,0,3.88,7.23,1945662,1945794
2829,120,14,0,4.27,7.91,1945793,1945913
2830,124,14,0,4.13,6.48,1945912,1946036
2831,100,15,0,5.12,11.17,1946035,1946135
2832,90,21,0,5.69,12.77,1946134,1946224
2833,102,17,0,5.02,8.08,1946223,1946325
2834,83,13,1,6.17,9.37,1946324,1946407
2835,97,16,1,5.28,9.33,1946406,1946503
2836,106,18,1,4.83,7.80,1946502,1946608
2837,101,14,0,5.07,9.01,1946607,1946708
2838,99,15,1,5.17,9.70,1946708,1946807
2839,110,19,0,4.65,12.10,1946806,1946916
2840,115,17,0,4.45,10.65,1946915,1947030
2841,129,14,0,3.97,7.35,1947029,1947158
2842,115,18,0,4.45,8.28,1947157,1947272
2843,92,16,1,5.57,8.98,1947271,1947363
2844,91,16,1,5.63,11.33,1947362,1947453
2845,70,44,2,7.31,30.02,1947452,1947522
2846,93,22,0,5.51,15.02,1947521,1947614
2847,87,30,1,5.89,14.31,1947613,1947700
2848,102,13,0,5.02,7.84,1947699,1947801
2849,106,11,0,4.83,6.08,1947800,1947906
2850,94,15,1,5.45,12.01,1947906,1948000
2851,105,21,0,4.88,13.38,1947999,1948104
2852,120,14,0,4.27,11.60,1948103,1948223
2853,128,12,0,4.00,6.33,1948222,1948350
2854,96,23,0,5.33,17.78,1948349,1948445
2855,92,27,1,5.57,12.64,1948444,1948536
2856,98,21,0,5.22,10.03,1948536,1948634
2857,80,24,1,6.40,13.46,1948634,1948714
2858,111,15,0,4.61,6.94,1948714,1948825
2859,101,15,1,5.07,7.27,1948824,1948925
2860,103,19,1,4.97,10.47,1948924,1949027
2861,94,13,1,5.45,7.61,1949027,1949121
2862,99,13,0,5.17,10.14,1949120,1949219
2863,121,12,0,4.23,9.02,1949218,1949339
2864,133,20,0,3.85,10.59,1949338,1949471
2865,106,19,0,4.83,10.95,1949470,1949576
2866,89,16,1,5.75,9.22,1949576,1949665
2867,103,15,1,4.97,7.08,1949664,1949767
2868,87,17,1,5.89,10.24,1949766,1949853
2869,95,16,1,5.39,7.25,1949853,1949948
2870,88,23,1,5.82,13.51,1949947,1950035
2871,109,16,1,4.70,7.73,1950034,1950143
2872,92,44,0,5.57,25.38,1950142,1950234
2873,91,14,1,5.63,10.17,1950233,1950324
2874,111,23,0,4.61,11.26,1950323,1950434
2875,93,19,0,5.51,18.38,1950434,1950527
2876,115,18,0,4.45,10.20,1950526,1950641
2877,122,13,0,4.20,6.01,1950641,1950763
2878,90,16,0,5.69,11.04,1950762,1950852
2879,84,14,0,6.10,9.75,1950852,1950936
2880,96,18,0,5.33,10.26,1950935,1951031
2881,87,18,0,5.89,12.70,1951031,1951118
2882,111,14,0,4.61,10.81,1951117,1951228
2883,112,18,0,4.57,8.35,1951227,1951339
2884,103,25,0,4.97,14.36,1951338,1951441
2885,95,14,1,5.39,8.36,1951440,1951535
2886,95,16,1,5.39,8.39,1951534,1951629
2887,100,21,0,5.12,14.07,1951628,1951728
2888,99,17,0,5.17,13.07,1951727,1951826
2889,101,14,0,5.07,13.77,1951825,1951926
2890,118,12,0,4.34,5.92,1951925,1952043
2891,95,17,1,5.39,8.28,1952042,1952137
2892,91,19,0,5.63,10.56,1952136,1952227
2893,87,20,1,5.89,15.83,1952226,1952313
2894,86,26,0,5.95,15.53,1952312,1952398
2895,98,19,0,5.22,13.91,1952397,1952495
2896,97,25,0,5.28,14.28,1952494,1952591
2897,105,15,0,4.88,9.00,1952590,1952695
2898,94,28,1,5.45,15.33,1952694,1952788
2899,93,18,0,5.51,9.07,1952787,1952880
2900,98,19,0,5.22,11.05,1952879,1952977
2901,84,20,1,6.10,11.40,1952976,1953060
2902,104,18,0,4.92,12.28,1953059,1953163
2903,123,20,0,4.16,11.24,1953162,1953285
2904,99,17,1,5.17,8.43,1953285,1953384
2905,92,16,1,5.57,8.85,1953383,1953475
2906,89,14,0,5.75,8.10,1953474,1953563
2907,104,13,1,4.92,6.74,1953562,1953666
2908,98,18,0,5.22,11.66,1953666,1953764
2909,114,17,0,4.49,10.67,1953764,1953878
2910,112,17,0,4.57,10.01,1953878,1953990
2911,91,20,0,5.63,14.70,1953989,1954080
2912,96,15,1,5.33,7.74,1954079,1954175
2913,101,12,0,5.07,7.37,1954174,1954275
2914,92,21,0,5.57,13.18,1954275,1954367
2915,98,18,0,5.22,9.79,1954366,1954464
2916,126,15,0,4.06,8.28,1954463,1954589
2917,104,20,0,4.92,10.47,1954588,1954692
2918,107,14,0,4.79,8.15,1954692,1954799
2919,105,23,0,4.88,10.15,1954798,1954903
2920,96,18,1,5.33,10.31,1954903,1954999
2921,88,22,0,5.82,16.90,1954998,1955086
2922,93,20,1,5.51,9.99,1955085,1955178
2923,111,18,0,4.61,12.47,1955177,1955288
2924,102,18,0,5.02,11.80,1955288,1955390
2925,103,22,0,4.97,11.85,1955389,1955492
2926,96,16,0,5.33,10.26,1955491,1955587
2927,81,33,2,6.32,18.37,1955586,1955667
2928,95,19,1,5.39,10.36,1955666,1955761
2929,100,17,0,5.12,10.07,1955760,1955860
2930,100,22,1,5.12,12.27,1955859,1955959
2931,119,15,0,4.30,9.93,1955958,1956077
2932,105,14,1,4.88,7.67,1956077,1956182
2933,96,23,1,5.33,11.66,1956181,1956277
2934,105,12,1,4.88,6.76,1956277,1956382
2935,95,20,1,5.39,9.56,1956381,1956476
2936,97,21,1,5.28,10.39,1956475,1956572
2937,96,28,0,5.33,14.33,1956571,1956667
2938,113,17,0,4.53,12.04,1956666,1956779
2939,94,17,0,5.45,13.89,1956778,1956872
2940,104,25,1,4.92,15.49,1956871,1956975
2941,91,16,1,5.63,12.94,1956974,1957065
2942,92,14,1,5.57,8.96,1957064,1957156
2943,85,22,1,6.02,12.16,1957155,1957240
2944,98,17,0,5.22,9.87,1957240,1957338
2945,91,19,0,5.63,11.31,1957337,1957428
2946,94,19,0,5.45,19.29,1957427,1957521
2947,105,17,0,4.88,10.24,1957520,1957625
2948,104,16,0,4.92,10.97,1957624,1957728
2949,100,21,1,5.12,10.33,1957727,1957827
2950,99,13,0,5.17,7.33,1957827,1957926
2951,103,23,0,4.97,10.96,1957925,1958028
2952,99,18,0,5.17,11.64,1958027,1958126
2953,109,15,0,4.70,11.09,1958125,1958234
2954,89,25,0,5.75,18.05,1958233,1958322
2955,118,12,0,4.34,7.89,1958321,1958439
2956,80,18,0,6.40,12.29,1958439,1958519
2957,95,32,0,5.39,17.80,1958518,1958613
2958,97,15,1,5.28,7.50,1958613,1958710
2959,93,16,1,5.51,9.37,1958709,1958802
2960,86,25,0,5.95,21.72,1958801,1958887
2961,99,16,0,5.17,11.82,1958886,1958985
2962,97,16,0,5.28,13.29,1958985,1959082
2963,118,11,1,4.34,5.43,1959082,1959200
2964,94,20,0,5.45,10.27,1959199,1959293
2965,84,24,1,6.10,11.06,1959293,1959377
2966,91,15,1,5.63,9.40,1959376,1959467
2967,97,22,0,5.28,9.48,1959466,1959563
2968,101,21,0,5.07,13.23,1959562,1959663
2969,101,21,0,5.07,12.80,1959662,1959763
2970,88,24,1,5.82,18.56,1959762,1959850
2971,111,13,0,4.61,9.79,1959849,1959960
2972,98,17,1,5.22,8.52,1959959,1960057
2973,97,16,0,5.28,7.97,1960056,1960153
2974,92,14,0,5.57,7.90,1960153,1960245
2975,84,19,1,6.10,14.44,1960244,1960328
2976,89,36,1,5.75,19.53,1960327,1960416
2977,91,20,0,5.63,18.92,1960415,1960506
2978,114,32,0,4.49,20.27,1960505,1960619
2979,101,13,0,5.07,6.38,1960618,1960719
2980,104,13,1,4.92,6.74,1960718,1960822
2981,75,36,0,6.83,23.85,1960821,1960896
2982,93,15,0,5.51,9.30,1960895,1960988
2983,94,17,1,5.45,9.33,1960987,1961081
2984,110,13,0,4.65,7.74,1961080,1961190
2985,108,46,0,4.74,26.01,1961189,1961297
2986,108,18,1,4.74,9.36,1961297,1961405
2987,94,15,1,5.45,7.91,1961404,1961498
2988,88,33,1,5.82,19.17,1961497,1961585
2989,89,19,1,5.75,8.30,1961585,1961674
2990,82,20,0,6.24,15.92,1961673,1961755
2991,84,17,1,6.10,11.78,1961754,1961838
2992,102,30,0,5.02,14.59,1961837,1961939
2993,108,20,0,4.74,13.71,1961938,1962046
2994,126,16,0,4.06,8.04,1962045,1962171
2995,87,26,1,5.89,14.61,1962170,1962257
2996,90,15,0,5.69,10.19,1962256,1962346
2997,92,20,0,5.57,11.57,1962345,1962437
2998,89,33,1,5.75,27.42,1962436,1962525
2999,95,21,0,5.39,12.41,1962525,1962620
3000,95,36,0,5.39,22.64,1962619,1962714
3001,102,18,0,5.02,11.63,1962713,1962815
3002,104,13,1,4.92,8.22,1962814,1962918
3003,94,15,0,5.45,11.14,1962918,1963012
3004,83,16,0,6.17,12.67,1963011,1963094
3005,84,18,1,6.10,10.92,1963093,1963177
3006,99,16,0,5.17,10.85,1963176,1963275
3007,92,20,0,5.57,14.01,1963275,1963367
3008,89,15,1,5.75,9.80,1963366,1963455
3009,113,16,0,4.53,11.49,1963454,1963567
3010,107,29,0,4.79,13.98,1963566,1963673
3011,91,18,0,5.63,8.83,1963672,1963763
3012,85,16,1,6.02,10.73,1963762,1963847
3013,94,14,1,5.45,8.03,1963847,1963941
3014,83,34,0,6.17,23.61,1963940,1964023
3015,102,23,0,5.02,11.55,1964022,1964124
3016,88,20,0,5.82,14.90,1964123,1964211
3017,106,24,0,4.83,15.52,1964211,1964317
3018,108,29,0,4.74,14.40,1964316,1964424
3019,79,27,1,6.48,22.73,1964423,1964502
3020,74,22,1,6.92,18.21,1964502,1964576
3021,87,16,1,5.89,10.10,1964575,1964662
3022,87,15,1,5.89,8.98,1964661,1964748
3023,84,22,1,6.10,13.73,1964747,1964831
3024,81,21,0,6.32,17.38,1964830,1964911
3025,99,23,0,5.17,13.98,1964910,1965009
3026,107,20,0,4.79,13.35,1965008,1965115
3027,101,15,0,5.07,7.63,1965114,1965215
3028,85,20,0,6.02,14.61,1965214,1965299
3029,85,25,1,6.02,13.88,1965298,1965383
3030,94,12,0,5.45,5.99,1965383,1965477
3031,90,17,1,5.69,12.28,1965476,1965566
3032,86,24,0,5.95,19.37,1965565,1965651
3033,112,33,0,4.57,19.16,1965650,1965762
3034,113,17,0,4.53,11.28,1965761,1965874
3035,94,20,1,5.45,10.89,1965873,1965967
3036,85,20,2,6.02,13.48,1965966,1966051
3037,90,17,0,5.69,11.88,1966051,1966141
3038,97,19,1,5.28,8.82,1966140,1966237
3039,107,15,1,4.79,7.23,1966236,1966343
3040,93,12,0,5.51,8.01,1966342,1966435
3041,114,18,0,4.49,13.92,1966435,1966549
3042,113,16,0,4.53,9.98,1966548,1966661
3043,84,20,1,6.10,14.71,1966660,1966744
3044,90,12,1,5.69,5.97,1966743,1966833
3045,90,15,1,5.69,10.10,1966832,1966922
3046,100,16,0,5.12,11.57,1966922,1967022
3047,92,20,1,5.57,10.68,1967021,1967113
3048,100,21,0,5.12,12.75,1967112,1967212
3049,88,16,0,5.82,14.97,1967211,1967299
3050,108,18,0,4.74,12.58,1967298,1967406
3051,93,19,1,5.51,7.65,1967405,1967498
3052,90,27,1,5.69,12.70,1967497,1967587
3053,93,27,1,5.51,11.99,1967586,1967679
3054,101,19,0,5.07,10.86,1967678,1967779
3055,91,15,1,5.63,8.96,1967778,1967869
3056,104,27,0,4.92,18.38,1967868,1967972
3057,106,17,0,4.83,14.52,1967971,1968077
3058,108,16,0,4.74,9.97,1968076,1968184
3059,105,15,0,4.88,8.13,1968183,1968288
3060,93,15,1,5.51,10.68,1968287,1968380
3061,88,20,1,5.82,10.90,1968379,1968467
3062,101,15,0,5.07,8.24,1968466,1968567
3063,78,32,0,6.56,19.09,1968566,1968644
3064,99,21,0,5.17,15.48,1968643,1968742
3065,120,16,0,4.27,10.53,1968741,1968861
3066,89,18,0,5.75,13.71,1968860,1968949
3067,96,13,1,5.33,9.39,1968948,1969044
3068,79,24,0,6.48,20.68,1969043,1969122
3069,100,19,0,5.12,10.47,1969121,1969221
3070,89,28,0,5.75,17.31,1969220,1969309
3071,102,14,1,5.02,8.47,1969308,1969410
3072,96,72,0,5.33,63.03,1969409,1969505
3073,121,13,0,4.23,9.00,1969504,1969625
3074,92,21,0,5.57,15.16,1969624,1969716
3075,103,12,1,4.97,5.37,1969715,1969818
3076,84,35,1,6.10,17.99,1969818,1969902
3077,82,24,1,6.24,13.14,1969901,1969983
3078,90,18,1,5.69,10.64,1969982,1970072
3079,116,15,1,4.41,6.71,1970071,1970187
3080,91,26,1,5.63,14.28,1970186,1970277
3081,82,19,0,6.24,12.72,1970276,1970358
3082,98,21,0,5.22,12.66,1970357,1970455
3083,110,19,0,4.65,9.72,1970454,1970564
3084,96,33,0,5.33,17.83,1970563,1970659
3085,111,14,1,4.61,7.80,1970658,1970769
3086,95,19,1,5.39,13.67,1970768,1970863
3087,91,20,0,5.63,13.33,1970862,1970953
3088,77,32,1,6.65,20.05,1970953,1971030
3089,89,15,1,5.75,9.96,1971029,1971118
3090,104,16,0,4.92,10.34,1971117,1971221
3091,109,18,0,4.70,9.48,1971220,1971329
3092,88,19,1,5.82,13.42,1971328,1971416
3093,94,15,0,5.45,9.01,1971415,1971509
3094,119,20,0,4.30,14.13,1971508,1971627
3095,88,27,0,5.82,18.74,1971627,1971715
3096,111,20,1,4.61,9.70,1971714,1971825
3097,86,23,0,5.95,12.04,1971824,1971910
3098,88,17,1,5.82,8.69,1971909,1971997
3099,81,19,1,6.32,16.42,1971996,1972077
3100,77,27,1,6.65,15.47,1972076,1972153
3101,89,15,0,5.75,9.51,1972153,1972242
3102,91,15,0,5.63,9.14,1972241,1972332
3103,93,20,0,5.51,11.54,1972332,1972425
3104,77,30,0,6.65,20.02,1972425,1972502
3105,89,18,1,5.75,12.57,1972501,1972590
3106,77,48,0,6.65,43.37,1972589,1972666
3107,101,17,0,5.07,15.53,1972665,1972766
3108,120,15,0,4.27,9.15,1972765,1972885
3109,110,12,0,4.65,6.35,1972885,1972995
3110,90,15,1,5.69,6.81,1972994,1973084
3111,103,11,1,4.97,6.94,1973083,1973186
3112,78,20,1,6.56,11.48,1973186,1973264
3113,87,18,1,5.89,9.60,1973263,1973350
3114,93,22,1,5.51,12.29,1973349,1973442
3115,98,17,0,5.22,10.73,1973441,1973539
3116,96,29,0,5.33,16.83,1973538,1973634
3117,89,16,1,5.75,9.38,1973633,1973722
3118,92,19,0,5.57,13.42,1973721,1973813
3119,115,22,0,4.45,15.36,1973812,1973927
3120,115,15,0,4.45,8.87,1973926,1974041
3121,93,32,1,5.51,16.90,1974040,1974133
3122,87,18,1,5.89,12.26,1974132,1974219
3123,91,18,0,5.63,12.32,1974218,1974309
3124,67,32,1,7.64,23.99,1974308,1974375
3125,91,14,0,5.63,8.59,1974374,1974465
3126,95,14,1,5.39,6.39,1974464,1974559
3127,101,16,1,5.07,8.40,1974559,1974660
3128,97,19,0,5.28,12.51,1974659,1974756
3129,99,25,0,5.17,19.50,1974756,1974855
3130,118,18,0,4.34,13.43,1974854,1974972
3131,125,21,0,4.10,13.00,1974971,1975096
3132,114,24,0,4.49,10.23,1975095,1975209
3133,93,18,1,5.51,10.68,1975208,1975301
3134,96,24,0,5.33,13.62,1975300,1975396
3135,82,45,2,6.24,31.14,1975395,1975477
3136,93,14,1,5.51,6.47,1975476,1975569
3137,91,22,0,5.63,17.90,1975569,1975660
3138,101,26,0,5.07,15.87,1975659,1975760
3139,91,21,0,5.63,16.06,1975759,1975850
3140,85,41,1,6.02,26.00,1975850,1975935
3141,124,24,0,4.13,13.40,1975934,1976058
3142,89,18,0,5.75,15.65,1976057,1976146
3143,102,22,0,5.02,12.22,1976145,1976247
3144,91,19,1,5.63,11.77,1976247,1976338
3145,99,12,1,5.17,7.76,1976337,1976436
3146,90,20,1,5.69,14.57,1976435,1976525
3147,77,26,1,6.65,16.02,1976524,1976601
3148,91,17,1,5.63,8.10,1976600,1976691
3149,85,15,0,6.02,11.13,1976690,1976775
3150,95,15,1,5.39,9.29,1976774,1976869
3151,81,44,0,6.32,30.79,1976868,1976949
3152,109,22,0,4.70,12.80,1976948,1977057
3153,113,16,0,4.53,12.41,1977056,1977169
3154,127,21,0,4.03,11.32,1977168,1977295
3155,118,11,0,4.34,5.82,1977294,1977412
3156,90,16,0,5.69,9.95,1977411,1977501
3157,86,19,1,5.95,10.79,1977500,1977586
3158,85,20,1,6.02,14.56,1977585,1977670
3159,84,24,0,6.10,12.01,1977669,1977753
3160,84,21,1,6.10,14.13,1977752,1977836
3161,90,16,1,5.69,7.64,1977835,1977925
3162,99,30,0,5.17,14.87,1977925,1978024
3163,104,16,0,4.92,9.69,1978023,1978127
3164,91,20,0,5.63,16.08,1978126,1978217
3165,114,19,0,4.49,11.14,1978217,1978331
3166,101,12,0,5.07,8.42,1978331,1978432
3167,101,16,1,5.07,9.49,1978431,1978532
3168,85,17,2,6.02,12.80,1978531,1978616
3169,94,16,1,5.45,9.93,1978615,1978709
3170,81,18,1,6.32,11.58,1978708,1978789
3171,104,17,0,4.92,7.99,1978788,1978892
3172,86,18,1,5.95,11.25,1978891,1978977
3173,102,22,0,5.02,12.80,1978976,1979078
3174,81,28,1,6.32,20.44,1979077,1979158
3175,85,26,0,6.02,16.99,1979158,1979243
3176,103,18,0,4.97,11.08,1979242,1979345
3177,97,21,0,5.28,19.83,1979344,1979441
3178,90,23,0,5.69,18.88,1979440,1979530
3179,111,18,0,4.61,8.40,1979529,1979640
3180,88,18,0,5.82,14.33,1979639,1979727
3181,78,28,1,6.56,18.58,1979726,1979804
3182,80,18,0,6.40,13.24,1979804,1979884
3183,85,24,1,6.02,13.79,1979883,1979968
3184,83,17,1,6.17,11.56,1979967,1980050
3185,88,26,0,5.82,14.19,1980049,1980137
3186,96,21,1,5.33,11.97,1980136,1980232
3187,97,12,0,5.28,8.80,1980231,1980328
3188,89,18,1,5.75,10.88,1980327,1980416
3189,115,16,0,4.45,12.89,1980416,1980531
3190,92,15,1,5.57,12.51,1980531,1980623
3191,100,18,0,5.12,9.25,1980622,1980722
3192,94,18,1,5.45,12.08,1980721,1980815
3193,98,32,1,5.22,15.62,1980814,1980912
3194,80,40,0,6.40,30.97,1980911,1980991
3195,62,36,1,8.26,35.84,1980990,1981052
3196,90,21,1,5.69,11.95,1981051,1981141
3197,90,21,0,5.69,9.95,1981140,1981230
3198,85,19,0,6.02,13.53,1981230,1981315
3199,93,16,1,5.51,8.57,1981314,1981407
3200,88,24,0,5.82,16.38,1981406,1981494
3201,94,19,0,5.45,17.91,1981494,1981588
3202,110,14,0,4.65,11.04,1981587,1981697
3203,111,19,0,4.61,10.98,1981696,1981807
3204,110,15,0,4.65,7.41,1981806,1981916
3205,72,21,1,7.11,15.63,1981916,1981988
3206,88,19,1,5.82,11.19,1981988,1982076
3207,90,22,0,5.69,13.19,1982075,1982165
3208,84,15,1,6.10,10.71,1982164,1982248
3209,90,20,0,5.69,13.33,1982247,1982337
3210,100,27,1,5.12,12.61,1982336,1982436
3211,91,17,0,5.63,11.71,1982435,1982526
3212,104,16,0,4.92,12.21,1982525,1982629
3213,104,17,0,4.92,11.65,1982629,1982733
3214,91,27,0,5.63,19.60,1982732,1982823
3215,104,18,0,4.92,10.55,1982823,1982927
3216,92,16,1,5.57,9.48,1982926,1983018
3217,90,19,1,5.69,12.70,1983018,1983108
3218,85,30,1,6.02,16.05,1983107,1983192
3219,89,19,1,5.75,11.22,1983191,1983280
3220,86,19,1,5.95,9.93,1983279,1983365
3221,96,17,0,5.33,10.76,1983364,1983460
3222,96,19,0,5.33,11.58,1983459,1983555
3223,85,21,1,6.02,14.02,1983554,1983639
3224,103,12,0,4.97,9.80,1983638,1983741
3225,105,31,0,4.88,17.56,1983740,1983845
3226,122,19,0,4.20,8.76,1983844,1983966
3227,112,15,0,4.57,7.57,1983965,1984077
3228,89,17,1,5.75,14.10,1984076,1984165
3229,87,31,0,5.89,22.45,1984165,1984252
3230,81,18,1,6.32,10.07,1984251,1984332
3231,78,19,0,6.56,14.66,1984331,1984409
3232,87,21,1,5.89,12.19,1984408,1984495
3233,94,14,1,5.45,9.46,1984494,1984588
3234,97,16,0,5.28,11.07,1984587,1984684
3235,79,37,1,6.48,27.19,1984683,1984762
3236,93,19,0,5.51,9.84,1984761,1984854
3237,115,18,0,4.45,12.02,1984853,1984968
3238,84,40,0,6.10,26.09,1984967,1985051
3239,102,13,0,5.02,8.45,1985050,1985152
3240,104,16,1,4.92,10.76,1985151,1985255
3241,93,20,1,5.51,11.78,1985254,1985347
3242,81,23,0,6.32,14.44,1985346,1985427
3243,82,18,1,6.24,15.18,1985426,1985508
3244,73,17,1,7.01,13.47,1985507,1985580
3245,80,63,1,6.40,49.52,1985580,1985660
3246,100,13,0,5.12,10.21,1985659,1985759
3247,85,16,0,6.02,13.32,1985758,1985843
3248,82,34,1,6.24,18.38,1985843,1985925
3249,107,21,0,4.79,15.33,1985924,1986031
3250,115,32,0,4.45,14.18,1986030,1986145
3251,109,15,0,4.70,8.36,1986145,1986254
3252,92,17,1,5.57,11.68,1986253,1986345
3253,94,19,0,5.45,11.61,1986344,1986438
3254,88,30,1,5.82,17.35,1986437,1986525
3255,86,22,0,5.95,12.02,1986524,1986610
3256,86,21,1,5.95,14.21,1986609,1986695
3257,87,20,1,5.89,11.41,1986694,1986781
3258,91,14,1,5.63,9.11,1986780,1986871
3259,86,22,0,5.95,14.16,1986871,1986957
3260,87,14,0,5.89,9.27,1986956,1987043
3261,105,20,0,4.88,14.20,1987042,1987147
3262,121,14,0,4.23,10.11,1987147,1987268
3263,108,12,1,4.74,7.53,1987267,1987375
3264,91,19,0,5.63,14.28,1987374,1987465
3265,94,22,1,5.45,12.14,1987464,1987558
3266,85,18,0,6.02,11.72,1987557,1987642
3267,83,16,1,6.17,9.32,1987641,1987724
3268,80,23,1,6.40,13.79,1987723,1987803
3269,89,21,1,5.75,11.44,1987803,1987892
3270,97,35,0,5.28,18.16,1987891,1987988
3271,91,25,0,5.63,19.31,1987988,1988079
3272,79,28,0,6.48,24.27,1988078,1988157
3273,115,26,0,4.45,17.08,1988156,1988271
3274,104,20,0,4.92,12.19,1988270,1988374
3275,125,13,1,4.10,6.25,1988374,1988499
3276,86,24,1,5.95,13.88,1988498,1988584
3277,86,24,1,5.95,13.46,1988583,1988669
3278,81,21,1,6.32,10.96,1988669,1988750
3279,72,31,1,7.11,25.57,1988750,1988822
3280,82,18,0,6.24,9.21,1988821,1988903
3281,79,23,1,6.48,14.73,1988902,1988981
3282,91,16,1,5.63,10.26,1988980,1989071
3283,96,17,1,5.33,10.18,1989070,1989166
3284,79,31,1,6.48,21.09,1989165,1989244
3285,99,22,0,5.17,19.76,1989243,1989342
3286,108,40,0,4.74,23.58,1989341,1989449
3287,110,15,0,4.65,8.55,1989449,1989559
3288,99,18,1,5.17,10.77,1989558,1989657
3289,86,16,0,5.95,10.60,1989656,1989742
3290,92,15,0,5.57,8.81,1989741,1989833
3291,78,28,0,6.56,21.76,1989832,1989910
3292,88,23,0,5.82,16.13,1989909,1989997
3293,89,16,1,5.75,10.59,1989996,1990085
3294,94,18,1,5.45,10.52,1990084,1990178
3295,82,31,0,6.24,25.96,1990177,1990259
3296,82,20,1,6.24,10.70,1990258,1990340
3297,82,36,0,6.24,28.36,1990339,1990421
3298,111,15,0,4.61,10.18,1990420,1990531
3299,99,32,0,5.17,16.77,1990530,1990629
3300,99,18,0,5.17,13.17,1990629,1990728
3301,95,18,1,5.39,10.32,1990727,1990822
3302,92,17,1,5.57,11.12,1990822,1990914
3303,79,31,2,6.48,18.45,1990913,1990992
3304,89,15,1,5.75,8.39,1990991,1991080
3305,91,23,1,5.63,9.75,1991079,1991170
3306,102,15,0,5.02,9.37,1991169,1991271
3307,77,23,1,6.65,17.14,1991270,1991347
3308,81,19,0,6.32,13.25,1991346,1991427
3309,101,16,0,5.07,10.82,1991426,1991527
3310,102,20,0,5.02,18.37,1991526,1991628
3311,110,14,1,4.65,8.90,1991627,1991737
3312,104,20,0,4.92,10.88,1991737,1991841
3313,88,17,1,5.82,11.17,1991840,1991928
3314,88,14,0,5.82,9.67,1991928,1992016
3315,65,23,2,7.88,19.52,1992015,1992080
3316,82,44,1,6.24,24.82,1992080,1992162
3317,89,15,1,5.75,7.96,1992161,1992250
3318,83,17,0,6.17,11.71,1992250,1992333
3319,97,25,0,5.28,12.04,1992332,1992429
3320,82,17,0,6.24,12.40,1992429,1992511
3321,92,20,0,5.57,15.83,1992510,1992602
3322,98,24,0,5.22,23.34,1992601,1992699
3323,98,27,0,5.22,20.52,1992698,1992796
3324,111,20,0,4.61,11.21,1992795,1992906
3325,93,18,1,5.51,10.40,1992905,1992998
3326,85,23,1,6.02,13.08,1992997,1993082
3327,96,19,1,5.33,10.53,1993082,1993178
3328,82,27,1,6.24,16.31,1993177,1993259
3329,87,15,1,5.89,8.95,1993259,1993346
3330,94,15,1,5.45,9.50,1993346,1993440
3331,99,17,1,5.17,10.95,1993439,1993538
3332,68,20,1,7.53,19.93,1993537,1993605
3333,82,18,0,6.24,11.18,1993604,1993686
3334,93,17,0,5.51,13.58,1993685,1993778
3335,96,22,0,5.33,15.70,1993777,1993873
3336,98,23,0,5.22,14.60,1993872,1993970
3337,91,20,1,5.63,12.45,1993969,1994060
3338,94,15,0,5.45,8.29,1994059,1994153
3339,92,16,1,5.57,9.05,1994152,1994244
3340,83,18,1,6.17,11.95,1994243,1994326
3341,86,14,1,5.95,10.09,1994325,1994411
3342,104,18,0,4.92,8.42,1994411,1994515
3343,91,17,0,5.63,11.88,1994514,1994605
3344,92,20,1,5.57,13.81,1994604,1994696
3345,95,16,0,5.39,11.10,1994695,1994790
3346,119,15,0,4.30,10.88,1994789,1994908
3347,103,23,0,4.97,19.74,1994907,1995010
3348,115,11,0,4.45,6.79,1995009,1995124
3349,93,20,1,5.51,12.10,1995123,1995216
3350,77,20,0,6.65,14.41,1995215,1995292
3351,95,15,0,5.39,10.64,1995291,1995386
3352,79,20,1,6.48,11.29,1995385,1995464
3353,86,15,1,5.95,10.53,1995463,1995549
3354,84,21,1,6.10,15.59,1995548,1995632
3355,98,17,0,5.22,10.60,1995631,1995729
3356,80,19,2,6.40,11.21,1995728,1995808
3357,86,30,0,5.95,16.16,1995807,1995893
3358,106,26,0,4.83,14.71,1995892,1995998
3359,102,20,0,5.02,13.39,1995998,1996100
3360,102,20,0,5.02,12.41,1996099,1996201
3361,97,31,0,5.28,20.16,1996200,1996297
3362,84,19,1,6.10,15.78,1996296,1996380
3363,97,22,0,5.28,13.62,1996380,1996477
3364,79,24,0,6.48,13.72,1996476,1996555
3365,82,20,1,6.24,14.84,1996554,1996636
3366,92,17,0,5.57,12.48,1996635,1996727
3367,83,37,1,6.17,19.95,1996726,1996809
3368,88,24,1,5.82,14.97,1996808,1996896
3369,82,17,1,6.24,13.48,1996895,1996977
3370,97,23,0,5.28,19.58,1996976,1997073
3371,105,21,0,4.88,13.98,1997072,1997177
3372,124,14,0,4.13,7.14,1997176,1997300
3373,91,14,1,5.63,10.89,1997300,1997391
3374,95,19,1,5.39,11.04,1997390,1997485
3375,99,12,1,5.17,8.06,1997484,1997583
3376,79,14,2,6.48,8.58,1997582,1997661
3377,87,22,0,5.89,14.26,1997661,1997748
3378,96,17,0,5.33,9.89,1997747,1997843
3379,86,21,0,5.95,14.02,1997843,1997929
3380,87,25,1,5.89,13.96,1997928,1998015
3381,71,47,1,7.21,59.15,1998014,1998085
3382,103,16,0,4.97,14.24,1998084,1998187
3383,108,22,0,4.74,16.08,1998186,1998294
3384,98,17,1,5.22,11.58,1998293,1998391
3385,97,16,0,5.28,10.24,1998390,1998487
3386,88,25,0,5.82,13.81,1998486,1998574
3387,96,21,1,5.33,10.58,1998573,1998669
3388,80,22,1,6.40,17.16,1998668,1998748
3389,95,16,0,5.39,8.13,1998747,1998842
3390,81,22,1,6.32,14.17,1998841,1998922
3391,93,15,1,5.51,8.70,1998921,1999014
3392,84,29,1,6.10,23.63,1999013,1999097
3393,90,34,1,5.69,15.93,1999096,1999186
3394,110,16,0,4.65,12.50,1999185,1999295
3395,103,20,0,4.97,15.21,1999294,1999397
3396,101,23,0,5.07,12.12,1999396,1999497
3397,89,17,0,5.75,14.41,1999496,1999585
3398,89,18,0,5.75,9.58,1999584,1999673
3399,85,15,2,6.02,9.27,1999672,1999757
3400,78,36,1,6.56,25.84,1999757,1999835
3401,68,24,2,7.53,18.63,1999834,1999902
3402,91,14,0,5.63,9.27,1999901,1999992
3403,98,14,1,5.22,8.85,1999991,2000089
3404,96,17,1,5.33,11.87,2000088,2000184
3405,92,22,1,5.57,12.46,2000183,2000275
3406,106,20,0,4.83,14.44,2000274,2000380
3407,105,22,0,4.88,15.56,2000379,2000484
3408,98,22,1,5.22,16.64,2000483,2000581
3409,108,17,1,4.74,8.47,2000580,2000688
3410,87,14,0,5.89,9.85,2000688,2000775
3411,90,22,1,5.69,12.88,2000774,2000864
3412,75,22,1,6.83,18.65,2000864,2000939
3413,88,22,0,5.82,15.29,2000938,2001026
3414,80,21,0,6.40,13.64,2001025,2001105
3415,94,19,0,5.45,14.29,2001104,2001198
3416,79,14,1,6.48,11.06,2001198,2001277
3417,78,21,1,6.56,19.45,2001276,2001354
3418,104,17,0,4.92,12.15,2001353,2001457
3419,91,21,0,5.63,23.62,2001457,2001548
3420,93,19,0,5.51,15.71,2001547,2001640
3421,101,14,1,5.07,6.86,2001639,2001740
3422,88,30,1,5.82,25.33,2001739,2001827
3423,83,30,1,6.17,15.47,2001826,2001909
3424,79,19,1,6.48,14.76,2001908,2001987
3425,81,26,1,6.32,16.96,2001986,2002067
3426,90,24,1,5.69,12.99,2002066,2002156
3427,93,19,1,5.51,9.45,2002156,2002249
3428,84,46,0,6.10,33.13,2002248,2002332
3429,79,25,1,6.48,17.87,2002331,2002410
3430,89,18,0,5.75,11.53,2002409,2002498
3431,101,21,0,5.07,22.02,2002497,2002598
3432,86,26,0,5.95,24.25,2002597,2002683
3433,111,13,0,4.61,9.35,2002682,2002793
3434,106,16,1,4.83,8.16,2002792,2002898
3435,101,23,1,5.07,13.77,2002897,2002998
3436,82,15,1,6.24,10.09,2002997,2003079
3437,83,22,1,6.17,13.35,2003079,2003162
3438,69,69,1,7.42,73.63,2003161,2003230
3439,87,19,0,5.89,11.80,2003230,2003317
3440,99,14,0,5.17,9.94,2003316,2003415
3441,84,22,1,6.10,12.61,2003415,2003499
3442,78,25,1,6.56,21.91,2003498,2003576
3443,100,18,0,5.12,10.47,2003575,2003675
3444,107,16,0,4.79,11.74,2003674,2003781
3445,104,62,0,4.92,39.32,2003780,2003884
3446,99,16,0,5.17,9.54,2003883,2003982
3447,86,20,0,5.95,16.42,2003981,2004067
3448,79,24,0,6.48,16.07,2004066,2004145
3449,104,19,0,4.92,10.28,2004144,2004248
3450,58,69,1,8.83,139.66,2004247,2004305
3451,83,23,0,6.17,16.41,2004304,2004387
3452,83,34,0,6.17,25.10,2004386,2004469
3453,97,13,0,5.28,7.99,2004468,2004565
3454,89,17,1,5.75,11.15,2004565,2004654
3455,94,28,1,5.45,16.01,2004654,2004748
3456,113,16,0,4.53,11.08,2004747,2004860
3457,94,32,0,5.45,24.93,2004860,2004954
3458,109,20,0,4.70,10.01,2004954,2005063
3459,92,27,1,5.57,16.51,2005062,2005154
3460,86,20,0,5.95,14.02,2005153,2005239
3461,96,14,0,5.33,8.24,2005239,2005335
3462,72,16,0,7.11,12.74,2005335,2005407
3463,84,21,1,6.10,11.30,2005407,2005491
3464,89,16,0,5.75,9.98,2005490,2005579
3465,101,15,0,5.07,8.12,2005579,2005680
3466,91,19,1,5.63,11.79,2005679,2005770
3467,94,30,0,5.45,16.86,2005769,2005863
3468,104,19,0,4.92,14.01,2005863,2005967
3469,109,17,0,4.70,13.06,2005966,2006075
3470,102,13,1,5.02,6.74,2006074,2006176
3471,88,29,1,5.82,20.31,2006175,2006263
3472,100,13,0,5.12,8.27,2006262,2006362
3473,77,28,1,6.65,17.73,2006362,2006439
3474,88,20,1,5.82,11.22,2006438,2006526
3475,94,15,0,5.45,8.65,2006525,2006619
3476,92,13,1,5.57,8.48,2006618,2006710
3477,75,23,1,6.83,15.88,2006709,2006784
3478,99,17,0,5.17,11.60,2006784,2006883
3479,103,14,0,4.97,8.90,2006882,2006985
3480,112,18,0,4.57,11.76,2006984,2007096
3481,108,16,0,4.74,12.14,2007095,2007203
3482,108,13,0,4.74,9.47,2007202,2007310
3483,78,97,0,6.56,116.30,2007309,2007387
3484,96,16,1,5.33,9.49,2007386,2007482
3485,83,16,1,6.17,9.80,2007481,2007564
3486,74,34,2,6.92,19.18,2007563,2007637
3487,95,15,1,5.39,8.49,2007636,2007731
3488,93,21,1,5.51,14.47,2007730,2007823
3489,96,15,0,5.33,10.66,2007822,2007918
3490,81,31,0,6.32,22.12,2007917,2007998
3491,97,15,0,5.28,11.77,2007998,2008095
3492,111,20,0,4.61,14.09,2008094,2008205
3493,107,24,0,4.79,14.80,2008204,2008311
3494,106,28,0,4.83,12.93,2008310,2008416
3495,84,42,1,6.10,25.87,2008416,2008500
3496,85,21,0,6.02,13.91,2008499,2008584
3497,79,25,1,6.48,23.72,2008583,2008662
3498,81,17,0,6.32,10.81,2008661,2008742
3499,84,29,1,6.10,16.40,2008741,2008825
3500,86,16,1,5.95,10.90,2008824,2008910
3501,94,21,0,5.45,11.57,2008909,2009003
3502,87,21,0,5.89,14.45,2009002,2009089
3503,96,23,0,5.33,14.60,2009088,2009184
3504,113,16,0,4.53,10.92,2009184,2009297
3505,99,16,0,5.17,10.67,2009296,2009395
3506,100,19,0,5.12,13.07,2009394,2009494
3507,99,17,1,5.17,8.36,2009494,2009593
3508,78,22,1,6.56,18.84,2009592,2009670
3509,91,17,1,5.63,9.22,2009669,2009760
3510,75,23,1,6.83,17.45,2009759,2009834
3511,84,23,0,6.10,11.94,2009833,2009917
3512,88,22,1,5.82,13.47,2009916,2010004
3513,101,18,1,5.07,9.25,2010003,2010104
3514,76,23,1,6.74,21.30,2010103,2010179
3515,82,16,0,6.24,10.36,2010178,2010260
3516,114,20,0,4.49,13.18,2010259,2010373
3517,100,18,0,5.12,14.59,2010372,2010472
3518,100,16,0,5.12,10.31,2010472,2010572
3519,96,28,0,5.33,15.24,2010571,2010667
3520,86,20,1,5.95,15.14,2010666,2010752
3521,78,29,1,6.56,20.50,2010752,2010830
3522,67,23,0,7.64,19.36,2010829,2010896
3523,77,22,1,6.65,19.86,2010896,2010973
3524,88,18,0,5.82,10.67,2010972,2011060
3525,81,18,1,6.32,16.24,2011059,2011140
3526,81,23,1,6.32,15.70,2011139,2011220
3527,86,17,1,5.95,13.95,2011219,2011305
3528,82,29,1,6.24,18.89,2011305,2011387
3529,93,48,0,5.51,34.47,2011386,2011479
3530,84,24,1,6.10,22.73,2011479,2011563
3531,95,16,1,5.39,11.50,2011562,2011657
3532,108,12,1,4.74,6.78,2011656,2011764
3533,85,19,1,6.02,11.58,2011763,2011848
3534,90,15,1,5.69,9.61,2011847,2011937
3535,75,17,1,6.83,13.66,2011936,2012011
3536,79,19,1,6.48,10.81,2012010,2012089
3537,97,15,0,5.28,7.75,2012088,2012185
3538,94,14,0,5.45,8.46,2012184,2012278
3539,78,20,1,6.56,18.04,2012277,2012355
3540,90,19,0,5.69,13.99,2012354,2012444
3541,102,20,0,5.02,14.65,2012443,2012545
3542,102,21,0,5.02,15.10,2012544,2012646
3543,98,14,0,5.22,9.19,2012645,2012743
3544,101,14,0,5.07,9.47,2012742,2012843
3545,75,29,1,6.83,18.38,2012842,2012917
3546,87,21,1,5.89,12.19,2012916,2013003
3547,83,16,1,6.17,11.90,2013002,2013085
3548,75,17,1,6.83,12.86,2013084,2013159
3549,89,17,0,5.75,10.12,2013158,2013247
3550,102,13,0,5.02,6.18,2013246,2013348
3551,91,17,1,5.63,9.60,2013347,2013438
3552,85,21,1,6.02,13.62,2013438,2013523
3553,86,25,0,5.95,17.72,2013522,2013608
3554,106,47,0,4.83,28.46,2013607,2013713
3555,110,27,0,4.65,14.57,2013712,2013822
3556,101,15,1,5.07,7.67,2013821,2013922
3557,103,19,0,4.97,11.60,2013921,2014024
3558,86,19,1,5.95,13.39,2014023,2014109
3559,91,19,0,5.63,12.12,2014108,2014199
3560,88,18,0,5.82,9.92,2014198,2014286
3561,80,32,0,6.40,25.74,2014285,2014365
3562,89,15,0,5.75,9.49,2014365,2014454
3563,96,48,1,5.33,31.14,2014453,2014549
3564,81,24,1,6.32,20.59,2014548,2014629
3565,100,24,0,5.12,14.17,2014629,2014729
3566,103,21,0,4.97,14.32,2014729,2014832
3567,115,24,0,4.45,13.33,2014831,2014946
3568,100,13,1,5.12,9.61,2014946,2015046
3569,98,25,0,5.22,11.26,2015045,2015143
3570,79,18,1,6.48,13.24,2015143,2015222
3571,92,17,0,5.57,11.07,2015221,2015313
3572,83,16,0,6.17,10.48,2015312,2015395
3573,96,14,1,5.33,10.03,2015394,2015490
3574,95,20,0,5.39,12.85,2015489,2015584
3575,71,29,1,7.21,16.28,2015584,2015655
3576,94,17,0,5.45,12.80,2015654,2015748
3577,104,19,0,4.92,15.38,2015747,2015851
3578,107,17,0,4.79,12.39,2015850,2015957
3579,89,18,0,5.75,13.69,2015956,2016045
3580,118,16,0,4.34,8.55,2016044,2016162
3581,93,23,0,5.51,18.27,2016161,2016254
3582,80,22,1,6.40,14.26,2016253,2016333
3583,84,21,0,6.10,13.42,2016332,2016416
3584,88,17,1,5.82,9.38,2016415,2016503
3585,89,27,1,5.75,16.61,2016502,2016591
3586,81,19,0,6.32,13.63,2016590,2016671
3587,101,30,0,5.07,15.13,2016670,2016771
3588,81,17,0,6.32,13.70,2016771,2016852
3589,97,19,1,5.28,13.46,2016851,2016948
3590,92,16,0,5.57,12.81,2016947,2017039
3591,80,42,0,6.40,31.79,2017039,2017119
3592,86,27,0,5.95,22.18,2017118,2017204
3593,104,19,0,4.92,14.65,2017203,2017307
3594,109,20,0,4.70,8.14,2017306,2017415
3595,100,15,1,5.12,10.45,2017414,2017514
3596,80,17,0,6.40,10.91,2017514,2017594
3597,91,14,0,5.63,9.66,2017593,2017684
3598,85,18,1,6.02,12.82,2017683,2017768
3599,82,16,0,6.24,11.55,2017767,2017849
3600,94,15,1,5.45,8.67,2017848,2017942
3601,95,18,0,5.39,10.17,2017941,2018036
3602,94,16,0,5.45,11.80,2018036,2018130
3603,88,19,0,5.82,14.79,2018129,2018217
3604,93,17,0,5.51,12.29,2018216,2018309
3605,126,20,0,4.06,11.08,2018308,2018434
3606,79,25,0,6.48,24.53,2018433,2018512
3607,92,16,0,5.57,11.01,2018511,2018603
3608,105,12,1,4.88,6.53,2018602,2018707
3609,84,37,0,6.10,24.90,2018707,2018791
3610,86,15,1,5.95,11.97,2018790,2018876
3611,87,21,1,5.89,11.34,2018875,2018962
3612,72,22,1,7.11,16.60,2018961,2019033
3613,84,47,0,6.10,30.28,2019032,2019116
3614,80,23,1,6.40,14.32,2019115,2019195
3615,91,19,0,5.63,10.10,2019194,2019285
3616,87,23,0,5.89,18.79,2019284,2019371
3617,90,14,0,5.69,9.64,2019370,2019460
3618,90,15,0,5.69,11.17,2019459,2019549
3619,85,23,0,6.02,22.61,2019548,2019633
3620,112,19,0,4.57,12.92,2019633,2019745
3621,121,15,0,4.23,7.65,2019744,2019865
3622,103,18,0,4.97,9.85,2019864,2019967
3623,89,24,0,5.75,18.37,2019966,2020055
3624,85,31,1,6.02,24.09,2020054,2020139
3625,79,57,1,6.48,45.87,2020139,2020218
3626,87,14,1,5.89,9.60,2020217,2020304
3627,79,52,1,6.48,46.07,2020304,2020383
3628,81,23,1,6.32,13.82,2020383,2020464
3629,83,20,1,6.17,13.03,2020463,2020546
3630,87,18,1,5.89,15.46,2020545,2020632
3631,98,11,0,5.22,8.26,2020631,2020729
3632,77,27,0,6.65,20.85,2020728,2020805
3633,111,18,0,4.61,10.87,2020804,2020915
3634,100,19,0,5.12,16.59,2020914,2021014
3635,120,15,1,4.27,9.45,2021013,2021133
3636,97,17,0,5.28,11.83,2021132,2021229
3637,100,17,0,5.12,9.27,2021228,2021328
3638,84,18,1,6.10,11.13,2021327,2021411
3639,75,24,1,6.83,20.81,2021410,2021485
3640,85,15,1,6.02,9.67,2021484,2021569
3641,81,27,0,6.32,20.81,2021568,2021649
3642,85,14,1,6.02,7.81,2021648,2021733
3643,90,20,0,5.69,13.19,2021732,2021822
3644,93,18,1,5.51,11.17,2021822,2021915
3645,76,18,1,6.74,15.11,2021914,2021990
3646,92,18,0,5.57,11.59,2021989,2022081
3647,102,15,0,5.02,10.29,2022080,2022182
3648,103,30,0,4.97,20.86,2022181,2022284
3649,103,22,0,4.97,13.78,2022283,2022386
3650,102,20,0,5.02,10.20,2022385,2022487
3651,93,16,1,5.51,11.60,2022486,2022579
3652,95,15,0,5.39,11.84,2022578,2022673
3653,87,20,1,5.89,11.44,2022672,2022759
3654,71,20,1,7.21,15.83,2022758,2022829
3655,83,22,1,6.17,16.38,2022828,2022911
3656,76,24,1,6.74,16.33,2022910,2022986
3657,88,22,1,5.82,11.94,2022985,2023073
3658,97,34,0,5.28,20.65,2023073,2023170
3659,93,17,0,5.51,9.30,2023170,2023263
3660,72,26,1,7.11,28.79,2023262,2023334
3661,98,15,0,5.22,12.17,2023333,2023431
3662,107,25,0,4.79,14.94,2023430,2023537
3663,99,16,0,5.17,11.33,2023536,2023635
3664,112,14,0,4.57,10.21,2023634,2023746
3665,101,17,0,5.07,11.71,2023745,2023846
3666,84,18,0,6.10,14.18,2023845,2023929
3667,64,29,1,8.00,26.12,2023928,2023992
3668,83,20,0,6.17,14.19,2023991,2024074
3669,69,45,1,7.42,30.74,2024073,2024142
3670,95,15,0,5.39,9.69,2024141,2024236
3671,90,15,0,5.69,10.59,2024235,2024325
3672,87,19,1,5.89,14.49,2024324,2024411
3673,87,32,1,5.89,22.61,2024411,2024498
3674,86,24,1,5.95,15.23,2024497,2024583
3675,91,16,1,5.63,13.88,2024582,2024673
3676,111,17,0,4.61,12.47,2024672,2024783
3677,81,30,1,6.32,17.23,2024782,2024863
3678,113,17,0,4.53,9.84,2024862,2024975
3679,97,20,0,5.28,13.81,2024974,2025071
3680,86,29,1,5.95,20.14,2025070,2025156
3681,90,25,1,5.69,13.48,2025155,2025245
3682,77,23,1,6.65,20.44,2025244,2025321
3683,72,32,1,7.11,19.85,2025320,2025392
3684,85,15,1,6.02,9.95,2025391,2025476
3685,86,18,0,5.95,13.67,2025476,2025562
3686,83,29,1,6.17,15.92,2025561,2025644
3687,90,20,0,5.69,15.41,2025643,2025733
3688,90,23,1,5.69,13.75,2025732,2025822
3689,95,18,0,5.39,11.77,2025821,2025916
3690,94,43,0,5.45,27.89,2025915,2026009
3691,106,37,0,4.83,22.69,2026008,2026114
3692,82,22,0,6.24,17.84,2026113,2026195
3693,112,17,1,4.57,7.80,2026194,2026306
3694,106,20,0,4.83,13.93,2026305,2026411
3695,89,18,0,5.75,9.80,2026410,2026499
3696,74,30,1,6.92,25.70,2026499,2026573
3697,81,38,0,6.32,22.66,2026573,2026654
3698,71,22,0,7.21,18.87,2026653,2026724
3699,76,21,0,6.74,15.33,2026723,2026799
3700,83,18,1,6.17,11.18,2026798,2026881
3701,84,19,1,6.10,14.56,2026880,2026964
3702,91,18,1,5.63,15.16,2026963,2027054
3703,84,16,0,6.10,13.75,2027053,2027137
3704,78,40,1,6.56,33.94,2027137,2027215
3705,93,27,0,5.51,17.54,2027214,2027307
3706,100,17,0,5.12,13.83,2027306,2027406
3707,97,24,0,5.28,19.97,2027405,2027502
3708,110,17,0,4.65,8.81,2027501,2027611
3709,111,15,0,4.61,10.31,2027611,2027722
3710,83,14,0,6.17,11.61,2027722,2027805
3711,85,17,1,6.02,11.69,2027804,2027889
3712,77,22,1,6.65,17.42,2027888,2027965
3713,70,29,1,7.31,28.44,2027964,2028034
3714,86,24,0,5.95,16.90,2028033,2028119
3715,86,16,1,5.95,10.88,2028118,2028204
3716,90,16,0,5.69,12.33,2028203,2028293
3717,83,33,1,6.17,17.90,2028293,2028376
3718,75,22,1,6.83,15.34,2028375,2028450
3719,98,36,0,5.22,20.11,2028449,2028547
3720,101,29,0,5.07,21.09,2028547,2028648
3721,86,40,0,5.95,24.86,2028647,2028733
3722,99,16,0,5.17,10.87,2028732,2028831
3723,107,15,1,4.79,5.66,2028830,2028937
3724,86,20,1,5.95,13.53,2028936,2029022
3725,85,23,0,6.02,16.33,2029021,2029106
3726,87,20,0,5.89,13.99,2029105,2029192
3727,85,16,1,6.02,10.07,2029191,2029276
3728,88,13,0,5.82,7.33,2029275,2029363
3729,79,18,1,6.48,12.25,2029363,2029442
3730,90,23,1,5.69,10.75,2029441,2029531
3731,86,41,1,5.95,29.23,2029530,2029616
3732,88,17,0,5.82,13.19,2029615,2029703
3733,74,18,0,6.92,17.67,2029702,2029776
3734,113,15,0,4.53,9.38,2029775,2029888
3735,112,27,0,4.57,18.42,2029887,2029999
3736,107,25,0,4.79,13.79,2029998,2030105
3737,113,20,0,4.53,9.86,2030104,2030217
3738,85,18,1,6.02,13.13,2030217,2030302
3739,89,16,0,5.75,8.97,2030301,2030390
3740,83,26,1,6.17,17.35,2030389,2030472
3741,85,20,1,6.02,15.43,2030471,2030556
3742,84,23,0,6.10,15.75,2030555,2030639
3743,94,15,1,5.45,8.84,2030638,2030732
3744,97,24,1,5.28,15.58,2030731,2030828
3745,80,29,1,6.40,20.19,2030828,2030908
3746,85,22,0,6.02,16.33,2030908,2030993
3747,103,23,0,4.97,13.68,2030992,2031095
3748,102,39,0,5.02,25.12,2031094,2031196
3749,84,35,0,6.10,22.59,2031195,2031279
3750,106,15,0,4.83,10.42,2031278,2031384
3751,103,13,1,4.97,7.74,2031383,2031486
3752,98,20,0,5.22,13.73,2031485,2031583
3753,79,25,1,6.48,12.73,2031582,2031661
3754,87,35,0,5.89,19.85,2031660,2031747
3755,77,35,2,6.65,21.50,2031746,2031823
3756,82,15,1,6.24,9.28,2031822,2031904
3757,85,26,1,6.02,17.98,2031903,2031988
3758,84,27,1,6.10,19.56,2031987,2032071
3759,85,18,0,6.02,14.71,2032071,2032156
3760,66,22,0,7.76,22.30,2032156,2032222
3761,105,13,0,4.88,9.25,2032221,2032326
3762,92,19,0,5.57,15.38,2032326,2032418
3763,111,19,0,4.61,12.76,2032417,2032528
3764,90,19,0,5.69,12.75,2032528,2032618
3765,103,21,0,4.97,15.78,2032618,2032721
3766,91,24,0,5.63,17.88,2032720,2032811
3767,90,24,0,5.69,13.35,2032810,2032900
3768,89,25,0,5.75,13.17,2032899,2032988
3769,81,29,1,6.32,20.39,2032987,2033068
3770,85,20,2,6.02,10.28,2033067,2033152
3771,84,22,1,6.10,14.59,2033151,2033235
3772,83,18,1,6.17,13.54,2033234,2033317
3773,84,31,0,6.10,27.32,2033316,2033400
3774,82,33,1,6.24,17.57,2033400,2033482
3775,85,19,1,6.02,14.87,2033481,2033566
3776,88,20,1,5.82,12.54,2033565,2033653
3777,83,20,0,6.17,18.02,2033652,2033735
3778,93,31,0,5.51,24.29,2033734,2033827
3779,94,21,0,5.45,18.33,2033826,2033920
3780,106,16,0,4.83,9.22,2033919,2034025
3781,101,17,0,5.07,13.11,2034024,2034125
3782,86,22,1,5.95,13.93,2034124,2034210
3783,90,22,1,5.69,11.86,2034209,2034299
3784,78,21,1,6.56,17.86,2034298,2034376
3785,79,32,1,6.48,21.90,2034375,2034454
3786,81,35,1,6.32,19.58,2034453,2034534
3787,77,19,0,6.65,16.41,2034533,2034610
3788,92,24,1,5.57,15.94,2034609,2034701
3789,90,17,0,5.69,12.46,2034701,2034791
3790,83,14,1,6.17,8.60,2034790,2034873
3791,80,19,1,6.40,15.19,2034872,2034952
3792,87,30,0,5.89,24.54,2034951,2035038
3793,93,25,0,5.51,22.42,2035037,2035130
3794,96,26,0,5.33,19.66,2035129,2035225
3795,96,29,0,5.33,17.37,2035224,2035320
3796,87,21,0,5.89,18.93,2035319,2035406
3797,98,14,1,5.22,7.81,2035405,2035503
3798,91,24,1,5.63,15.60,2035502,2035593
3799,78,25,0,6.56,14.71,2035592,2035670
3800,76,14,1,6.74,8.14,2035669,2035745
3801,87,14,1,5.89,9.71,2035744,2035831
3802,87,26,0,5.89,15.00,2035830,2035917
3803,75,80,1,6.83,85.69,2035916,2035991
3804,79,16,1,6.48,10.15,2035990,2036069
3805,91,19,0,5.63,11.86,2036068,2036159
3806,87,23,0,5.89,16.61,2036158,2036245
3807,114,17,0,4.49,11.95,2036244,2036358
3808,73,27,1,7.01,26.59,2036357,2036430
3809,107,19,0,4.79,15.01,2036429,2036536
3810,100,25,1,5.12,13.69,2036535,2036635
3811,90,19,1,5.69,16.39,2036634,2036724
3812,82,17,1,6.24,11.94,2036724,2036806
3813,89,17,0,5.75,9.60,2036805,2036894
3814,81,36,0,6.32,21.77,2036893,2036974
3815,79,28,0,6.48,16.12,2036973,2037052
3816,87,17,0,5.89,9.37,2037051,2037138
3817,84,15,1,6.10,10.51,2037137,2037221
3818,96,18,0,5.33,10.47,2037221,2037317
3819,67,50,1,7.64,39.99,2037317,2037384
3820,83,19,0,6.17,11.90,2037383,2037466
3821,92,21,1,5.57,11.51,2037465,2037557
3822,100,22,0,5.12,15.05,2037556,2037656
3823,77,24,0,6.65,21.66,2037655,2037732
3824,100,22,0,5.12,16.27,2037731,2037831
3825,109,17,1,4.70,5.68,2037830,2037939
3826,92,22,1,5.57,13.88,2037938,2038030
3827,90,19,1,5.69,10.53,2038029,2038119
3828,85,17,0,6.02,9.69,2038118,2038203
3829,78,22,2,6.56,16.81,2038202,2038280
3830,83,17,0,6.17,9.85,2038279,2038362
3831,87,23,0,5.89,14.15,2038361,2038448
3832,81,23,1,6.32,15.58,2038447,2038528
3833,86,15,1,5.95,9.86,2038527,2038613
3834,83,26,0,6.17,15.56,2038612,2038695
3835,68,25,1,7.53,25.10,2038694,2038762
3836,66,24,1,7.76,26.12,2038761,2038827
3837,123,17,0,4.16,9.96,2038826,2038949
3838,88,23,1,5.82,15.10,2038948,2039036
3839,115,26,0,4.45,11.71,2039035,2039150
3840,93,26,0,5.51,15.56,2039149,2039242
3841,94,16,1,5.45,7.23,2039242,2039336
3842,89,14,1,5.75,10.77,2039335,2039424
3843,83,22,1,6.17,14.31,2039423,2039506
3844,79,19,0,6.48,12.73,2039506,2039585
3845,87,18,0,5.89,12.06,2039584,2039671
3846,95,16,0,5.39,8.72,2039671,2039766
3847,83,25,1,6.17,22.98,2039765,2039848
3848,88,27,1,5.82,20.15,2039847,2039935
3849,95,17,1,5.39,12.97,2039934,2040029
3850,88,17,0,5.82,10.54,2040028,2040116
3851,91,24,0,5.63,21.25,2040115,2040206
3852,89,24,0,5.75,24.79,2040205,2040294
3853,114,22,0,4.49,13.34,2040293,2040407
3854,106,18,0,4.83,11.93,2040406,2040512
3855,107,18,0,4.79,11.59,2040511,2040618
3856,81,21,1,6.32,14.24,2040617,2040698
3857,97,19,0,5.28,11.77,2040697,2040794
3858,75,19,0,6.83,13.64,2040793,2040868
3859,85,19,1,6.02,9.81,2040867,2040952
3860,82,28,1,6.24,17.21,2040951,2041033
3861,99,17,0,5.17,8.49,2041033,2041132
3862,97,18,0,5.28,12.90,2041131,2041228
3863,90,18,1,5.69,12.01,2041227,2041317
3864,88,17,1,5.82,12.63,2041317,2041405
3865,79,28,0,6.48,27.74,2041404,2041483
3866,93,20,0,5.51,19.15,2041483,2041576
3867,108,17,0,4.74,12.53,2041575,2041683
3868,89,27,0,5.75,19.78,2041683,2041772
3869,109,18,0,4.70,10.47,2041772,2041881
3870,87,21,0,5.89,15.09,2041881,2041968
3871,91,22,0,5.63,15.33,2041968,2042059
3872,80,30,1,6.40,18.89,2042058,2042138
3873,86,19,1,5.95,13.04,2042137,2042223
3874,89,26,0,5.75,15.65,2042222,2042311
3875,84,34,0,6.10,21.97,2042310,2042394
3876,90,15,1,5.69,11.06,2042393,2042483
3877,85,16,0,6.02,11.13,2042482,2042567
3878,87,27,0,5.89,21.71,2042566,2042653
3879,77,22,0,6.65,21.79,2042652,2042729
3880,100,23,0,5.12,19.31,2042728,2042828
3881,75,27,0,6.83,23.32,2042827,2042902
3882,113,25,0,4.53,11.36,2042902,2043015
3883,102,19,1,5.02,12.10,2043014,2043116
3884,109,12,0,4.70,7.73,2043115,2043224
3885,82,26,1,6.24,14.16,2043223,2043305
3886,85,18,0,6.02,14.19,2043304,2043389
3887,88,15,0,5.82,8.58,2043388,2043476
3888,85,14,1,6.02,9.11,2043476,2043561
3889,94,24,1,5.45,14.25,2043560,2043654
3890,74,76,1,6.92,82.45,2043654,2043728
3891,90,15,0,5.69,11.70,2043727,2043817
3892,86,34,1,5.95,22.37,2043816,2043902
3893,90,24,0,5.69,16.81,2043902,2043992
3894,94,22,0,5.45,13.40,2043991,2044085
3895,106,28,0,4.83,16.65,2044084,2044190
3896,103,17,0,4.97,12.46,2044189,2044292
3897,95,24,1,5.39,14.45,2044291,2044386
3898,97,17,0,5.28,11.79,2044385,2044482
3899,99,12,1,5.17,6.67,2044481,2044580
3900,78,18,1,6.56,12.86,2044579,2044657
3901,84,19,0,6.10,13.71,2044656,2044740
3902,75,34,1,6.83,26.46,2044739,2044814
3903,96,15,0,5.33,9.01,2044813,2044909
3904,84,20,2,6.10,9.56,2044908,2044992
3905,104,17,1,4.92,8.28,2044991,2045095
3906,88,15,1,5.82,10.85,2045094,2045182
3907,98,16,1,5.22,9.54,2045181,2045279
3908,89,16,1,5.75,10.39,2045278,2045367
3909,90,21,0,5.69,17.41,2045367,2045457
3910,82,26,0,6.24,23.33,2045457,2045539
3911,99,22,0,5.17,14.73,2045538,2045637
3912,102,20,0,5.02,10.41,2045636,2045738
3913,92,18,1,5.57,11.92,2045737,2045829
3914,80,16,1,6.40,10.66,2045828,2045908
3915,87,20,1,5.89,13.85,2045907,2045994
3916,95,17,0,5.39,9.96,2045993,2046088
3917,88,19,0,5.82,15.17,2046087,2046175
3918,88,17,1,5.82,11.40,2046174,2046262
3919,100,23,0,5.12,12.23,2046261,2046361
3920,78,20,1,6.56,16.27,2046360,2046438
3921,75,37,1,6.83,36.49,2046437,2046512
3922,71,17,0,7.21,17.38,2046511,2046582
3923,104,23,0,4.92,11.44,2046582,2046686
3924,96,25,0,5.33,18.78,2046685,2046781
3925,83,35,0,6.17,26.50,2046780,2046863
3926,107,15,0,4.79,14.15,2046862,2046969
3927,104,13,1,4.92,8.01,2046968,2047072
3928,89,19,1,5.75,11.38,2047071,2047160
3929,79,23,0,6.48,15.82,2047159,2047238
3930,84,17,1,6.10,15.01,2047237,2047321
3931,80,28,1,6.40,18.99,2047320,2047400
3932,80,22,1,6.40,15.24,2047399,2047479
3933,84,17,0,6.10,11.61,2047478,2047562
3934,81,24,1,6.32,17.75,2047561,2047642
3935,88,22,1,5.82,14.63,2047641,2047729
3936,79,23,0,6.48,19.97,2047729,2047808
3937,75,26,1,6.83,17.53,2047807,2047882
3938,101,16,0,5.07,11.77,2047881,2047982
3939,100,22,0,5.12,13.79,2047981,2048081
3940,76,44,0,6.74,38.22,2048080,2048156
3941,112,20,0,4.57,12.60,2048155,2048267
3942,101,19,1,5.07,10.90,2048266,2048367
3943,82,19,0,6.24,15.79,2048366,2048448
3944,77,26,0,6.65,18.07,2048447,2048524
3945,86,28,1,5.95,22.04,2048524,2048610
3946,77,22,1,6.65,18.28,2048609,2048686
3947,96,14,1,5.33,8.03,2048686,2048782
3948,88,20,1,5.82,11.31,2048781,2048869
3949,86,18,1,5.95,12.77,2048868,2048954
3950,93,20,1,5.51,12.55,2048954,2049047
3951,79,26,1,6.48,13.69,2049046,2049125
3952,83,20,1,6.17,12.43,2049124,2049207
3953,99,23,0,5.17,14.36,2049206,2049305
3954,100,17,0,5.12,16.63,2049304,2049404
3955,115,26,0,4.45,13.99,2049403,2049518
3956,92,19,1,5.57,10.94,2049517,2049609
3957,97,26,0,5.28,15.79,2049608,2049705
3958,83,22,1,6.17,19.32,2049705,2049788
3959,69,25,1,7.42,17.72,2049787,2049856
3960,88,19,1,5.82,17.19,2049855,2049943
3961,78,16,0,6.56,10.37,2049942,2050020
3962,84,18,0,6.10,13.16,2050019,2050103
3963,78,18,0,6.56,10.99,2050102,2050180
3964,83,29,1,6.17,15.42,2050179,2050262
3965,89,22,0,5.75,16.48,2050261,2050350
3966,82,22,0,6.24,17.96,2050349,2050431
3967,85,22,1,6.02,16.35,2050430,2050515
3968,96,19,0,5.33,12.93,2050514,2050610
3969,103,18,0,4.97,14.38,2050609,2050712
3970,81,33,0,6.32,25.33,2050711,2050792
3971,111,17,0,4.61,10.53,2050791,2050902
3972,100,22,0,5.12,14.53,2050902,2051002
3973,93,18,1,5.51,10.29,2051001,2051094
3974,84,22,1,6.10,14.51,2051093,2051177
3975,80,21,1,6.40,12.17,2051177,2051257
3976,77,19,1,6.65,13.40,2051256,2051333
3977,81,28,1,6.32,16.39,2051333,2051414
3978,90,20,1,5.69,14.55,2051413,2051503
3979,94,16,0,5.45,12.12,2051502,2051596
3980,73,18,1,7.01,17.19,2051595,2051668
3981,96,19,0,5.33,13.41,2051667,2051763
3982,75,22,1,6.83,23.00,2051762,2051837
3983,114,20,0,4.49,13.32,2051836,2051950
3984,81,23,1,6.32,20.49,2051949,2052030
3985,99,18,0,5.17,15.29,2052029,2052128
3986,97,14,1,5.28,8.65,2052127,2052224
3987,95,21,0,5.39,15.84,2052224,2052319
3988,82,19,1,6.24,12.38,2052318,2052400
3989,86,17,0,5.95,14.72,2052399,2052485
3990,80,21,0,6.40,13.39,2052484,2052564
3991,78,18,0,6.56,12.58,2052564,2052642
3992,78,18,2,6.56,10.14,2052641,2052719
3993,72,32,1,7.11,30.07,2052718,2052790
3994,83,18,0,6.17,13.59,2052789,2052872
3995,89,23,0,5.75,16.61,2052871,2052960
3996,91,17,1,5.63,13.16,2052959,2053050
3997,72,31,1,7.11,28.35,2053049,2053121
3998,112,15,0,4.57,11.23,2053120,2053232
3999,78,17,0,6.56,11.25,2053231,2053309
4000,119,72,0,4.30,47.86,2053309,2053428
4001,107,15,1,4.79,8.64,2053427,2053534
4002,89,14,1,5.75,7.24,2053533,2053622
4003,81,19,1,6.32,11.21,2053621,2053702
4004,89,31,0,5.75,15.35,2053701,2053790
4005,84,18,0,6.10,11.94,2053789,2053873
4006,86,20,1,5.95,14.23,2053872,2053958
4007,91,16,1,5.63,11.35,2053957,2054048
4008,98,16,0,5.22,11.58,2054047,2054145
4009,75,32,1,6.83,23.50,2054144,2054219
4010,87,21,0,5.89,13.89,2054218,2054305
4011,79,14,1,6.48,10.78,2054304,2054383
4012,87,18,0,5.89,17.48,2054382,2054469
4013,96,22,0,5.33,16.72,2054468,2054564
4014,92,76,0,5.57,89.12,2054563,2054655
4015,104,21,0,4.92,15.07,2054654,2054758
4016,99,19,0,5.17,11.92,2054757,2054856
4017,103,21,0,4.97,12.42,2054855,2054958
4018,77,23,0,6.65,14.95,2054958,2055035
4019,76,20,1,6.74,15.77,2055034,2055110
4020,76,27,1,6.74,19.61,2055109,2055185
4021,90,23,1,5.69,14.95,2055184,2055274
4022,87,13,1,5.89,7.53,2055273,2055360
4023,88,17,1,5.82,11.60,2055359,2055447
4024,90,19,0,5.69,11.75,2055446,2055536
4025,82,26,0,6.24,20.92,2055535,2055617
4026,75,24,1,6.83,16.89,2055616,2055691
4027,103,21,0,4.97,18.73,2055690,2055793
4028,100,28,0,5.12,23.29,2055792,2055892
4029,102,17,0,5.02,11.49,2055891,2055993
4030,98,22,1,5.22,12.81,2055992,2056090
4031,96,20,0,5.33,15.51,2056089,2056185
4032,83,27,1,6.17,20.94,2056185,2056268
4033,86,18,1,5.95,8.46,2056267,2056353
4034,90,29,1,5.69,16.70,2056352,2056442
4035,86,31,1,5.95,19.37,2056441,2056527
4036,83,14,0,6.17,9.20,2056526,2056609
4037,81,19,1,6.32,15.08,2056609,2056690
4038,83,27,0,6.17,21.90,2056689,2056772
4039,87,18,0,5.89,13.87,2056771,2056858
4040,82,44,0,6.24,33.31,2056857,2056939
4041,76,20,1,6.74,12.25,2056938,2057014
4042,94,22,0,5.45,19.50,2057014,2057108
4043,103,25,1,4.97,18.07,2057107,2057210
4044,95,30,0,5.39,21.44,2057209,2057304
4045,108,18,0,4.74,8.91,2057303,2057411
4046,99,25,0,5.17,13.15,2057410,2057509
4047,78,19,1,6.56,14.40,2057509,2057587
4048,82,19,1,6.24,14.82,2057586,2057668
4049,68,25,0,7.53,22.25,2057667,2057735
4050,72,18,1,7.11,20.15,2057734,2057806
4051,77,53,1,6.65,38.25,2057805,2057882
4052,95,21,0,5.39,12.43,2057881,2057976
4053,85,25,1,6.02,18.07,2057976,2058061
4054,91,16,1,5.63,8.92,2058060,2058151
4055,73,26,1,7.01,25.60,2058151,2058224
4056,91,18,0,5.63,12.63,2058224,2058315
4057,92,21,0,5.57,16.09,2058314,2058406
4058,91,29,0,5.63,18.78,2058406,2058497
4059,108,21,0,4.74,11.58,2058496,2058604
4060,97,31,0,5.28,16.24,2058603,2058700
4061,90,24,0,5.69,19.06,2058700,2058790
4062,91,19,1,5.63,8.32,2058789,2058880
4063,75,16,0,6.83,12.17,2058879,2058954
4064,71,25,0,7.21,20.19,2058953,2059024
4065,66,23,0,7.76,25.21,2059023,2059089
4066,84,16,1,6.10,11.06,2059088,2059172
4067,88,18,0,5.82,11.42,2059172,2059260
4068,93,22,0,5.51,13.86,2059259,2059352
4069,86,17,0,5.95,9.02,2059351,2059437
4070,92,25,0,5.57,18.33,2059436,2059528
4071,70,33,1,7.31,29.59,2059527,2059597
4072,84,24,0,6.10,26.23,2059597,2059681
4073,97,22,0,5.28,19.56,2059680,2059777
4074,100,28,0,5.12,18.57,2059776,2059876
4075,94,23,1,5.45,14.78,2059876,2059970
4076,95,23,0,5.39,13.84,2059969,2060064
4077,83,16,0,6.17,10.43,2060063,2060146
4078,82,18,1,6.24,11.87,2060145,2060227
4079,93,13,1,5.51,8.19,2060226,2060319
4080,67,36,0,7.64,38.08,2060318,2060385
4081,81,37,0,6.32,34.09,2060384,2060465
4082,85,25,0,6.02,13.46,2060464,2060549
4083,89,13,0,5.75,8.66,2060548,2060637
4084,87,16,1,5.89,12.86,2060636,2060723
4085,87,22,0,5.89,12.58,2060722,2060809
4086,84,22,0,6.10,17.09,2060808,2060892
4087,109,23,0,4.70,14.28,2060891,2061000
4088,108,15,0,4.74,10.95,2060999,2061107
4089,124,22,0,4.13,11.98,2061106,2061230
4090,109,14,0,4.70,7.83,2061229,2061338
4091,92,18,0,5.57,8.59,2061337,2061429
4092,88,27,0,5.82,15.40,2061428,2061516
4093,97,15,1,5.28,8.45,2061515,2061612
4094,77,25,1,6.65,22.05,2061611,2061688
4095,79,36,0,6.48,24.27,2061687,2061766
4096,84,20,1,6.10,13.47,2061766,2061850
4097,93,16,0,5.51,13.05,2061849,2061942
4098,83,18,0,6.17,14.14,2061941,2062024
4099,76,51,0,6.74,35.93,2062023,2062099
4100,78,36,0,6.56,27.40,2062098,2062176
4101,84,23,0,6.10,18.37,2062175,2062259
4102,93,21,0,5.51,17.13,2062258,2062351
4103,62,22,1,8.26,25.93,2062350,2062412
4104,101,18,0,5.07,14.20,2062411,2062512
4105,106,27,0,4.83,12.44,2062511,2062617
4106,89,31,1,5.75,17.49,2062616,2062705
4107,84,24,1,6.10,16.47,2062704,2062788
4108,79,24,1,6.48,15.74,2062787,2062866
4109,85,16,1,6.02,11.29,2062865,2062950
4110,87,21,1,5.89,14.98,2062949,2063036
4111,83,28,0,6.17,21.71,2063035,2063118
4112,85,15,1,6.02,8.47,2063117,2063202
4113,98,16,0,5.22,7.91,2063201,2063299
4114,85,15,1,6.02,11.34,2063298,2063383
4115,71,42,1,7.21,38.79,2063382,2063453
4116,80,31,1,6.40,20.21,2063452,2063532
4117,84,29,0,6.10,24.47,2063531,2063615
4118,101,25,0,5.07,15.25,2063614,2063715
4119,108,23,0,4.74,15.10,2063714,2063822
4120,114,24,1,4.49,10.34,2063822,2063936
4121,88,18,1,5.82,15.24,2063935,2064023
4122,81,28,1,6.32,14.64,2064022,2064103
4123,87,18,1,5.89,10.75,2064102,2064189
4124,68,33,1,7.53,29.96,2064189,2064257
4125,88,16,1,5.82,10.17,2064256,2064344
4126,78,15,1,6.56,10.94,2064343,2064421
4127,89,22,1,5.75,11.51,2064420,2064509
4128,93,21,0,5.51,12.90,2064508,2064601
4129,77,21,1,6.65,18.46,2064600,2064677
4130,79,27,0,6.48,19.34,2064676,2064755
4131,93,19,0,5.51,13.93,2064754,2064847
4132,95,23,0,5.39,20.28,2064846,2064941
4133,104,15,0,4.92,10.55,2064940,2065044
4134,110,15,0,4.65,10.84,2065044,2065154
4135,91,21,1,5.63,18.74,2065153,2065244
4136,93,25,1,5.51,12.77,2065243,2065336
4137,84,14,1,6.10,9.80,2065335,2065419
4138,82,25,1,6.24,17.87,2065418,2065500
4139,78,25,0,6.56,20.99,2065499,2065577
4140,71,22,1,7.21,18.03,2065576,2065647
4141,77,18,1,6.65,10.70,2065646,2065723
4142,84,19,1,6.10,11.49,2065722,2065806
4143,84,19,0,6.10,15.61,2065805,2065889
4144,79,23,1,6.48,23.59,2065888,2065967
4145,84,21,1,6.10,14.75,2065966,2066050
4146,86,19,0,5.95,16.00,2066049,2066135
4147,78,19,0,6.56,15.63,2066134,2066212
4148,93,30,0,5.51,24.31,2066212,2066305
4149,84,31,1,6.10,33.82,2066304,2066388
4150,86,30,0,5.95,18.67,2066387,2066473
4151,108,19,0,4.74,10.19,2066472,2066580
4152,95,26,0,5.39,17.35,2066579,2066674
4153,79,16,1,6.48,9.95,2066674,2066753
4154,76,20,1,6.74,18.69,2066752,2066828
4155,73,26,1,7.01,15.44,2066827,2066900
4156,90,15,0,5.69,11.50,2066899,2066989
4157,98,18,0,5.22,8.73,2066988,2067086
4158,85,22,1,6.02,18.71,2067085,2067170
4159,77,23,0,6.65,25.53,2067169,2067246
4160,77,27,1,6.65,17.68,2067245,2067322
4161,100,19,1,5.12,8.91,2067321,2067421
4162,85,37,0,6.02,27.06,2067420,2067505
4163,90,27,0,5.69,19.75,2067504,2067594
4164,71,42,0,7.21,45.10,2067593,2067664
4165,88,21,0,5.82,18.69,2067663,2067751
4166,103,19,0,4.97,11.19,2067750,2067853
4167,90,34,0,5.69,19.77,2067852,2067942
4168,81,42,1,6.32,27.45,2067941,2068022
4169,74,22,1,6.92,17.78,2068021,2068095
4170,79,18,1,6.48,9.79,2068094,2068173
4171,83,20,1,6.17,10.00,2068172,2068255
4172,86,13,1,5.95,8.30,2068254,2068340
4173,92,17,0,5.57,12.22,2068339,2068431
4174,93,15,0,5.51,13.22,2068430,2068523
4175,84,21,1,6.10,12.90,2068522,2068606
4176,70,22,1,7.31,19.02,2068605,2068675
4177,82,20,0,6.24,15.53,2068674,2068756
4178,82,21,0,6.24,20.82,2068755,2068837
4179,82,20,1,6.24,19.75,2068836,2068918
4180,111,20,0,4.61,14.27,2068918,2069029
4181,89,42,0,5.75,25.38,2069029,2069118
4182,101,15,0,5.07,11.19,2069117,2069218
4183,86,18,1,5.95,14.44,2069217,2069303
4184,86,21,1,5.95,13.81,2069302,2069388
4185,72,21,0,7.11,14.32,2069387,2069459
4186,84,23,0,6.10,16.47,2069458,2069542
4187,84,21,0,6.10,14.42,2069542,2069626
4188,79,23,0,6.48,17.46,2069625,2069704
4189,77,22,1,6.65,13.60,2069703,2069780
4190,80,24,1,6.40,21.51,2069779,2069859
4191,72,33,0,7.11,27.57,2069858,2069930
4192,86,21,1,5.95,15.97,2069930,2070016
4193,93,24,0,5.51,17.15,2070015,2070108
4194,87,25,0,5.89,25.94,2070107,2070194
4195,93,29,1,5.51,13.80,2070193,2070286
4196,89,48,1,5.75,30.41,2070286,2070375
4197,86,20,0,5.95,12.35,2070374,2070460
4198,86,19,1,5.95,11.84,2070459,2070545
4199,79,26,0,6.48,18.40,2070544,2070623
4200,76,21,1,6.74,18.17,2070622,2070698
4201,76,21,1,6.74,13.88,2070697,2070773
4202,85,23,0,6.02,14.56,2070772,2070857
4203,81,42,0,6.32,34.86,2070856,2070937
4204,72,22,0,7.11,20.10,2070936,2071008
4205,75,17,0,6.83,17.96,2071007,2071082
4206,85,31,0,6.02,26.96,2071081,2071166
4207,104,22,0,4.92,15.53,2071165,2071269
4208,79,31,0,6.48,23.11,2071268,2071347
4209,94,35,0,5.45,25.40,2071346,2071440
4210,106,18,0,4.83,9.93,2071439,2071545
4211,92,15,1,5.57,13.07,2071544,2071636
4212,81,20,1,6.32,12.27,2071635,2071716
4213,73,22,0,7.01,18.56,2071715,2071788
4214,78,16,0,6.56,13.27,2071787,2071865
4215,78,18,1,6.56,13.25,2071864,2071942
4216,74,18,0,6.92,13.32,2071942,2072016
4217,97,16,0,5.28,9.99,2072015,2072112
4218,79,31,1,6.48,21.24,2072111,2072190
4219,69,26,1,7.42,18.53,2072189,2072258
4220,92,16,0,5.57,11.57,2072257,2072349
4221,108,29,0,4.74,21.01,2072348,2072456
4222,78,35,0,6.56,28.35,2072456,2072534
4223,93,28,0,5.51,18.74,2072533,2072626
4224,100,26,0,5.12,16.67,2072626,2072726
4225,91,32,1,5.63,18.45,2072726,2072817
4226,89,16,0,5.75,12.16,2072816,2072905
4227,85,26,0,6.02,17.76,2072904,2072989
4228,77,59,0,6.65,55.53,2072988,2073065
4229,85,22,1,6.02,10.80,2073064,2073149
4230,87,20,0,5.89,18.17,2073148,2073235
4231,85,18,0,6.02,16.07,2073235,2073320
4232,80,20,1,6.40,14.96,2073319,2073399
4233,86,28,1,5.95,20.04,2073399,2073485
4234,75,39,0,6.83,34.38,2073484,2073559
4235,115,30,0,4.45,19.45,2073558,2073673
4236,94,21,0,5.45,13.08,2073673,2073767
4237,100,19,0,5.12,13.03,2073766,2073866
4238,98,17,0,5.22,13.48,2073865,2073963
4239,86,19,0,5.95,12.72,2073963,2074049
4240,79,23,1,6.48,13.79,2074048,2074127
4241,77,51,0,6.65,39.63,2074126,2074203
4242,76,16,1,6.74,10.22,2074202,2074278
4243,86,15,1,5.95,11.90,2074278,2074364
4244,84,19,1,6.10,11.54,2074363,2074447
4245,97,44,0,5.28,23.42,2074446,2074543
4246,79,26,1,6.48,16.55,2074542,2074621
4247,76,41,0,6.74,35.30,2074621,2074697
4248,96,38,0,5.33,26.47,2074696,2074792
4249,98,22,0,5.22,16.11,2074791,2074889
4250,99,40,0,5.17,23.13,2074888,2074987
4251,108,16,0,4.74,8.95,2074986,2075094
4252,85,23,1,6.02,15.22,2075093,2075178
4253,88,16,1,5.82,11.44,2075177,2075265
4254,79,22,0,6.48,16.63,2075264,2075343
4255,76,21,0,6.74,18.48,2075342,2075418
4256,87,18,1,5.89,13.94,2075417,2075504
4257,87,15,1,5.89,10.56,2075503,2075590
4258,93,27,1,5.51,13.73,2075590,2075683
4259,80,29,1,6.40,23.41,2075682,2075762
4260,89,17,1,5.75,9.83,2075761,2075850
4261,104,22,0,4.92,16.49,2075849,2075953
4262,96,24,0,5.33,17.66,2075952,2076048
4263,109,18,0,4.70,12.63,2076047,2076156
4264,92,17,0,5.57,14.62,2076155,2076247
4265,96,15,1,5.33,8.66,2076247,2076343
4266,75,16,1,6.83,8.33,2076342,2076417
4267,81,17,0,6.32,14.42,2076416,2076497
4268,77,22,1,6.65,17.79,2076496,2076573
4269,73,21,1,7.01,20.23,2076572,2076645
4270,76,14,1,6.74,10.17,2076644,2076720
4271,82,17,0,6.24,10.84,2076719,2076801
4272,100,18,0,5.12,11.83,2076800,2076900
4273,81,23,0,6.32,19.50,2076899,2076980
4274,80,24,0,6.40,21.24,2076979,2077059
4275,108,23,0,4.74,16.03,2077059,2077167
4276,84,22,0,6.10,20.28,2077166,2077250
4277,108,22,0,4.74,10.78,2077249,2077357
4278,99,24,0,5.17,14.57,2077356,2077455
4279,90,15,1,5.69,9.66,2077454,2077544
4280,83,14,1,6.17,8.31,2077544,2077627
4281,87,17,0,5.89,11.34,2077627,2077714
4282,75,21,1,6.83,13.58,2077713,2077788
4283,82,21,0,6.24,14.04,2077787,2077869
4284,93,14,1,5.51,10.16,2077868,2077961
4285,91,22,0,5.63,18.06,2077960,2078051
4286,86,18,0,5.95,14.58,2078050,2078136
4287,80,15,0,6.40,11.96,2078135,2078215
4288,88,19,0,5.82,18.90,2078214,2078302
4289,91,18,0,5.63,16.06,2078301,2078392
4290,91,17,0,5.63,16.87,2078391,2078482
4291,116,20,0,4.41,13.33,2078481,2078597
4292,101,16,0,5.07,10.72,2078596,2078697
4293,83,25,1,6.17,16.98,2078696,2078779
4294,75,18,1,6.83,13.34,2078778,2078853
4295,80,21,0,6.40,16.87,2078853,2078933
4296,81,26,0,6.32,23.21,2078932,2079013
4297,77,24,0,6.65,14.59,2079012,2079089
4298,78,22,1,6.56,14.43,2079088,2079166
4299,82,18,1,6.24,11.48,2079166,2079248
4300,77,20,0,6.65,18.49,2079247,2079324
4301,83,18,0,6.17,13.59,2079324,2079407
4302,83,58,1,6.17,42.28,2079406,2079489
4303,89,22,0,5.75,12.95,2079488,2079577
4304,105,24,0,4.88,21.40,2079576,2079681
4305,87,24,0,5.89,18.52,2079680,2079767
4306,100,27,0,5.12,17.29,2079766,2079866
4307,97,18,1,5.28,11.87,2079866,2079963
4308,90,24,1,5.69,16.37,2079962,2080052
4309,66,30,1,7.76,31.27,2080051,2080117
4310,82,21,1,6.24,14.04,2080116,2080198
4311,77,20,0,6.65,15.45,2080197,2080274
4312,86,17,0,5.95,10.72,2080273,2080359
4313,84,29,1,6.10,20.32,2080358,2080442
4314,90,15,1,5.69,11.17,2080441,2080531
4315,87,19,1,5.89,13.53,2080531,2080618
4316,87,26,0,5.89,19.23,2080617,2080704
4317,78,23,0,6.56,17.40,2080703,2080781
4318,82,47,1,6.24,36.62,2080780,2080862
4319,93,36,0,5.51,27.09,2080861,2080954
4320,112,17,0,4.57,10.76,2080953,2081065
4321,96,23,0,5.33,11.87,2081065,2081161
4322,115,16,0,4.45,9.97,2081160,2081275
4323,86,35,1,5.95,18.88,2081274,2081360
4324,88,14,1,5.82,9.92,2081359,2081447
4325,81,20,1,6.32,16.22,2081446,2081527
4326,88,17,1,5.82,11.56,2081526,2081614
4327,78,26,1,6.56,18.32,2081613,2081691
4328,75,74,2,6.83,72.54,2081690,2081765
4329,77,22,1,6.65,18.46,2081764,2081841
4330,74,42,1,6.92,30.02,2081840,2081914
4331,93,19,1,5.51,11.11,2081914,2082007
4332,76,21,0,6.74,26.43,2082006,2082082
4333,72,46,0,7.11,47.60,2082081,2082153
4334,77,18,0,6.65,16.80,2082153,2082230
4335,97,18,0,5.28,15.00,2082229,2082326
4336,96,18,1,5.33,11.83,2082325,2082421
4337,104,18,0,4.92,10.61,2082420,2082524
4338,86,18,0,5.95,13.02,2082523,2082609
4339,73,21,1,7.01,12.42,2082609,2082682
4340,72,23,1,7.11,23.32,2082681,2082753
4341,78,27,0,6.56,20.55,2082752,2082830
4342,90,16,0,5.69,9.41,2082829,2082919
4343,84,16,1,6.10,11.54,2082918,2083002
4344,97,16,0,5.28,11.99,2083001,2083098
4345,89,21,0,5.75,11.76,2083097,2083186
4346,79,22,1,6.48,23.34,2083186,2083265
4347,71,22,1,7.21,23.86,2083264,2083335
4348,80,28,0,6.40,28.59,2083334,2083414
4349,88,34,0,5.82,31.29,2083413,2083501
4350,103,23,1,4.97,13.23,2083501,2083604
4351,107,22,0,4.79,10.75,2083603,2083710
4352,96,30,1,5.33,17.14,2083709,2083805
4353,87,15,0,5.89,12.58,2083804,2083891
4354,89,17,1,5.75,10.82,2083890,2083979
4355,68,30,1,7.53,24.40,2083978,2084046
4356,81,20,1,6.32,15.45,2084046,2084127
4357,74,25,0,6.92,19.59,2084126,2084200
4358,88,20,1,5.82,10.08,2084199,2084287
4359,80,28,1,6.40,17.41,2084287,2084367
4360,81,17,0,6.32,11.72,2084366,2084447
4361,93,20,1,5.51,15.63,2084446,2084539
4362,78,24,1,6.56,22.58,2084538,2084616
4363,93,48,0,5.51,35.33,2084615,2084708
4364,89,20,0,5.75,12.77,2084707,2084796
4365,105,17,0,4.88,11.23,2084795,2084900
4366,103,17,0,4.97,10.73,2084899,2085002
4367,99,19,0,5.17,12.40,2085001,2085100
4368,75,20,1,6.83,15.05,2085099,2085174
4369,86,27,0,5.95,14.49,2085173,2085259
4370,75,22,2,6.83,16.01,2085258,2085333
4371,80,19,1,6.40,11.56,2085332,2085412
4372,75,21,1,6.83,13.56,2085411,2085486
4373,84,24,1,6.10,10.68,2085485,2085569
4374,92,28,0,5.57,20.55,2085568,2085660
4375,78,21,1,6.56,21.91,2085660,2085738
4376,91,17,0,5.63,14.96,2085737,2085828
4377,81,29,0,6.32,39.63,2085827,2085908
4378,85,31,0,6.02,27.46,2085907,2085992
4379,83,21,0,6.17,18.33,2085991,2086074
4380,92,21,1,5.57,16.96,2086073,2086165
4381,111,14,0,4.61,6.96,2086165,2086276
4382,87,22,0,5.89,15.25,2086275,2086362
4383,76,22,0,6.74,15.85,2086361,2086437
4384,93,28,1,5.51,15.02,2086436,2086529
4385,88,20,0,5.82,13.47,2086528,2086616
4386,86,32,1,5.95,19.53,2086615,2086701
4387,73,38,1,7.01,27.93,2086700,2086773
4388,86,20,0,5.95,14.70,2086772,2086858
4389,79,19,2,6.48,14.20,2086857,2086936
4390,88,15,0,5.82,11.72,2086935,2087023
4391,98,17,0,5.22,8.68,2087022,2087120
4392,101,29,0,5.07,17.05,2087119,2087220
4393,85,28,0,6.02,20.92,2087220,2087305
4394,107,15,0,4.79,9.48,2087304,2087411
4395,100,20,0,5.12,15.41,2087410,2087510
4396,84,39,1,6.10,26.30,2087509,2087593
4397,84,18,0,6.10,13.30,2087592,2087676
4398,77,24,1,6.65,18.88,2087675,2087752
4399,80,33,1,6.40,26.01,2087751,2087831
4400,81,23,1,6.32,17.43,2087830,2087911
4401,87,24,0,5.89,15.30,2087910,2087997
4402,91,16,1,5.63,7.68,2087996,2088087
4403,78,21,0,6.56,21.30,2088086,2088164
4404,74,36,1,6.92,28.75,2088163,2088237
4405,90,18,0,5.69,15.77,2088236,2088326
4406,83,19,0,6.17,17.37,2088326,2088409
4407,106,20,0,4.83,15.76,2088408,2088514
4408,96,16,0,5.33,12.95,2088513,2088609
4409,105,22,0,4.88,12.93,2088609,2088714
4410,104,23,0,4.92,15.78,2088713,2088817
4411,79,18,1,6.48,13.24,2088816,2088895
4412,70,57,1,7.31,45.90,2088894,2088964
4413,91,16,1,5.63,9.18,2088963,2089054
4414,75,45,0,6.83,33.29,2089053,2089128
4415,79,42,1,6.48,31.41,2089127,2089206
4416,77,22,1,6.65,17.32,2089205,2089282
4417,88,19,1,5.82,13.83,2089281,2089369
4418,83,20,0,6.17,11.10,2089368,2089451
4419,90,22,1,5.69,14.06,2089450,2089540
4420,82,31,1,6.24,17.87,2089539,2089621
4421,89,26,0,5.75,20.01,2089620,2089709
4422,103,20,0,4.97,15.41,2089708,2089811
4423,93,41,0,5.51,28.81,2089810,2089903
4424,85,14,1,6.02,10.35,2089902,2089987
4425,97,35,0,5.28,21.77,2089986,2090083
4426,69,41,0,7.42,48.48,2090082,2090151
4427,74,22,1,6.92,20.43,2090150,2090224
4428,85,22,0,6.02,20.54,2090223,2090308
4429,72,33,1,7.11,27.13,2090307,2090379
4430,81,20,1,6.32,14.46,2090378,2090459
4431,81,20,1,6.32,11.55,2090459,2090540
4432,72,43,1,7.11,44.54,2090540,2090612
4433,79,24,1,6.48,18.83,2090611,2090690
4434,82,24,1,6.24,19.28,2090689,2090771
4435,79,22,0,6.48,18.12,2090771,2090850
4436,83,21,1,6.17,20.38,2090849,2090932
4437,103,17,0,4.97,11.66,2090931,2091034
4438,82,25,1,6.24,24.60,2091034,2091116
4439,103,24,0,4.97,17.27,2091115,2091218
4440,99,19,0,5.17,14.95,2091217,2091316
4441,90,18,0,5.69,10.41,2091315,2091405
4442,66,55,2,7.76,56.88,2091404,2091470
4443,77,38,1,6.65,31.71,2091470,2091547
4444,74,34,1,6.92,24.48,2091546,2091620
4445,79,46,0,6.48,44.48,2091619,2091698
4446,77,27,1,6.65,19.63,2091697,2091774
4447,94,16,1,5.45,9.23,2091773,2091867
4448,93,21,0,5.51,13.60,2091866,2091959
4449,83,23,0,6.17,19.13,2091958,2092041
4450,74,22,1,6.92,20.18,2092040,2092114
4451,87,22,0,5.89,22.19,2092113,2092200
4452,100,22,0,5.12,19.63,2092199,2092299
4453,116,15,0,4.41,9.48,2092298,2092414
4454,104,23,0,4.92,14.38,2092413,2092517
4455,84,21,1,6.10,18.01,2092516,2092600
4456,74,38,1,6.92,29.91,2092600,2092674
4457,90,20,1,5.69,12.46,2092674,2092764
4458,74,22,1,6.92,17.70,2092763,2092837
4459,76,20,1,6.74,15.17,2092836,2092912
4460,81,18,1,6.32,11.23,2092911,2092992
4461,83,17,1,6.17,11.71,2092991,2093074
4462,83,23,1,6.17,18.50,2093073,2093156
4463,86,24,1,5.95,15.58,2093155,2093241
4464,98,14,0,5.22,9.34,2093240,2093338
4465,95,18,0,5.39,12.51,2093337,2093432
4466,90,41,0,5.69,40.99,2093432,2093522
4467,87,26,0,5.89,23.32,2093521,2093608
4468,94,28,1,5.45,16.35,2093607,2093701
4469,98,19,0,5.22,14.73,2093700,2093798
4470,89,23,1,5.75,17.96,2093797,2093886
4471,70,31,1,7.31,27.10,2093885,2093955
4472,95,15,0,5.39,9.25,2093954,2094049
4473,76,17,1,6.74,10.85,2094048,2094124
4474,80,23,0,6.40,14.76,2094123,2094203
4475,92,16,0,5.57,9.29,2094202,2094294
4476,88,19,1,5.82,10.94,2094294,2094382
4477,72,47,0,7.11,61.65,2094381,2094453
4478,81,28,1,6.32,21.13,2094452,2094533
4479,82,26,1,6.24,18.92,2094532,2094614
4480,73,49,0,7.01,39.85,2094613,2094686
4481,108,18,0,4.74,11.78,2094685,2094793
4482,97,17,0,5.28,16.96,2094792,2094889
4483,111,22,0,4.61,10.72,2094888,2094999
4484,112,28,0,4.57,12.82,2094998,2095110
4485,75,32,0,6.83,32.09,2095110,2095185
4486,81,33,1,6.32,22.24,2095184,2095265
4487,91,24,0,5.63,14.76,2095264,2095355
4488,78,18,0,6.56,11.40,2095355,2095433
4489,86,14,0,5.95,11.97,2095432,2095518
4490,78,23,0,6.56,18.35,2095517,2095595
4491,82,22,1,6.24,18.48,2095594,2095676
4492,85,23,1,6.02,15.46,2095675,2095760
4493,76,24,1,6.74,16.27,2095759,2095835
4494,82,26,0,6.24,20.11,2095835,2095917
4495,69,37,1,7.42,32.77,2095916,2095985
4496,103,24,0,4.97,16.13,2095985,2096088
4497,95,22,0,5.39,17.94,2096087,2096182
4498,92,21,0,5.57,17.44,2096181,2096273
4499,117,15,0,4.38,9.11,2096272,2096389
4500,93,18,1,5.51,15.24,2096388,2096481
4501,93,27,1,5.51,13.91,2096480,2096573
4502,84,19,1,6.10,11.18,2096572,2096656
4503,76,30,1,6.74,23.25,2096655,2096731
4504,84,23,1,6.10,12.71,2096730,2096814
4505,86,20,1,5.95,11.32,2096813,2096899
4506,87,25,0,5.89,20.22,2096898,2096985
4507,71,28,0,7.21,26.70,2096984,2097055
4508,77,24,0,6.65,22.90,2097054,2097131
4509,83,19,0,6.17,15.88,2097130,2097213
4510,105,21,0,4.88,13.23,2097212,2097317
4511,75,34,1,6.83,30.44,2097317,2097392
4512,86,61,0,5.95,55.58,2097391,2097477
4513,89,20,0,5.75,17.80,2097476,2097565
4514,87,20,1,5.89,13.83,2097564,2097651
4515,84,25,0,6.10,12.68,2097650,2097734
4516,81,25,0,6.32,17.72,2097733,2097814
4517,83,23,0,6.17,18.65,2097813,2097896
4518,69,25,1,7.42,23.00,2097895,2097964
4519,80,26,0,6.40,15.87,2097963,2098043
4520,88,28,0,5.82,17.47,2098042,2098130
4521,81,18,1,6.32,15.67,2098130,2098211
4522,74,27,1,6.92,21.99,2098210,2098284
4523,86,55,0,5.95,47.60,2098283,2098369
4524,93,39,0,5.51,28.16,2098368,2098461
4525,113,22,0,4.53,15.06,2098460,2098573
4526,103,19,1,4.97,7.87,2098572,2098675
4527,88,21,1,5.82,17.35,2098674,2098762
4528,74,17,2,6.92,12.72,2098762,2098836
4529,94,22,1,5.45,10.76,2098835,2098929
4530,79,18,1,6.48,11.97,2098928,2099007
4531,83,21,1,6.17,14.04,2099006,2099089
4532,79,18,1,6.48,12.25,2099088,2099167
4533,82,22,1,6.24,17.04,2099166,2099248
4534,82,16,0,6.24,13.45,2099247,2099329
4535,87,57,0,5.89,43.37,2099328,2099415
4536,79,47,0,6.48,42.98,2099414,2099493
4537,95,23,0,5.39,18.91,2099492,2099587
4538,108,16,0,4.74,12.75,2099586,2099694
4539,112,12,0,4.57,7.21,2099693,2099805
4540,88,25,1,5.82,17.06,2099804,2099892
4541,72,36,1,7.11,27.38,2099892,2099964
4542,87,18,0,5.89,12.79,2099963,2100050
4543,81,22,1,6.32,14.86,2100049,2100130
4544,83,19,0,6.17,15.63,2100129,2100212
4545,87,13,1,5.89,7.62,2100211,2100298
4546,83,22,0,6.17,19.63,2100297,2100380
4547,94,16,0,5.45,12.27,2100379,2100473
4548,82,35,1,6.24,24.21,2100472,2100554
4549,86,28,0,5.95,17.63,2100553,2100639
4550,96,44,0,5.33,28.37,2100638,2100734
4551,101,28,0,5.07,16.08,2100733,2100834
4552,105,15,0,4.88,10.22,2100833,2100938
4553,95,20,0,5.39,15.96,2100938,2101033
4554,76,49,1,6.74,39.85,2101032,2101108
4555,82,16,1,6.24,10.55,2101107,2101189
4556,83,24,1,6.17,18.45,2101188,2101271
4557,76,59,0,6.74,46.35,2101271,2101347
4558,82,19,1,6.24,13.53,2101346,2101428
4559,75,21,1,6.83,16.78,2101427,2101502
4560,86,25,0,5.95,16.93,2101501,2101587
4561,93,15,0,5.51,13.11,2101586,2101679
4562,63,49,0,8.13,50.59,2101679,2101742
4563,81,30,0,6.32,38.07,2101741,2101822
4564,81,79,0,6.32,87.65,2101822,2101903
4565,98,37,0,5.22,25.62,2101902,2102000
4566,98,60,0,5.22,42.81,2101999,2102097
4567,101,15,0,5.07,7.93,2102096,2102197
4568,87,17,1,5.89,9.32,2102196,2102283
4569,86,40,1,5.95,25.32,2102282,2102368
4570,80,17,1,6.40,10.96,2102367,2102447
4571,92,23,0,5.57,13.27,2102446,2102538
4572,75,18,2,6.83,12.92,2102538,2102613
4573,103,16,1,4.97,8.79,2102612,2102715
4574,95,30,0,5.39,20.87,2102715,2102810
4575,89,15,0,5.75,11.69,2102809,2102898
4576,89,21,1,5.75,21.69,2102897,2102986
4577,95,40,0,5.39,28.01,2102985,2103080
4578,105,15,0,4.88,10.79,2103079,2103184
4579,102,15,0,5.02,9.59,2103183,2103285
4580,83,21,0,6.17,19.85,2103284,2103367
4581,73,21,1,7.01,15.38,2103366,2103439
4582,75,56,1,6.83,47.69,2103438,2103513
4583,82,19,0,6.24,14.79,2103512,2103594
4584,89,28,0,5.75,12.97,2103594,2103683
4585,80,20,1,6.40,9.46,2103682,2103762
4586,95,17,1,5.39,12.26,2103761,2103856
4587,77,26,1,6.65,24.31,2103856,2103933
4588,82,18,0,6.24,15.77,2103932,2104014
4589,98,33,0,5.22,27.77,2104013,2104111
4590,80,21,0,6.40,21.07,2104111,2104191
4591,103,20,0,4.97,13.17,2104191,2104294
4592,91,24,1,5.63,16.94,2104293,2104384
4593,90,31,0,5.69,21.44,2104383,2104473
4594,73,29,1,7.01,20.21,2104473,2104546
4595,77,37,0,6.65,35.66,2104545,2104622
4596,78,19,1,6.56,17.73,2104621,2104699
4597,68,39,1,7.53,42.98,2104698,2104766
4598,84,22,0,6.10,12.42,2104765,2104849
4599,77,24,0,6.65,20.95,2104848,2104925
4600,91,15,0,5.63,11.14,2104924,2105015
4601,95,20,0,5.39,10.87,2105014,2105109
4602,80,17,0,6.40,13.39,2105108,2105188
4603,101,34,0,5.07,24.36,2105187,2105288
4604,88,17,0,5.82,12.79,2105287,2105375
4605,105,20,0,4.88,15.10,2105374,2105479
4606,93,26,0,5.51,17.54,2105479,2105572
4607,84,24,0,6.10,18.42,2105571,2105655
4608,84,14,1,6.10,9.61,2105654,2105738
4609,52,58,1,9.85,217.01,2105737,2105789
4610,81,23,1,6.32,13.16,2105788,2105869
4611,67,47,1,7.64,43.39,2105868,2105935
4612,77,58,1,6.65,48.44,2105934,2106011
4613,84,18,1,6.10,10.94,2106010,2106094
4614,93,14,0,5.51,9.13,2106093,2106186
4615,81,30,0,6.32,17.13,2106185,2106266
4616,82,20,0,6.24,19.70,2106265,2106347
4617,97,22,0,5.28,15.44,2106346,2106443
4618,83,41,0,6.17,34.81,2106442,2106525
4619,105,16,0,4.88,11.02,2106524,2106629
4620,92,23,0,5.57,18.38,2106629,2106721
4621,88,18,1,5.82,10.26,2106721,2106809
4622,72,40,2,7.11,51.96,2106808,2106880
4623,79,50,0,6.48,37.06,2106879,2106958
4624,89,19,0,5.75,14.03,2106957,2107046
4625,84,20,2,6.10,10.30,2107045,2107129
4626,77,34,0,6.65,24.80,2107128,2107205
4627,81,30,0,6.32,23.01,2107204,2107285
4628,76,29,1,6.74,22.06,2107284,2107360
4629,80,22,0,6.40,17.74,2107360,2107440
4630,93,22,0,5.51,20.87,2107440,2107533
4631,73,33,0,7.01,47.99,2107532,2107605
4632,95,23,0,5.39,19.37,2107604,2107699
4633,105,19,0,4.88,14.43,2107698,2107803
4634,86,16,1,5.95,11.42,2107803,2107889
4635,81,23,1,6.32,15.85,2107888,2107969
4636,85,23,1,6.02,13.25,2107968,2108053
4637,75,32,0,6.83,20.52,2108052,2108127
4638,84,20,0,6.10,10.75,2108126,2108210
4639,89,22,0,5.75,13.83,2108209,2108298
4640,88,19,0,5.82,15.35,2108297,2108385
4641,85,19,0,6.02,15.34,2108385,2108470
4642,103,28,0,4.97,24.61,2108469,2108572
4643,79,24,1,6.48,19.77,2108571,2108650
4644,110,16,0,4.65,8.75,2108649,2108759
4645,97,19,0,5.28,12.02,2108758,2108855
4646,79,39,1,6.48,21.72,2108855,2108934
4647,75,32,1,6.83,24.60,2108933,2109008
4648,93,23,1,5.51,14.36,2109007,2109100
4649,84,21,1,6.10,13.78,2109099,2109183
4650,82,22,1,6.24,16.26,2109182,2109264
4651,84,26,0,6.10,16.18,2109263,2109347
4652,74,22,0,6.92,22.29,2109346,2109420
4653,108,17,0,4.74,13.01,2109419,2109527
4654,101,17,0,5.07,11.97,2109526,2109627
4655,100,18,0,5.12,13.69,2109626,2109726
4656,94,19,0,5.45,12.72,2109725,2109819
4657,70,27,1,7.31,27.04,2109818,2109888
4658,81,19,1,6.32,15.40,2109887,2109968
4659,81,31,1,6.32,18.12,2109967,2110048
4660,78,48,1,6.56,32.78,2110047,2110125
4661,90,18,0,5.69,11.75,2110124,2110214
4662,81,25,1,6.32,18.46,2110213,2110294
4663,84,30,0,6.10,25.94,2110294,2110378
4664,102,20,0,5.02,14.00,2110377,2110479
4665,96,19,0,5.33,13.06,2110478,2110574
4666,103,14,1,4.97,7.85,2110574,2110677
4667,93,19,1,5.51,15.30,2110676,2110769
4668,76,18,0,6.74,12.67,2110768,2110844
4669,81,36,1,6.32,29.72,2110843,2110924
4670,79,22,1,6.48,18.48,2110924,2111003
4671,79,18,1,6.48,17.16,2111002,2111081
4672,82,17,0,6.24,14.50,2111080,2111162
4673,88,29,1,5.82,16.29,2111161,2111249
4674,74,27,0,6.92,21.80,2111248,2111322
4675,119,15,0,4.30,9.35,2111321,2111440
4676,98,23,0,5.22,15.62,2111440,2111538
4677,110,21,0,4.65,13.77,2111537,2111647
4678,84,27,1,6.10,20.92,2111647,2111731
4679,79,17,1,6.48,13.84,2111730,2111809
4680,82,19,1,6.24,11.75,2111808,2111890
4681,69,22,1,7.42,24.68,2111889,2111958
4682,76,22,1,6.74,23.80,2111957,2112033
4683,81,20,1,6.32,15.55,2112032,2112113
4684,83,41,0,6.17,27.92,2112112,2112195
4685,82,21,0,6.24,17.04,2112194,2112276
4686,90,17,0,5.69,11.95,2112275,2112365
4687,106,18,0,4.83,11.39,2112365,2112471
4688,98,23,0,5.22,14.66,2112470,2112568
4689,101,16,0,5.07,11.61,2112567,2112668
4690,105,17,0,4.88,12.09,2112667,2112772
4691,85,32,1,6.02,26.45,2112771,2112856
4692,81,22,0,6.32,19.53,2112855,2112936
4693,84,18,1,6.10,11.51,2112935,2113019
4694,80,38,0,6.40,24.61,2113019,2113099
4695,87,19,1,5.89,14.38,2113098,2113185
4696,76,25,1,6.74,16.38,2113184,2113260
4697,77,46,1,6.65,34.49,2113260,2113337
4698,72,43,2,7.11,37.24,2113336,2113408
4699,85,42,1,6.02,30.73,2113407,2113492
4700,85,32,1,6.02,23.13,2113491,2113576
4701,97,22,0,5.28,17.09,2113575,2113672
4702,102,34,0,5.02,19.67,2113671,2113773
4703,113,18,0,4.53,10.30,2113772,2113885
4704,84,26,0,6.10,17.54,2113884,2113968
4705,80,20,1,6.40,15.64,2113967,2114047
4706,74,24,1,6.92,24.53,2114046,2114120
4707,77,59,1,6.65,58.72,2114119,2114196
4708,88,22,0,5.82,15.33,2114195,2114283
4709,84,19,0,6.10,12.66,2114282,2114366
4710,78,25,2,6.56,16.73,2114365,2114443
4711,85,21,1,6.02,14.40,2114442,2114527
4712,83,21,1,6.17,15.42,2114527,2114610
4713,93,24,0,5.51,21.13,2114610,2114703
4714,104,17,0,4.92,16.69,2114702,2114806
4715,87,24,0,5.89,24.49,2114805,2114892
4716,98,23,0,5.22,12.58,2114892,2114990
4717,88,25,0,5.82,19.17,2114989,2115077
4718,94,15,0,5.45,11.74,2115076,2115170
4719,83,21,0,6.17,19.42,2115169,2115252
4720,67,55,1,7.64,51.51,2115251,2115318
4721,78,31,1,6.56,22.09,2115317,2115395
4722,78,22,1,6.56,16.07,2115394,2115472
4723,67,35,0,7.64,35.27,2115471,2115538
4724,73,28,1,7.01,20.67,2115537,2115610
4725,83,21,0,6.17,17.85,2115609,2115692
4726,77,22,0,6.65,23.60,2115692,2115769
4727,104,18,0,4.92,13.94,2115769,2115873
4728,96,34,0,5.33,26.45,2115872,2115968
4729,101,31,0,5.07,20.64,2115968,2116069
4730,93,19,1,5.51,15.52,2116068,2116161
4731,93,30,0,5.51,20.16,2116160,2116253
4732,97,20,0,5.28,10.90,2116252,2116349
4733,79,20,0,6.48,14.43,2116348,2116427
4734,92,18,0,5.57,9.94,2116427,2116519
4735,74,39,1,6.92,30.18,2116518,2116592
4736,71,32,1,7.21,22.28,2116592,2116663
4737,68,44,1,7.53,39.07,2116662,2116730
4738,82,30,0,6.24,26.45,2116729,2116811
4739,83,22,0,6.17,17.20,2116810,2116893
4740,81,30,1,6.32,21.63,2116892,2116973
4741,91,33,0,5.63,31.49,2116972,2117063
4742,89,18,0,5.75,20.46,2117062,2117151
4743,98,17,0,5.22,12.01,2117150,2117248
4744,89,32,0,5.75,22.48,2117247,2117336
4745,109,28,0,4.70,16.69,2117335,2117444
4746,70,27,1,7.31,22.04,2117444,2117514
4747,71,24,2,7.21,18.45,2117513,2117584
4748,81,17,0,6.32,16.29,2117584,2117665
4749,78,23,1,6.56,16.43,2117664,2117742
4750,75,27,0,6.83,23.82,2117742,2117817
4751,77,16,1,6.65,13.21,2117817,2117894
4752,90,18,1,5.69,13.77,2117893,2117983
4753,82,20,1,6.24,14.57,2117982,2118064
4754,72,19,0,7.11,28.79,2118063,2118135
4755,90,23,0,5.69,12.99,2118134,2118224
4756,90,77,0,5.69,70.79,2118223,2118313
4757,102,19,0,5.02,13.16,2118312,2118414
4758,92,27,1,5.57,16.79,2118414,2118506
4759,99,15,0,5.17,11.37,2118505,2118604
4760,64,33,0,8.00,30.53,2118603,2118667
4761,92,22,0,5.57,13.81,2118666,2118758
4762,94,12,1,5.45,7.40,2118758,2118852
4763,85,31,0,6.02,23.22,2118851,2118936
4764,79,27,1,6.48,22.10,2118935,2119014
4765,81,25,0,6.32,21.40,2119013,2119094
4766,78,37,0,6.56,35.60,2119093,2119171
4767,91,19,1,5.63,13.27,2119170,2119261
4768,74,26,0,6.92,20.91,2119260,2119334
4769,92,24,0,5.57,20.81,2119333,2119425
4770,100,26,0,5.12,15.35,2119424,2119524
4771,97,22,0,5.28,16.43,2119523,2119620
4772,100,24,1,5.12,13.29,2119619,2119719
4773,83,21,0,6.17,15.20,2119718,2119801
4774,74,23,1,6.92,16.32,2119800,2119874
4775,90,24,1,5.69,19.70,2119873,2119963
4776,70,19,0,7.31,18.56,2119963,2120033
4777,88,18,1,5.82,11.65,2120032,2120120
4778,83,14,2,6.17,8.16,2120119,2120202
4779,81,30,0,6.32,21.92,2120201,2120282
4780,71,19,2,7.21,14.81,2120281,2120352
4781,96,17,0,5.33,11.14,2120351,2120447
4782,83,29,1,6.17,15.97,2120446,2120529
4783,95,24,0,5.39,21.69,2120528,2120623
4784,106,31,0,4.83,17.41,2120622,2120728
4785,99,19,1,5.17,12.10,2120727,2120826
4786,99,29,0,5.17,14.02,2120826,2120925
4787,82,19,0,6.24,14.23,2120924,2121006
4788,85,17,1,6.02,13.48,2121005,2121090
4789,78,17,1,6.56,9.63,2121089,2121167
4790,77,23,0,6.65,18.67,2121166,2121243
4791,71,28,1,7.21,22.25,2121243,2121314
4792,81,31,1,6.32,21.82,2121314,2121395
4793,85,61,0,6.02,47.36,2121395,2121480
4794,85,29,0,6.02,18.49,2121479,2121564
4795,83,24,0,6.17,21.97,2121563,2121646
4796,86,26,0,5.95,26.81,2121645,2121731
4797,127,20,0,4.03,11.07,2121730,2121857
4798,94,24,0,5.45,19.08,2121856,2121950
4799,75,28,1,6.83,33.05,2121949,2122024
4800,74,39,0,6.92,43.07,2122023,2122097
4801,88,17,0,5.82,10.56,2122097,2122185
4802,77,18,0,6.65,13.55,2122184,2122261
4803,85,16,0,6.02,9.79,2122260,2122345
4804,72,22,1,7.11,19.46,2122344,2122416
4805,83,20,1,6.17,18.65,2122416,2122499
4806,79,19,0,6.48,18.20,2122499,2122578
4807,77,21,0,6.65,23.99,2122577,2122654
4808,72,26,0,7.11,25.57,2122653,2122725
4809,101,17,0,5.07,13.97,2122724,2122825
4810,96,21,0,5.33,16.14,2122824,2122920
4811,98,16,0,5.22,11.15,2122919,2123017
4812,85,28,0,6.02,23.29,2123017,2123102
4813,110,16,0,4.65,10.94,2123101,2123211
4814,72,29,1,7.11,23.79,2123210,2123282
4815,74,22,2,6.92,23.02,2123281,2123355
4816,88,31,0,5.82,15.22,2123354,2123442
4817,87,17,1,5.89,12.84,2123441,2123528
4818,79,34,0,6.48,27.90,2123527,2123606
4819,87,39,1,5.89,25.37,2123606,2123693
4820,90,18,0,5.69,11.04,2123692,2123782
4821,81,23,0,6.32,24.17,2123781,2123862
4822,90,25,1,5.69,17.06,2123861,2123951
4823,89,26,0,5.75,23.74,2123950,2124039
4824,92,30,0,5.57,20.62,2124038,2124130
4825,107,25,0,4.79,15.14,2124130,2124237
4826,88,19,0,5.82,12.76,2124236,2124324
4827,79,17,1,6.48,15.31,2124323,2124402
4828,82,23,0,6.24,17.38,2124401,2124483
4829,75,32,1,6.83,24.97,2124482,2124557
4830,85,24,1,6.02,17.22,2124557,2124642
4831,77,18,1,6.65,15.81,2124641,2124718
4832,69,43,1,7.42,50.33,2124717,2124786
4833,81,38,0,6.32,27.33,2124785,2124866
4834,83,14,1,6.17,11.68,2124865,2124948
4835,88,22,1,5.82,15.42,2124947,2125035
4836,100,30,0,5.12,25.77,2125034,2125134
4837,95,20,0,5.39,16.66,2125133,2125228
4838,101,14,0,5.07,10.34,2125227,2125328
4839,99,35,0,5.17,21.98,2125327,2125426
4840,81,22,1,6.32,17.48,2125425,2125506
4841,76,27,1,6.74,15.43,2125505,2125581
4842,76,22,1,6.74,14.83,2125581,2125657
4843,77,45,1,6.65,37.97,2125656,2125733
4844,87,25,1,5.89,12.70,2125732,2125819
4845,83,27,1,6.17,20.53,2125818,2125901
4846,82,33,0,6.24,20.11,2125901,2125983
4847,85,46,0,6.02,30.16,2125982,2126067
4848,82,28,1,6.24,26.40,2126066,2126148
4849,93,22,0,5.51,16.14,2126147,2126240
4850,84,78,0,6.10,86.97,2126240,2126324
4851,111,19,0,4.61,13.48,2126323,2126434
4852,89,23,0,5.75,14.97,2126433,2126522
4853,88,24,1,5.82,17.58,2126522,2126610
4854,79,21,1,6.48,20.40,2126609,2126688
4855,79,25,0,6.48,14.10,2126687,2126766
4856,86,22,0,5.95,20.44,2126765,2126851
4857,85,25,0,6.02,15.36,2126850,2126935
4858,80,23,1,6.40,17.97,2126934,2127014
4859,81,26,1,6.32,22.56,2127013,2127094
4860,78,30,0,6.56,30.09,2127093,2127171
4861,78,28,1,6.56,21.60,2127171,2127249
4862,68,62,1,7.53,68.84,2127248,2127316
4863,104,17,0,4.92,14.47,2127315,2127419
4864,104,21,0,4.92,12.92,2127418,2127522
4865,105,18,0,4.88,9.40,2127522,2127627
4866,99,80,0,5.17,66.77,2127626,2127725
4867,89,18,1,5.75,12.79,2127724,2127813
4868,84,20,0,6.10,13.28,2127812,2127896
4869,74,27,1,6.92,24.94,2127896,2127970
4870,77,44,1,6.65,29.29,2127969,2128046
4871,92,19,1,5.57,10.42,2128045,2128137
4872,87,33,1,5.89,21.89,2128136,2128223
4873,76,22,1,6.74,16.33,2128222,2128298
4874,102,26,0,5.02,17.00,2128297,2128399
4875,78,20,1,6.56,16.76,2128398,2128476
4876,112,19,0,4.57,12.58,2128475,2128587
4877,96,16,1,5.33,10.70,2128586,2128682
4878,92,29,0,5.57,19.22,2128682,2128774
4879,98,19,0,5.22,12.50,2128773,2128871
4880,73,20,1,7.01,17.68,2128870,2128943
4881,83,25,1,6.17,14.96,2128942,2129025
4882,91,26,1,5.63,16.06,2129024,2129115
4883,74,24,1,6.92,20.59,2129114,2129188
4884,82,23,0,6.24,15.62,2129187,2129269
4885,73,22,1,7.01,15.19,2129268,2129341
4886,89,22,0,5.75,11.17,2129340,2129429
4887,82,27,1,6.24,23.65,2129428,2129510
4888,74,23,0,6.92,23.99,2129509,2129583
4889,98,21,0,5.22,16.09,2129582,2129680
4890,94,21,0,5.45,19.16,2129679,2129773
4891,97,24,0,5.28,20.61,2129772,2129869
4892,98,20,0,5.22,14.79,2129868,2129966
4893,85,17,1,6.02,13.15,2129965,2130050
4894,69,64,1,7.42,64.59,2130049,2130118
4895,76,20,1,6.74,15.75,2130117,2130193
4896,80,32,1,6.40,22.89,2130192,2130272
4897,82,31,0,6.24,20.87,2130271,2130353
4898,81,23,1,6.32,16.88,2130353,2130434
4899,87,32,0,5.89,18.98,2130434,2130521
4900,77,27,0,6.65,21.58,2130520,2130597
4901,101,29,0,5.07,16.88,2130596,2130697
4902,100,26,0,5.12,17.69,2130697,2130797
4903,102,19,0,5.02,16.31,2130796,2130898
4904,94,19,0,5.45,12.16,2130898,2130992
4905,76,20,0,6.74,15.67,2130991,2131067
4906,95,17,1,5.39,11.48,2131066,2131161
4907,86,20,1,5.95,14.77,2131160,2131246
4908,79,24,0,6.48,17.01,2131245,2131324
4909,92,22,0,5.57,12.03,2131323,2131415
4910,82,27,1,6.24,18.70,2131414,2131496
4911,92,17,1,5.57,11.27,2131495,2131587
4912,76,24,2,6.74,20.69,2131586,2131662
4913,96,38,0,5.33,26.14,2131661,2131757
4914,82,32,1,6.24,25.62,2131756,2131838
4915,110,13,0,4.65,9.06,2131837,2131947
4916,99,28,0,5.17,18.75,2131946,2132045
4917,85,17,0,6.02,12.96,2132044,2132129
4918,78,17,0,6.56,13.81,2132128,2132206
4919,83,29,0,6.17,23.42,2132205,2132288
4920,65,21,2,7.88,24.05,2132287,2132352
4921,77,33,0,6.65,26.67,2132351,2132428
4922,85,18,1,6.02,11.86,2132427,2132512
4923,78,18,1,6.56,13.76,2132512,2132590
4924,83,37,1,6.17,28.60,2132589,2132672
4925,81,24,0,6.32,26.17,2132671,2132752
4926,80,56,0,6.40,63.54,2132751,2132831
4927,95,24,0,5.39,22.43,2132830,2132925
4928,96,35,0,5.33,22.74,2132924,2133020
4929,103,20,0,4.97,13.31,2133019,2133122
4930,101,26,1,5.07,16.18,2133121,2133222
4931,78,20,1,6.56,18.30,2133221,2133299
4932,83,20,1,6.17,14.31,2133298,2133381
4933,73,32,0,7.01,24.95,2133380,2133453
4934,72,65,0,7.11,67.15,2133452,2133524
4935,87,15,1,5.89,9.64,2133523,2133610
4936,75,25,1,6.83,23.32,2133609,2133684
4937,73,32,1,7.01,31.36,2133683,2133756
4938,68,39,2,7.53,30.16,2133755,2133823
4939,80,19,0,6.40,17.69,2133822,2133902
4940,75,31,1,6.83,25.82,2133902,2133977
4941,97,23,0,5.28,22.35,2133976,2134073
4942,109,21,0,4.70,11.70,2134073,2134182
4943,73,49,1,7.01,40.29,2134181,2134254
4944,103,19,0,4.97,12.13,2134254,2134357
4945,83,18,0,6.17,13.61,2134356,2134439
4946,76,22,1,6.74,19.09,2134439,2134515
4947,70,53,1,7.31,54.10,2134515,2134585
4948,71,27,1,7.21,19.35,2134584,2134655
4949,83,22,0,6.17,15.78,2134654,2134737
4950,76,30,1,6.74,35.04,2134736,2134812
4951,87,20,1,5.89,12.77,2134811,2134898
4952,84,17,0,6.10,12.63,2134897,2134981
4953,84,18,0,6.10,13.18,2134980,2135064
4954,88,26,0,5.82,24.94,2135063,2135151
4955,107,17,0,4.79,12.39,2135150,2135257
4956,93,26,0,5.51,19.24,2135256,2135349
4957,90,27,0,5.69,22.53,2135348,2135438
4958,74,25,1,6.92,22.32,2135437,2135511
4959,86,19,0,5.95,10.23,2135510,2135596
4960,84,31,2,6.10,15.61,2135595,2135679
4961,80,31,0,6.40,28.72,2135678,2135758
4962,76,20,0,6.74,11.11,2135757,2135833
4963,80,20,1,6.40,13.44,2135832,2135912
4964,75,26,1,6.83,23.16,2135912,2135987
4965,87,35,1,5.89,22.91,2135986,2136073
4966,111,20,0,4.61,11.80,2136072,2136183
4967,70,60,0,7.31,64.04,2136183,2136253
4968,95,21,0,5.39,16.93,2136252,2136347
4969,104,21,0,4.92,15.42,2136346,2136450
4970,81,22,1,6.32,19.60,2136449,2136530
4971,80,19,1,6.40,14.44,2136529,2136609
4972,69,53,1,7.42,62.94,2136608,2136677
4973,77,15,1,6.65,12.72,2136676,2136753
4974,75,30,0,6.83,23.72,2136753,2136828
4975,79,23,1,6.48,15.52,2136827,2136906
4976,90,27,0,5.69,15.77,2136906,2136996
4977,72,23,2,7.11,23.60,2136995,2137067
4978,75,35,0,6.83,26.52,2137066,2137141
4979,96,27,0,5.33,22.83,2137140,2137236
4980,92,25,0,5.57,17.88,2137235,2137327
4981,105,21,0,4.88,12.43,2137326,2137431
4982,99,17,1,5.17,11.74,2137430,2137529
4983,91,22,1,5.63,13.82,2137528,2137619
4984,78,32,1,6.56,19.14,2137618,2137696
4985,75,33,0,6.83,26.89,2137695,2137770
4986,77,29,1,6.65,20.95,2137769,2137846
4987,90,17,1,5.69,11.50,2137845,2137935
4988,78,29,1,6.56,21.76,2137934,2138012
4989,87,34,1,5.89,24.93,2138011,2138098
4990,77,29,1,6.65,22.88,2138098,2138175
4991,83,22,1,6.17,19.42,2138174,2138257
4992,97,27,0,5.28,21.44,2138256,2138353
4993,99,19,0,5.17,13.82,2138353,2138452
4994,100,29,0,5.12,21.67,2138451,2138551
4995,102,18,0,5.02,10.74,2138550,2138652
4996,101,21,0,5.07,12.78,2138652,2138753
4997,74,27,0,6.92,21.34,2138753,2138827
4998,67,48,1,7.64,62.08,2138826,2138893
4999,75,25,1,6.83,21.24,2138893,2138968
5000,76,18,1,6.74,14.40,2138967,2139043
5001,83,36,0,6.17,21.27,2139043,2139126
5002,73,20,1,7.01,17.25,2139125,2139198
5003,82,24,0,6.24,24.31,2139197,2139279
5004,71,30,1,7.21,30.93,2139278,2139349
5005,88,21,1,5.82,20.74,2139349,2139437
5006,106,24,0,4.83,21.76,2139436,2139542
5007,105,17,0,4.88,11.96,2139541,2139646
5008,97,25,0,5.28,19.93,2139645,2139742
5009,93,27,1,5.51,19.97,2139741,2139834
5010,68,58,1,7.53,79.43,2139833,2139901
5011,76,21,0,6.74,16.06,2139900,2139976
5012,78,19,2,6.56,18.07,2139976,2140054
5013,67,35,0,7.64,31.60,2140053,2140120
5014,85,28,0,6.02,22.73,2140120,2140205
5015,81,24,1,6.32,13.16,2140205,2140286
5016,96,17,0,5.33,9.28,2140285,2140381
5017,81,20,0,6.32,13.63,2140380,2140461
5018,84,22,1,6.10,14.23,2140460,2140544
5019,79,49,0,6.48,41.49,2140543,2140622
5020,100,17,0,5.12,13.85,2140622,2140722
5021,107,22,0,4.79,12.65,2140721,2140828
5022,100,17,1,5.12,9.71,2140827,2140927
5023,93,17,1,5.51,13.30,2140926,2141019
5024,77,23,1,6.65,19.24,2141018,2141095
5025,69,22,1,7.42,26.79,2141094,2141163
5026,78,20,0,6.56,14.48,2141162,2141240
5027,81,34,1,6.32,25.90,2141239,2141320
5028,66,58,0,7.76,83.82,2141319,2141385
5029,70,48,1,7.31,39.99,2141384,2141454
5030,87,39,0,5.89,23.53,2141453,2141540
5031,81,28,1,6.32,27.01,2141539,2141620
5032,81,20,1,6.32,16.07,2141620,2141701
5033,79,23,0,6.48,27.16,2141700,2141779
5034,91,25,0,5.63,18.98,2141779,2141870
5035,99,24,0,5.17,12.73,2141869,2141968
5036,90,16,1,5.69,11.84,2141967,2142057
5037,84,23,1,6.10,16.04,2142056,2142140
5038,77,23,0,6.65,18.02,2142139,2142216
5039,93,22,0,5.51,14.10,2142216,2142309
5040,77,27,0,6.65,20.95,2142309,2142386
5041,84,22,1,6.10,14.92,2142385,2142469
5042,79,31,1,6.48,26.65,2142468,2142547
5043,74,20,2,6.92,17.16,2142546,2142620
5044,90,22,0,5.69,15.39,2142619,2142709
5045,78,41,0,6.56,45.58,2142708,2142786
5046,89,23,0,5.75,14.34,2142785,2142874
5047,99,38,0,5.17,31.72,2142874,2142973
5048,109,33,0,4.70,17.53,2142972,2143081
5049,94,28,0,5.45,15.57,2143080,2143174
5050,102,16,0,5.02,13.16,2143173,2143275
5051,78,18,1,6.56,14.32,2143274,2143352
5052,71,48,2,7.21,42.50,2143352,2143423
5053,80,35,1,6.40,24.71,2143422,2143502
5054,69,50,1,7.42,37.92,2143501,2143570
5055,76,20,0,6.74,18.35,2143569,2143645
5056,78,30,1,6.56,22.43,2143644,2143722
5057,93,14,0,5.51,8.72,2143721,2143814
5058,66,26,1,7.76,26.67,2143814,2143880
5059,91,32,1,5.63,21.68,2143879,2143970
5060,87,20,0,5.89,17.99,2143969,2144056
5061,92,25,0,5.57,20.31,2144055,2144147
5062,97,22,0,5.28,14.06,2144147,2144244
5063,82,26,1,6.24,18.92,2144243,2144325
5064,89,17,0,5.75,12.30,2144324,2144413
5065,101,16,1,5.07,9.17,2144413,2144514
5066,75,22,2,6.83,14.20,2144513,2144588
5067,75,30,0,6.83,28.22,2144587,2144662
5068,70,57,2,7.31,50.24,2144661,2144731
5069,89,17,1,5.75,13.08,2144730,2144819
5070,74,29,0,6.92,21.59,2144819,2144893
5071,67,86,0,7.64,112.59,2144892,2144959
5072,87,32,0,5.89,22.79,2144958,2145045
5073,68,52,1,7.53,55.78,2145044,2145112
5074,91,21,0,5.63,14.81,2145111,2145202
5075,98,28,1,5.22,15.81,2145201,2145299
5076,111,18,0,4.61,12.24,2145298,2145409
5077,103,18,0,4.97,11.37,2145408,2145511
5078,93,19,1,5.51,13.24,2145510,2145603
5079,81,18,1,6.32,17.25,2145602,2145683
5080,78,22,0,6.56,15.48,2145683,2145761
5081,73,43,1,7.01,36.40,2145760,2145833
5082,72,46,1,7.11,42.93,2145832,2145904
5083,88,24,0,5.82,17.51,2145903,2145991
5084,76,18,0,6.74,15.75,2145990,2146066
5085,80,23,0,6.40,15.31,2146065,2146145
5086,119,23,0,4.30,13.44,2146144,2146263
5087,104,17,0,4.92,13.42,2146262,2146366
5088,105,18,0,4.88,10.49,2146365,2146470
5089,75,44,0,6.83,38.46,2146470,2146545
5090,83,27,1,6.17,18.60,2146544,2146627
5091,78,21,0,6.56,17.73,2146626,2146704
5092,81,18,1,6.32,13.08,2146704,2146785
5093,83,26,1,6.17,17.22,2146785,2146868
5094,77,20,1,6.65,22.25,2146867,2146944
5095,77,36,1,6.65,26.41,2146943,2147020
5096,84,20,0,6.10,16.06,2147019,2147103
5097,81,31,0,6.32,32.29,2147102,2147183
5098,84,41,0,6.10,37.51,2147182,2147266
5099,94,25,0,5.45,19.86,2147266,2147360
5100,93,24,0,5.51,22.12,2147360,2147453
5101,109,23,0,4.70,11.59,2147452,2147561
5102,86,39,0,5.95,30.70,2147560,2147646
5103,76,22,1,6.74,13.38,2147646,2147722
5104,80,23,1,6.40,16.76,2147721,2147801
5105,95,15,0,5.39,10.26,2147800,2147895
5106,82,18,0,6.24,12.53,2147894,2147976
5107,69,39,1,7.42,36.91,2147975,2148044
5108,102,15,0,5.02,8.78,2148043,2148145
5109,83,21,1,6.17,16.33,2148145,2148228
5110,85,32,0,6.02,21.65,2148227,2148312
5111,105,19,0,4.88,11.18,2148311,2148416
5112,95,26,0,5.39,17.71,2148415,2148510
5113,97,17,0,5.28,13.44,2148509,2148606
5114,95,17,0,5.39,14.07,2148605,2148700
5115,90,26,1,5.69,19.86,2148699,2148789
5116,72,26,1,7.11,27.65,2148788,2148860
5117,75,28,1,6.83,23.48,2148859,2148934
5118,71,25,1,7.21,22.76,2148933,2149004
5119,72,32,2,7.11,20.46,2149003,2149075
5120,79,60,0,6.48,48.55,2149074,2149153
5121,82,30,1,6.24,20.89,2149153,2149235
5122,85,46,0,6.02,27.98,2149234,2149319
5123,78,17,1,6.56,14.50,2149318,2149396
5124,82,23,0,6.24,18.60,2149395,2149477
5125,93,19,0,5.51,19.00,2149476,2149569
5126,93,21,0,5.51,16.47,2149568,2149661
5127,104,14,1,4.92,6.72,2149660,2149764
5128,93,32,0,5.51,17.56,2149763,2149856
5129,85,23,0,6.02,15.15,2149855,2149940
5130,73,28,1,7.01,24.40,2149939,2150012
5131,78,17,1,6.56,17.17,2150012,2150090
5132,75,29,1,6.83,19.74,2150089,2150164
5133,77,18,2,6.65,11.94,2150163,2150240
5134,80,35,0,6.40,26.04,2150239,2150319
5135,75,31,0,6.83,29.29,2150318,2150393
5136,82,49,0,6.24,33.65,2150392,2150474
5137,67,55,1,7.64,54.11,2150473,2150540
5138,73,69,1,7.01,75.33,2150539,2150612
5139,107,15,0,4.79,11.89,2150611,2150718
5140,90,62,0,5.69,49.30,2150717,2150807
5141,101,19,1,5.07,9.13,2150806,2150907
5142,90,23,1,5.69,19.44,2150907,2150997
5143,81,22,0,6.32,16.51,2150996,2151077
5144,82,21,1,6.24,15.11,2151076,2151158
5145,82,22,1,6.24,18.26,2151157,2151239
5146,85,19,0,6.02,14.52,2151238,2151323
5147,92,19,0,5.57,11.90,2151322,2151414
5148,85,20,1,6.02,10.38,2151413,2151498
5149,68,43,1,7.53,43.10,2151498,2151566
5150,77,44,1,6.65,28.02,2151566,2151643
5151,78,30,0,6.56,24.60,2151642,2151720
5152,91,28,0,5.63,21.27,2151719,2151810
5153,86,29,0,5.95,24.00,2151809,2151895
5154,103,18,0,4.97,12.47,2151894,2151997
5155,98,22,1,5.22,16.42,2151996,2152094
5156,97,23,1,5.28,14.59,2152093,2152190
5157,62,51,1,8.26,49.93,2152190,2152252
5158,85,27,0,6.02,19.48,2152251,2152336
5159,73,31,0,7.01,20.29,2152335,2152408
5160,74,23,0,6.92,16.89,2152408,2152482
5161,86,15,1,5.95,8.72,2152481,2152567
5162,80,24,0,6.40,18.56,2152566,2152646
5163,86,30,0,5.95,22.53,2152645,2152731
5164,81,25,0,6.32,20.44,2152730,2152811
5165,98,20,0,5.22,14.36,2152811,2152909
5166,103,15,0,4.97,11.19,2152908,2153011
5167,87,21,1,5.89,14.81,2153010,2153097
5168,75,46,0,6.83,40.12,2153096,2153171
5169,81,21,1,6.32,12.59,2153170,2153251
5170,75,19,1,6.83,15.29,2153250,2153325
5171,78,19,1,6.56,14.25,2153324,2153402
5172,88,16,1,5.82,10.33,2153401,2153489
5173,80,14,0,6.40,12.86,2153488,2153568
5174,80,25,0,6.40,21.71,2153567,2153647
5175,81,23,0,6.32,17.90,2153647,2153728
5176,86,37,0,5.95,40.02,2153727,2153813
5177,86,22,0,5.95,21.67,2153812,2153898
5178,87,28,0,5.89,26.52,2153897,2153984
5179,102,20,0,5.02,18.73,2153983,2154085
5180,87,37,0,5.89,26.56,2154084,2154171
5181,88,18,0,5.82,13.51,2154171,2154259
5182,82,20,1,6.24,12.92,2154259,2154341
5183,83,31,1,6.17,22.84,2154341,2154424
5184,77,33,0,6.65,27.58,2154423,2154500
5185,76,20,0,6.74,20.19,2154499,2154575
5186,77,29,1,6.65,22.75,2154574,2154651
5187,82,25,1,6.24,16.65,2154650,2154732
5188,84,22,0,6.10,15.04,2154732,2154816
5189,73,57,0,7.01,52.07,2154815,2154888
5190,109,14,0,4.70,8.95,2154888,2154997
5191,108,16,0,4.74,11.66,2154997,2155105
5192,96,18,0,5.33,12.76,2155105,2155201
5193,80,44,1,6.40,33.74,2155200,2155280
5194,77,22,1,6.65,13.50,2155279,2155356
5195,79,33,0,6.48,29.19,2155355,2155434
5196,85,24,0,6.02,20.05,2155433,2155518
5197,86,18,0,5.95,16.25,2155517,2155603
5198,89,21,1,5.75,12.14,2155603,2155692
5199,88,16,1,5.82,10.22,2155691,2155779
5200,78,25,1,6.56,19.09,2155778,2155856
5201,92,26,0,5.57,21.22,2155855,2155947
5202,70,39,0,7.31,39.02,2155946,2156016
5203,98,27,0,5.22,23.46,2156015,2156113
5204,89,28,0,5.75,22.28,2156112,2156201
5205,88,33,0,5.82,28.40,2156201,2156289
5206,116,16,1,4.41,7.28,2156288,2156404
5207,74,35,1,6.92,25.02,2156403,2156477
5208,72,27,1,7.11,23.21,2156477,2156549
5209,93,26,0,5.51,14.98,2156548,2156641
5210,79,23,1,6.48,14.00,2156640,2156719
5211,92,31,0,5.57,15.98,2156718,2156810
5212,89,20,0,5.75,19.58,2156809,2156898
5213,83,30,0,6.17,20.16,2156897,2156980
5214,83,28,0,6.17,18.91,2156979,2157062
5215,83,37,0,6.17,38.07,2157062,2157145
5216,76,29,0,6.74,27.01,2157144,2157220
5217,109,20,0,4.70,12.25,2157219,2157328
5218,100,15,0,5.12,11.49,2157327,2157427
5219,71,45,1,7.21,33.29,2157426,2157497
5220,80,26,0,6.40,21.01,2157496,2157576
5221,81,22,1,6.32,18.37,2157575,2157656
5222,84,14,0,6.10,9.49,2157655,2157739
5223,85,19,0,6.02,16.61,2157738,2157823
5224,75,20,1,6.83,19.10,2157823,2157898
5225,86,17,1,5.95,13.37,2157897,2157983
5226,68,33,1,7.53,27.40,2157982,2158050
5227,80,22,0,6.40,17.19,2158049,2158129
5228,58,35,0,8.83,38.14,2158129,2158187
5229,113,16,0,4.53,10.53,2158187,2158300
5230,84,26,1,6.10,20.92,2158299,2158383
5231,102,14,0,5.02,11.80,2158382,2158484
5232,87,20,1,5.89,15.69,2158483,2158570
5233,74,40,1,6.92,36.18,2158569,2158643
5234,76,38,0,6.74,33.54,2158642,2158718
5235,70,21,1,7.31,21.93,2158717,2158787
5236,85,24,1,6.02,17.01,2158787,2158872
5237,85,16,1,6.02,10.63,2158871,2158956
5238,90,22,0,5.69,15.35,2158955,2159045
5239,68,29,2,7.53,23.60,2159044,2159112
5240,69,30,1,7.42,28.27,2159111,2159180
5241,86,33,0,5.95,30.00,2159180,2159266
5242,79,20,0,6.48,13.97,2159266,2159345
5243,57,103,0,8.98,183.21,2159345,2159402
5244,98,23,0,5.22,13.32,2159402,2159500
5245,90,31,0,5.69,19.33,2159499,2159589
5246,94,20,0,5.45,15.52,2159588,2159682
5247,106,42,0,4.83,23.10,2159682,2159788
5248,106,23,0,4.83,11.71,2159788,2159894
5249,88,18,0,5.82,11.22,2159893,2159981
5250,84,24,1,6.10,16.92,2159980,2160064
5251,70,25,1,7.31,21.39,2160063,2160133
5252,82,19,1,6.24,15.43,2160132,2160214
5253,81,28,1,6.32,20.51,2160213,2160294
5254,76,36,0,6.74,30.88,2160293,2160369
5255,79,23,1,6.48,20.53,2160368,2160447
5256,88,22,0,5.82,17.26,2160446,2160534
5257,106,16,0,4.83,9.10,2160533,2160639
5258,89,36,0,5.75,28.05,2160639,2160728
5259,103,20,1,4.97,14.07,2160727,2160830
5260,76,24,0,6.74,22.25,2160829,2160905
5261,75,28,1,6.83,21.66,2160904,2160979
5262,80,49,1,6.40,34.39,2160978,2161058
5263,91,20,1,5.63,11.68,2161057,2161148
5264,71,29,1,7.21,23.49,2161147,2161218
5265,89,33,0,5.75,23.65,2161217,2161306
5266,91,18,1,5.63,12.78,2161305,2161396
5267,74,50,1,6.92,46.45,2161395,2161469
5268,96,20,0,5.33,16.66,2161468,2161564
5269,104,17,0,4.92,11.09,2161564,2161668
5270,92,39,0,5.57,21.64,2161668,2161760
5271,94,26,0,5.45,18.42,2161759,2161853
5272,93,15,0,5.51,10.68,2161852,2161945
5273,77,35,1,6.65,29.97,2161944,2162021
5274,75,25,1,6.83,23.80,2162020,2162095
5275,82,17,0,6.24,13.53,2162094,2162176
5276,95,17,1,5.39,12.79,2162175,2162270
5277,74,21,0,6.92,17.80,2162270,2162344
5278,82,26,1,6.24,24.89,2162344,2162426
5279,97,29,0,5.28,24.63,2162425,2162522
5280,84,22,1,6.10,16.01,2162521,2162605
5281,112,20,0,4.57,12.71,2162605,2162717
5282,100,30,1,5.12,19.87,2162716,2162816
5283,80,40,1,6.40,24.31,2162815,2162895
5284,76,30,1,6.74,25.27,2162894,2162970
5285,83,23,0,6.17,15.83,2162969,2163052
5286,86,23,0,5.95,15.70,2163051,2163137
5287,82,21,1,6.24,12.18,2163137,2163219
5288,74,29,0,6.92,28.64,2163218,2163292
5289,83,31,1,6.17,27.68,2163291,2163374
5290,84,16,1,6.10,11.30,2163373,2163457
5291,76,35,1,6.74,26.80,2163457,2163533
5292,104,16,0,4.92,12.94,2163532,2163636
5293,98,21,0,5.22,15.28,2163635,2163733
5294,98,26,0,5.22,23.21,2163732,2163830
5295,101,22,0,5.07,13.73,2163829,2163930
5296,82,28,0,6.24,30.77,2163929,2164011
5297,88,18,0,5.82,14.17,2164010,2164098
5298,78,23,1,6.56,17.53,2164097,2164175
5299,88,21,0,5.82,11.90,2164175,2164263
5300,78,25,1,6.56,19.66,2164262,2164340
5301,82,26,0,6.24,22.70,2164339,2164421
5302,72,46,1,7.11,34.46,2164420,2164492
5303,95,15,0,5.39,11.42,2164491,2164586
5304,84,27,1,6.10,22.54,2164585,2164669
5305,77,52,0,6.65,39.45,2164668,2164745
5306,74,59,0,6.92,56.16,2164745,2164819
5307,84,23,0,6.10,21.44,2164818,2164902
5308,89,41,0,5.75,33.06,2164901,2164990
5309,80,31,0,6.40,32.66,2164989,2165069
5310,88,27,1,5.82,27.24,2165068,2165156
5311,85,22,0,6.02,15.76,2165156,2165241
5312,93,14,0,5.51,10.14,2165240,2165333
5313,64,35,0,8.00,48.88,2165332,2165396
5314,87,23,0,5.89,13.71,2165395,2165482
5315,78,30,1,6.56,16.96,2165481,2165559
5316,72,29,0,7.11,31.49,2165558,2165630
5317,77,45,0,6.65,37.47,2165630,2165707
5318,77,33,1,6.65,33.71,2165706,2165783
5319,82,24,1,6.24,19.94,2165782,2165864
5320,73,31,1,7.01,31.25,2165863,2165936
5321,86,17,0,5.95,14.60,2165936,2166022
5322,83,25,0,6.17,22.36,2166021,2166104
5323,63,27,0,8.13,41.76,2166104,2166167
5324,103,17,0,4.97,13.97,2166166,2166269
5325,72,71,0,7.11,77.07,2166268,2166340
5326,91,21,1,5.63,18.56,2166339,2166430
5327,74,34,1,6.92,27.91,2166429,2166503
5328,75,28,1,6.83,16.38,2166502,2166577
5329,75,22,1,6.83,18.36,2166576,2166651
5330,73,26,1,7.01,26.12,2166650,2166723
5331,75,30,1,6.83,27.82,2166722,2166797
5332,80,20,0,6.40,16.24,2166796,2166876
5333,72,34,1,7.11,27.57,2166876,2166948
5334,71,29,0,7.21,25.18,2166947,2167018
5335,102,19,0,5.02,12.94,2167017,2167119
5336,69,28,1,7.42,27.61,2167118,2167187
5337,70,108,1,7.31,162.82,2167186,2167256
5338,71,23,0,7.21,21.49,2167255,2167326
5339,94,21,0,5.45,13.40,2167326,2167420
5340,79,27,0,6.48,23.84,2167419,2167498
5341,96,26,0,5.33,16.49,2167497,2167593
5342,103,21,0,4.97,13.54,2167592,2167695
5343,81,22,1,6.32,16.81,2167694,2167775
5344,75,17,1,6.83,16.57,2167774,2167849
5345,79,23,1,6.48,14.71,2167848,2167927
5346,95,24,1,5.39,16.30,2167926,2168021
5347,104,24,0,4.92,18.71,2168020,2168124
5348,91,31,0,5.63,20.85,2168123,2168214
5349,85,23,0,6.02,20.68,2168213,2168298
5350,89,21,0,5.75,13.80,2168297,2168386
5351,73,22,1,7.01,19.90,2168385,2168458
5352,76,22,1,6.74,16.61,2168457,2168533
5353,88,22,0,5.82,14.13,2168532,2168620
5354,76,22,1,6.74,21.88,2168619,2168695
5355,89,28,0,5.75,26.52,2168694,2168783
5356,84,30,0,6.10,21.32,2168783,2168867
5357,109,19,0,4.70,10.28,2168866,2168975
5358,76,23,1,6.74,19.17,2168974,2169050
5359,62,67,0,8.26,92.35,2169049,2169111
5360,80,18,1,6.40,16.49,2169110,2169190
5361,70,20,0,7.31,19.24,2169190,2169260
5362,70,24,1,7.31,21.44,2169259,2169329
5363,99,34,0,5.17,22.36,2169328,2169427
5364,101,36,0,5.07,22.48,2169426,2169527
5365,74,40,0,6.92,33.67,2169526,2169600
5366,88,19,1,5.82,12.42,2169600,2169688
5367,75,21,1,6.83,20.68,2169687,2169762
5368,86,27,0,5.95,18.32,2169761,2169847
5369,68,25,1,7.53,26.37,2169846,2169914
5370,63,98,1,8.13,154.46,2169913,2169976
5371,86,30,0,5.95,23.53,2169975,2170061
5372,91,30,0,5.63,27.49,2170060,2170151
5373,96,25,0,5.33,15.31,2170150,2170246
5374,78,23,1,6.56,17.22,2170246,2170324
5375,71,30,0,7.21,28.56,2170323,2170394
5376,78,24,0,6.56,18.81,2170393,2170471
5377,88,15,1,5.82,9.72,2170471,2170559
5378,84,23,0,6.10,19.40,2170558,2170642
5379,83,30,0,6.17,20.69,2170641,2170724
5380,84,23,0,6.10,20.54,2170723,2170807
5381,96,20,0,5.33,18.12,2170806,2170902
5382,94,19,0,5.45,18.33,2170901,2170995
5383,102,25,0,5.02,14.71,2170994,2171096
5384,80,31,0,6.40,24.49,2171095,2171175
5385,85,25,1,6.02,14.09,2171174,2171259
5386,69,66,1,7.42,73.90,2171258,2171327
5387,83,21,0,6.17,22.84,2171326,2171409
5388,64,64,1,8.00,74.78,2171408,2171472
5389,87,23,1,5.89,19.89,2171472,2171559
5390,103,22,0,4.97,14.07,2171558,2171661
5391,79,43,0,6.48,37.16,2171660,2171739
5392,105,22,0,4.88,11.35,2171738,2171843
5393,80,29,0,6.40,19.39,2171843,2171923
5394,80,18,0,6.40,20.11,2171922,2172002
5395,63,28,2,8.13,32.17,2172001,2172064
5396,71,20,0,7.21,16.98,2172063,2172134
5397,77,24,1,6.65,16.95,2172133,2172210
5398,84,32,0,6.10,23.44,2172209,2172293
5399,75,31,1,6.83,32.78,2172292,2172367
5400,110,26,0,4.65,20.30,2172366,2172476
5401,88,23,1,5.82,16.90,2172476,2172564
5402,86,23,1,5.95,15.53,2172563,2172649
5403,73,28,0,7.01,21.71,2172649,2172722
5404,79,16,1,6.48,11.54,2172721,2172800
5405,69,26,2,7.42,20.48,2172799,2172868
5406,78,34,0,6.56,22.17,2172868,2172946
5407,79,25,0,6.48,22.65,2172945,2173024
5408,102,15,0,5.02,11.82,2173023,2173125
5409,89,22,0,5.75,17.74,2173124,2173213
5410,92,31,0,5.57,18.81,2173212,2173304
5411,85,26,0,6.02,19.93,2173303,2173388
5412,96,15,1,5.33,9.62,2173387,2173483
5413,75,26,1,6.83,22.94,2173482,2173557
5414,96,24,0,5.33,12.49,2173557,2173653
5415,83,29,0,6.17,18.48,2173652,2173735
5416,84,36,0,6.10,29.66,2173735,2173819
5417,117,25,0,4.38,10.22,2173818,2173935
5418,99,20,1,5.17,13.15,2173935,2174034
5419,92,22,1,5.57,10.96,2174033,2174125
5420,94,16,1,5.45,8.67,2174124,2174218
5421,73,29,0,7.01,22.04,2174217,2174290
5422,82,20,2,6.24,11.87,2174289,2174371
5423,77,35,1,6.65,23.45,2174370,2174447
5424,83,34,1,6.17,26.72,2174446,2174529
5425,94,22,0,5.45,17.29,2174528,2174622
5426,96,20,1,5.33,15.68,2174621,2174717
5427,94,37,1,5.45,32.72,2174716,2174810
5428,79,20,1,6.48,15.19,2174809,2174888
5429,80,21,1,6.40,19.26,2174887,2174967
5430,86,25,1,5.95,15.32,2174966,2175052
5431,79,17,0,6.48,15.41,2175051,2175130
5432,69,46,1,7.42,53.37,2175130,2175199
5433,84,23,0,6.10,19.59,2175198,2175282
5434,93,15,0,5.51,11.20,2175281,2175374
5435,114,15,0,4.49,9.30,2175373,2175487
5436,81,54,0,6.32,40.07,2175487,2175568
5437,83,26,0,6.17,18.09,2175567,2175650
5438,67,30,1,7.64,32.32,2175650,2175717
5439,80,40,1,6.40,33.24,2175716,2175796
5440,83,19,1,6.17,12.55,2175796,2175879
5441,85,21,1,6.02,13.06,2175878,2175963
5442,70,92,0,7.31,117.90,2175962,2176032
5443,84,28,0,6.10,25.87,2176031,2176115
5444,101,57,0,5.07,44.38,2176114,2176215
5445,92,39,0,5.57,24.98,2176214,2176306
5446,94,21,0,5.45,16.55,2176305,2176399
5447,102,21,0,5.02,14.43,2176398,2176500
5448,85,28,0,6.02,19.20,2176500,2176585
5449,73,34,1,7.01,21.58,2176584,2176657
5450,91,21,1,5.63,13.16,2176656,2176747
5451,81,27,1,6.32,17.75,2176747,2176828
5452,95,18,0,5.39,10.17,2176827,2176922
5453,91,22,0,5.63,14.26,2176921,2177012
5454,86,26,0,5.95,19.39,2177011,2177097
5455,86,48,0,5.95,37.58,2177096,2177182
5456,87,21,0,5.89,18.38,2177181,2177268
5457,89,16,0,5.75,13.65,2177267,2177356
5458,101,18,0,5.07,13.19,2177356,2177457
5459,92,19,0,5.57,16.68,2177457,2177549
5460,86,17,1,5.95,14.16,2177548,2177634
5461,80,24,1,6.40,16.04,2177633,2177713
5462,73,30,1,7.01,27.30,2177712,2177785
5463,71,20,1,7.21,20.84,2177784,2177855
5464,83,21,0,6.17,16.12,2177854,2177937
5465,85,21,1,6.02,18.19,2177936,2178021
5466,76,21,1,6.74,18.77,2178020,2178096
5467,61,65,0,8.39,83.52,2178095,2178156
5468,75,23,0,6.83,20.76,2178155,2178230
5469,80,32,0,6.40,30.67,2178229,2178309
5470,106,23,0,4.83,12.69,2178308,2178414
5471,91,16,0,5.63,12.83,2178413,2178504
5472,83,26,1,6.17,24.67,2178503,2178586
5473,79,32,0,6.48,23.97,2178585,2178664
5474,81,18,0,6.32,11.03,2178663,2178744
5475,83,18,0,6.17,13.90,2178743,2178826
5476,88,23,1,5.82,14.99,2178825,2178913
5477,79,32,1,6.48,22.17,2178912,2178991
5478,97,20,1,5.28,14.30,2178990,2179087
5479,90,14,0,5.69,9.64,2179086,2179176
5480,81,33,1,6.32,20.69,2179175,2179256
5481,107,18,0,4.79,17.46,2179255,2179362
5482,88,48,0,5.82,50.40,2179361,2179449
5483,108,15,0,4.74,10.75,2179448,2179556
5484,80,36,1,6.40,29.17,2179555,2179635
5485,109,17,0,4.70,8.83,2179634,2179743
5486,70,40,1,7.31,31.10,2179742,2179812
5487,68,34,1,7.53,35.81,2179811,2179879
5488,85,27,0,6.02,19.27,2179878,2179963
5489,83,19,1,6.17,11.97,2179962,2180045
5490,84,34,0,6.10,24.18,2180045,2180129
5491,88,18,0,5.82,12.15,2180128,2180216
5492,80,34,0,6.40,20.81,2180215,2180295
5493,99,29,0,5.17,24.30,2180295,2180394
5494,102,19,0,5.02,11.35,2180393,2180495
5495,90,23,1,5.69,16.30,2180494,2180584
5496,93,14,0,5.51,10.70,2180584,2180677
5497,76,22,1,6.74,17.61,2180677,2180753
5498,58,47,1,8.83,85.73,2180752,2180810
5499,84,19,0,6.10,18.16,2180809,2180893
5500,87,29,0,5.89,21.71,2180892,2180979
5501,77,36,1,6.65,26.67,2180978,2181055
5502,85,27,1,6.02,16.63,2181054,2181139
5503,87,28,0,5.89,16.38,2181139,2181226
5504,88,15,1,5.82,9.33,2181226,2181314
5505,89,20,0,5.75,14.61,2181313,2181402
5506,80,24,1,6.40,20.49,2181401,2181481
5507,95,19,0,5.39,14.17,2181480,2181575
5508,106,19,0,4.83,13.10,2181575,2181681
5509,94,29,0,5.45,17.57,2181680,2181774
5510,100,25,0,5.12,17.89,2181773,2181873
5511,94,20,0,5.45,14.40,2181873,2181967
5512,77,26,0,6.65,20.41,2181966,2182043
5513,88,22,0,5.82,13.29,2182042,2182130
5514,85,30,0,6.02,19.91,2182129,2182214
5515,83,28,0,6.17,24.67,2182213,2182296
5516,87,21,1,5.89,13.66,2182296,2182383
5517,77,31,0,6.65,32.64,2182382,2182459
5518,87,43,0,5.89,27.96,2182459,2182546
5519,98,41,0,5.22,21.77,2182545,2182643
5520,100,22,0,5.12,17.17,2182642,2182742
5521,105,25,0,4.88,13.35,2182742,2182847
5522,90,35,1,5.69,21.46,2182847,2182937
5523,71,21,0,7.21,18.65,2182936,2183007
5524,80,22,1,6.40,17.76,2183006,2183086
5525,81,23,1,6.32,18.98,2183085,2183166
5526,84,17,1,6.10,11.13,2183165,2183249
5527,76,32,0,6.74,21.83,2183248,2183324
5528,82,20,1,6.24,14.06,2183323,2183405
5529,90,27,0,5.69,20.84,2183404,2183494
5530,79,53,1,6.48,47.36,2183493,2183572
5531,70,39,1,7.31,33.53,2183571,2183641
5532,72,25,0,7.11,25.74,2183640,2183712
5533,83,34,0,6.17,46.16,2183711,2183794
5534,80,49,0,6.40,43.54,2183793,2183873
5535,106,22,0,4.83,14.59,2183872,2183978
5536,105,18,0,4.88,10.97,2183977,2184082
5537,75,38,0,6.83,34.28,2184082,2184157
5538,80,22,0,6.40,20.74,2184157,2184237
5539,85,18,0,6.02,11.98,2184236,2184321
5540,78,34,0,6.56,27.09,2184320,2184398
5541,89,35,0,5.75,20.97,2184397,2184486
5542,77,19,0,6.65,15.42,2184486,2184563
5543,80,21,0,6.40,21.39,2184562,2184642
5544,76,35,0,6.74,34.19,2184641,2184717
5545,74,34,0,6.92,34.26,2184717,2184791
5546,64,92,1,8.00,138.22,2184790,2184854
5547,86,18,1,5.95,12.95,2184853,2184939
5548,107,18,0,4.79,13.83,2184938,2185045
5549,77,42,0,6.65,39.50,2185044,2185121
5550,102,24,0,5.02,17.55,2185120,2185222
5551,71,23,0,7.21,28.11,2185221,2185292
5552,89,29,0,5.75,25.69,2185291,2185380
5553,85,36,0,6.02,27.08,2185379,2185464
5554,83,27,0,6.17,17.54,2185463,2185546
5555,82,21,0,6.24,18.33,2185545,2185627
5556,79,17,0,6.48,16.10,2185626,2185705
5557,88,19,1,5.82,16.06,2185704,2185792
5558,70,31,0,7.31,32.27,2185791,2185861
5559,90,22,0,5.69,15.68,2185860,2185950
5560,87,26,1,5.89,18.19,2185949,2186036
5561,55,103,1,9.31,211.89,2186035,2186090
5562,83,22,1,6.17,16.53,2186089,2186172
5563,102,27,0,5.02,25.82,2186171,2186273
5564,80,20,1,6.40,18.11,2186272,2186352
5565,93,33,0,5.51,31.00,2186351,2186444
5566,99,20,1,5.17,14.43,2186443,2186542
5567,99,23,1,5.17,14.53,2186541,2186640
5568,82,77,1,6.24,84.62,2186639,2186721
5569,84,23,1,6.10,14.99,2186720,2186804
5570,79,23,0,6.48,18.71,2186803,2186882
5571,96,18,1,5.33,11.56,2186881,2186977
5572,88,26,0,5.82,15.29,2186976,2187064
5573,79,25,0,6.48,13.46,2187063,2187142
5574,74,24,2,6.92,19.40,2187141,2187215
5575,79,26,0,6.48,25.59,2187214,2187293
5576,92,19,0,5.57,14.27,2187293,2187385
5577,74,43,0,6.92,43.72,2187384,2187458
5578,88,27,0,5.82,21.58,2187458,2187546
5579,89,33,0,5.75,24.73,2187545,2187634
5580,87,26,0,5.89,25.37,2187634,2187721
5581,91,21,1,5.63,14.32,2187720,2187811
5582,93,21,1,5.51,13.35,2187810,2187903
5583,89,18,1,5.75,16.19,2187903,2187992
5584,87,19,0,5.89,12.22,2187991,2188078
5585,78,25,0,6.56,20.63,2188078,2188156
5586,73,27,1,7.01,19.19,2188155,2188228
5587,86,28,0,5.95,21.51,2188227,2188313
5588,80,31,0,6.40,25.64,2188312,2188392
5589,74,35,1,6.92,27.94,2188391,2188465
5590,78,28,1,6.56,19.60,2188464,2188542
5591,97,28,0,5.28,19.64,2188541,2188638
5592,78,40,0,6.56,34.96,2188637,2188715
5593,98,27,0,5.22,19.19,2188714,2188812
5594,88,26,1,5.82,22.74,2188811,2188899
5595,84,17,0,6.10,14.47,2188898,2188982
5596,71,18,1,7.21,13.86,2188981,2189052
5597,88,26,0,5.82,18.90,2189052,2189140
5598,70,49,1,7.31,41.82,2189139,2189209
5599,78,25,0,6.56,24.63,2189208,2189286
5600,89,28,0,5.75,18.73,2189285,2189374
5601,79,38,1,6.48,35.06,2189374,2189453
5602,68,22,1,7.53,16.69,2189452,2189520
5603,79,33,0,6.48,30.33,2189519,2189598
5604,70,25,0,7.31,24.70,2189597,2189667
5605,69,27,1,7.42,28.27,2189667,2189736
5606,87,25,0,5.89,20.68,2189735,2189822
5607,85,23,0,6.02,24.42,2189822,2189907
5608,101,22,0,5.07,14.26,2189906,2190007
5609,103,22,0,4.97,13.87,2190006,2190109
5610,93,52,0,5.51,33.93,2190109,2190202
5611,75,40,1,6.83,28.44,2190201,2190276
5612,83,20,0,6.17,18.91,2190276,2190359
5613,88,26,0,5.82,18.29,2190358,2190446
5614,76,25,0,6.74,25.61,2190445,2190521
5615,73,28,1,7.01,23.90,2190520,2190593
5616,83,24,0,6.17,10.43,2190592,2190675
5617,80,21,1,6.40,19.79,2190674,2190754
5618,75,36,0,6.83,23.72,2190753,2190828
5619,88,21,0,5.82,15.97,2190828,2190916
5620,71,48,0,7.21,48.42,2190915,2190986
5621,101,22,0,5.07,20.76,2190985,2191086
5622,89,20,0,5.75,13.92,2191085,2191174
5623,93,44,0,5.51,28.83,2191174,2191267
5624,93,24,0,5.51,18.44,2191266,2191359
5625,85,24,0,6.02,21.48,2191358,2191443
5626,94,18,0,5.45,10.89,2191442,2191536
5627,79,22,1,6.48,17.46,2191535,2191614
5628,73,18,0,7.01,16.84,2191613,2191686
5629,72,31,1,7.11,32.82,2191685,2191757
5630,80,29,1,6.40,25.29,2191756,2191836
5631,71,30,1,7.21,29.15,2191835,2191906
5632,68,26,1,7.53,31.93,2191905,2191973
5633,88,22,1,5.82,11.99,2191972,2192060
5634,87,24,0,5.89,19.14,2192059,2192146
5635,74,35,1,6.92,40.91,2192145,2192219
5636,89,26,0,5.75,25.83,2192218,2192307
5637,65,64,1,7.88,72.32,2192307,2192372
5638,94,32,0,5.45,22.82,2192371,2192465
5639,92,16,0,5.57,13.83,2192464,2192556
5640,100,13,1,5.12,8.75,2192555,2192655
5641,79,57,1,6.48,48.71,2192655,2192734
5642,72,29,0,7.11,25.85,2192733,2192805
5643,78,32,1,6.56,26.30,2192804,2192882
5644,79,17,1,6.48,11.87,2192881,2192960
5645,85,34,0,6.02,19.29,2192959,2193044
5646,85,25,1,6.02,19.76,2193043,2193128
5647,75,23,1,6.83,17.77,2193127,2193202
5648,84,20,0,6.10,13.92,2193201,2193285
5649,90,18,0,5.69,14.48,2193285,2193375
5650,87,21,0,5.89,14.15,2193374,2193461
5651,89,29,0,5.75,23.11,2193460,2193549
5652,87,31,0,5.89,31.16,2193548,2193635
5653,100,20,0,5.12,18.13,2193634,2193734
5654,97,33,0,5.28,18.76,2193734,2193831
5655,100,15,0,5.12,9.83,2193830,2193930
5656,92,20,0,5.57,15.48,2193929,2194021
5657,79,25,1,6.48,21.72,2194020,2194099
5658,80,20,1,6.40,15.49,2194098,2194178
5659,71,27,0,7.21,23.27,2194178,2194249
5660,76,40,0,6.74,32.06,2194249,2194325
5661,75,43,1,6.83,38.68,2194324,2194399
5662,87,20,0,5.89,11.18,2194399,2194486
5663,92,22,1,5.57,12.77,2194486,2194578
5664,91,28,0,5.63,20.12,2194577,2194668
5665,79,27,1,6.48,19.39,2194667,2194746
5666,99,21,0,5.17,13.86,2194745,2194844
5667,91,26,0,5.63,18.23,2194844,2194935
5668,104,17,0,4.92,13.11,2194934,2195038
5669,101,27,0,5.07,16.16,2195037,2195138
5670,100,34,0,5.12,18.51,2195138,2195238
5671,83,21,1,6.17,12.28,2195238,2195321
5672,98,16,1,5.22,8.52,2195320,2195418
5673,84,15,1,6.10,10.13,2195417,2195501
5674,82,28,0,6.24,23.96,2195500,2195582
5675,77,29,1,6.65,24.90,2195581,2195658
5676,79,22,0,6.48,17.39,2195657,2195736
5677,81,18,0,6.32,16.49,2195735,2195816
5678,80,27,0,6.40,28.94,2195815,2195895
5679,83,39,0,6.17,41.73,2195894,2195977
5680,82,27,1,6.24,20.50,2195976,2196058
5681,90,32,0,5.69,23.37,2196057,2196147
5682,89,28,0,5.75,25.02,2196146,2196235
5683,98,35,0,5.22,27.85,2196234,2196332
5684,111,12,0,4.61,9.39,2196331,2196442
5685,95,38,0,5.39,31.67,2196441,2196536
5686,72,44,0,7.11,33.52,2196535,2196607
5687,83,21,1,6.17,13.92,2196606,2196689
5688,70,28,2,7.31,20.56,2196688,2196758
5689,90,18,1,5.69,11.30,2196757,2196847
5690,72,23,2,7.11,18.02,2196846,2196918
5691,85,24,0,6.02,20.00,2196917,2197002
5692,60,48,1,8.53,52.18,2197001,2197061
5693,79,66,1,6.48,61.52,2197060,2197139
5694,85,29,0,6.02,28.49,2197138,2197223
5695,83,18,0,6.17,18.74,2197222,2197305
5696,100,19,0,5.12,16.47,2197304,2197404
5697,75,34,0,6.83,39.24,2197404,2197479
5698,89,23,0,5.75,17.74,2197478,2197567
5699,81,42,0,6.32,46.34,2197566,2197647
5700,90,32,0,5.69,20.97,2197647,2197737
5701,83,20,0,6.17,14.60,2197736,2197819
5702,82,18,0,6.24,15.38,2197819,2197901
5703,79,34,0,6.48,22.30,2197900,2197979
5704,87,23,1,5.89,17.30,2197978,2198065
5705,71,29,0,7.21,23.43,2198064,2198135
5706,85,23,1,6.02,17.95,2198134,2198219
5707,84,29,1,6.10,18.13,2198218,2198302
5708,89,17,1,5.75,11.42,2198301,2198390
5709,83,22,1,6.17,16.14,2198389,2198472
5710,98,26,0,5.22,18.70,2198471,2198569
5711,86,16,1,5.95,13.79,2198568,2198654
5712,75,60,0,6.83,59.37,2198653,2198728
5713,113,26,0,4.53,19.90,2198727,2198840
5714,90,49,0,5.69,43.64,2198840,2198930
5715,101,20,0,5.07,15.05,2198929,2199030
5716,116,16,0,4.41,9.31,2199029,2199145
5717,91,22,0,5.63,12.70,2199144,2199235
5718,87,22,1,5.89,15.64,2199235,2199322
5719,81,19,1,6.32,13.45,2199321,2199402
5720,86,20,0,5.95,15.23,2199401,2199487
5721,76,23,0,6.74,15.48,2199487,2199563
5722,79,32,1,6.48,21.31,2199563,2199642
5723,82,22,1,6.24,15.87,2199641,2199723
5724,79,24,0,6.48,21.46,2199722,2199801
5725,71,53,1,7.21,71.35,2199800,2199871
5726,72,28,0,7.11,32.54,2199870,2199942
5727,74,20,1,6.92,18.67,2199941,2200015
5728,107,23,0,4.79,13.59,2200014,2200121
5729,90,29,0,5.69,17.88,2200120,2200210
5730,87,15,0,5.89,10.35,2200210,2200297
5731,75,26,1,6.83,27.56,2200296,2200371
5732,67,27,1,7.64,34.59,2200370,2200437
5733,87,28,1,5.89,16.10,2200436,2200523
5734,74,32,1,6.92,33.67,2200522,2200596
5735,77,40,0,6.65,29.19,2200596,2200673
5736,95,16,0,5.39,8.91,2200672,2200767
5737,79,29,1,6.48,22.35,2200766,2200845
5738,88,19,0,5.82,16.69,2200844,2200932
5739,77,83,0,6.65,132.38,2200931,2201008
5740,88,39,0,5.82,35.51,2201007,2201095
5741,81,28,1,6.32,26.59,2201094,2201175
5742,106,32,0,4.83,22.46,2201174,2201280
5743,104,20,0,4.92,13.55,2201280,2201384
5744,79,20,1,6.48,16.07,2201383,2201462
5745,91,13,0,5.63,9.38,2201461,2201552
5746,73,47,1,7.01,41.11,2201551,2201624
5747,83,27,1,6.17,24.31,2201623,2201706
5748,88,25,0,5.82,17.58,2201705,2201793
5749,74,24,1,6.92,20.86,2201792,2201866
5750,79,19,1,6.48,15.03,2201865,2201944
5751,96,27,0,5.33,15.81,2201943,2202039
5752,76,25,1,6.74,19.83,2202038,2202114
5753,85,35,1,6.02,24.73,2202113,2202198
5754,79,29,0,6.48,29.21,2202197,2202276
5755,103,27,0,4.97,19.21,2202276,2202379
5756,83,42,0,6.17,28.60,2202379,2202462
5757,85,24,0,6.02,17.69,2202462,2202547
5758,86,30,0,5.95,27.42,2202546,2202632
5759,101,22,0,5.07,15.59,2202631,2202732
5760,92,36,1,5.57,25.33,2202732,2202824
5761,75,26,1,6.83,22.14,2202823,2202898
5762,81,30,1,6.32,23.67,2202897,2202978
5763,61,31,1,8.39,46.50,2202978,2203039
5764,75,25,1,6.83,19.93,2203038,2203113
5765,75,43,0,6.83,35.61,2203113,2203188
5766,72,37,1,7.11,32.90,2203187,2203259
5767,81,20,0,6.32,15.65,2203258,2203339
5768,81,32,0,6.32,28.71,2203338,2203419
5769,55,94,1,9.31,184.43,2203418,2203473
5770,82,35,0,6.24,29.57,2203472,2203554
5771,80,25,0,6.40,24.16,2203553,2203633
5772,110,22,0,4.65,17.99,2203632,2203742
5773,70,31,0,7.31,44.24,2203741,2203811
5774,103,42,0,4.97,30.75,2203810,2203913
5775,111,21,0,4.61,8.87,2203912,2204023
5776,82,24,1,6.24,26.11,2204022,2204104
5777,88,24,1,5.82,17.04,2204103,2204191
5778,72,20,2,7.11,14.88,2204190,2204262
5779,75,21,1,6.83,15.50,2204261,2204336
5780,71,40,1,7.21,29.86,2204335,2204406
5781,85,20,1,6.02,14.54,2204405,2204490
5782,78,21,1,6.56,18.22,2204489,2204567
5783,90,27,0,5.69,18.55,2204566,2204656
5784,68,36,1,7.53,30.96,2204655,2204723
5785,66,54,0,7.76,61.00,2204722,2204788
5786,97,19,0,5.28,13.91,2204787,2204884
5787,79,25,1,6.48,23.21,2204884,2204963
5788,89,23,0,5.75,23.02,2204962,2205051
5789,91,23,0,5.63,19.62,2205050,2205141
5790,105,22,0,4.88,16.05,2205141,2205246
5791,105,16,0,4.88,11.02,2205245,2205350
5792,86,21,1,5.95,14.70,2205350,2205436
5793,82,24,0,6.24,16.89,2205436,2205518
5794,82,22,1,6.24,15.36,2205517,2205599
5795,66,43,0,7.76,62.55,2205599,2205665
5796,73,25,0,7.01,26.56,2205664,2205737
5797,76,16,2,6.74,14.59,2205736,2205812
5798,84,23,0,6.10,18.63,2205811,2205895
5799,66,32,0,7.76,33.61,2205895,2205961
5800,76,21,0,6.74,21.77,2205960,2206036
5801,90,33,0,5.69,26.66,2206035,2206125
5802,84,26,0,6.10,26.49,2206124,2206208
5803,120,22,0,4.27,10.70,2206208,2206328
5804,101,20,0,5.07,13.73,2206327,2206428
5805,78,31,1,6.56,23.89,2206428,2206506
5806,72,25,1,7.11,17.63,2206505,2206577
5807,80,31,0,6.40,26.89,2206576,2206656
5808,92,15,1,5.57,8.59,2206655,2206747
5809,75,50,1,6.83,38.30,2206746,2206821
5810,67,19,1,7.64,14.17,2206820,2206887
5811,80,23,1,6.40,16.34,2206886,2206966
5812,68,83,1,7.53,100.48,2206965,2207033
5813,69,28,1,7.42,26.16,2207032,2207101
5814,74,46,0,6.92,44.99,2207100,2207174
5815,78,25,0,6.56,23.78,2207173,2207251
5816,109,23,0,4.70,18.14,2207250,2207359
5817,87,24,0,5.89,25.14,2207358,2207445
5818,84,38,0,6.10,33.92,2207444,2207528
5819,92,21,0,5.57,17.22,2207527,2207619
5820,92,27,0,5.57,19.57,2207618,2207710
5821,84,20,1,6.10,20.97,2207709,2207793
5822,83,36,1,6.17,27.83,2207792,2207875
5823,67,26,1,7.64,31.81,2207874,2207941
5824,73,42,1,7.01,37.68,2207940,2208013
5825,63,67,1,8.13,99.73,2208012,2208075
5826,78,26,1,6.56,21.71,2208074,2208152
5827,82,22,1,6.24,14.43,2208152,2208234
5828,76,38,1,6.74,26.22,2208234,2208310
5829,85,27,0,6.02,28.28,2208309,2208394
5830,87,21,1,5.89,17.96,2208393,2208480
5831,83,22,1,6.17,17.54,2208479,2208562
5832,83,29,0,6.17,23.49,2208561,2208644
5833,112,26,0,4.57,24.69,2208643,2208755
5834,103,17,0,4.97,15.78,2208754,2208857
5835,88,26,0,5.82,20.08,2208856,2208944
5836,102,26,0,5.02,19.18,2208943,2209045
5837,86,45,1,5.95,34.37,2209044,2209130
5838,79,24,1,6.48,14.05,2209129,2209208
5839,75,32,1,6.83,37.61,2209208,2209283
5840,82,20,0,6.24,16.31,2209282,2209364
5841,83,22,0,6.17,15.90,2209363,2209446
5842,82,15,0,6.24,11.89,2209445,2209527
5843,87,30,0,5.89,19.80,2209526,2209613
5844,86,18,0,5.95,14.07,2209612,2209698
5845,79,17,0,6.48,13.72,2209697,2209776
5846,84,28,1,6.10,20.06,2209775,2209859
5847,70,23,0,7.31,24.93,2209858,2209928
5848,82,36,0,6.24,44.94,2209927,2210009
5849,89,22,0,5.75,15.17,2210008,2210097
5850,85,39,0,6.02,29.06,2210096,2210181
5851,101,31,0,5.07,14.48,2210180,2210281
5852,106,33,0,4.83,20.01,2210280,2210386
5853,86,28,0,5.95,26.39,2210385,2210471
5854,72,23,0,7.11,22.68,2210470,2210542
5855,88,19,1,5.82,15.35,2210541,2210629
5856,92,19,0,5.57,13.92,2210628,2210720
5857,84,22,0,6.10,16.94,2210719,2210803
5858,82,27,1,6.24,15.04,2210802,2210884
5859,72,51,1,7.11,39.40,2210884,2210956
5860,82,20,1,6.24,20.84,2210956,2211038
5861,79,24,0,6.48,22.55,2211037,2211116
5862,92,20,0,5.57,15.70,2211115,2211207
5863,98,24,0,5.22,14.68,2211206,2211304
5864,86,22,0,5.95,16.39,2211304,2211390
5865,89,28,0,5.75,17.71,2211389,2211478
5866,84,20,1,6.10,12.21,2211477,2211561
5867,71,47,0,7.21,44.93,2211560,2211631
5868,78,22,1,6.56,14.40,2211630,2211708
5869,85,27,0,6.02,22.61,2211707,2211792
5870,81,18,0,6.32,13.90,2211792,2211873
5871,74,18,1,6.92,18.34,2211872,2211946
5872,75,23,1,6.83,15.58,2211945,2212020
5873,93,19,1,5.51,13.13,2212019,2212112
5874,80,25,0,6.40,18.59,2212111,2212191
5875,91,25,0,5.63,19.90,2212190,2212281
5876,72,20,0,7.11,20.85,2212280,2212352
5877,67,32,0,7.64,40.41,2212352,2212419
5878,102,32,0,5.02,21.51,2212418,2212520
5879,86,17,0,5.95,21.23,2212519,2212605
5880,82,34,1,6.24,22.28,2212604,2212686
5881,106,21,0,4.83,11.03,2212685,2212791
5882,71,44,1,7.21,40.76,2212790,2212861
5883,92,18,1,5.57,10.77,2212861,2212953
5884,86,22,1,5.95,16.30,2212952,2213038
5885,73,31,1,7.01,21.55,2213037,2213110
5886,76,54,1,6.74,43.96,2213109,2213185
5887,86,18,0,5.95,14.63,2213184,2213270
5888,87,27,0,5.89,19.25,2213270,2213357
5889,86,33,0,5.95,25.70,2213356,2213442
5890,77,21,1,6.65,21.19,2213441,2213518
5891,95,23,0,5.39,14.11,2213517,2213612
5892,89,37,0,5.75,24.55,2213611,2213700
5893,99,26,0,5.17,16.40,2213700,2213799
5894,97,13,1,5.28,8.32,2213798,2213895
5895,85,22,1,6.02,17.79,2213894,2213979
5896,74,23,1,6.92,23.72,2213978,2214052
5897,79,23,0,6.48,18.20,2214051,2214130
5898,74,19,0,6.92,20.43,2214130,2214204
5899,68,38,1,7.53,29.43,2214203,2214271
5900,70,19,1,7.31,16.90,2214271,2214341
5901,79,20,0,6.48,16.86,2214340,2214419
5902,91,21,0,5.63,15.64,2214419,2214510
5903,74,36,1,6.92,28.21,2214509,2214583
5904,71,37,1,7.21,50.03,2214583,2214654
5905,84,25,1,6.10,18.99,2214653,2214737
5906,98,29,0,5.22,20.54,2214736,2214834
5907,87,17,0,5.89,16.40,2214834,2214921
5908,98,23,0,5.22,20.91,2214921,2215019
5909,83,22,0,6.17,17.75,2215019,2215102
5910,105,25,0,4.88,12.05,2215101,2215206
5911,78,22,1,6.56,21.04,2215205,2215283
5912,72,28,0,7.11,22.46,2215282,2215354
5913,82,30,0,6.24,25.28,2215353,2215435
5914,73,25,1,7.01,19.30,2215434,2215507
5915,79,32,1,6.48,20.30,2215506,2215585
5916,91,16,1,5.63,10.39,2215584,2215675
5917,80,21,1,6.40,16.54,2215674,2215754
5918,92,29,0,5.57,19.31,2215753,2215845
5919,70,20,2,7.31,18.93,2215844,2215914
5920,84,33,0,6.10,21.94,2215914,2215998
5921,67,28,0,7.64,28.32,2215997,2216064
5922,90,27,0,5.69,21.79,2216063,2216153
5923,83,24,0,6.17,25.27,2216152,2216235
5924,107,22,0,4.79,11.96,2216234,2216341
5925,82,31,1,6.24,27.82,2216340,2216422
5926,101,47,1,5.07,27.81,2216422,2216523
5927,98,20,0,5.22,14.81,2216522,2216620
5928,82,18,0,6.24,13.40,2216619,2216701
5929,83,19,1,6.17,15.13,2216701,2216784
5930,78,18,1,6.56,13.22,2216784,2216862
5931,72,51,0,7.11,50.60,2216861,2216933
5932,71,29,1,7.21,28.34,2216933,2217004
5933,70,20,1,7.31,16.47,2217003,2217073
5934,74,45,1,6.92,34.26,2217073,2217147
5935,80,22,0,6.40,16.44,2217146,2217226
5936,94,33,0,5.45,28.29,2217225,2217319
5937,104,32,0,4.92,20.38,2217318,2217422
5938,89,21,0,5.75,16.84,2217421,2217510
5939,120,14,0,4.27,6.50,2217510,2217630
5940,77,25,0,6.65,19.92,2217629,2217706
5941,80,25,1,6.40,19.39,2217705,2217785
5942,73,22,0,7.01,15.68,2217784,2217857
5943,75,38,1,6.83,38.22,2217856,2217931
5944,76,17,1,6.74,14.30,2217931,2218007
5945,84,24,1,6.10,20.63,2218006,2218090
5946,70,39,2,7.31,35.19,2218089,2218159
5947,47,106,2,10.89,265.03,2218159,2218206
5948,85,26,0,6.02,19.51,2218206,2218291
5949,75,25,0,6.83,22.86,2218290,2218365
5950,80,43,0,6.40,50.39,2218364,2218444
5951,71,50,1,7.21,78.79,2218443,2218514
5952,86,37,0,5.95,24.88,2218514,2218600
5953,100,31,0,5.12,15.11,2218599,2218699
5954,83,18,0,6.17,13.03,2218698,2218781
5955,74,30,0,6.92,35.59,2218780,2218854
5956,81,32,2,6.32,16.51,2218853,2218934
5957,79,21,0,6.48,13.14,2218933,2219012
5958,58,47,0,8.83,61.52,2219011,2219069
5959,77,19,1,6.65,15.86,2219068,2219145
5960,84,22,1,6.10,17.61,2219144,2219228
5961,83,33,1,6.17,20.36,2219228,2219311
5962,85,16,0,6.02,15.91,2219310,2219395
5963,91,25,0,5.63,22.87,2219394,2219485
5964,92,20,0,5.57,19.05,2219484,2219576
5965,84,20,1,6.10,18.13,2219575,2219659
5966,101,22,0,5.07,14.84,2219658,2219759
5967,89,29,1,5.75,15.80,2219758,2219847
5968,78,23,1,6.56,19.22,2219846,2219924
5969,72,33,1,7.11,30.79,2219923,2219995
5970,80,21,1,6.40,12.54,2219994,2220074
5971,71,26,1,7.21,25.72,2220073,2220144
5972,75,28,0,6.83,23.58,2220143,2220218
5973,90,27,0,5.69,15.19,2220217,2220307
5974,79,26,1,6.48,25.59,2220306,2220385
5975,76,30,1,6.74,29.83,2220384,2220460
5976,54,102,0,9.48,231.40,2220459,2220513
5977,76,28,0,6.74,23.27,2220512,2220588
5978,84,24,0,6.10,22.47,2220588,2220672
5979,113,27,0,4.53,18.23,2220672,2220785
5980,88,25,0,5.82,19.40,2220784,2220872
5981,99,17,0,5.17,11.86,2220871,2220970
5982,102,22,0,5.02,17.00,2220970,2221072
5983,75,26,1,6.83,19.85,2221072,2221147
5984,91,21,0,5.63,13.25,2221146,2221237
5985,81,20,1,6.32,18.98,2221237,2221318
5986,73,21,2,7.01,15.71,2221317,2221390
5987,68,90,0,7.53,114.84,2221389,2221457
5988,73,24,0,7.01,19.41,2221456,2221529
5989,70,28,1,7.31,25.47,2221528,2221598
5990,74,22,0,6.92,23.70,2221597,2221671
5991,73,21,1,7.01,18.97,2221670,2221743
5992,74,41,0,6.92,47.97,2221742,2221816
5993,64,36,1,8.00,45.25,2221815,2221879
5994,80,39,0,6.40,32.39,2221878,2221958
5995,97,26,0,5.28,23.69,2221957,2222054
5996,107,28,0,4.79,17.16,2222053,2222160
5997,89,24,0,5.75,24.34,2222160,2222249
5998,103,21,0,4.97,10.32,2222249,2222352
5999,84,32,1,6.10,22.73,2222351,2222435
6000,80,16,1,6.40,13.61,2222434,2222514
6001,78,36,1,6.56,30.04,2222513,2222591
6002,71,16,0,7.21,20.19,2222590,2222661
6003,78,21,1,6.56,15.78,2222660,2222738
6004,83,18,1,6.17,11.54,2222738,2222821
6005,76,21,1,6.74,19.38,2222820,2222896
6006,75,28,1,6.83,21.90,2222895,2222970
6007,79,32,0,6.48,26.50,2222969,2223048
6008,80,22,0,6.40,18.51,2223047,2223127
6009,92,25,0,5.57,19.40,2223126,2223218
6010,81,36,0,6.32,34.51,2223217,2223298
6011,92,32,0,5.57,28.75,2223297,2223389
6012,82,23,0,6.24,18.11,2223388,2223470
6013,81,23,1,6.32,23.38,2223469,2223550
6014,93,29,0,5.51,24.12,2223550,2223643
6015,90,21,0,5.69,16.30,2223643,2223733
6016,75,27,1,6.83,23.42,2223732,2223807
6017,78,24,1,6.56,17.89,2223806,2223884
6018,86,21,0,5.95,17.65,2223883,2223969
6019,76,30,0,6.74,25.56,2223968,2224044
6020,62,25,1,8.26,27.87,2224044,2224106
6021,73,32,1,7.01,28.86,2224105,2224178
6022,74,26,1,6.92,24.67,2224177,2224251
6023,83,14,1,6.17,11.06,2224250,2224333
6024,88,21,0,5.82,15.44,2224332,2224420
6025,97,23,0,5.28,12.26,2224419,2224516
6026,83,23,0,6.17,15.20,2224515,2224598
6027,102,22,0,5.02,21.80,2224597,2224699
6028,74,116,0,6.92,181.59,2224698,2224772
6029,114,22,0,4.49,12.30,2224771,2224885
6030,91,22,1,5.63,13.14,2224884,2224975
6031,97,30,0,5.28,19.15,2224974,2225071
6032,73,19,1,7.01,14.97,2225070,2225143
6033,75,18,0,6.83,17.37,2225142,2225217
6034,99,19,1,5.17,11.41,2225216,2225315
6035,73,20,0,7.01,20.45,2225314,2225387
6036,83,27,1,6.17,16.53,2225386,2225469
6037,74,24,0,6.92,20.18,2225468,2225542
6038,76,33,0,6.74,33.09,2225541,2225617
6039,84,34,0,6.10,26.37,2225617,2225701
6040,68,45,2,7.53,39.87,2225700,2225768
6041,66,41,1,7.76,40.97,2225767,2225833
6042,69,28,1,7.42,31.58,2225833,2225902
6043,74,29,0,6.92,32.59,2225901,2225975
6044,93,22,0,5.51,21.20,2225974,2226067
6045,85,23,0,6.02,21.27,2226066,2226151
6046,104,21,0,4.92,13.40,2226150,2226254
6047,97,25,0,5.28,15.85,2226253,2226350
6048,83,22,1,6.17,18.26,2226349,2226432
6049,78,29,0,6.56,19.09,2226431,2226509
6050,91,24,0,5.63,19.20,2226508,2226599
6051,74,18,1,6.92,13.72,2226598,2226672
6052,84,22,0,6.10,21.18,2226671,2226755
6053,81,21,1,6.32,17.75,2226754,2226835
6054,79,26,1,6.48,17.39,2226834,2226913
6055,75,24,0,6.83,26.20,2226912,2226987
6056,84,24,1,6.10,19.44,2226986,2227070
6057,68,33,0,7.53,40.54,2227070,2227138
6058,104,21,0,4.92,16.96,2227137,2227241
6059,78,28,1,6.56,27.30,2227240,2227318
6060,82,23,1,6.24,18.87,2227317,2227399
6061,85,35,1,6.02,22.56,2227398,2227483
6062,90,22,0,5.69,17.21,2227482,2227572
6063,82,30,0,6.24,18.45,2227572,2227654
6064,84,18,0,6.10,15.51,2227653,2227737
6065,78,33,1,6.56,19.40,2227736,2227814
6066,74,32,0,6.92,32.40,2227813,2227887
6067,72,30,1,7.11,27.15,2227886,2227958
6068,74,24,1,6.92,17.83,2227957,2228031
6069,83,27,1,6.17,17.22,2228030,2228113
6070,78,22,1,6.56,15.94,2228112,2228190
6071,75,32,1,6.83,26.36,2228190,2228265
6072,77,50,0,6.65,59.06,2228264,2228341
6073,116,38,0,4.41,21.29,2228340,2228456
6074,76,31,0,6.74,36.59,2228456,2228532
6075,104,21,0,4.92,13.65,2228531,2228635
6076,95,25,0,5.39,15.77,2228635,2228730
6077,107,18,0,4.79,12.49,2228729,2228836
6078,66,32,1,7.76,36.15,2228836,2228902
6079,84,53,1,6.10,37.40,2228901,2228985
6080,87,22,0,5.89,14.24,2228985,2229072
6081,77,25,1,6.65,16.57,2229071,2229148
6082,69,35,0,7.42,37.17,2229147,2229216
6083,80,22,0,6.40,19.06,2229215,2229295
6084,89,29,0,5.75,23.33,2229294,2229383
6085,80,28,0,6.40,26.62,2229382,2229462
6086,78,26,1,6.56,19.58,2229461,2229539
6087,78,31,0,6.56,28.99,2229538,2229616
6088,83,26,0,6.17,23.54,2229615,2229698
6089,99,20,0,5.17,15.58,2229697,2229796
6090,84,22,0,6.10,16.23,2229796,2229880
6091,118,21,0,4.34,11.75,2229880,2229998
6092,113,13,0,4.53,6.02,2229997,2230110
6093,88,22,1,5.82,12.22,2230109,2230197
6094,72,20,1,7.11,15.04,2230196,2230268
6095,83,29,0,6.17,19.90,2230267,2230350
6096,74,25,1,6.92,18.05,2230349,2230423
6097,68,44,1,7.53,39.78,2230423,2230491
6098,76,26,1,6.74,23.04,2230490,2230566
6099,75,41,1,6.83,34.62,2230565,2230640
6100,67,29,1,7.64,29.01,2230639,2230706
6101,85,18,1,6.02,13.65,2230706,2230791
6102,85,26,0,6.02,18.89,2230790,2230875
6103,82,29,1,6.24,21.57,2230874,2230956
6104,86,24,0,5.95,19.58,2230955,2231041
6105,103,25,0,4.97,17.45,2231040,2231143
6106,106,17,0,4.83,11.73,2231142,2231248
6107,91,20,0,5.63,14.21,2231247,2231338
6108,103,25,0,4.97,13.27,2231338,2231441
6109,76,63,1,6.74,69.09,2231440,2231516
6110,63,39,1,8.13,42.84,2231515,2231578
6111,76,23,2,6.74,16.56,2231577,2231653
6112,49,128,1,10.45,366.17,2231652,2231701
6113,77,22,0,6.65,17.29,2231700,2231777
6114,78,19,1,6.56,11.53,2231776,2231854
6115,80,17,1,6.40,13.76,2231853,2231933
6116,92,16,1,5.57,10.40,2231932,2232024
6117,65,27,2,7.88,28.97,2232023,2232088
6118,67,25,0,7.64,33.21,2232087,2232154
6119,70,33,1,7.31,31.90,2232153,2232223
6120,79,33,0,6.48,26.60,2232223,2232302
6121,75,54,0,6.83,54.86,2232301,2232376
6122,105,23,0,4.88,17.42,2232375,2232480
6123,78,23,1,6.56,25.66,2232479,2232557
6124,87,42,0,5.89,31.85,2232556,2232643
6125,97,21,0,5.28,14.30,2232643,2232740
6126,88,16,1,5.82,11.63,2232739,2232827
6127,72,40,1,7.11,34.74,2232826,2232898
6128,66,21,0,7.76,24.76,2232898,2232964
6129,80,21,1,6.40,16.66,2232963,2233043
6130,77,17,1,6.65,12.33,2233042,2233119
6131,67,36,1,7.64,37.84,2233118,2233185
6132,75,41,1,6.83,30.09,2233185,2233260
6133,70,36,1,7.31,37.87,2233259,2233329
6134,76,25,0,6.74,15.83,2233328,2233404
6135,82,35,0,6.24,22.16,2233403,2233485
6136,78,33,1,6.56,26.37,2233484,2233562
6137,77,18,0,6.65,17.86,2233561,2233638
6138,95,35,0,5.39,25.59,2233637,2233732
6139,95,24,0,5.39,14.11,2233731,2233826
6140,94,31,0,5.45,20.29,2233825,2233919
6141,97,31,1,5.28,18.32,2233918,2234015
6142,99,42,0,5.17,26.00,2234014,2234113
6143,83,24,1,6.17,18.50,2234113,2234196
6144,93,16,1,5.51,7.88,2234195,2234288
6145,84,26,1,6.10,19.75,2234287,2234371
6146,77,21,2,6.65,12.59,2234370,2234447
6147,78,29,0,6.56,24.60,2234446,2234524
6148,70,33,1,7.31,35.82,2234523,2234593
6149,75,19,1,6.83,16.06,2234592,2234667
6150,76,21,1,6.74,22.46,2234666,2234742
6151,91,16,0,5.63,11.05,2234741,2234832
6152,82,23,0,6.24,18.57,2234831,2234913
6153,84,32,0,6.10,24.16,2234912,2234996
6154,91,39,0,5.63,34.10,2234996,2235087
6155,86,28,0,5.95,22.58,2235086,2235172
6156,94,24,0,5.45,20.80,2235171,2235265
6157,97,21,0,5.28,14.55,2235264,2235361
6158,87,30,0,5.89,18.52,2235360,2235447
6159,88,28,1,5.82,18.69,2235446,2235534
6160,93,17,1,5.51,10.66,2235533,2235626
6161,78,53,0,6.56,51.22,2235625,2235703
6162,71,22,1,7.21,16.11,2235702,2235773
6163,77,50,0,6.65,44.64,2235772,2235849
6164,72,30,1,7.11,28.43,2235848,2235920
6165,99,16,0,5.17,8.63,2235919,2236018
6166,91,18,1,5.63,11.82,2236018,2236109
6167,71,28,1,7.21,37.07,2236108,2236179
6168,91,26,0,5.63,19.31,2236178,2236269
6169,77,20,0,6.65,15.40,2236268,2236345
6170,101,21,0,5.07,16.52,2236344,2236445
6171,108,23,0,4.74,17.32,2236444,2236552
6172,100,28,0,5.12,18.25,2236551,2236651
6173,88,51,1,5.82,33.35,2236651,2236739
6174,104,14,0,4.92,9.28,2236739,2236843
6175,81,25,0,6.32,16.24,2236842,2236923
6176,76,27,1,6.74,25.30,2236922,2236998
6177,64,47,1,8.00,43.88,2236998,2237062
6178,70,46,0,7.31,35.99,2237061,2237131
6179,75,31,1,6.83,25.93,2237130,2237205
6180,78,19,1,6.56,18.76,2237204,2237282
6181,77,16,1,6.65,16.15,2237281,2237358
6182,77,31,1,6.65,30.10,2237357,2237434
6183,76,32,0,6.74,26.51,2237433,2237509
6184,85,46,0,6.02,37.46,2237508,2237593
6185,83,24,0,6.17,16.72,2237592,2237675
6186,93,34,0,5.51,38.44,2237674,2237767
6187,82,37,0,6.24,42.79,2237766,2237848
6188,86,21,0,5.95,22.70,2237847,2237933
6189,83,32,0,6.17,27.30,2237932,2238015
6190,80,35,1,6.40,34.81,2238014,2238094
6191,70,26,0,7.31,35.19,2238093,2238163
6192,78,18,1,6.56,15.53,2238162,2238240
6193,73,22,1,7.01,16.89,2238239,2238312
6194,80,30,0,6.40,18.89,2238311,2238391
6195,65,30,1,7.88,29.65,2238390,2238455
6196,71,28,1,7.21,30.00,2238454,2238525
6197,79,24,1,6.48,20.15,2238524,2238603
6198,82,16,1,6.24,14.23,2238602,2238684
6199,86,28,0,5.95,19.67,2238683,2238769
6200,70,26,0,7.31,28.39,2238768,2238838
6201,87,32,0,5.89,27.69,2238837,2238924
6202,57,36,1,8.98,47.77,2238923,2238980
6203,86,18,0,5.95,19.25,2238979,2239065
6204,86,25,0,5.95,30.21,2239064,2239150
6205,82,20,0,6.24,20.67,2239149,2239231
6206,96,17,0,5.33,11.35,2239230,2239326
6207,85,42,0,6.02,32.21,2239326,2239411
6208,91,34,0,5.63,24.52,2239410,2239501
6209,77,34,1,6.65,24.77,2239500,2239577
6210,63,32,0,8.13,30.21,2239576,2239639
6211,81,36,1,6.32,35.13,2239638,2239719
6212,80,20,0,6.40,15.31,2239718,2239798
6213,79,22,1,6.48,16.00,2239797,2239876
6214,72,27,1,7.11,27.38,2239876,2239948
6215,81,23,1,6.32,17.53,2239947,2240028
6216,97,20,0,5.28,16.57,2240027,2240124
6217,82,22,0,6.24,16.82,2240124,2240206
6218,76,50,1,6.74,37.85,2240205,2240281
6219,107,20,0,4.79,20.11,2240280,2240387
6220,81,30,0,6.32,27.55,2240386,2240467
6221,107,16,0,4.79,11.98,2240466,2240573
6222,99,20,0,5.17,12.99,2240572,2240671
6223,98,16,0,5.22,10.70,2240670,2240768
6224,86,23,0,5.95,19.18,2240768,2240854
6225,77,21,1,6.65,21.79,2240854,2240931
6226,89,19,0,5.75,17.22,2240931,2241020
6227,81,25,1,6.32,13.38,2241019,2241100
6228,81,29,1,6.32,22.81,2241099,2241180
6229,85,17,1,6.02,16.42,2241179,2241264
6230,66,25,0,7.76,24.00,2241263,2241329
6231,71,25,1,7.21,18.45,2241328,2241399
6232,94,27,0,5.45,23.99,2241398,2241492
6233,87,21,0,5.89,17.64,2241491,2241578
6234,59,81,1,8.68,118.59,2241577,2241636
6235,103,47,0,4.97,28.61,2241635,2241738
6236,93,24,0,5.51,21.82,2241737,2241830
6237,122,28,0,4.20,15.65,2241829,2241951
6238,89,23,1,5.75,14.10,2241950,2242039
6239,90,44,1,5.69,26.04,2242038,2242128
6240,86,22,1,5.95,17.07,2242127,2242213
6241,60,32,1,8.53,39.05,2242212,2242272
6242,83,32,0,6.17,25.06,2242271,2242354
6243,86,17,0,5.95,12.93,2242353,2242439
6244,70,23,0,7.31,26.62,2242438,2242508
6245,74,22,0,6.92,27.43,2242507,2242581
6246,73,41,1,7.01,40.42,2242580,2242653
6247,80,30,0,6.40,28.51,2242652,2242732
6248,81,22,0,6.32,19.33,2242731,2242812
6249,71,32,1,7.21,30.62,2242811,2242882
6250,85,27,1,6.02,23.55,2242881,2242966
6251,76,30,1,6.74,26.75,2242965,2243041
6252,97,24,0,5.28,17.29,2243040,2243137
6253,112,28,0,4.57,16.85,2243137,2243249
6254,97,51,0,5.28,37.77,2243248,2243345
6255,96,29,0,5.33,20.20,2243344,2243440
6256,91,19,0,5.63,14.52,2243439,2243530
6257,69,22,1,7.42,15.95,2243529,2243598
6258,88,26,1,5.82,20.54,2243597,2243685
6259,89,18,1,5.75,10.10,2243684,2243773
6260,63,56,1,8.13,55.92,2243773,2243836
6261,76,26,1,6.74,25.04,2243835,2243911
6262,75,43,0,6.83,29.48,2243910,2243985
6263,94,20,1,5.45,13.55,2243984,2244078
6264,82,21,1,6.24,18.14,2244077,2244159
6265,85,30,1,6.02,19.62,2244158,2244243
6266,67,38,1,7.64,33.84,2244242,2244309
6267,111,20,0,4.61,14.89,2244308,2244419
6268,79,29,0,6.48,30.05,2244418,2244497
6269,84,28,0,6.10,23.82,2244496,2244580
6270,100,17,0,5.12,8.57,2244579,2244679
6271,113,15,0,4.53,10.13,2244678,2244791
6272,75,22,1,6.83,23.58,2244790,2244865
6273,71,18,1,7.21,18.19,2244864,2244935
6274,87,20,1,5.89,14.79,2244935,2245022
6275,80,21,0,6.40,15.04,2245021,2245101
6276,62,81,0,8.26,106.00,2245100,2245162
6277,76,20,0,6.74,19.83,2245161,2245237
6278,72,20,1,7.11,18.35,2245236,2245308
6279,70,22,0,7.31,21.64,2245307,2245377
6280,75,21,0,6.83,20.17,2245376,2245451
6281,66,28,1,7.76,26.91,2245450,2245516
6282,84,27,0,6.10,27.04,2245515,2245599
6283,76,41,0,6.74,31.06,2245598,2245674
6284,99,23,0,5.17,21.03,2245673,2245772
6285,75,49,0,6.83,61.61,2245771,2245846
6286,112,24,0,4.57,15.01,2245845,2245957
6287,89,63,1,5.75,52.41,2245956,2246045
6288,102,16,0,5.02,12.73,2246044,2246146
6289,76,28,0,6.74,29.33,2246145,2246221
6290,81,22,1,6.32,15.30,2246220,2246301
6291,87,16,1,5.89,11.99,2246300,2246387
6292,80,24,0,6.40,16.84,2246386,2246466
6293,77,26,0,6.65,21.94,2246465,2246542
6294,70,32,1,7.31,22.10,2246541,2246611
6295,80,35,0,6.40,22.04,2246610,2246690
6296,76,28,0,6.74,25.33,2246689,2246765
6297,73,25,0,7.01,31.22,2246764,2246837
6298,79,22,1,6.48,20.65,2246836,2246915
6299,63,50,0,8.13,71.95,2246914,2246977
6300,103,24,0,4.97,19.14,2246976,2247079
6301,85,26,0,6.02,21.36,2247078,2247163
6302,102,17,0,5.02,16.02,2247163,2247265
6303,85,24,1,6.02,16.52,2247265,2247350
6304,111,13,0,4.61,8.09,2247349,2247460
6305,76,20,0,6.74,23.38,2247459,2247535
6306,67,32,1,7.64,34.47,2247534,2247601
6307,81,22,1,6.32,18.93,2247600,2247681
6308,73,19,1,7.01,18.86,2247680,2247753
6309,73,30,0,7.01,30.73,2247753,2247826
6310,57,57,0,8.98,78.89,2247825,2247882
6311,85,26,0,6.02,18.92,2247881,2247966
6312,75,23,0,6.83,17.90,2247966,2248041
6313,81,22,0,6.32,19.38,2248040,2248121
6314,80,27,0,6.40,36.17,2248120,2248200
6315,77,30,0,6.65,33.53,2248199,2248276
6316,101,37,0,5.07,20.36,2248276,2248377
6317,93,18,0,5.51,15.09,2248376,2248469
6318,99,20,0,5.17,10.95,2248468,2248567
6319,85,23,0,6.02,11.67,2248566,2248651
6320,75,19,2,6.83,12.01,2248650,2248725
6321,82,23,0,6.24,20.55,2248724,2248806
6322,76,19,1,6.74,17.11,2248805,2248881
6323,75,37,1,6.83,26.76,2248880,2248955
6324,84,15,1,6.10,11.37,2248954,2249038
6325,78,21,1,6.56,17.30,2249038,2249116
6326,69,30,1,7.42,28.65,2249115,2249184
6327,97,15,0,5.28,10.80,2249184,2249281
6328,79,31,1,6.48,24.50,2249281,2249360
6329,72,29,0,7.11,31.21,2249359,2249431
6330,102,32,0,5.02,22.73,2249430,2249532
6331,81,27,0,6.32,24.79,2249531,2249612
6332,95,19,0,5.39,16.91,2249611,2249706
6333,89,25,0,5.75,17.83,2249705,2249794
6334,100,21,0,5.12,15.33,2249793,2249893
6335,73,52,1,7.01,41.19,2249892,2249965
6336,89,32,1,5.75,21.22,2249964,2250053
6337,75,23,1,6.83,18.22,2250052,2250127
6338,68,38,1,7.53,40.37,2250126,2250194
6339,72,24,0,7.11,25.13,2250193,2250265
6340,64,28,1,8.00,39.34,2250264,2250328
6341,78,30,0,6.56,21.25,2250327,2250405
6342,95,34,0,5.39,21.08,2250405,2250500
6343,74,27,1,6.92,19.59,2250499,2250573
6344,71,24,0,7.21,24.53,2250572,2250643
6345,76,30,0,6.74,29.33,2250642,2250718
6346,82,24,0,6.24,26.55,2250717,2250799
6347,93,28,0,5.51,20.57,2250798,2250891
6348,107,29,0,4.79,18.19,2250890,2250997
6349,100,21,1,5.12,12.93,2250996,2251096
6350,100,19,0,5.12,11.17,2251095,2251195
6351,83,18,0,6.17,14.94,2251194,2251277
6352,74,26,0,6.92,25.48,2251277,2251351
6353,85,29,0,6.02,21.11,2251350,2251435
6354,71,50,0,7.21,41.29,2251434,2251505
6355,56,49,2,9.14,67.12,2251504,2251560
6356,65,69,0,7.88,84.05,2251559,2251624
6357,75,19,1,6.83,15.45,2251623,2251698
6358,77,25,2,6.65,15.06,2251697,2251774
6359,71,33,1,7.21,32.81,2251773,2251844
6360,78,43,1,6.56,33.86,2251843,2251921
6361,64,28,0,8.00,26.38,2251920,2251984
6362,85,18,0,6.02,17.06,2251983,2252068
6363,76,25,0,6.74,25.61,2252067,2252143
6364,99,18,0,5.17,16.73,2252142,2252241
6365,98,19,0,5.22,14.62,2252240,2252338
6366,102,40,0,5.02,28.73,2252337,2252439
6367,82,23,0,6.24,19.48,2252438,2252520
6368,71,42,0,7.21,59.97,2252519,2252590
6369,73,22,0,7.01,18.53,2252589,2252662
6370,87,18,1,5.89,9.85,2252661,2252748
6371,80,24,1,6.40,19.16,2252747,2252827
6372,74,24,0,6.92,22.51,2252826,2252900
6373,68,27,1,7.53,24.07,2252899,2252967
6374,69,28,1,7.42,30.39,2252966,2253035
6375,78,25,0,6.56,24.37,2253034,2253112
6376,81,17,0,6.32,15.06,2253111,2253192
6377,69,27,1,7.42,26.27,2253191,2253260
6378,75,28,0,6.83,31.74,2253259,2253334
6379,81,19,0,6.32,18.42,2253333,2253414
6380,91,24,0,5.63,25.71,2253413,2253504
6381,98,30,0,5.22,22.28,2253503,2253601
6382,97,43,0,5.28,26.98,2253600,2253697
6383,100,22,0,5.12,13.29,2253697,2253797
6384,106,16,0,4.83,11.18,2253796,2253902
6385,84,16,0,6.10,11.73,2253901,2253985
6386,70,26,1,7.31,24.67,2253984,2254054
6387,76,21,1,6.74,23.77,2254053,2254129
6388,76,26,0,6.74,25.54,2254128,2254204
6389,74,18,1,6.92,16.89,2254203,2254277
6390,66,30,1,7.76,27.21,2254276,2254342
6391,90,24,0,5.69,14.10,2254341,2254431
6392,86,20,1,5.95,12.72,2254430,2254516
6393,76,20,0,6.74,20.85,2254515,2254591
6394,93,24,0,5.51,19.05,2254590,2254683
6395,99,32,0,5.17,24.87,2254683,2254782
6396,97,22,1,5.28,13.99,2254781,2254878
6397,89,31,0,5.75,23.02,2254877,2254966
6398,65,24,1,7.88,27.15,2254965,2255030
6399,83,20,1,6.17,17.03,2255030,2255113
6400,62,57,1,8.26,67.74,2255112,2255174
6401,76,34,1,6.74,27.30,2255174,2255250
6402,72,24,1,7.11,24.21,2255250,2255322
6403,58,84,1,8.83,143.35,2255322,2255380
6404,71,32,1,7.21,23.35,2255379,2255450
6405,86,27,0,5.95,16.46,2255449,2255535
6406,75,22,1,6.83,19.72,2255534,2255609
6407,81,17,1,6.32,11.92,2255608,2255689
6408,84,23,1,6.10,19.66,2255688,2255772
6409,98,18,0,5.22,13.54,2255771,2255869
6410,80,39,0,6.40,39.74,2255868,2255948
6411,104,20,0,4.92,14.84,2255947,2256051
6412,84,33,0,6.10,21.99,2256051,2256135
6413,99,21,0,5.17,13.37,2256134,2256233
6414,77,25,1,6.65,25.27,2256232,2256309
6415,79,23,0,6.48,18.12,2256308,2256387
6416,84,24,1,6.10,20.94,2256386,2256470
6417,75,28,1,6.83,25.24,2256469,2256544
6418,86,19,0,5.95,15.32,2256543,2256629
6419,75,23,1,6.83,15.40,2256628,2256703
6420,81,19,1,6.32,13.53,2256703,2256784
6421,84,30,0,6.10,23.16,2256783,2256867
6422,83,18,0,6.17,17.51,2256866,2256949
6423,72,37,1,7.11,30.85,2256948,2257020
6424,73,22,0,7.01,26.26,2257019,2257092
6425,70,28,1,7.31,38.47,2257091,2257161
6426,107,25,0,4.79,18.49,2257160,2257267
6427,85,24,0,6.02,18.45,2257266,2257351
6428,98,22,1,5.22,15.81,2257350,2257448
6429,107,21,0,4.79,11.29,2257447,2257554
6430,86,48,0,5.95,41.37,2257553,2257639
6431,74,19,1,6.92,14.70,2257638,2257712
6432,75,22,0,6.83,22.57,2257712,2257787
6433,82,26,1,6.24,18.50,2257786,2257868
6434,72,32,0,7.11,27.82,2257867,2257939
6435,78,28,0,6.56,28.86,2257938,2258016
6436,74,17,1,6.92,15.70,2258015,2258089
6437,79,34,0,6.48,24.00,2258088,2258167
6438,100,21,0,5.12,11.97,2258166,2258266
6439,65,51,0,7.88,55.00,2258265,2258330
6440,84,31,0,6.10,25.61,2258329,2258413
6441,81,35,0,6.32,22.88,2258412,2258493
6442,99,51,0,5.17,34.04,2258492,2258591
6443,90,25,0,5.69,20.04,2258591,2258681
6444,101,16,1,5.07,10.82,2258680,2258781
6445,93,26,1,5.51,20.23,2258780,2258873
6446,94,23,0,5.45,16.95,2258872,2258966
6447,71,25,1,7.21,21.38,2258965,2259036
6448,95,29,0,5.39,21.94,2259035,2259130
6449,80,30,1,6.40,22.99,2259129,2259209
6450,65,41,0,7.88,34.23,2259208,2259273
6451,74,30,1,6.92,21.29,2259272,2259346
6452,77,20,2,6.65,16.02,2259345,2259422
6453,73,36,1,7.01,32.86,2259421,2259494
6454,95,34,0,5.39,21.37,2259493,2259588
6455,87,23,0,5.89,16.08,2259587,2259674
6456,90,26,0,5.69,18.10,2259674,2259764
6457,100,27,0,5.12,21.47,2259763,2259863
6458,96,29,0,5.33,20.22,2259862,2259958
6459,95,17,1,5.39,12.36,2259957,2260052
6460,100,27,0,5.12,19.91,2260051,2260151
6461,86,26,0,5.95,18.49,2260150,2260236
6462,83,22,0,6.17,16.26,2260235,2260318
6463,74,26,1,6.92,21.59,2260317,2260391
6464,69,46,0,7.42,48.01,2260390,2260459
6465,83,21,0,6.17,20.41,2260459,2260542
6466,77,32,1,6.65,26.10,2260542,2260619
6467,73,23,0,7.01,21.63,2260618,2260691
6468,75,23,0,6.83,20.97,2260690,2260765
6469,76,25,0,6.74,24.35,2260764,2260840
6470,85,24,0,6.02,20.78,2260839,2260924
6471,79,21,0,6.48,17.14,2260924,2261003
6472,74,25,0,6.92,27.72,2261002,2261076
6473,68,107,0,7.53,163.31,2261076,2261144
6474,79,51,0,6.48,52.93,2261143,2261222
6475,85,51,0,6.02,41.79,2261222,2261307
6476,82,19,0,6.24,15.89,2261307,2261389
6477,96,16,0,5.33,14.56,2261389,2261485
6478,76,27,0,6.74,28.80,2261484,2261560
6479,91,24,0,5.63,18.98,2261559,2261650
6480,70,26,1,7.31,20.39,2261649,2261719
6481,83,15,1,6.17,9.71,2261718,2261801
6482,69,32,2,7.42,36.88,2261800,2261869
6483,66,35,1,7.76,34.24,2261868,2261934
6484,79,23,0,6.48,21.41,2261933,2262012
6485,71,30,0,7.21,33.15,2262011,2262082
6486,80,44,0,6.40,31.39,2262081,2262161
6487,77,23,0,6.65,24.88,2262160,2262237
6488,70,29,1,7.31,29.56,2262236,2262306
6489,86,28,0,5.95,26.65,2262305,2262391
6490,70,30,1,7.31,26.76,2262390,2262460
6491,86,31,0,5.95,34.84,2262459,2262545
6492,84,22,1,6.10,15.63,2262544,2262628
6493,99,22,0,5.17,17.74,2262627,2262726
6494,85,24,0,6.02,18.94,2262726,2262811
6495,102,29,0,5.02,19.49,2262810,2262912
6496,78,16,0,6.56,14.37,2262911,2262989
6497,62,33,1,8.26,34.51,2262988,2263050
6498,80,31,1,6.40,22.04,2263050,2263130
6499,76,21,1,6.74,13.88,2263129,2263205
6500,85,23,0,6.02,16.16,2263204,2263289
6501,77,24,0,6.65,19.86,2263288,2263365
6502,80,21,1,6.40,16.89,2263365,2263445
6503,79,25,0,6.48,21.90,2263444,2263523
6504,79,20,1,6.48,17.24,2263522,2263601
6505,82,27,1,6.24,17.48,2263600,2263682
6506,71,28,0,7.21,34.96,2263681,2263752
6507,90,33,0,5.69,38.30,2263751,2263841
6508,90,91,0,5.69,93.81,2263840,2263930
6509,82,33,0,6.24,34.43,2263930,2264012
6510,87,17,0,5.89,11.07,2264011,2264098
6511,90,27,0,5.69,23.26,2264097,2264187
6512,78,23,1,6.56,16.78,2264186,2264264
6513,76,26,1,6.74,21.72,2264263,2264339
6514,58,88,1,8.83,121.49,2264338,2264396
6515,80,23,1,6.40,18.79,2264395,2264475
6516,75,34,0,6.83,30.86,2264474,2264549
6517,85,19,1,6.02,12.80,2264549,2264634
6518,67,34,2,7.64,31.24,2264633,2264700
6519,71,34,0,7.21,39.07,2264699,2264770
6520,91,17,0,5.63,14.70,2264769,2264860
6521,81,22,1,6.32,18.69,2264859,2264940
6522,86,32,1,5.95,26.25,2264939,2265025
6523,82,19,0,6.24,17.18,2265024,2265106
6524,98,21,0,5.22,16.17,2265106,2265204
6525,100,34,0,5.12,25.53,2265203,2265303
6526,81,44,0,6.32,47.92,2265302,2265383
6527,81,19,1,6.32,14.07,2265382,2265463
6528,103,20,0,4.97,13.95,2265462,2265565
6529,89,36,1,5.75,23.42,2265564,2265653
6530,60,39,2,8.53,36.12,2265652,2265712
6531,91,20,0,5.63,12.94,2265711,2265802
6532,74,37,0,6.92,36.29,2265801,2265875
6533,72,28,1,7.11,27.27,2265874,2265946
6534,63,40,1,8.13,50.17,2265945,2266008
6535,85,19,1,6.02,15.27,2266007,2266092
6536,77,24,1,6.65,23.29,2266091,2266168
6537,69,142,0,7.42,282.01,2266168,2266237
6538,78,39,0,6.56,28.19,2266236,2266314
6539,99,22,0,5.17,17.11,2266314,2266413
6540,99,25,0,5.17,21.76,2266412,2266511
6541,101,15,0,5.07,10.08,2266510,2266611
6542,85,35,0,6.02,34.35,2266610,2266695
6543,69,37,1,7.42,27.37,2266694,2266763
6544,76,20,0,6.74,18.85,2266762,2266838
6545,87,21,1,5.89,14.58,2266837,2266924
6546,73,28,0,7.01,28.23,2266924,2266997
6547,74,19,0,6.92,18.64,2266997,2267071
6548,72,23,1,7.11,18.96,2267070,2267142
6549,84,47,0,6.10,35.37,2267142,2267226
6550,83,27,0,6.17,19.85,2267225,2267308
6551,82,21,1,6.24,20.72,2267307,2267389
6552,99,29,0,5.17,19.19,2267388,2267487
6553,111,24,0,4.61,16.78,2267486,2267597
6554,94,18,0,5.45,15.76,2267597,2267691
6555,101,22,0,5.07,14.60,2267691,2267792
6556,88,16,1,5.82,13.97,2267792,2267880
6557,71,33,0,7.21,40.93,2267879,2267950
6558,87,67,0,5.89,59.34,2267950,2268037
6559,76,23,1,6.74,17.61,2268036,2268112
6560,87,23,0,5.89,17.23,2268111,2268198
6561,69,31,1,7.42,24.68,2268197,2268266
6562,75,35,0,6.83,26.52,2268265,2268340
6563,67,29,1,7.64,31.42,2268339,2268406
6564,77,27,1,6.65,16.72,2268405,2268482
6565,70,33,1,7.31,31.70,2268481,2268551
6566,79,31,0,6.48,27.19,2268550,2268629
6567,72,24,2,7.11,16.79,2268628,2268700
6568,84,39,0,6.10,30.59,2268699,2268783
6569,82,25,0,6.24,21.36,2268782,2268864
6570,101,32,0,5.07,24.40,2268864,2268965
6571,84,26,0,6.10,27.61,2268964,2269048
6572,102,28,0,5.02,18.43,2269047,2269149
6573,88,27,0,5.82,28.01,2269148,2269236
6574,94,22,1,5.45,14.91,2269236,2269330
6575,85,22,0,6.02,14.12,2269329,2269414
6576,87,25,1,5.89,15.69,2269414,2269501
6577,79,25,1,6.48,20.55,2269500,2269579
6578,80,20,1,6.40,16.61,2269578,2269658
6579,74,21,1,6.92,17.40,2269657,2269731
6580,75,26,0,6.83,21.90,2269731,2269806
6581,73,20,1,7.01,14.56,2269805,2269878
6582,88,16,0,5.82,12.44,2269877,2269965
6583,75,31,1,6.83,33.74,2269964,2270039
6584,83,31,1,6.17,24.36,2270038,2270121
6585,82,43,0,6.24,35.55,2270120,2270202
6586,88,33,0,5.82,41.17,2270201,2270289
6587,88,16,1,5.82,11.31,2270288,2270376
6588,92,40,0,5.57,27.72,2270375,2270467
6589,96,26,0,5.33,18.18,2270466,2270562
6590,96,24,1,5.33,17.53,2270562,2270658
6591,80,29,0,6.40,22.91,2270657,2270737
6592,70,30,0,7.31,28.10,2270736,2270806
6593,75,25,0,6.83,28.60,2270805,2270880
6594,65,51,0,7.88,48.11,2270880,2270945
6595,71,48,1,7.21,42.31,2270944,2271015
6596,82,23,1,6.24,17.75,2271014,2271096
6597,61,27,1,8.39,33.71,2271095,2271156
6598,83,19,1,6.17,14.79,2271155,2271238
6599,95,18,1,5.39,12.03,2271237,2271332
6600,74,27,0,6.92,26.80,2271331,2271405
6601,78,24,0,6.56,16.81,2271405,2271483
6602,97,21,0,5.28,17.21,2271482,2271579
6603,89,27,0,5.75,32.16,2271578,2271667
6604,62,68,0,8.26,92.45,2271666,2271728
6605,100,16,0,5.12,12.29,2271727,2271827
6606,116,18,0,4.41,7.85,2271826,2271942
6607,88,60,0,5.82,48.04,2271941,2272029
6608,66,82,1,7.76,97.58,2272028,2272094
6609,75,17,1,6.83,14.20,2272093,2272168
6610,73,21,1,7.01,19.58,2272167,2272240
6611,76,28,1,6.74,22.83,2272239,2272315
6612,65,38,1,7.88,44.69,2272314,2272379
6613,67,25,0,7.64,21.84,2272378,2272445
6614,75,31,1,6.83,33.26,2272445,2272520
6615,66,35,0,7.76,45.43,2272519,2272585
6616,84,28,0,6.10,21.35,2272584,2272668
6617,91,25,0,5.63,16.21,2272667,2272758
6618,78,49,0,6.56,44.27,2272757,2272835
6619,91,27,0,5.63,17.49,2272834,2272925
6620,122,22,0,4.20,10.76,2272924,2273046
6621,82,19,0,6.24,16.96,2273045,2273127
6622,85,21,1,6.02,17.93,2273126,2273211
6623,78,27,0,6.56,26.04,2273210,2273288
6624,64,46,1,8.00,58.62,2273287,2273351
6625,79,25,0,6.48,19.26,2273350,2273429
6626,72,24,1,7.11,22.13,2273429,2273501
6627,73,48,0,7.01,38.78,2273500,2273573
6628,82,22,1,6.24,14.89,2273573,2273655
6629,77,29,0,6.65,25.40,2273654,2273731
6630,78,21,1,6.56,18.86,2273730,2273808
6631,72,45,1,7.11,40.27,2273808,2273880
6632,113,19,0,4.53,14.34,2273879,2273992
6633,82,32,0,6.24,23.55,2273991,2274073
6634,92,19,0,5.57,15.22,2274072,2274164
6635,90,25,0,5.69,20.57,2274163,2274253
6636,81,25,0,6.32,27.18,2274252,2274333
6637,87,28,0,5.89,18.93,2274332,2274419
6638,84,23,1,6.10,16.78,2274418,2274502
6639,77,28,0,6.65,29.79,2274501,2274578
6640,68,37,1,7.53,35.72,2274578,2274646
6641,83,20,1,6.17,14.67,2274645,2274728
6642,71,33,1,7.21,26.70,2274727,2274798
6643,78,22,0,6.56,19.02,2274797,2274875
6644,82,18,0,6.24,14.40,2274874,2274956
6645,75,44,0,6.83,41.37,2274955,2275030
6646,77,31,0,6.65,19.89,2275029,2275106
6647,84,20,0,6.10,15.40,2275105,2275189
6648,78,24,0,6.56,26.02,2275188,2275266
6649,102,25,0,5.02,14.65,2275265,2275367
6650,73,28,1,7.01,23.25,2275366,2275439
6651,89,28,0,5.75,30.10,2275438,2275527
6652,89,21,0,5.75,15.51,2275526,2275615
6653,87,21,0,5.89,13.71,2275614,2275701
6654,82,28,0,6.24,19.23,2275701,2275783
6655,73,28,0,7.01,23.74,2275782,2275855
6656,93,13,1,5.51,8.79,2275855,2275948
6657,74,20,0,6.92,17.21,2275947,2276021
6658,64,29,1,8.00,30.62,2276020,2276084
6659,78,21,0,6.56,21.68,2276083,2276161
6660,70,30,0,7.31,27.87,2276160,2276230
6661,83,18,1,6.17,11.32,2276229,2276312
6662,77,20,0,6.65,13.63,2276311,2276388
6663,82,18,1,6.24,13.23,2276387,2276469
6664,77,37,0,6.65,48.10,2276469,2276546
6665,95,27,0,5.39,23.14,2276545,2276640
6666,74,33,0,6.92,44.91,2276639,2276713
6667,81,22,0,6.32,23.01,2276712,2276793
6668,94,28,1,5.45,18.99,2276792,2276886
6669,86,22,0,5.95,15.28,2276886,2276972
6670,79,27,1,6.48,20.63,2276971,2277050
6671,83,15,0,6.17,14.41,2277049,2277132
6672,81,20,0,6.32,17.11,2277132,2277213
6673,80,26,0,6.40,18.46,2277212,2277292
6674,79,22,1,6.48,15.57,2277291,2277370
6675,78,19,0,6.56,16.25,2277369,2277447
6676,78,19,1,6.56,13.35,2277446,2277524
6677,79,30,1,6.48,20.38,2277523,2277602
6678,61,52,1,8.39,72.50,2277601,2277662
6679,73,41,0,7.01,37.36,2277661,2277734
6680,76,23,0,6.74,19.56,2277733,2277809
6681,90,22,0,5.69,19.84,2277808,2277898
6682,85,30,0,6.02,37.46,2277897,2277982
6683,87,45,0,5.89,30.65,2277981,2278068
6684,100,17,0,5.12,12.97,2278068,2278168
6685,85,23,1,6.02,17.06,2278167,2278252
6686,76,21,0,6.74,14.25,2278251,2278327
6687,80,18,0,6.40,14.04,2278327,2278407
6688,81,38,1,6.32,28.64,2278407,2278488
6689,77,21,1,6.65,16.51,2278487,2278564
6690,81,19,0,6.32,16.12,2278563,2278644
6691,63,25,1,8.13,27.92,2278643,2278706
6692,88,19,1,5.82,11.94,2278706,2278794
6693,76,25,0,6.74,20.48,2278793,2278869
6694,78,30,0,6.56,24.76,2278868,2278946
6695,83,57,1,6.17,49.59,2278945,2279028
6696,69,29,1,7.42,20.88,2279027,2279096
6697,102,31,0,5.02,23.00,2279095,2279197
6698,87,27,0,5.89,19.87,2279196,2279283
6699,72,90,0,7.11,123.65,2279282,2279354
6700,93,67,0,5.51,48.59,2279353,2279446
6701,95,23,0,5.39,17.35,2279446,2279541
6702,76,68,0,6.74,72.33,2279540,2279616
6703,66,40,1,7.76,37.55,2279615,2279681
6704,63,30,1,8.13,34.68,2279680,2279743
6705,63,35,1,8.13,35.06,2279742,2279805
6706,73,29,1,7.01,23.41,2279804,2279877
6707,77,21,1,6.65,16.49,2279876,2279953
6708,79,16,1,6.48,14.02,2279952,2280031
6709,65,28,0,7.88,26.85,2280031,2280096
6710,71,27,0,7.21,21.52,2280095,2280166
6711,91,25,0,5.63,17.29,2280165,2280256
6712,71,20,1,7.21,21.21,2280255,2280326
6713,79,24,0,6.48,22.78,2280325,2280404
6714,81,32,0,6.32,29.55,2280403,2280484
6715,90,24,0,5.69,24.01,2280484,2280574
6716,99,36,0,5.17,26.53,2280573,2280672
6717,86,25,0,5.95,26.95,2280671,2280757
6718,103,21,0,4.97,13.17,2280756,2280859
6719,87,19,0,5.89,15.27,2280858,2280945
6720,90,19,0,5.69,15.41,2280944,2281034
6721,64,40,1,8.00,62.44,2281033,2281097
6722,96,18,1,5.33,14.35,2281096,2281192
6723,82,23,1,6.24,18.92,2281191,2281273
6724,73,25,0,7.01,25.16,2281273,2281346
6725,66,19,0,7.76,16.15,2281345,2281411
6726,75,27,1,6.83,23.50,2281410,2281485
6727,82,23,1,6.24,23.60,2281484,2281566
6728,77,30,1,6.65,31.84,2281565,2281642
6729,81,26,0,6.32,22.74,2281641,2281722
6730,105,20,0,4.88,17.86,2281721,2281826
6731,83,90,0,6.17,104.77,2281825,2281908
6732,106,14,0,4.83,9.91,2281908,2282014
6733,95,22,0,5.39,19.40,2282013,2282108
6734,69,45,1,7.42,37.40,2282107,2282176
6735,73,30,1,7.01,29.00,2282175,2282248
6736,81,39,1,6.32,35.18,2282247,2282328
6737,76,20,0,6.74,15.77,2282327,2282403
6738,79,30,0,6.48,25.36,2282402,2282481
6739,67,31,1,7.64,25.45,2282480,2282547
6740,71,21,1,7.21,17.83,2282546,2282617
6741,80,32,2,6.40,19.37,2282616,2282696
6742,75,19,0,6.83,21.53,2282695,2282770
6743,77,17,1,6.65,12.57,2282769,2282846
6744,87,21,0,5.89,13.83,2282845,2282932
6745,74,24,0,6.92,26.99,2282931,2283005
6746,97,37,0,5.28,23.15,2283004,2283101
6747,93,22,0,5.51,19.20,2283101,2283194
6748,97,33,0,5.28,27.11,2283194,2283291
6749,96,21,0,5.33,13.68,2283290,2283386
6750,98,16,0,5.22,12.97,2283385,2283483
6751,81,22,0,6.32,20.42,2283482,2283563
6752,77,32,1,6.65,24.41,2283563,2283640
6753,68,21,1,7.53,21.60,2283639,2283707
6754,69,31,1,7.42,27.37,2283707,2283776
6755,73,31,1,7.01,27.44,2283775,2283848
6756,76,23,1,6.74,26.17,2283847,2283923
6757,71,31,1,7.21,27.35,2283923,2283994
6758,78,20,0,6.56,16.35,2283994,2284072
6759,73,30,1,7.01,29.41,2284072,2284145
6760,68,46,0,7.53,47.46,2284144,2284212
6761,87,27,0,5.89,24.98,2284211,2284298
6762,88,21,0,5.82,19.72,2284297,2284385
6763,79,26,1,6.48,19.41,2284384,2284463
6764,81,61,0,6.32,72.09,2284462,2284543
6765,91,32,1,5.63,22.94,2284543,2284634
6766,73,48,0,7.01,52.92,2284633,2284706
6767,74,36,1,6.92,29.02,2284705,2284779
6768,86,21,0,5.95,15.51,2284778,2284864
6769,65,85,0,7.88,115.55,2284863,2284928
6770,66,57,1,7.76,77.18,2284927,2284993
6771,66,30,0,7.76,25.24,2284992,2285058
6772,79,18,1,6.48,14.00,2285057,2285136
6773,77,30,0,6.65,28.59,2285135,2285212
6774,82,20,0,6.24,16.04,2285211,2285293
6775,82,49,0,6.24,44.36,2285292,2285374
6776,95,19,0,5.39,20.36,2285373,2285468
6777,87,23,0,5.89,21.04,2285467,2285554
6778,100,16,0,5.12,8.91,2285553,2285653
6779,91,20,1,5.63,15.35,2285653,2285744
6780,79,20,1,6.48,17.11,2285743,2285822
6781,57,114,1,8.98,221.42,2285821,2285878
6782,79,21,0,6.48,14.81,2285877,2285956
6783,79,32,1,6.48,19.74,2285955,2286034
6784,76,30,0,6.74,26.93,2286033,2286109
6785,72,31,0,7.11,23.77,2286108,2286180
6786,72,51,1,7.11,52.02,2286179,2286251
6787,77,21,0,6.65,15.71,2286251,2286328
6788,73,22,2,7.01,23.00,2286327,2286400
6789,71,45,0,7.21,53.97,2286399,2286470
6790,91,38,0,5.63,29.99,2286469,2286560
6791,88,59,0,5.82,48.51,2286559,2286647
6792,87,17,0,5.89,14.10,2286646,2286733
6793,74,27,0,6.92,33.56,2286732,2286806
6794,81,21,1,6.32,17.18,2286805,2286886
6795,80,29,0,6.40,22.64,2286885,2286965
6796,72,32,1,7.11,29.82,2286964,2287036
6797,74,20,1,6.92,21.51,2287035,2287109
6798,75,23,0,6.83,19.93,2287108,2287183
6799,70,34,2,7.31,27.07,2287183,2287253
6800,77,23,1,6.65,17.47,2287253,2287330
6801,72,21,0,7.11,13.35,2287329,2287401
6802,79,30,1,6.48,20.86,2287400,2287479
6803,92,25,0,5.57,20.96,2287478,2287570
6804,79,21,0,6.48,16.17,2287569,2287648
6805,83,27,1,6.17,20.86,2287647,2287730
6806,73,44,0,7.01,36.40,2287729,2287802
6807,69,22,0,7.42,22.39,2287801,2287870
6808,88,32,0,5.82,27.10,2287869,2287957
6809,84,27,0,6.10,32.04,2287956,2288040
6810,83,24,0,6.17,19.18,2288039,2288122
6811,76,35,1,6.74,28.48,2288121,2288197
6812,79,30,0,6.48,31.54,2288196,2288275
6813,86,17,1,5.95,15.42,2288274,2288360
6814,74,17,0,6.92,15.51,2288359,2288433
6815,80,28,1,6.40,17.06,2288432,2288512
6816,79,27,0,6.48,17.90,2288511,2288590
6817,79,22,1,6.48,16.81,2288589,2288668
6818,69,36,2,7.42,29.32,2288667,2288736
6819,75,23,1,6.83,14.92,2288735,2288810
6820,76,26,1,6.74,21.01,2288809,2288885
6821,72,36,1,7.11,32.57,2288884,2288956
6822,73,25,1,7.01,20.01,2288955,2289028
6823,77,49,0,6.65,41.81,2289027,2289104
6824,85,21,0,6.02,17.93,2289103,2289188
6825,102,19,0,5.02,16.71,2289187,2289289
6826,86,30,0,5.95,26.21,2289288,2289374
6827,108,28,0,4.74,20.64,2289373,2289481
6828,82,19,0,6.24,16.60,2289480,2289562
6829,100,16,0,5.12,12.85,2289561,2289661
6830,91,16,0,5.63,12.65,2289660,2289751
6831,79,23,1,6.48,17.16,2289750,2289829
6832,80,26,1,6.40,16.44,2289829,2289909
6833,76,23,1,6.74,17.88,2289908,2289984
6834,73,22,1,7.01,21.22,2289983,2290056
6835,66,54,1,7.76,50.85,2290056,2290122
6836,64,27,1,8.00,26.12,2290121,2290185
6837,83,26,1,6.17,23.47,2290185,2290268
6838,70,31,0,7.31,22.22,2290267,2290337
6839,82,28,0,6.24,28.94,2290336,2290418
6840,97,30,0,5.28,24.37,2290417,2290514
6841,71,36,0,7.21,35.38,2290513,2290584
6842,103,29,0,4.97,18.34,2290583,2290686
6843,89,26,0,5.75,24.61,2290685,2290774
6844,86,34,0,5.95,33.46,2290773,2290859
6845,73,30,1,7.01,33.08,2290858,2290931
6846,92,21,0,5.57,14.59,2290930,2291022
6847,87,16,1,5.89,12.75,2291021,2291108
6848,86,17,1,5.95,12.63,2291108,2291194
6849,69,24,1,7.42,18.79,2291193,2291262
6850,80,17,1,6.40,12.19,2291261,2291341
6851,93,22,0,5.51,14.66,2291340,2291433
6852,82,25,0,6.24,16.26,2291432,2291514
6853,77,31,1,6.65,20.41,2291513,2291590
6854,76,19,1,6.74,20.46,2291589,2291665
6855,81,26,0,6.32,29.21,2291664,2291745
6856,103,17,0,4.97,13.97,2291744,2291847
6857,76,44,0,6.74,52.01,2291846,2291922
6858,111,21,0,4.61,16.81,2291921,2292032
6859,96,18,0,5.33,13.06,2292031,2292127
6860,89,15,1,5.75,10.82,2292126,2292215
6861,73,67,0,7.01,77.27,2292214,2292287
6862,72,26,1,7.11,22.35,2292286,2292358
6863,83,28,0,6.17,24.45,2292357,2292440
6864,74,27,0,6.92,20.64,2292440,2292514
6865,67,26,0,7.64,29.16,2292513,2292580
6866,78,24,1,6.56,18.02,2292579,2292657
6867,70,30,2,7.31,29.79,2292657,2292727
6868,81,18,1,6.32,13.63,2292726,2292807
6869,72,29,0,7.11,26.27,2292806,2292878
6870,72,22,1,7.11,18.13,2292877,2292949
6871,84,50,0,6.10,42.82,2292948,2293032
6872,70,25,0,7.31,32.07,2293031,2293101
6873,103,21,0,4.97,16.40,2293100,2293203
6874,78,27,1,6.56,26.84,2293202,2293280
6875,77,26,0,6.65,27.21,2293279,2293356
6876,96,25,0,5.33,22.83,2293355,2293451
6877,102,43,0,5.02,22.78,2293451,2293553
6878,85,32,0,6.02,29.86,2293552,2293637
6879,83,29,1,6.17,16.02,2293636,2293719
6880,72,23,2,7.11,17.07,2293718,2293790
6881,79,38,0,6.48,29.39,2293789,2293868
6882,76,44,0,6.74,35.64,2293867,2293943
6883,77,30,1,6.65,25.11,2293943,2294020
6884,69,22,1,7.42,18.74,2294020,2294089
6885,73,39,1,7.01,33.99,2294088,2294161
6886,56,52,0,9.14,64.69,2294160,2294216
6887,92,26,0,5.57,17.01,2294215,2294307
6888,84,22,0,6.10,21.94,2294306,2294390
6889,108,27,0,4.74,16.12,2294389,2294497
6890,103,27,0,4.97,22.20,2294496,2294599
6891,90,19,0,5.69,19.08,2294598,2294688
6892,88,35,0,5.82,30.06,2294687,2294775
6893,79,22,0,6.48,19.77,2294774,2294853
6894,82,24,0,6.24,16.57,2294852,2294934
6895,73,40,1,7.01,41.66,2294934,2295007
6896,80,23,1,6.40,16.14,2295006,2295086
6897,82,21,1,6.24,14.31,2295085,2295167
6898,78,21,0,6.56,14.12,2295166,2295244
6899,77,21,1,6.65,15.71,2295243,2295320
6900,78,27,0,6.56,20.94,2295319,2295397
6901,73,34,1,7.01,40.29,2295396,2295469
6902,80,19,1,6.40,14.44,2295468,2295548
6903,62,29,1,8.26,39.97,2295548,2295610
6904,96,30,0,5.33,30.83,2295609,2295705
6905,100,19,0,5.12,12.89,2295704,2295804
6906,91,43,0,5.63,46.39,2295803,2295894
6907,81,27,1,6.32,25.11,2295893,2295974
6908,90,40,0,5.69,24.95,2295974,2296064
6909,91,23,0,5.63,14.56,2296063,2296154
6910,84,19,0,6.10,15.97,2296153,2296237
6911,74,17,2,6.92,14.40,2296236,2296310
6912,80,28,0,6.40,19.17,2296310,2296390
6913,70,24,1,7.31,20.59,2296389,2296459
6914,71,25,1,7.21,21.04,2296458,2296529
6915,76,25,1,6.74,18.98,2296528,2296604
6916,74,20,0,6.92,19.29,2296604,2296678
6917,77,28,0,6.65,22.93,2296677,2296754
6918,95,17,0,5.39,14.39,2296753,2296848
6919,78,20,0,6.56,16.48,2296847,2296925
6920,84,29,1,6.10,27.51,2296924,2297008
6921,58,80,0,8.83,129.11,2297007,2297065
6922,84,28,0,6.10,24.73,2297064,2297148
6923,92,33,0,5.57,27.27,2297148,2297240
6924,82,23,0,6.24,23.50,2297239,2297321
6925,85,20,0,6.02,13.93,2297320,2297405
6926,104,25,0,4.92,12.72,2297405,2297509
6927,90,20,0,5.69,13.55,2297508,2297598
6928,70,24,0,7.31,28.99,2297597,2297667
6929,66,57,0,7.76,53.76,2297666,2297732
6930,85,24,1,6.02,17.67,2297731,2297816
6931,83,17,1,6.17,15.25,2297815,2297898
6932,78,22,0,6.56,15.60,2297897,2297975
6933,77,22,0,6.65,17.94,2297974,2298051
6934,76,39,0,6.74,31.19,2298050,2298126
6935,95,17,1,5.39,10.83,2298125,2298220
6936,80,19,1,6.40,14.26,2298219,2298299
6937,75,51,1,6.83,43.45,2298298,2298373
6938,77,23,0,6.65,22.83,2298372,2298449
6939,73,20,0,7.01,18.97,2298448,2298521
6940,109,27,0,4.70,19.09,2298520,2298629
6941,76,35,0,6.74,31.01,2298628,2298704
6942,107,27,0,4.79,15.48,2298704,2298811
6943,95,20,1,5.39,14.39,2298810,2298905
6944,90,22,0,5.69,19.28,2298904,2298994
6945,83,24,0,6.17,17.49,2298993,2299076
6946,73,27,1,7.01,28.42,2299076,2299149
6947,90,23,0,5.69,15.19,2299148,2299238
6948,66,52,1,7.76,46.85,2299237,2299303
6949,80,26,0,6.40,23.54,2299302,2299382
6950,60,34,1,8.53,32.28,2299381,2299441
6951,79,20,1,6.48,14.63,2299440,2299519
6952,83,25,1,6.17,21.20,2299518,2299601
6953,65,39,2,7.88,32.05,2299600,2299665
6954,74,42,0,6.92,35.40,2299664,2299738
6955,85,44,0,6.02,35.22,2299737,2299822
6956,81,36,1,6.32,29.01,2299821,2299902
6957,99,34,0,5.17,22.16,2299901,2300000
6958,80,21,1,6.40,20.24,2299999,2300079
6959,105,21,0,4.88,14.26,2300078,2300183
6960,94,26,0,5.45,20.23,2300182,2300276
6961,86,35,1,5.95,24.30,2300276,2300362
6962,92,40,0,5.57,24.44,2300361,2300453
6963,70,25,1,7.31,25.39,2300452,2300522
6964,70,21,0,7.31,22.87,2300521,2300591
6965,82,24,1,6.24,22.28,2300590,2300672
6966,77,27,1,6.65,19.99,2300671,2300748
6967,70,24,1,7.31,23.30,2300747,2300817
6968,68,26,1,7.53,23.63,2300816,2300884
6969,78,28,0,6.56,16.96,2300883,2300961
6970,76,34,0,6.74,30.25,2300961,2301037
6971,83,32,1,6.17,25.63,2301036,2301119
6972,86,32,0,5.95,20.79,2301118,2301204
6973,83,68,0,6.17,60.09,2301203,2301286
6974,96,32,0,5.33,30.64,2301285,2301381
6975,96,26,0,5.33,14.72,2301380,2301476
6976,93,20,0,5.51,19.73,2301475,2301568
6977,91,25,0,5.63,16.28,2301568,2301659
6978,88,27,0,5.82,29.38,2301658,2301746
6979,88,21,0,5.82,18.92,2301745,2301833
6980,72,20,1,7.11,14.63,2301832,2301904
6981,84,18,1,6.10,13.61,2301903,2301987
6982,70,40,1,7.31,31.50,2301986,2302056
6983,83,20,1,6.17,14.84,2302055,2302138
6984,80,17,1,6.40,12.81,2302137,2302217
6985,64,51,1,8.00,46.66,2302216,2302280
6986,83,23,1,6.17,13.61,2302279,2302362
6987,80,23,1,6.40,13.59,2302361,2302441
6988,80,27,1,6.40,20.79,2302440,2302520
6989,69,25,1,7.42,25.69,2302519,2302588
6990,76,40,0,6.74,35.98,2302587,2302663
6991,80,31,0,6.40,29.97,2302662,2302742
6992,110,29,0,4.65,17.37,2302741,2302851
6993,74,42,1,6.92,50.94,2302851,2302925
6994,93,32,0,5.51,22.53,2302925,2303018
6995,99,21,0,5.17,16.87,2303017,2303116
6996,89,43,0,5.75,41.92,2303115,2303204
6997,69,29,0,7.42,30.71,2303203,2303272
6998,76,23,1,6.74,16.30,2303271,2303347
6999,88,13,0,5.82,9.85,2303346,2303434
7000,63,46,0,8.13,72.05,2303433,2303496
7001,80,27,1,6.40,16.21,2303496,2303576
7002,75,28,1,6.83,23.69,2303575,2303650
7003,70,44,0,7.31,37.76,2303649,2303719
7004,75,21,0,6.83,15.34,2303718,2303793
7005,89,18,0,5.75,13.78,2303792,2303881
7006,58,51,2,8.83,54.83,2303880,2303938
7007,79,27,0,6.48,29.52,2303937,2304016
7008,73,27,1,7.01,21.88,2304015,2304088
7009,68,40,0,7.53,40.69,2304087,2304155
7010,93,22,0,5.51,19.56,2304154,2304247
7011,73,25,1,7.01,26.53,2304247,2304320
7012,102,21,0,5.02,15.53,2304319,2304421
7013,85,66,0,6.02,68.16,2304420,2304505
7014,81,99,0,6.32,128.46,2304504,2304585
7015,82,25,0,6.24,20.53,2304584,2304666
7016,69,28,1,7.42,29.98,2304665,2304734
7017,82,22,0,6.24,25.31,2304733,2304815
7018,64,45,0,8.00,58.19,2304814,2304878
7019,80,29,1,6.40,21.86,2304877,2304957
7020,90,33,1,5.69,17.53,2304956,2305046
7021,76,26,1,6.74,22.27,2305045,2305121
7022,84,28,0,6.10,18.30,2305120,2305204
7023,83,67,0,6.17,60.33,2305203,2305286
7024,74,21,0,6.92,21.64,2305285,2305359
7025,82,25,1,6.24,18.65,2305358,2305440
7026,69,77,0,7.42,91.32,2305439,2305508
7027,108,19,0,4.74,16.60,2305507,2305615
7028,83,25,0,6.17,29.47,2305614,2305697
7029,75,33,0,6.83,37.42,2305696,2305771
7030,77,63,1,6.65,59.99,2305770,2305847
7031,107,48,0,4.79,29.44,2305846,2305953
7032,72,24,1,7.11,20.77,2305952,2306024
7033,83,22,0,6.17,15.92,2306023,2306106
7034,71,17,1,7.21,13.01,2306105,2306176
7035,88,20,0,5.82,17.04,2306175,2306263
7036,80,39,0,6.40,23.74,2306263,2306343
7037,73,29,1,7.01,25.58,2306342,2306415
7038,74,29,1,6.92,22.10,2306414,2306488
7039,76,22,1,6.74,18.22,2306487,2306563
7040,81,19,0,6.32,14.86,2306562,2306643
7041,83,33,0,6.17,23.01,2306642,2306725
7042,77,17,1,6.65,15.21,2306724,2306801
7043,87,22,1,5.89,17.57,2306800,2306887
7044,64,22,0,8.00,29.12,2306887,2306951
7045,92,23,0,5.57,23.27,2306950,2307042
7046,80,83,0,6.40,88.94,2307041,2307121
7047,86,33,0,5.95,35.23,2307120,2307206
7048,76,28,0,6.74,26.22,2307205,2307281
7049,91,20,0,5.63,18.70,2307280,2307371
7050,76,36,0,6.74,31.56,2307370,2307446
7051,75,21,1,6.83,18.33,2307445,2307520
7052,68,35,0,7.53,38.84,2307519,2307587
7053,71,20,0,7.21,20.62,2307587,2307658
7054,74,21,0,6.92,17.37,2307657,2307731
7055,78,34,1,6.56,29.02,2307730,2307808
7056,66,32,1,7.76,23.43,2307807,2307873
7057,74,23,1,6.92,21.18,2307873,2307947
7058,74,23,0,6.92,18.16,2307946,2308020
7059,79,40,1,6.48,54.05,2308019,2308098
7060,72,22,0,7.11,20.40,2308097,2308169
7061,79,29,1,6.48,25.57,2308168,2308247
7062,67,31,0,7.64,41.90,2308246,2308313
7063,80,31,0,6.40,25.84,2308312,2308392
7064,86,40,0,5.95,35.86,2308391,2308477
7065,78,30,0,6.56,27.45,2308477,2308555
7066,86,29,0,5.95,26.28,2308554,2308640
7067,96,20,0,5.33,16.43,2308640,2308736
7068,89,25,1,5.75,18.84,2308735,2308824
7069,70,31,1,7.31,26.90,2308823,2308893
7070,81,18,0,6.32,13.58,2308892,2308973
7071,82,19,2,6.24,14.43,2308972,2309054
7072,72,25,0,7.11,21.60,2309054,2309126
7073,72,23,1,7.11,20.04,2309125,2309197
7074,64,40,1,8.00,37.62,2309197,2309261
7075,79,34,1,6.48,26.05,2309260,2309339
7076,73,31,2,7.01,32.84,2309338,2309411
7077,67,42,1,7.64,44.11,2309410,2309477
7078,79,33,1,6.48,24.15,2309476,2309555
7079,83,21,0,6.17,16.86,2309554,2309637
7080,59,30,0,8.68,43.88,2309636,2309695
7081,92,34,0,5.57,32.05,2309694,2309786
7082,80,40,1,6.40,29.64,2309786,2309866
7083,92,23,0,5.57,18.81,2309865,2309957
7084,84,23,0,6.10,22.66,2309956,2310040
7085,107,15,0,4.79,9.37,2310039,2310146
7086,87,26,0,5.89,20.01,2310146,2310233
7087,89,17,0,5.75,12.10,2310232,2310321
7088,64,18,1,8.00,17.22,2310320,2310384
7089,85,19,1,6.02,14.66,2310383,2310468
7090,77,26,1,6.65,24.80,2310467,2310544
7091,76,26,0,6.74,24.80,2310543,2310619
7092,69,29,1,7.42,23.81,2310618,2310687
7093,80,29,0,6.40,19.61,2310686,2310766
7094,77,29,0,6.65,24.36,2310765,2310842
7095,70,21,1,7.31,17.02,2310841,2310911
7096,70,27,0,7.31,33.39,2310910,2310980
7097,77,35,0,6.65,29.94,2310979,2311056
7098,67,51,0,7.64,52.59,2311055,2311122
7099,93,34,0,5.51,29.63,2311121,2311214
7100,76,39,0,6.74,48.69,2311213,2311289
7101,100,25,0,5.12,18.57,2311288,2311388
7102,81,26,1,6.32,20.81,2311387,2311468
7103,91,25,0,5.63,21.88,2311467,2311558
7104,85,15,1,6.02,13.18,2311558,2311643
7105,72,41,1,7.11,28.29,2311642,2311714
7106,75,30,1,6.83,17.69,2311713,2311788
7107,86,18,1,5.95,12.16,2311787,2311873
7108,68,46,2,7.53,55.57,2311872,2311940
7109,82,26,1,6.24,23.11,2311940,2312022
7110,69,27,0,7.42,29.61,2312021,2312090
7111,74,19,0,6.92,18.16,2312089,2312163
7112,68,30,1,7.53,29.22,2312162,2312230
7113,82,25,1,6.24,16.26,2312229,2312311
7114,72,43,1,7.11,33.15,2312310,2312382
7115,82,22,1,6.24,15.06,2312381,2312463
7116,71,21,1,7.21,22.14,2312462,2312533
7117,99,27,0,5.17,23.17,2312532,2312631
7118,93,23,0,5.51,18.10,2312630,2312723
7119,92,29,1,5.57,21.12,2312722,2312814
7120,109,17,0,4.70,9.57,2312814,2312923
7121,93,24,0,5.51,17.26,2312922,2313015
7122,83,18,0,6.17,13.27,2313015,2313098
7123,73,19,1,7.01,23.08,2313097,2313170
7124,81,24,1,6.32,23.08,2313169,2313250
7125,74,30,1,6.92,27.07,2313249,2313323
7126,77,22,0,6.65,20.59,2313323,2313400
7127,78,18,1,6.56,13.14,2313399,2313477
7128,72,17,1,7.11,13.29,2313476,2313548
7129,64,31,1,8.00,31.72,2313547,2313611
7130,95,15,0,5.39,9.42,2313611,2313706
7131,71,24,1,7.21,22.45,2313705,2313776
7132,82,30,0,6.24,23.79,2313775,2313857
7133,78,22,0,6.56,26.19,2313857,2313935
7134,94,21,0,5.45,21.01,2313934,2314028
7135,76,28,0,6.74,28.19,2314027,2314103
7136,88,45,0,5.82,47.76,2314103,2314191
7137,105,16,0,4.88,11.08,2314190,2314295
7138,98,42,1,5.22,35.38,2314295,2314393
7139,57,35,1,8.98,50.96,2314392,2314449
7140,71,36,0,7.21,29.97,2314448,2314519
7141,70,24,1,7.31,25.04,2314518,2314588
7142,88,22,0,5.82,13.81,2314587,2314675
7143,82,26,1,6.24,20.14,2314674,2314756
7144,62,35,0,8.26,49.74,2314755,2314817
7145,68,24,1,7.53,24.66,2314816,2314884
7146,67,31,1,7.64,25.19,2314884,2314951
7147,76,24,1,6.74,19.51,2314950,2315026
7148,77,25,1,6.65,29.55,2315025,2315102
7149,70,23,1,7.31,23.30,2315101,2315171
7150,90,23,1,5.69,16.04,2315170,2315260
7151,55,81,0,9.31,133.09,2315259,2315314
7152,101,28,0,5.07,18.94,2315313,2315414
7153,79,26,0,6.48,17.24,2315413,2315492
7154,78,42,0,6.56,47.89,2315491,2315569
7155,90,23,0,5.69,19.68,2315568,2315658
7156,76,30,0,6.74,37.77,2315657,2315733
7157,75,53,0,6.83,48.33,2315732,2315807
7158,66,26,1,7.76,23.49,2315806,2315872
7159,75,23,1,6.83,20.94,2315872,2315947
7160,73,40,1,7.01,30.31,2315946,2316019
7161,70,25,1,7.31,23.27,2316018,2316088
7162,74,35,1,6.92,33.34,2316087,2316161
7163,76,42,0,6.74,29.90,2316160,2316236
7164,66,31,1,7.76,27.09,2316235,2316301
7165,90,21,0,5.69,18.70,2316301,2316391
7166,75,21,1,6.83,21.05,2316390,2316465
7167,83,21,0,6.17,17.03,2316464,2316547
7168,81,55,0,6.32,50.64,2316546,2316627
7169,86,16,0,5.95,16.58,2316626,2316712
7170,76,22,0,6.74,24.75,2316711,2316787
7171,88,20,0,5.82,14.65,2316786,2316874
7172,92,23,0,5.57,21.31,2316873,2316965
7173,78,27,0,6.56,23.66,2316964,2317042
7174,71,24,0,7.21,20.05,2317041,2317112
7175,89,24,1,5.75,14.37,2317111,2317200
7176,76,23,1,6.74,17.77,2317199,2317275
7177,73,23,1,7.01,17.79,2317274,2317347
7178,64,46,1,8.00,56.50,2317347,2317411
7179,74,25,1,6.92,17.62,2317410,2317484
7180,66,35,1,7.76,43.70,2317483,2317549
7181,98,25,0,5.22,18.42,2317548,2317646
7182,67,23,1,7.64,20.92,2317645,2317712
7183,74,30,0,6.92,35.89,2317711,2317785
7184,73,35,0,7.01,35.68,2317784,2317857
7185,85,34,0,6.02,38.80,2317856,2317941
7186,93,19,1,5.51,14.62,2317940,2318033
7187,72,38,2,7.11,42.74,2318032,2318104
7188,94,23,0,5.45,16.42,2318103,2318197
7189,89,39,0,5.75,30.66,2318197,2318286
7190,69,66,0,7.42,72.42,2318285,2318354
7191,83,23,0,6.17,16.53,2318353,2318436
7192,76,19,1,6.74,17.01,2318435,2318511
7193,82,28,1,6.24,15.94,2318510,2318592
7194,64,48,1,8.00,43.44,2318591,2318655
7195,71,36,0,7.21,35.80,2318654,2318725
7196,70,33,0,7.31,43.33,2318724,2318794
7197,55,50,1,9.31,65.70,2318793,2318848
7198,73,26,0,7.01,21.74,2318847,2318920
7199,74,30,1,6.92,37.45,2318919,2318993
7200,82,23,0,6.24,17.87,2318992,2319074
7201,70,36,1,7.31,29.33,2319073,2319143
7202,82,26,0,6.24,20.82,2319142,2319224
7203,62,30,1,8.26,31.71,2319223,2319285
7204,78,27,0,6.56,22.07,2319284,2319362
7205,80,28,0,6.40,33.76,2319361,2319441
7206,96,39,0,5.33,34.81,2319440,2319536
7207,97,31,0,5.28,23.46,2319535,2319632
7208,97,31,0,5.28,18.76,2319631,2319728
7209,78,91,0,6.56,104.84,2319728,2319806
7210,70,25,0,7.31,18.50,2319805,2319875
7211,63,27,0,8.13,30.59,2319874,2319937
7212,67,30,1,7.64,32.38,2319936,2320003
7213,85,21,0,6.02,13.34,2320002,2320087
7214,69,42,1,7.42,44.01,2320086,2320155
7215,61,32,0,8.39,38.86,2320154,2320215
7216,72,27,1,7.11,25.32,2320214,2320286
7217,71,19,0,7.21,13.86,2320285,2320356
7218,90,18,0,5.69,10.53,2320355,2320445
7219,66,45,1,7.76,53.03,2320444,2320510
7220,72,47,0,7.11,60.24,2320509,2320581
7221,57,32,1,8.98,48.40,2320581,2320638
7222,90,32,0,5.69,31.46,2320637,2320727
7223,74,32,0,6.92,26.80,2320726,2320800
7224,90,18,0,5.69,19.35,2320799,2320889
7225,88,27,0,5.82,24.15,2320888,2320976
7226,86,43,0,5.95,49.88,2320975,2321061
7227,78,33,1,6.56,26.04,2321060,2321138
7228,85,22,0,6.02,12.23,2321137,2321222
7229,80,18,1,6.40,11.29,2321221,2321301
7230,84,33,0,6.10,22.06,2321300,2321384
7231,78,22,0,6.56,22.53,2321383,2321461
7232,79,18,1,6.48,15.16,2321460,2321539
7233,75,26,1,6.83,24.68,2321538,2321613
7234,72,23,1,7.11,20.79,2321612,2321684
7235,81,28,1,6.32,18.14,2321683,2321764
7236,103,22,0,4.97,12.65,2321764,2321867
7237,67,26,1,7.64,29.90,2321866,2321933
7238,84,21,0,6.10,18.66,2321933,2322017
7239,68,30,1,7.53,27.04,2322016,2322084
7240,84,32,0,6.10,28.61,2322083,2322167
7241,111,22,0,4.61,13.97,2322166,2322277
7242,91,23,0,5.63,30.37,2322276,2322367
7243,100,17,0,5.12,13.07,2322366,2322466
7244,89,29,0,5.75,22.91,2322465,2322554
7245,81,22,0,6.32,17.43,2322553,2322634
7246,78,16,1,6.56,13.99,2322633,2322711
7247,76,27,0,6.74,29.09,2322710,2322786
7248,87,28,1,5.89,15.25,2322785,2322872
7249,65,42,1,7.88,40.57,2322871,2322936
7250,63,34,1,8.13,37.16,2322935,2322998
7251,81,20,1,6.32,16.56,2322997,2323078
7252,78,42,1,6.56,30.94,2323077,2323155
7253,77,27,1,6.65,23.03,2323154,2323231
7254,78,34,1,6.56,24.40,2323230,2323308
7255,86,25,0,5.95,25.32,2323307,2323393
7256,85,28,1,6.02,24.71,2323393,2323478
7257,84,25,0,6.10,20.32,2323477,2323561
7258,81,31,0,6.32,28.14,2323560,2323641
7259,90,22,1,5.69,20.17,2323641,2323731
7260,71,23,1,7.21,20.48,2323730,2323801
7261,69,26,1,7.42,24.68,2323800,2323869
7262,72,32,1,7.11,24.43,2323868,2323940
7263,76,51,0,6.74,47.80,2323939,2324015
7264,69,35,1,7.42,30.48,2324014,2324083
7265,75,21,1,6.83,19.18,2324082,2324157
7266,58,55,1,8.83,72.76,2324156,2324214
7267,80,20,1,6.40,12.66,2324214,2324294
7268,78,25,1,6.56,27.53,2324293,2324371
7269,77,22,1,6.65,13.76,2324370,2324447
7270,85,24,0,6.02,23.58,2324447,2324532
7271,67,32,1,7.64,34.05,2324532,2324599
7272,73,26,0,7.01,31.47,2324598,2324671
7273,100,51,0,5.12,44.17,2324670,2324770
7274,96,23,0,5.33,22.66,2324769,2324865
7275,78,32,0,6.56,29.60,2324865,2324943
7276,79,53,0,6.48,44.81,2324942,2325021
7277,84,31,1,6.10,20.92,2325020,2325104
7278,86,22,1,5.95,19.23,2325103,2325189
7279,75,37,1,6.83,33.10,2325188,2325263
7280,79,25,0,6.48,22.38,2325263,2325342
7281,80,38,1,6.40,28.79,2325341,2325421
7282,66,45,1,7.76,63.61,2325420,2325486
7283,64,33,1,8.00,37.56,2325485,2325549
7284,69,19,1,7.42,18.13,2325548,2325617
7285,74,23,1,6.92,15.05,2325616,2325690
7286,89,22,0,5.75,15.62,2325689,2325778
7287,70,25,0,7.31,21.59,2325777,2325847
7288,76,27,0,6.74,27.56,2325846,2325922
7289,69,23,1,7.42,21.26,2325921,2325990
7290,79,28,0,6.48,29.62,2325989,2326068
7291,90,26,0,5.69,23.79,2326067,2326157
7292,85,32,0,6.02,35.98,2326156,2326241
7293,95,18,0,5.39,12.39,2326241,2326336
7294,85,21,0,6.02,15.98,2326335,2326420
7295,80,34,0,6.40,36.07,2326419,2326499
7296,74,26,1,6.92,24.94,2326498,2326572
7297,70,23,1,7.31,16.22,2326571,2326641
7298,89,25,0,5.75,14.30,2326640,2326729
7299,68,21,0,7.53,18.93,2326728,2326796
7300,71,32,1,7.21,30.25,2326795,2326866
7301,75,18,0,6.83,16.65,2326865,2326940
7302,62,25,1,8.26,28.32,2326939,2327001
7303,68,26,1,7.53,20.96,2327001,2327069
7304,83,23,0,6.17,23.15,2327068,2327151
7305,68,37,0,7.53,31.87,2327150,2327218
7306,69,28,0,7.42,33.63,2327217,2327286
7307,74,22,1,6.92,16.05,2327285,2327359
7308,70,36,0,7.31,41.84,2327358,2327428
7309,85,30,0,6.02,30.85,2327427,2327512
7310,92,21,0,5.57,19.55,2327511,2327603
7311,103,26,0,4.97,16.51,2327602,2327705
7312,110,14,0,4.65,7.03,2327704,2327814
7313,87,18,0,5.89,16.63,2327813,2327900
7314,81,31,1,6.32,28.19,2327900,2327981
7315,67,34,0,7.64,33.16,2327980,2328047
7316,72,27,1,7.11,32.93,2328047,2328119
7317,71,23,1,7.21,16.48,2328118,2328189
7318,70,28,1,7.31,22.96,2328188,2328258
7319,76,33,0,6.74,23.88,2328257,2328333
7320,75,31,1,6.83,20.76,2328332,2328407
7321,71,33,0,7.21,31.60,2328406,2328477
7322,78,27,1,6.56,25.73,2328476,2328554
7323,74,22,1,6.92,20.24,2328554,2328628
7324,71,29,1,7.21,33.49,2328627,2328698
7325,70,94,1,7.31,125.47,2328697,2328767
7326,46,40,0,11.13,118.68,2328766,2328812
7327,83,30,0,6.17,31.27,2328811,2328894
7328,89,21,0,5.75,21.87,2328893,2328982
7329,70,74,0,7.31,92.27,2328981,2329051
7330,88,34,0,5.82,29.04,2329050,2329138
7331,101,16,0,5.07,10.86,2329137,2329238
7332,89,19,0,5.75,15.42,2329237,2329326
7333,78,21,1,6.56,21.27,2329325,2329403
7334,84,22,0,6.10,15.13,2329403,2329487
7335,83,29,1,6.17,21.90,2329486,2329569
7336,81,21,1,6.32,14.07,2329569,2329650
7337,71,22,1,7.21,18.05,2329649,2329720
7338,58,30,1,8.83,42.42,2329719,2329777
7339,75,23,0,6.83,18.49,2329776,2329851
7340,74,36,1,6.92,21.89,2329851,2329925
7341,84,22,1,6.10,17.73,2329925,2330009
7342,65,48,1,7.88,41.37,2330008,2330073
7343,85,25,0,6.02,15.65,2330072,2330157
7344,74,28,0,6.92,29.16,2330156,2330230
7345,74,29,0,6.92,29.80,2330229,2330303
7346,95,20,0,5.39,19.71,2330302,2330397
7347,106,21,0,4.83,15.07,2330396,2330502
7348,93,22,0,5.51,15.22,2330502,2330595
7349,92,36,0,5.57,20.66,2330594,2330686
7350,83,39,0,6.17,31.80,2330685,2330768
7351,74,23,0,6.92,21.05,2330767,2330841
7352,66,36,1,7.76,39.43,2330841,2330907
7353,87,30,0,5.89,23.94,2330906,2330993
7354,68,34,2,7.53,30.19,2330992,2331060
7355,73,52,0,7.01,46.21,2331060,2331133
7356,69,22,0,7.42,19.78,2331133,2331202
7357,70,24,2,7.31,25.67,2331201,2331271
7358,83,26,1,6.17,16.94,2331270,2331353
7359,79,31,1,6.48,18.60,2331352,2331431
7360,74,26,0,6.92,25.48,2331430,2331504
7361,71,48,0,7.21,47.77,2331503,2331574
7362,86,24,0,5.95,23.37,2331573,2331659
7363,86,22,0,5.95,23.02,2331658,2331744
7364,70,68,0,7.31,90.24,2331743,2331813
7365,109,19,0,4.70,11.86,2331812,2331921
7366,95,21,1,5.39,16.20,2331920,2332015
7367,90,49,0,5.69,33.53,2332014,2332104
7368,85,23,1,6.02,13.03,2332103,2332188
7369,73,23,2,7.01,14.86,2332187,2332260
7370,71,26,0,7.21,28.62,2332259,2332330
7371,75,27,1,6.83,21.88,2332329,2332404
7372,75,26,0,6.83,26.36,2332403,2332478
7373,78,25,0,6.56,20.81,2332478,2332556
7374,92,18,1,5.57,9.12,2332555,2332647
7375,72,29,1,7.11,35.57,2332646,2332718
7376,81,16,0,6.32,17.65,2332717,2332798
7377,68,36,1,7.53,32.43,2332797,2332865
7378,75,50,0,6.83,43.96,2332864,2332939
7379,61,30,0,8.39,43.26,2332938,2332999
7380,73,49,0,7.01,50.31,2332998,2333071
7381,104,18,0,4.92,12.67,2333070,2333174
7382,94,28,0,5.45,30.91,2333173,2333267
7383,104,18,0,4.92,10.32,2333266,2333370
7384,72,54,0,7.11,64.60,2333369,2333441
7385,83,26,1,6.17,17.08,2333440,2333523
7386,78,38,0,6.56,41.76,2333522,2333600
7387,72,23,1,7.11,19.13,2333599,2333671
7388,64,42,1,8.00,41.22,2333670,2333734
7389,73,27,0,7.01,29.52,2333734,2333807
7390,73,22,1,7.01,16.56,2333806,2333879
7391,73,30,1,7.01,24.89,2333878,2333951
7392,84,18,0,6.10,12.63,2333950,2334034
7393,77,30,1,6.65,21.55,2334033,2334110
7394,80,32,0,6.40,32.39,2334109,2334189
7395,77,24,1,6.65,19.79,2334188,2334265
7396,87,25,0,5.89,25.48,2334265,2334352
7397,79,20,1,6.48,21.03,2334352,2334431
7398,75,50,0,6.83,53.61,2334430,2334505
7399,97,43,0,5.28,30.02,2334504,2334601
7400,103,20,0,4.97,14.65,2334600,2334703
7401,90,33,0,5.69,19.97,2334702,2334792
7402,105,25,0,4.88,12.39,2334792,2334897
7403,96,14,0,5.33,10.37,2334896,2334992
7404,69,69,1,7.42,72.10,2334991,2335060
7405,76,26,1,6.74,15.06,2335059,2335135
7406,79,22,1,6.48,14.22,2335135,2335214
7407,79,19,1,6.48,19.06,2335213,2335292
7408,75,28,1,6.83,20.14,2335291,2335366
7409,81,36,0,6.32,27.06,2335365,2335446
7410,73,22,1,7.01,24.34,2335445,2335518
7411,72,42,1,7.11,31.54,2335517,2335589
7412,71,48,1,7.21,47.35,2335588,2335659
7413,82,47,0,6.24,38.65,2335658,2335740
7414,100,24,0,5.12,16.75,2335739,2335839
7415,86,34,0,5.95,29.00,2335838,2335924
7416,94,25,1,5.45,12.67,2335923,2336017
7417,79,28,0,6.48,22.96,2336016,2336095
7418,71,21,1,7.21,19.60,2336094,2336165
7419,75,30,1,6.83,27.58,2336164,2336239
7420,83,15,1,6.17,10.14,2336239,2336322
7421,69,30,2,7.42,23.43,2336321,2336390
7422,50,51,1,10.24,92.34,2336389,2336439
7423,80,21,0,6.40,17.62,2336438,2336518
7424,57,36,1,8.98,48.58,2336517,2336574
7425,78,26,2,6.56,17.91,2336574,2336652
7426,88,30,0,5.82,25.33,2336652,2336740
7427,75,27,1,6.83,23.00,2336739,2336814
7428,78,36,1,6.56,25.86,2336813,2336891
7429,64,34,0,8.00,40.94,2336891,2336955
7430,81,28,0,6.32,28.49,2336954,2337035
7431,88,21,0,5.82,16.99,2337034,2337122
7432,87,26,0,5.89,29.23,2337121,2337208
7433,86,25,0,5.95,18.28,2337207,2337293
7434,89,17,0,5.75,14.64,2337292,2337381
7435,89,16,1,5.75,9.11,2337380,2337469
7436,86,28,0,5.95,18.93,2337468,2337554
7437,63,36,1,8.13,50.05,2337554,2337617
7438,85,21,1,6.02,13.43,2337616,2337701
7439,74,22,0,6.92,24.51,2337701,2337775
7440,54,31,1,9.48,47.47,2337774,2337828
7441,80,26,0,6.40,20.84,2337827,2337907
7442,71,29,0,7.21,22.50,2337906,2337977
7443,73,31,0,7.01,25.41,2337977,2338050
7444,85,23,0,6.02,18.07,2338049,2338134
7445,65,32,2,7.88,28.08,2338133,2338198
7446,69,48,0,7.42,57.55,2338197,2338266
7447,75,51,0,6.83,43.34,2338265,2338340
7448,78,29,0,6.56,30.19,2338339,2338417
7449,81,24,0,6.32,19.82,2338416,2338497
7450,88,26,0,5.82,20.38,2338496,2338584
7451,94,41,0,5.45,28.16,2338583,2338677
7452,92,16,0,5.57,13.09,2338676,2338768
7453,84,19,1,6.10,18.16,2338767,2338851
7454,87,32,0,5.89,22.31,2338850,2338937
7455,59,26,1,8.68,31.88,2338936,2338995
7456,72,22,0,7.11,23.57,2338994,2339066
7457,79,17,0,6.48,13.87,2339065,2339144
7458,81,19,0,6.32,16.71,2339144,2339225
7459,71,30,1,7.21,27.07,2339224,2339295
7460,66,33,1,7.76,25.40,2339294,2339360
7461,75,21,1,6.83,16.84,2339360,2339435
7462,91,22,0,5.63,17.35,2339435,2339526
7463,68,57,1,7.53,56.43,2339525,2339593
7464,73,30,0,7.01,30.04,2339592,2339665
7465,76,34,1,6.74,24.19,2339664,2339740
7466,77,35,0,6.65,37.08,2339740,2339817
7467,84,20,0,6.10,18.49,2339816,2339900
7468,103,50,0,4.97,43.25,2339899,2340002
7469,97,26,0,5.28,16.76,2340002,2340099
7470,98,27,1,5.22,17.64,2340098,2340196
7471,77,31,0,6.65,33.50,2340195,2340272
7472,75,33,0,6.83,23.37,2340271,2340346
7473,76,40,2,6.74,24.38,2340345,2340421
7474,66,50,0,7.76,56.40,2340420,2340486
7475,76,23,0,6.74,20.06,2340485,2340561
7476,75,32,0,6.83,23.69,2340560,2340635
7477,75,22,1,6.83,14.14,2340634,2340709
7478,69,27,1,7.42,24.94,2340708,2340777
7479,66,32,0,7.76,26.46,2340776,2340842
7480,89,26,0,5.75,24.43,2340841,2340930
7481,72,18,1,7.11,16.79,2340930,2341002
7482,80,22,0,6.40,21.14,2341001,2341081
7483,82,21,0,6.24,18.36,2341080,2341162
7484,63,72,1,8.13,93.19,2341161,2341224
7485,76,24,0,6.74,32.48,2341223,2341299
7486,116,21,0,4.41,14.54,2341298,2341414
7487,95,24,0,5.39,15.40,2341413,2341508
7488,91,21,0,5.63,14.67,2341507,2341598
7489,87,17,0,5.89,12.15,2341597,2341684
7490,74,32,1,6.92,35.34,2341683,2341757
7491,63,40,1,8.13,43.48,2341756,2341819
7492,65,26,1,7.88,27.25,2341818,2341883
7493,72,25,0,7.11,25.29,2341883,2341955
7494,71,24,1,7.21,24.31,2341954,2342025
7495,64,29,2,8.00,32.47,2342024,2342088
7496,61,46,1,8.39,49.29,2342087,2342148
7497,71,47,1,7.21,41.88,2342147,2342218
7498,79,21,1,6.48,13.97,2342217,2342296
7499,77,28,0,6.65,26.36,2342295,2342372
7500,80,29,0,6.40,27.99,2342371,2342451
7501,92,34,0,5.57,29.53,2342451,2342543
7502,94,24,0,5.45,25.93,2342542,2342636
7503,70,36,0,7.31,36.22,2342635,2342705
7504,90,20,0,5.69,17.39,2342704,2342794
7505,72,37,1,7.11,32.32,2342794,2342866
7506,66,50,1,7.76,42.52,2342866,2342932
7507,58,36,0,8.83,39.42,2342931,2342989
7508,75,38,0,6.83,35.34,2342988,2343063
7509,81,16,1,6.32,11.43,2343062,2343143
7510,78,24,0,6.56,21.68,2343142,2343220
7511,70,27,1,7.31,26.62,2343219,2343289
7512,78,23,1,6.56,23.63,2343288,2343366
7513,86,22,0,5.95,17.28,2343365,2343451
7514,69,19,2,7.42,16.04,2343450,2343519
7515,71,26,0,7.21,27.38,2343518,2343589
7516,68,37,0,7.53,40.22,2343588,2343656
7517,79,22,0,6.48,21.87,2343655,2343734
7518,68,51,1,7.53,60.60,2343733,2343801
7519,100,23,0,5.12,17.63,2343801,2343901
7520,83,87,0,6.17,92.91,2343900,2343983
7521,95,22,1,5.39,15.10,2343982,2344077
7522,97,28,0,5.28,24.32,2344077,2344174
7523,73,74,0,7.01,87.11,2344173,2344246
7524,70,26,1,7.31,21.82,2344246,2344316
7525,77,36,0,6.65,26.80,2344315,2344392
7526,81,17,1,6.32,14.19,2344391,2344472
7527,71,26,2,7.21,19.55,2344471,2344542
7528,85,21,0,6.02,12.80,2344541,2344626
7529,66,42,0,7.76,41.00,2344625,2344691
7530,58,32,1,8.83,36.97,2344690,2344748
7531,84,26,0,6.10,15.94,2344747,2344831
7532,74,43,0,6.92,47.70,2344830,2344904
7533,60,31,1,8.53,38.95,2344903,2344963
7534,76,33,0,6.74,34.77,2344962,2345038
7535,63,25,1,8.13,25.00,2345037,2345100
7536,76,22,0,6.74,27.06,2345100,2345176
7537,82,16,0,6.24,15.09,2345175,2345257
7538,103,22,0,4.97,17.43,2345257,2345360
7539,80,25,1,6.40,29.34,2345359,2345439
7540,95,26,0,5.39,18.97,2345438,2345533
7541,82,36,0,6.24,25.53,2345532,2345614
7542,68,36,0,7.53,43.96,2345613,2345681
7543,73,29,0,7.01,23.36,2345680,2345753
7544,69,24,0,7.42,24.27,2345752,2345821
7545,71,19,0,7.21,20.25,2345821,2345892
7546,70,21,1,7.31,26.04,2345891,2345961
7547,72,28,1,7.11,32.07,2345960,2346032
7548,71,33,2,7.21,22.45,2346031,2346102
7549,72,35,0,7.11,22.96,2346101,2346173
7550,79,45,0,6.48,37.39,2346172,2346251
7551,79,24,0,6.48,18.43,2346250,2346329
7552,68,22,1,7.53,25.96,2346328,2346396
7553,84,17,0,6.10,16.35,2346396,2346480
7554,69,51,0,7.42,55.40,2346480,2346549
7555,72,35,0,7.11,33.02,2346548,2346620
7556,97,39,0,5.28,23.91,2346619,2346716
7557,92,29,0,5.57,26.07,2346715,2346807
7558,79,31,1,6.48,22.07,2346806,2346885
7559,82,38,0,6.24,31.70,2346884,2346966
7560,84,20,0,6.10,17.40,2346965,2347049
7561,69,21,1,7.42,18.91,2347048,2347117
7562,89,19,1,5.75,9.65,2347116,2347205
7563,75,31,2,6.83,21.66,2347204,2347279
7564,68,44,1,7.53,36.43,2347278,2347346
7565,71,45,1,7.21,36.53,2347346,2347417
7566,67,22,1,7.64,28.32,2347416,2347483
7567,76,27,0,6.74,25.38,2347482,2347558
7568,75,19,0,6.83,19.29,2347557,2347632
7569,66,43,0,7.76,51.73,2347631,2347697
7570,64,29,1,8.00,30.16,2347697,2347761
7571,79,32,0,6.48,30.07,2347760,2347839
7572,86,34,0,5.95,30.84,2347839,2347925
7573,91,23,0,5.63,19.14,2347924,2348015
7574,104,23,0,4.92,14.96,2348014,2348118
7575,84,40,0,6.10,26.32,2348117,2348201
7576,70,23,0,7.31,24.56,2348200,2348270
7577,77,34,1,6.65,24.31,2348269,2348346
7578,64,35,0,8.00,31.78,2348346,2348410
7579,80,28,0,6.40,18.89,2348409,2348489
7580,63,27,0,8.13,27.86,2348488,2348551
7581,78,23,1,6.56,15.71,2348550,2348628
7582,84,16,0,6.10,12.21,2348628,2348712
7583,70,47,0,7.31,40.39,2348711,2348781
7584,77,23,1,6.65,17.37,2348780,2348857
7585,64,38,0,8.00,37.19,2348856,2348920
7586,66,23,0,7.76,34.46,2348919,2348985
7587,96,30,0,5.33,24.49,2348984,2349080
7588,86,37,0,5.95,27.28,2349079,2349165
7589,78,51,1,6.56,48.09,2349164,2349242
7590,81,21,1,6.32,14.34,2349241,2349322
7591,82,22,0,6.24,16.09,2349321,2349403
7592,81,32,0,6.32,26.93,2349402,2349483
7593,75,25,1,6.83,28.73,2349482,2349557
7594,71,18,0,7.21,16.03,2349556,2349627
7595,63,39,1,8.13,57.48,2349627,2349690
7596,61,32,0,8.39,39.98,2349689,2349750
7597,63,59,1,8.13,67.57,2349749,2349812
7598,65,25,1,7.88,24.05,2349811,2349876
7599,72,31,1,7.11,22.32,2349876,2349948
7600,77,20,1,6.65,19.40,2349947,2350024
7601,68,28,2,7.53,27.10,2350024,2350092
7602,73,27,0,7.01,31.90,2350091,2350164
7603,62,44,1,8.26,46.97,2350163,2350225
7604,73,23,0,7.01,17.08,2350225,2350298
7605,79,20,0,6.48,22.05,2350297,2350376
7606,100,21,0,5.12,18.81,2350376,2350476
7607,80,34,0,6.40,35.61,2350475,2350555
7608,76,39,0,6.74,26.88,2350555,2350631
7609,76,38,0,6.74,47.77,2350631,2350707
7610,100,20,0,5.12,12.99,2350706,2350806
7611,79,21,1,6.48,18.15,2350805,2350884
7612,56,29,2,9.14,43.05,2350883,2350939
7613,69,24,1,7.42,28.88,2350939,2351008
7614,74,23,0,6.92,19.91,2351008,2351082
7615,63,34,1,8.13,29.32,2351081,2351144
7616,49,38,2,10.45,57.92,2351143,2351192
7617,55,32,0,9.31,57.70,2351191,2351246
7618,75,21,0,6.83,19.80,2351245,2351320
7619,72,29,1,7.11,31.43,2351319,2351391
7620,65,65,1,7.88,82.29,2351390,2351455
7621,66,25,0,7.76,31.46,2351454,2351520
7622,71,51,0,7.21,43.24,2351519,2351590
7623,80,42,0,6.40,39.57,2351589,2351669
7624,90,37,0,5.69,34.99,2351669,2351759
7625,97,22,0,5.28,13.09,2351758,2351855
7626,92,28,0,5.57,22.77,2351854,2351946
7627,70,24,1,7.31,22.82,2351945,2352015
7628,67,28,1,7.64,32.74,2352014,2352081
7629,71,22,1,7.21,21.15,2352080,2352151
7630,72,22,0,7.11,24.35,2352150,2352222
7631,80,28,1,6.40,22.81,2352221,2352301
7632,68,46,0,7.53,42.19,2352300,2352368
7633,70,19,1,7.31,18.39,2352367,2352437
7634,76,18,1,6.74,13.01,2352436,2352512
7635,80,21,0,6.40,20.37,2352511,2352591
7636,86,22,0,5.95,18.53,2352590,2352676
7637,70,29,1,7.31,27.27,2352675,2352745
7638,81,42,1,6.32,31.40,2352744,2352825
7639,69,27,1,7.42,34.33,2352824,2352893
7640,71,33,0,7.21,30.70,2352892,2352963
7641,89,28,0,5.75,25.56,2352963,2353052
7642,106,19,0,4.83,15.27,2353051,2353157
7643,93,22,0,5.51,15.02,2353156,2353249
7644,97,22,0,5.28,15.93,2353248,2353345
7645,78,26,1,6.56,30.14,2353344,2353422
7646,80,24,0,6.40,21.84,2353421,2353501
7647,76,28,0,6.74,22.33,2353500,2353576
7648,74,36,0,6.92,39.34,2353575,2353649
7649,78,22,1,6.56,20.71,2353648,2353726
7650,73,21,1,7.01,19.00,2353725,2353798
7651,77,30,1,6.65,21.11,2353798,2353875
7652,66,29,1,7.76,24.61,2353875,2353941
7653,79,27,0,6.48,17.52,2353940,2354019
7654,80,29,0,6.40,25.82,2354018,2354098
7655,69,27,1,7.42,38.27,2354097,2354166
7656,67,32,2,7.64,25.60,2354165,2354232
7657,86,30,0,5.95,18.28,2354231,2354317
7658,54,51,0,9.48,84.92,2354316,2354370
7659,64,24,0,8.00,34.09,2354369,2354433
7660,73,38,1,7.01,37.79,2354432,2354505
7661,103,50,0,4.97,35.66,2354504,2354607
7662,90,69,0,5.69,62.08,2354606,2354696
7663,97,31,0,5.28,18.53,2354695,2354792
7664,95,22,1,5.39,17.14,2354791,2354886
7665,80,21,0,6.40,20.06,2354885,2354965
7666,66,33,0,7.76,25.61,2354965,2355031
7667,79,25,1,6.48,20.00,2355030,2355109
7668,76,20,1,6.74,14.75,2355108,2355184
7669,76,20,1,6.74,19.35,2355183,2355259
7670,70,34,0,7.31,37.19,2355258,2355328
7671,75,18,0,6.83,18.46,2355327,2355402
7672,78,40,0,6.56,32.48,2355401,2355479
7673,60,29,1,8.53,38.12,2355478,2355538
7674,70,51,0,7.31,75.82,2355537,2355607
7675,63,74,1,8.13,109.89,2355607,2355670
7676,82,20,0,6.24,21.04,2355669,2355751
7677,107,34,0,4.79,21.20,2355750,2355857
7678,93,26,0,5.51,19.84,2355856,2355949
7679,90,22,0,5.69,16.01,2355949,2356039
7680,93,29,0,5.51,19.37,2356038,2356131
7681,85,24,0,6.02,13.58,2356130,2356215
7682,77,24,0,6.65,26.70,2356214,2356291
7683,84,28,1,6.10,14.16,2356290,2356374
7684,74,27,0,6.92,22.07,2356374,2356448
7685,67,26,0,7.64,25.04,2356448,2356515
7686,88,33,0,5.82,18.60,2356514,2356602
7687,91,21,0,5.63,14.43,2356601,2356692
7688,62,66,1,8.26,73.80,2356691,2356753
7689,57,112,1,8.98,217.88,2356752,2356809
7690,72,51,0,7.11,53.27,2356808,2356880
7691,88,64,0,5.82,59.69,2356879,2356967
7692,99,25,0,5.17,17.39,2356966,2357065
7693,77,31,1,6.65,23.03,2357064,2357141
7694,101,19,1,5.07,15.21,2357140,2357241
7695,69,60,0,7.42,67.35,2357240,2357309
7696,80,21,0,6.40,15.69,2357308,2357388
7697,75,23,1,6.83,20.22,2357387,2357462
7698,76,18,1,6.74,11.64,2357461,2357537
7699,80,43,0,6.40,30.49,2357536,2357616
7700,82,21,0,6.24,15.92,2357615,2357697
7701,88,20,1,5.82,16.08,2357696,2357784
7702,67,21,0,7.64,24.95,2357783,2357850
7703,77,22,0,6.65,18.93,2357849,2357926
7704,62,47,2,8.26,46.61,2357925,2357987
7705,83,27,0,6.17,27.35,2357986,2358069
7706,93,16,0,5.51,14.44,2358068,2358161
7707,88,44,0,5.82,39.17,2358160,2358248
7708,83,28,1,6.17,20.79,2358248,2358331
7709,78,25,0,6.56,27.55,2358330,2358408
7710,89,19,0,5.75,13.71,2358407,2358496
7711,68,28,1,7.53,23.25,2358495,2358563
7712,64,26,1,8.00,27.03,2358562,2358626
7713,81,27,0,6.32,16.17,2358625,2358706
7714,74,37,0,6.92,33.51,2358706,2358780
7715,83,21,0,6.17,17.56,2358779,2358862
7716,73,25,1,7.01,19.36,2358861,2358934
7717,75,19,0,6.83,13.34,2358933,2359008
7718,79,22,1,6.48,15.29,2359007,2359086
7719,75,27,1,6.83,27.58,2359085,2359160
7720,89,27,0,5.75,21.78,2359159,2359248
7721,76,31,1,6.74,25.80,2359247,2359323
7722,82,23,0,6.24,24.14,2359322,2359404
7723,84,48,0,6.10,39.49,2359403,2359487
7724,96,44,0,5.33,34.24,2359486,2359582
7725,94,59,0,5.45,53.61,2359581,2359675
7726,93,26,0,5.51,18.25,2359674,2359767
7727,90,22,0,5.69,18.59,2359767,2359857
7728,81,26,1,6.32,17.72,2359856,2359937
7729,56,31,0,9.14,48.48,2359936,2359992
7730,61,29,1,8.39,37.19,2359991,2360052
7731,76,20,0,6.74,20.43,2360051,2360127
7732,69,47,0,7.42,36.07,2360127,2360196
7733,69,29,1,7.42,40.85,2360195,2360264
7734,68,39,1,7.53,34.81,2360263,2360331
7735,63,24,1,8.13,29.00,2360330,2360393
7736,66,32,2,7.76,31.52,2360393,2360459
7737,85,27,1,6.02,21.41,2360458,2360543
7738,63,82,1,8.13,113.95,2360542,2360605
7739,68,25,1,7.53,23.13,2360604,2360672
7740,74,42,0,6.92,68.53,2360671,2360745
7741,60,35,1,8.53,36.88,2360744,2360804
7742,72,28,0,7.11,29.60,2360803,2360875
7743,73,26,0,7.01,23.36,2360874,2360947
7744,100,28,0,5.12,20.33,2360946,2361046
7745,120,28,0,4.27,14.05,2361045,2361165
7746,99,22,1,5.17,16.22,2361164,2361263
7747,89,24,0,5.75,24.48,2361262,2361351
7748,79,22,0,6.48,22.25,2361350,2361429
7749,66,35,0,7.76,36.91,2361429,2361495
7750,67,22,1,7.64,24.98,2361494,2361561
7751,62,26,0,8.26,29.13,2361560,2361622
7752,81,19,1,6.32,13.13,2361621,2361702
7753,61,37,1,8.39,40.14,2361701,2361762
7754,56,42,2,9.14,65.91,2361762,2361818
7755,80,22,1,6.40,17.14,2361818,2361898
7756,70,23,1,7.31,29.62,2361897,2361967
7757,71,26,0,7.21,22.56,2361966,2362037
7758,85,43,0,6.02,31.69,2362036,2362121
7759,78,33,0,6.56,32.68,2362120,2362198
7760,100,25,0,5.12,19.33,2362197,2362297
7761,99,25,0,5.17,21.52,2362296,2362395
7762,89,19,0,5.75,15.17,2362394,2362483
7763,83,38,1,6.17,25.68,2362483,2362566
7764,75,20,1,6.83,14.94,2362565,2362640
7765,80,35,0,6.40,28.71,2362639,2362719
7766,92,19,0,5.57,10.62,2362718,2362810
7767,79,20,1,6.48,17.36,2362809,2362888
7768,65,60,0,7.88,82.45,2362888,2362953
7769,72,50,0,7.11,60.79,2362952,2363024
7770,87,28,1,5.89,16.54,2363023,2363110
7771,67,60,1,7.64,56.26,2363109,2363176
7772,83,15,0,6.17,11.06,2363176,2363259
7773,83,19,1,6.17,12.77,2363258,2363341
7774,99,21,0,5.17,13.74,2363340,2363439
7775,74,25,1,6.92,23.29,2363439,2363513
7776,83,23,1,6.17,18.57,2363512,2363595
7777,67,23,0,7.64,35.10,2363594,2363661
7778,92,44,0,5.57,34.16,2363660,2363752
7779,80,26,0,6.40,25.89,2363751,2363831
7780,91,17,0,5.63,17.44,2363830,2363921
7781,83,27,0,6.17,26.67,2363920,2364003
7782,84,26,0,6.10,21.61,2364002,2364086
7783,81,17,1,6.32,12.51,2364085,2364166
7784,71,37,1,7.21,30.73,2364165,2364236
7785,76,22,1,6.74,21.75,2364235,2364311
7786,77,25,1,6.65,19.42,2364310,2364387
7787,84,21,1,6.10,13.21,2364386,2364470
7788,79,34,0,6.48,24.12,2364469,2364548
7789,85,40,0,6.02,31.62,2364547,2364632
7790,86,38,0,5.95,22.90,2364631,2364717
7791,70,32,0,7.31,28.07,2364717,2364787
7792,77,22,1,6.65,17.73,2364786,2364863
7793,101,15,0,5.07,10.01,2364862,2364963
7794,76,24,1,6.74,19.09,2364962,2365038
7795,66,34,2,7.76,37.40,2365037,2365103
7796,77,43,0,6.65,44.75,2365102,2365179
7797,81,25,0,6.32,23.63,2365178,2365259
7798,94,16,0,5.45,11.25,2365259,2365353
7799,86,22,1,5.95,12.81,2365352,2365438
7800,96,25,0,5.33,15.58,2365437,2365533
7801,73,23,0,7.01,20.07,2365532,2365605
7802,68,24,0,7.53,28.22,2365604,2365672
7803,75,20,1,6.83,18.65,2365671,2365746
7804,74,32,1,6.92,24.05,2365745,2365819
7805,78,22,0,6.56,18.17,2365818,2365896
7806,66,40,1,7.76,41.34,2365895,2365961
7807,80,29,1,6.40,20.24,2365960,2366040
7808,76,51,0,6.74,48.01,2366039,2366115
7809,78,21,0,6.56,14.60,2366114,2366192
7810,83,16,1,6.17,11.25,2366191,2366274
7811,65,45,0,7.88,62.94,2366273,2366338
7812,64,29,0,8.00,33.84,2366337,2366401
7813,93,30,0,5.51,24.06,2366400,2366493
7814,94,29,0,5.45,15.89,2366492,2366586
7815,79,32,0,6.48,26.86,2366585,2366664
7816,77,38,2,6.65,21.42,2366663,2366740
7817,59,59,0,8.68,101.81,2366739,2366798
7818,68,25,0,7.53,26.69,2366797,2366865
7819,93,15,1,5.51,9.24,2366864,2366957
7820,73,18,1,7.01,17.52,2366956,2367029
7821,85,20,1,6.02,11.81,2367028,2367113
7822,78,20,0,6.56,19.48,2367112,2367190
7823,73,23,1,7.01,19.36,2367189,2367262
7824,58,49,1,8.83,92.38,2367261,2367319
7825,63,32,0,8.13,30.14,2367318,2367381
7826,80,31,1,6.40,25.06,2367380,2367460
7827,101,21,1,5.07,16.38,2367459,2367560
7828,68,37,1,7.53,31.31,2367559,2367627
7829,75,27,1,6.83,18.73,2367626,2367701
7830,63,31,1,8.13,35.79,2367700,2367763
7831,70,161,0,7.31,369.56,2367763,2367833
7832,90,26,0,5.69,22.75,2367832,2367922
7833,98,19,0,5.22,14.75,2367921,2368019
7834,89,21,1,5.75,11.56,2368018,2368107
7835,85,21,0,6.02,21.72,2368106,2368191
7836,78,25,0,6.56,17.17,2368190,2368268
7837,89,20,0,5.75,17.13,2368267,2368356
7838,83,16,0,6.17,13.08,2368356,2368439
7839,70,24,0,7.31,25.79,2368438,2368508
7840,69,40,1,7.42,44.91,2368507,2368576
7841,64,31,0,8.00,30.25,2368575,2368639
7842,68,18,1,7.53,17.78,2368639,2368707
7843,89,34,0,5.75,28.19,2368707,2368796
7844,57,51,1,8.98,58.23,2368795,2368852
7845,66,20,1,7.76,21.97,2368851,2368917
7846,95,18,0,5.39,10.57,2368916,2369011
7847,75,25,0,6.83,24.30,2369010,2369085
7848,80,46,0,6.40,35.82,2369085,2369165
7849,101,26,0,5.07,17.81,2369164,2369265
7850,83,50,1,6.17,47.56,2369264,2369347
7851,93,33,0,5.51,21.05,2369346,2369439
7852,100,23,0,5.12,19.01,2369438,2369538
7853,80,26,1,6.40,21.29,2369537,2369617
7854,73,27,1,7.01,24.56,2369616,2369689
7855,68,49,1,7.53,49.10,2369688,2369756
7856,81,23,0,6.32,22.24,2369755,2369836
7857,76,26,0,6.74,23.43,2369835,2369911
7858,68,25,0,7.53,20.84,2369910,2369978
7859,74,23,1,6.92,16.89,2369977,2370051
7860,73,20,0,7.01,20.70,2370051,2370124
7861,72,23,1,7.11,21.27,2370123,2370195
7862,84,38,1,6.10,31.97,2370195,2370279
7863,67,30,1,7.64,33.75,2370279,2370346
7864,67,47,0,7.64,60.20,2370345,2370412
7865,66,23,0,7.76,25.52,2370411,2370477
7866,83,20,0,6.17,14.48,2370476,2370559
7867,85,42,0,6.02,28.92,2370558,2370643
7868,85,29,0,6.02,31.46,2370642,2370727
7869,107,23,0,4.79,19.44,2370726,2370833
7870,95,17,1,5.39,10.81,2370832,2370927
7871,99,22,0,5.17,11.33,2370926,2371025
7872,68,28,1,7.53,34.72,2371024,2371092
7873,79,20,1,6.48,19.24,2371091,2371170
7874,71,24,1,7.21,17.77,2371169,2371240
7875,78,19,1,6.56,15.71,2371239,2371317
7876,76,23,1,6.74,24.33,2371317,2371393
7877,78,28,1,6.56,15.94,2371392,2371470
7878,74,21,1,6.92,18.51,2371469,2371543
7879,65,30,1,7.88,27.95,2371542,2371607
7880,73,43,1,7.01,32.84,2371606,2371679
7881,83,22,0,6.17,21.66,2371678,2371761
7882,68,34,1,7.53,36.16,2371760,2371828
7883,82,26,0,6.24,16.31,2371827,2371909
7884,69,24,0,7.42,27.81,2371908,2371977
7885,87,24,0,5.89,22.98,2371976,2372063
7886,98,32,0,5.22,24.46,2372062,2372160
7887,99,31,0,5.17,23.17,2372159,2372258
7888,95,49,1,5.39,32.85,2372258,2372353
7889,95,45,0,5.39,32.60,2372352,2372447
7890,80,23,1,6.40,26.94,2372446,2372526
7891,79,27,0,6.48,24.35,2372525,2372604
7892,73,30,0,7.01,23.27,2372603,2372676
7893,74,32,1,6.92,28.13,2372676,2372750
7894,76,24,1,6.74,22.56,2372749,2372825
7895,66,33,1,7.76,37.27,2372824,2372890
7896,70,23,2,7.31,21.50,2372890,2372960
7897,71,19,0,7.21,20.14,2372959,2373030
7898,71,29,0,7.21,20.50,2373029,2373100
7899,79,22,0,6.48,18.33,2373099,2373178
7900,67,20,1,7.64,21.04,2373177,2373244
7901,64,47,1,8.00,46.47,2373244,2373308
7902,93,25,0,5.51,20.40,2373307,2373400
7903,81,36,0,6.32,30.91,2373400,2373481
7904,73,29,1,7.01,38.40,2373481,2373554
7905,97,19,0,5.28,16.80,2373554,2373651
7906,91,29,0,5.63,24.28,2373650,2373741
7907,69,50,1,7.42,49.72,2373740,2373809
7908,103,22,0,4.97,10.90,2373808,2373911
7909,80,38,0,6.40,32.59,2373910,2373990
7910,81,25,1,6.32,20.22,2373989,2374070
7911,75,32,1,6.83,29.00,2374069,2374144
7912,92,23,0,5.57,11.18,2374143,2374235
7913,72,25,1,7.11,25.60,2374234,2374306
7914,64,27,0,8.00,29.22,2374306,2374370
7915,77,27,1,6.65,20.88,2374369,2374446
7916,62,28,0,8.26,31.77,2374445,2374507
7917,69,32,1,7.42,33.03,2374506,2374575
7918,95,19,1,5.39,12.76,2374575,2374670
7919,83,21,0,6.17,19.73,2374669,2374752
7920,78,42,0,6.56,37.89,2374751,2374829
7921,65,38,0,7.88,47.65,2374829,2374894
7922,83,34,0,6.17,28.21,2374893,2374976
7923,97,19,0,5.28,12.28,2374976,2375073
7924,81,59,0,6.32,87.63,2375072,2375153
7925,93,32,0,5.51,28.62,2375152,2375245
7926,95,18,0,5.39,11.96,2375244,2375339
7927,83,20,0,6.17,18.98,2375338,2375421
7928,82,26,0,6.24,22.77,2375420,2375502
7929,69,30,0,7.42,32.21,2375501,2375570
7930,61,34,1,8.39,32.63,2375569,2375630
7931,73,22,1,7.01,19.19,2375629,2375702
7932,67,28,1,7.64,23.48,2375701,2375768
7933,74,23,1,6.92,25.34,2375767,2375841
7934,67,21,1,7.64,20.29,2375840,2375907
7935,47,68,1,10.89,146.01,2375906,2375953
7936,74,47,0,6.92,43.45,2375953,2376027
7937,85,21,0,6.02,21.39,2376026,2376111
7938,60,28,0,8.53,34.12,2376110,2376170
7939,62,26,0,8.26,33.71,2376169,2376231
7940,67,39,0,7.64,44.23,2376230,2376297
7941,73,22,1,7.01,19.27,2376296,2376369
7942,75,38,0,6.83,42.62,2376369,2376444
7943,71,34,0,7.21,44.96,2376443,2376514
7944,88,48,0,5.82,62.94,2376513,2376601
7945,93,66,0,5.51,60.40,2376600,2376693
7946,79,21,0,6.48,19.44,2376693,2376772
7947,102,20,0,5.02,14.04,2376771,2376873
7948,78,22,0,6.56,18.94,2376872,2376950
7949,76,23,0,6.74,13.56,2376949,2377025
7950,61,59,2,8.39,74.63,2377024,2377085
7951,83,21,0,6.17,20.26,2377084,2377167
7952,72,48,1,7.11,35.65,2377166,2377238
7953,63,44,1,8.13,49.29,2377237,2377300
7954,58,34,1,8.83,44.76,2377299,2377357
7955,54,45,1,9.48,63.25,2377356,2377410
7956,79,29,1,6.48,21.54,2377409,2377488
7957,87,22,0,5.89,15.14,2377487,2377574
7958,71,36,0,7.21,34.81,2377573,2377644
7959,66,28,1,7.76,29.82,2377643,2377709
7960,84,48,1,6.10,40.40,2377709,2377793
7961,74,34,0,6.92,34.78,2377792,2377866
7962,87,27,0,5.89,26.58,2377865,2377952
7963,98,37,0,5.22,31.26,2377951,2378049
7964,95,19,0,5.39,18.32,2378048,2378143
7965,82,53,1,6.24,43.40,2378142,2378224
7966,96,40,1,5.33,26.60,2378223,2378319
7967,73,29,1,7.01,20.23,2378318,2378391
7968,76,23,0,6.74,18.72,2378391,2378467
7969,73,23,1,7.01,19.25,2378466,2378539
7970,82,23,0,6.24,16.04,2378538,2378620
7971,68,18,1,7.53,14.96,2378620,2378688
7972,80,23,0,6.40,15.96,2378687,2378767
7973,79,22,0,6.48,21.21,2378766,2378845
7974,75,47,1,6.83,35.13,2378844,2378919
7975,72,28,1,7.11,19.99,2378918,2378990
7976,82,26,1,6.24,21.01,2378989,2379071
7977,65,31,1,7.88,32.48,2379070,2379135
7978,76,28,0,6.74,28.64,2379134,2379210
7979,76,19,0,6.74,20.80,2379209,2379285
7980,78,29,0,6.56,29.60,2379284,2379362
7981,97,22,0,5.28,15.07,2379361,2379458
7982,98,23,0,5.22,18.40,2379457,2379555
7983,114,20,0,4.49,16.06,2379554,2379668
7984,90,26,0,5.69,22.95,2379668,2379758
7985,90,36,0,5.69,29.66,2379757,2379847
7986,73,26,1,7.01,22.12,2379846,2379919
7987,77,17,0,6.65,13.68,2379918,2379995
7988,65,25,1,7.88,28.94,2379994,2380059
7989,79,21,2,6.48,18.86,2380058,2380137
7990,67,23,0,7.64,28.02,2380136,2380203
7991,79,20,1,6.48,16.05,2380202,2380281
7992,64,37,1,8.00,37.34,2380280,2380344
7993,84,20,1,6.10,14.13,2380343,2380427
7994,72,27,1,7.11,27.82,2380426,2380498
7995,82,24,1,6.24,20.87,2380497,2380579
7996,71,25,2,7.21,23.72,2380578,2380649
7997,72,29,0,7.11,35.96,2380648,2380720
7998,60,43,1,8.53,53.95,2380719,2380779
7999,79,25,0,6.48,25.49,2380778,2380857
8000,83,35,0,6.17,33.54,2380856,2380939
8001,96,17,0,5.33,16.33,2380938,2381034
8002,95,23,0,5.39,19.31,2381034,2381129
8003,90,29,0,5.69,23.01,2381128,2381218
8004,84,35,1,6.10,28.01,2381217,2381301
8005,80,27,0,6.40,23.39,2381300,2381380
8006,71,29,0,7.21,22.42,2381379,2381450
8007,72,30,1,7.11,22.10,2381449,2381521
8008,62,22,1,8.26,23.32,2381520,2381582
8009,79,31,0,6.48,29.03,2381581,2381660
8010,70,29,0,7.31,23.10,2381659,2381729
8011,64,44,1,8.00,35.38,2381728,2381792
8012,65,37,2,7.88,38.60,2381791,2381856
8013,77,36,1,6.65,39.73,2381855,2381932
8014,81,22,0,6.32,21.01,2381931,2382012
8015,74,43,1,6.92,33.70,2382011,2382085
8016,81,24,0,6.32,28.69,2382085,2382166
8017,65,30,0,7.88,36.97,2382165,2382230
8018,70,24,0,7.31,29.99,2382229,2382299
8019,72,51,0,7.11,65.04,2382298,2382370
8020,110,13,0,4.65,8.52,2382369,2382479
8021,85,20,1,6.02,21.74,2382478,2382563
8022,82,40,1,6.24,32.77,2382562,2382644
8023,89,30,0,5.75,25.65,2382643,2382732
8024,73,34,0,7.01,26.12,2382731,2382804
8025,77,29,0,6.65,26.85,2382803,2382880
8026,75,23,1,6.83,18.12,2382879,2382954
8027,75,22,1,6.83,19.13,2382953,2383028
8028,46,43,1,11.13,87.77,2383028,2383074
8029,79,20,1,6.48,15.09,2383073,2383152
8030,73,23,0,7.01,25.60,2383151,2383224
8031,72,23,1,7.11,17.96,2383223,2383295
8032,73,20,1,7.01,24.64,2383294,2383367
8033,67,36,1,7.64,35.99,2383366,2383433
8034,80,39,0,6.40,29.34,2383432,2383512
8035,70,29,1,7.31,28.90,2383511,2383581
8036,81,18,1,6.32,18.54,2383580,2383661
8037,74,36,0,6.92,49.72,2383661,2383735
8038,99,24,0,5.17,21.62,2383734,2383833
8039,89,28,0,5.75,21.92,2383832,2383921
8040,94,20,0,5.45,12.97,2383920,2384014
8041,100,24,0,5.12,14.85,2384014,2384114
8042,78,21,1,6.56,19.45,2384113,2384191
8043,97,17,0,5.28,12.16,2384190,2384287
8044,74,22,1,6.92,21.64,2384286,2384360
8045,72,27,1,7.11,24.27,2384359,2384431
8046,67,32,0,7.64,31.36,2384430,2384497
8047,69,41,1,7.42,33.17,2384496,2384565
8048,83,18,1,6.17,12.62,2384564,2384647
8049,70,30,0,7.31,25.33,2384646,2384716
8050,71,21,1,7.21,22.84,2384715,2384786
8051,90,27,0,5.69,17.21,2384785,2384875
8052,71,24,0,7.21,21.49,2384874,2384945
8053,77,26,0,6.65,31.06,2384945,2385022
8054,69,22,0,7.42,20.53,2385022,2385091
8055,74,34,0,6.92,37.48,2385090,2385164
8056,100,27,0,5.12,22.13,2385163,2385263
8057,87,51,0,5.89,45.87,2385262,2385349
8058,80,31,1,6.40,21.86,2385348,2385428
8059,89,30,0,5.75,18.55,2385427,2385516
8060,84,37,1,6.10,25.56,2385515,2385599
8061,65,24,1,7.88,27.65,2385598,2385663
8062,71,27,1,7.21,23.52,2385662,2385733
8063,69,36,1,7.42,39.06,2385733,2385802
8064,74,37,0,6.92,28.05,2385801,2385875
8065,77,18,0,6.65,14.62,2385874,2385951
8066,59,23,2,8.68,24.73,2385950,2386009
8067,70,24,0,7.31,17.82,2386008,2386078
8068,69,35,1,7.42,51.58,2386077,2386146
8069,78,30,1,6.56,19.53,2386145,2386223
8070,66,25,1,7.76,20.61,2386222,2386288
8071,63,72,0,8.13,101.73,2386287,2386350
8072,75,28,0,6.83,32.97,2386349,2386424
8073,86,42,0,5.95,42.37,2386423,2386509
8074,82,53,0,6.24,70.84,2386509,2386591
8075,91,44,0,5.63,40.30,2386591,2386682
8076,77,32,1,6.65,32.72,2386681,2386758
8077,96,20,1,5.33,14.12,2386757,2386853
8078,86,23,0,5.95,16.97,2386852,2386938
8079,70,21,1,7.31,21.70,2386937,2387007
8080,58,28,2,8.83,33.04,2387006,2387064
8081,78,20,0,6.56,18.40,2387063,2387141
8082,73,28,2,7.01,23.68,2387140,2387213
8083,68,23,1,7.53,16.60,2387212,2387280
8084,65,23,2,7.88,18.48,2387279,2387344
8085,78,25,1,6.56,22.32,2387343,2387421
8086,80,24,0,6.40,22.06,2387420,2387500
8087,74,21,1,6.92,15.26,2387499,2387573
8088,82,23,0,6.24,22.92,2387572,2387654
8089,63,51,1,8.13,50.97,2387653,2387716
8090,76,31,0,6.74,33.96,2387715,2387791
8091,80,39,0,6.40,44.69,2387790,2387870
8092,93,36,0,5.51,31.91,2387869,2387962
8093,85,29,1,6.02,19.06,2387962,2388047
8094,99,20,0,5.17,12.32,2388046,2388145
8095,71,28,1,7.21,30.31,2388144,2388215
8096,75,22,0,6.83,20.04,2388214,2388289
8097,81,22,1,6.32,20.19,2388288,2388369
8098,69,23,0,7.42,27.75,2388368,2388437
8099,64,32,0,8.00,35.41,2388436,2388500
8100,73,22,0,7.01,19.85,2388499,2388572
8101,78,34,1,6.56,26.71,2388571,2388649
8102,76,33,0,6.74,23.98,2388648,2388724
8103,82,27,0,6.24,24.57,2388723,2388805
8104,65,91,0,7.88,129.25,2388804,2388869
8105,79,31,0,6.48,29.84,2388868,2388947
8106,105,24,0,4.88,18.15,2388946,2389051
8107,106,30,0,4.83,19.39,2389051,2389157
8108,80,26,1,6.40,27.57,2389156,2389236
8109,66,59,1,7.76,85.12,2389236,2389302
8110,74,38,0,6.92,28.48,2389302,2389376
8111,73,25,1,7.01,24.45,2389375,2389448
8112,73,17,1,7.01,14.56,2389448,2389521
8113,73,23,0,7.01,18.10,2389520,2389593
8114,66,41,0,7.76,43.88,2389593,2389659
8115,68,70,1,7.53,71.01,2389659,2389727
8116,75,30,1,6.83,25.00,2389726,2389801
8117,81,22,0,6.32,27.18,2389800,2389881
8118,73,25,1,7.01,17.08,2389880,2389953
8119,81,36,1,6.32,25.25,2389953,2390034
8120,62,51,1,8.26,81.84,2390033,2390095
8121,55,26,0,9.31,42.58,2390094,2390149
8122,81,20,1,6.32,19.21,2390148,2390229
8123,99,26,0,5.17,23.50,2390228,2390327
8124,63,30,0,8.13,45.03,2390326,2390389
8125,84,25,0,6.10,23.35,2390388,2390472
8126,82,21,1,6.24,15.40,2390471,2390553
8127,76,47,1,6.74,43.67,2390552,2390628
8128,56,47,0,9.14,70.12,2390627,2390683
8129,75,22,1,6.83,16.28,2390682,2390757
8130,76,36,1,6.74,39.38,2390756,2390832
8131,74,22,1,6.92,18.21,2390831,2390905
8132,83,19,1,6.17,16.26,2390904,2390987
8133,66,24,1,7.76,27.49,2390986,2391052
8134,77,18,1,6.65,13.27,2391051,2391128
8135,82,24,1,6.24,18.79,2391128,2391210
8136,59,46,2,8.68,44.96,2391209,2391268
8137,74,61,0,6.92,61.40,2391267,2391341
8138,57,57,1,8.98,98.96,2391340,2391397
8139,90,21,0,5.69,21.04,2391396,2391486
8140,115,21,0,4.45,17.73,2391485,2391600
8141,73,70,0,7.01,73.60,2391599,2391672
8142,101,20,1,5.07,11.41,2391671,2391772
8143,78,34,1,6.56,23.96,2391771,2391849
8144,81,37,1,6.32,36.42,2391848,2391929
8145,81,21,1,6.32,18.42,2391928,2392009
8146,78,20,1,6.56,17.53,2392008,2392086
8147,92,20,0,5.57,13.01,2392085,2392177
8148,77,27,1,6.65,26.36,2392176,2392253
8149,69,30,1,7.42,27.40,2392252,2392321
8150,71,28,1,7.21,25.29,2392320,2392391
8151,84,24,1,6.10,25.23,2392390,2392474
8152,66,33,1,7.76,27.58,2392473,2392539
8153,82,32,1,6.24,27.01,2392538,2392620
8154,51,51,1,10.04,111.37,2392619,2392670
8155,63,111,0,8.13,194.08,2392669,2392732
8156,76,50,0,6.74,53.43,2392731,2392807
8157,98,24,0,5.22,21.56,2392806,2392904
8158,90,40,0,5.69,45.15,2392903,2392993
8159,85,67,1,6.02,53.98,2392992,2393077
8160,88,23,0,5.82,15.94,2393076,2393164
8161,77,26,0,6.65,24.49,2393163,2393240
8162,75,19,0,6.83,16.22,2393239,2393314
8163,81,21,1,6.32,15.45,2393313,2393394
8164,69,23,1,7.42,20.30,2393393,2393462
8165,71,35,1,7.21,25.58,2393461,2393532
8166,62,60,2,8.26,61.22,2393531,2393593
8167,63,25,1,8.13,25.54,2393592,2393655
8168,92,22,0,5.57,18.59,2393654,2393746
8169,72,49,0,7.11,38.79,2393745,2393817
8170,67,24,0,7.64,27.19,2393816,2393883
8171,80,26,0,6.40,24.91,2393882,2393962
8172,70,39,0,7.31,36.24,2393962,2394032
8173,81,27,0,6.32,27.40,2394031,2394112
8174,105,24,0,4.88,18.30,2394111,2394216
8175,77,49,0,6.65,68.02,2394215,2394292
8176,78,34,1,6.56,25.40,2394291,2394369
8177,98,21,0,5.22,12.30,2394368,2394466
8178,69,25,1,7.42,29.92,2394465,2394534
8179,75,22,1,6.83,21.53,2394533,2394608
8180,60,31,0,8.53,46.52,2394607,2394667
8181,68,38,1,7.53,36.37,2394666,2394734
8182,73,44,1,7.01,35.90,2394733,2394806
8183,57,44,1,8.98,54.58,2394805,2394862
8184,65,20,1,7.88,22.08,2394861,2394926
8185,62,26,0,8.26,26.26,2394925,2394987
8186,74,32,0,6.92,28.45,2394986,2395060
8187,91,27,0,5.63,26.45,2395059,2395150
8188,78,36,1,6.56,38.14,2395149,2395227
8189,96,18,0,5.33,13.12,2395226,2395322
8190,106,22,0,4.83,17.16,2395322,2395428
8191,91,29,0,5.63,23.53,2395427,2395518
8192,77,33,1,6.65,26.44,2395517,2395594
8193,81,16,1,6.32,10.79,2395593,2395674
8194,74,27,0,6.92,28.02,2395673,2395747
8195,79,21,0,6.48,14.53,2395746,2395825
8196,74,19,1,6.92,19.91,2395824,2395898
8197,70,26,1,7.31,22.39,2395897,2395967
8198,75,23,1,6.83,16.38,2395966,2396041
8199,90,25,0,5.69,16.90,2396041,2396131
8200,67,42,1,7.64,34.44,2396130,2396197
8201,63,43,1,8.13,55.35,2396196,2396259
8202,77,31,0,6.65,29.03,2396258,2396335
8203,56,78,0,9.14,139.55,2396334,2396390
8204,78,17,0,6.56,20.48,2396390,2396468
8205,87,68,0,5.89,65.96,2396467,2396554
8206,96,18,0,5.33,12.58,2396553,2396649
8207,66,70,1,7.76,101.15,2396648,2396714
8208,89,28,0,5.75,22.19,2396713,2396802
8209,68,21,1,7.53,21.34,2396801,2396869
8210,78,22,0,6.56,19.96,2396868,2396946
8211,73,18,1,7.01,12.95,2396945,2397018
8212,91,18,0,5.63,13.31,2397017,2397108
8213,81,28,0,6.32,23.45,2397107,2397188
8214,78,22,0,6.56,16.89,2397187,2397265
8215,78,34,1,6.56,25.99,2397264,2397342
8216,77,31,0,6.65,25.01,2397341,2397418
8217,77,23,1,6.65,20.93,2397417,2397494
8218,69,25,1,7.42,20.94,2397493,2397562
8219,81,26,0,6.32,24.88,2397561,2397642
8220,91,21,0,5.63,18.96,2397641,2397732
8221,108,21,0,4.74,16.88,2397731,2397839
8222,96,19,0,5.33,15.35,2397838,2397934
8223,57,42,2,8.98,70.68,2397933,2397990
8224,90,37,0,5.69,27.79,2397989,2398079
8225,92,36,0,5.57,24.62,2398078,2398170
8226,84,21,0,6.10,17.32,2398169,2398253
8227,86,16,1,5.95,10.25,2398252,2398338
8228,80,34,0,6.40,25.92,2398337,2398417
8229,64,23,0,8.00,24.53,2398416,2398480
8230,62,73,1,8.26,90.74,2398479,2398541
8231,61,31,1,8.39,32.11,2398540,2398601
8232,73,23,2,7.01,17.19,2398600,2398673
8233,78,30,0,6.56,22.35,2398672,2398750
8234,87,23,0,5.89,16.54,2398749,2398836
8235,53,35,1,9.66,69.09,2398835,2398888
8236,64,45,1,8.00,62.69,2398887,2398951
8237,65,32,0,7.88,38.38,2398950,2399015
8238,62,37,1,8.26,56.61,2399014,2399076
8239,82,26,0,6.24,25.45,2399075,2399157
8240,109,18,0,4.70,13.79,2399156,2399265
8241,88,42,0,5.82,27.67,2399264,2399352
8242,112,16,0,4.57,11.17,2399351,2399463
8243,90,16,1,5.69,10.04,2399462,2399552
8244,79,20,1,6.48,17.03,2399552,2399631
8245,86,25,1,5.95,19.56,2399630,2399716
8246,70,42,0,7.31,36.39,2399715,2399785
8247,69,32,1,7.42,37.26,2399784,2399853
8248,76,22,1,6.74,18.67,2399852,2399928
8249,70,40,1,7.31,46.36,2399928,2399998
8250,84,39,1,6.10,26.68,2399997,2400081
8251,83,31,1,6.17,19.90,2400081,2400164
8252,69,32,0,7.42,55.66,2400163,2400232
8253,72,24,0,7.11,21.79,2400231,2400303
8254,68,42,0,7.53,42.43,2400302,2400370
8255,66,48,0,7.76,54.30,2400369,2400435
8256,91,22,0,5.63,25.31,2400435,2400526
8257,73,59,0,7.01,64.10,2400526,2400599
8258,89,27,1,5.75,22.55,2400598,2400687
8259,76,29,1,6.74,29.38,2400686,2400762
8260,68,27,0,7.53,28.98,2400761,2400829
8261,58,38,1,8.83,52.35,2400828,2400886
8262,66,18,0,7.76,14.67,2400885,2400951
8263,79,18,0,6.48,18.17,2400950,2401029
8264,72,41,1,7.11,32.24,2401028,2401100
8265,65,23,0,7.88,30.82,2401099,2401164
8266,70,22,1,7.31,18.53,2401163,2401233
8267,66,32,0,7.76,35.49,2401232,2401298
8268,72,19,1,7.11,13.99,2401298,2401370
8269,79,27,1,6.48,20.48,2401369,2401448
8270,84,28,0,6.10,24.71,2401447,2401531
8271,71,28,1,7.21,30.90,2401530,2401601
8272,62,34,0,8.26,48.97,2401600,2401662
8273,78,38,0,6.56,35.45,2401661,2401739
8274,93,31,0,5.51,26.10,2401738,2401831
8275,106,20,0,4.83,12.73,2401830,2401936
8276,95,31,0,5.39,21.71,2401935,2402030
8277,93,21,0,5.51,17.95,2402029,2402122
8278,81,19,0,6.32,13.67,2402121,2402202
8279,82,22,0,6.24,17.87,2402202,2402284
8280,72,44,1,7.11,38.99,2402283,2402355
8281,70,33,0,7.31,34.36,2402354,2402424
8282,69,24,1,7.42,25.98,2402424,2402493
8283,66,20,1,7.76,23.15,2402493,2402559
8284,92,22,0,5.57,15.72,2402558,2402650
8285,72,22,1,7.11,19.77,2402649,2402721
8286,70,29,1,7.31,34.22,2402720,2402790
8287,77,39,0,6.65,33.08,2402789,2402866
8288,60,43,1,8.53,48.75,2402865,2402925
8289,81,35,0,6.32,40.17,2402924,2403005
8290,82,43,0,6.24,44.09,2403005,2403087
8291,83,34,0,6.17,32.26,2403087,2403170
8292,101,38,0,5.07,29.13,2403169,2403270
8293,87,29,0,5.89,31.73,2403269,2403356
8294,63,23,1,8.13,26.68,2403355,2403418
8295,83,24,1,6.17,22.84,2403417,2403500
8296,77,22,1,6.65,14.23,2403499,2403576
8297,87,24,0,5.89,14.72,2403575,2403662
8298,73,23,0,7.01,24.95,2403661,2403734
8299,72,24,0,7.11,22.02,2403733,2403805
8300,80,18,1,6.40,12.06,2403805,2403885
8301,66,21,2,7.76,17.15,2403884,2403950
8302,71,26,1,7.21,21.49,2403949,2404020
8303,79,20,1,6.48,16.15,2404019,2404098
8304,90,22,0,5.69,21.97,2404097,2404187
8305,84,24,1,6.10,21.06,2404186,2404270
8306,80,24,0,6.40,23.34,2404269,2404349
8307,89,28,0,5.75,35.13,2404348,2404437
8308,85,26,0,6.02,19.65,2404437,2404522
8309,96,42,1,5.33,24.43,2404522,2404618
8310,94,17,1,5.45,12.01,2404618,2404712
8311,80,19,0,6.40,15.76,2404711,2404791
8312,63,45,1,8.13,41.98,2404790,2404853
8313,90,15,0,5.69,10.01,2404852,2404942
8314,79,30,1,6.48,20.27,2404941,2405020
8315,61,25,1,8.39,26.66,2405019,2405080
8316,70,40,0,7.31,34.02,2405079,2405149
8317,69,24,1,7.42,22.01,2405148,2405217
8318,73,53,1,7.01,46.75,2405216,2405289
8319,79,36,0,6.48,31.97,2405288,2405367
8320,60,33,2,8.53,29.52,2405366,2405426
8321,49,160,1,10.45,503.96,2405425,2405474
8322,73,26,1,7.01,28.04,2405473,2405546
8323,76,76,0,6.74,84.46,2405545,2405621
8324,95,21,0,5.39,18.70,2405620,2405715
8325,91,27,0,5.63,30.21,2405714,2405805
8326,82,33,0,6.24,26.70,2405804,2405886
8327,86,26,0,5.95,21.56,2405885,2405971
8328,74,53,0,6.92,52.53,2405970,2406044
8329,79,25,0,6.48,24.05,2406043,2406122
8330,64,62,1,8.00,63.41,2406121,2406185
8331,76,30,1,6.74,27.48,2406184,2406260
8332,70,32,1,7.31,27.87,2406259,2406329
8333,71,39,0,7.21,32.70,2406329,2406400
8334,68,40,1,7.53,36.22,2406399,2406467
8335,76,23,0,6.74,22.22,2406466,2406542
8336,62,22,1,8.26,29.74,2406541,2406603
8337,87,20,0,5.89,20.35,2406602,2406689
8338,69,36,0,7.42,40.74,2406689,2406758
8339,90,25,0,5.69,21.01,2406757,2406847
8340,104,34,0,4.92,22.11,2406846,2406950
8341,95,28,1,5.39,15.40,2406950,2407045
8342,83,51,0,6.17,46.02,2407044,2407127
8343,90,23,0,5.69,14.41,2407126,2407216
8344,70,20,0,7.31,19.96,2407215,2407285
8345,83,18,1,6.17,13.59,2407284,2407367
8346,63,46,1,8.13,40.40,2407366,2407429
8347,86,21,0,5.95,17.74,2407428,2407514
8348,63,31,1,8.13,26.87,2407513,2407576
8349,76,35,0,6.74,24.61,2407575,2407651
8350,79,35,0,6.48,30.96,2407650,2407729
8351,55,33,0,9.31,44.61,2407728,2407783
8352,87,19,0,5.89,13.37,2407782,2407869
8353,64,26,1,8.00,27.47,2407868,2407932
8354,69,45,0,7.42,43.14,2407931,2408000
8355,73,40,1,7.01,42.26,2407999,2408072
8356,97,21,0,5.28,19.95,2408071,2408168
8357,94,26,0,5.45,22.57,2408167,2408261
8358,85,49,0,6.02,35.03,2408260,2408345
8359,88,21,0,5.82,12.99,2408345,2408433
8360,83,21,0,6.17,15.39,2408432,2408515
8361,76,17,0,6.74,13.11,2408514,2408590
8362,71,33,1,7.21,29.35,2408590,2408661
8363,79,20,1,6.48,16.91,2408660,2408739
8364,70,50,0,7.31,52.73,2408738,2408808
8365,75,22,1,6.83,15.82,2408807,2408882
8366,63,28,1,8.13,24.33,2408881,2408944
8367,85,17,1,6.02,13.58,2408944,2409029
8368,74,22,1,6.92,19.94,2409029,2409103
8369,69,29,1,7.42,28.71,2409102,2409171
8370,67,31,1,7.64,31.69,2409171,2409238
8371,91,25,0,5.63,16.63,2409238,2409329
8372,89,52,0,5.75,46.16,2409328,2409417
8373,101,48,0,5.07,29.21,2409416,2409517
8374,87,25,1,5.89,16.01,2409516,2409603
8375,112,18,0,4.57,12.24,2409602,2409714
8376,84,20,0,6.10,18.32,2409713,2409797
8377,68,29,0,7.53,29.25,2409796,2409864
8378,70,30,0,7.31,28.42,2409863,2409933
8379,81,32,1,6.32,22.42,2409932,2410013
8380,78,22,0,6.56,22.45,2410013,2410091
8381,65,39,2,7.88,33.12,2410091,2410156
8382,67,52,1,7.64,52.47,2410155,2410222
8383,62,42,0,8.26,43.80,2410221,2410283
8384,76,22,0,6.74,29.43,2410282,2410358
8385,78,21,1,6.56,13.99,2410357,2410435
8386,81,46,0,6.32,34.00,2410435,2410516
8387,61,52,0,8.39,62.24,2410515,2410576
8388,100,24,0,5.12,15.43,2410575,2410675
8389,105,25,0,4.88,19.75,2410674,2410779
8390,108,18,0,4.74,15.53,2410778,2410886
8391,106,26,0,4.83,12.57,2410886,2410992
8392,96,16,1,5.33,9.93,2410991,2411087
8393,69,19,1,7.42,20.74,2411086,2411155
8394,64,51,1,8.00,50.62,2411154,2411218
8395,79,21,1,6.48,16.71,2411218,2411297
8396,69,26,1,7.42,23.90,2411296,2411365
8397,73,27,0,7.01,32.48,2411364,2411437
8398,83,17,1,6.17,12.98,2411436,2411519
8399,73,25,1,7.01,25.71,2411518,2411591
8400,84,23,1,6.10,19.44,2411591,2411675
8401,90,20,1,5.69,16.06,2411674,2411764
8402,80,24,0,6.40,24.44,2411763,2411843
8403,73,23,0,7.01,23.74,2411842,2411915
8404,88,16,0,5.82,18.29,2411914,2412002
8405,84,43,0,6.10,43.04,2412001,2412085
8406,100,23,0,5.12,20.17,2412084,2412184
8407,100,20,0,5.12,15.51,2412183,2412283
8408,93,19,0,5.51,18.14,2412282,2412375
8409,65,22,0,7.88,27.00,2412374,2412439
8410,79,27,1,6.48,18.68,2412438,2412517
8411,85,22,1,6.02,14.73,2412516,2412601
8412,76,28,0,6.74,26.77,2412600,2412676
8413,49,95,1,10.45,179.59,2412675,2412724
8414,65,56,0,7.88,53.00,2412723,2412788
8415,84,15,0,6.10,14.68,2412788,2412872
8416,74,22,0,6.92,24.07,2412871,2412945
8417,80,42,1,6.40,28.01,2412944,2413024
8418,76,20,0,6.74,22.93,2413023,2413099
8419,82,38,0,6.24,42.16,2413098,2413180
8420,89,26,1,5.75,17.33,2413179,2413268
8421,93,19,0,5.51,16.01,2413267,2413360
8422,87,19,1,5.89,13.02,2413359,2413446
8423,68,34,0,7.53,32.98,2413445,2413513
8424,70,20,1,7.31,22.62,2413512,2413582
8425,68,32,1,7.53,29.69,2413581,2413649
8426,67,51,1,7.64,41.96,2413648,2413715
8427,69,40,1,7.42,34.10,2413714,2413783
8428,65,27,2,7.88,24.08,2413782,2413847
8429,72,23,0,7.11,26.07,2413846,2413918
8430,87,24,0,5.89,18.38,2413917,2414004
8431,65,32,0,7.88,40.42,2414003,2414068
8432,63,33,1,8.13,44.90,2414067,2414130
8433,70,33,1,7.31,38.33,2414130,2414200
8434,67,24,0,7.64,27.42,2414199,2414266
8435,78,36,0,6.56,35.35,2414265,2414343
8436,105,52,0,4.88,32.55,2414342,2414447
8437,95,29,0,5.39,24.76,2414446,2414541
8438,84,49,0,6.10,37.04,2414540,2414624
8439,92,22,0,5.57,15.44,2414623,2414715
8440,78,25,0,6.56,27.89,2414714,2414792
8441,56,67,1,9.14,87.55,2414791,2414847
8442,73,32,0,7.01,21.19,2414846,2414919
8443,69,30,0,7.42,32.04,2414919,2414988
8444,67,26,1,7.64,25.72,2414987,2415054
8445,76,19,1,6.74,14.80,2415053,2415129
8446,63,25,1,8.13,29.48,2415128,2415191
8447,60,30,1,8.53,38.95,2415190,2415250
8448,88,24,0,5.82,16.85,2415249,2415337
8449,61,32,1,8.39,30.57,2415336,2415397
8450,80,26,0,6.40,28.32,2415396,2415476
8451,69,36,0,7.42,41.66,2415475,2415544
8452,68,38,0,7.53,37.16,2415543,2415611
8453,71,36,1,7.21,37.72,2415610,2415681
8454,75,71,0,6.83,79.13,2415680,2415755
8455,75,79,0,6.83,99.18,2415754,2415829
8456,90,31,1,5.69,21.21,2415828,2415918
8457,91,31,0,5.63,22.98,2415917,2416008
8458,80,21,0,6.40,16.26,2416007,2416087
8459,70,29,1,7.31,30.93,2416086,2416156
8460,82,18,1,6.24,12.38,2416155,2416237
8461,71,26,1,7.21,23.38,2416236,2416307
8462,71,41,1,7.21,40.28,2416306,2416377
8463,60,46,1,8.53,46.68,2416376,2416436
8464,61,107,0,8.39,177.45,2416435,2416496
8465,69,30,1,7.42,22.27,2416495,2416564
8466,83,19,0,6.17,17.32,2416563,2416646
8467,62,23,0,8.26,31.42,2416645,2416707
8468,79,54,1,6.48,43.21,2416706,2416785
8469,83,21,0,6.17,17.39,2416784,2416867
8470,69,32,0,7.42,47.92,2416866,2416935
8471,87,36,0,5.89,27.92,2416934,2417021
8472,101,27,0,5.07,21.01,2417021,2417122
8473,85,24,1,6.02,18.82,2417121,2417206
8474,110,20,0,4.65,11.37,2417205,2417315
8475,83,23,0,6.17,16.81,2417314,2417397
8476,77,20,1,6.65,15.32,2417396,2417473
8477,74,21,1,6.92,16.83,2417472,2417546
8478,72,37,0,7.11,26.54,2417545,2417617
8479,80,21,0,6.40,18.62,2417617,2417697
8480,73,39,0,7.01,28.01,2417696,2417769
8481,72,47,1,7.11,39.93,2417768,2417840
8482,74,25,1,6.92,18.70,2417839,2417913
8483,70,20,0,7.31,15.82,2417912,2417982
8484,74,16,1,6.92,15.75,2417982,2418056
8485,86,19,0,5.95,14.44,2418055,2418141
8486,74,19,0,6.92,18.72,2418140,2418214
8487,86,18,1,5.95,12.02,2418213,2418299
8488,79,30,0,6.48,23.41,2418298,2418377
8489,68,19,0,7.53,20.66,2418377,2418445
8490,79,25,0,6.48,27.77,2418444,2418523
8491,99,17,0,5.17,15.80,2418522,2418621
8492,89,26,0,5.75,21.42,2418620,2418709
8493,78,32,0,6.56,30.96,2418708,2418786
8494,102,18,0,5.02,10.74,2418785,2418887
8495,86,33,1,5.95,23.28,2418887,2418973
8496,83,47,1,6.17,42.50,2418972,2419055
8497,86,29,0,5.95,17.53,2419054,2419140
8498,72,30,1,7.11,24.35,2419139,2419211
8499,66,24,0,7.76,27.24,2419210,2419276
8500,66,35,1,7.76,32.67,2419275,2419341
8501,69,32,1,7.42,31.08,2419340,2419409
8502,75,29,1,6.83,28.12,2419408,2419483
8503,61,33,0,8.39,51.62,2419482,2419543
8504,63,25,2,8.13,28.17,2419543,2419606
8505,66,35,1,7.76,32.30,2419605,2419671
8506,69,26,1,7.42,22.74,2419670,2419739
8507,84,17,0,6.10,14.25,2419738,2419822
8508,69,20,1,7.42,17.17,2419821,2419890
8509,63,34,1,8.13,35.92,2419889,2419952
8510,61,48,1,8.39,60.07,2419951,2420012
8511,71,28,0,7.21,30.70,2420011,2420082
8512,116,20,0,4.41,17.69,2420081,2420197
8513,54,109,1,9.48,212.10,2420196,2420250
8514,82,19,1,6.24,17.55,2420249,2420331
8515,95,54,0,5.39,39.33,2420330,2420425
8516,77,22,0,6.65,23.60,2420425,2420502
8517,72,20,0,7.11,22.24,2420501,2420573
8518,68,21,0,7.53,19.48,2420572,2420640
8519,69,32,1,7.42,26.45,2420639,2420708
8520,74,21,0,6.92,19.26,2420707,2420781
8521,64,28,1,8.00,26.81,2420780,2420844
8522,72,30,1,7.11,25.21,2420843,2420915
8523,59,31,0,8.68,39.13,2420914,2420973
8524,58,91,0,8.83,148.45,2420972,2421030
8525,69,23,1,7.42,22.07,2421029,2421098
8526,59,39,1,8.68,45.13,2421097,2421156
8527,79,25,1,6.48,22.12,2421155,2421234
8528,84,22,0,6.10,16.01,2421233,2421317
8529,91,22,0,5.63,19.77,2421316,2421407
8530,65,22,2,7.88,13.80,2421407,2421472
8531,67,29,1,7.64,37.69,2421471,2421538
8532,78,27,0,6.56,31.07,2421538,2421616
8533,52,51,1,9.85,122.09,2421615,2421667
8534,73,37,0,7.01,36.70,2421666,2421739
8535,92,25,0,5.57,18.31,2421738,2421830
8536,95,26,0,5.39,26.68,2421829,2421924
8537,98,21,0,5.22,12.36,2421923,2422021
8538,80,38,0,6.40,43.26,2422020,2422100
8539,99,19,0,5.17,13.01,2422099,2422198
8540,71,22,1,7.21,25.60,2422198,2422269
8541,78,35,1,6.56,26.50,2422268,2422346
8542,75,24,1,6.83,20.73,2422345,2422420
8543,64,38,1,8.00,45.78,2422419,2422483
8544,71,19,1,7.21,15.60,2422482,2422553
8545,77,28,1,6.65,25.66,2422552,2422629
8546,73,25,0,7.01,23.16,2422628,2422701
8547,69,22,0,7.42,25.40,2422701,2422770
8548,61,36,1,8.39,43.32,2422769,2422830
8549,80,21,0,6.40,16.04,2422829,2422909
8550,77,27,0,6.65,25.73,2422908,2422985
8551,64,29,1,8.00,23.38,2422984,2423048
8552,67,41,1,7.64,46.50,2423047,2423114
8553,74,22,0,6.92,22.86,2423113,2423187
8554,81,26,0,6.32,22.24,2423186,2423267
8555,87,26,0,5.89,25.27,2423266,2423353
8556,82,41,0,6.24,43.09,2423352,2423434
8557,92,28,0,5.57,17.81,2423433,2423525
8558,89,24,0,5.75,18.25,2423524,2423613
8559,94,26,1,5.45,13.97,2423612,2423706
8560,77,23,0,6.65,20.20,2423706,2423783
8561,74,20,0,6.92,18.21,2423782,2423856
8562,76,26,1,6.74,19.69,2423855,2423931
8563,65,21,2,7.88,24.29,2423930,2423995
8564,81,19,0,6.32,13.60,2423994,2424075
8565,78,21,0,6.56,16.07,2424074,2424152
8566,78,48,0,6.56,37.94,2424151,2424229
8567,67,24,0,7.64,22.32,2424228,2424295
8568,66,22,1,7.76,21.03,2424294,2424360
8569,75,29,0,6.83,24.25,2424359,2424434
8570,67,31,1,7.64,32.47,2424433,2424500
8571,75,31,1,6.83,30.25,2424499,2424574
8572,79,22,0,6.48,20.91,2424573,2424652
8573,62,36,2,8.26,38.19,2424651,2424713
8574,79,25,0,6.48,21.03,2424712,2424791
8575,75,53,0,6.83,57.32,2424790,2424865
8576,84,25,1,6.10,18.23,2424864,2424948
8577,81,28,0,6.32,37.87,2424947,2425028
8578,102,25,0,5.02,15.67,2425027,2425129
8579,92,22,0,5.57,11.57,2425128,2425220
8580,89,34,0,5.75,27.02,2425219,2425308
8581,105,50,0,4.88,35.99,2425308,2425413
8582,75,18,0,6.83,19.93,2425413,2425488
8583,88,27,0,5.82,16.29,2425487,2425575
8584,66,30,1,7.76,39.91,2425574,2425640
8585,68,18,2,7.53,13.25,2425640,2425708
8586,83,16,1,6.17,12.19,2425707,2425790
8587,78,39,0,6.56,25.81,2425789,2425867
8588,68,51,1,7.53,45.93,2425866,2425934
8589,61,55,1,8.39,86.24,2425934,2425995
8590,75,21,2,6.83,20.44,2425994,2426069
8591,70,28,0,7.31,22.27,2426068,2426138
8592,53,69,1,9.66,111.02,2426137,2426190
8593,79,20,1,6.48,16.20,2426189,2426268
8594,95,30,0,5.39,22.66,2426267,2426362
8595,66,34,2,7.76,25.03,2426361,2426427
8596,51,81,1,10.04,143.45,2426426,2426477
8597,84,37,0,6.10,26.85,2426476,2426560
8598,73,25,0,7.01,30.95,2426559,2426632
8599,75,41,0,6.83,37.74,2426632,2426707
8600,95,31,1,5.39,19.40,2426706,2426801
8601,85,21,0,6.02,21.32,2426800,2426885
8602,94,18,0,5.45,14.10,2426884,2426978
8603,97,29,0,5.28,23.75,2426977,2427074
8604,93,20,0,5.51,16.25,2427074,2427167
8605,90,26,0,5.69,13.10,2427166,2427256
8606,91,23,0,5.63,11.09,2427255,2427346
8607,71,25,1,7.21,21.97,2427345,2427416
8608,70,25,1,7.31,18.82,2427416,2427486
8609,63,25,1,8.13,22.94,2427485,2427548
8610,75,37,0,6.83,22.92,2427547,2427622
8611,69,24,1,7.42,24.39,2427621,2427690
8612,62,30,1,8.26,29.39,2427689,2427751
8613,60,40,2,8.53,40.42,2427750,2427810
8614,62,22,2,8.26,19.06,2427809,2427871
8615,72,19,2,7.11,17.63,2427870,2427942
8616,75,24,1,6.83,21.40,2427941,2428016
8617,67,34,0,7.64,32.95,2428015,2428082
8618,78,21,0,6.56,16.35,2428081,2428159
8619,72,20,1,7.11,19.60,2428158,2428230
8620,73,39,1,7.01,40.97,2428229,2428302
8621,61,32,1,8.39,28.83,2428301,2428362
8622,68,47,0,7.53,47.96,2428361,2428429
8623,79,41,0,6.48,33.97,2428428,2428507
8624,111,18,0,4.61,11.77,2428506,2428617
8625,91,45,0,5.63,32.59,2428616,2428707
8626,95,36,0,5.39,22.93,2428706,2428801
8627,76,36,1,6.74,48.96,2428801,2428877
8628,92,42,0,5.57,27.53,2428876,2428968
8629,74,37,0,6.92,42.13,2428967,2429041
8630,79,17,1,6.48,15.79,2429040,2429119
8631,86,19,0,5.95,11.21,2429118,2429204
8632,63,51,1,8.13,51.76,2429203,2429266
8633,67,25,0,7.64,27.90,2429265,2429332
8634,66,21,0,7.76,25.40,2429331,2429397
8635,66,33,1,7.76,35.27,2429396,2429462
8636,61,28,2,8.39,27.03,2429461,2429522
8637,71,47,0,7.21,38.39,2429521,2429592
8638,70,43,1,7.31,41.87,2429591,2429661
8639,81,27,1,6.32,20.91,2429660,2429741
8640,76,20,1,6.74,23.06,2429740,2429816
8641,87,36,1,5.89,25.96,2429815,2429902
8642,69,77,0,7.42,99.32,2429902,2429971
8643,72,48,0,7.11,82.93,2429970,2430042
8644,93,42,0,5.51,42.70,2430041,2430134
8645,81,44,1,6.32,35.18,2430133,2430214
8646,83,32,0,6.17,21.71,2430213,2430296
8647,74,25,0,6.92,25.86,2430296,2430370
8648,83,63,0,6.17,58.26,2430369,2430452
8649,87,22,0,5.89,21.14,2430451,2430538
8650,68,29,0,7.53,40.10,2430537,2430605
8651,63,62,2,8.13,69.16,2430604,2430667
8652,82,20,1,6.24,18.75,2430666,2430748
8653,71,26,1,7.21,22.90,2430747,2430818
8654,84,26,0,6.10,17.68,2430817,2430901
8655,67,25,1,7.64,26.56,2430900,2430967
8656,79,31,0,6.48,19.34,2430966,2431045
8657,67,28,1,7.64,31.84,2431044,2431111
8658,79,34,0,6.48,33.69,2431110,2431189
8659,73,28,0,7.01,23.03,2431188,2431261
8660,74,25,0,6.92,28.40,2431260,2431334
8661,67,43,0,7.64,52.41,2431333,2431400
8662,102,36,0,5.02,26.33,2431399,2431501
8663,72,68,0,7.11,99.65,2431501,2431573
8664,93,19,0,5.51,19.48,2431573,2431666
8665,89,35,0,5.75,26.82,2431665,2431754
8666,93,19,0,5.51,15.88,2431753,2431846
8667,70,41,0,7.31,48.82,2431845,2431915
8668,81,25,0,6.32,18.42,2431914,2431995
8669,69,26,0,7.42,21.98,2431994,2432063
8670,71,18,1,7.21,16.34,2432062,2432133
8671,66,32,0,7.76,38.03,2432133,2432199
8672,71,32,0,7.21,33.21,2432199,2432270
8673,79,21,0,6.48,17.44,2432269,2432348
8674,68,21,0,7.53,19.34,2432347,2432415
8675,54,34,1,9.48,49.25,2432414,2432468
8676,72,29,0,7.11,21.49,2432467,2432539
8677,85,22,0,6.02,16.21,2432538,2432623
8678,71,41,1,7.21,31.97,2432622,2432693
8679,79,24,0,6.48,23.59,2432693,2432772
8680,54,43,0,9.48,63.81,2432771,2432825
8681,67,28,0,7.64,35.81,2432825,2432892
8682,84,20,0,6.10,17.85,2432891,2432975
8683,66,48,1,7.76,59.76,2432974,2433040
8684,90,21,0,5.69,19.35,2433039,2433129
8685,92,27,0,5.57,20.01,2433128,2433220
8686,74,30,0,6.92,26.67,2433220,2433294
8687,84,31,0,6.10,23.75,2433294,2433378
8688,70,78,1,7.31,91.64,2433377,2433447
8689,52,53,2,9.85,84.17,2433446,2433498
8690,74,20,1,6.92,12.86,2433497,2433571
8691,77,36,2,6.65,24.75,2433570,2433647
8692,66,20,0,7.76,20.91,2433646,2433712
8693,61,31,1,8.39,31.22,2433711,2433772
8694,72,30,1,7.11,25.49,2433771,2433843
8695,68,49,1,7.53,46.19,2433842,2433910
8696,86,16,0,5.95,13.30,2433909,2433995
8697,58,31,1,8.83,30.04,2433994,2434052
8698,74,26,1,6.92,23.70,2434051,2434125
8699,70,36,0,7.31,32.64,2434124,2434194
8700,64,22,1,8.00,21.53,2434193,2434257
8701,89,28,0,5.75,26.48,2434256,2434345
8702,90,37,0,5.69,34.44,2434344,2434434
8703,80,31,1,6.40,33.79,2434433,2434513
8704,87,41,1,5.89,35.16,2434512,2434599
8705,76,37,0,6.74,41.51,2434598,2434674
8706,81,21,1,6.32,26.98,2434674,2434755
8707,84,22,0,6.10,16.75,2434754,2434838
8708,71,27,1,7.21,20.11,2434837,2434908
8709,69,25,1,7.42,23.61,2434907,2434976
8710,70,31,1,7.31,27.59,2434975,2435045
8711,73,44,1,7.01,33.88,2435044,2435117
8712,71,23,0,7.21,21.72,2435117,2435188
8713,75,18,1,6.83,16.60,2435187,2435262
8714,61,50,1,8.39,55.03,2435261,2435322
8715,72,27,1,7.11,29.18,2435321,2435393
8716,70,19,0,7.31,18.42,2435393,2435463
8717,76,28,0,6.74,21.27,2435462,2435538
8718,92,22,0,5.57,16.46,2435537,2435629
8719,61,18,0,8.39,17.42,2435628,2435689
8720,77,35,1,6.65,26.85,2435688,2435765
8721,78,27,0,6.56,36.73,2435764,2435842
8722,77,21,0,6.65,20.98,2435841,2435918
8723,102,25,0,5.02,15.39,2435917,2436019
8724,91,28,0,5.63,26.76,2436018,2436109
8725,91,19,0,5.63,19.71,2436108,2436199
8726,84,40,1,6.10,32.37,2436198,2436282
8727,88,32,1,5.82,23.47,2436281,2436369
8728,93,33,0,5.51,21.48,2436368,2436461
8729,90,20,1,5.69,15.13,2436460,2436550
8730,79,19,0,6.48,16.50,2436549,2436628
8731,79,22,1,6.48,18.86,2436627,2436706
8732,65,24,1,7.88,24.60,2436705,2436770
8733,74,24,1,6.92,20.43,2436769,2436843
8734,70,23,1,7.31,23.73,2436842,2436912
8735,73,28,1,7.01,24.75,2436912,2436985
8736,73,28,0,7.01,28.42,2436984,2437057
8737,74,22,1,6.92,18.21,2437056,2437130
8738,61,24,2,8.39,26.27,2437129,2437190
8739,71,49,0,7.21,43.43,2437189,2437260
8740,84,27,1,6.10,24.30,2437259,2437343
8741,64,31,1,8.00,39.50,2437342,2437406
8742,68,22,1,7.53,23.63,2437405,2437473
8743,78,20,0,6.56,24.68,2437473,2437551
8744,66,36,0,7.76,54.61,2437550,2437616
8745,89,22,0,5.75,19.02,2437615,2437704
8746,103,21,0,4.97,15.80,2437703,2437806
8747,89,28,0,5.75,22.32,2437805,2437894
8748,70,38,0,7.31,62.53,2437893,2437963
8749,59,82,1,8.68,165.17,2437962,2438021
8750,70,51,0,7.31,74.44,2438020,2438090
8751,88,54,1,5.82,47.44,2438089,2438177
8752,73,42,0,7.01,39.58,2438176,2438249
8753,81,21,0,6.32,21.25,2438249,2438330
8754,76,41,0,6.74,39.93,2438329,2438405
8755,74,26,1,6.92,23.24,2438404,2438478
8756,68,22,0,7.53,21.28,2438477,2438545
8757,81,26,0,6.32,21.70,2438544,2438625
8758,51,59,2,10.04,80.35,2438624,2438675
8759,70,31,1,7.31,28.73,2438675,2438745
8760,74,48,1,6.92,42.37,2438744,2438818
8761,67,20,2,7.64,21.87,2438817,2438884
8762,70,32,2,7.31,21.44,2438883,2438953
8763,67,24,1,7.64,21.33,2438952,2439019
8764,80,33,0,6.40,26.71,2439018,2439098
8765,80,56,0,6.40,45.29,2439097,2439177
8766,77,21,1,6.65,17.71,2439176,2439253
8767,80,28,0,6.40,22.21,2439252,2439332
8768,70,21,0,7.31,23.42,2439332,2439402
8769,74,26,0,6.92,27.32,2439401,2439475
8770,70,28,0,7.31,30.70,2439474,2439544
8771,102,25,0,5.02,22.31,2439543,2439645
8772,80,63,0,6.40,64.66,2439644,2439724
8773,93,21,0,5.51,17.28,2439723,2439816
8774,95,45,0,5.39,31.50,2439815,2439910
8775,98,21,0,5.22,14.54,2439909,2440007
8776,79,22,1,6.48,18.12,2440007,2440086
8777,82,25,0,6.24,27.72,2440085,2440167
8778,55,47,1,9.31,64.87,2440166,2440221
8779,68,29,1,7.53,27.63,2440220,2440288
8780,84,19,1,6.10,14.23,2440287,2440371
8781,61,39,1,8.39,34.27,2440371,2440432
8782,64,28,1,8.00,31.25,2440431,2440495
8783,60,23,1,8.53,26.58,2440494,2440554
8784,74,23,0,6.92,17.59,2440553,2440627
8785,72,20,1,7.11,19.96,2440626,2440698
8786,73,29,1,7.01,28.51,2440697,2440770
8787,61,43,1,8.39,41.52,2440769,2440830
8788,77,38,1,6.65,40.12,2440829,2440906
8789,57,48,1,8.98,61.46,2440906,2440963
8790,67,25,1,7.64,34.14,2440962,2441029
8791,75,39,0,6.83,34.60,2441028,2441103
8792,111,26,0,4.61,18.51,2441102,2441213
8793,83,20,0,6.17,17.25,2441212,2441295
8794,83,28,0,6.17,17.30,2441294,2441377
8795,89,22,0,5.75,17.47,2441376,2441465
8796,74,22,0,6.92,21.86,2441464,2441538
8797,71,44,1,7.21,33.29,2441538,2441609
8798,72,26,1,7.11,23.63,2441608,2441680
8799,65,25,1,7.88,30.78,2441679,2441744
8800,74,29,1,6.92,21.45,2441743,2441817
8801,80,18,1,6.40,15.99,2441816,2441896
8802,71,47,1,7.21,40.53,2441895,2441966
8803,63,53,0,8.13,63.79,2441966,2442029
8804,71,18,0,7.21,18.79,2442028,2442099
8805,69,28,0,7.42,26.68,2442098,2442167
8806,63,27,1,8.13,28.11,2442166,2442229
8807,80,24,0,6.40,19.27,2442229,2442309
8808,76,31,0,6.74,24.83,2442308,2442384
8809,66,22,1,7.76,20.15,2442383,2442449
8810,63,25,0,8.13,34.46,2442448,2442511
8811,62,45,1,8.26,54.42,2442510,2442572
8812,79,24,1,6.48,20.33,2442571,2442650
8813,70,40,0,7.31,61.67,2442649,2442719
8814,104,23,0,4.92,19.40,2442718,2442822
8815,91,38,0,5.63,30.74,2442821,2442912
8816,90,19,1,5.69,17.88,2442911,2443001
8817,90,23,0,5.69,16.64,2443000,2443090
8818,85,23,0,6.02,20.35,2443090,2443175
8819,89,37,1,5.75,27.94,2443174,2443263
8820,81,28,0,6.32,20.74,2443262,2443343
8821,72,17,1,7.11,14.40,2443343,2443415
8822,64,23,0,8.00,23.59,2443414,2443478
8823,66,34,1,7.76,28.85,2443477,2443543
8824,81,18,1,6.32,12.91,2443542,2443623
8825,73,20,2,7.01,15.19,2443623,2443696
8826,78,25,0,6.56,22.09,2443695,2443773
8827,67,30,0,7.64,29.01,2443772,2443839
8828,60,25,1,8.53,29.78,2443838,2443898
8829,76,20,0,6.74,14.72,2443897,2443973
8830,69,24,1,7.42,22.50,2443972,2444041
8831,102,31,0,5.02,19.55,2444040,2444142
8832,67,26,2,7.64,21.63,2444142,2444209
8833,82,31,0,6.24,27.40,2444208,2444290
8834,70,29,1,7.31,30.22,2444289,2444359
8835,89,20,0,5.75,16.01,2444358,2444447
8836,74,33,1,6.92,35.13,2444446,2444520
8837,88,44,0,5.82,56.22,2444519,2444607
8838,102,51,0,5.02,40.20,2444606,2444708
8839,95,29,0,5.39,21.63,2444707,2444802
8840,79,51,1,6.48,42.17,2444801,2444880
8841,77,22,1,6.65,26.36,2444879,2444956
8842,91,30,0,5.63,22.65,2444955,2445046
8843,82,22,1,6.24,16.45,2445045,2445127
8844,70,33,1,7.31,25.22,2445126,2445196
8845,69,36,0,7.42,38.39,2445195,2445264
8846,69,42,1,7.42,40.24,2445263,2445332
8847,72,29,1,7.11,27.29,2445331,2445403
8848,64,41,0,8.00,46.56,2445402,2445466
8849,74,16,1,6.92,14.18,2445465,2445539
8850,69,26,1,7.42,24.30,2445538,2445607
8851,58,22,2,8.83,24.76,2445607,2445665
8852,68,33,1,7.53,26.96,2445664,2445732
8853,75,19,1,6.83,16.22,2445731,2445806
8854,109,23,0,4.70,13.75,2445806,2445915
8855,63,34,2,8.13,33.89,2445914,2445977
8856,64,59,1,8.00,72.31,2445976,2446040
8857,71,26,1,7.21,25.29,2446039,2446110
8858,82,19,1,6.24,16.31,2446110,2446192
8859,94,29,0,5.45,26.91,2446192,2446286
8860,84,47,0,6.10,48.54,2446285,2446369
8861,95,36,0,5.39,24.20,2446368,2446463
8862,78,29,0,6.56,31.71,2446462,2446540
8863,89,39,0,5.75,29.67,2446539,2446628
8864,99,19,0,5.17,12.34,2446627,2446726
8865,72,24,1,7.11,20.68,2446725,2446797
8866,72,43,1,7.11,55.52,2446796,2446868
8867,76,20,1,6.74,18.14,2446867,2446943
8868,73,22,1,7.01,17.82,2446942,2447015
8869,67,34,0,7.64,46.53,2447014,2447081
8870,63,42,1,8.13,55.25,2447081,2447144
8871,62,23,0,8.26,30.74,2447143,2447205
8872,73,45,1,7.01,35.52,2447204,2447277
8873,65,30,2,7.88,31.71,2447277,2447342
8874,62,28,1,8.26,31.16,2447341,2447403
8875,76,19,1,6.74,15.35,2447402,2447478
8876,72,63,0,7.11,75.96,2447477,2447549
8877,70,32,1,7.31,35.24,2447548,2447618
8878,63,33,0,8.13,32.62,2447617,2447680
8879,64,43,1,8.00,51.06,2447679,2447743
8880,66,40,0,7.76,44.52,2447742,2447808
8881,68,26,0,7.53,27.13,2447807,2447875
8882,63,35,1,8.13,46.43,2447874,2447937
8883,65,34,0,7.88,41.77,2447936,2448001
8884,86,20,0,5.95,18.93,2448001,2448087
8885,105,30,0,4.88,24.17,2448087,2448192
8886,109,21,0,4.70,17.37,2448191,2448300
8887,78,28,1,6.56,28.53,2448299,2448377
8888,90,25,1,5.69,18.50,2448376,2448466
8889,80,26,0,6.40,30.34,2448466,2448546
8890,86,16,0,5.95,14.53,2448545,2448631
8891,75,27,0,6.83,17.02,2448630,2448705
8892,69,59,1,7.42,52.94,2448704,2448773
8893,79,21,0,6.48,16.35,2448772,2448851
8894,73,22,0,7.01,18.81,2448850,2448923
8895,73,28,0,7.01,27.27,2448922,2448995
8896,63,46,1,8.13,48.75,2448995,2449058
8897,54,39,1,9.48,51.21,2449057,2449111
8898,76,19,0,6.74,15.30,2449110,2449186
8899,56,39,1,9.14,49.59,2449185,2449241
8900,85,20,0,6.02,18.19,2449240,2449325
8901,78,21,0,6.56,19.43,2449324,2449402
8902,57,27,1,8.98,30.82,2449401,2449458
8903,80,33,0,6.40,32.04,2449457,2449537
8904,78,72,1,6.56,70.37,2449536,2449614
8905,53,51,0,9.66,94.30,2449613,2449666
8906,74,37,0,6.92,33.53,2449665,2449739
8907,86,30,0,5.95,25.70,2449738,2449824
8908,84,56,0,6.10,62.75,2449823,2449907
8909,109,46,0,4.70,26.83,2449906,2450015
8910,84,23,0,6.10,20.92,2450014,2450098
8911,89,50,0,5.75,39.85,2450097,2450186
8912,90,25,0,5.69,22.44,2450185,2450275
8913,78,19,1,6.56,17.19,2450274,2450352
8914,70,25,1,7.31,20.87,2450351,2450421
8915,57,47,2,8.98,47.67,2450420,2450477
8916,77,19,1,6.65,18.10,2450476,2450553
8917,80,40,1,6.40,33.49,2450552,2450632
8918,71,41,1,7.21,32.73,2450631,2450702
8919,74,22,0,6.92,19.97,2450701,2450775
8920,77,25,2,6.65,17.79,2450774,2450851
8921,72,22,0,7.11,22.13,2450850,2450922
8922,63,31,2,8.13,37.54,2450921,2450984
8923,64,33,0,8.00,40.12,2450983,2451047
8924,60,32,1,8.53,25.32,2451046,2451106
8925,86,77,0,5.95,77.88,2451105,2451191
8926,59,26,1,8.68,27.68,2451190,2451249
8927,75,22,0,6.83,23.34,2451248,2451323
8928,72,25,0,7.11,28.29,2451322,2451394
8929,51,44,1,10.04,84.47,2451394,2451445
8930,81,36,1,6.32,31.70,2451445,2451526
8931,75,27,1,6.83,27.08,2451526,2451601
8932,97,19,0,5.28,18.53,2451600,2451697
8933,100,88,0,5.12,84.15,2451696,2451796
8934,80,33,1,6.40,32.34,2451796,2451876
8935,86,27,0,5.95,25.25,2451875,2451961
8936,82,38,1,6.24,30.23,2451960,2452042
8937,88,24,0,5.82,21.76,2452041,2452129
8938,75,35,0,6.83,27.45,2452128,2452203
8939,66,27,1,7.76,24.82,2452202,2452268
8940,81,19,1,6.32,15.01,2452267,2452348
8941,59,40,1,8.68,53.37,2452348,2452407
8942,70,37,0,7.31,41.19,2452407,2452477
8943,81,26,0,6.32,22.05,2452476,2452557
8944,69,37,1,7.42,31.35,2452556,2452625
8945,73,17,1,7.01,13.66,2452624,2452697
8946,68,37,0,7.53,39.72,2452696,2452764
8947,68,23,1,7.53,19.19,2452763,2452831
8948,96,49,1,5.33,30.83,2452830,2452926
8949,59,42,0,8.68,47.03,2452925,2452984
8950,75,23,0,6.83,27.08,2452983,2453058
8951,84,21,0,6.10,14.37,2453057,2453141
8952,65,17,0,7.88,20.38,2453140,2453205
8953,59,97,1,8.68,169.24,2453204,2453263
8954,74,40,0,6.92,46.53,2453262,2453336
8955,113,30,0,4.53,22.21,2453335,2453448
8956,89,24,1,5.75,25.65,2453447,2453536
8957,89,87,0,5.75,88.55,2453535,2453624
8958,80,27,1,6.40,20.99,2453623,2453703
8959,88,27,0,5.82,19.33,2453702,2453790
8960,84,36,0,6.10,28.80,2453790,2453874
8961,83,19,1,6.17,12.57,2453874,2453957
8962,64,49,1,8.00,45.44,2453956,2454020
8963,67,30,1,7.64,29.36,2454020,2454087
8964,80,21,1,6.40,20.31,2454086,2454166
8965,72,41,1,7.11,31.96,2454166,2454238
8966,63,49,1,8.13,49.51,2454237,2454300
8967,76,32,0,6.74,25.01,2454299,2454375
8968,75,25,1,6.83,19.24,2454374,2454449
8969,66,21,1,7.76,23.85,2454448,2454514
8970,71,56,1,7.21,51.60,2454513,2454584
8971,72,25,0,7.11,20.90,2454583,2454655
8972,69,41,1,7.42,50.07,2454654,2454723
8973,71,23,1,7.21,20.50,2454722,2454793
8974,58,68,1,8.83,90.59,2454792,2454850
8975,80,22,0,6.40,16.89,2454849,2454929
8976,62,35,1,8.26,50.77,2454928,2454990
8977,61,42,0,8.39,59.75,2454990,2455051
8978,54,40,0,9.48,79.81,2455050,2455104
8979,65,46,1,7.88,57.46,2455103,2455168
8980,103,19,0,4.97,16.36,2455167,2455270
8981,82,26,0,6.24,24.87,2455269,2455351
8982,116,25,0,4.41,13.97,2455350,2455466
8983,82,51,0,6.24,39.23,2455465,2455547
8984,86,36,1,5.95,25.49,2455546,2455632
8985,73,27,1,7.01,30.21,2455631,2455704
8986,78,19,2,6.56,12.14,2455703,2455781
8987,67,24,1,7.64,20.74,2455780,2455847
8988,77,27,1,6.65,18.36,2455846,2455923
8989,76,28,1,6.74,20.51,2455922,2455998
8990,67,25,0,7.64,26.74,2455997,2456064
8991,65,45,1,7.88,45.74,2456063,2456128
8992,57,38,1,8.98,51.70,2456127,2456184
8993,60,38,0,8.53,58.25,2456183,2456243
8994,73,23,0,7.01,21.38,2456242,2456315
8995,68,47,2,7.53,35.90,2456314,2456382
8996,92,16,0,5.57,13.51,2456381,2456473
8997,55,34,1,9.31,40.40,2456473,2456528
8998,64,32,1,8.00,40.44,2456527,2456591
8999,75,46,0,6.83,38.54,2456591,2456666
9000,56,40,0,9.14,59.80,2456665,2456721
9001,45,37,1,11.38,83.35,2456720,2456765
9002,59,81,1,8.68,111.24,2456764,2456823
9003,83,23,0,6.17,27.01,2456822,2456905
9004,92,45,0,5.57,38.29,2456905,2456997
9005,80,32,0,6.40,32.99,2456996,2457076
9006,94,38,0,5.45,33.93,2457076,2457170
9007,71,23,0,7.21,18.70,2457169,2457240
9008,72,53,1,7.11,42.35,2457239,2457311
9009,89,21,0,5.75,17.06,2457311,2457400
9010,79,18,0,6.48,15.62,2457400,2457479
9011,74,17,0,6.92,14.02,2457478,2457552
9012,78,19,0,6.56,16.40,2457551,2457629
9013,81,22,1,6.32,18.37,2457628,2457709
9014,78,19,1,6.56,17.35,2457708,2457786
9015,70,36,1,7.31,32.07,2457785,2457855
9016,53,54,1,9.66,67.58,2457854,2457907
9017,61,21,0,8.39,19.78,2457906,2457967
9018,66,29,1,7.76,22.52,2457966,2458032
9019,68,30,0,7.53,23.57,2458031,2458099
9020,88,16,0,5.82,13.38,2458098,2458186
9021,76,28,0,6.74,23.64,2458185,2458261
9022,73,36,1,7.01,29.36,2458260,2458333
9023,55,46,1,9.31,58.10,2458332,2458387
9024,78,27,0,6.56,29.53,2458386,2458464
9025,52,42,1,9.85,84.32,2458463,2458515
9026,55,83,1,9.31,135.60,2458514,2458569
9027,67,43,0,7.64,58.11,2458568,2458635
9028,73,33,1,7.01,29.22,2458635,2458708
9029,107,34,0,4.79,22.47,2458707,2458814
9030,59,54,0,8.68,108.15,2458814,2458873
9031,101,23,0,5.07,15.15,2458872,2458973
9032,97,21,0,5.28,14.76,2458972,2459069
9033,87,21,1,5.89,20.12,2459068,2459155
9034,79,33,0,6.48,26.81,2459154,2459233
9035,77,17,1,6.65,13.21,2459232,2459309
9036,61,31,2,8.39,33.42,2459309,2459370
9037,70,22,1,7.31,19.50,2459369,2459439
9038,75,21,1,6.83,14.17,2459438,2459513
9039,74,28,1,6.92,21.67,2459513,2459587
9040,77,19,0,6.65,16.18,2459586,2459663
9041,64,26,1,8.00,26.22,2459662,2459726
9042,69,27,1,7.42,27.63,2459725,2459794
9043,58,24,1,8.83,30.07,2459793,2459851
9044,76,35,0,6.74,29.98,2459850,2459926
9045,97,22,0,5.28,12.68,2459925,2460022
9046,72,22,1,7.11,20.96,2460021,2460093
9047,72,19,1,7.11,18.77,2460092,2460164
9048,97,22,0,5.28,15.50,2460164,2460261
9049,57,36,1,8.98,50.47,2460260,2460317
9050,65,45,0,7.88,54.72,2460316,2460381
9051,78,52,0,6.56,52.78,2460380,2460458
9052,71,84,0,7.21,110.56,2460457,2460528
9053,93,36,0,5.51,33.56,2460527,2460620
9054,98,44,0,5.22,32.87,2460619,2460717
9055,71,31,1,7.21,35.18,2460717,2460788
9056,79,26,0,6.48,25.26,2460787,2460866
9057,91,23,1,5.63,18.45,2460865,2460956
9058,82,23,1,6.24,22.67,2460955,2461037
9059,75,18,0,6.83,16.36,2461037,2461112
9060,79,18,1,6.48,13.29,2461111,2461190
9061,88,26,0,5.82,20.31,2461189,2461277
9062,68,43,1,7.53,53.84,2461276,2461344
9063,54,54,1,9.48,62.69,2461343,2461397
9064,77,23,0,6.65,21.68,2461396,2461473
9065,56,73,0,9.14,102.12,2461472,2461528
9066,66,21,1,7.76,19.64,2461527,2461593
9067,65,30,1,7.88,37.09,2461592,2461657
9068,67,34,0,7.64,53.30,2461656,2461723
9069,86,22,1,5.95,16.51,2461722,2461808
9070,59,39,2,8.68,34.76,2461807,2461866
9071,69,33,1,7.42,37.49,2461865,2461934
9072,76,26,1,6.74,24.30,2461933,2462009
9073,56,43,1,9.14,67.37,2462008,2462064
9074,75,18,0,6.83,19.32,2462063,2462138
9075,75,34,0,6.83,43.24,2462137,2462212
9076,81,50,0,6.32,45.16,2462212,2462293
9077,92,46,0,5.57,44.33,2462293,2462385
9078,111,24,0,4.61,15.91,2462384,2462495
9079,90,26,1,5.69,17.48,2462494,2462584
9080,81,31,0,6.32,39.33,2462583,2462664
9081,86,19,1,5.95,12.81,2462663,2462749
9082,77,24,0,6.65,17.06,2462748,2462825
9083,61,26,1,8.39,31.12,2462824,2462885
9084,64,36,1,8.00,34.28,2462885,2462949
9085,70,18,1,7.31,18.07,2462948,2463018
9086,77,34,1,6.65,21.40,2463017,2463094
9087,68,40,1,7.53,37.48,2463093,2463161
9088,68,31,1,7.53,31.13,2463160,2463228
9089,68,28,1,7.53,19.66,2463227,2463295
9090,64,39,1,8.00,41.38,2463294,2463358
9091,71,23,1,7.21,16.87,2463357,2463428
9092,68,47,0,7.53,49.75,2463427,2463495
9093,79,32,0,6.48,32.55,2463494,2463573
9094,60,28,2,8.53,25.12,2463572,2463632
9095,73,26,1,7.01,24.42,2463631,2463704
9096,69,27,0,7.42,23.69,2463704,2463773
9097,61,47,1,8.39,53.78,2463772,2463833
9098,67,45,1,7.64,63.21,2463832,2463899
9099,87,33,0,5.89,27.83,2463898,2463985
9100,96,27,0,5.33,30.76,2463984,2464080
9101,75,38,1,6.83,37.50,2464079,2464154
9102,96,16,0,5.33,12.37,2464154,2464250
9103,89,66,1,5.75,52.46,2464249,2464338
9104,85,32,0,6.02,24.71,2464337,2464422
9105,87,38,0,5.89,33.62,2464421,2464508
9106,76,20,0,6.74,19.35,2464507,2464583
9107,63,21,0,8.13,14.43,2464583,2464646
9108,66,36,1,7.76,34.55,2464645,2464711
9109,84,26,1,6.10,16.68,2464710,2464794
9110,68,31,1,7.53,25.90,2464793,2464861
9111,59,59,1,8.68,83.40,2464860,2464919
9112,67,22,1,7.64,23.90,2464918,2464985
9113,68,21,0,7.53,20.37,2464984,2465052
9114,65,40,1,7.88,51.52,2465051,2465116
9115,64,51,1,8.00,59.69,2465115,2465179
9116,61,37,0,8.39,47.45,2465178,2465239
9117,65,22,1,7.88,24.69,2465238,2465303
9118,66,35,1,7.76,37.21,2465302,2465368
9119,62,37,0,8.26,45.61,2465367,2465429
9120,93,25,0,5.51,22.66,2465428,2465521
9121,96,25,0,5.33,27.06,2465520,2465616
9122,76,50,0,6.74,51.27,2465615,2465691
9123,81,34,0,6.32,34.84,2465690,2465771
9124,81,32,0,6.32,31.63,2465770,2465851
9125,74,23,0,6.92,25.70,2465850,2465924
9126,72,37,0,7.11,39.96,2465923,2465995
9127,63,63,1,8.13,64.30,2465994,2466057
9128,63,30,1,8.13,29.60,2466056,2466119
9129,72,36,1,7.11,29.74,2466118,2466190
9130,76,35,0,6.74,29.80,2466190,2466266
9131,71,38,0,7.21,32.56,2466265,2466336
9132,59,58,1,8.68,59.57,2466336,2466395
9133,64,43,0,8.00,49.22,2466394,2466458
9134,61,26,0,8.39,30.07,2466457,2466518
9135,62,45,2,8.26,45.42,2466517,2466579
9136,59,36,0,8.68,43.37,2466579,2466638
9137,68,29,1,7.53,43.19,2466638,2466706
9138,84,30,0,6.10,22.54,2466705,2466789
9139,64,21,1,8.00,20.75,2466788,2466852
9140,68,44,0,7.53,44.78,2466851,2466919
9141,67,35,0,7.64,40.20,2466918,2466985
9142,72,29,1,7.11,29.68,2466984,2467056
9143,81,26,0,6.32,24.17,2467056,2467137
9144,102,37,0,5.02,27.14,2467136,2467238
9145,100,26,0,5.12,30.17,2467237,2467337
9146,76,35,1,6.74,37.46,2467336,2467412
9147,88,23,0,5.82,18.22,2467411,2467499
9148,89,23,0,5.75,22.79,2467499,2467588
9149,92,21,1,5.57,14.64,2467587,2467679
9150,77,42,0,6.65,38.23,2467678,2467755
9151,66,28,1,7.76,20.91,2467754,2467820
9152,76,31,0,6.74,23.01,2467820,2467896
9153,76,21,1,6.74,18.14,2467895,2467971
9154,63,46,0,8.13,45.73,2467970,2468033
9155,62,38,0,8.26,45.45,2468032,2468094
9156,70,24,1,7.31,26.70,2468093,2468163
9157,67,23,1,7.64,25.39,2468162,2468229
9158,58,28,1,8.83,31.35,2468228,2468286
9159,77,34,0,6.65,23.21,2468286,2468363
9160,72,26,1,7.11,31.24,2468362,2468434
9161,87,32,0,5.89,27.27,2468433,2468520
9162,59,33,1,8.68,30.90,2468519,2468578
9163,54,54,2,9.48,74.40,2468577,2468631
9164,76,25,0,6.74,23.88,2468630,2468706
9165,69,28,1,7.42,31.35,2468705,2468774
9166,70,43,0,7.31,50.33,2468773,2468843
9167,89,28,0,5.75,26.64,2468842,2468931
9168,91,19,0,5.63,21.77,2468930,2469021
9169,100,24,0,5.12,21.49,2469020,2469120
9170,85,30,0,6.02,21.27,2469119,2469204
9171,94,24,0,5.45,16.63,2469203,2469297
9172,96,50,0,5.33,33.26,2469296,2469392
9173,67,40,0,7.64,47.72,2469391,2469458
9174,96,18,0,5.33,13.01,2469458,2469554
9175,76,15,0,6.74,10.90,2469553,2469629
9176,59,29,1,8.68,27.17,2469628,2469687
9177,71,26,1,7.21,20.79,2469686,2469757
9178,69,52,0,7.42,48.77,2469756,2469825
9179,69,18,0,7.42,21.17,2469824,2469893
9180,64,38,1,8.00,37.03,2469892,2469956
9181,67,29,0,7.64,25.81,2469956,2470023
9182,72,28,0,7.11,30.10,2470022,2470094
9183,82,36,0,6.24,32.92,2470093,2470175
9184,70,23,0,7.31,23.16,2470175,2470245
9185,71,22,1,7.21,20.59,2470244,2470315
9186,84,42,0,6.10,41.44,2470314,2470398
9187,84,22,0,6.10,15.85,2470397,2470481
9188,78,36,0,6.56,32.89,2470481,2470559
9189,117,18,0,4.38,11.40,2470558,2470675
9190,76,30,0,6.74,29.72,2470674,2470750
9191,83,26,0,6.17,23.63,2470749,2470832
9192,86,26,1,5.95,22.07,2470832,2470918
9193,84,20,0,6.10,15.71,2470917,2471001
9194,89,35,0,5.75,23.65,2471001,2471090
9195,65,49,0,7.88,52.69,2471089,2471154
9196,77,22,1,6.65,18.93,2471153,2471230
9197,77,16,1,6.65,11.03,2471229,2471306
9198,80,21,0,6.40,17.76,2471305,2471385
9199,68,37,1,7.53,36.81,2471384,2471452
9200,67,25,0,7.64,24.74,2471451,2471518
9201,59,26,1,8.68,28.12,2471517,2471576
9202,66,37,0,7.76,36.24,2471575,2471641
9203,68,32,2,7.53,22.81,2471640,2471708
9204,74,66,0,6.92,81.75,2471708,2471782
9205,69,28,1,7.42,23.43,2471781,2471850
9206,58,53,1,8.83,70.66,2471849,2471907
9207,57,55,1,8.98,77.28,2471907,2471964
9208,67,31,0,7.64,37.93,2471963,2472030
9209,68,43,0,7.53,57.16,2472029,2472097
9210,89,21,0,5.75,23.42,2472096,2472185
9211,97,44,0,5.28,39.75,2472184,2472281
9212,76,21,1,6.74,21.14,2472280,2472356
9213,76,34,0,6.74,29.17,2472355,2472431
9214,90,32,0,5.69,23.86,2472430,2472520
9215,74,29,1,6.92,29.43,2472519,2472593
9216,85,30,0,6.02,17.39,2472592,2472677
9217,72,33,1,7.11,27.93,2472676,2472748
9218,80,30,0,6.40,21.26,2472747,2472827
9219,70,56,1,7.31,55.13,2472826,2472896
9220,70,34,1,7.31,26.84,2472895,2472965
9221,72,21,0,7.11,18.15,2472965,2473037
9222,66,27,0,7.76,29.21,2473036,2473102
9223,71,25,1,7.21,19.86,2473102,2473173
9224,57,66,0,8.98,108.47,2473173,2473230
9225,81,20,0,6.32,14.81,2473229,2473310
9226,73,20,1,7.01,23.27,2473309,2473382
9227,64,46,1,8.00,58.28,2473381,2473445
9228,75,30,0,6.83,29.34,2473444,2473519
9229,61,26,0,8.39,34.47,2473518,2473579
9230,66,37,0,7.76,56.09,2473578,2473644
9231,93,23,0,5.51,27.11,2473643,2473736
9232,100,21,0,5.12,18.95,2473736,2473836
9233,85,30,0,6.02,21.93,2473835,2473920
9234,76,39,1,6.74,46.46,2473919,2473995
9235,84,32,0,6.10,23.23,2473994,2474078
9236,73,43,0,7.01,39.33,2474077,2474150
9237,81,44,0,6.32,32.74,2474149,2474230
9238,62,35,1,8.26,42.97,2474229,2474291
9239,64,26,1,8.00,26.91,2474290,2474354
9240,65,21,1,7.88,20.57,2474353,2474418
9241,74,32,0,6.92,24.40,2474417,2474491
9242,69,23,0,7.42,19.98,2474490,2474559
9243,71,28,1,7.21,28.22,2474559,2474630
9244,68,35,1,7.53,35.98,2474629,2474697
9245,74,31,1,6.92,20.32,2474696,2474770
9246,74,16,1,6.92,14.43,2474769,2474843
9247,60,30,1,8.53,45.62,2474842,2474902
9248,75,29,0,6.83,30.41,2474901,2474976
9249,118,13,0,4.34,8.70,2474975,2475093
9250,95,25,0,5.39,21.14,2475093,2475188
9251,73,27,1,7.01,31.66,2475187,2475260
9252,86,23,0,5.95,16.53,2475260,2475346
9253,80,18,0,6.40,16.94,2475345,2475425
9254,90,17,0,5.69,11.33,2475424,2475514
9255,68,21,1,7.53,19.43,2475513,2475581
9256,75,20,1,6.83,15.90,2475580,2475655
9257,68,26,1,7.53,31.16,2475654,2475722
9258,59,38,1,8.68,64.08,2475721,2475780
9259,68,25,1,7.53,22.40,2475779,2475847
9260,56,35,2,9.14,30.84,2475846,2475902
9261,63,41,1,8.13,39.92,2475901,2475964
9262,73,21,1,7.01,24.48,2475963,2476036
9263,82,20,0,6.24,20.87,2476035,2476117
9264,66,40,1,7.76,40.97,2476116,2476182
9265,67,46,1,7.64,57.51,2476181,2476248
9266,64,45,0,8.00,49.22,2476247,2476311
9267,66,37,0,7.76,53.76,2476310,2476376
9268,96,28,0,5.33,15.74,2476375,2476471
9269,96,18,0,5.33,18.81,2476470,2476566
9270,81,28,0,6.32,30.56,2476565,2476646
9271,76,40,0,6.74,38.06,2476645,2476721
9272,89,22,0,5.75,20.12,2476721,2476810
9273,84,18,1,6.10,13.90,2476809,2476893
9274,86,21,0,5.95,15.16,2476893,2476979
9275,69,22,1,7.42,21.43,2476978,2477047
9276,62,34,1,8.26,32.13,2477046,2477108
9277,64,41,0,8.00,44.41,2477107,2477171
9278,58,37,1,8.83,41.56,2477171,2477229
9279,65,33,0,7.88,44.26,2477229,2477294
9280,57,49,0,8.98,62.30,2477293,2477350
9281,70,23,1,7.31,20.19,2477349,2477419
9282,67,25,0,7.64,23.48,2477418,2477485
9283,66,27,2,7.76,22.94,2477484,2477550
9284,84,55,0,6.10,50.68,2477549,2477633
9285,56,40,0,9.14,40.80,2477632,2477688
9286,64,23,0,8.00,21.28,2477687,2477751
9287,76,26,0,6.74,28.67,2477750,2477826
9288,68,31,1,7.53,34.13,2477825,2477893
9289,76,46,0,6.74,42.25,2477892,2477968
9290,100,22,0,5.12,22.57,2477967,2478067
9291,78,28,0,6.56,36.84,2478067,2478145
9292,89,18,0,5.75,16.59,2478144,2478233
9293,68,84,1,7.53,111.84,2478232,2478300
9294,89,52,0,5.75,46.91,2478299,2478388
9295,75,37,0,6.83,30.62,2478387,2478462
9296,65,63,1,7.88,95.15,2478461,2478526
9297,74,18,0,6.92,19.91,2478526,2478600
9298,71,27,0,7.21,26.65,2478599,2478670
9299,65,20,0,7.88,21.95,2478669,2478734
9300,69,31,1,7.42,21.17,2478733,2478802
9301,71,20,0,7.21,21.49,2478801,2478872
9302,55,32,1,9.31,47.56,2478871,2478926
9303,59,78,1,8.68,101.78,2478925,2478984
9304,64,24,1,8.00,27.09,2478983,2479047
9305,89,21,0,5.75,17.80,2479046,2479135
9306,66,66,0,7.76,69.21,2479134,2479200
9307,60,22,1,8.53,22.68,2479199,2479259
9308,77,25,0,6.65,22.64,2479259,2479336
9309,68,23,1,7.53,24.46,2479335,2479403
9310,72,21,1,7.11,15.49,2479402,2479474
9311,83,23,0,6.17,20.07,2479473,2479556
9312,94,34,0,5.45,27.50,2479556,2479650
9313,84,41,0,6.10,35.68,2479650,2479734
9314,90,22,0,5.69,25.37,2479733,2479823
9315,81,23,1,6.32,17.58,2479822,2479903
9316,89,17,0,5.75,13.58,2479902,2479991
9317,86,21,0,5.95,16.56,2479990,2480076
9318,60,55,1,8.53,60.82,2480075,2480135
9319,67,35,1,7.64,33.93,2480134,2480201
9320,75,24,1,6.83,21.37,2480200,2480275
9321,79,23,1,6.48,15.92,2480274,2480353
9322,71,22,0,7.21,22.05,2480352,2480423
9323,67,27,1,7.64,26.92,2480422,2480489
9324,56,44,1,9.14,52.02,2480488,2480544
9325,70,17,0,7.31,17.84,2480544,2480614
9326,69,22,0,7.42,21.00,2480613,2480682
9327,68,51,0,7.53,73.75,2480681,2480749
9328,67,31,0,7.64,32.65,2480748,2480815
9329,56,55,0,9.14,76.02,2480814,2480870
9330,70,44,0,7.31,42.39,2480870,2480940
9331,62,40,1,8.26,56.29,2480939,2481001
9332,81,25,0,6.32,19.90,2481000,2481081
9333,99,30,0,5.17,22.08,2481080,2481179
9334,106,18,0,4.83,15.82,2481178,2481284
9335,84,18,1,6.10,16.01,2481283,2481367
9336,102,20,1,5.02,12.82,2481366,2481468
9337,90,26,1,5.69,15.44,2481467,2481557
9338,82,18,1,6.24,16.06,2481556,2481638
9339,65,40,1,7.88,38.72,2481637,2481702
9340,67,31,1,7.64,32.35,2481701,2481768
9341,72,24,1,7.11,25.90,2481767,2481839
9342,75,31,0,6.83,31.00,2481838,2481913
9343,62,24,0,8.26,24.74,2481912,2481974
9344,70,26,0,7.31,24.76,2481973,2482043
9345,61,30,1,8.39,34.57,2482042,2482103
9346,63,73,1,8.13,86.62,2482102,2482165
9347,74,17,0,6.92,16.91,2482164,2482238
9348,75,28,1,6.83,27.32,2482237,2482312
9349,79,25,0,6.48,25.36,2482311,2482390
9350,62,35,1,8.26,44.77,2482389,2482451
9351,61,36,0,8.39,41.58,2482451,2482512
9352,68,21,0,7.53,23.69,2482511,2482579
9353,69,32,0,7.42,42.97,2482578,2482647
9354,79,24,0,6.48,26.02,2482646,2482725
9355,70,27,0,7.31,36.19,2482724,2482794
9356,92,32,0,5.57,37.31,2482793,2482885
9357,93,38,0,5.51,26.10,2482884,2482977
9358,86,29,0,5.95,23.90,2482977,2483063
9359,87,21,0,5.89,14.81,2483062,2483149
9360,83,18,0,6.17,14.55,2483148,2483231
9361,64,41,1,8.00,45.91,2483230,2483294
9362,86,21,1,5.95,12.81,2483293,2483379
9363,64,27,0,8.00,30.97,2483378,2483442
9364,80,29,0,6.40,22.69,2483441,2483521
9365,62,34,1,8.26,41.00,2483520,2483582
9366,68,27,1,7.53,23.22,2483581,2483649
9367,60,32,0,8.53,39.98,2483648,2483708
9368,59,43,1,8.68,68.42,2483707,2483766
9369,92,23,1,5.57,17.35,2483765,2483857
9370,65,24,0,7.88,18.29,2483856,2483921
9371,56,86,1,9.14,142.34,2483920,2483976
9372,76,22,0,6.74,28.11,2483975,2484051
9373,64,29,0,8.00,38.53,2484050,2484114
9374,69,29,0,7.42,46.10,2484113,2484182
9375,94,24,0,5.45,26.18,2484181,2484275
9376,83,30,0,6.17,33.27,2484274,2484357
9377,73,36,1,7.01,40.18,2484356,2484429
9378,82,37,1,6.24,33.23,2484428,2484510
9379,73,53,1,7.01,65.52,2484510,2484583
9380,90,15,1,5.69,8.97,2484583,2484673
9381,84,40,0,6.10,29.37,2484672,2484756
9382,70,22,0,7.31,18.87,2484755,2484825
9383,70,27,0,7.31,32.82,2484824,2484894
9384,68,21,1,7.53,24.46,2484893,2484961
9385,78,24,1,6.56,22.09,2484960,2485038
9386,66,33,0,7.76,35.49,2485037,2485103
9387,59,43,2,8.68,55.03,2485102,2485161
9388,61,24,1,8.39,26.99,2485161,2485222
9389,52,102,1,9.85,202.36,2485221,2485273
9390,67,41,0,7.64,41.16,2485272,2485339
9391,91,19,0,5.63,16.92,2485338,2485429
9392,62,32,1,8.26,31.80,2485428,2485490
9393,77,21,0,6.65,19.08,2485490,2485567
9394,76,27,0,6.74,26.77,2485566,2485642
9395,74,27,0,6.92,35.56,2485642,2485716
9396,97,21,0,5.28,19.66,2485715,2485812
9397,96,26,0,5.33,26.35,2485811,2485907
9398,70,36,0,7.31,42.50,2485906,2485976
9399,79,31,1,6.48,27.09,2485975,2486054
9400,100,16,0,5.12,12.91,2486053,2486153
9401,90,21,0,5.69,15.39,2486152,2486242
9402,75,28,0,6.83,28.01,2486241,2486316
9403,77,27,1,6.65,22.67,2486315,2486392
9404,65,33,1,7.88,28.48,2486392,2486457
9405,82,22,1,6.24,17.77,2486456,2486538
9406,75,38,1,6.83,30.25,2486537,2486612
9407,69,37,0,7.42,38.85,2486611,2486680
9408,61,60,0,8.39,73.03,2486679,2486740
9409,66,17,1,7.76,15.70,2486739,2486805
9410,69,20,1,7.42,15.98,2486804,2486873
9411,78,24,1,6.56,24.27,2486872,2486950
9412,55,36,0,9.31,43.20,2486949,2487004
9413,70,35,0,7.31,41.10,2487004,2487074
9414,70,69,0,7.31,82.04,2487073,2487143
9415,49,26,0,10.45,54.25,2487142,2487191
9416,70,32,0,7.31,43.47,2487190,2487260
9417,101,45,0,5.07,32.26,2487259,2487360
9418,95,28,0,5.39,24.87,2487359,2487454
9419,78,23,0,6.56,24.19,2487453,2487531
9420,81,21,1,6.32,20.86,2487530,2487611
9421,85,26,0,6.02,37.62,2487611,2487696
9422,74,26,1,6.92,22.40,2487695,2487769
9423,81,21,1,6.32,21.28,2487768,2487849
9424,71,20,0,7.21,22.98,2487848,2487919
9425,61,24,1,8.39,26.14,2487918,2487979
9426,72,19,1,7.11,17.46,2487978,2488050
9427,69,27,1,7.42,24.79,2488049,2488118
9428,58,33,0,8.83,58.11,2488117,2488175
9429,67,25,1,7.64,31.45,2488174,2488241
9430,82,28,0,6.24,25.92,2488240,2488322
9431,76,16,0,6.74,15.40,2488321,2488397
9432,73,24,0,7.01,21.05,2488396,2488469
9433,67,39,1,7.64,52.59,2488468,2488535
9434,78,22,0,6.56,23.30,2488534,2488612
9435,108,18,0,4.74,15.32,2488611,2488719
9436,104,31,0,4.92,24.94,2488718,2488822
9437,90,25,0,5.69,20.33,2488821,2488911
9438,99,34,0,5.17,21.25,2488910,2489009
9439,72,21,0,7.11,23.43,2489008,2489080
9440,81,20,0,6.32,19.30,2489079,2489160
9441,73,24,0,7.01,23.19,2489159,2489232
9442,67,27,0,7.64,26.11,2489231,2489298
9443,76,27,1,6.74,23.48,2489298,2489374
9444,62,28,1,8.26,32.39,2489373,2489435
9445,58,32,1,8.83,37.97,2489434,2489492
9446,61,27,1,8.39,32.96,2489491,2489552
9447,65,43,1,7.88,72.51,2489551,2489616
9448,87,19,0,5.89,14.93,2489615,2489702
9449,64,24,1,8.00,28.97,2489702,2489766
9450,70,33,0,7.31,32.33,2489765,2489835
9451,74,22,1,6.92,26.18,2489834,2489908
9452,66,26,0,7.76,36.76,2489907,2489973
9453,64,41,0,8.00,35.75,2489972,2490036
9454,93,24,0,5.51,25.76,2490035,2490128
9455,57,89,0,8.98,150.23,2490127,2490184
9456,81,39,0,6.32,29.13,2490183,2490264
9457,88,38,1,5.82,28.97,2490263,2490351
9458,82,28,1,6.24,28.28,2490351,2490433
9459,92,21,0,5.57,15.55,2490432,2490524
9460,78,32,1,6.56,22.30,2490523,2490601
9461,55,37,1,9.31,58.47,2490600,2490655
9462,78,15,1,6.56,11.17,2490654,2490732
9463,71,28,0,7.21,25.04,2490731,2490802
9464,74,29,0,6.92,24.43,2490802,2490876
9465,57,32,0,8.98,33.21,2490876,2490933
9466,69,25,0,7.42,24.74,2490932,2491001
9467,67,28,1,7.64,24.62,2491000,2491067
9468,68,24,2,7.53,21.16,2491066,2491134
9469,66,25,1,7.76,22.37,2491133,2491199
9470,79,47,0,6.48,39.64,2491198,2491277
9471,61,27,2,8.39,19.68,2491276,2491337
9472,74,25,0,6.92,18.59,2491336,2491410
9473,79,30,0,6.48,24.88,2491409,2491488
9474,71,39,0,7.21,32.25,2491487,2491558
9475,75,26,0,6.83,28.65,2491557,2491632
9476,101,29,0,5.07,32.10,2491632,2491733
9477,108,20,0,4.74,15.06,2491732,2491840
9478,87,30,0,5.89,15.73,2491839,2491926
9479,94,21,0,5.45,16.29,2491926,2492020
9480,77,23,1,6.65,15.29,2492019,2492096
9481,63,76,1,8.13,108.24,2492096,2492159
9482,68,21,0,7.53,21.48,2492158,2492226
9483,56,88,2,9.14,135.91,2492226,2492282
9484,67,25,0,7.64,26.26,2492281,2492348
9485,77,17,1,6.65,12.38,2492347,2492424
9486,58,52,1,8.83,55.56,2492423,2492481
9487,67,20,1,7.64,23.72,2492480,2492547
9488,61,43,1,8.39,47.71,2492546,2492607
9489,62,29,0,8.26,35.68,2492606,2492668
9490,71,22,1,7.21,25.32,2492667,2492738
9491,88,19,1,5.82,14.29,2492737,2492825
9492,68,23,1,7.53,17.51,2492824,2492892
9493,60,29,1,8.53,37.38,2492891,2492951
9494,65,22,0,7.88,26.29,2492950,2493015
9495,72,23,0,7.11,30.52,2493014,2493086
9496,78,52,0,6.56,50.89,2493085,2493163
9497,86,53,0,5.95,49.81,2493162,2493248
9498,104,18,0,4.92,15.03,2493247,2493351
9499,97,22,1,5.28,13.13,2493350,2493447
9500,93,26,0,5.51,23.50,2493446,2493539
9501,87,16,0,5.89,12.03,2493538,2493625
9502,92,24,0,5.57,19.01,2493624,2493716
9503,76,20,0,6.74,18.98,2493716,2493792
9504,69,26,1,7.42,25.37,2493791,2493860
9505,65,30,1,7.88,20.35,2493860,2493925
9506,85,30,1,6.02,18.59,2493924,2494009
9507,59,49,1,8.68,66.15,2494008,2494067
9508,73,19,0,7.01,23.05,2494066,2494139
9509,50,63,1,10.24,85.50,2494138,2494188
9510,66,25,1,7.76,21.61,2494187,2494253
9511,65,60,1,7.88,65.58,2494252,2494317
9512,72,36,1,7.11,36.32,2494316,2494388
9513,76,19,1,6.74,15.35,2494387,2494463
9514,74,35,0,6.92,29.75,2494462,2494536
9515,63,44,0,8.13,61.41,2494535,2494598
9516,73,36,0,7.01,39.16,2494597,2494670
9517,88,38,0,5.82,30.13,2494669,2494757
9518,102,33,0,5.02,26.29,2494756,2494858
9519,77,27,0,6.65,25.40,2494857,2494934
9520,94,18,0,5.45,16.06,2494934,2495028
9521,86,21,1,5.95,14.79,2495027,2495113
9522,78,35,0,6.56,26.84,2495112,2495190
9523,76,33,1,6.74,31.54,2495189,2495265
9524,68,32,1,7.53,27.66,2495264,2495332
9525,66,22,1,7.76,20.37,2495332,2495398
9526,69,54,0,7.42,59.75,2495397,2495466
9527,64,35,1,8.00,41.44,2495465,2495529
9528,63,41,0,8.13,43.48,2495528,2495591
9529,67,22,0,7.64,25.99,2495590,2495657
9530,60,23,0,8.53,21.18,2495657,2495717
9531,82,21,0,6.24,20.21,2495716,2495798
9532,74,23,1,6.92,19.32,2495797,2495871
9533,81,20,0,6.32,21.45,2495870,2495951
9534,60,37,2,8.53,42.48,2495950,2496010
9535,70,39,0,7.31,43.47,2496009,2496079
9536,99,30,0,5.17,32.61,2496078,2496177
9537,101,20,0,5.07,15.97,2496176,2496277
9538,70,36,0,7.31,33.73,2496276,2496346
9539,86,38,0,5.95,27.58,2496345,2496431
9540,60,39,0,8.53,56.25,2496431,2496491
9541,78,26,1,6.56,18.02,2496490,2496568
9542,61,30,1,8.39,22.93,2496567,2496628
9543,74,28,1,6.92,29.86,2496627,2496701
9544,83,16,1,6.17,9.54,2496700,2496783
9545,62,49,0,8.26,61.80,2496782,2496844
9546,65,23,1,7.88,25.55,2496843,2496908
9547,62,41,1,8.26,50.16,2496907,2496969
9548,66,22,1,7.76,22.52,2496968,2497034
9549,77,21,1,6.65,20.85,2497033,2497110
9550,73,54,0,7.01,59.11,2497109,2497182
9551,58,38,1,8.83,50.94,2497181,2497239
9552,72,26,0,7.11,26.71,2497238,2497310
9553,78,22,0,6.56,21.63,2497309,2497387
9554,68,49,0,7.53,68.57,2497386,2497454
9555,87,36,0,5.89,31.34,2497453,2497540
9556,108,21,0,4.74,15.75,2497539,2497647
9557,78,18,1,6.56,17.78,2497646,2497724
9558,88,27,1,5.82,21.35,2497724,2497812
9559,89,59,0,5.75,51.87,2497811,2497900
9560,98,29,0,5.22,17.81,2497900,2497998
9561,73,24,1,7.01,26.92,2497997,2498070
9562,68,28,0,7.53,31.96,2498069,2498137
9563,54,42,1,9.48,48.95,2498136,2498190
9564,72,20,1,7.11,18.29,2498189,2498261
9565,78,35,0,6.56,25.07,2498260,2498338
9566,69,32,1,7.42,21.03,2498337,2498406
9567,68,36,1,7.53,36.40,2498405,2498473
9568,50,80,2,10.24,134.90,2498472,2498522
9569,55,35,1,9.31,44.32,2498521,2498576
9570,68,17,1,7.53,16.46,2498575,2498643
9571,79,20,0,6.48,17.39,2498642,2498721
9572,81,37,0,6.32,30.61,2498720,2498801
9573,80,28,0,6.40,25.66,2498800,2498880
9574,69,30,0,7.42,32.71,2498879,2498948
9575,54,55,0,9.48,113.62,2498947,2499001
9576,69,28,0,7.42,31.52,2499000,2499069
9577,66,31,0,7.76,39.76,2499068,2499134
9578,90,28,0,5.69,26.64,2499133,2499223
9579,88,26,0,5.82,21.85,2499223,2499311
9580,71,40,1,7.21,44.81,2499310,2499381
9581,100,30,0,5.12,20.11,2499380,2499480
9582,83,28,0,6.17,17.01,2499479,2499562
9583,73,20,0,7.01,16.92,2499561,2499634
9584,79,27,1,6.48,21.14,2499633,2499712
9585,72,28,0,7.11,24.32,2499712,2499784
9586,67,37,1,7.64,43.48,2499783,2499850
9587,65,32,1,7.88,28.17,2499849,2499914
9588,63,28,1,8.13,31.06,2499914,2499977
9589,60,27,0,8.53,34.85,2499976,2500036
9590,77,26,1,6.65,17.55,2500035,2500112
9591,77,49,0,6.65,53.60,2500111,2500188
9592,65,49,0,7.88,51.43,2500187,2500252
9593,57,42,1,8.98,77.56,2500251,2500308
9594,58,26,1,8.83,29.73,2500307,2500365
9595,90,29,1,5.69,17.39,2500364,2500454
9596,70,91,0,7.31,133.59,2500453,2500523
9597,55,25,1,9.31,34.90,2500522,2500577
9598,74,29,0,6.92,27.29,2500576,2500650
9599,77,25,0,6.65,30.64,2500649,2500726
9600,124,18,0,4.13,14.50,2500725,2500849
9601,80,19,0,6.40,19.01,2500848,2500928
9602,75,62,1,6.83,98.12,2500927,2501002
9603,87,17,0,5.89,15.14,2501001,2501088
9604,69,41,0,7.42,42.91,2501087,2501156
9605,68,50,0,7.53,55.54,2501155,2501223
9606,59,58,1,8.68,71.85,2501222,2501281
9607,69,19,0,7.42,18.24,2501281,2501350
9608,70,47,2,7.31,35.56,2501349,2501419
9609,89,21,0,5.75,12.37,2501418,2501507
9610,60,24,0,8.53,28.18,2501506,2501566
9611,68,25,0,7.53,25.63,2501565,2501633
9612,67,25,1,7.64,23.81,2501632,2501699
9613,77,29,0,6.65,22.46,2501698,2501775
9614,60,41,2,8.53,48.22,2501774,2501834
9615,66,30,1,7.76,35.76,2501833,2501899
9616,82,32,1,6.24,26.28,2501898,2501980
9617,66,25,0,7.76,26.73,2501979,2502045
9618,75,22,0,6.83,23.37,2502044,2502119
9619,82,28,0,6.24,33.53,2502118,2502200
9620,105,22,0,4.88,15.80,2502199,2502304
9621,79,49,1,6.48,46.48,2502303,2502382
9622,86,39,1,5.95,40.72,2502381,2502467
9623,76,26,1,6.74,26.38,2502466,2502542
9624,84,27,1,6.10,22.47,2502541,2502625
9625,53,109,1,9.66,228.19,2502624,2502677
9626,64,24,1,8.00,24.31,2502676,2502740
9627,71,23,1,7.21,20.84,2502739,2502810
9628,69,40,0,7.42,38.36,2502809,2502878
9629,69,39,0,7.42,40.94,2502878,2502947
9630,63,22,0,8.13,28.94,2502946,2503009
9631,65,56,1,7.88,65.86,2503009,2503074
9632,56,41,1,9.14,69.91,2503073,2503129
9633,78,28,0,6.56,25.71,2503128,2503206
9634,92,48,0,5.57,35.70,2503205,2503297
9635,57,43,1,8.98,51.49,2503296,2503353
9636,73,23,0,7.01,28.10,2503352,2503425
9637,67,42,0,7.64,41.04,2503424,2503491
9638,81,47,0,6.32,41.35,2503491,2503572
9639,87,32,0,5.89,35.66,2503571,2503658
9640,79,39,0,6.48,34.00,2503657,2503736
9641,74,28,0,6.92,26.91,2503735,2503809
9642,88,18,1,5.82,18.63,2503808,2503896
9643,83,31,0,6.17,19.97,2503895,2503978
9644,63,22,1,8.13,24.68,2503977,2504040
9645,66,21,1,7.76,20.18,2504040,2504106
9646,75,23,0,6.83,24.30,2504105,2504180
9647,69,28,1,7.42,23.87,2504179,2504248
9648,64,36,1,8.00,37.06,2504247,2504311
9649,61,33,0,8.39,39.62,2504310,2504371
9650,55,33,1,9.31,43.16,2504370,2504425
9651,64,60,1,8.00,58.59,2504424,2504488
9652,73,20,0,7.01,21.99,2504488,2504561
9653,76,45,0,6.74,46.80,2504560,2504636
9654,74,19,1,6.92,16.24,2504635,2504709
9655,59,47,0,8.68,59.03,2504709,2504768
9656,78,39,0,6.56,40.96,2504767,2504845
9657,66,24,1,7.76,28.85,2504844,2504910
9658,74,27,1,6.92,31.37,2504909,2504983
9659,99,31,0,5.17,27.96,2504982,2505081
9660,97,36,0,5.28,35.33,2505080,2505177
9661,91,35,0,5.63,26.67,2505176,2505267
9662,88,17,0,5.82,15.31,2505266,2505354
9663,82,29,0,6.24,30.26,2505353,2505435
9664,71,53,1,7.21,48.56,2505434,2505505
9665,67,29,1,7.64,30.80,2505504,2505571
9666,73,25,1,7.01,16.53,2505570,2505643
9667,63,42,1,8.13,56.33,2505642,2505705
9668,72,27,0,7.11,20.13,2505704,2505776
9669,63,37,1,8.13,33.38,2505776,2505839
9670,57,32,1,8.98,34.79,2505838,2505895
9671,69,23,1,7.42,21.35,2505895,2505964
9672,74,25,0,6.92,27.29,2505963,2506037
9673,67,29,0,7.64,30.41,2506037,2506104
9674,58,49,1,8.83,87.63,2506103,2506161
9675,62,66,1,8.26,119.03,2506160,2506222
9676,66,33,1,7.76,29.30,2506221,2506287
9677,71,38,0,7.21,40.96,2506286,2506357
9678,78,30,0,6.56,36.04,2506356,2506434
9679,101,23,0,5.07,16.84,2506433,2506534
9680,94,21,1,5.45,13.84,2506533,2506627
9681,72,53,1,7.11,45.18,2506626,2506698
9682,77,44,0,6.65,39.86,2506697,2506774
9683,68,36,0,7.53,33.66,2506773,2506841
9684,65,35,0,7.88,37.09,2506840,2506905
9685,70,28,0,7.31,31.59,2506904,2506974
9686,68,24,1,7.53,30.34,2506973,2507041
9687,77,33,1,6.65,25.08,2507041,2507118
9688,64,38,1,8.00,47.59,2507117,2507181
9689,64,23,0,8.00,25.19,2507180,2507244
9690,59,36,1,8.68,47.37,2507243,2507302
9691,76,63,0,6.74,60.93,2507301,2507377
9692,75,33,1,6.83,24.54,2507376,2507451
9693,68,48,1,7.53,45.69,2507450,2507518
9694,85,27,0,6.02,22.19,2507517,2507602
9695,68,23,0,7.53,23.31,2507601,2507669
9696,56,65,0,9.14,93.30,2507668,2507724
9697,71,47,0,7.21,55.58,2507723,2507794
9698,92,21,0,5.57,18.98,2507793,2507885
9699,91,22,0,5.63,23.25,2507884,2507975
9700,76,24,1,6.74,23.25,2507974,2508050
9701,79,38,0,6.48,38.45,2508050,2508129
9702,88,18,1,5.82,12.29,2508128,2508216
9703,62,129,0,8.26,268.39,2508215,2508277
9704,66,32,1,7.76,35.67,2508276,2508342
9705,64,37,1,8.00,37.53,2508341,2508405
9706,64,36,2,8.00,33.75,2508404,2508468
9707,71,28,0,7.21,20.19,2508467,2508538
9708,76,22,1,6.74,15.83,2508537,2508613
9709,78,17,1,6.56,16.22,2508612,2508690
9710,61,21,2,8.39,24.40,2508689,2508750
9711,62,29,1,8.26,34.06,2508749,2508811
9712,67,21,1,7.64,23.69,2508811,2508878
9713,78,27,0,6.56,26.14,2508877,2508955
9714,70,29,0,7.31,23.27,2508954,2509024
9715,54,30,2,9.48,42.95,2509023,2509077
9716,71,20,0,7.21,20.28,2509076,2509147
9717,73,39,0,7.01,31.74,2509146,2509219
9718,73,28,0,7.01,33.85,2509218,2509291
9719,78,21,0,6.56,21.66,2509290,2509368
9720,78,40,0,6.56,38.27,2509367,2509445
9721,89,17,0,5.75,17.35,2509444,2509533
9722,71,37,0,7.21,47.29,2509532,2509603
9723,88,24,1,5.82,14.88,2509602,2509690
9724,79,20,0,6.48,17.90,2509689,2509768
9725,66,38,1,7.76,37.79,2509767,2509833
9726,58,45,0,8.83,59.94,2509832,2509890
9727,76,21,1,6.74,21.17,2509889,2509965
9728,58,61,1,8.83,69.66,2509965,2510023
9729,67,38,1,7.64,39.42,2510022,2510089
9730,63,25,0,8.13,25.25,2510088,2510151
9731,66,24,1,7.76,19.43,2510151,2510217
9732,68,26,0,7.53,27.10,2510216,2510284
9733,72,23,1,7.11,15.29,2510283,2510355
9734,71,30,1,7.21,25.74,2510354,2510425
9735,64,26,0,8.00,22.28,2510424,2510488
9736,75,24,0,6.83,19.69,2510487,2510562
9737,75,30,0,6.83,33.18,2510561,2510636
9738,69,28,0,7.42,31.95,2510635,2510704
9739,69,59,0,7.42,78.79,2510703,2510772
9740,78,32,0,6.56,34.48,2510772,2510850
9741,97,50,0,5.28,39.64,2510849,2510946
9742,78,48,0,6.56,49.45,2510945,2511023
9743,97,15,0,5.28,11.77,2511022,2511119
9744,100,24,0,5.12,15.21,2511118,2511218
9745,83,21,1,6.17,19.10,2511217,2511300
9746,73,27,1,7.01,20.64,2511300,2511373
9747,65,24,1,7.88,22.75,2511372,2511437
9748,65,44,1,7.88,45.68,2511436,2511501
9749,73,29,0,7.01,33.00,2511500,2511573
9750,73,26,0,7.01,25.49,2511572,2511645
9751,61,23,1,8.39,22.93,2511644,2511705
9752,62,41,1,8.26,41.68,2511705,2511767
9753,83,29,0,6.17,26.77,2511766,2511849
9754,70,22,0,7.31,19.73,2511848,2511918
9755,67,29,1,7.64,37.33,2511917,2511984
9756,68,21,0,7.53,21.63,2511983,2512051
9757,77,42,0,6.65,49.47,2512050,2512127
9758,95,46,0,5.39,43.37,2512126,2512221
9759,90,22,0,5.69,17.79,2512220,2512310
9760,91,16,0,5.63,15.66,2512310,2512401
9761,74,20,0,6.92,23.59,2512400,2512474
9762,81,32,1,6.32,26.93,2512473,2512554
9763,65,33,1,7.88,38.63,2512553,2512618
9764,65,25,1,7.88,21.40,2512617,2512682
9765,73,22,2,7.01,16.67,2512681,2512754
9766,79,30,0,6.48,20.55,2512754,2512833
9767,62,36,2,8.26,40.16,2512832,2512894
9768,68,20,1,7.53,23.90,2512893,2512961
9769,88,26,0,5.82,14.31,2512960,2513048
9770,66,25,0,7.76,21.24,2513047,2513113
9771,66,39,1,7.76,32.70,2513112,2513178
9772,63,41,1,8.13,39.44,2513177,2513240
9773,72,41,0,7.11,42.65,2513239,2513311
9774,82,48,0,6.24,42.14,2513311,2513393
9775,87,26,0,5.89,34.93,2513392,2513479
9776,79,21,1,6.48,20.30,2513478,2513557
9777,87,19,1,5.89,15.87,2513556,2513643
9778,78,27,0,6.56,25.40,2513643,2513721
9779,86,38,0,5.95,25.72,2513720,2513806
9780,80,18,1,6.40,15.34,2513805,2513885
9781,56,48,1,9.14,73.84,2513884,2513940
9782,56,54,2,9.14,64.27,2513939,2513995
9783,53,48,1,9.66,85.96,2513995,2514048
9784,74,21,1,6.92,19.29,2514047,2514121
9785,68,26,1,7.53,26.81,2514120,2514188
9786,64,72,1,8.00,85.31,2514187,2514251
9787,50,26,1,10.24,38.54,2514250,2514300
9788,63,22,1,8.13,28.36,2514299,2514362
9789,67,38,0,7.64,51.99,2514361,2514428
9790,67,34,0,7.64,43.72,2514427,2514494
9791,90,37,0,5.69,34.35,2514493,2514583
9792,102,19,0,5.02,23.33,2514582,2514684
9793,81,54,0,6.32,47.70,2514683,2514764
9794,84,28,1,6.10,24.28,2514763,2514847
9795,82,23,0,6.24,23.77,2514846,2514928
9796,85,30,1,6.02,14.80,2514927,2515012
9797,71,18,1,7.21,15.80,2515011,2515082
9798,65,33,1,7.88,41.15,2515081,2515146
9799,68,21,1,7.53,22.63,2515145,2515213
9800,65,26,0,7.88,34.38,2515212,2515277
9801,69,23,0,7.42,30.27,2515276,2515345
9802,64,36,0,8.00,35.78,2515344,2515408
9803,54,73,2,9.48,145.51,2515407,2515461
9804,70,23,1,7.31,24.33,2515461,2515531
9805,62,43,1,8.26,48.51,2515530,2515592
9806,76,31,1,6.74,28.83,2515591,2515667
9807,65,25,0,7.88,29.89,2515666,2515731
9808,75,60,0,6.83,56.36,2515731,2515806
9809,84,35,0,6.10,34.09,2515805,2515889
9810,85,24,0,6.02,18.73,2515888,2515973
9811,93,19,0,5.51,17.95,2515972,2516065
9812,81,33,0,6.32,27.18,2516064,2516145
9813,76,19,0,6.74,22.83,2516144,2516220
9814,72,23,1,7.11,21.52,2516220,2516292
9815,77,25,0,6.65,20.25,2516291,2516368
9816,77,25,0,6.65,17.53,2516368,2516445
9817,71,30,0,7.21,27.88,2516444,2516515
9818,73,26,1,7.01,19.41,2516514,2516587
9819,75,20,0,6.83,15.13,2516586,2516661
9820,69,42,1,7.42,30.59,2516660,2516729
9821,80,19,0,6.40,19.29,2516728,2516808
9822,66,22,0,7.76,20.76,2516807,2516873
9823,71,22,1,7.21,21.35,2516873,2516944
9824,70,21,0,7.31,29.36,2516943,2517013
9825,92,23,0,5.57,18.12,2517013,2517105
9826,78,34,0,6.56,33.19,2517104,2517182
9827,115,25,0,4.45,19.71,2517181,2517296
9828,89,25,0,5.75,23.06,2517296,2517385
9829,77,59,1,6.65,56.62,2517385,2517462
9830,88,23,1,5.82,24.22,2517461,2517549
9831,72,20,1,7.11,18.71,2517548,2517620
9832,81,26,1,6.32,21.18,2517619,2517700
9833,63,34,2,8.13,39.44,2517699,2517762
9834,59,32,1,8.68,29.51,2517761,2517820
9835,62,35,0,8.26,44.22,2517819,2517881
9836,60,34,0,8.53,38.95,2517880,2517940
9837,58,77,1,8.83,104.35,2517939,2517997
9838,61,23,1,8.39,30.11,2517996,2518057
9839,77,19,1,6.65,14.95,2518056,2518133
9840,57,23,1,8.98,33.07,2518133,2518190
9841,64,20,1,8.00,25.66,2518189,2518253
9842,87,17,0,5.89,13.92,2518253,2518340
9843,69,35,1,7.42,28.82,2518339,2518408
9844,77,38,1,6.65,42.05,2518407,2518484
9845,55,29,0,9.31,45.09,2518483,2518538
9846,60,42,1,8.53,61.02,2518537,2518597
9847,78,30,0,6.56,29.89,2518596,2518674
9848,100,27,0,5.12,20.15,2518673,2518773
9849,93,31,0,5.51,30.92,2518773,2518866
9850,87,26,1,5.89,18.45,2518865,2518952
9851,86,22,1,5.95,20.90,2518951,2519037
9852,83,53,1,6.17,36.28,2519036,2519119
9853,89,17,0,5.75,10.77,2519118,2519207
9854,72,32,0,7.11,27.93,2519206,2519278
9855,69,18,0,7.42,21.03,2519277,2519346
9856,64,48,0,8.00,59.25,2519345,2519409
9857,71,19,0,7.21,18.76,2519408,2519479
9858,58,40,1,8.83,43.90,2519478,2519536
9859,73,25,0,7.01,18.89,2519535,2519608
9860,55,81,2,9.31,120.29,2519607,2519662
9861,63,23,1,8.13,22.87,2519661,2519724
9862,63,43,1,8.13,51.13,2519723,2519786
9863,69,49,0,7.42,63.37,2519785,2519854
9864,58,21,2,8.83,20.87,2519853,2519911
9865,73,25,1,7.01,26.10,2519910,2519983
9866,67,28,1,7.64,30.59,2519982,2520049
9867,69,23,1,7.42,20.71,2520049,2520118
9868,67,30,0,7.64,34.47,2520117,2520184
9869,90,42,0,5.69,32.61,2520183,2520273
9870,100,20,0,5.12,16.45,2520273,2520373
9871,86,23,1,5.95,22.90,2520372,2520458
9872,92,21,1,5.57,15.16,2520457,2520549
9873,84,31,1,6.10,25.25,2520549,2520633
9874,80,24,0,6.40,16.91,2520632,2520712
9875,75,26,1,6.83,25.21,2520711,2520786
9876,76,29,1,6.74,23.04,2520786,2520862
9877,65,26,1,7.88,26.11,2520861,2520926
9878,64,27,0,8.00,29.94,2520925,2520989
9879,65,21,0,7.88,20.54,2520988,2521053
9880,55,32,0,9.31,52.50,2521052,2521107
9881,54,43,1,9.48,78.29,2521106,2521160
9882,64,22,1,8.00,27.00,2521159,2521223
9883,79,18,0,6.48,16.35,2521222,2521301
9884,70,36,0,7.31,35.56,2521300,2521370
9885,58,49,1,8.83,68.28,2521369,2521427
9886,63,57,0,8.13,74.40,2521427,2521490
9887,71,24,0,7.21,24.11,2521489,2521560
9888,83,23,0,6.17,27.44,2521559,2521642
9889,95,35,0,5.39,29.65,2521641,2521736
9890,83,58,1,6.17,48.33,2521735,2521818
9891,83,32,0,6.17,24.55,2521817,2521900
9892,79,43,0,6.48,46.33,2521899,2521978
9893,73,44,1,7.01,35.52,2521977,2522050
9894,67,22,1,7.64,25.27,2522049,2522116
9895,75,38,1,6.83,25.96,2522115,2522190
9896,62,25,2,8.26,27.39,2522190,2522252
9897,65,26,0,7.88,32.60,2522251,2522316
9898,56,30,1,9.14,27.80,2522315,2522371
9899,69,39,1,7.42,31.29,2522370,2522439
9900,86,24,1,5.95,18.21,2522438,2522524
9901,75,21,0,6.83,21.42,2522524,2522599
9902,66,32,1,7.76,31.18,2522598,2522664
9903,77,33,0,6.65,29.08,2522663,2522740
9904,69,21,0,7.42,23.08,2522739,2522808
9905,76,32,0,6.74,44.54,2522807,2522883
9906,95,31,0,5.39,23.19,2522882,2522977
9907,105,23,0,4.88,18.24,2522976,2523081
9908,72,28,0,7.11,34.32,2523081,2523153
9909,71,99,0,7.21,135.94,2523152,2523223
9910,87,20,0,5.89,20.61,2523223,2523310
9911,90,28,0,5.69,17.06,2523309,2523399
9912,82,29,0,6.24,22.06,2523399,2523481
9913,67,35,0,7.64,30.41,2523480,2523547
9914,63,29,1,8.13,27.83,2523546,2523609
9915,60,34,1,8.53,46.78,2523608,2523668
9916,76,16,2,6.74,10.59,2523667,2523743
9917,79,28,0,6.48,24.27,2523743,2523822
9918,66,37,1,7.76,32.61,2523821,2523887
9919,73,21,1,7.01,15.74,2523887,2523960
9920,72,26,1,7.11,25.93,2523959,2524031
9921,67,45,1,7.64,67.69,2524030,2524097
9922,64,37,1,8.00,35.66,2524097,2524161
9923,68,21,0,7.53,20.93,2524160,2524228
9924,72,32,1,7.11,22.15,2524227,2524299
9925,73,26,0,7.01,24.67,2524298,2524371
9926,49,41,1,10.45,92.29,2524370,2524419
9927,83,35,0,6.17,36.24,2524418,2524501
9928,114,21,0,4.49,15.23,2524500,2524614
9929,88,23,1,5.82,16.15,2524614,2524702
9930,100,33,1,5.12,16.05,2524702,2524802
9931,83,28,0,6.17,24.16,2524801,2524884
9932,73,61,1,7.01,57.63,2524884,2524957
9933,85,23,0,6.02,14.89,2524956,2525041
9934,67,29,1,7.64,37.90,2525040,2525107
9935,69,34,1,7.42,32.07,2525106,2525175
9936,74,29,1,6.92,21.02,2525174,2525248
9937,59,29,1,8.68,43.34,2525247,2525306
9938,64,36,0,8.00,40.38,2525305,2525369
9939,66,20,1,7.76,15.85,2525368,2525434
9940,64,32,1,8.00,40.22,2525433,2525497
9941,79,34,0,6.48,34.58,2525496,2525575
9942,66,31,0,7.76,38.24,2525574,2525640
9943,70,23,1,7.31,22.73,2525639,2525709
9944,77,29,0,6.65,25.01,2525708,2525785
9945,76,18,1,6.74,14.33,2525784,2525860
9946,53,112,0,9.66,255.43,2525859,2525912
9947,81,29,0,6.32,24.29,2525911,2525992
9948,88,26,0,5.82,30.19,2525991,2526079
9949,94,31,0,5.45,25.33,2526078,2526172
9950,77,34,1,6.65,32.46,2526171,2526248
9951,76,44,0,6.74,58.46,2526247,2526323
9952,91,45,1,5.63,26.67,2526322,2526413
9953,80,22,1,6.40,16.64,2526412,2526492
9954,76,43,1,6.74,30.96,2526491,2526567
9955,65,28,0,7.88,23.98,2526566,2526631
9956,67,31,1,7.64,38.86,2526630,2526697
9957,66,24,0,7.76,24.97,2526696,2526762
9958,66,28,0,7.76,26.03,2526762,2526828
9959,67,33,1,7.64,30.53,2526827,2526894
9960,57,26,1,8.98,31.74,2526894,2526951
9961,72,38,0,7.11,39.49,2526950,2527022
9962,60,68,1,8.53,101.45,2527021,2527081
9963,58,39,1,8.83,46.76,2527080,2527138
9964,78,24,0,6.56,20.86,2527137,2527215
9965,71,25,1,7.21,21.38,2527214,2527285
9966,51,57,1,10.04,96.00,2527285,2527336
9967,76,52,0,6.74,50.96,2527336,2527412
9968,74,35,0,6.92,43.24,2527411,2527485
9969,81,37,0,6.32,37.43,2527484,2527565
9970,103,22,0,4.97,18.18,2527565,2527668
9971,83,23,1,6.17,16.43,2527667,2527750
9972,70,44,0,7.31,66.42,2527749,2527819
9973,76,20,0,6.74,22.46,2527818,2527894
9974,78,30,0,6.56,22.73,2527893,2527971
9975,66,31,0,7.76,26.67,2527970,2528036
9976,79,18,1,6.48,15.79,2528035,2528114
9977,58,28,1,8.83,39.11,2528114,2528172
9978,73,29,1,7.01,23.41,2528171,2528244
9979,63,36,1,8.13,33.22,2528243,2528306
9980,60,34,1,8.53,43.42,2528305,2528365
9981,62,40,2,8.26,29.48,2528364,2528426
9982,72,26,1,7.11,23.79,2528425,2528497
9983,76,20,1,6.74,19.09,2528496,2528572
9984,80,22,0,6.40,19.37,2528571,2528651
9985,77,20,1,6.65,19.92,2528650,2528727
9986,68,35,0,7.53,36.78,2528726,2528794
9987,59,22,1,8.68,29.95,2528793,2528852
9988,55,53,0,9.31,78.83,2528851,2528906
9989,76,27,0,6.74,30.09,2528905,2528981
9990,76,28,0,6.74,38.43,2528980,2529056
9991,107,23,0,4.79,20.45,2529055,2529162
9992,92,23,0,5.57,14.70,2529161,2529253
9993,103,26,0,4.97,14.75,2529252,2529355
9994,81,47,0,6.32,36.59,2529354,2529435
9995,71,39,1,7.21,40.50,2529435,2529506
9996,77,27,1,6.65,21.94,2529506,2529583
9997,62,35,2,8.26,38.64,2529583,2529645
9998,70,34,0,7.31,34.36,2529644,2529714
9999,66,22,0,7.76,21.24,2529713,2529779
10000,61,38,2,8.39,50.60,2529778,2529839
10001,67,45,1,7.64,55.21,2529838,2529905
10002,58,34,1,8.83,47.18,2529905,2529963
10003,72,37,1,7.11,27.32,2529962,2530034
10004,74,29,1,6.92,30.45,2530033,2530107
10005,59,36,1,8.68,44.69,2530106,2530165
10006,58,34,0,8.83,39.42,2530165,2530223
10007,64,28,0,8.00,40.09,2530222,2530286
10008,62,58,0,8.26,73.29,2530285,2530347
10009,69,28,0,7.42,33.49,2530346,2530415
10010,68,36,0,7.53,54.13,2530415,2530483
10011,108,30,0,4.74,19.14,2530482,2530590
10012,112,18,0,4.57,14.78,2530589,2530701
10013,84,21,0,6.10,18.47,2530701,2530785
10014,95,37,0,5.39,24.05,2530784,2530879
10015,82,26,0,6.24,23.33,2530878,2530960
10016,67,64,1,7.64,90.38,2530959,2531026
10017,71,35,1,7.21,37.38,2531025,2531096
10018,74,38,1,6.92,27.18,2531095,2531169
10019,69,30,1,7.42,28.10,2531169,2531238
10020,67,28,1,7.64,28.80,2531237,2531304
10021,58,55,2,8.83,63.97,2531303,2531361
10022,66,43,0,7.76,49.97,2531360,2531426
10023,50,24,2,10.24,39.58,2531425,2531475
10024,72,36,0,7.11,35.15,2531474,2531546
10025,62,25,0,8.26,27.26,2531546,2531608
10026,67,47,0,7.64,57.69,2531607,2531674
10027,68,34,1,7.53,29.51,2531673,2531741
10028,64,29,1,8.00,46.59,2531740,2531804
10029,65,44,1,7.88,49.98,2531803,2531868
10030,66,31,0,7.76,31.52,2531867,2531933
10031,68,30,0,7.53,42.16,2531933,2532001
10032,102,28,0,5.02,22.41,2532000,2532102
10033,105,32,0,4.88,26.91,2532101,2532206
10034,82,27,0,6.24,25.11,2532205,2532287
10035,88,20,0,5.82,15.47,2532286,2532374
10036,78,20,1,6.56,18.53,2532373,2532451
10037,77,21,0,6.65,19.53,2532450,2532527
10038,86,32,0,5.95,22.67,2532526,2532612
10039,79,18,1,6.48,14.63,2532612,2532691
10040,57,31,0,8.98,45.56,2532690,2532747
10041,64,41,1,8.00,47.19,2532746,2532810
10042,64,39,1,8.00,43.03,2532809,2532873
10043,64,36,0,8.00,41.44,2532872,2532936
10044,63,37,0,8.13,38.81,2532936,2532999
10045,67,41,0,7.64,39.27,2532998,2533065
10046,68,34,1,7.53,27.96,2533064,2533132
10047,78,32,0,6.56,28.94,2533131,2533209
10048,64,19,0,8.00,16.38,2533208,2533272
10049,72,30,0,7.11,29.15,2533271,2533343
10050,65,31,1,7.88,28.29,2533342,2533407
10051,55,30,1,9.31,37.85,2533406,2533461
10052,64,48,0,8.00,59.22,2533460,2533524
10053,88,27,0,5.82,27.13,2533523,2533611
10054,116,25,0,4.41,18.16,2533611,2533727
10055,84,47,1,6.10,33.92,2533727,2533811
10056,92,26,1,5.57,19.38,2533810,2533902
10057,72,48,1,7.11,48.52,2533901,2533973
10058,59,95,0,8.68,146.39,2533973,2534032
10059,78,31,0,6.56,24.99,2534031,2534109
10060,77,31,1,6.65,22.49,2534108,2534185
10061,59,33,1,8.68,37.98,2534184,2534243
10062,80,21,0,6.40,23.14,2534242,2534322
10063,64,20,1,8.00,17.31,2534322,2534386
10064,80,18,0,6.40,19.09,2534385,2534465
10065,64,29,1,8.00,27.34,2534465,2534529
10066,59,29,1,8.68,39.91,2534528,2534587
10067,82,18,0,6.24,15.23,2534587,2534669
10068,67,21,0,7.64,23.75,2534668,2534735
10069,64,26,2,8.00,30.44,2534734,2534798
10070,58,37,0,8.83,70.94,2534797,2534855
10071,53,57,0,9.66,110.26,2534854,2534907
10072,48,47,0,10.67,93.10,2534906,2534954
10073,67,52,0,7.64,61.51,2534953,2535020
10074,81,27,0,6.32,37.45,2535019,2535100
10075,91,45,0,5.63,44.81,2535099,2535190
10076,92,26,0,5.57,23.55,2535189,2535281
10077,91,26,1,5.63,24.54,2535280,2535371
10078,86,38,1,5.95,26.30,2535370,2535456
10079,93,27,0,5.51,17.63,2535455,2535548
10080,69,42,0,7.42,49.23,2535547,2535616
10081,72,69,0,7.11,78.04,2535615,2535687
10082,69,18,1,7.42,17.26,2535686,2535755
10083,84,39,0,6.10,28.97,2535754,2535838
10084,65,32,0,7.88,35.58,2535837,2535902
10085,55,48,1,9.31,86.43,2535901,2535956
10086,75,24,1,6.83,23.10,2535955,2536030
10087,65,37,1,7.88,39.98,2536029,2536094
10088,72,21,0,7.11,23.43,2536093,2536165
10089,77,29,1,6.65,21.81,2536164,2536241
10090,57,26,1,8.98,40.26,2536240,2536297
10091,68,29,0,7.53,36.40,2536296,2536364
10092,64,49,1,8.00,54.53,2536363,2536427
10093,62,25,1,8.26,29.42,2536426,2536488
10094,68,27,0,7.53,34.22,2536487,2536555
10095,74,61,0,6.92,59.02,2536554,2536628
10096,103,37,0,4.97,25.78,2536627,2536730
10097,87,36,0,5.89,29.55,2536729,2536816
10098,92,24,0,5.57,18.20,2536815,2536907
10099,91,23,1,5.63,13.42,2536907,2536998
10100,75,31,0,6.83,31.18,2536997,2537072
10101,78,33,0,6.56,42.45,2537071,2537149
10102,55,38,1,9.31,54.36,2537148,2537203
10103,70,19,0,7.31,17.24,2537202,2537272
10104,75,38,0,6.83,36.92,2537271,2537346
10105,62,34,0,8.26,39.90,2537345,2537407
10106,75,25,0,6.83,18.09,2537406,2537481
10107,67,48,0,7.64,46.02,2537480,2537547
10108,66,23,1,7.76,19.70,2537546,2537612
10109,74,22,0,6.92,16.80,2537611,2537685
10110,82,29,0,6.24,23.87,2537684,2537766
10111,77,22,1,6.65,15.99,2537765,2537842
10112,75,28,1,6.83,21.93,2537841,2537916
10113,62,62,0,8.26,94.84,2537915,2537977
10114,69,44,1,7.42,44.04,2537976,2538045
10115,76,26,0,6.74,28.04,2538044,2538120
10116,101,33,0,5.07,27.00,2538119,2538220
10117,85,30,0,6.02,28.47,2538219,2538304
10118,84,30,0,6.10,26.54,2538303,2538387
10119,94,28,1,5.45,18.12,2538386,2538480
10120,84,22,1,6.10,17.40,2538480,2538564
10121,83,29,0,6.17,31.06,2538563,2538646
10122,67,45,1,7.64,39.24,2538645,2538712
10123,62,29,1,8.26,33.55,2538711,2538773
10124,63,30,1,8.13,36.68,2538772,2538835
10125,66,22,1,7.76,22.09,2538835,2538901
10126,61,29,0,8.39,36.27,2538900,2538961
10127,65,26,1,7.88,30.60,2538961,2539026
10128,73,26,1,7.01,21.25,2539025,2539098
10129,71,18,2,7.21,14.96,2539097,2539168
10130,79,20,0,6.48,17.95,2539167,2539246
10131,62,24,1,8.26,28.22,2539245,2539307
10132,67,37,1,7.64,44.14,2539306,2539373
10133,72,40,0,7.11,42.77,2539372,2539444
10134,57,26,1,8.98,39.49,2539443,2539500
10135,56,50,0,9.14,82.98,2539499,2539555
10136,70,42,1,7.31,34.13,2539554,2539624
10137,78,62,0,6.56,79.37,2539624,2539702
10138,96,29,0,5.33,27.68,2539701,2539797
10139,89,22,0,5.75,14.19,2539796,2539885
10140,91,22,0,5.63,14.83,2539884,2539975
10141,90,31,0,5.69,22.66,2539974,2540064
10142,90,14,1,5.69,10.86,2540063,2540153
10143,70,70,0,7.31,75.07,2540153,2540223
10144,82,16,0,6.24,11.92,2540222,2540304
10145,59,32,1,8.68,52.93,2540304,2540363
10146,68,37,1,7.53,46.96,2540362,2540430
10147,67,26,1,7.64,28.86,2540429,2540496
10148,58,41,0,8.83,55.90,2540495,2540553
10149,72,28,1,7.11,20.77,2540552,2540624
10150,60,64,1,8.53,70.55,2540623,2540683
10151,68,20,1,7.53,18.48,2540682,2540750
10152,80,19,1,6.40,18.01,2540749,2540829
10153,71,25,1,7.21,22.34,2540828,2540899
10154,64,28,0,8.00,31.53,2540898,2540962
10155,60,32,0,8.53,61.32,2540961,2541021
10156,61,44,1,8.39,48.83,2541020,2541081
10157,69,66,0,7.42,91.06,2541080,2541149
10158,96,27,0,5.33,25.64,2541148,2541244
10159,105,21,0,4.88,15.69,2541243,2541348
10160,84,23,0,6.10,17.82,2541348,2541432
10161,94,23,0,5.45,19.55,2541431,2541525
10162,90,21,0,5.69,17.15,2541524,2541614
10163,69,28,0,7.42,35.90,2541613,2541682
10164,62,53,0,8.26,92.77,2541681,2541743
10165,65,25,1,7.88,23.65,2541742,2541807
10166,64,23,1,8.00,20.41,2541806,2541870
10167,69,23,1,7.42,19.14,2541869,2541938
10168,56,34,2,9.14,43.55,2541937,2541993
10169,56,44,1,9.14,54.66,2541992,2542048
10170,63,22,0,8.13,29.73,2542048,2542111
10171,69,33,0,7.42,27.72,2542110,2542179
10172,75,19,1,6.83,18.33,2542178,2542253
10173,74,24,0,6.92,22.34,2542252,2542326
10174,76,17,1,6.74,16.56,2542325,2542401
10175,68,51,0,7.53,74.57,2542400,2542468
10176,57,44,1,8.98,55.70,2542468,2542525
10177,64,23,0,8.00,35.88,2542525,2542589
10178,71,42,0,7.21,38.76,2542588,2542659
10179,98,23,0,5.22,16.64,2542658,2542756
10180,105,22,0,4.88,20.28,2542755,2542860
10181,77,42,1,6.65,50.57,2542859,2542936
10182,81,26,0,6.32,20.42,2542935,2543016
10183,76,37,0,6.74,41.01,2543015,2543091
10184,77,29,0,6.65,23.08,2543090,2543167
10185,74,25,0,6.92,26.16,2543166,2543240
10186,74,25,1,6.92,18.18,2543239,2543313
10187,72,21,0,7.11,19.40,2543313,2543385
10188,69,19,0,7.42,17.06,2543384,2543453
10189,64,22,1,8.00,22.88,2543452,2543516
10190,76,43,1,6.74,32.43,2543515,2543591
10191,65,34,1,7.88,44.85,2543590,2543655
10192,53,24,1,9.66,32.83,2543655,2543708
10193,78,19,0,6.56,17.63,2543707,2543785
10194,77,18,0,6.65,24.25,2543784,2543861
10195,42,58,0,12.19,142.96,2543861,2543903
10196,67,24,1,7.64,29.84,2543902,2543969
10197,76,25,0,6.74,32.80,2543969,2544045
10198,84,33,0,6.10,30.75,2544044,2544128
10199,79,29,1,6.48,31.41,2544127,2544206
10200,111,17,0,4.61,12.36,2544205,2544316
10201,74,38,0,6.92,34.02,2544315,2544389
10202,82,22,1,6.24,20.14,2544388,2544470
10203,66,22,1,7.76,20.43,2544469,2544535
10204,61,58,1,8.39,63.94,2544534,2544595
10205,70,22,1,7.31,22.64,2544594,2544664
10206,68,27,0,7.53,28.16,2544664,2544732
10207,67,33,0,7.64,36.44,2544731,2544798
10208,55,41,2,9.31,65.56,2544797,2544852
10209,48,46,1,10.67,96.76,2544851,2544899
10210,67,23,1,7.64,24.05,2544899,2544966
10211,65,20,0,7.88,25.55,2544966,2545031
10212,54,22,2,9.48,31.25,2545030,2545084
10213,69,36,1,7.42,30.33,2545084,2545153
10214,57,24,1,8.98,33.39,2545152,2545209
10215,46,130,0,11.13,351.64,2545208,2545254
10216,69,41,0,7.42,51.75,2545254,2545323
10217,52,83,0,9.85,164.67,2545323,2545375
10218,103,22,0,4.97,20.51,2545374,2545477
10219,91,25,0,5.63,29.20,2545477,2545568
10220,73,31,1,7.01,29.14,2545567,2545640
10221,82,38,0,6.24,32.26,2545639,2545721
10222,96,35,1,5.33,26.12,2545720,2545816
10223,75,64,1,6.83,57.29,2545815,2545890
10224,67,32,0,7.64,35.78,2545889,2545956
10225,63,26,1,8.13,32.30,2545955,2546018
10226,60,20,0,8.53,23.25,2546017,2546077
10227,72,26,1,7.11,19.43,2546076,2546148
10228,69,24,1,7.42,21.49,2546147,2546216
10229,67,46,1,7.64,39.48,2546215,2546282
10230,71,22,0,7.21,26.28,2546281,2546352
10231,61,29,1,8.39,32.24,2546351,2546412
10232,72,20,0,7.11,17.57,2546411,2546483
10233,69,26,0,7.42,30.13,2546482,2546551
10234,64,21,0,8.00,24.19,2546550,2546614
10235,61,28,1,8.39,39.68,2546613,2546674
10236,77,42,0,6.65,45.68,2546673,2546750
10237,51,39,1,10.04,75.06,2546749,2546800
10238,69,64,0,7.42,71.20,2546799,2546868
10239,91,24,0,5.63,20.59,2546867,2546958
10240,91,37,0,5.63,37.22,2546957,2547048
10241,96,42,0,5.33,34.60,2547047,2547143
10242,88,17,0,5.82,15.42,2547142,2547230
10243,71,113,0,7.21,184.84,2547229,2547300
10244,83,35,0,6.17,25.63,2547299,2547382
10245,65,22,0,7.88,24.85,2547381,2547446
10246,76,31,1,6.74,24.90,2547445,2547521
10247,69,26,1,7.42,25.14,2547520,2547589
10248,64,25,2,8.00,19.25,2547588,2547652
10249,67,25,0,7.64,26.23,2547651,2547718
10250,72,46,1,7.11,39.99,2547717,2547789
10251,77,24,1,6.65,24.36,2547788,2547865
10252,60,23,0,8.53,32.02,2547864,2547924
10253,60,36,1,8.53,52.55,2547923,2547983
10254,71,28,1,7.21,21.32,2547982,2548053
10255,74,38,1,6.92,30.72,2548052,2548126
10256,59,32,1,8.68,35.44,2548126,2548185
10257,75,21,0,6.83,25.02,2548184,2548259
10258,55,29,1,9.31,44.29,2548258,2548313
10259,59,33,0,8.68,41.64,2548313,2548372
10260,73,26,0,7.01,41.27,2548372,2548445
10261,79,21,0,6.48,21.39,2548444,2548523
10262,102,40,0,5.02,38.18,2548522,2548624
10263,79,29,1,6.48,21.11,2548624,2548703
10264,88,30,1,5.82,22.94,2548702,2548790
10265,77,33,0,6.65,26.54,2548789,2548866
10266,81,24,0,6.32,19.77,2548865,2548946
10267,72,80,1,7.11,130.38,2548945,2549017
10268,68,30,0,7.53,32.66,2549016,2549084
10269,58,58,0,8.83,92.80,2549083,2549141
10270,76,39,1,6.74,24.48,2549140,2549216
10271,56,27,1,9.14,35.84,2549215,2549271
10272,56,40,0,9.14,54.84,2549270,2549326
10273,63,26,0,8.13,31.19,2549325,2549388
10274,64,39,1,8.00,30.78,2549387,2549451
10275,68,19,0,7.53,21.87,2549450,2549518
10276,79,39,0,6.48,33.41,2549517,2549596
10277,73,32,1,7.01,23.27,2549595,2549668
10278,57,45,1,8.98,60.47,2549667,2549724
10279,65,47,1,7.88,59.31,2549723,2549788
10280,57,29,1,8.98,41.98,2549787,2549844
10281,74,29,0,6.92,24.37,2549843,2549917
10282,80,26,0,6.40,28.81,2549917,2549997
10283,75,38,0,6.83,67.72,2549996,2550071
10284,93,26,0,5.51,21.97,2550070,2550163
10285,78,38,0,6.56,43.60,2550162,2550240
10286,87,48,0,5.89,38.79,2550239,2550326
10287,91,26,0,5.63,17.82,2550325,2550416
10288,71,32,0,7.21,30.59,2550415,2550486
10289,64,58,1,8.00,72.78,2550485,2550549
10290,75,30,1,6.83,29.18,2550548,2550623
10291,66,57,1,7.76,62.40,2550622,2550688
10292,72,18,1,7.11,14.35,2550687,2550759
10293,71,26,2,7.21,22.00,2550758,2550829
10294,72,26,1,7.11,26.60,2550828,2550900
10295,56,74,1,9.14,96.30,2550899,2550955
10296,79,23,0,6.48,22.78,2550954,2551033
10297,84,40,0,6.10,30.35,2551032,2551116
10298,57,39,1,8.98,41.39,2551115,2551172
10299,71,35,0,7.21,38.53,2551171,2551242
10300,72,22,0,7.11,24.99,2551241,2551313
10301,60,28,1,8.53,32.72,2551313,2551373
10302,62,43,0,8.26,48.29,2551372,2551434
10303,79,29,0,6.48,35.72,2551434,2551513
10304,114,26,0,4.49,14.71,2551512,2551626
10305,88,38,0,5.82,31.47,2551626,2551714
10306,81,39,1,6.32,31.45,2551713,2551794
10307,89,23,0,5.75,16.10,2551794,2551883
10308,87,21,1,5.89,16.12,2551882,2551969
10309,64,31,0,8.00,48.50,2551969,2552033
10310,65,26,1,7.88,28.57,2552032,2552097
10311,80,17,0,6.40,11.24,2552096,2552176
10312,80,20,0,6.40,17.94,2552175,2552255
10313,63,42,1,8.13,47.67,2552254,2552317
10314,60,38,0,8.53,45.15,2552316,2552376
10315,65,31,1,7.88,28.35,2552375,2552440
10316,70,28,0,7.31,24.56,2552439,2552509
10317,68,26,1,7.53,23.25,2552508,2552576
10318,78,32,0,6.56,33.81,2552575,2552653
10319,63,27,1,8.13,45.29,2552652,2552715
10320,72,29,0,7.11,34.65,2552714,2552786
10321,100,31,0,5.12,22.79,2552786,2552886
10322,87,31,0,5.89,20.38,2552885,2552972
10323,70,49,0,7.31,65.62,2552971,2553041
10324,82,38,0,6.24,28.65,2553040,2553122
10325,77,21,1,6.65,24.85,2553121,2553198
10326,73,49,0,7.01,58.89,2553197,2553270
10327,61,57,1,8.39,57.12,2553269,2553330
10328,61,38,1,8.39,39.78,2553329,2553390
10329,78,18,0,6.56,13.25,2553389,2553467
10330,65,36,1,7.88,59.18,2553466,2553531
10331,69,18,0,7.42,18.74,2553530,2553599
10332,63,45,1,8.13,45.67,2553598,2553661
10333,63,36,1,8.13,31.35,2553661,2553724
10334,62,54,1,8.26,77.22,2553723,2553785
10335,61,37,1,8.39,49.71,2553784,2553845
10336,68,52,1,7.53,65.87,2553844,2553912
10337,74,23,1,6.92,23.59,2553912,2553986
10338,75,17,0,6.83,15.45,2553985,2554060
10339,67,32,1,7.64,36.86,2554059,2554126
10340,68,39,0,7.53,46.84,2554125,2554193
10341,76,34,0,6.74,50.22,2554193,2554269
10342,95,43,0,5.39,31.71,2554268,2554363
10343,83,23,0,6.17,23.66,2554363,2554446
10344,82,26,0,6.24,19.01,2554445,2554527
10345,82,39,0,6.24,30.16,2554526,2554608
10346,79,15,0,6.48,14.53,2554607,2554686
10347,75,38,1,6.83,24.78,2554685,2554760
10348,71,28,0,7.21,36.70,2554759,2554830
10349,65,42,1,7.88,37.71,2554829,2554894
10350,70,20,1,7.31,21.67,2554893,2554963
10351,64,49,0,8.00,48.59,2554962,2555026
10352,59,46,1,8.68,53.91,2555025,2555084
10353,58,39,1,8.83,56.69,2555083,2555141
10354,74,24,0,6.92,25.10,2555140,2555214
10355,62,21,1,8.26,19.77,2555213,2555275
10356,61,24,1,8.39,25.88,2555274,2555335
10357,59,25,1,8.68,30.22,2555334,2555393
10358,73,23,1,7.01,26.86,2555392,2555465
10359,58,30,2,8.83,33.63,2555464,2555522
10360,71,24,1,7.21,18.36,2555521,2555592
10361,87,24,0,5.89,18.84,2555591,2555678
10362,65,36,0,7.88,46.05,2555678,2555743
10363,54,47,1,9.48,58.88,2555742,2555796
10364,56,45,0,9.14,84.19,2555795,2555851
10365,83,27,0,6.17,26.26,2555850,2555933
10366,118,20,0,4.34,13.55,2555932,2556050
10367,88,42,0,5.82,37.67,2556049,2556137
10368,88,21,0,5.82,19.40,2556136,2556224
10369,85,18,0,6.02,14.21,2556223,2556308
10370,82,27,0,6.24,22.21,2556308,2556390
10371,66,29,1,7.76,21.43,2556389,2556455
10372,71,25,0,7.21,24.48,2556455,2556526
10373,66,23,0,7.76,22.21,2556525,2556591
10374,68,29,0,7.53,30.31,2556590,2556658
10375,72,21,0,7.11,20.82,2556657,2556729
10376,63,26,0,8.13,33.13,2556728,2556791
10377,78,23,1,6.56,20.09,2556790,2556868
10378,60,22,1,8.53,23.35,2556867,2556927
10379,68,35,1,7.53,35.31,2556926,2556994
10380,56,43,2,9.14,55.55,2556993,2557049
10381,81,24,0,6.32,18.34,2557048,2557129
10382,81,22,0,6.32,24.02,2557128,2557209
10383,60,34,0,8.53,46.05,2557208,2557268
10384,64,27,1,8.00,39.19,2557267,2557331
10385,67,28,0,7.64,26.14,2557331,2557398
10386,61,61,0,8.39,125.32,2557397,2557458
10387,80,24,0,6.40,21.19,2557457,2557537
10388,91,18,0,5.63,23.75,2557536,2557627
10389,89,18,0,5.75,18.39,2557626,2557715
10390,75,19,1,6.83,19.18,2557714,2557789
10391,91,27,1,5.63,21.84,2557788,2557879
10392,86,26,0,5.95,17.11,2557879,2557965
10393,73,42,0,7.01,39.05,2557964,2558037
10394,58,51,0,8.83,78.14,2558036,2558094
10395,56,42,1,9.14,51.19,2558093,2558149
10396,73,25,1,7.01,27.99,2558148,2558221
10397,64,34,1,8.00,34.69,2558220,2558284
10398,66,30,1,7.76,25.70,2558283,2558349
10399,67,56,1,7.64,58.38,2558348,2558415
10400,54,28,1,9.48,39.66,2558415,2558469
10401,58,33,3,8.83,30.32,2558469,2558527
10402,70,23,1,7.31,24.53,2558526,2558596
10403,74,23,0,6.92,21.56,2558595,2558669
10404,52,28,1,9.85,39.67,2558669,2558721
10405,62,57,1,8.26,60.97,2558721,2558783
10406,69,21,1,7.42,23.35,2558782,2558851
10407,76,29,0,6.74,29.43,2558850,2558926
10408,59,38,1,8.68,57.61,2558925,2558984
10409,70,24,0,7.31,31.07,2558984,2559054
10410,67,63,1,7.64,77.87,2559053,2559120
10411,110,25,0,4.65,25.46,2559119,2559229
10412,86,25,0,5.95,31.42,2559228,2559314
10413,77,23,1,6.65,20.49,2559313,2559390
10414,84,32,0,6.10,27.71,2559389,2559473
10415,90,30,0,5.69,16.53,2559472,2559562
10416,86,22,0,5.95,21.79,2559561,2559647
10417,55,24,1,9.31,35.96,2559646,2559701
10418,67,32,1,7.64,36.92,2559700,2559767
10419,81,17,0,6.32,18.69,2559766,2559847
10420,67,44,0,7.64,35.39,2559847,2559914
10421,71,32,0,7.21,28.11,2559913,2559984
10422,68,28,2,7.53,24.48,2559983,2560051
10423,66,27,1,7.76,20.70,2560050,2560116
10424,68,24,1,7.53,31.48,2560115,2560183
10425,69,18,1,7.42,14.53,2560182,2560251
10426,72,30,0,7.11,23.74,2560250,2560322
10427,64,27,1,8.00,23.88,2560322,2560386
10428,52,71,1,9.85,105.63,2560385,2560437
10429,70,22,1,7.31,24.76,2560436,2560506
10430,62,52,1,8.26,49.74,2560505,2560567
10431,56,34,1,9.14,48.05,2560566,2560622
10432,79,24,0,6.48,26.53,2560621,2560700
10433,94,22,0,5.45,23.95,2560699,2560793
10434,111,21,0,4.61,16.69,2560792,2560903
10435,74,36,1,6.92,45.07,2560902,2560976
10436,83,27,0,6.17,20.81,2560976,2561059
10437,73,55,0,7.01,58.73,2561058,2561131
10438,70,28,0,7.31,28.27,2561130,2561200
10439,89,17,0,5.75,12.34,2561200,2561289
10440,71,31,1,7.21,27.94,2561288,2561359
10441,66,39,1,7.76,38.85,2561358,2561424
10442,66,24,1,7.76,26.12,2561423,2561489
10443,70,24,1,7.31,24.24,2561489,2561559
10444,58,46,1,8.83,67.94,2561558,2561616
10445,70,23,1,7.31,21.50,2561616,2561686
10446,57,36,2,8.98,41.67,2561685,2561742
10447,75,41,1,6.83,29.74,2561741,2561816
10448,67,19,2,7.64,17.66,2561815,2561882
10449,71,64,0,7.21,70.14,2561881,2561952
10450,68,24,1,7.53,24.60,2561951,2562019
10451,46,88,1,11.13,166.72,2562018,2562064
10452,59,44,0,8.68,73.37,2562063,2562122
10453,61,32,0,8.39,47.45,2562121,2562182
10454,58,93,0,8.83,147.52,2562181,2562239
10455,79,25,0,6.48,24.35,2562239,2562318
10456,78,52,0,6.56,39.53,2562317,2562395
10457,98,24,0,5.22,30.28,2562394,2562492
10458,69,54,0,7.42,64.71,2562491,2562560
10459,84,22,0,6.10,17.97,2562560,2562644
10460,79,31,1,6.48,26.60,2562643,2562722
10461,79,54,0,6.48,45.39,2562721,2562800
10462,83,39,0,6.17,27.54,2562799,2562882
10463,57,24,2,8.98,29.03,2562881,2562938
10464,61,54,2,8.39,53.35,2562937,2562998
10465,80,18,0,6.40,17.19,2562997,2563077
10466,72,21,1,7.11,22.96,2563076,2563148
10467,64,51,1,8.00,61.62,2563147,2563211
10468,71,24,0,7.21,26.50,2563210,2563281
10469,54,33,1,9.48,49.29,2563280,2563334
10470,66,29,1,7.76,27.94,2563333,2563399
10471,79,21,1,6.48,14.93,2563398,2563477
10472,70,67,0,7.31,99.70,2563476,2563546
10473,52,38,2,9.85,51.86,2563545,2563597
10474,71,35,0,7.21,38.14,2563596,2563667
10475,75,24,0,6.83,30.25,2563666,2563741
10476,65,24,0,7.88,21.86,2563740,2563805
10477,61,62,0,8.39,76.14,2563804,2563865
10478,70,32,1,7.31,40.22,2563864,2563934
10479,102,23,0,5.02,20.61,2563933,2564035
10480,108,26,0,4.74,17.99,2564034,2564142
10481,79,29,1,6.48,30.12,2564141,2564220
10482,82,46,0,6.24,33.09,2564219,2564301
10483,81,45,0,6.32,35.97,2564300,2564381
10484,79,17,0,6.48,10.45,2564380,2564459
10485,79,18,0,6.48,16.12,2564459,2564538
10486,61,27,2,8.39,32.89,2564537,2564598
10487,72,21,1,7.11,22.68,2564597,2564669
10488,65,25,1,7.88,28.82,2564669,2564734
10489,60,39,1,8.53,50.72,2564733,2564793
10490,62,31,0,8.26,55.19,2564792,2564854
10491,61,35,0,8.39,38.44,2564853,2564914
10492,65,20,1,7.88,14.75,2564913,2564978
10493,65,22,0,7.88,23.77,2564977,2565042
10494,79,21,0,6.48,18.76,2565041,2565120
10495,71,25,0,7.21,30.42,2565120,2565191
10496,63,23,1,8.13,25.83,2565190,2565253
10497,70,29,1,7.31,30.79,2565252,2565322
10498,63,42,1,8.13,64.59,2565321,2565384
10499,52,51,1,9.85,87.21,2565383,2565435
10500,76,23,0,6.74,25.48,2565434,2565510
10501,82,44,0,6.24,31.77,2565509,2565591
10502,94,19,0,5.45,19.33,2565590,2565684
10503,96,24,0,5.33,21.53,2565683,2565779
10504,91,32,0,5.63,23.51,2565778,2565869
10505,86,23,0,5.95,24.39,2565868,2565954
10506,79,20,0,6.48,26.43,2565953,2566032
10507,77,25,0,6.65,23.55,2566031,2566108
10508,68,29,2,7.53,31.54,2566107,2566175
10509,70,24,0,7.31,24.33,2566174,2566244
10510,73,28,1,7.01,25.68,2566243,2566316
10511,58,36,0,8.83,49.07,2566315,2566373
10512,71,23,0,7.21,21.83,2566372,2566443
10513,63,30,1,8.13,37.00,2566442,2566505
10514,73,28,1,7.01,24.42,2566504,2566577
10515,71,36,0,7.21,42.70,2566576,2566647
10516,56,49,1,9.14,56.27,2566646,2566702
10517,72,26,0,7.11,34.15,2566702,2566774
10518,68,37,0,7.53,52.37,2566773,2566841
10519,66,24,1,7.76,28.85,2566840,2566906
10520,65,32,0,7.88,34.35,2566906,2566971
10521,102,32,0,5.02,22.51,2566970,2567072
10522,96,18,0,5.33,14.62,2567071,2567167
10523,92,21,0,5.57,15.83,2567167,2567259
10524,82,44,0,6.24,33.96,2567258,2567340
10525,82,19,0,6.24,15.60,2567339,2567421
10526,75,18,1,6.83,15.80,2567421,2567496
10527,54,56,0,9.48,63.36,2567495,2567549
10528,72,22,0,7.11,20.60,2567548,2567620
10529,70,27,2,7.31,26.42,2567619,2567689
10530,68,34,0,7.53,39.31,2567688,2567756
10531,78,31,1,6.56,21.99,2567755,2567833
10532,53,49,1,9.66,72.79,2567832,2567885
10533,70,20,0,7.31,21.42,2567884,2567954
10534,62,36,1,8.26,35.32,2567953,2568015
10535,82,39,0,6.24,33.26,2568014,2568096
10536,63,22,0,8.13,22.08,2568095,2568158
10537,64,50,1,8.00,76.28,2568157,2568221
10538,79,31,0,6.48,35.41,2568220,2568299
10539,66,42,0,7.76,56.03,2568298,2568364
10540,75,37,0,6.83,35.72,2568363,2568438
10541,83,20,0,6.17,23.32,2568437,2568520
10542,107,25,0,4.79,18.11,2568519,2568626
10543,93,21,0,5.51,19.50,2568625,2568718
10544,63,69,0,8.13,105.76,2568717,2568780
10545,80,26,1,6.40,24.91,2568779,2568859
10546,74,28,0,6.92,28.24,2568858,2568932
10547,65,36,1,7.88,41.25,2568931,2568996
10548,76,18,0,6.74,18.09,2568995,2569071
10549,60,47,1,8.53,70.82,2569070,2569130
10550,66,26,1,7.76,23.52,2569129,2569195
10551,65,30,1,7.88,26.29,2569194,2569259
10552,51,28,2,10.04,39.37,2569258,2569309
10553,70,22,1,7.31,21.27,2569308,2569378
10554,53,46,2,9.66,60.15,2569377,2569430
10555,67,25,1,7.64,23.01,2569429,2569496
10556,65,45,0,7.88,47.83,2569496,2569561
10557,57,44,0,8.98,66.58,2569561,2569618
10558,78,17,0,6.56,16.07,2569617,2569695
10559,60,28,1,8.53,42.25,2569694,2569754
10560,67,23,1,7.64,27.81,2569753,2569820
10561,59,80,0,8.68,172.18,2569819,2569878
10562,65,53,1,7.88,62.11,2569877,2569942
10563,46,51,2,11.13,71.94,2569941,2569987
10564,57,62,1,8.98,116.19,2569986,2570043
10565,65,50,0,7.88,65.89,2570042,2570107
10566,88,30,0,5.82,35.92,2570106,2570194
10567,104,19,0,4.92,16.92,2570193,2570297
10568,79,29,0,6.48,26.63,2570296,2570375
10569,87,25,0,5.89,26.35,2570374,2570461
10570,79,17,1,6.48,17.49,2570461,2570540
10571,81,38,0,6.32,30.00,2570539,2570620
10572,84,24,1,6.10,17.32,2570619,2570703
10573,62,28,0,8.26,40.03,2570703,2570765
10574,68,21,1,7.53,20.16,2570764,2570832
10575,63,18,1,8.13,18.14,2570831,2570894
10576,71,21,1,7.21,21.35,2570893,2570964
10577,75,29,0,6.83,21.74,2570963,2571038
10578,60,24,0,8.53,28.98,2571037,2571097
10579,55,36,2,9.31,50.76,2571096,2571151
10580,68,19,1,7.53,17.25,2571150,2571218
10581,78,23,1,6.56,18.84,2571217,2571295
10582,75,28,0,6.83,26.94,2571294,2571369
10583,54,31,1,9.48,40.62,2571368,2571422
10584,71,28,1,7.21,33.27,2571421,2571492
10585,71,23,1,7.21,24.25,2571491,2571562
10586,46,63,0,11.13,162.33,2571562,2571608
10587,73,30,0,7.01,33.03,2571607,2571680
10588,96,27,0,5.33,15.91,2571679,2571775
10589,123,18,0,4.16,11.14,2571774,2571897
10590,82,29,0,6.24,30.36,2571896,2571978
10591,82,29,1,6.24,22.33,2571977,2572059
10592,80,20,0,6.40,13.96,2572058,2572138
10593,70,25,1,7.31,21.42,2572137,2572207
10594,65,52,0,7.88,62.57,2572206,2572271
10595,72,21,1,7.11,19.93,2572271,2572343
10596,54,40,1,9.48,58.10,2572342,2572396
10597,64,34,0,8.00,39.69,2572395,2572459
10598,53,40,1,9.66,69.47,2572458,2572511
10599,61,39,1,8.39,35.19,2572510,2572571
10600,66,24,0,7.76,28.94,2572570,2572636
10601,57,29,1,8.98,33.67,2572635,2572692
10602,69,21,0,7.42,19.87,2572691,2572760
10603,69,28,0,7.42,41.92,2572759,2572828
10604,61,23,1,8.39,17.68,2572827,2572888
10605,64,28,0,8.00,30.16,2572887,2572951
10606,67,32,1,7.64,35.33,2572950,2573017
10607,55,36,1,9.31,47.16,2573016,2573071
10608,72,31,0,7.11,25.54,2573071,2573143
10609,67,29,0,7.64,32.38,2573142,2573209
10610,74,38,0,6.92,41.53,2573208,2573282
10611,75,24,1,6.83,24.41,2573281,2573356
10612,96,29,0,5.33,30.24,2573356,2573452
10613,104,16,0,4.92,15.01,2573451,2573555
10614,83,31,0,6.17,22.14,2573554,2573637
10615,84,47,0,6.10,47.56,2573636,2573720
10616,77,32,0,6.65,27.19,2573719,2573796
10617,78,17,1,6.56,17.50,2573795,2573873
10618,72,21,2,7.11,18.46,2573872,2573944
10619,59,33,2,8.68,37.61,2573943,2574002
10620,71,21,1,7.21,21.74,2574001,2574072
10621,76,17,0,6.74,12.56,2574071,2574147
10622,65,28,1,7.88,27.68,2574146,2574211
10623,57,53,2,8.98,62.82,2574210,2574267
10624,53,26,1,9.66,31.73,2574266,2574319
10625,62,31,1,8.26,27.84,2574318,2574380
10626,66,54,2,7.76,47.40,2574379,2574445
10627,78,43,0,6.56,36.60,2574444,2574522
10628,70,30,1,7.31,29.76,2574521,2574591
10629,66,34,0,7.76,36.82,2574590,2574656
10630,73,24,1,7.01,27.03,2574655,2574728
10631,103,24,0,4.97,21.68,2574727,2574830
10632,83,34,0,6.17,41.39,2574830,2574913
10633,81,31,0,6.32,25.70,2574912,2574993
10634,81,30,0,6.32,31.28,2574992,2575073
10635,68,41,1,7.53,48.01,2575072,2575140
10636,65,28,0,7.88,25.03,2575139,2575204
10637,65,20,1,7.88,23.15,2575203,2575268
10638,70,23,1,7.31,19.82,2575267,2575337
10639,56,28,1,9.14,39.44,2575336,2575392
10640,67,30,1,7.64,28.02,2575391,2575458
10641,60,29,1,8.53,32.72,2575457,2575517
10642,57,39,0,8.98,58.93,2575516,2575573
10643,56,59,1,9.14,77.12,2575572,2575628
10644,56,36,0,9.14,59.80,2575627,2575683
10645,61,30,1,8.39,33.32,2575682,2575743
10646,57,42,0,8.98,77.28,2575742,2575799
10647,75,38,0,6.83,30.84,2575798,2575873
10648,56,30,2,9.14,33.23,2575873,2575929
10649,59,29,0,8.68,35.44,2575928,2575987
10650,73,41,0,7.01,48.95,2575986,2576059
10651,55,40,0,9.31,54.72,2576058,2576113
10652,69,25,0,7.42,30.24,2576112,2576181
10653,57,49,0,8.98,91.74,2576180,2576237
10654,109,33,0,4.70,21.73,2576236,2576345
10655,77,42,0,6.65,43.21,2576344,2576421
10656,93,19,0,5.51,16.44,2576420,2576513
10657,93,20,1,5.51,18.25,2576512,2576605
10658,78,30,0,6.56,28.14,2576605,2576683
10659,89,21,1,5.75,16.77,2576682,2576771
10660,84,19,0,6.10,16.75,2576770,2576854
10661,66,24,1,7.76,31.58,2576853,2576919
10662,57,38,2,8.98,41.32,2576918,2576975
10663,66,28,1,7.76,33.06,2576974,2577040
10664,73,21,0,7.01,16.84,2577040,2577113
10665,59,54,1,8.68,67.07,2577112,2577171
10666,73,28,1,7.01,27.22,2577170,2577243
10667,57,31,1,8.98,33.98,2577242,2577299
10668,68,26,1,7.53,24.31,2577298,2577366
10669,59,28,1,8.68,45.24,2577365,2577424
10670,82,20,0,6.24,23.26,2577423,2577505
10671,58,33,1,8.83,41.00,2577504,2577562
10672,58,34,1,8.83,55.97,2577561,2577619
10673,77,44,0,6.65,44.72,2577618,2577695
10674,54,27,1,9.48,43.14,2577695,2577749
10675,62,47,0,8.26,57.93,2577748,2577810
10676,64,45,0,8.00,69.75,2577809,2577873
10677,79,36,0,6.48,33.90,2577872,2577951
10678,89,19,0,5.75,22.43,2577951,2578040
10679,98,49,0,5.22,32.68,2578040,2578138
10680,79,18,0,6.48,20.38,2578137,2578216
10681,69,48,0,7.42,53.35,2578215,2578284
10682,75,40,0,6.83,34.49,2578283,2578358
10683,70,39,1,7.31,29.27,2578357,2578427
10684,68,25,1,7.53,29.07,2578427,2578495
10685,71,37,1,7.21,40.50,2578494,2578565
10686,69,26,1,7.42,25.43,2578564,2578633
10687,69,27,1,7.42,20.91,2578632,2578701
10688,63,35,0,8.13,42.90,2578700,2578763
10689,58,31,1,8.83,34.87,2578762,2578820
10690,69,40,1,7.42,33.61,2578819,2578888
10691,67,25,1,7.64,25.51,2578887,2578954
10692,71,47,0,7.21,41.74,2578953,2579024
10693,82,22,0,6.24,20.72,2579024,2579106
10694,59,55,1,8.68,60.39,2579105,2579164
10695,66,27,1,7.76,31.03,2579163,2579229
10696,75,36,0,6.83,36.20,2579228,2579303
10697,71,25,0,7.21,26.08,2579302,2579373
10698,79,19,0,6.48,22.45,2579372,2579451
10699,87,25,0,5.89,31.80,2579451,2579538
10700,94,26,0,5.45,29.44,2579538,2579632
10701,82,24,0,6.24,30.28,2579631,2579713
10702,83,22,0,6.17,20.84,2579712,2579795
10703,70,29,0,7.31,40.84,2579794,2579864
10704,78,18,1,6.56,17.53,2579864,2579942
10705,90,19,0,5.69,14.06,2579941,2580031
10706,60,56,1,8.53,78.52,2580030,2580090
10707,52,43,0,9.85,70.78,2580089,2580141
10708,65,33,0,7.88,41.98,2580140,2580205
10709,72,21,0,7.11,16.90,2580204,2580276
10710,55,81,0,9.31,131.63,2580275,2580330
10711,57,53,1,8.98,69.74,2580329,2580386
10712,68,37,1,7.53,34.69,2580385,2580453
10713,74,27,0,6.92,25.34,2580452,2580526
10714,65,29,0,7.88,42.94,2580525,2580590
10715,63,23,1,8.13,26.17,2580589,2580652
10716,76,42,0,6.74,38.96,2580651,2580727
10717,60,44,1,8.53,68.15,2580727,2580787
10718,59,25,0,8.68,33.64,2580787,2580846
10719,74,34,0,6.92,27.78,2580845,2580919
10720,82,21,0,6.24,25.60,2580918,2581000
10721,84,40,0,6.10,42.23,2580999,2581083
10722,77,29,0,6.65,27.55,2581082,2581159
10723,84,35,0,6.10,29.82,2581158,2581242
10724,76,26,1,6.74,17.96,2581242,2581318
10725,66,22,1,7.76,25.06,2581317,2581383
10726,64,23,1,8.00,24.25,2581382,2581446
10727,71,23,1,7.21,18.90,2581445,2581516
10728,76,29,1,6.74,22.96,2581515,2581591
10729,58,38,1,8.83,44.32,2581590,2581648
10730,54,34,2,9.48,48.73,2581647,2581701
10731,52,51,1,9.85,70.40,2581700,2581752
10732,65,22,1,7.88,28.14,2581751,2581816
10733,71,48,1,7.21,40.76,2581816,2581887
10734,81,33,0,6.32,35.40,2581886,2581967
10735,61,53,0,8.39,56.47,2581966,2582027
10736,64,27,0,8.00,28.69,2582026,2582090
10737,66,42,0,7.76,43.06,2582089,2582155
10738,70,34,1,7.31,46.42,2582155,2582225
10739,42,76,2,12.19,167.06,2582224,2582266
10740,69,45,0,7.42,47.23,2582265,2582334
10741,107,20,0,4.79,16.34,2582333,2582440
10742,91,24,0,5.63,21.42,2582439,2582530
10743,62,42,0,8.26,56.22,2582529,2582591
10744,78,37,0,6.56,35.30,2582590,2582668
10745,75,39,1,6.83,53.29,2582668,2582743
10746,88,43,0,5.82,29.01,2582742,2582830
10747,60,23,0,8.53,25.52,2582829,2582889
10748,89,22,0,5.75,19.11,2582888,2582977
10749,76,26,1,6.74,20.01,2582976,2583052
10750,64,22,0,8.00,24.91,2583051,2583115
10751,67,39,1,7.64,41.57,2583114,2583181
10752,65,36,1,7.88,41.09,2583180,2583245
10753,70,21,1,7.31,21.19,2583244,2583314
10754,52,41,2,9.85,63.63,2583313,2583365
10755,82,30,0,6.24,19.53,2583364,2583446
10756,58,39,0,8.83,46.11,2583445,2583503
10757,62,32,0,8.26,49.87,2583502,2583564
10758,55,44,1,9.31,49.41,2583563,2583618
10759,67,47,0,7.64,44.38,2583617,2583684
10760,71,26,1,7.21,34.48,2583683,2583754
10761,104,22,0,4.92,14.69,2583753,2583857
10762,99,30,0,5.17,20.63,2583856,2583955
10763,84,18,1,6.10,17.13,2583954,2584038
10764,69,37,0,7.42,50.01,2584037,2584106
10765,73,28,1,7.01,24.29,2584105,2584178
10766,81,32,0,6.32,31.21,2584177,2584258
10767,62,33,1,8.26,50.55,2584257,2584319
10768,72,20,1,7.11,16.32,2584318,2584390
10769,58,66,1,8.83,88.83,2584389,2584447
10770,67,23,1,7.64,22.32,2584446,2584513
10771,65,34,0,7.88,32.45,2584512,2584577
10772,58,32,1,8.83,34.52,2584576,2584634
10773,48,43,1,10.67,80.39,2584633,2584681
10774,58,31,1,8.83,36.32,2584681,2584739
10775,52,26,0,9.85,33.71,2584738,2584790
10776,61,50,1,8.39,56.40,2584789,2584850
10777,62,28,0,8.26,31.71,2584849,2584911
10778,66,71,1,7.76,76.03,2584910,2584976
10779,62,30,0,8.26,41.32,2584975,2585037
10780,65,24,1,7.88,25.92,2585036,2585101
10781,64,48,0,8.00,90.50,2585100,2585164
10782,72,30,0,7.11,37.38,2585163,2585235
10783,49,41,1,10.45,79.92,2585234,2585283
10784,81,47,0,6.32,38.42,2585283,2585364
10785,82,30,0,6.24,34.87,2585363,2585445
10786,95,26,0,5.39,23.19,2585444,2585539
10787,57,95,0,8.98,215.00,2585538,2585595
10788,73,45,1,7.01,53.11,2585594,2585667
10789,84,33,0,6.10,34.04,2585666,2585750
10790,70,27,0,7.31,25.10,2585749,2585819
10791,89,27,0,5.75,24.23,2585818,2585907
10792,66,32,1,7.76,35.52,2585906,2585972
10793,61,24,1,8.39,25.78,2585971,2586032
10794,65,29,1,7.88,34.78,2586031,2586096
10795,73,37,0,7.01,26.81,2586095,2586168
10796,63,39,1,8.13,43.38,2586167,2586230
10797,69,33,1,7.42,33.35,2586229,2586298
10798,62,53,1,8.26,52.29,2586297,2586359
10799,55,24,1,9.31,29.45,2586358,2586413
10800,68,25,1,7.53,27.51,2586412,2586480
10801,75,34,0,6.83,28.38,2586479,2586554
10802,75,21,1,6.83,16.04,2586553,2586628
10803,68,44,0,7.53,53.78,2586627,2586695
10804,46,40,1,11.13,76.24,2586694,2586740
10805,75,28,1,6.83,30.09,2586739,2586814
10806,72,29,0,7.11,26.07,2586813,2586885
10807,62,57,0,8.26,78.35,2586884,2586946
10808,87,27,0,5.89,29.55,2586945,2587032
10809,84,25,0,6.10,26.06,2587031,2587115
10810,77,20,1,6.65,18.38,2587114,2587191
10811,90,21,0,5.69,18.35,2587191,2587281
10812,71,82,0,7.21,94.67,2587280,2587351
10813,91,29,0,5.63,25.46,2587350,2587441
10814,70,27,1,7.31,27.59,2587440,2587510
10815,95,16,0,5.39,12.22,2587509,2587604
10816,61,29,0,8.39,35.48,2587603,2587664
10817,57,28,1,8.98,33.84,2587663,2587720
10818,71,26,0,7.21,24.28,2587719,2587790
10819,69,44,0,7.42,37.75,2587789,2587858
10820,72,24,1,7.11,15.24,2587857,2587929
10821,59,50,0,8.68,62.05,2587928,2587987
10822,57,43,1,8.98,40.30,2587986,2588043
10823,67,21,0,7.64,22.11,2588042,2588109
10824,64,27,1,8.00,31.22,2588108,2588172
10825,49,58,2,10.45,103.88,2588171,2588220
10826,78,33,0,6.56,26.32,2588219,2588297
10827,68,33,2,7.53,30.07,2588296,2588364
10828,78,30,1,6.56,39.86,2588363,2588441
10829,53,37,1,9.66,54.75,2588440,2588493
10830,63,28,0,8.13,27.48,2588492,2588555
10831,76,20,1,6.74,18.61,2588555,2588631
10832,89,25,0,5.75,20.57,2588630,2588719
10833,87,28,0,5.89,28.75,2588718,2588805
10834,67,48,0,7.64,42.17,2588804,2588871
10835,84,28,1,6.10,26.37,2588870,2588954
10836,84,36,0,6.10,26.13,2588953,2589037
10837,67,27,0,7.64,26.83,2589036,2589103
10838,83,33,0,6.17,24.24,2589102,2589185
10839,70,26,1,7.31,17.04,2589184,2589254
10840,58,47,1,8.83,49.94,2589253,2589311
10841,71,21,1,7.21,19.88,2589311,2589382
10842,56,39,1,9.14,42.12,2589382,2589438
10843,63,34,1,8.13,33.06,2589437,2589500
10844,68,22,0,7.53,25.28,2589499,2589567
10845,60,45,0,8.53,43.58,2589566,2589626
10846,51,36,1,10.04,64.98,2589625,2589676
10847,72,38,0,7.11,49.68,2589675,2589747
10848,61,35,1,8.39,41.75,2589746,2589807
10849,60,45,0,8.53,54.15,2589806,2589866
10850,68,28,0,7.53,42.57,2589865,2589933
10851,67,30,0,7.64,29.72,2589932,2589999
10852,70,55,0,7.31,64.22,2589998,2590068
10853,97,40,0,5.28,29.46,2590067,2590164
10854,74,31,1,6.92,21.43,2590164,2590238
10855,73,33,1,7.01,30.70,2590237,2590310
10856,71,27,0,7.21,29.41,2590309,2590380
10857,47,90,1,10.89,191.41,2590379,2590426
10858,65,54,0,7.88,88.66,2590425,2590490
10859,68,28,0,7.53,27.84,2590490,2590558
10860,62,21,1,8.26,28.48,2590557,2590619
10861,70,30,0,7.31,28.96,2590618,2590688
10862,69,37,0,7.42,46.62,2590687,2590756
10863,74,21,1,6.92,19.86,2590756,2590830
10864,53,55,2,9.66,82.75,2590829,2590882
10865,59,33,2,8.68,32.83,2590881,2590940
10866,64,39,1,8.00,37.31,2590939,2591003
10867,82,28,0,6.24,26.31,2591002,2591084
10868,69,18,1,7.42,19.00,2591084,2591153
10869,73,32,0,7.01,40.37,2591152,2591225
10870,63,36,1,8.13,38.30,2591224,2591287
10871,60,40,0,8.53,72.32,2591286,2591346
10872,75,27,0,6.83,34.17,2591345,2591420
10873,105,22,0,4.88,16.68,2591419,2591524
10874,83,47,1,6.17,37.63,2591523,2591606
10875,81,73,1,6.32,68.84,2591605,2591686
10876,74,24,0,6.92,27.32,2591685,2591759
10877,80,38,0,6.40,29.56,2591758,2591838
10878,64,39,1,8.00,53.88,2591837,2591901
10879,61,28,1,8.39,31.62,2591900,2591961
10880,61,29,0,8.39,35.94,2591960,2592021
10881,63,41,1,8.13,48.17,2592020,2592083
10882,52,29,1,9.85,42.82,2592082,2592134
10883,62,24,1,8.26,27.74,2592133,2592195
10884,61,24,0,8.39,33.81,2592194,2592255
10885,73,22,0,7.01,17.63,2592254,2592327
10886,55,46,1,9.31,50.76,2592326,2592381
10887,67,23,2,7.64,25.90,2592380,2592447
10888,58,27,1,8.83,30.59,2592446,2592504
10889,74,30,1,6.92,24.10,2592503,2592577
10890,57,29,0,8.98,45.03,2592576,2592633
10891,75,37,0,6.83,30.52,2592632,2592707
10892,49,42,1,10.45,99.39,2592706,2592755
10893,64,69,0,8.00,95.88,2592755,2592819
10894,97,22,0,5.28,16.92,2592818,2592915
10895,90,61,0,5.69,53.21,2592914,2593004
10896,81,24,0,6.32,24.79,2593003,2593084
10897,78,30,0,6.56,37.22,2593083,2593161
10898,81,23,1,6.32,19.40,2593160,2593241
10899,88,25,0,5.82,14.90,2593240,2593328
10900,77,45,0,6.65,36.31,2593327,2593404
10901,75,35,0,6.83,45.80,2593403,2593478
10902,63,28,0,8.13,34.71,2593477,2593540
10903,62,34,1,8.26,33.22,2593539,2593601
10904,60,31,1,8.53,31.02,2593600,2593660
10905,63,47,0,8.13,51.89,2593659,2593722
10906,64,31,1,8.00,30.84,2593721,2593785
10907,61,25,0,8.39,22.14,2593784,2593845
10908,65,30,1,7.88,23.98,2593845,2593910
10909,74,30,1,6.92,33.89,2593910,2593984
10910,72,26,0,7.11,25.32,2593983,2594055
10911,68,28,1,7.53,27.75,2594054,2594122
10912,73,25,1,7.01,25.88,2594121,2594194
10913,57,28,0,8.98,35.39,2594193,2594250
10914,60,24,0,8.53,31.32,2594249,2594309
10915,55,43,0,9.31,63.30,2594308,2594363
10916,88,38,0,5.82,27.56,2594362,2594450
10917,105,18,0,4.88,15.12,2594449,2594554
10918,80,29,1,6.40,26.26,2594553,2594633
10919,92,17,0,5.57,14.48,2594632,2594724
10920,97,28,0,5.28,20.32,2594724,2594821
10921,71,23,0,7.21,21.86,2594820,2594891
10922,79,25,1,6.48,21.62,2594890,2594969
10923,71,21,1,7.21,16.90,2594968,2595039
10924,61,41,1,8.39,42.73,2595038,2595099
10925,77,18,0,6.65,14.46,2595098,2595175
10926,63,65,0,8.13,74.21,2595174,2595237
10927,73,21,0,7.01,18.15,2595236,2595309
10928,58,47,2,8.83,57.35,2595308,2595366
10929,68,21,0,7.53,26.16,2595365,2595433
10930,71,24,1,7.21,21.43,2595432,2595503
10931,70,26,0,7.31,26.99,2595502,2595572
10932,78,34,1,6.56,24.96,2595572,2595650
10933,58,29,1,8.83,36.94,2595649,2595707
10934,65,29,1,7.88,32.85,2595706,2595771
10935,81,23,0,6.32,20.59,2595770,2595851
10936,85,30,0,6.02,29.41,2595850,2595935
10937,80,43,0,6.40,53.77,2595934,2596014
10938,83,27,1,6.17,16.28,2596013,2596096
10939,82,33,0,6.24,26.65,2596095,2596177
10940,54,48,1,9.48,76.21,2596176,2596230
10941,72,71,1,7.11,94.10,2596229,2596301
10942,65,28,0,7.88,39.86,2596300,2596365
10943,72,28,1,7.11,32.49,2596364,2596436
10944,66,25,1,7.76,22.73,2596435,2596501
10945,65,33,1,7.88,38.14,2596500,2596565
10946,79,19,1,6.48,15.39,2596565,2596644
10947,68,35,1,7.53,29.51,2596643,2596711
10948,69,52,0,7.42,43.55,2596711,2596780
10949,67,22,1,7.64,21.04,2596779,2596846
10950,60,29,0,8.53,40.22,2596845,2596905
10951,67,23,0,7.64,26.59,2596904,2596971
10952,59,30,0,8.68,36.49,2596970,2597029
10953,69,33,1,7.42,28.42,2597029,2597098
10954,61,25,2,8.39,30.04,2597097,2597158
10955,77,47,0,6.65,44.98,2597157,2597234
10956,57,26,1,8.98,36.40,2597233,2597290
10957,81,20,1,6.32,16.05,2597289,2597370
10958,66,29,1,7.76,34.61,2597369,2597435
10959,55,47,1,9.31,94.58,2597434,2597489
10960,57,41,0,8.98,63.91,2597488,2597545
10961,69,26,0,7.42,39.49,2597544,2597613
10962,79,71,0,6.48,76.30,2597612,2597691
10963,110,31,0,4.65,23.70,2597690,2597800
10964,96,37,0,5.33,34.31,2597799,2597895
10965,101,23,0,5.07,16.76,2597894,2597995
10966,83,28,1,6.17,25.10,2597995,2598078
10967,80,39,0,6.40,28.67,2598077,2598157
10968,82,38,1,6.24,26.70,2598157,2598239
10969,82,61,0,6.24,50.45,2598238,2598320
10970,62,32,0,8.26,30.19,2598319,2598381
10971,90,24,0,5.69,21.30,2598380,2598470
10972,69,20,0,7.42,20.24,2598469,2598538
10973,69,25,1,7.42,22.42,2598537,2598606
10974,67,25,0,7.64,33.19,2598605,2598672
10975,68,25,1,7.53,23.48,2598671,2598739
10976,63,32,0,8.13,30.49,2598738,2598801
10977,55,30,0,9.31,46.54,2598801,2598856
10978,64,45,1,8.00,44.00,2598855,2598919
10979,56,32,0,9.14,51.27,2598919,2598975
10980,70,39,0,7.31,34.76,2598974,2599044
10981,65,34,0,7.88,28.20,2599043,2599108
10982,75,39,0,6.83,38.68,2599107,2599182
10983,65,42,1,7.88,38.72,2599181,2599246
10984,63,31,1,8.13,29.44,2599245,2599308
10985,52,87,1,9.85,147.90,2599307,2599359
10986,73,25,0,7.01,27.36,2599358,2599431
10987,66,34,1,7.76,43.12,2599430,2599496
10988,64,32,1,8.00,35.47,2599495,2599559
10989,75,29,0,6.83,36.41,2599558,2599633
10990,84,24,0,6.10,23.51,2599632,2599716
10991,111,21,0,4.61,18.36,2599715,2599826
10992,101,23,0,5.07,21.47,2599826,2599927
10993,81,23,0,6.32,20.14,2599926,2600007
10994,77,28,1,6.65,31.27,2600006,2600083
10995,86,18,0,5.95,18.51,2600082,2600168
10996,55,47,0,9.31,94.43,2600167,2600222
10997,95,25,0,5.39,22.43,2600221,2600316
10998,67,28,1,7.64,27.01,2600315,2600382
10999,95,15,0,5.39,11.71,2600382,2600477
11000,62,53,1,8.26,59.00,2600476,2600538
11001,69,43,1,7.42,42.13,2600538,2600607
11002,74,28,1,6.92,25.94,2600606,2600680
11003,78,25,1,6.56,21.89,2600680,2600758
11004,62,28,2,8.26,25.26,2600757,2600819
11005,75,21,1,6.83,24.89,2600818,2600893
11006,61,25,1,8.39,35.06,2600892,2600953
11007,72,28,0,7.11,18.96,2600952,2601024
11008,54,28,1,9.48,40.03,2601023,2601077
11009,64,25,1,8.00,31.62,2601076,2601140
11010,67,19,1,7.64,19.63,2601139,2601206
11011,69,40,1,7.42,52.74,2601205,2601274
11012,70,20,0,7.31,24.53,2601273,2601343
11013,68,21,1,7.53,19.78,2601342,2601410
11014,75,23,0,6.83,25.64,2601409,2601484
11015,65,23,0,7.88,36.94,2601483,2601548
11016,63,27,0,8.13,34.56,2601547,2601610
11017,71,30,0,7.21,37.46,2601609,2601680
11018,73,37,0,7.01,33.41,2601679,2601752
11019,86,24,0,5.95,20.44,2601751,2601837
11020,88,27,0,5.82,25.65,2601836,2601924
11021,98,23,0,5.22,23.97,2601923,2602021
11022,75,31,0,6.83,34.20,2602020,2602095
11023,77,24,1,6.65,23.40,2602094,2602171
11024,74,30,1,6.92,26.86,2602170,2602244
11025,86,27,0,5.95,25.07,2602243,2602329
11026,75,29,0,6.83,28.60,2602329,2602404
11027,72,30,0,7.11,37.32,2602403,2602475
11028,81,26,1,6.32,22.49,2602474,2602555
11029,56,38,0,9.14,49.52,2602554,2602610
11030,73,36,1,7.01,25.41,2602609,2602682
11031,65,36,1,7.88,34.23,2602682,2602747
11032,70,30,1,7.31,25.47,2602746,2602816
11033,78,23,1,6.56,14.58,2602815,2602893
11034,68,22,0,7.53,20.16,2602892,2602960
11035,58,27,0,8.83,40.14,2602959,2603017
11036,42,75,2,12.19,192.73,2603016,2603058
11037,78,23,0,6.56,15.89,2603057,2603135
11038,75,25,0,6.83,23.08,2603134,2603209
11039,78,18,0,6.56,17.58,2603209,2603287
11040,81,24,0,6.32,23.58,2603286,2603367
11041,64,25,0,8.00,35.00,2603366,2603430
11042,69,27,0,7.42,33.03,2603429,2603498
11043,85,26,0,6.02,21.32,2603497,2603582
11044,89,26,0,5.75,33.31,2603581,2603670
11045,105,26,0,4.88,18.36,2603669,2603774
11046,83,19,1,6.17,16.07,2603773,2603856
11047,82,26,0,6.24,21.23,2603855,2603937
11048,93,22,0,5.51,21.07,2603936,2604029
11049,78,22,1,6.56,20.48,2604029,2604107
11050,69,24,0,7.42,25.55,2604106,2604175
11051,80,26,0,6.40,18.94,2604174,2604254
11052,72,33,0,7.11,29.68,2604253,2604325
11053,54,32,0,9.48,36.84,2604324,2604378
11054,79,23,0,6.48,22.50,2604377,2604456
11055,66,26,1,7.76,28.27,2604455,2604521
11056,60,34,2,8.53,39.35,2604520,2604580
11057,66,33,1,7.76,39.00,2604579,2604645
11058,62,28,1,8.26,25.71,2604644,2604706
11059,40,104,1,12.80,276.51,2604705,2604745
11060,64,24,1,8.00,22.91,2604745,2604809
11061,69,23,1,7.42,22.50,2604808,2604877
11062,69,34,1,7.42,31.23,2604877,2604946
11063,53,55,1,9.66,80.53,2604946,2604999
11064,60,27,1,8.53,32.52,2604998,2605058
11065,71,38,1,7.21,41.52,2605057,2605128
11066,69,30,0,7.42,41.52,2605127,2605196
11067,72,28,0,7.11,27.99,2605195,2605267
11068,67,33,0,7.64,35.27,2605266,2605333
11069,72,33,0,7.11,25.29,2605332,2605404
11070,67,33,0,7.64,29.27,2605403,2605470
11071,81,56,0,6.32,68.59,2605469,2605550
11072,119,27,0,4.30,21.45,2605549,2605668
11073,72,32,0,7.11,42.71,2605668,2605740
11074,76,38,0,6.74,42.27,2605740,2605816
11075,84,18,0,6.10,21.85,2605815,2605899
11076,77,28,1,6.65,30.15,2605898,2605975
11077,60,32,1,8.53,47.85,2605974,2606034
11078,65,52,1,7.88,60.88,2606033,2606098
11079,60,30,1,8.53,40.25,2606097,2606157
11080,77,28,1,6.65,32.25,2606157,2606234
11081,82,29,0,6.24,26.45,2606233,2606315
11082,73,30,1,7.01,19.16,2606315,2606388
11083,54,24,1,9.48,34.10,2606387,2606441
11084,66,51,0,7.76,66.88,2606440,2606506
11085,68,36,1,7.53,34.75,2606505,2606573
11086,63,46,0,8.13,59.60,2606572,2606635
11087,66,40,1,7.76,35.21,2606635,2606701
11088,58,49,1,8.83,66.52,2606700,2606758
11089,54,50,1,9.48,66.47,2606757,2606811
11090,64,29,1,8.00,23.47,2606810,2606874
11091,58,37,0,8.83,49.38,2606874,2606932
11092,70,26,1,7.31,32.90,2606931,2607001
11093,69,27,1,7.42,29.43,2607000,2607069
11094,55,54,1,9.31,61.78,2607068,2607123
11095,68,40,1,7.53,39.28,2607122,2607190
11096,72,30,0,7.11,30.27,2607189,2607261
11097,59,34,0,8.68,35.74,2607260,2607319
11098,66,35,0,7.76,39.27,2607319,2607385
11099,72,37,0,7.11,38.35,2607384,2607456
11100,69,34,0,7.42,36.16,2607455,2607524
11101,116,26,0,4.41,18.38,2607523,2607639
11102,95,27,0,5.39,26.49,2607638,2607733
11103,73,30,0,7.01,32.15,2607733,2607806
11104,85,24,1,6.02,20.71,2607805,2607890
11105,84,22,1,6.10,22.37,2607889,2607973
11106,78,33,0,6.56,35.81,2607972,2608050
11107,68,34,0,7.53,46.34,2608049,2608117
11108,43,94,1,11.91,262.46,2608116,2608159
11109,62,42,1,8.26,49.90,2608158,2608220
11110,59,42,1,8.68,64.39,2608220,2608279
11111,57,31,1,8.98,47.91,2608278,2608335
11112,79,15,2,6.48,10.35,2608334,2608413
11113,58,43,1,8.83,80.63,2608412,2608470
11114,44,150,0,11.64,507.23,2608469,2608513
11115,72,25,0,7.11,27.82,2608512,2608584
11116,53,67,1,9.66,93.13,2608583,2608636
11117,55,51,1,9.31,85.05,2608635,2608690
11118,50,34,1,10.24,41.66,2608689,2608739
11119,35,122,1,14.63,430.12,2608738,2608773
11120,73,18,1,7.01,18.18,2608772,2608845
11121,61,34,0,8.39,38.73,2608844,2608905
11122,55,34,2,9.31,36.25,2608904,2608959
11123,57,29,1,8.98,33.84,2608958,2609015
11124,60,34,1,8.53,35.48,2609014,2609074
11125,58,44,0,8.83,70.56,2609073,2609131
11126,50,28,3,10.24,36.90,2609130,2609180
11127,70,34,0,7.31,52.64,2609179,2609249
11128,64,21,1,8.00,23.69,2609248,2609312
11129,72,26,1,7.11,25.60,2609311,2609383
11130,76,18,0,6.74,22.75,2609382,2609458
11131,54,61,0,9.48,124.43,2609457,2609511
11132,51,45,0,10.04,64.82,2609510,2609561
11133,55,37,1,9.31,61.01,2609560,2609615
11134,50,49,1,10.24,98.50,2609614,2609664
11135,44,48,0,11.64,163.87,2609663,2609707
11136,65,73,0,7.88,95.09,2609706,2609771
11137,86,27,0,5.95,25.74,2609770,2609856
11138,73,24,0,7.01,32.81,2609855,2609928
11139,62,43,0,8.26,63.35,2609927,2609989
11140,70,39,0,7.31,39.22,2609988,2610058
11141,70,36,1,7.31,37.16,2610058,2610128
11142,67,32,1,7.64,49.16,2610127,2610194
11143,79,24,0,6.48,21.57,2610193,2610272
11144,59,26,1,8.68,32.90,2610271,2610330
11145,78,34,1,6.56,27.73,2610329,2610407
11146,75,54,0,6.83,55.53,2610406,2610481
11147,61,28,0,8.39,26.86,2610481,2610542
11148,62,27,1,8.26,37.29,2610542,2610604
11149,59,32,1,8.68,35.13,2610603,2610662
11150,71,24,1,7.21,17.12,2610661,2610732
11151,65,22,1,7.88,20.57,2610731,2610796
11152,56,32,1,9.14,44.16,2610795,2610851
11153,63,35,1,8.13,37.92,2610850,2610913
11154,54,29,2,9.48,36.36,2610912,2610966
11155,56,36,1,9.14,54.98,2610965,2611021
11156,56,41,1,9.14,44.59,2611020,2611076
11157,62,28,1,8.26,39.58,2611075,2611137
11158,67,40,1,7.64,60.89,2611136,2611203
11159,59,33,0,8.68,30.83,2611202,2611261
11160,66,33,1,7.76,37.15,2611260,2611326
11161,56,55,0,9.14,97.69,2611325,2611381
11162,67,19,0,7.64,23.36,2611380,2611447
11163,68,27,0,7.53,33.75,2611447,2611515
11164,52,76,1,9.85,193.05,2611514,2611566
11165,61,31,1,8.39,40.37,2611565,2611626
11166,58,60,1,8.83,101.00,2611625,2611683
11167,79,26,0,6.48,32.43,2611683,2611762
11168,92,33,0,5.57,35.16,2611761,2611853
11169,83,25,0,6.17,25.39,2611852,2611935
11170,101,24,0,5.07,17.21,2611934,2612035
11171,74,18,1,6.92,14.32,2612034,2612108
11172,72,37,0,7.11,56.04,2612107,2612179
11173,65,46,1,7.88,53.40,2612178,2612243
11174,66,24,0,7.76,28.55,2612242,2612308
11175,64,30,1,8.00,29.34,2612307,2612371
11176,76,48,0,6.74,47.04,2612370,2612446
11177,72,33,0,7.11,24.82,2612445,2612517
11178,72,22,1,7.11,17.13,2612516,2612588
11179,63,37,0,8.13,36.46,2612587,2612650
11180,74,25,0,6.92,19.53,2612649,2612723
11181,56,33,1,9.14,37.12,2612722,2612778
11182,69,21,0,7.42,18.01,2612777,2612846
11183,53,43,0,9.66,77.55,2612845,2612898
11184,70,22,1,7.31,18.93,2612897,2612967
11185,62,25,2,8.26,24.22,2612966,2613028
11186,50,28,1,10.24,39.78,2613027,2613077
11187,66,31,1,7.76,27.52,2613076,2613142
11188,62,36,2,8.26,32.58,2613141,2613203
11189,70,27,1,7.31,23.53,2613202,2613272
11190,68,34,0,7.53,27.87,2613271,2613339
11191,61,28,1,8.39,36.21,2613338,2613399
11192,65,58,0,7.88,61.98,2613398,2613463
11193,63,25,0,8.13,30.87,2613463,2613526
11194,60,47,1,8.53,80.58,2613525,2613585
11195,66,30,0,7.76,37.24,2613584,2613650
11196,58,41,0,8.83,52.18,2613649,2613707
11197,61,42,0,8.39,60.86,2613706,2613767
11198,62,30,1,8.26,44.39,2613767,2613829
11199,92,30,0,5.57,22.79,2613828,2613920
11200,112,20,0,4.57,16.67,2613919,2614031
11201,78,24,0,6.56,22.81,2614030,2614108
11202,77,29,0,6.65,27.16,2614107,2614184
11203,82,32,0,6.24,24.16,2614183,2614265
11204,83,24,0,6.17,19.03,2614264,2614347
11205,66,30,1,7.76,29.55,2614347,2614413
11206,82,27,0,6.24,28.06,2614412,2614494
11207,60,45,1,8.53,45.72,2614493,2614553
11208,61,43,1,8.39,49.35,2614553,2614614
11209,60,29,0,8.53,38.18,2614613,2614673
11210,64,26,0,8.00,32.62,2614672,2614736
11211,54,32,2,9.48,34.25,2614735,2614789
11212,64,50,0,8.00,65.09,2614788,2614852
11213,52,48,3,9.85,64.13,2614851,2614903
11214,61,47,1,8.39,60.04,2614902,2614963
11215,59,22,1,8.68,28.73,2614962,2615021
11216,49,27,1,10.45,40.57,2615021,2615070
11217,48,75,2,10.67,116.93,2615069,2615117
11218,62,34,1,8.26,38.39,2615117,2615179
11219,67,34,1,7.64,36.68,2615178,2615245
11220,65,22,1,7.88,21.43,2615244,2615309
11221,82,23,1,6.24,18.28,2615308,2615390
11222,63,30,1,8.13,30.62,2615389,2615452
11223,73,35,1,7.01,30.62,2615451,2615524
11224,85,23,1,6.02,24.42,2615523,2615608
11225,64,44,1,8.00,53.16,2615607,2615671
11226,76,28,0,6.74,26.51,2615670,2615746
11227,78,29,0,6.56,29.71,2615745,2615823
11228,76,49,0,6.74,47.83,2615822,2615898
11229,85,38,1,6.02,34.07,2615898,2615983
11230,86,38,0,5.95,37.90,2615982,2616068
11231,96,36,0,5.33,24.99,2616067,2616163
11232,72,42,0,7.11,34.24,2616162,2616234
11233,80,23,0,6.40,24.91,2616233,2616313
11234,83,46,0,6.17,35.20,2616312,2616395
11235,77,47,0,6.65,36.28,2616394,2616471
11236,73,27,0,7.01,24.62,2616471,2616544
11237,63,33,0,8.13,54.24,2616544,2616607
11238,65,40,1,7.88,43.09,2616606,2616671
11239,53,42,1,9.66,48.71,2616670,2616723
11240,56,48,1,9.14,56.02,2616722,2616778
11241,69,26,1,7.42,28.53,2616778,2616847
11242,69,22,0,7.42,25.35,2616846,2616915
11243,71,20,0,7.21,19.04,2616914,2616985
11244,62,40,1,8.26,42.58,2616984,2617046
11245,64,24,1,8.00,28.81,2617045,2617109
11246,53,51,1,9.66,70.49,2617108,2617161
11247,56,46,1,9.14,58.19,2617160,2617216
11248,71,42,1,7.21,31.63,2617215,2617286
11249,72,23,1,7.11,19.85,2617285,2617357
11250,85,25,1,6.02,18.31,2617356,2617441
11251,66,42,1,7.76,37.58,2617440,2617506
11252,64,62,0,8.00,74.22,2617505,2617569
11253,63,38,0,8.13,53.38,2617568,2617631
11254,63,35,1,8.13,57.38,2617630,2617693
11255,61,34,0,8.39,48.80,2617693,2617754
11256,60,69,1,8.53,92.78,2617753,2617813
11257,76,24,0,6.74,25.83,2617813,2617889
11258,97,56,0,5.28,55.73,2617888,2617985
11259,98,26,0,5.22,25.26,2617984,2618082
11260,91,30,0,5.63,30.89,2618081,2618172
11261,89,25,0,5.75,16.93,2618171,2618260
11262,76,32,1,6.74,39.19,2618259,2618335
11263,87,27,0,5.89,19.32,2618334,2618421
11264,78,20,1,6.56,18.35,2618420,2618498
11265,66,56,1,7.76,66.15,2618497,2618563
11266,69,24,1,7.42,27.03,2618562,2618631
11267,68,24,2,7.53,25.54,2618630,2618698
11268,59,32,0,8.68,47.57,2618697,2618756
11269,68,20,1,7.53,20.22,2618755,2618823
11270,60,22,1,8.53,32.92,2618822,2618882
11271,69,23,0,7.42,18.94,2618881,2618950
11272,69,22,0,7.42,22.62,2618949,2619018
11273,61,30,0,8.39,41.12,2619017,2619078
11274,52,23,0,9.85,38.94,2619077,2619129
11275,64,32,2,8.00,41.88,2619128,2619192
11276,59,40,1,8.68,53.37,2619192,2619251
11277,48,58,1,10.67,131.43,2619250,2619298
11278,67,39,1,7.64,42.32,2619297,2619364
11279,66,26,0,7.76,40.67,2619363,2619429
11280,73,27,0,7.01,29.25,2619428,2619501
11281,67,24,0,7.64,30.62,2619500,2619567
11282,61,41,1,8.39,57.19,2619566,2619627
11283,69,29,1,7.42,42.65,2619626,2619695
11284,64,97,1,8.00,148.59,2619694,2619758
11285,55,44,1,9.31,75.38,2619757,2619812
11286,55,34,1,9.31,47.96,2619811,2619866
11287,69,20,0,7.42,30.53,2619865,2619934
11288,76,30,0,6.74,24.98,2619933,2620009
11289,77,39,0,6.65,33.84,2620008,2620085
11290,85,39,0,6.02,48.68,2620084,2620169
11291,72,35,0,7.11,35.96,2620168,2620240
11292,88,20,0,5.82,14.90,2620239,2620327
11293,69,47,0,7.42,53.55,2620326,2620395
11294,80,32,1,6.40,23.74,2620394,2620474
11295,58,39,0,8.83,40.97,2620473,2620531
11296,67,48,0,7.64,60.08,2620530,2620597
11297,80,23,0,6.40,24.39,2620596,2620676
11298,67,53,1,7.64,59.27,2620675,2620742
11299,67,19,1,7.64,21.54,2620741,2620808
11300,59,34,0,8.68,45.81,2620808,2620867
11301,68,30,0,7.53,32.87,2620866,2620934
11302,69,27,1,7.42,27.58,2620933,2621002
11303,69,21,1,7.42,16.04,2621001,2621070
11304,60,31,0,8.53,34.78,2621069,2621129
11305,68,45,1,7.53,36.13,2621128,2621196
11306,69,32,1,7.42,22.91,2621195,2621264
11307,54,38,0,9.48,50.40,2621263,2621317
11308,66,40,1,7.76,27.12,2621316,2621382
11309,55,31,1,9.31,37.30,2621382,2621437
11310,57,45,1,8.98,46.51,2621436,2621493
11311,87,31,0,5.89,23.76,2621492,2621579
11312,61,26,0,8.39,35.29,2621578,2621639
11313,58,34,3,8.83,34.14,2621638,2621696
11314,73,43,0,7.01,54.37,2621695,2621768
11315,59,42,1,8.68,59.07,2621767,2621826
11316,54,33,1,9.48,49.03,2621825,2621879
11317,65,38,1,7.88,40.85,2621878,2621943
11318,60,42,0,8.53,48.65,2621942,2622002
11319,77,25,0,6.65,23.79,2622002,2622079
11320,113,38,0,4.53,26.11,2622078,2622191
11321,99,33,0,5.17,30.12,2622190,2622289
11322,70,40,1,7.31,49.47,2622288,2622358
11323,86,23,1,5.95,26.11,2622357,2622443
11324,94,19,0,5.45,14.84,2622442,2622536
11325,69,30,1,7.42,29.40,2622535,2622604
11326,80,22,0,6.40,20.06,2622604,2622684
11327,75,34,1,6.83,34.04,2622683,2622758
11328,63,30,1,8.13,31.73,2622757,2622820
11329,53,63,1,9.66,90.45,2622819,2622872
11330,65,30,0,7.88,34.69,2622872,2622937
11331,63,35,1,8.13,30.11,2622936,2622999
11332,69,37,0,7.42,30.04,2622999,2623068
11333,54,37,1,9.48,58.51,2623067,2623121
11334,60,34,1,8.53,55.65,2623120,2623180
11335,74,36,1,6.92,30.70,2623179,2623253
11336,60,19,1,8.53,16.52,2623252,2623312
11337,56,23,2,9.14,20.87,2623311,2623367
11338,67,39,1,7.64,40.68,2623366,2623433
11339,57,27,1,8.98,32.47,2623432,2623489
11340,77,42,0,6.65,44.05,2623488,2623565
11341,69,20,1,7.42,20.85,2623564,2623633
11342,64,25,1,8.00,27.25,2623632,2623696
11343,58,34,1,8.83,50.28,2623696,2623754
11344,79,48,0,6.48,44.98,2623753,2623832
11345,63,20,0,8.13,30.94,2623831,2623894
11346,59,35,0,8.68,42.56,2623893,2623952
11347,71,21,0,7.21,29.41,2623951,2624022
11348,75,30,0,6.83,29.64,2624021,2624096
11349,88,20,0,5.82,22.90,2624095,2624183
11350,78,88,0,6.56,128.55,2624182,2624260
11351,98,30,0,5.22,21.38,2624259,2624357
11352,80,22,0,6.40,26.84,2624356,2624436
11353,77,33,0,6.65,31.32,2624435,2624512
11354,85,26,1,6.02,23.06,2624511,2624596
11355,72,35,0,7.11,36.88,2624596,2624668
11356,82,32,1,6.24,26.92,2624667,2624749
11357,75,26,0,6.83,17.74,2624749,2624824
11358,61,23,1,8.39,27.58,2624823,2624884
11359,63,26,1,8.13,30.24,2624883,2624946
11360,59,34,1,8.68,39.71,2624945,2625004
11361,68,35,1,7.53,31.01,2625004,2625072
11362,62,43,0,8.26,56.55,2625072,2625134
11363,56,47,2,9.14,50.34,2625133,2625189
11364,60,30,1,8.53,32.95,2625188,2625248
11365,61,33,1,8.39,29.03,2625248,2625309
11366,70,19,1,7.31,14.33,2625308,2625378
11367,74,26,0,6.92,24.40,2625377,2625451
11368,72,46,0,7.11,38.63,2625450,2625522
11369,66,39,0,7.76,47.76,2625521,2625587
11370,67,26,1,7.64,31.72,2625587,2625654
11371,49,39,1,10.45,49.19,2625653,2625702
11372,56,47,0,9.14,69.41,2625701,2625757
11373,53,30,0,9.66,47.36,2625756,2625809
11374,67,40,1,7.64,44.71,2625808,2625875
11375,63,27,0,8.13,34.94,2625874,2625937
11376,48,41,0,10.67,77.43,2625936,2625984
11377,63,51,0,8.13,84.27,2625983,2626046
11378,77,42,0,6.65,41.27,2626045,2626122
11379,104,25,0,4.92,19.88,2626121,2626225
11380,94,21,0,5.45,18.50,2626225,2626319
11381,88,27,0,5.82,27.01,2626318,2626406
11382,68,40,1,7.53,41.19,2626405,2626473
11383,84,47,1,6.10,32.71,2626473,2626557
11384,86,22,1,5.95,17.39,2626556,2626642
11385,79,25,1,6.48,21.26,2626641,2626720
11386,59,70,1,8.68,87.13,2626719,2626778
11387,82,20,1,6.24,14.36,2626777,2626859
11388,54,43,2,9.48,51.36,2626858,2626912
11389,63,34,1,8.13,34.46,2626911,2626974
11390,60,35,0,8.53,50.72,2626974,2627034
11391,69,22,1,7.42,24.77,2627033,2627102
11392,53,35,1,9.66,39.32,2627101,2627154
11393,72,21,0,7.11,21.54,2627153,2627225
11394,57,33,0,8.98,49.42,2627225,2627282
11395,54,41,1,9.48,57.84,2627281,2627335
11396,68,38,0,7.53,53.63,2627334,2627402
11397,42,71,1,12.19,139.39,2627401,2627443
11398,51,89,2,10.04,152.19,2627442,2627493
11399,77,20,0,6.65,16.83,2627492,2627569
11400,60,50,0,8.53,71.85,2627568,2627628
11401,67,24,1,7.64,24.20,2627627,2627694
11402,64,40,0,8.00,46.78,2627693,2627757
11403,48,36,2,10.67,47.68,2627756,2627804
11404,66,25,1,7.76,28.85,2627803,2627869
11405,65,30,1,7.88,41.46,2627868,2627933
11406,72,29,1,7.11,25.27,2627932,2628004
11407,78,24,0,6.56,24.37,2628004,2628082
11408,66,39,0,7.76,49.79,2628082,2628148
11409,70,32,0,7.31,48.84,2628147,2628217
11410,84,31,0,6.10,41.94,2628216,2628300
11411,119,22,0,4.30,17.54,2628299,2628418
11412,67,24,1,7.64,26.26,2628417,2628484
11413,66,43,1,7.76,58.00,2628483,2628549
11414,83,28,0,6.17,19.88,2628548,2628631
11415,76,23,1,6.74,24.14,2628630,2628706
11416,61,34,1,8.39,28.53,2628705,2628766
11417,70,28,1,7.31,33.50,2628765,2628835
11418,60,45,1,8.53,44.38,2628834,2628894
11419,79,28,0,6.48,19.14,2628893,2628972
11420,65,37,1,7.88,34.85,2628971,2629036
11421,48,85,1,10.67,183.81,2629035,2629083
11422,62,42,1,8.26,55.03,2629082,2629144
11423,61,34,1,8.39,41.98,2629143,2629204
11424,68,20,1,7.53,20.10,2629203,2629271
11425,40,88,1,12.80,211.61,2629270,2629310
11426,76,22,1,6.74,17.83,2629309,2629385
11427,65,61,1,7.88,64.57,2629384,2629449
11428,50,44,1,10.24,52.78,2629448,2629498
11429,72,33,1,7.11,38.27,2629497,2629569
11430,56,38,1,9.14,42.73,2629568,2629624
11431,78,24,0,6.56,17.35,2629623,2629701
11432,68,25,0,7.53,31.75,2629700,2629768
11433,46,49,2,11.13,88.29,2629767,2629813
11434,79,41,1,6.48,35.21,2629812,2629891
11435,38,97,1,13.47,280.57,2629890,2629928
11436,72,36,0,7.11,53.15,2629927,2629999
11437,59,29,0,8.68,50.76,2629998,2630057
11438,53,38,1,9.66,66.45,2630056,2630109
11439,52,27,1,9.85,42.09,2630108,2630160
11440,62,35,0,8.26,55.87,2630159,2630221
11441,63,70,0,8.13,93.63,2630220,2630283
11442,85,39,0,6.02,33.86,2630282,2630367
11443,82,56,0,6.24,68.31,2630366,2630448
11444,75,28,0,6.83,35.56,2630447,2630522
11445,79,75,1,6.48,68.22,2630521,2630600
11446,71,54,0,7.21,63.66,2630599,2630670
11447,70,36,0,7.31,35.96,2630669,2630739
11448,78,27,1,6.56,34.17,2630738,2630816
11449,61,25,0,8.39,32.86,2630815,2630876
11450,74,40,1,6.92,31.83,2630875,2630949
11451,83,19,0,6.17,16.19,2630948,2631031
11452,60,36,0,8.53,39.05,2631030,2631090
11453,59,38,1,8.68,37.37,2631089,2631148
11454,64,36,1,8.00,40.84,2631147,2631211
11455,67,26,1,7.64,30.47,2631211,2631278
11456,69,24,1,7.42,20.85,2631277,2631346
11457,65,25,0,7.88,21.55,2631345,2631410
11458,60,37,1,8.53,49.75,2631409,2631469
11459,67,40,0,7.64,51.10,2631469,2631536
11460,63,43,1,8.13,39.98,2631535,2631598
11461,67,51,1,7.64,51.84,2631597,2631664
11462,62,92,1,8.26,146.68,2631663,2631725
11463,52,39,0,9.85,58.48,2631724,2631776
11464,64,32,0,8.00,47.06,2631775,2631839
11465,84,27,0,6.10,20.04,2631838,2631922
11466,96,31,0,5.33,32.26,2631921,2632017
11467,99,32,0,5.17,30.28,2632017,2632116
11468,85,24,0,6.02,24.99,2632115,2632200
11469,86,21,0,5.95,15.95,2632199,2632285
11470,77,39,1,6.65,28.70,2632284,2632361
11471,84,26,1,6.10,20.42,2632361,2632445
11472,89,19,0,5.75,17.83,2632444,2632533
11473,85,22,0,6.02,18.02,2632532,2632617
11474,77,24,0,6.65,20.80,2632616,2632693
11475,52,34,1,9.85,59.44,2632692,2632744
11476,61,86,1,8.39,122.21,2632743,2632804
11477,65,35,0,7.88,35.00,2632803,2632868
11478,72,43,1,7.11,29.96,2632867,2632939
11479,61,24,1,8.39,30.83,2632938,2632999
11480,63,35,1,8.13,34.43,2632999,2633062
11481,65,21,1,7.88,25.25,2633062,2633127
11482,48,57,2,10.67,78.18,2633126,2633174
11483,64,24,0,8.00,30.12,2633173,2633237
11484,72,21,1,7.11,19.40,2633236,2633308
11485,54,71,2,9.48,128.99,2633307,2633361
11486,71,31,1,7.21,33.69,2633360,2633431
11487,61,27,0,8.39,33.52,2633430,2633491
11488,68,25,1,7.53,26.37,2633490,2633558
11489,55,32,2,9.31,48.90,2633557,2633612
11490,71,32,0,7.21,42.73,2633611,2633682
11491,53,26,1,9.66,39.85,2633681,2633734
11492,56,28,1,9.14,44.48,2633733,2633789
11493,63,29,0,8.13,40.27,2633788,2633851
11494,75,47,0,6.83,56.84,2633850,2633925
11495,75,22,0,6.83,28.14,2633924,2633999
11496,93,27,0,5.51,23.58,2633999,2634092
11497,66,55,0,7.76,87.79,2634091,2634157
11498,99,19,0,5.17,16.10,2634156,2634255
11499,74,27,1,6.92,22.99,2634255,2634329
11500,84,38,0,6.10,38.16,2634328,2634412
11501,82,25,0,6.24,21.14,2634411,2634493
11502,70,29,1,7.31,30.82,2634492,2634562
11503,76,26,0,6.74,28.06,2634561,2634637
11504,66,27,1,7.76,31.03,2634636,2634702
11505,76,25,1,6.74,22.83,2634701,2634777
11506,62,22,2,8.26,19.13,2634776,2634838
11507,67,34,0,7.64,40.20,2634837,2634904
11508,66,43,1,7.76,38.88,2634904,2634970
11509,69,37,1,7.42,35.75,2634969,2635038
11510,61,42,1,8.39,45.52,2635037,2635098
11511,66,27,0,7.76,34.27,2635097,2635163
11512,59,27,0,8.68,34.22,2635162,2635221
11513,62,24,1,8.26,25.61,2635220,2635282
11514,66,32,1,7.76,33.64,2635281,2635347
11515,62,28,2,8.26,27.35,2635346,2635408
11516,73,25,1,7.01,27.66,2635407,2635480
11517,59,38,1,8.68,47.91,2635480,2635539
11518,48,116,0,10.67,266.14,2635538,2635586
11519,68,35,1,7.53,34.48,2635586,2635654
11520,59,40,1,8.68,51.07,2635654,2635713
11521,72,96,0,7.11,136.10,2635712,2635784
11522,50,43,1,10.24,74.38,2635783,2635833
11523,75,21,0,6.83,22.73,2635833,2635908
11524,62,38,0,8.26,59.71,2635907,2635969
11525,75,47,0,6.83,46.01,2635968,2636043
11526,96,46,0,5.33,41.41,2636042,2636138
11527,105,19,0,4.88,17.99,2636138,2636243
11528,88,23,0,5.82,16.22,2636243,2636331
11529,78,23,1,6.56,27.27,2636330,2636408
11530,66,28,1,7.76,41.85,2636408,2636474
11531,73,33,0,7.01,36.67,2636473,2636546
11532,67,24,1,7.64,21.84,2636545,2636612
11533,75,28,1,6.83,23.42,2636611,2636686
11534,74,37,0,6.92,40.99,2636685,2636759
11535,66,28,1,7.76,29.06,2636758,2636824
11536,53,88,1,9.66,182.79,2636823,2636876
11537,61,44,1,8.39,47.29,2636875,2636936
11538,58,49,0,8.83,77.07,2636935,2636993
11539,57,27,1,8.98,25.46,2636992,2637049
11540,63,25,0,8.13,31.09,2637048,2637111
11541,52,32,1,9.85,47.94,2637110,2637162
11542,63,27,0,8.13,32.46,2637161,2637224
11543,58,25,1,8.83,35.80,2637224,2637282
11544,62,33,0,8.26,37.48,2637281,2637343
11545,66,21,1,7.76,16.15,2637342,2637408
11546,66,23,1,7.76,26.06,2637408,2637474
11547,58,44,0,8.83,60.00,2637473,2637531
11548,71,25,0,7.21,23.66,2637531,2637602
11549,64,28,0,8.00,30.00,2637601,2637665
11550,68,35,1,7.53,31.31,2637665,2637733
11551,60,32,1,8.53,51.32,2637732,2637792
11552,51,61,1,10.04,86.00,2637791,2637842
11553,83,24,0,6.17,24.81,2637841,2637924
11554,54,54,1,9.48,62.14,2637923,2637977
11555,73,18,0,7.01,19.55,2637976,2638049
11556,67,53,0,7.64,65.19,2638048,2638115
11557,77,24,0,6.65,21.55,2638114,2638191
11558,119,21,0,4.30,16.93,2638190,2638309
11559,106,37,0,4.83,25.54,2638308,2638414
11560,76,20,1,6.74,18.98,2638413,2638489
11561,80,22,0,6.40,21.34,2638488,2638568
11562,64,32,1,8.00,40.03,2638568,2638632
11563,71,46,0,7.21,61.69,2638631,2638702
11564,58,23,1,8.83,28.63,2638701,2638759
11565,90,22,0,5.69,21.01,2638758,2638848
11566,69,27,1,7.42,25.14,2638847,2638916
11567,76,30,0,6.74,23.93,2638915,2638991
11568,65,27,1,7.88,28.11,2638990,2639055
11569,67,28,1,7.64,27.96,2639054,2639121
11570,53,27,1,9.66,40.68,2639120,2639173
11571,74,17,1,6.92,13.62,2639172,2639246
11572,60,29,1,8.53,35.85,2639245,2639305
11573,52,49,1,9.85,71.17,2639304,2639356
11574,73,27,1,7.01,21.60,2639355,2639428
11575,74,19,1,6.92,16.32,2639427,2639501
11576,55,38,1,9.31,48.80,2639500,2639555
11577,65,24,1,7.88,21.77,2639555,2639620
11578,68,18,1,7.53,16.69,2639619,2639687
11579,71,29,1,7.21,32.65,2639686,2639757
11580,68,27,2,7.53,22.63,2639756,2639824
11581,62,141,0,8.26,312.55,2639823,2639885
11582,57,45,1,8.98,48.65,2639885,2639942
11583,69,29,0,7.42,39.92,2639942,2640011
11584,74,34,0,6.92,33.59,2640011,2640085
11585,65,45,0,7.88,42.88,2640084,2640149
11586,66,32,0,7.76,43.12,2640149,2640215
11587,63,38,0,8.13,63.09,2640214,2640277
11588,93,41,0,5.51,41.13,2640276,2640369
11589,100,49,0,5.12,37.83,2640368,2640468
11590,92,27,0,5.57,27.18,2640467,2640559
11591,67,43,1,7.64,56.11,2640558,2640625
11592,86,43,0,5.95,41.32,2640624,2640710
11593,80,39,1,6.40,32.92,2640709,2640789
11594,65,45,1,7.88,40.26,2640788,2640853
11595,82,29,0,6.24,21.77,2640853,2640935
11596,68,39,0,7.53,37.22,2640934,2641002
11597,72,22,0,7.11,22.57,2641001,2641073
11598,59,40,1,8.68,53.03,2641072,2641131
11599,38,94,0,13.47,373.30,2641130,2641168
11600,60,45,0,8.53,56.58,2641167,2641227
11601,59,28,0,8.68,33.13,2641226,2641285
11602,63,30,1,8.13,40.75,2641284,2641347
11603,64,26,1,8.00,25.66,2641346,2641410
11604,60,22,1,8.53,24.45,2641409,2641469
11605,56,29,1,9.14,26.69,2641468,2641524
11606,75,19,1,6.83,17.02,2641523,2641598
11607,74,22,0,6.92,21.67,2641597,2641671
11608,62,48,1,8.26,53.00,2641670,2641732
11609,59,43,1,8.68,61.07,2641731,2641790
11610,62,21,2,8.26,27.51,2641789,2641851
11611,68,32,1,7.53,29.54,2641850,2641918
11612,52,41,1,9.85,68.82,2641918,2641970
11613,74,44,0,6.92,37.91,2641969,2642043
11614,62,38,1,8.26,50.09,2642042,2642104
11615,69,30,0,7.42,40.01,2642103,2642172
11616,74,47,0,6.92,45.75,2642171,2642245
11617,86,22,0,5.95,16.53,2642244,2642330
11618,95,56,0,5.39,46.43,2642329,2642424
11619,84,22,0,6.10,22.28,2642424,2642508
11620,67,34,1,7.64,43.07,2642507,2642574
11621,84,26,1,6.10,22.85,2642573,2642657
11622,64,37,0,8.00,33.19,2642656,2642720
11623,81,47,1,6.32,50.59,2642719,2642800
11624,94,17,0,5.45,12.84,2642799,2642893
11625,72,23,0,7.11,25.99,2642892,2642964
11626,61,49,0,8.39,54.07,2642963,2643024
11627,84,36,0,6.10,25.30,2643023,2643107
11628,70,38,1,7.31,31.33,2643106,2643176
11629,74,25,1,6.92,24.67,2643176,2643250
11630,70,20,1,7.31,22.96,2643249,2643319
11631,71,23,1,7.21,18.17,2643318,2643389
11632,58,44,1,8.83,43.49,2643388,2643446
11633,63,30,2,8.13,34.56,2643445,2643508
11634,59,31,1,8.68,33.74,2643508,2643567
11635,52,61,1,9.85,92.94,2643566,2643618
11636,68,22,1,7.53,24.40,2643617,2643685
11637,55,27,1,9.31,35.81,2643685,2643740
11638,57,29,1,8.98,36.79,2643739,2643796
11639,64,40,1,8.00,52.59,2643796,2643860
11640,63,24,1,8.13,29.92,2643859,2643922
11641,69,37,0,7.42,43.11,2643921,2643990
11642,56,54,0,9.14,83.12,2643989,2644045
11643,53,35,1,9.66,52.49,2644044,2644097
11644,58,33,1,8.83,62.63,2644096,2644154
11645,70,59,0,7.31,83.99,2644153,2644223
11646,73,26,0,7.01,25.90,2644222,2644295
11647,98,20,0,5.22,20.64,2644294,2644392
11648,101,32,0,5.07,20.42,2644391,2644492
11649,57,54,1,8.98,94.12,2644491,2644548
11650,83,24,1,6.17,18.89,2644547,2644630
11651,85,25,1,6.02,17.03,2644630,2644715
11652,79,42,1,6.48,38.07,2644714,2644793
11653,73,23,0,7.01,25.90,2644792,2644865
11654,70,28,0,7.31,26.93,2644864,2644934
11655,62,24,1,8.26,30.51,2644933,2644995
11656,70,22,2,7.31,20.22,2644994,2645064
11657,62,21,1,8.26,27.90,2645063,2645125
11658,61,28,1,8.39,32.50,2645124,2645185
11659,67,27,1,7.64,24.77,2645184,2645251
11660,61,42,0,8.39,42.30,2645250,2645311
11661,67,30,0,7.64,33.01,2645310,2645377
11662,57,36,0,8.98,37.14,2645376,2645433
11663,72,28,0,7.11,26.85,2645432,2645504
11664,67,25,1,7.64,26.53,2645504,2645571
11665,82,24,1,6.24,20.67,2645570,2645652
11666,60,25,1,8.53,21.45,2645651,2645711
11667,54,35,2,9.48,43.14,2645710,2645764
11668,66,23,1,7.76,24.85,2645763,2645829
11669,60,26,0,8.53,40.75,2645828,2645888
11670,78,21,0,6.56,24.55,2645887,2645965
11671,62,33,0,8.26,40.45,2645964,2646026
11672,55,53,0,9.31,91.63,2646026,2646081
11673,53,44,1,9.66,79.28,2646080,2646133
11674,73,28,0,7.01,27.82,2646132,2646205
11675,75,56,0,6.83,92.01,2646204,2646279
11676,84,22,0,6.10,26.63,2646278,2646362
11677,100,42,0,5.12,35.17,2646361,2646461
11678,62,30,1,8.26,35.26,2646460,2646522
11679,69,31,1,7.42,33.26,2646521,2646590
11680,86,26,1,5.95,21.67,2646589,2646675
11681,82,17,0,6.24,12.33,2646674,2646756
11682,64,30,1,8.00,40.28,2646755,2646819
11683,65,33,1,7.88,46.26,2646818,2646883
11684,84,19,1,6.10,15.97,2646882,2646966
11685,77,34,0,6.65,32.46,2646966,2647043
11686,60,32,1,8.53,46.48,2647042,2647102
11687,63,51,1,8.13,49.86,2647101,2647164
11688,59,51,1,8.68,52.56,2647163,2647222
11689,69,36,0,7.42,38.53,2647221,2647290
11690,66,20,1,7.76,22.46,2647289,2647355
11691,67,36,1,7.64,39.69,2647355,2647422
11692,63,44,1,8.13,42.97,2647421,2647484
11693,67,21,1,7.64,26.26,2647484,2647551
11694,50,75,1,10.24,109.18,2647550,2647600
11695,62,45,2,8.26,39.68,2647599,2647661
11696,51,48,1,10.04,80.27,2647660,2647711
11697,59,49,1,8.68,57.54,2647710,2647769
11698,67,32,0,7.64,41.45,2647768,2647835
11699,59,42,1,8.68,53.64,2647835,2647894
11700,69,28,1,7.42,26.59,2647894,2647963
11701,41,84,1,12.49,195.81,2647962,2648003
11702,84,19,0,6.10,19.92,2648002,2648086
11703,53,60,3,9.66,89.96,2648085,2648138
11704,56,40,2,9.14,55.69,2648137,2648193
11705,70,58,0,7.31,62.73,2648192,2648262
11706,77,25,0,6.65,23.99,2648261,2648338
11707,87,24,0,5.89,28.91,2648337,2648424
11708,99,37,0,5.17,42.79,2648423,2648522
11709,92,23,0,5.57,23.44,2648521,2648613
11710,65,39,1,7.88,56.42,2648612,2648677
11711,78,29,0,6.56,24.40,2648676,2648754
11712,89,37,0,5.75,27.24,2648753,2648842
11713,70,46,0,7.31,48.19,2648841,2648911
11714,75,23,0,6.83,23.85,2648910,2648985
11715,61,27,2,8.39,24.53,2648985,2649046
11716,74,33,0,6.92,33.75,2649046,2649120
11717,56,46,2,9.14,66.73,2649119,2649175
11718,77,27,1,6.65,25.32,2649174,2649251
11719,62,47,0,8.26,43.19,2649250,2649312
11720,52,42,1,9.85,87.28,2649311,2649363
11721,56,27,1,9.14,41.27,2649362,2649418
11722,74,18,0,6.92,12.56,2649417,2649491
11723,51,24,1,10.04,29.29,2649490,2649541
11724,65,44,0,7.88,63.77,2649540,2649605
11725,65,30,1,7.88,32.57,2649604,2649669
11726,58,27,1,8.83,35.11,2649668,2649726
11727,64,32,1,8.00,30.81,2649725,2649789
11728,75,19,1,6.83,17.85,2649788,2649863
11729,62,36,1,8.26,44.84,2649862,2649924
11730,66,40,0,7.76,51.00,2649923,2649989
11731,67,26,1,7.64,21.24,2649988,2650055
11732,66,55,2,7.76,47.79,2650054,2650120
11733,67,30,0,7.64,38.35,2650119,2650186
11734,67,26,0,7.64,26.83,2650185,2650252
11735,44,62,0,11.64,115.19,2650252,2650296
11736,49,30,2,10.45,61.55,2650295,2650344
11737,81,30,0,6.32,33.08,2650344,2650425
11738,82,20,0,6.24,25.82,2650425,2650507
11739,81,39,0,6.32,38.96,2650506,2650587
11740,69,64,0,7.42,87.35,2650587,2650656
11741,56,84,0,9.14,270.37,2650656,2650712
11742,64,48,0,8.00,58.22,2650711,2650775
11743,72,51,0,7.11,58.74,2650774,2650846
11744,80,23,1,6.40,27.57,2650845,2650925
11745,82,32,0,6.24,26.82,2650924,2651006
11746,83,27,0,6.17,21.32,2651006,2651089
11747,46,61,1,11.13,124.11,2651088,2651134
11748,70,44,1,7.31,45.59,2651133,2651203
11749,77,50,0,6.65,44.38,2651202,2651279
11750,71,23,1,7.21,23.18,2651278,2651349
11751,64,26,0,8.00,34.84,2651348,2651412
11752,41,45,3,12.49,76.05,2651411,2651452
11753,64,42,1,8.00,48.88,2651451,2651515
11754,65,31,1,7.88,23.80,2651515,2651580
11755,59,43,1,8.68,51.91,2651579,2651638
11756,56,28,1,9.14,33.48,2651637,2651693
11757,67,34,1,7.64,44.32,2651692,2651759
11758,60,24,2,8.53,29.48,2651758,2651818
11759,67,23,0,7.64,29.45,2651817,2651884
11760,73,31,1,7.01,27.77,2651883,2651956
11761,60,41,2,8.53,41.92,2651955,2652015
11762,58,119,1,8.83,243.45,2652014,2652072
11763,59,27,2,8.68,29.40,2652071,2652130
11764,61,27,1,8.39,36.07,2652129,2652190
11765,63,48,1,8.13,50.27,2652189,2652252
11766,79,19,0,6.48,19.90,2652251,2652330
11767,74,30,1,6.92,27.99,2652329,2652403
11768,57,97,0,8.98,159.70,2652402,2652459
11769,69,30,0,7.42,50.33,2652458,2652527
11770,51,98,1,10.04,211.17,2652526,2652577
11771,74,72,0,6.92,95.83,2652576,2652650
11772,92,39,0,5.57,51.25,2652650,2652742
11773,97,30,0,5.28,29.36,2652741,2652838
11774,73,40,1,7.01,41.71,2652837,2652910
11775,87,26,0,5.89,21.80,2652909,2652996
11776,83,27,0,6.17,29.30,2652995,2653078
11777,74,35,0,6.92,35.67,2653077,2653151
11778,77,35,1,6.65,33.68,2653150,2653227
11779,61,23,1,8.39,28.93,2653226,2653287
11780,82,20,0,6.24,16.72,2653286,2653368
11781,70,24,1,7.31,19.22,2653367,2653437
11782,77,22,0,6.65,18.51,2653436,2653513
11783,56,35,1,9.14,50.62,2653512,2653568
11784,62,52,0,8.26,66.42,2653567,2653629
11785,59,22,1,8.68,27.57,2653628,2653687
11786,67,24,2,7.64,22.26,2653686,2653753
11787,59,58,1,8.68,62.39,2653752,2653811
11788,63,19,1,8.13,20.02,2653810,2653873
11789,61,28,1,8.39,23.94,2653872,2653933
11790,69,22,0,7.42,18.65,2653932,2654001
11791,63,47,1,8.13,53.16,2654000,2654063
11792,65,25,2,7.88,22.48,2654063,2654128
11793,71,27,1,7.21,26.70,2654127,2654198
11794,68,52,0,7.53,46.96,2654197,2654265
11795,72,23,0,7.11,21.90,2654265,2654337
11796,58,31,0,8.83,40.38,2654336,2654394
11797,61,94,0,8.39,152.86,2654393,2654454
11798,60,57,1,8.53,76.68,2654453,2654513
11799,48,45,1,10.67,78.31,2654512,2654560
11800,56,43,0,9.14,57.23,2654559,2654615
11801,58,63,0,8.83,95.25,2654614,2654672
11802,59,50,1,8.68,64.18,2654671,2654730
11803,88,39,0,5.82,36.65,2654729,2654817
11804,100,33,0,5.12,32.71,2654816,2654916
11805,76,24,0,6.74,28.56,2654915,2654991
11806,83,36,0,6.17,24.48,2654990,2655073
11807,95,22,1,5.39,17.52,2655072,2655167
11808,63,45,1,8.13,68.81,2655166,2655229
11809,96,30,1,5.33,23.43,2655228,2655324
11810,73,32,0,7.01,35.33,2655323,2655396
11811,72,21,1,7.11,18.32,2655395,2655467
11812,71,37,0,7.21,35.63,2655467,2655538
11813,67,38,1,7.64,44.11,2655537,2655604
11814,55,40,1,9.31,48.25,2655603,2655658
11815,58,24,1,8.83,37.00,2655657,2655715
11816,71,22,1,7.21,22.25,2655714,2655785
11817,66,52,1,7.76,58.06,2655784,2655850
11818,65,25,0,7.88,33.34,2655849,2655914
11819,65,24,1,7.88,29.95,2655913,2655978
11820,66,23,1,7.76,27.52,2655977,2656043
11821,56,25,0,9.14,36.30,2656042,2656098
11822,69,26,0,7.42,25.06,2656098,2656167
11823,75,37,1,6.83,28.44,2656166,2656241
11824,49,42,1,10.45,54.33,2656240,2656289
11825,78,31,0,6.56,32.99,2656288,2656366
11826,68,41,1,7.53,40.43,2656365,2656433
11827,60,22,1,8.53,25.08,2656432,2656492
11828,81,37,0,6.32,40.39,2656491,2656572
11829,57,32,1,8.98,41.25,2656571,2656628
11830,56,42,0,9.14,52.52,2656627,2656683
11831,70,41,0,7.31,54.47,2656682,2656752
11832,57,58,0,8.98,101.35,2656751,2656808
11833,88,22,0,5.82,25.10,2656807,2656895
11834,102,56,0,5.02,48.59,2656894,2656996
11835,25,100,0,20.48,880.41,2656995,2657020
11836,91,26,0,5.63,21.16,2657019,2657110
11837,75,46,1,6.83,52.33,2657109,2657184
11838,85,26,1,6.02,19.13,2657183,2657268
11839,90,20,0,5.69,15.26,2657267,2657357
11840,92,25,1,5.57,18.70,2657357,2657449
11841,55,72,0,9.31,159.92,2657448,2657503
11842,70,25,0,7.31,34.22,2657503,2657573
11843,76,52,0,6.74,52.83,2657572,2657648
11844,58,30,1,8.83,47.66,2657647,2657705
11845,66,31,0,7.76,40.49,2657704,2657770
11846,74,17,0,6.92,19.72,2657769,2657843
11847,63,30,1,8.13,29.41,2657843,2657906
11848,66,28,1,7.76,23.97,2657905,2657971
11849,61,47,1,8.39,45.03,2657971,2658032
11850,63,24,0,8.13,30.87,2658031,2658094
11851,58,44,0,8.83,66.35,2658093,2658151
11852,59,30,2,8.68,34.96,2658150,2658209
11853,58,48,0,8.83,54.90,2658208,2658266
11854,71,21,1,7.21,18.00,2658266,2658337
11855,58,41,1,8.83,46.69,2658336,2658394
11856,81,25,0,6.32,23.85,2658393,2658474
11857,48,54,1,10.67,84.26,2658473,2658521
11858,61,36,1,8.39,43.26,2658520,2658581
11859,62,47,1,8.26,49.74,2658580,2658642
11860,69,60,0,7.42,69.06,2658641,2658710
11861,58,42,0,8.83,58.21,2658709,2658767
11862,56,78,0,9.14,115.77,2658766,2658822
11863,63,36,0,8.13,48.49,2658821,2658884
11864,75,23,0,6.83,25.53,2658883,2658958
11865,81,42,0,6.32,45.18,2658957,2659038
11866,102,36,0,5.02,30.49,2659037,2659139
11867,104,25,0,4.92,21.13,2659138,2659242
11868,73,38,0,7.01,38.07,2659242,2659315
11869,79,31,0,6.48,33.36,2659314,2659393
11870,82,44,1,6.24,33.84,2659392,2659474
11871,92,28,0,5.57,24.88,2659473,2659565
11872,68,42,1,7.53,45.43,2659565,2659633
11873,81,29,0,6.32,29.13,2659632,2659713
11874,72,31,0,7.11,32.02,2659712,2659784
11875,59,30,1,8.68,35.85,2659783,2659842
11876,69,23,0,7.42,28.59,2659841,2659910
11877,64,28,0,8.00,39.44,2659909,2659973
11878,57,21,1,8.98,27.21,2659972,2660029
11879,67,34,1,7.64,29.19,2660028,2660095
11880,59,22,1,8.68,25.24,2660094,2660153
11881,66,28,0,7.76,28.03,2660152,2660218
11882,55,27,0,9.31,42.29,2660217,2660272
11883,59,41,1,8.68,37.24,2660271,2660330
11884,61,28,1,8.39,39.09,2660329,2660390
11885,58,69,1,8.83,96.11,2660389,2660447
11886,74,25,0,6.92,23.67,2660447,2660521
11887,75,20,1,6.83,16.46,2660520,2660595
11888,53,56,0,9.66,99.24,2660594,2660647
11889,68,31,1,7.53,29.87,2660646,2660714
11890,51,77,0,10.04,140.51,2660713,2660764
11891,72,35,0,7.11,44.49,2660763,2660835
11892,74,29,0,6.92,33.67,2660834,2660908
11893,97,30,0,5.28,32.18,2660907,2661004
11894,101,24,0,5.07,20.92,2661003,2661104
11895,77,53,1,6.65,52.95,2661103,2661180
11896,85,21,1,6.02,20.82,2661179,2661264
11897,75,28,1,6.83,30.17,2661263,2661338
11898,82,20,1,6.24,19.28,2661337,2661419
11899,58,84,1,8.83,118.21,2661418,2661476
11900,73,44,0,7.01,54.29,2661475,2661548
11901,52,25,1,9.85,36.05,2661547,2661599
11902,74,24,1,6.92,18.94,2661598,2661672
11903,57,23,1,8.98,38.40,2661671,2661728
11904,76,18,0,6.74,15.06,2661727,2661803
11905,56,30,1,9.14,37.48,2661802,2661858
11906,66,21,1,7.76,21.64,2661857,2661923
11907,55,29,0,9.31,41.89,2661922,2661977
11908,62,44,1,8.26,46.77,2661976,2662038
11909,73,26,0,7.01,32.37,2662037,2662110
11910,67,24,1,7.64,27.57,2662109,2662176
11911,53,60,0,9.66,103.47,2662175,2662228
11912,69,24,0,7.42,29.03,2662227,2662296
11913,41,85,0,12.49,295.03,2662295,2662336
11914,48,45,0,10.67,117.68,2662335,2662383
11915,64,31,0,8.00,57.38,2662383,2662447
11916,66,28,0,7.76,33.79,2662446,2662512
11917,78,79,0,6.56,96.91,2662511,2662589
11918,86,57,0,5.95,56.02,2662589,2662675
11919,94,29,0,5.45,29.35,2662675,2662769
11920,87,33,1,5.89,24.29,2662768,2662855
11921,88,23,0,5.82,16.49,2662854,2662942
11922,75,26,1,6.83,24.92,2662941,2663016
11923,73,24,0,7.01,23.99,2663015,2663088
11924,66,23,1,7.76,24.37,2663087,2663153
11925,58,75,1,8.83,108.66,2663152,2663210
11926,69,21,1,7.42,13.95,2663209,2663278
11927,62,28,0,8.26,43.80,2663277,2663339
11928,55,40,0,9.31,49.49,2663338,2663393
11929,51,31,1,10.04,50.19,2663392,2663443
11930,68,27,1,7.53,19.66,2663442,2663510
11931,53,35,1,9.66,40.26,2663509,2663562
11932,62,31,1,8.26,34.64,2663561,2663623
11933,53,39,0,9.66,53.55,2663622,2663675
11934,60,30,1,8.53,43.42,2663674,2663734
11935,68,30,0,7.53,34.43,2663733,2663801
11936,57,29,0,8.98,50.02,2663800,2663857
11937,76,27,0,6.74,30.59,2663856,2663932
11938,53,49,1,9.66,90.41,2663932,2663985
11939,98,24,0,5.22,21.28,2663984,2664082
11940,98,37,0,5.22,36.77,2664081,2664179
11941,117,16,0,4.38,12.46,2664178,2664295
11942,78,63,0,6.56,59.91,2664294,2664372
11943,77,74,0,6.65,77.73,2664372,2664449
11944,53,54,1,9.66,92.79,2664448,2664501
11945,75,41,0,6.83,35.16,2664500,2664575
11946,63,27,0,8.13,29.54,2664574,2664637
11947,61,28,1,8.39,39.06,2664637,2664698
11948,67,32,1,7.64,34.92,2664697,2664764
11949,57,43,1,8.98,61.53,2664764,2664821
11950,51,34,1,10.04,41.61,2664820,2664871
11951,67,32,1,7.64,32.38,2664870,2664937
11952,59,37,1,8.68,47.57,2664936,2664995
11953,58,52,1,8.83,85.66,2664995,2665053
11954,74,51,0,6.92,44.83,2665052,2665126
11955,56,29,1,9.14,43.55,2665125,2665181
11956,51,36,1,10.04,63.61,2665180,2665231
11957,63,35,0,8.13,42.33,2665230,2665293
11958,64,43,0,8.00,56.28,2665292,2665356
11959,58,36,0,8.83,44.66,2665355,2665413
11960,56,54,0,9.14,137.80,2665412,2665468
11961,87,30,0,5.89,21.83,2665467,2665554
11962,94,30,0,5.45,28.03,2665553,2665647
11963,97,31,0,5.28,28.32,2665646,2665743
11964,66,29,1,7.76,45.82,2665742,2665808
11965,70,36,0,7.31,40.47,2665807,2665877
11966,75,32,1,6.83,25.21,2665876,2665951
11967,77,37,0,6.65,36.28,2665950,2666027
11968,73,59,0,7.01,51.27,2666026,2666099
11969,62,21,1,8.26,30.84,2666099,2666161
11970,65,24,1,7.88,25.43,2666160,2666225
11971,59,50,1,8.68,61.81,2666224,2666283
11972,61,40,0,8.39,43.09,2666282,2666343
11973,68,32,0,7.53,28.28,2666342,2666410
11974,49,50,1,10.45,92.41,2666409,2666458
11975,58,34,2,8.83,46.28,2666458,2666516
11976,58,42,1,8.83,48.83,2666515,2666573
11977,69,29,1,7.42,27.58,2666573,2666642
11978,59,37,0,8.68,44.79,2666641,2666700
11979,66,26,0,7.76,35.61,2666699,2666765
11980,63,48,1,8.13,62.05,2666764,2666827
11981,57,41,0,8.98,66.75,2666826,2666883
11982,71,31,0,7.21,32.81,2666882,2666953
11983,72,31,1,7.11,39.49,2666952,2667024
11984,107,21,0,4.79,20.52,2667023,2667130
11985,89,34,0,5.75,30.03,2667129,2667218
11986,70,43,1,7.31,58.59,2667217,2667287
11987,73,38,0,7.01,46.18,2667286,2667359
11988,71,25,1,7.21,32.03,2667358,2667429
11989,72,28,1,7.11,25.40,2667428,2667500
11990,77,22,1,6.65,20.93,2667499,2667576
11991,64,31,1,8.00,27.47,2667575,2667639
11992,64,42,1,8.00,36.22,2667638,2667702
11993,58,32,1,8.83,48.87,2667701,2667759
11994,72,26,0,7.11,21.10,2667758,2667830
11995,69,25,0,7.42,21.55,2667829,2667898
11996,58,25,0,8.83,38.07,2667898,2667956
11997,53,29,1,9.66,34.87,2667955,2668008
11998,65,25,1,7.88,23.12,2668007,2668072
11999,56,32,0,9.14,39.34,2668072,2668128
12000,68,69,1,7.53,73.43,2668127,2668195
12001,56,43,1,9.14,64.52,2668194,2668250
12002,77,52,0,6.65,53.97,2668249,2668326
12003,65,29,1,7.88,36.66,2668325,2668390
12004,76,37,0,6.74,45.75,2668389,2668465
12005,69,39,1,7.42,35.87,2668464,2668533
12006,67,114,0,7.64,215.36,2668532,2668599
12007,95,23,0,5.39,25.61,2668598,2668693
12008,86,35,0,5.95,35.97,2668692,2668778
12009,68,31,0,7.53,35.07,2668777,2668845
12010,80,45,0,6.40,39.59,2668845,2668925
12011,76,39,1,6.74,34.30,2668924,2669000
12012,66,30,0,7.76,40.37,2668999,2669065
12013,64,24,1,8.00,26.22,2669064,2669128
12014,64,19,1,8.00,21.84,2669127,2669191
12015,74,30,1,6.92,25.80,2669190,2669264
12016,68,27,0,7.53,31.72,2669263,2669331
12017,69,31,1,7.42,30.13,2669330,2669399
12018,59,36,0,8.68,43.78,2669398,2669457
12019,67,32,0,7.64,38.92,2669456,2669523
12020,70,33,0,7.31,58.56,2669522,2669592
12021,59,34,0,8.68,39.98,2669591,2669650
12022,66,33,2,7.76,36.46,2669649,2669715
12023,85,26,0,6.02,25.48,2669714,2669799
12024,65,36,0,7.88,51.58,2669798,2669863
12025,71,27,0,7.21,26.19,2669862,2669933
12026,66,59,0,7.76,69.76,2669933,2669999
12027,90,37,0,5.69,32.15,2669999,2670089
12028,88,26,0,5.82,31.42,2670088,2670176
12029,87,27,0,5.89,24.68,2670175,2670262
12030,80,47,0,6.40,38.27,2670261,2670341
12031,84,40,1,6.10,28.30,2670340,2670424
12032,57,37,0,8.98,47.91,2670424,2670481
12033,75,34,0,6.83,48.41,2670480,2670555
12034,68,28,1,7.53,29.04,2670554,2670622
12035,61,44,1,8.39,47.26,2670621,2670682
12036,66,27,0,7.76,26.24,2670681,2670747
12037,62,27,1,8.26,29.45,2670746,2670808
12038,63,28,1,8.13,29.86,2670807,2670870
12039,55,35,1,9.31,48.61,2670869,2670924
12040,59,50,2,8.68,48.46,2670923,2670982
12041,62,21,1,8.26,22.80,2670982,2671044
12042,75,22,0,6.83,14.44,2671044,2671119
12043,63,25,1,8.13,24.24,2671118,2671181
12044,64,55,0,8.00,86.78,2671180,2671244
12045,67,24,1,7.64,31.78,2671243,2671310
12046,44,86,1,11.64,194.64,2671309,2671353
12047,62,41,0,8.26,50.22,2671353,2671415
12048,72,41,0,7.11,39.15,2671414,2671486
12049,74,49,0,6.92,56.83,2671485,2671559
12050,72,66,0,7.11,113.96,2671558,2671630
12051,51,38,0,10.04,89.96,2671629,2671680
12052,91,22,0,5.63,24.28,2671679,2671770
12053,102,34,0,5.02,18.73,2671769,2671871
12054,67,82,1,7.64,104.80,2671870,2671937
12055,77,28,1,6.65,26.07,2671936,2672013
12056,71,30,1,7.21,31.91,2672012,2672083
12057,57,31,1,8.98,42.12,2672082,2672139
12058,48,150,1,10.67,437.01,2672138,2672186
12059,66,48,1,7.76,45.64,2672186,2672252
12060,65,23,1,7.88,21.95,2672251,2672316
12061,53,52,0,9.66,77.47,2672315,2672368
12062,64,31,1,8.00,33.03,2672367,2672431
12063,39,54,2,13.13,104.73,2672431,2672470
12064,62,26,0,8.26,25.61,2672469,2672531
12065,61,48,2,8.39,53.45,2672531,2672592
12066,70,43,1,7.31,35.16,2672591,2672661
12067,63,40,1,8.13,35.83,2672660,2672723
12068,63,62,0,8.13,72.56,2672722,2672785
12069,64,22,0,8.00,31.31,2672784,2672848
12070,56,39,0,9.14,62.73,2672847,2672903
12071,49,65,1,10.45,109.84,2672902,2672951
12072,55,39,1,9.31,73.05,2672950,2673005
12073,56,72,0,9.14,135.12,2673004,2673060
12074,101,38,0,5.07,28.92,2673059,2673160
12075,102,24,0,5.02,22.63,2673159,2673261
12076,83,33,1,6.17,30.28,2673260,2673343
12077,72,32,0,7.11,28.13,2673342,2673414
12078,62,40,1,8.26,40.48,2673413,2673475
12079,70,25,1,7.31,32.39,2673474,2673544
12080,68,30,0,7.53,21.69,2673543,2673611
12081,66,35,1,7.76,39.43,2673610,2673676
12082,50,41,1,10.24,74.98,2673675,2673725
12083,67,25,1,7.64,23.72,2673724,2673791
12084,65,23,2,7.88,16.54,2673790,2673855
12085,67,25,0,7.64,38.08,2673854,2673921
12086,59,29,1,8.68,32.63,2673920,2673979
12087,55,56,1,9.31,79.85,2673978,2674033
12088,76,29,1,6.74,22.83,2674032,2674108
12089,74,24,0,6.92,22.10,2674107,2674181
12090,68,27,1,7.53,18.57,2674180,2674248
12091,53,47,1,9.66,80.11,2674247,2674300
12092,45,44,0,11.38,89.44,2674299,2674344
12093,64,39,0,8.00,55.31,2674343,2674407
12094,71,26,0,7.21,44.73,2674406,2674477
12095,78,51,0,6.56,50.96,2674476,2674554
12096,100,26,0,5.12,24.97,2674553,2674653
12097,87,60,0,5.89,59.87,2674652,2674739
12098,63,52,1,8.13,59.35,2674738,2674801
12099,77,30,0,6.65,28.25,2674800,2674877
12100,76,31,1,6.74,29.77,2674876,2674952
12101,53,64,2,9.66,115.24,2674951,2675004
12102,70,23,1,7.31,21.93,2675003,2675073
12103,57,58,0,8.98,79.53,2675072,2675129
12104,52,58,1,9.85,99.21,2675129,2675181
12105,75,27,1,6.83,24.30,2675180,2675255
12106,62,23,1,8.26,26.71,2675254,2675316
12107,46,68,1,11.13,123.64,2675315,2675361
12108,57,34,1,8.98,55.28,2675360,2675417
12109,59,22,3,8.68,23.13,2675416,2675475
12110,53,55,1,9.66,73.73,2675474,2675527
12111,63,26,1,8.13,19.92,2675527,2675590
12112,50,75,1,10.24,206.50,2675589,2675639
12113,58,70,0,8.83,111.73,2675638,2675696
12114,51,26,1,10.04,34.47,2675695,2675746
12115,78,32,0,6.56,26.45,2675745,2675823
12116,61,51,0,8.39,68.07,2675822,2675883
12117,75,45,0,6.83,46.20,2675882,2675957
12118,54,75,0,9.48,208.81,2675956,2676010
12119,98,39,0,5.22,28.99,2676009,2676107
12120,98,26,0,5.22,21.07,2676106,2676204
12121,69,41,0,7.42,40.97,2676203,2676272
12122,77,27,1,6.65,25.11,2676271,2676348
12123,74,31,1,6.92,38.80,2676347,2676421
12124,69,24,1,7.42,29.20,2676420,2676489
12125,69,45,0,7.42,53.66,2676488,2676557
12126,58,24,1,8.83,23.90,2676556,2676614
12127,68,38,1,7.53,42.63,2676613,2676681
12128,65,29,1,7.88,34.48,2676680,2676745
12129,63,28,1,8.13,23.03,2676744,2676807
12130,54,57,2,9.48,70.99,2676806,2676860
12131,46,111,1,11.13,246.33,2676859,2676905
12132,66,27,0,7.76,26.73,2676904,2676970
12133,52,35,2,9.85,42.63,2676970,2677022
12134,54,57,0,9.48,73.47,2677021,2677075
12135,64,34,1,8.00,37.06,2677074,2677138
12136,55,70,1,9.31,97.81,2677137,2677192
12137,67,35,1,7.64,38.59,2677191,2677258
12138,55,38,2,9.31,67.63,2677257,2677312
12139,77,52,0,6.65,49.81,2677311,2677388
12140,64,35,0,8.00,62.41,2677388,2677452
12141,61,72,0,8.39,103.88,2677451,2677512
12142,114,18,0,4.49,16.39,2677512,2677626
12143,86,30,0,5.95,41.49,2677625,2677711
12144,73,76,1,7.01,91.47,2677710,2677783
12145,76,47,0,6.74,43.61,2677782,2677858
12146,73,40,0,7.01,49.44,2677858,2677931
12147,67,21,1,7.64,23.81,2677930,2677997
12148,71,30,0,7.21,32.73,2677997,2678068
12149,70,64,1,7.31,59.36,2678067,2678137
12150,55,32,1,9.31,32.61,2678136,2678191
12151,66,30,1,7.76,26.79,2678191,2678257
12152,62,35,0,8.26,39.64,2678256,2678318
12153,61,26,1,8.39,28.04,2678317,2678378
12154,50,32,1,10.24,48.14,2678377,2678427
12155,56,52,1,9.14,59.12,2678426,2678482
12156,52,33,1,9.85,41.09,2678481,2678533
12157,59,41,1,8.68,50.83,2678532,2678591
12158,70,22,1,7.31,26.19,2678590,2678660
12159,68,32,0,7.53,36.84,2678659,2678727
12160,57,33,1,8.98,45.25,2678726,2678783
12161,83,34,0,6.17,30.41,2678782,2678865
12162,63,28,0,8.13,31.00,2678864,2678927
12163,64,47,0,8.00,80.03,2678926,2678990
12164,71,64,0,7.21,74.76,2678989,2679060
12165,83,34,0,6.17,32.79,2679059,2679142
12166,93,39,0,5.51,27.60,2679141,2679234
12167,74,29,0,6.92,27.56,2679233,2679307
12168,94,19,1,5.45,16.44,2679306,2679400
12169,69,35,0,7.42,36.59,2679399,2679468
12170,83,29,0,6.17,32.31,2679467,2679550
12171,75,24,0,6.83,20.06,2679549,2679624
12172,75,35,0,6.83,26.12,2679623,2679698
12173,62,28,0,8.26,28.13,2679697,2679759
12174,63,29,1,8.13,32.36,2679759,2679822
12175,71,29,0,7.21,25.52,2679821,2679892
12176,50,50,1,10.24,96.34,2679891,2679941
12177,61,45,1,8.39,50.66,2679940,2680001
12178,65,24,1,7.88,23.22,2680000,2680065
12179,66,33,1,7.76,35.27,2680064,2680130
12180,61,30,0,8.39,46.96,2680129,2680190
12181,53,52,0,9.66,72.34,2680189,2680242
12182,77,25,1,6.65,25.40,2680241,2680318
12183,58,58,0,8.83,76.90,2680317,2680375
12184,62,34,1,8.26,34.42,2680374,2680436
12185,68,30,0,7.53,35.13,2680435,2680503
12186,70,53,0,7.31,60.82,2680502,2680572
12187,83,27,0,6.17,28.45,2680571,2680654
12188,103,28,0,4.97,20.98,2680653,2680756
12189,89,22,0,5.75,14.23,2680755,2680844
12190,97,16,0,5.28,15.73,2680843,2680940
12191,66,45,0,7.76,47.43,2680939,2681005
12192,86,22,1,5.95,17.37,2681004,2681090
12193,68,54,0,7.53,58.84,2681090,2681158
12194,73,20,1,7.01,19.36,2681157,2681230
12195,56,35,1,9.14,44.02,2681229,2681285
12196,68,30,0,7.53,23.63,2681284,2681352
12197,54,25,1,9.48,35.21,2681351,2681405
12198,66,51,1,7.76,53.37,2681404,2681470
12199,47,31,2,10.89,47.33,2681470,2681517
12200,64,45,2,8.00,44.25,2681516,2681580
12201,52,41,1,9.85,50.36,2681579,2681631
12202,73,32,1,7.01,31.41,2681630,2681703
12203,63,30,0,8.13,32.49,2681702,2681765
12204,62,24,1,8.26,29.97,2681764,2681826
12205,59,61,0,8.68,80.15,2681825,2681884
12206,63,39,1,8.13,51.32,2681883,2681946
12207,64,41,0,8.00,58.25,2681945,2682009
12208,71,24,0,7.21,30.14,2682008,2682079
12209,93,30,0,5.51,27.15,2682078,2682171
12210,76,72,0,6.74,98.04,2682170,2682246
12211,90,25,1,5.69,15.70,2682245,2682335
12212,73,24,1,7.01,27.44,2682335,2682408
12213,83,17,0,6.17,16.84,2682407,2682490
12214,69,22,1,7.42,28.19,2682490,2682559
12215,76,21,0,6.74,22.35,2682559,2682635
12216,61,38,0,8.39,34.73,2682634,2682695
12217,60,37,1,8.53,61.12,2682694,2682754
12218,64,50,1,8.00,52.94,2682753,2682817
12219,70,25,0,7.31,29.07,2682816,2682886
12220,64,20,2,8.00,20.72,2682885,2682949
12221,69,17,1,7.42,14.39,2682948,2683017
12222,61,51,2,8.39,46.99,2683016,2683077
12223,76,20,0,6.74,20.51,2683076,2683152
12224,69,19,0,7.42,20.07,2683151,2683220
12225,64,50,1,8.00,61.28,2683219,2683283
12226,59,40,1,8.68,65.81,2683282,2683341
12227,54,54,0,9.48,95.47,2683340,2683394
12228,51,56,0,10.04,122.55,2683394,2683445
12229,63,42,0,8.13,85.19,2683444,2683507
12230,65,39,0,7.88,59.25,2683506,2683571
12231,76,97,0,6.74,128.25,2683570,2683646
12232,89,39,0,5.75,45.96,2683645,2683734
12233,78,32,0,6.56,41.66,2683734,2683812
12234,73,27,1,7.01,26.40,2683811,2683884
12235,80,36,0,6.40,29.74,2683883,2683963
12236,68,46,1,7.53,60.84,2683962,2684030
12237,55,45,0,9.31,94.36,2684029,2684084
12238,68,23,1,7.53,23.69,2684083,2684151
12239,47,95,2,10.89,177.03,2684150,2684197
12240,84,21,1,6.10,15.23,2684196,2684280
12241,65,26,1,7.88,21.03,2684279,2684344
12242,54,39,1,9.48,68.73,2684343,2684397
12243,62,23,2,8.26,23.42,2684396,2684458
12244,70,27,0,7.31,24.70,2684457,2684527
12245,58,49,2,8.83,65.90,2684526,2684584
12246,71,27,0,7.21,24.70,2684583,2684654
12247,69,19,0,7.42,20.97,2684653,2684722
12248,66,36,1,7.76,33.67,2684722,2684788
12249,59,57,1,8.68,84.83,2684788,2684847
12250,45,73,1,11.38,147.21,2684847,2684892
12251,58,41,0,8.83,53.32,2684891,2684949
12252,72,33,0,7.11,52.77,2684948,2685020
12253,63,51,0,8.13,68.59,2685019,2685082
12254,102,23,0,5.02,18.10,2685081,2685183
12255,90,32,0,5.69,24.99,2685183,2685273
12256,87,30,0,5.89,25.30,2685272,2685359
12257,88,18,1,5.82,14.19,2685358,2685446
12258,78,19,0,6.56,17.27,2685445,2685523
12259,76,39,0,6.74,30.54,2685523,2685599
12260,71,35,0,7.21,32.65,2685598,2685669
12261,61,39,1,8.39,53.22,2685668,2685729
12262,69,43,1,7.42,44.10,2685728,2685797
12263,57,25,2,8.98,34.68,2685796,2685853
12264,56,29,0,9.14,29.69,2685852,2685908
12265,59,25,2,8.68,29.95,2685907,2685966
12266,61,25,1,8.39,18.96,2685965,2686026
12267,69,28,1,7.42,26.88,2686025,2686094
12268,66,29,1,7.76,30.88,2686093,2686159
12269,58,52,0,8.83,80.45,2686158,2686216
12270,61,32,1,8.39,46.86,2686215,2686276
12271,83,31,0,6.17,30.21,2686275,2686358
12272,51,43,1,10.04,78.19,2686357,2686408
12273,65,26,0,7.88,35.09,2686408,2686473
12274,71,46,0,7.21,51.83,2686472,2686543
12275,129,43,0,3.97,20.37,2686542,2686671
12276,88,24,0,5.82,21.35,2686671,2686759
12277,77,26,0,6.65,23.16,2686758,2686835
12278,91,22,0,5.63,17.75,2686834,2686925
12279,64,49,1,8.00,69.38,2686925,2686989
12280,83,17,0,6.17,15.20,2686988,2687071
12281,60,39,1,8.53,45.18,2687070,2687130
12282,68,29,0,7.53,30.81,2687129,2687197
12283,60,26,1,8.53,28.02,2687197,2687257
12284,58,33,0,8.83,35.83,2687256,2687314
12285,63,29,1,8.13,26.02,2687313,2687376
12286,68,21,0,7.53,18.90,2687375,2687443
12287,57,56,0,8.98,68.40,2687442,2687499
12288,65,20,0,7.88,26.48,2687498,2687563
12289,54,37,1,9.48,57.25,2687562,2687616
12290,53,55,1,9.66,92.53,2687615,2687668
12291,62,63,1,8.26,71.90,2687668,2687730
12292,66,25,2,7.76,29.37,2687729,2687795
12293,76,28,0,6.74,33.69,2687794,2687870
12294,43,106,1,11.91,266.08,2687869,2687912
12295,49,146,0,10.45,430.94,2687911,2687960
12296,59,49,0,8.68,80.12,2687959,2688018
12297,99,21,0,5.17,21.70,2688017,2688116
12298,90,56,0,5.69,42.73,2688115,2688205
12299,71,43,1,7.21,40.14,2688204,2688275
12300,83,24,1,6.17,20.84,2688274,2688357
12301,86,42,0,5.95,35.65,2688356,2688442
12302,68,51,1,7.53,55.51,2688441,2688509
12303,74,29,0,6.92,34.67,2688508,2688582
12304,63,61,1,8.13,75.09,2688581,2688644
12305,64,57,0,8.00,61.25,2688643,2688707
12306,77,16,0,6.65,13.34,2688706,2688783
12307,59,28,1,8.68,37.95,2688782,2688841
12308,64,28,1,8.00,24.47,2688840,2688904
12309,72,18,1,7.11,19.18,2688903,2688975
12310,57,31,1,8.98,33.49,2688974,2689031
12311,72,38,0,7.11,33.43,2689030,2689102
12312,76,26,0,6.74,20.54,2689101,2689177
12313,68,45,1,7.53,45.48,2689176,2689244
12314,56,33,1,9.14,58.55,2689243,2689299
12315,76,54,0,6.74,52.69,2689298,2689374
12316,61,43,1,8.39,62.34,2689373,2689434
12317,74,28,1,6.92,42.10,2689433,2689507
12318,103,26,0,4.97,21.87,2689506,2689609
12319,92,39,0,5.57,41.25,2689608,2689700
12320,72,46,0,7.11,46.49,2689699,2689771
12321,73,23,1,7.01,25.96,2689770,2689843
12322,89,26,1,5.75,23.49,2689842,2689931
12323,55,81,0,9.31,177.34,2689930,2689985
12324,91,21,0,5.63,15.75,2689984,2690075
12325,63,26,2,8.13,20.40,2690075,2690138
12326,65,23,1,7.88,28.69,2690137,2690202
12327,49,34,2,10.45,33.64,2690201,2690250
12328,62,50,1,8.26,58.42,2690249,2690311
12329,66,26,1,7.76,31.40,2690310,2690376
12330,66,21,1,7.76,17.12,2690375,2690441
12331,66,29,0,7.76,30.09,2690440,2690506
12332,64,42,0,8.00,35.47,2690505,2690569
12333,50,38,1,10.24,52.82,2690568,2690618
12334,60,23,1,8.53,23.58,2690617,2690677
12335,71,27,0,7.21,24.56,2690676,2690747
12336,59,49,1,8.68,66.32,2690746,2690805
12337,70,22,0,7.31,28.04,2690804,2690874
12338,59,31,1,8.68,45.54,2690873,2690932
12339,77,22,0,6.65,24.54,2690931,2691008
12340,65,32,0,7.88,44.35,2691007,2691072
12341,58,86,1,8.83,137.18,2691072,2691130
12342,61,51,0,8.39,72.96,2691129,2691190
12343,66,32,0,7.76,43.40,2691189,2691255
12344,71,18,0,7.21,19.04,2691254,2691325
12345,84,28,0,6.10,27.32,2691324,2691408
12346,91,23,0,5.63,27.93,2691407,2691498
12347,98,28,0,5.22,28.05,2691497,2691595
12348,86,38,0,5.95,38.70,2691594,2691680
12349,69,26,0,7.42,37.20,2691679,2691748
12350,80,24,0,6.40,22.56,2691747,2691827
12351,83,24,0,6.17,18.62,2691826,2691909
12352,68,33,1,7.53,23.72,2691908,2691976
12353,74,18,0,6.92,24.10,2691975,2692049
12354,61,24,1,8.39,23.32,2692048,2692109
12355,67,32,1,7.64,38.08,2692108,2692175
12356,57,37,1,8.98,54.89,2692174,2692231
12357,77,40,0,6.65,33.55,2692230,2692307
12358,64,33,1,8.00,38.09,2692306,2692370
12359,63,28,1,8.13,31.48,2692369,2692432
12360,66,44,0,7.76,49.49,2692431,2692497
12361,57,37,1,8.98,44.86,2692496,2692553
12362,57,31,1,8.98,40.47,2692552,2692609
12363,60,30,2,8.53,27.28,2692608,2692668
12364,61,54,1,8.39,56.66,2692667,2692728
12365,69,24,0,7.42,25.40,2692727,2692796
12366,59,52,0,8.68,64.15,2692796,2692855
12367,59,35,1,8.68,40.83,2692854,2692913
12368,53,77,1,9.66,117.02,2692913,2692966
12369,68,40,0,7.53,45.13,2692965,2693033
12370,71,24,0,7.21,28.28,2693032,2693103
12371,71,34,0,7.21,36.31,2693102,2693173
12372,83,29,0,6.17,32.60,2693172,2693255
12373,84,21,0,6.10,19.25,2693254,2693338
12374,101,35,0,5.07,38.14,2693337,2693438
12375,70,76,0,7.31,164.56,2693437,2693507
12376,74,29,0,6.92,31.10,2693507,2693581
12377,73,25,0,7.01,34.75,2693580,2693653
12378,86,28,1,5.95,21.86,2693652,2693738
12379,83,47,1,6.17,33.88,2693737,2693820
12380,79,20,1,6.48,16.05,2693819,2693898
12381,80,44,0,6.40,34.09,2693897,2693977
12382,75,39,0,6.83,39.48,2693976,2694051
12383,73,24,0,7.01,26.95,2694051,2694124
12384,70,22,1,7.31,19.59,2694123,2694193
12385,70,30,1,7.31,35.04,2694192,2694262
12386,66,34,0,7.76,33.94,2694262,2694328
12387,62,27,1,8.26,26.87,2694327,2694389
12388,79,28,1,6.48,21.64,2694388,2694467
12389,57,34,2,8.98,42.05,2694466,2694523
12390,68,23,1,7.53,17.46,2694522,2694590
12391,66,23,1,7.76,23.34,2694590,2694656
12392,57,28,1,8.98,38.09,2694655,2694712
12393,65,38,0,7.88,40.66,2694711,2694776
12394,70,26,1,7.31,26.50,2694775,2694845
12395,70,18,1,7.31,19.47,2694844,2694914
12396,82,27,0,6.24,21.43,2694914,2694996
12397,57,30,0,8.98,45.60,2694995,2695052
12398,70,40,0,7.31,54.67,2695051,2695121
12399,47,54,0,10.89,159.29,2695120,2695167
12400,49,40,1,10.45,52.41,2695166,2695215
12401,96,29,0,5.33,21.68,2695214,2695310
12402,88,76,0,5.82,79.42,2695309,2695397
12403,94,49,0,5.45,47.93,2695396,2695490
12404,76,37,1,6.74,29.40,2695489,2695565
12405,81,30,0,6.32,30.44,2695564,2695645
12406,59,39,1,8.68,47.10,2695645,2695704
12407,64,54,0,8.00,96.19,2695703,2695767
12408,65,39,1,7.88,51.28,2695766,2695831
12409,54,44,1,9.48,82.51,2695830,2695884
12410,64,44,1,8.00,51.50,2695883,2695947
12411,67,52,0,7.64,73.19,2695946,2696013
12412,65,27,1,7.88,23.43,2696012,2696077
12413,63,27,0,8.13,38.24,2696076,2696139
12414,89,15,0,5.75,13.06,2696138,2696227
12415,56,34,2,9.14,36.37,2696226,2696282
12416,68,26,1,7.53,34.13,2696281,2696349
12417,67,20,1,7.64,22.17,2696348,2696415
12418,61,34,0,8.39,44.57,2696414,2696475
12419,60,27,0,8.53,25.32,2696474,2696534
12420,58,27,1,8.83,32.32,2696533,2696591
12421,65,32,0,7.88,32.05,2696591,2696656
12422,56,35,0,9.14,48.34,2696655,2696711
12423,58,120,0,8.83,250.28,2696710,2696768
12424,61,26,1,8.39,35.32,2696767,2696828
12425,67,32,2,7.64,36.59,2696827,2696894
12426,58,34,0,8.83,60.94,2696893,2696951
12427,66,27,0,7.76,33.52,2696950,2697016
12428,30,130,0,17.07,928.00,2697015,2697045
12429,45,111,1,11.38,281.21,2697044,2697089
12430,48,145,0,10.67,425.89,2697088,2697136
12431,74,29,0,6.92,41.26,2697135,2697209
12432,94,27,0,5.45,25.72,2697208,2697302
12433,98,39,0,5.22,29.48,2697302,2697400
12434,101,41,0,5.07,26.22,2697400,2697501
12435,81,30,1,6.32,24.19,2697500,2697581
12436,68,47,1,7.53,58.72,2697580,2697648
12437,84,46,0,6.10,44.94,2697648,2697732
12438,82,26,0,6.24,25.60,2697731,2697813
12439,66,33,1,7.76,38.21,2697812,2697878
12440,78,27,0,6.56,26.09,2697878,2697956
12441,63,27,1,8.13,38.24,2697955,2698018
12442,69,18,0,7.42,17.26,2698017,2698086
12443,71,21,1,7.21,21.29,2698086,2698157
12444,63,34,0,8.13,40.56,2698156,2698219
12445,54,30,1,9.48,34.95,2698218,2698272
12446,64,22,0,8.00,24.53,2698271,2698335
12447,52,35,2,9.85,48.40,2698334,2698386
12448,64,28,0,8.00,26.31,2698385,2698449
12449,57,69,0,8.98,117.07,2698448,2698505
12450,77,18,0,6.65,20.75,2698504,2698581
12451,62,30,1,8.26,29.35,2698580,2698642
12452,64,40,1,8.00,69.56,2698641,2698705
12453,70,31,0,7.31,35.82,2698704,2698774
12454,59,30,1,8.68,33.98,2698773,2698832
12455,55,101,0,9.31,223.12,2698831,2698886
12456,69,71,1,7.42,97.78,2698885,2698954
12457,89,35,0,5.75,46.01,2698953,2699042
12458,92,23,0,5.57,26.59,2699041,2699133
12459,72,29,0,7.11,29.04,2699132,2699204
12460,83,21,1,6.17,15.35,2699203,2699286
12461,81,32,0,6.32,25.25,2699286,2699367
12462,79,17,0,6.48,17.03,2699366,2699445
12463,82,25,0,6.24,21.60,2699444,2699526
12464,78,31,0,6.56,25.40,2699525,2699603
12465,65,33,1,7.88,24.82,2699602,2699667
12466,67,26,1,7.64,29.84,2699666,2699733
12467,63,22,1,8.13,23.98,2699732,2699795
12468,71,19,1,7.21,18.05,2699794,2699865
12469,62,32,1,8.26,28.90,2699864,2699926
12470,54,47,1,9.48,61.21,2699926,2699980
12471,60,35,1,8.53,42.45,2699979,2700039
12472,57,70,1,8.98,101.35,2700038,2700095
12473,66,25,1,7.76,24.58,2700094,2700160
12474,65,32,0,7.88,33.15,2700159,2700224
12475,82,29,0,6.24,28.36,2700223,2700305
12476,63,29,1,8.13,24.81,2700304,2700367
12477,67,52,0,7.64,57.45,2700366,2700433
12478,86,23,0,5.95,24.02,2700432,2700518
12479,63,24,0,8.13,32.14,2700517,2700580
12480,66,38,1,7.76,46.12,2700579,2700645
12481,75,50,0,6.83,49.80,2700644,2700719
12482,80,34,0,6.40,37.14,2700718,2700798
12483,96,35,0,5.33,27.58,2700797,2700893
12484,103,36,0,4.97,36.59,2700892,2700995
12485,77,43,1,6.65,37.42,2700994,2701071
12486,80,30,1,6.40,23.51,2701070,2701150
12487,93,27,0,5.51,17.41,2701149,2701242
12488,58,65,1,8.83,115.76,2701241,2701299
12489,70,26,1,7.31,23.24,2701298,2701368
12490,68,32,0,7.53,45.60,2701367,2701435
12491,61,29,0,8.39,34.34,2701434,2701495
12492,65,51,1,7.88,48.08,2701494,2701559
12493,73,20,0,7.01,14.45,2701558,2701631
12494,68,23,0,7.53,25.57,2701630,2701698
12495,69,28,1,7.42,20.13,2701697,2701766
12496,59,39,0,8.68,45.74,2701766,2701825
12497,65,28,0,7.88,31.80,2701824,2701889
12498,61,26,0,8.39,35.75,2701888,2701949
12499,68,34,1,7.53,26.57,2701948,2702016
12500,63,23,1,8.13,22.62,2702015,2702078
12501,66,22,1,7.76,18.09,2702077,2702143
12502,71,27,0,7.21,38.00,2702142,2702213
12503,68,19,0,7.53,26.28,2702213,2702281
12504,58,56,1,8.83,83.04,2702280,2702338
12505,46,98,1,11.13,195.16,2702337,2702383
12506,67,82,0,7.64,121.45,2702382,2702449
12507,54,30,0,9.48,44.21,2702448,2702502
12508,72,34,0,7.11,35.93,2702501,2702573
12509,75,48,0,6.83,44.20,2702572,2702647
12510,105,20,0,4.88,16.13,2702646,2702751
12511,91,32,0,5.63,32.74,2702750,2702841
12512,92,42,0,5.57,35.90,2702840,2702932
12513,84,21,0,6.10,20.16,2702931,2703015
12514,76,30,0,6.74,43.06,2703014,2703090
12515,80,39,0,6.40,30.64,2703089,2703169
12516,77,21,0,6.65,21.37,2703168,2703245
12517,56,38,0,9.14,58.37,2703244,2703300
12518,82,33,1,6.24,20.82,2703299,2703381
12519,64,35,0,8.00,34.94,2703381,2703445
12520,65,20,1,7.88,25.49,2703444,2703509
12521,59,39,1,8.68,38.49,2703508,2703567
12522,62,27,1,8.26,30.93,2703566,2703628
12523,55,24,1,9.31,26.32,2703627,2703682
12524,66,27,0,7.76,27.67,2703681,2703747
12525,59,40,1,8.68,49.07,2703746,2703805
12526,62,32,1,8.26,35.48,2703804,2703866
12527,65,20,1,7.88,21.89,2703865,2703930
12528,72,22,1,7.11,18.27,2703930,2704002
12529,64,25,2,8.00,19.66,2704001,2704065
12530,54,34,1,9.48,63.03,2704064,2704118
12531,83,28,0,6.17,21.35,2704117,2704200
12532,52,51,3,9.85,60.40,2704199,2704251
12533,74,26,1,6.92,20.78,2704250,2704324
12534,70,52,0,7.31,55.62,2704323,2704393
12535,46,60,1,11.13,130.68,2704393,2704439
12536,66,34,0,7.76,45.67,2704438,2704504
12537,70,58,0,7.31,74.24,2704504,2704574
12538,88,41,0,5.82,30.31,2704573,2704661
12539,100,33,0,5.12,27.37,2704661,2704761
12540,107,22,0,4.79,19.93,2704760,2704867
12541,74,24,0,6.92,27.91,2704867,2704941
12542,76,29,1,6.74,30.88,2704941,2705017
12543,87,40,0,5.89,32.63,2705016,2705103
12544,77,46,1,6.65,47.58,2705102,2705179
12545,64,46,0,8.00,43.09,2705178,2705242
12546,69,36,0,7.42,40.65,2705241,2705310
12547,66,28,1,7.76,30.88,2705309,2705375
12548,66,20,0,7.76,23.55,2705374,2705440
12549,58,56,1,8.83,78.83,2705439,2705497
12550,59,31,2,8.68,37.40,2705497,2705556
12551,68,25,1,7.53,24.01,2705555,2705623
12552,62,24,1,8.26,26.74,2705622,2705684
12553,60,32,1,8.53,32.55,2705683,2705743
12554,66,29,1,7.76,26.91,2705742,2705808
12555,64,28,0,8.00,39.84,2705807,2705871
12556,51,67,0,10.04,142.78,2705870,2705921
12557,63,46,0,8.13,50.65,2705920,2705983
12558,59,25,1,8.68,34.63,2705982,2706041
12559,63,30,1,8.13,23.25,2706040,2706103
12560,67,49,0,7.64,55.30,2706102,2706169
12561,54,30,1,9.48,35.88,2706168,2706222
12562,80,32,0,6.40,24.04,2706221,2706301
12563,72,26,1,7.11,30.02,2706300,2706372
12564,69,51,1,7.42,47.78,2706371,2706440
12565,50,47,1,10.24,68.98,2706439,2706489
12566,48,70,0,10.67,133.89,2706488,2706536
12567,72,33,0,7.11,44.57,2706536,2706608
12568,86,23,0,5.95,23.65,2706607,2706693
12569,98,28,0,5.22,28.83,2706692,2706790
12570,85,29,0,6.02,29.03,2706789,2706874
12571,80,31,0,6.40,26.31,2706873,2706953
12572,87,35,0,5.89,41.02,2706952,2707039
12573,50,69,1,10.24,180.26,2707038,2707088
12574,72,39,0,7.11,53.35,2707087,2707159
12575,75,24,0,6.83,24.49,2707158,2707233
12576,73,54,0,7.01,53.60,2707232,2707305
12577,64,31,1,8.00,40.28,2707304,2707368
12578,68,26,1,7.53,24.40,2707367,2707435
12579,63,26,1,8.13,31.95,2707434,2707497
12580,64,29,0,8.00,38.38,2707496,2707560
12581,63,23,0,8.13,25.54,2707560,2707623
12582,65,43,1,7.88,50.57,2707622,2707687
12583,41,50,2,12.49,97.57,2707686,2707727
12584,61,33,0,8.39,44.83,2707727,2707788
12585,64,22,1,8.00,24.97,2707787,2707851
12586,44,93,1,11.64,204.05,2707850,2707894
12587,67,18,0,7.64,20.59,2707893,2707960
12588,63,50,0,8.13,57.67,2707959,2708022
12589,49,63,1,10.45,158.49,2708021,2708070
12590,65,42,0,7.88,49.03,2708069,2708134
12591,59,38,1,8.68,44.12,2708133,2708192
12592,74,23,0,6.92,19.70,2708191,2708265
12593,52,43,1,9.85,74.21,2708265,2708317
12594,77,22,0,6.65,24.54,2708316,2708393
12595,62,35,0,8.26,44.26,2708392,2708454
12596,74,33,0,6.92,38.21,2708453,2708527
12597,85,35,0,6.02,34.40,2708526,2708611
12598,121,20,0,4.23,15.55,2708611,2708732
12599,107,37,0,4.79,30.45,2708731,2708838
12600,82,24,1,6.24,25.33,2708837,2708919
12601,75,33,0,6.83,36.54,2708919,2708994
12602,96,19,0,5.33,14.47,2708993,2709089
12603,78,30,0,6.56,26.17,2709088,2709166
12604,58,46,1,8.83,78.28,2709165,2709223
12605,68,59,1,7.53,67.78,2709222,2709290
12606,65,47,0,7.88,46.72,2709289,2709354
12607,63,33,0,8.13,38.40,2709353,2709416
12608,64,22,0,8.00,26.06,2709416,2709480
12609,73,23,1,7.01,25.41,2709479,2709552
12610,61,32,0,8.39,33.78,2709551,2709612
12611,70,29,1,7.31,24.44,2709611,2709681
12612,58,26,0,8.83,31.87,2709680,2709738
12613,69,26,0,7.42,26.82,2709737,2709806
12614,51,31,3,10.04,38.23,2709805,2709856
12615,70,33,1,7.31,30.02,2709855,2709925
12616,57,32,0,8.98,45.46,2709924,2709981
12617,70,30,2,7.31,22.59,2709980,2710050
12618,74,31,0,6.92,29.99,2710049,2710123
12619,62,23,1,8.26,35.29,2710122,2710184
12620,72,37,0,7.11,36.88,2710183,2710255
12621,72,43,1,7.11,38.96,2710255,2710327
12622,60,27,1,8.53,32.28,2710326,2710386
12623,62,36,1,8.26,33.61,2710385,2710447
12624,67,44,0,7.64,59.75,2710446,2710513
12625,92,22,0,5.57,19.66,2710512,2710604
12626,86,62,0,5.95,60.77,2710603,2710689
12627,100,24,0,5.12,25.01,2710688,2710788
12628,83,30,0,6.17,17.22,2710787,2710870
12629,90,20,0,5.69,15.06,2710869,2710959
12630,71,32,1,7.21,30.84,2710958,2711029
12631,65,27,1,7.88,31.98,2711028,2711093
12632,57,30,1,8.98,38.51,2711092,2711149
12633,68,55,1,7.53,47.93,2711148,2711216
12634,67,55,0,7.64,49.01,2711215,2711282
12635,60,28,0,8.53,37.78,2711281,2711341
12636,76,29,0,6.74,21.46,2711340,2711416
12637,60,43,1,8.53,35.32,2711415,2711475
12638,71,28,1,7.21,20.39,2711474,2711545
12639,61,39,2,8.39,36.24,2711544,2711605
12640,55,26,1,9.31,33.85,2711604,2711659
12641,54,32,1,9.48,41.36,2711658,2711712
12642,72,30,0,7.11,28.99,2711712,2711784
12643,59,44,2,8.68,40.25,2711783,2711842
12644,80,24,0,6.40,23.62,2711841,2711921
12645,60,24,1,8.53,22.22,2711920,2711980
12646,57,73,0,8.98,118.44,2711979,2712036
12647,76,21,1,6.74,22.88,2712035,2712111
12648,53,54,1,9.66,70.68,2712111,2712164
12649,41,56,1,12.49,128.54,2712163,2712204
12650,67,35,0,7.64,39.60,2712203,2712270
12651,73,22,1,7.01,24.56,2712269,2712342
12652,102,19,0,5.02,20.71,2712341,2712443
12653,87,24,0,5.89,23.37,2712442,2712529
12654,87,27,0,5.89,24.47,2712529,2712616
12655,61,27,1,8.39,36.73,2712615,2712676
12656,82,20,0,6.24,21.21,2712675,2712757
12657,72,32,1,7.11,25.99,2712756,2712828
12658,90,25,0,5.69,18.24,2712827,2712917
12659,61,30,1,8.39,37.03,2712916,2712977
12660,76,26,0,6.74,29.17,2712976,2713052
12661,72,29,0,7.11,27.24,2713051,2713123
12662,61,31,1,8.39,31.09,2713122,2713183
12663,53,33,1,9.66,46.34,2713182,2713235
12664,69,29,0,7.42,34.24,2713234,2713303
12665,58,22,0,8.83,27.66,2713303,2713361
12666,47,102,1,10.89,216.56,2713360,2713407
12667,54,44,0,9.48,63.62,2713406,2713460
12668,53,35,1,9.66,40.83,2713460,2713513
12669,61,25,1,8.39,33.29,2713512,2713573
12670,50,60,1,10.24,106.14,2713572,2713622
12671,51,55,1,10.04,71.68,2713622,2713673
12672,69,34,1,7.42,24.74,2713672,2713741
12673,44,70,2,11.64,149.37,2713740,2713784
12674,65,23,1,7.88,30.08,2713783,2713848
12675,59,23,2,8.68,23.20,2713847,2713906
12676,63,25,2,8.13,22.17,2713905,2713968
12677,77,48,0,6.65,43.66,2713967,2714044
12678,62,31,1,8.26,36.39,2714044,2714106
12679,51,28,1,10.04,52.47,2714105,2714156
12680,62,30,0,8.26,42.19,2714155,2714217
12681,63,33,0,8.13,63.63,2714216,2714279
12682,77,33,0,6.65,35.86,2714278,2714355
12683,96,45,0,5.33,49.56,2714354,2714450
12684,114,60,0,4.49,46.78,2714449,2714563
12685,65,32,1,7.88,47.71,2714562,2714627
12686,82,30,0,6.24,18.14,2714626,2714708
12687,82,32,0,6.24,32.36,2714707,2714789
12688,83,49,0,6.17,62.62,2714788,2714871
12689,70,27,1,7.31,28.33,2714870,2714940
12690,88,29,0,5.82,16.72,2714940,2715028
12691,59,24,0,8.68,24.93,2715027,2715086
12692,69,17,0,7.42,21.32,2715085,2715154
12693,69,36,0,7.42,37.84,2715154,2715223
12694,66,26,0,7.76,25.18,2715222,2715288
12695,63,28,2,8.13,33.60,2715287,2715350
12696,58,32,1,8.83,45.45,2715349,2715407
12697,56,39,1,9.14,78.30,2715406,2715462
12698,49,47,1,10.45,96.57,2715461,2715510
12699,60,27,1,8.53,31.38,2715509,2715569
12700,56,29,0,9.14,39.62,2715568,2715624
12701,63,38,1,8.13,44.02,2715623,2715686
12702,58,25,1,8.83,29.52,2715685,2715743
12703,56,44,0,9.14,50.84,2715743,2715799
12704,73,64,0,7.01,73.33,2715798,2715871
12705,61,30,2,8.39,30.63,2715870,2715931
12706,57,31,1,8.98,35.28,2715930,2715987
12707,80,27,0,6.40,28.32,2715986,2716066
12708,63,33,1,8.13,47.51,2716065,2716128
12709,59,75,0,8.68,126.46,2716127,2716186
12710,58,33,1,8.83,48.42,2716186,2716244
12711,86,45,0,5.95,36.32,2716243,2716329
12712,119,23,0,4.30,16.97,2716328,2716447
12713,106,28,0,4.83,21.78,2716446,2716552
12714,77,44,1,6.65,35.08,2716551,2716628
12715,74,36,0,6.92,41.56,2716628,2716702
12716,91,23,0,5.63,23.22,2716701,2716792
12717,62,25,1,8.26,27.71,2716791,2716853
12718,62,32,1,8.26,45.06,2716852,2716914
12719,88,42,0,5.82,32.92,2716913,2717001
12720,68,41,0,7.53,58.60,2717000,2717068
12721,62,31,0,8.26,33.90,2717067,2717129
12722,67,21,1,7.64,20.44,2717128,2717195
12723,62,45,1,8.26,56.16,2717194,2717256
12724,65,21,1,7.88,21.43,2717255,2717320
12725,64,32,1,8.00,26.62,2717319,2717383
12726,68,27,1,7.53,28.01,2717383,2717451
12727,52,47,0,9.85,64.32,2717450,2717502
12728,55,34,1,9.31,36.69,2717501,2717556
12729,55,49,1,9.31,66.47,2717556,2717611
12730,62,28,1,8.26,30.22,2717610,2717672
12731,75,24,0,6.83,22.04,2717671,2717746
12732,75,18,0,6.83,16.65,2717745,2717820
12733,59,30,1,8.68,40.66,2717819,2717878
12734,62,40,0,8.26,48.61,2717877,2717939
12735,75,22,1,6.83,25.82,2717939,2718014
12736,59,35,0,8.68,52.18,2718013,2718072
12737,62,31,1,8.26,35.22,2718071,2718133
12738,57,39,0,8.98,68.68,2718132,2718189
12739,82,24,0,6.24,24.67,2718188,2718270
12740,101,81,0,5.07,71.25,2718269,2718370
12741,83,51,0,6.17,56.12,2718369,2718452
12742,68,54,0,7.53,63.28,2718451,2718519
12743,87,26,1,5.89,17.69,2718518,2718605
12744,71,42,0,7.21,50.76,2718604,2718675
12745,65,35,0,7.88,43.62,2718675,2718740
12746,69,35,1,7.42,39.87,2718739,2718808
12747,65,32,1,7.88,31.43,2718807,2718872
12748,69,39,1,7.42,46.59,2718872,2718941
12749,60,28,1,8.53,29.68,2718941,2719001
12750,66,25,0,7.76,25.94,2719000,2719066
12751,68,29,1,7.53,23.60,2719065,2719133
12752,63,31,1,8.13,27.54,2719132,2719195
12753,60,47,0,8.53,72.98,2719194,2719254
12754,60,35,1,8.53,49.28,2719253,2719313
12755,44,30,1,11.64,56.28,2719312,2719356
12756,61,100,1,8.39,158.40,2719355,2719416
12757,66,27,1,7.76,33.15,2719415,2719481
12758,69,29,1,7.42,27.78,2719480,2719549
12759,76,31,1,6.74,28.43,2719548,2719624
12760,65,23,1,7.88,27.46,2719623,2719688
12761,64,21,1,8.00,26.88,2719687,2719751
12762,73,26,0,7.01,31.55,2719750,2719823
12763,57,44,0,8.98,52.26,2719822,2719879
12764,65,47,0,7.88,61.34,2719878,2719943
12765,74,27,0,6.92,34.64,2719942,2720016
12766,84,27,0,6.10,36.35,2720015,2720099
12767,96,43,0,5.33,45.72,2720098,2720194
12768,93,41,0,5.51,41.05,2720193,2720286
12769,83,20,0,6.17,16.96,2720285,2720368
12770,72,29,0,7.11,28.40,2720367,2720439
12771,84,29,0,6.10,26.44,2720438,2720522
12772,81,21,1,6.32,13.18,2720522,2720603
12773,73,44,1,7.01,35.25,2720602,2720675
12774,62,49,0,8.26,52.09,2720674,2720736
12775,71,33,1,7.21,35.63,2720735,2720806
12776,65,19,1,7.88,21.12,2720805,2720870
12777,65,32,0,7.88,38.35,2720869,2720934
12778,58,39,2,8.83,40.35,2720933,2720991
12779,56,35,1,9.14,49.55,2720990,2721046
12780,65,32,1,7.88,27.62,2721045,2721110
12781,35,64,1,14.63,169.60,2721109,2721144
12782,58,26,1,8.83,31.97,2721143,2721201
12783,50,56,1,10.24,96.70,2721200,2721250
12784,62,32,0,8.26,38.93,2721249,2721311
12785,77,27,0,6.65,25.84,2721310,2721387
12786,50,37,1,10.24,66.62,2721387,2721437
12787,61,30,1,8.39,34.07,2721436,2721497
12788,61,36,1,8.39,43.68,2721496,2721557
12789,77,36,0,6.65,34.36,2721556,2721633
12790,57,23,1,8.98,25.03,2721632,2721689
12791,56,36,0,9.14,55.77,2721688,2721744
12792,60,41,0,8.53,92.38,2721743,2721803
12793,63,34,0,8.13,50.27,2721802,2721865
12794,102,36,0,5.02,34.96,2721864,2721966
12795,108,27,0,4.74,24.88,2721965,2722073
12796,75,25,1,6.83,32.81,2722073,2722148
12797,87,21,0,5.89,13.39,2722147,2722234
12798,72,27,0,7.11,24.65,2722233,2722305
12799,79,24,0,6.48,28.25,2722305,2722384
12800,59,30,2,8.68,37.54,2722384,2722443
12801,88,24,0,5.82,17.92,2722442,2722530
12802,67,31,0,7.64,28.53,2722529,2722596
12803,70,21,0,7.31,18.02,2722595,2722665
12804,71,37,1,7.21,30.62,2722664,2722735
12805,75,25,0,6.83,31.02,2722734,2722809
12806,69,30,2,7.42,26.71,2722808,2722877
12807,67,30,0,7.64,29.30,2722876,2722943
12808,62,33,2,8.26,24.26,2722942,2723004
12809,54,26,1,9.48,35.36,2723004,2723058
12810,64,35,1,8.00,32.69,2723057,2723121
12811,80,19,0,6.40,15.89,2723120,2723200
12812,62,55,0,8.26,85.71,2723199,2723261
12813,56,39,1,9.14,43.52,2723261,2723317
12814,80,23,1,6.40,16.14,2723316,2723396
12815,47,87,0,10.89,158.52,2723395,2723442
12816,77,21,0,6.65,24.10,2723441,2723518
12817,54,55,1,9.48,85.84,2723517,2723571
12818,54,34,0,9.48,56.32,2723570,2723624
12819,58,43,0,8.83,88.59,2723623,2723681
12820,65,25,0,7.88,29.62,2723680,2723745
12821,111,32,0,4.61,29.64,2723744,2723855
12822,115,25,0,4.45,21.59,2723854,2723969
12823,78,28,1,6.56,29.86,2723968,2724046
12824,76,37,0,6.74,43.04,2724045,2724121
12825,93,17,0,5.51,14.36,2724121,2724214
12826,80,33,1,6.40,33.02,2724213,2724293
12827,52,70,1,9.85,109.63,2724292,2724344
12828,90,30,0,5.69,19.04,2724343,2724433
12829,57,44,0,8.98,54.12,2724432,2724489
12830,61,28,1,8.39,41.32,2724488,2724549
12831,66,20,1,7.76,21.12,2724549,2724615
12832,72,19,1,7.11,20.85,2724614,2724686
12833,62,31,1,8.26,36.64,2724685,2724747
12834,68,32,1,7.53,32.90,2724746,2724814
12835,53,54,1,9.66,102.07,2724814,2724867
12836,62,30,1,8.26,33.74,2724866,2724928
12837,68,38,1,7.53,38.57,2724927,2724995
12838,39,89,1,13.13,259.14,2724994,2725033
12839,62,67,1,8.26,77.80,2725032,2725094
12840,54,36,1,9.48,47.47,2725093,2725147
12841,61,35,1,8.39,53.91,2725146,2725207
12842,67,29,0,7.64,43.63,2725206,2725273
12843,64,32,1,8.00,34.97,2725272,2725336
12844,63,32,0,8.13,33.38,2725335,2725398
12845,68,54,0,7.53,58.07,2725398,2725466
12846,65,35,0,7.88,62.29,2725465,2725530
12847,56,62,0,9.14,92.80,2725529,2725585
12848,42,95,0,12.19,346.30,2725584,2725626
12849,60,33,0,8.53,55.45,2725626,2725686
12850,58,90,0,8.83,161.76,2725685,2725743
12851,52,45,0,9.85,107.94,2725742,2725794
12852,90,37,0,5.69,42.86,2725793,2725883
12853,122,21,0,4.20,15.60,2725882,2726004
12854,67,30,0,7.64,37.84,2726003,2726070
12855,87,34,1,5.89,24.17,2726069,2726156
12856,79,31,0,6.48,33.06,2726155,2726234
12857,77,26,0,6.65,26.75,2726233,2726310
12858,52,74,1,9.85,134.13,2726309,2726361
12859,68,34,0,7.53,38.37,2726360,2726428
12860,62,34,0,8.26,43.77,2726427,2726489
12861,64,41,1,8.00,32.00,2726488,2726552
12862,67,32,1,7.64,35.81,2726551,2726618
12863,64,31,1,8.00,31.28,2726617,2726681
12864,76,20,1,6.74,16.83,2726680,2726756
12865,63,31,1,8.13,35.38,2726755,2726818
12866,59,46,2,8.68,61.34,2726817,2726876
12867,42,98,2,12.19,213.20,2726875,2726917
12868,67,55,0,7.64,53.16,2726917,2726984
12869,56,54,1,9.14,86.37,2726983,2727039
12870,62,24,0,8.26,24.77,2727038,2727100
12871,71,26,0,7.21,33.60,2727099,2727170
12872,60,30,1,8.53,28.38,2727170,2727230
12873,63,49,0,8.13,68.87,2727229,2727292
12874,59,42,0,8.68,52.49,2727291,2727350
12875,56,60,0,9.14,108.52,2727350,2727406
12876,68,49,0,7.53,70.07,2727405,2727473
12877,52,34,0,9.85,52.75,2727472,2727524
12878,81,31,0,6.32,31.58,2727523,2727604
12879,58,43,0,8.83,59.52,2727603,2727661
12880,106,44,0,4.83,34.27,2727660,2727766
12881,93,43,0,5.51,38.83,2727766,2727859
12882,66,27,1,7.76,30.43,2727858,2727924
12883,83,34,0,6.17,30.69,2727923,2728006
12884,88,34,0,5.82,25.58,2728005,2728093
12885,77,39,1,6.65,33.55,2728092,2728169
12886,58,41,1,8.83,61.11,2728168,2728226
12887,69,84,0,7.42,115.69,2728225,2728294
12888,58,33,2,8.83,39.59,2728293,2728351
12889,66,27,2,7.76,23.30,2728350,2728416
12890,59,31,1,8.68,30.76,2728415,2728474
12891,73,25,1,7.01,26.75,2728473,2728546
12892,45,90,0,11.38,189.04,2728545,2728590
12893,66,25,1,7.76,31.06,2728589,2728655
12894,52,39,0,9.85,50.09,2728654,2728706
12895,73,30,1,7.01,22.73,2728705,2728778
12896,52,22,1,9.85,25.51,2728777,2728829
12897,55,52,1,9.31,51.23,2728828,2728883
12898,63,40,1,8.13,40.24,2728883,2728946
12899,66,25,0,7.76,31.82,2728945,2729011
12900,72,36,1,7.11,32.24,2729010,2729082
12901,66,25,1,7.76,29.61,2729081,2729147
12902,57,45,2,8.98,73.42,2729146,2729203
12903,58,45,0,8.83,70.66,2729202,2729260
12904,58,48,0,8.83,80.69,2729260,2729318
12905,68,31,1,7.53,35.75,2729317,2729385
12906,67,29,0,7.64,41.84,2729384,2729451
12907,78,25,0,6.56,24.07,2729450,2729528
12908,92,38,0,5.57,48.40,2729527,2729619
12909,73,58,0,7.01,76.07,2729618,2729691
12910,88,20,0,5.82,23.22,2729690,2729778
12911,81,26,0,6.32,24.32,2729777,2729858
12912,81,22,0,6.32,22.64,2729857,2729938
12913,82,23,0,6.24,18.70,2729937,2730019
12914,72,38,0,7.11,38.74,2730018,2730090
12915,76,23,1,6.74,19.77,2730089,2730165
12916,64,50,0,8.00,59.81,2730164,2730228
12917,61,35,1,8.39,36.50,2730227,2730288
12918,62,26,0,8.26,28.03,2730287,2730349
12919,57,63,1,8.98,80.26,2730348,2730405
12920,53,60,0,9.66,97.51,2730404,2730457
12921,65,41,0,7.88,39.18,2730456,2730521
12922,47,51,0,10.89,96.31,2730520,2730567
12923,52,68,0,9.85,109.98,2730566,2730618
12924,66,30,1,7.76,29.88,2730617,2730683
12925,64,44,0,8.00,40.78,2730682,2730746
12926,72,30,1,7.11,21.13,2730745,2730817
12927,71,26,1,7.21,24.73,2730816,2730887
12928,61,54,0,8.39,74.24,2730886,2730947
12929,54,49,1,9.48,72.14,2730946,2731000
12930,52,77,0,9.85,205.25,2730999,2731051
12931,95,22,0,5.39,26.09,2731050,2731145
12932,103,24,0,4.97,22.92,2731145,2731248
12933,82,27,0,6.24,27.70,2731247,2731329
12934,71,39,1,7.21,42.05,2731328,2731399
12935,87,29,0,5.89,28.08,2731398,2731485
12936,63,42,1,8.13,41.06,2731484,2731547
12937,68,22,0,7.53,26.60,2731546,2731614
12938,46,57,1,11.13,147.24,2731613,2731659
12939,63,23,1,8.13,22.08,2731658,2731721
12940,64,35,0,8.00,58.09,2731720,2731784
12941,60,26,1,8.53,28.52,2731783,2731843
12942,57,26,1,8.98,40.09,2731842,2731899
12943,57,36,0,8.98,43.49,2731898,2731955
12944,63,28,1,8.13,23.09,2731954,2732017
12945,60,29,1,8.53,24.82,2732016,2732076
12946,66,26,1,7.76,26.52,2732075,2732141
12947,72,22,0,7.11,21.38,2732141,2732213
12948,59,46,1,8.68,60.63,2732212,2732271
12949,69,32,1,7.42,36.19,2732270,2732339
12950,63,35,0,8.13,45.79,2732338,2732401
12951,54,78,0,9.48,136.58,2732400,2732454
12952,70,36,0,7.31,49.53,2732453,2732523
12953,106,31,0,4.83,29.29,2732522,2732628
12954,95,38,0,5.39,31.08,2732627,2732722
12955,69,33,1,7.42,29.17,2732721,2732790
12956,101,27,0,5.07,17.77,2732789,2732890
12957,59,48,0,8.68,81.30,2732889,2732948
12958,83,21,1,6.17,19.63,2732947,2733030
12959,53,33,0,9.66,58.41,2733029,2733082
12960,60,34,1,8.53,33.48,2733081,2733141
12961,65,32,1,7.88,42.78,2733140,2733205
12962,71,21,0,7.21,19.83,2733204,2733275
12963,49,104,2,10.45,231.80,2733274,2733323
12964,64,27,1,8.00,27.81,2733322,2733386
12965,57,27,1,8.98,30.58,2733385,2733442
12966,62,50,1,8.26,63.29,2733441,2733503
12967,71,40,0,7.21,36.87,2733502,2733573
12968,68,33,1,7.53,27.81,2733572,2733640
12969,69,31,1,7.42,24.88,2733639,2733708
12970,65,67,0,7.88,87.34,2733707,2733772
12971,56,69,0,9.14,109.34,2733772,2733828
12972,46,83,0,11.13,233.33,2733828,2733874
12973,80,44,0,6.40,43.84,2733873,2733953
12974,94,47,0,5.45,70.23,2733953,2734047
12975,101,34,0,5.07,31.27,2734046,2734147
12976,78,21,0,6.56,25.25,2734146,2734224
12977,84,27,1,6.10,22.42,2734223,2734307
12978,78,17,1,6.56,15.25,2734306,2734384
12979,58,83,0,8.83,131.18,2734383,2734441
12980,73,23,0,7.01,23.96,2734440,2734513
12981,76,18,1,6.74,12.40,2734512,2734588
12982,62,41,0,8.26,44.71,2734587,2734649
12983,67,20,1,7.64,18.02,2734648,2734715
12984,63,35,1,8.13,35.35,2734714,2734777
12985,57,26,3,8.98,30.82,2734776,2734833
12986,58,45,1,8.83,45.38,2734832,2734890
12987,62,44,0,8.26,45.74,2734889,2734951
12988,62,30,1,8.26,39.32,2734951,2735013
12989,63,35,0,8.13,53.03,2735012,2735075
12990,61,46,1,8.39,56.30,2735074,2735135
12991,71,42,0,7.21,45.01,2735134,2735205
12992,69,18,0,7.42,24.79,2735204,2735273
12993,71,43,0,7.21,45.97,2735272,2735343
12994,60,101,0,8.53,165.92,2735342,2735402
12995,96,25,0,5.33,24.64,2735402,2735498
12996,84,59,0,6.10,68.47,2735497,2735581
12997,64,31,0,8.00,60.06,2735580,2735644
12998,86,18,1,5.95,15.25,2735643,2735729
12999,73,28,1,7.01,31.79,2735728,2735801
13000,71,41,1,7.21,31.15,2735801,2735872
13001,79,29,0,6.48,32.55,2735871,2735950
13002,69,21,2,7.42,18.94,2735949,2736018
13003,71,42,1,7.21,38.62,2736017,2736088
13004,59,26,1,8.68,30.22,2736087,2736146
13005,70,44,1,7.31,43.50,2736145,2736215
13006,58,41,1,8.83,38.87,2736214,2736272
13007,57,27,0,8.98,41.53,2736271,2736328
13008,53,58,1,9.66,77.28,2736327,2736380
13009,54,40,1,9.48,40.25,2736379,2736433
13010,50,32,2,10.24,47.70,2736432,2736482
13011,58,55,1,8.83,75.45,2736482,2736540
13012,72,23,1,7.11,21.90,2736539,2736611
13013,73,32,0,7.01,30.23,2736610,2736683
13014,61,25,0,8.39,34.37,2736682,2736743
13015,60,51,0,8.53,54.35,2736742,2736802
13016,57,46,1,8.98,58.58,2736801,2736858
13017,63,39,0,8.13,54.17,2736857,2736920
13018,60,30,0,8.53,43.22,2736920,2736980
13019,44,73,0,11.64,147.14,2736979,2737023
13020,55,67,0,9.31,106.90,2737022,2737077
13021,48,68,0,10.67,181.97,2737076,2737124
13022,79,33,0,6.48,36.48,2737123,2737202
13023,97,18,0,5.28,17.13,2737201,2737298
13024,93,37,0,5.51,27.54,2737298,2737391
13025,65,28,1,7.88,36.17,2737391,2737456
13026,72,47,1,7.11,50.90,2737455,2737527
13027,74,40,0,6.92,39.18,2737526,2737600
13028,73,24,0,7.01,27.77,2737600,2737673
13029,53,35,2,9.66,57.28,2737673,2737726
13030,79,26,0,6.48,22.12,2737726,2737805
13031,72,20,0,7.11,25.02,2737804,2737876
13032,67,26,1,7.64,25.33,2737875,2737942
13033,64,29,1,8.00,37.91,2737942,2738006
13034,56,59,0,9.14,80.73,2738006,2738062
13035,66,27,1,7.76,27.43,2738061,2738127
13036,72,31,2,7.11,21.82,2738126,2738198
13037,58,30,1,8.83,35.28,2738198,2738256
13038,73,24,1,7.01,19.85,2738255,2738328
13039,56,33,1,9.14,41.52,2738327,2738383
13040,52,63,2,9.85,79.82,2738382,2738434
13041,66,34,1,7.76,33.58,2738434,2738500
13042,50,49,2,10.24,94.50,2738499,2738549
13043,81,23,0,6.32,18.39,2738548,2738629
13044,62,37,1,8.26,43.87,2738628,2738690
13045,60,27,0,8.53,28.72,2738689,2738749
13046,82,26,0,6.24,24.65,2738748,2738830
13047,62,50,0,8.26,77.16,2738830,2738892
13048,70,22,1,7.31,27.24,2738891,2738961
13049,61,43,0,8.39,70.24,2738960,2739021
13050,73,27,1,7.01,28.04,2739020,2739093
13051,100,26,0,5.12,26.47,2739093,2739193
13052,105,18,0,4.88,14.97,2739192,2739297
13053,85,27,0,6.02,24.45,2739296,2739381
13054,78,24,0,6.56,29.37,2739380,2739458
13055,90,19,0,5.69,15.35,2739457,2739547
13056,75,31,0,6.83,31.37,2739546,2739621
13057,73,32,1,7.01,39.79,2739620,2739693
13058,67,72,0,7.64,97.16,2739692,2739759
13059,60,34,1,8.53,36.38,2739759,2739819
13060,70,18,1,7.31,18.64,2739818,2739888
13061,68,29,0,7.53,29.10,2739887,2739955
13062,56,91,1,9.14,158.41,2739954,2740010
13063,62,51,1,8.26,68.48,2740009,2740071
13064,61,23,1,8.39,37.03,2740070,2740131
13065,60,54,1,8.53,62.78,2740130,2740190
13066,50,62,1,10.24,84.58,2740189,2740239
13067,62,22,0,8.26,24.45,2740239,2740301
13068,63,20,1,8.13,22.36,2740300,2740363
13069,73,24,0,7.01,26.53,2740362,2740435
13070,61,27,0,8.39,34.57,2740434,2740495
13071,54,39,1,9.48,57.06,2740494,2740548
13072,58,65,1,8.83,79.28,2740548,2740606
13073,59,41,0,8.68,60.96,2740605,2740664
13074,70,46,1,7.31,49.90,2740663,2740733
13075,58,25,1,8.83,38.07,2740732,2740790
13076,65,62,0,7.88,90.85,2740789,2740854
13077,51,37,1,10.04,65.96,2740853,2740904
13078,80,47,0,6.40,41.86,2740903,2740983
13079,79,88,0,6.48,130.60,2740982,2741061
13080,93,70,0,5.51,79.95,2741060,2741153
13081,76,24,1,6.74,29.38,2741152,2741228
13082,76,24,0,6.74,28.88,2741227,2741303
13083,76,25,1,6.74,24.64,2741302,2741378
13084,87,19,0,5.89,16.33,2741377,2741464
13085,91,19,0,5.63,12.76,2741463,2741554
13086,74,35,1,6.92,38.72,2741553,2741627
13087,72,23,1,7.11,22.82,2741626,2741698
13088,63,23,1,8.13,27.00,2741697,2741760
13089,62,25,1,8.26,29.06,2741759,2741821
13090,56,58,1,9.14,95.80,2741820,2741876
13091,64,25,1,8.00,28.34,2741875,2741939
13092,59,21,2,8.68,23.34,2741938,2741997
13093,51,59,0,10.04,102.16,2741996,2742047
13094,62,28,1,8.26,28.51,2742047,2742109
13095,61,41,1,8.39,48.04,2742108,2742169
13096,49,25,1,10.45,38.04,2742168,2742217
13097,61,46,1,8.39,39.12,2742216,2742277
13098,67,21,0,7.64,23.96,2742276,2742343
13099,75,34,0,6.83,30.62,2742342,2742417
13100,61,49,1,8.39,50.86,2742416,2742477
13101,68,39,0,7.53,37.37,2742476,2742544
13102,69,30,0,7.42,29.84,2742543,2742612
13103,64,27,1,8.00,40.47,2742611,2742675
13104,57,48,1,8.98,68.96,2742674,2742731
13105,57,55,0,8.98,88.75,2742730,2742787
13106,81,31,0,6.32,33.21,2742786,2742867
13107,93,56,0,5.51,55.78,2742866,2742959
13108,79,27,0,6.48,29.31,2742958,2743037
13109,91,35,0,5.63,32.23,2743036,2743127
13110,79,24,1,6.48,16.43,2743126,2743205
13111,72,46,0,7.11,47.46,2743204,2743276
13112,71,30,1,7.21,35.83,2743275,2743346
13113,77,29,0,6.65,25.27,2743345,2743422
13114,70,29,0,7.31,27.22,2743421,2743491
13115,81,28,1,6.32,25.92,2743490,2743571
13116,71,24,1,7.21,27.24,2743570,2743641
13117,68,30,0,7.53,23.13,2743640,2743708
13118,77,32,1,6.65,26.57,2743707,2743784
13119,61,34,0,8.39,42.53,2743783,2743844
13120,68,36,0,7.53,32.37,2743843,2743911
13121,73,22,1,7.01,21.55,2743910,2743983
13122,59,34,0,8.68,49.00,2743982,2744041
13123,54,41,1,9.48,63.99,2744040,2744094
13124,60,38,0,8.53,49.22,2744094,2744154
13125,63,22,1,8.13,28.40,2744153,2744216
13126,71,24,1,7.21,27.83,2744215,2744286
13127,79,37,0,6.48,30.76,2744285,2744364
13128,59,31,1,8.68,51.00,2744363,2744422
13129,67,31,0,7.64,39.57,2744421,2744488
13130,79,23,0,6.48,24.88,2744487,2744566
13131,53,102,0,9.66,197.36,2744565,2744618
13132,56,98,0,9.14,163.62,2744617,2744673
13133,71,46,0,7.21,61.66,2744672,2744743
13134,99,23,0,5.17,22.95,2744742,2744841
13135,78,40,0,6.56,41.37,2744841,2744919
13136,107,23,0,4.79,16.06,2744919,2745026
13137,76,24,1,6.74,20.90,2745025,2745101
13138,77,34,1,6.65,38.05,2745100,2745177
13139,66,30,0,7.76,32.27,2745177,2745243
13140,72,31,0,7.11,36.63,2745243,2745315
13141,79,21,0,6.48,22.55,2745314,2745393
13142,74,33,0,6.92,25.94,2745393,2745467
13143,55,97,1,9.31,158.40,2745467,2745522
13144,66,25,0,7.76,30.09,2745521,2745587
13145,67,30,1,7.64,27.90,2745586,2745653
13146,58,39,2,8.83,39.32,2745652,2745710
13147,74,24,0,6.92,26.48,2745709,2745783
13148,50,41,2,10.24,43.34,2745782,2745832
13149,60,31,0,8.53,31.22,2745832,2745892
13150,65,24,0,7.88,25.58,2745891,2745956
13151,76,20,0,6.74,19.35,2745955,2746031
13152,64,25,1,8.00,25.28,2746030,2746094
13153,71,30,0,7.21,30.93,2746093,2746164
13154,61,36,1,8.39,46.70,2746164,2746225
13155,72,32,1,7.11,30.40,2746224,2746296
13156,67,41,0,7.64,37.07,2746295,2746362
13157,65,34,0,7.88,45.25,2746361,2746426
13158,54,35,0,9.48,51.06,2746425,2746479
13159,78,32,0,6.56,27.68,2746478,2746556
13160,70,114,0,7.31,192.53,2746555,2746625
13161,101,24,0,5.07,26.98,2746624,2746725
13162,78,38,0,6.56,47.04,2746724,2746802
13163,75,28,0,6.83,35.50,2746801,2746876
13164,59,51,1,8.68,80.08,2746875,2746934
13165,84,23,0,6.10,17.92,2746933,2747017
13166,78,23,1,6.56,25.68,2747016,2747094
13167,79,29,0,6.48,30.73,2747093,2747172
13168,66,34,1,7.76,45.76,2747172,2747238
13169,63,30,0,8.13,23.35,2747237,2747300
13170,58,90,1,8.83,161.28,2747299,2747357
13171,52,47,1,9.85,103.17,2747356,2747408
13172,60,24,0,8.53,30.72,2747407,2747467
13173,60,29,1,8.53,36.98,2747466,2747526
13174,45,58,1,11.38,121.75,2747525,2747570
13175,63,21,1,8.13,22.97,2747569,2747632
13176,73,24,0,7.01,26.81,2747631,2747704
13177,74,23,0,6.92,22.29,2747703,2747777
13178,54,43,2,9.48,75.10,2747776,2747830
13179,72,43,1,7.11,52.24,2747829,2747901
13180,54,64,0,9.48,102.29,2747900,2747954
13181,46,49,0,11.13,116.37,2747953,2747999
13182,74,38,0,6.92,39.99,2747999,2748073
13183,71,55,0,7.21,54.73,2748072,2748143
13184,79,33,0,6.48,37.74,2748142,2748221
13185,76,93,0,6.74,156.64,2748220,2748296
13186,87,23,0,5.89,23.27,2748295,2748382
13187,71,41,0,7.21,48.31,2748381,2748452
13188,77,36,0,6.65,38.93,2748451,2748528
13189,79,39,1,6.48,41.34,2748527,2748606
13190,81,29,1,6.32,29.30,2748605,2748686
13191,70,23,2,7.31,19.56,2748685,2748755
13192,71,47,1,7.21,39.74,2748754,2748825
13193,70,18,1,7.31,12.82,2748824,2748894
13194,58,35,1,8.83,49.63,2748893,2748951
13195,56,44,1,9.14,66.05,2748950,2749006
13196,54,31,1,9.48,38.88,2749005,2749059
13197,64,49,0,8.00,49.94,2749058,2749122
13198,57,45,2,8.98,48.26,2749121,2749178
13199,75,23,0,6.83,24.70,2749177,2749252
13200,52,66,1,9.85,146.21,2749251,2749303
13201,67,20,1,7.64,23.36,2749302,2749369
13202,70,28,0,7.31,34.70,2749368,2749438
13203,66,30,0,7.76,44.46,2749437,2749503
13204,74,36,0,6.92,46.18,2749502,2749576
13205,92,25,0,5.57,26.48,2749575,2749667
13206,107,30,0,4.79,30.71,2749666,2749773
13207,87,46,0,5.89,34.75,2749772,2749859
13208,90,31,0,5.69,22.21,2749858,2749948
13209,73,47,0,7.01,46.12,2749947,2750020
13210,68,41,0,7.53,37.51,2750020,2750088
13211,74,35,0,6.92,37.70,2750087,2750161
13212,67,27,1,7.64,25.81,2750160,2750227
13213,70,28,1,7.31,26.47,2750226,2750296
13214,57,90,0,8.98,144.23,2750295,2750352
13215,67,21,1,7.64,19.24,2750351,2750418
13216,71,24,0,7.21,25.97,2750417,2750488
13217,57,30,0,8.98,35.74,2750487,2750544
13218,62,44,1,8.26,76.00,2750543,2750605
13219,75,25,1,6.83,20.60,2750605,2750680
13220,56,28,2,9.14,38.12,2750680,2750736
13221,68,41,0,7.53,47.07,2750735,2750803
13222,72,28,0,7.11,30.65,2750803,2750875
13223,64,38,1,8.00,60.22,2750874,2750938
13224,77,26,0,6.65,28.70,2750937,2751014
13225,81,58,0,6.32,57.13,2751013,2751094
13226,82,48,0,6.24,43.04,2751094,2751176
13227,104,39,0,4.92,27.78,2751175,2751279
13228,80,20,0,6.40,20.24,2751278,2751358
13229,67,35,0,7.64,38.32,2751357,2751424
13230,91,21,0,5.63,15.53,2751423,2751514
13231,63,27,0,8.13,28.27,2751513,2751576
13232,68,24,0,7.53,20.01,2751575,2751643
13233,56,49,1,9.14,73.27,2751642,2751698
13234,67,41,0,7.64,41.78,2751697,2751764
13235,54,27,2,9.48,26.36,2751764,2751818
13236,71,27,1,7.21,24.93,2751817,2751888
13237,61,38,1,8.39,44.63,2751887,2751948
13238,63,22,0,8.13,23.89,2751947,2752010
13239,57,49,0,8.98,96.68,2752009,2752066
13240,58,41,0,8.83,69.32,2752066,2752124
13241,59,33,0,8.68,40.49,2752123,2752182
13242,45,71,0,11.38,178.50,2752181,2752226
13243,44,111,0,11.64,309.91,2752225,2752269
13244,78,21,0,6.56,25.35,2752268,2752346
13245,97,41,0,5.28,31.75,2752345,2752442
13246,90,22,0,5.69,20.19,2752441,2752531
13247,62,60,1,8.26,69.84,2752530,2752592
13248,84,18,0,6.10,15.94,2752591,2752675
13249,75,30,1,6.83,28.57,2752674,2752749
13250,70,42,1,7.31,54.07,2752749,2752819
13251,64,31,0,8.00,28.28,2752818,2752882
13252,68,32,1,7.53,36.07,2752881,2752949
13253,59,31,2,8.68,33.03,2752948,2753007
13254,56,41,2,9.14,37.84,2753007,2753063
13255,63,24,1,8.13,27.83,2753062,2753125
13256,68,29,1,7.53,19.63,2753124,2753192
13257,70,23,0,7.31,17.53,2753191,2753261
13258,74,47,0,6.92,44.78,2753260,2753334
13259,59,29,1,8.68,42.46,2753333,2753392
13260,57,55,0,8.98,78.93,2753392,2753449
13261,70,34,1,7.31,35.39,2753448,2753518
13262,51,85,0,10.04,174.00,2753517,2753568
13263,68,22,1,7.53,26.16,2753567,2753635
13264,57,42,0,8.98,64.79,2753634,2753691
13265,89,25,0,5.75,23.92,2753691,2753780
13266,113,30,0,4.53,26.43,2753779,2753892
13267,95,26,0,5.39,31.42,2753891,2753986
13268,75,24,1,6.83,27.69,2753985,2754060
13269,78,21,0,6.56,19.76,2754060,2754138
13270,100,19,0,5.12,14.01,2754137,2754237
13271,76,45,0,6.74,42.25,2754236,2754312
13272,76,17,1,6.74,13.54,2754312,2754388
13273,67,33,1,7.64,36.44,2754387,2754454
13274,63,30,0,8.13,38.59,2754454,2754517
13275,69,24,1,7.42,29.40,2754516,2754585
13276,58,32,2,8.83,32.87,2754585,2754643
13277,49,41,1,10.45,79.06,2754642,2754691
13278,55,30,0,9.31,51.52,2754690,2754745
13279,53,37,3,9.66,39.73,2754744,2754797
13280,54,43,0,9.48,47.29,2754796,2754850
13281,59,60,1,8.68,66.66,2754849,2754908
13282,73,27,1,7.01,24.10,2754907,2754980
13283,69,25,1,7.42,24.56,2754979,2755048
13284,65,32,0,7.88,32.45,2755047,2755112
13285,51,66,0,10.04,131.88,2755111,2755162
13286,55,70,0,9.31,140.47,2755162,2755217
13287,64,45,0,8.00,50.44,2755217,2755281
13288,59,43,1,8.68,69.24,2755280,2755339
13289,64,37,1,8.00,56.78,2755339,2755403
13290,84,42,0,6.10,35.99,2755403,2755487
13291,79,33,0,6.48,38.02,2755486,2755565
13292,97,30,0,5.28,24.53,2755564,2755661
13293,76,27,0,6.74,30.51,2755660,2755736
13294,63,49,1,8.13,60.36,2755735,2755798
13295,56,74,0,9.14,124.09,2755797,2755853
13296,63,71,1,8.13,145.60,2755852,2755915
13297,66,34,1,7.76,41.40,2755914,2755980
13298,64,47,1,8.00,54.69,2755979,2756043
13299,66,80,1,7.76,102.27,2756042,2756108
13300,73,21,1,7.01,18.51,2756107,2756180
13301,58,28,1,8.83,30.87,2756179,2756237
13302,76,18,0,6.74,20.19,2756236,2756312
13303,65,29,0,7.88,31.09,2756311,2756376
13304,45,95,0,11.38,227.30,2756375,2756420
13305,59,36,0,8.68,49.95,2756419,2756478
13306,51,72,1,10.04,101.25,2756478,2756529
13307,58,22,0,8.83,29.49,2756528,2756586
13308,76,41,0,6.74,38.46,2756585,2756661
13309,71,31,0,7.21,35.69,2756660,2756731
13310,68,18,1,7.53,13.04,2756730,2756798
13311,49,59,1,10.45,111.96,2756797,2756846
13312,63,42,0,8.13,58.65,2756845,2756908
13313,62,35,0,8.26,46.97,2756908,2756970
13314,64,47,0,8.00,78.47,2756969,2757033
13315,76,49,0,6.74,59.72,2757032,2757108
13316,88,30,0,5.82,31.13,2757107,2757195
13317,104,55,0,4.92,41.28,2757194,2757298
13318,73,23,1,7.01,18.18,2757297,2757370
13319,74,19,1,6.92,16.75,2757370,2757444
13320,74,68,0,6.92,71.86,2757443,2757517
13321,72,27,1,7.11,17.46,2757516,2757588
13322,56,57,1,9.14,88.91,2757588,2757644
13323,56,42,0,9.14,51.09,2757643,2757699
13324,61,28,1,8.39,32.37,2757698,2757759
13325,56,25,1,9.14,30.16,2757759,2757815
13326,64,28,1,8.00,29.66,2757815,2757879
13327,66,30,1,7.76,26.21,2757878,2757944
13328,55,92,0,9.31,166.36,2757943,2757998
13329,49,45,2,10.45,94.53,2757998,2758047
13330,54,81,0,9.48,136.92,2758046,2758100
13331,64,41,1,8.00,36.16,2758099,2758163
13332,54,35,1,9.48,55.51,2758162,2758216
13333,65,41,2,7.88,39.00,2758215,2758280
13334,63,22,0,8.13,30.21,2758279,2758342
13335,74,31,1,6.92,31.99,2758342,2758416
13336,66,21,1,7.76,22.03,2758415,2758481
13337,59,48,0,8.68,52.73,2758480,2758539
13338,75,35,0,6.83,36.68,2758538,2758613
13339,72,25,0,7.11,24.71,2758612,2758684
13340,66,46,0,7.76,57.61,2758683,2758749
13341,80,31,0,6.40,23.71,2758748,2758828
13342,111,33,0,4.61,26.08,2758827,2758938
13343,97,52,0,5.28,38.94,2758937,2759034
13344,87,29,0,5.89,31.37,2759033,2759120
13345,83,20,0,6.17,21.18,2759119,2759202
13346,87,53,1,5.89,40.40,2759201,2759288
13347,62,50,0,8.26,56.26,2759287,2759349
13348,78,20,0,6.56,16.66,2759349,2759427
13349,64,37,1,8.00,36.25,2759426,2759490
13350,62,26,1,8.26,19.97,2759489,2759551
13351,63,24,1,8.13,31.25,2759550,2759613
13352,64,38,0,8.00,35.44,2759612,2759676
13353,53,41,0,9.66,59.13,2759676,2759729
13354,50,58,0,10.24,98.18,2759728,2759778
13355,55,24,2,9.31,27.74,2759777,2759832
13356,62,34,1,8.26,41.32,2759831,2759893
13357,78,25,0,6.56,23.55,2759892,2759970
13358,70,29,1,7.31,24.30,2759969,2760039
13359,61,28,1,8.39,35.52,2760038,2760099
13360,55,96,1,9.31,160.69,2760098,2760153
13361,73,31,0,7.01,36.45,2760152,2760225
13362,51,59,1,10.04,90.59,2760224,2760275
13363,81,43,0,6.32,51.80,2760274,2760355
13364,110,25,0,4.65,19.23,2760354,2760464
13365,86,37,0,5.95,42.16,2760463,2760549
13366,86,22,1,5.95,18.16,2760548,2760634
13367,77,22,1,6.65,23.50,2760633,2760710
13368,84,24,0,6.10,19.25,2760709,2760793
13369,77,24,1,6.65,20.57,2760792,2760869
13370,71,51,1,7.21,53.97,2760868,2760939
13371,76,21,1,6.74,20.83,2760938,2761014
13372,65,27,1,7.88,22.48,2761014,2761079
13373,64,28,1,8.00,40.53,2761078,2761142
13374,59,25,2,8.68,32.96,2761141,2761200
13375,65,28,1,7.88,37.74,2761199,2761264
13376,58,32,1,8.83,31.18,2761263,2761321
13377,54,57,0,9.48,74.14,2761320,2761374
13378,60,29,2,8.53,34.72,2761373,2761433
13379,57,35,2,8.98,39.74,2761432,2761489
13380,69,22,0,7.42,22.71,2761488,2761557
13381,72,38,1,7.11,39.18,2761556,2761628
13382,64,43,1,8.00,54.59,2761627,2761691
13383,60,22,1,8.53,30.15,2761690,2761750
13384,62,31,2,8.26,31.13,2761749,2761811
13385,69,28,0,7.42,30.30,2761811,2761880
13386,54,77,0,9.48,115.06,2761879,2761933
13387,72,25,0,7.11,29.04,2761932,2762004
13388,81,46,0,6.32,42.44,2762003,2762084
13389,62,45,0,8.26,57.93,2762083,2762145
13390,103,29,0,4.97,28.75,2762144,2762247
13391,51,44,1,10.04,77.37,2762246,2762297
13392,79,28,0,6.48,23.74,2762296,2762375
13393,80,22,0,6.40,21.76,2762374,2762454
13394,70,31,1,7.31,41.02,2762453,2762523
13395,82,17,0,6.24,16.11,2762522,2762604
13396,91,39,0,5.63,22.61,2762603,2762694
13397,63,27,0,8.13,32.33,2762693,2762756
13398,71,22,0,7.21,25.55,2762755,2762826
13399,64,26,1,8.00,23.97,2762825,2762889
13400,78,18,0,6.56,21.71,2762889,2762967
13401,62,30,1,8.26,37.93,2762966,2763028
13402,62,23,1,8.26,25.32,2763027,2763089
13403,65,24,0,7.88,27.52,2763088,2763153
13404,66,49,1,7.76,47.00,2763152,2763218
13405,62,55,0,8.26,62.58,2763217,2763279
13406,67,21,0,7.64,19.66,2763279,2763346
13407,66,32,1,7.76,35.55,2763346,2763412
13408,50,67,1,10.24,124.06,2763411,2763461
13409,54,41,0,9.48,60.47,2763461,2763515
13410,58,51,1,8.83,71.42,2763514,2763572
13411,61,36,1,8.39,46.37,2763571,2763632
13412,67,33,0,7.64,51.90,2763631,2763698
13413,89,25,0,5.75,26.86,2763698,2763787
13414,100,37,0,5.12,29.97,2763786,2763886
13415,85,27,0,6.02,36.26,2763885,2763970
13416,63,33,1,8.13,48.87,2763969,2764032
13417,77,41,1,6.65,34.31,2764031,2764108
13418,81,76,1,6.32,74.29,2764107,2764188
13419,78,22,0,6.56,22.40,2764187,2764265
13420,68,32,1,7.53,38.16,2764264,2764332
13421,70,29,0,7.31,26.24,2764331,2764401
13422,73,30,0,7.01,35.19,2764400,2764473
13423,73,19,1,7.01,18.29,2764472,2764545
13424,43,49,1,11.91,93.90,2764544,2764587
13425,66,26,1,7.76,21.67,2764587,2764653
13426,58,37,0,8.83,40.32,2764652,2764710
13427,60,37,0,8.53,42.25,2764709,2764769
13428,54,46,1,9.48,57.03,2764768,2764822
13429,69,28,1,7.42,29.87,2764821,2764890
13430,52,63,0,9.85,87.40,2764889,2764941
13431,65,25,1,7.88,28.26,2764940,2765005
13432,61,54,1,8.39,64.60,2765004,2765065
13433,56,47,1,9.14,55.12,2765064,2765120
13434,78,21,1,6.56,14.76,2765119,2765197
13435,60,31,0,8.53,43.42,2765196,2765256
13436,66,51,1,7.76,69.94,2765255,2765321
13437,68,31,1,7.53,37.10,2765320,2765388
13438,65,32,0,7.88,39.46,2765387,2765452
13439,74,31,0,6.92,40.78,2765451,2765525
13440,116,28,0,4.41,16.24,2765524,2765640
13441,71,38,0,7.21,42.79,2765639,2765710
13442,85,19,1,6.02,16.47,2765709,2765794
13443,80,42,1,6.40,38.89,2765793,2765873
13444,69,72,0,7.42,112.04,2765872,2765941
13445,75,40,1,6.83,32.65,2765940,2766015
13446,63,50,1,8.13,82.24,2766014,2766077
13447,76,41,0,6.74,44.43,2766076,2766152
13448,64,25,1,8.00,26.66,2766151,2766215
13449,63,23,1,8.13,21.73,2766214,2766277
13450,69,22,1,7.42,28.65,2766276,2766345
13451,62,28,1,8.26,31.55,2766344,2766406
13452,62,33,0,8.26,34.06,2766405,2766467
13453,66,29,1,7.76,24.91,2766466,2766532
13454,67,32,1,7.64,31.69,2766531,2766598
13455,62,29,1,8.26,31.74,2766597,2766659
13456,73,28,0,7.01,31.41,2766658,2766731
13457,61,29,2,8.39,36.83,2766730,2766791
13458,61,35,1,8.39,33.78,2766790,2766851
13459,64,49,0,8.00,57.00,2766850,2766914
13460,67,32,0,7.64,34.68,2766913,2766980
13461,54,66,1,9.48,114.21,2766979,2767033
13462,56,31,1,9.14,43.16,2767032,2767088
13463,71,38,0,7.21,38.28,2767087,2767158
13464,72,41,0,7.11,41.71,2767158,2767230
13465,91,21,0,5.63,18.23,2767229,2767320
13466,96,37,0,5.33,26.03,2767319,2767415
13467,100,23,0,5.12,17.97,2767414,2767514
13468,67,76,1,7.64,104.08,2767513,2767580
13469,87,39,0,5.89,28.45,2767579,2767666
13470,76,29,0,6.74,26.43,2767665,2767741
13471,66,53,1,7.76,58.27,2767740,2767806
13472,69,20,0,7.42,20.42,2767806,2767875
13473,71,25,0,7.21,19.38,2767874,2767945
13474,69,18,1,7.42,17.72,2767944,2768013
13475,60,25,1,8.53,28.92,2768012,2768072
13476,67,37,0,7.64,49.78,2768071,2768138
13477,51,67,1,10.04,124.12,2768137,2768188
13478,64,49,1,8.00,56.47,2768187,2768251
13479,68,24,1,7.53,24.07,2768250,2768318
13480,82,42,0,6.24,33.72,2768318,2768400
13481,64,31,1,8.00,28.84,2768399,2768463
13482,58,36,1,8.83,44.94,2768462,2768520
13483,71,32,0,7.21,36.45,2768519,2768590
13484,41,197,2,12.49,878.10,2768590,2768631
13485,55,34,0,9.31,65.20,2768630,2768685
13486,69,39,0,7.42,55.43,2768684,2768753
13487,94,46,0,5.45,38.91,2768752,2768846
13488,92,30,0,5.57,33.98,2768845,2768937
13489,77,25,0,6.65,25.34,2768936,2769013
13490,78,39,0,6.56,28.96,2769013,2769091
13491,90,19,0,5.69,15.64,2769090,2769180
13492,68,42,1,7.53,43.10,2769179,2769247
13493,69,84,0,7.42,112.21,2769246,2769315
13494,71,29,0,7.21,39.74,2769314,2769385
13495,70,26,0,7.31,23.24,2769384,2769454
13496,60,52,2,8.53,64.58,2769454,2769514
13497,60,45,0,8.53,75.62,2769513,2769573
13498,54,90,1,9.48,142.14,2769572,2769626
13499,63,31,1,8.13,36.56,2769625,2769688
13500,46,44,2,11.13,67.90,2769687,2769733
13501,53,29,1,9.66,33.05,2769732,2769785
13502,71,23,1,7.21,18.03,2769784,2769855
13503,51,26,1,10.04,30.04,2769854,2769905
13504,49,76,1,10.45,165.80,2769904,2769953
13505,67,43,1,7.64,42.47,2769952,2770019
13506,67,41,1,7.64,40.56,2770018,2770085
13507,47,116,0,10.89,304.31,2770084,2770131
13508,58,41,0,8.83,72.59,2770130,2770188
13509,57,42,0,8.98,48.37,2770187,2770244
13510,74,24,0,6.92,30.70,2770243,2770317
13511,69,23,0,7.42,24.50,2770316,2770385
13512,80,32,0,6.40,33.29,2770384,2770464
13513,91,34,0,5.63,32.50,2770463,2770554
13514,103,45,0,4.97,36.59,2770553,2770656
13515,61,43,0,8.39,50.99,2770655,2770716
13516,68,29,2,7.53,31.87,2770715,2770783
13517,81,21,0,6.32,21.45,2770782,2770863
13518,81,28,1,6.32,24.42,2770862,2770943
13519,49,36,1,10.45,63.39,2770942,2770991
13520,75,32,0,6.83,39.56,2770990,2771065
13521,80,28,0,6.40,21.96,2771064,2771144
13522,69,32,1,7.42,34.19,2771143,2771212
13523,62,22,2,8.26,19.00,2771211,2771273
13524,60,26,1,8.53,35.42,2771272,2771332
13525,54,23,2,9.48,27.14,2771331,2771385
13526,64,35,1,8.00,33.06,2771384,2771448
13527,61,45,1,8.39,62.24,2771447,2771508
13528,64,23,1,8.00,24.25,2771507,2771571
13529,62,29,1,8.26,34.74,2771570,2771632
13530,73,39,0,7.01,34.12,2771631,2771704
13531,44,72,0,11.64,177.37,2771703,2771747
13532,54,43,0,9.48,84.55,2771746,2771800
13533,63,35,0,8.13,57.86,2771799,2771862
13534,67,42,0,7.64,79.24,2771861,2771928
13535,88,26,0,5.82,24.67,2771928,2772016
13536,84,45,0,6.10,60.66,2772015,2772099
13537,68,30,0,7.53,48.66,2772098,2772166
13538,81,27,0,6.32,24.12,2772165,2772246
13539,76,24,1,6.74,21.33,2772245,2772321
13540,83,20,0,6.17,20.14,2772321,2772404
13541,69,49,0,7.42,51.37,2772403,2772472
13542,68,77,1,7.53,99.19,2772471,2772539
13543,63,62,1,8.13,85.89,2772538,2772601
13544,67,55,0,7.64,53.48,2772600,2772667
13545,68,25,1,7.53,27.16,2772666,2772734
13546,72,20,0,7.11,19.71,2772733,2772805
13547,63,26,1,8.13,35.32,2772804,2772867
13548,66,32,0,7.76,32.00,2772866,2772932
13549,52,90,2,9.85,143.44,2772931,2772983
13550,49,35,1,10.45,72.33,2772982,2773031
13551,68,29,1,7.53,25.40,2773030,2773098
13552,82,22,0,6.24,19.21,2773097,2773179
13553,67,26,1,7.64,22.89,2773178,2773245
13554,58,25,1,8.83,36.83,2773244,2773302
13555,80,32,0,6.40,28.64,2773301,2773381
13556,64,35,0,8.00,49.03,2773380,2773444
13557,62,34,0,8.26,56.61,2773444,2773506
13558,47,53,1,10.89,161.41,2773505,2773552
13559,68,31,1,7.53,37.72,2773552,2773620
13560,94,51,0,5.45,54.18,2773619,2773713
13561,79,37,0,6.48,56.58,2773713,2773792
13562,111,40,0,4.61,34.94,2773791,2773902
13563,83,29,1,6.17,23.27,2773901,2773984
13564,88,19,1,5.82,14.60,2773983,2774071
13565,91,27,0,5.63,22.76,2774070,2774161
13566,75,69,1,6.83,80.89,2774161,2774236
13567,78,27,0,6.56,27.63,2774235,2774313
13568,90,18,0,5.69,13.19,2774313,2774403
13569,65,32,0,7.88,27.71,2774402,2774467
13570,57,51,0,8.98,65.77,2774466,2774523
13571,79,19,0,6.48,15.82,2774522,2774601
13572,55,90,2,9.31,141.30,2774600,2774655
13573,58,43,1,8.83,63.25,2774654,2774712
13574,66,24,1,7.76,22.73,2774711,2774777
13575,58,25,2,8.83,21.56,2774776,2774834
13576,66,43,1,7.76,42.88,2774833,2774899
13577,68,22,1,7.53,19.60,2774899,2774967
13578,84,20,1,6.10,18.68,2774966,2775050
13579,57,46,1,8.98,69.81,2775049,2775106
13580,64,43,1,8.00,55.88,2775105,2775169
13581,79,26,0,6.48,28.93,2775168,2775247
13582,66,39,0,7.76,57.52,2775246,2775312
13583,78,38,0,6.56,43.55,2775312,2775390
13584,84,29,0,6.10,34.90,2775389,2775473
13585,108,37,0,4.74,24.99,2775472,2775580
13586,99,38,0,5.17,36.38,2775579,2775678
13587,81,37,0,6.32,34.61,2775677,2775758
13588,75,42,1,6.83,38.52,2775757,2775832
13589,90,39,0,5.69,34.57,2775831,2775921
13590,58,104,0,8.83,186.45,2775920,2775978
13591,61,37,1,8.39,65.81,2775977,2776038
13592,72,24,1,7.11,20.38,2776037,2776109
13593,53,29,1,9.66,33.73,2776108,2776161
13594,75,24,1,6.83,19.58,2776160,2776235
13595,57,25,1,8.98,36.86,2776234,2776291
13596,69,28,0,7.42,43.03,2776290,2776359
13597,62,23,0,8.26,28.71,2776358,2776420
13598,69,39,0,7.42,32.50,2776419,2776488
13599,48,69,3,10.67,93.81,2776487,2776535
13600,48,53,1,10.67,100.26,2776534,2776582
13601,73,29,1,7.01,24.15,2776581,2776654
13602,56,32,2,9.14,40.05,2776653,2776709
13603,91,30,0,5.63,22.17,2776708,2776799
13604,61,33,1,8.39,30.93,2776798,2776859
13605,61,37,1,8.39,29.78,2776858,2776919
13606,70,35,0,7.31,38.73,2776919,2776989
13607,56,39,1,9.14,54.55,2776988,2777044
13608,50,32,1,10.24,63.10,2777043,2777093
13609,88,32,0,5.82,36.19,2777092,2777180
13610,93,26,0,5.51,29.69,2777179,2777272
13611,105,37,0,4.88,28.28,2777271,2777376
13612,81,30,1,6.32,22.46,2777375,2777456
13613,89,36,0,5.75,31.74,2777455,2777544
13614,75,23,1,6.83,32.86,2777543,2777618
13615,79,34,0,6.48,29.03,2777617,2777696
13616,60,49,2,8.53,49.62,2777695,2777755
13617,65,25,1,7.88,25.89,2777755,2777820
13618,65,30,1,7.88,32.63,2777819,2777884
13619,68,34,1,7.53,31.93,2777883,2777951
13620,52,37,3,9.85,52.67,2777950,2778002
13621,68,28,1,7.53,29.63,2778001,2778069
13622,47,98,1,10.89,202.95,2778068,2778115
13623,58,43,0,8.83,48.52,2778115,2778173
13624,63,31,0,8.13,32.40,2778172,2778235
13625,77,42,0,6.65,55.86,2778234,2778311
13626,58,39,1,8.83,46.94,2778310,2778368
13627,59,46,1,8.68,54.15,2778367,2778426
13628,67,44,0,7.64,68.08,2778425,2778492
13629,53,29,0,9.66,50.26,2778491,2778544
13630,67,28,0,7.64,38.74,2778543,2778610
13631,81,25,0,6.32,27.87,2778609,2778690
13632,91,23,0,5.63,25.93,2778689,2778780
13633,78,40,0,6.56,59.48,2778779,2778857
13634,90,30,0,5.69,23.37,2778856,2778946
13635,79,29,0,6.48,27.21,2778945,2779024
13636,74,35,1,6.92,41.51,2779024,2779098
13637,67,33,0,7.64,36.32,2779097,2779164
13638,78,35,0,6.56,26.96,2779163,2779241
13639,77,28,0,6.65,27.92,2779240,2779317
13640,73,35,0,7.01,38.23,2779316,2779389
13641,67,28,0,7.64,29.66,2779388,2779455
13642,66,26,1,7.76,27.40,2779454,2779520
13643,70,28,1,7.31,25.10,2779519,2779589
13644,67,24,1,7.64,24.86,2779588,2779655
13645,35,56,2,14.63,166.69,2779655,2779690
13646,63,30,1,8.13,29.25,2779689,2779752
13647,60,35,1,8.53,45.22,2779751,2779811
13648,56,30,0,9.14,36.44,2779810,2779866
13649,56,39,1,9.14,45.87,2779865,2779921
13650,60,30,1,8.53,40.22,2779920,2779980
13651,82,20,0,6.24,15.55,2779979,2780061
13652,62,87,2,8.26,125.97,2780060,2780122
13653,61,42,0,8.39,57.94,2780121,2780182
13654,58,36,1,8.83,50.69,2780181,2780239
13655,70,28,0,7.31,34.90,2780238,2780308
13656,65,26,0,7.88,29.80,2780307,2780372
13657,48,51,0,10.67,155.18,2780371,2780419
13658,71,28,0,7.21,38.28,2780418,2780489
13659,123,32,0,4.16,17.55,2780489,2780612
13660,105,17,0,4.88,14.28,2780611,2780716
13661,86,36,0,5.95,34.88,2780715,2780801
13662,84,25,0,6.10,16.35,2780800,2780884
13663,75,27,0,6.83,33.53,2780883,2780958
13664,92,28,0,5.57,18.85,2780957,2781049
13665,81,23,0,6.32,24.44,2781048,2781129
13666,54,35,0,9.48,52.84,2781128,2781182
13667,81,36,1,6.32,29.01,2781181,2781262
13668,56,29,1,9.14,44.09,2781261,2781317
13669,60,53,1,8.53,72.85,2781316,2781376
13670,60,28,1,8.53,28.95,2781375,2781435
13671,76,19,1,6.74,18.33,2781434,2781510
13672,66,39,0,7.76,42.55,2781509,2781575
13673,59,25,1,8.68,29.54,2781574,2781633
13674,47,89,0,10.89,167.20,2781632,2781679
13675,56,37,1,9.14,47.30,2781678,2781734
13676,60,29,1,8.53,36.38,2781733,2781793
13677,53,34,3,9.66,39.92,2781792,2781845
13678,60,24,1,8.53,24.58,2781845,2781905
13679,68,26,0,7.53,22.07,2781904,2781972
13680,79,28,0,6.48,23.59,2781971,2782050
13681,61,29,1,8.39,33.22,2782049,2782110
13682,76,50,0,6.74,49.40,2782109,2782185
13683,66,31,0,7.76,43.09,2782184,2782250
13684,66,38,0,7.76,38.58,2782249,2782315
13685,68,43,0,7.53,46.93,2782314,2782382
13686,84,39,0,6.10,27.44,2782381,2782465
13687,89,25,0,5.75,32.46,2782464,2782553
13688,91,23,0,5.63,23.07,2782552,2782643
13689,73,28,1,7.01,30.01,2782642,2782715
13690,103,18,0,4.97,13.29,2782714,2782817
13691,88,24,0,5.82,20.56,2782816,2782904
13692,85,21,0,6.02,16.00,2782904,2782989
13693,78,27,1,6.56,18.53,2782988,2783066
13694,75,29,0,6.83,29.34,2783065,2783140
13695,64,30,1,8.00,31.06,2783139,2783203
13696,67,24,0,7.64,25.42,2783202,2783269
13697,71,37,1,7.21,35.94,2783268,2783339
13698,72,49,1,7.11,41.57,2783338,2783410
13699,60,29,1,8.53,33.55,2783409,2783469
13700,56,50,0,9.14,69.91,2783468,2783524
13701,61,27,0,8.39,32.66,2783523,2783584
13702,50,56,2,10.24,69.38,2783583,2783633
13703,60,28,0,8.53,43.52,2783632,2783692
13704,66,23,0,7.76,28.94,2783691,2783757
13705,55,72,2,9.31,95.16,2783756,2783811
13706,80,26,0,6.40,23.94,2783810,2783890
13707,52,51,1,9.85,67.90,2783889,2783941
13708,64,26,1,8.00,27.34,2783940,2784004
13709,58,33,2,8.83,53.80,2784003,2784061
13710,32,114,1,16.00,391.00,2784060,2784092
13711,57,47,0,8.98,77.98,2784091,2784148
13712,70,24,1,7.31,25.99,2784147,2784217
13713,57,75,1,8.98,125.56,2784216,2784273
13714,52,39,1,9.85,88.63,2784272,2784324
13715,72,26,0,7.11,38.24,2784324,2784396
13716,98,31,0,5.22,22.89,2784395,2784493
13717,85,29,0,6.02,34.14,2784492,2784577
13718,103,25,0,4.97,18.90,2784577,2784680
13719,84,19,0,6.10,17.11,2784679,2784763
13720,88,32,0,5.82,22.97,2784762,2784850
13721,85,56,0,6.02,51.11,2784849,2784934
13722,83,21,0,6.17,17.75,2784933,2785016
13723,72,34,0,7.11,44.90,2785016,2785088
13724,61,28,1,8.39,40.70,2785087,2785148
13725,62,42,0,8.26,52.84,2785147,2785209
13726,63,63,1,8.13,67.48,2785208,2785271
13727,76,30,1,6.74,31.64,2785270,2785346
13728,57,32,1,8.98,46.23,2785345,2785402
13729,55,50,1,9.31,84.03,2785401,2785456
13730,63,20,0,8.13,26.90,2785455,2785518
13731,59,32,1,8.68,37.30,2785517,2785576
13732,75,22,1,6.83,17.37,2785576,2785651
13733,72,27,1,7.11,21.07,2785650,2785722
13734,71,30,0,7.21,31.49,2785721,2785792
13735,66,33,1,7.76,42.00,2785791,2785857
13736,66,33,2,7.76,31.46,2785856,2785922
13737,68,43,0,7.53,52.34,2785921,2785989
13738,77,26,0,6.65,18.59,2785988,2786065
13739,60,52,0,8.53,77.28,2786064,2786124
13740,85,25,0,6.02,31.55,2786124,2786209
13741,68,43,0,7.53,109.13,2786208,2786276
13742,119,20,0,4.30,15.49,2786275,2786394
13743,87,26,0,5.89,19.87,2786393,2786480
13744,94,21,0,5.45,17.35,2786479,2786573
13745,78,70,0,6.56,75.91,2786572,2786650
13746,67,33,1,7.64,33.30,2786649,2786716
13747,50,61,0,10.24,88.34,2786715,2786765
13748,64,56,1,8.00,50.94,2786765,2786829
13749,80,24,1,6.40,20.79,2786828,2786908
13750,65,28,1,7.88,24.26,2786907,2786972
13751,55,29,1,9.31,49.85,2786971,2787026
13752,60,35,0,8.53,36.45,2787026,2787086
13753,61,19,2,8.39,15.03,2787086,2787147
13754,70,35,0,7.31,32.47,2787146,2787216
13755,69,24,0,7.42,30.59,2787215,2787284
13756,75,30,0,6.83,30.54,2787283,2787358
13757,56,55,2,9.14,68.55,2787358,2787414
13758,54,41,0,9.48,49.62,2787414,2787468
13759,77,58,0,6.65,65.27,2787467,2787544
13760,58,54,1,8.83,67.38,2787543,2787601
13761,64,42,0,8.00,43.19,2787600,2787664
13762,55,80,0,9.31,158.72,2787664,2787719
13763,96,21,0,5.33,17.74,2787718,2787814
13764,120,21,0,4.27,17.60,2787813,2787933
13765,94,27,0,5.45,26.80,2787932,2788026
13766,84,19,0,6.10,19.78,2788025,2788109
13767,80,18,1,6.40,17.84,2788108,2788188
13768,71,35,1,7.21,34.59,2788187,2788258
13769,48,43,0,10.67,81.97,2788258,2788306
13770,65,35,0,7.88,36.69,2788305,2788370
13771,68,41,1,7.53,35.37,2788369,2788437
13772,67,26,2,7.64,20.65,2788436,2788503
13773,58,36,0,8.83,50.87,2788503,2788561
13774,58,40,1,8.83,45.49,2788560,2788618
13775,61,31,3,8.39,31.45,2788617,2788678
13776,72,21,1,7.11,12.38,2788678,2788750
13777,66,47,0,7.76,68.67,2788749,2788815
13778,50,63,1,10.24,96.90,2788814,2788864
13779,57,42,1,8.98,66.47,2788863,2788920
13780,57,33,0,8.98,30.68,2788919,2788976
13781,79,31,0,6.48,29.77,2788975,2789054
13782,61,34,1,8.39,37.88,2789053,2789114
13783,66,59,0,7.76,85.49,2789114,2789180
13784,61,97,1,8.39,161.85,2789179,2789240
13785,96,42,0,5.33,28.60,2789239,2789335
13786,99,49,0,5.17,34.61,2789335,2789434
13787,74,24,1,6.92,19.05,2789433,2789507
13788,63,150,0,8.13,342.87,2789506,2789569
13789,73,32,0,7.01,32.73,2789569,2789642
13790,89,37,0,5.75,27.78,2789641,2789730
13791,56,51,1,9.14,76.19,2789729,2789785
13792,77,42,0,6.65,35.08,2789785,2789862
13793,68,34,0,7.53,45.28,2789861,2789929
13794,60,39,0,8.53,42.38,2789928,2789988
13795,75,35,1,6.83,28.86,2789987,2790062
13796,68,37,1,7.53,29.90,2790061,2790129
13797,59,42,0,8.68,62.59,2790129,2790188
13798,45,38,2,11.38,83.75,2790187,2790232
13799,58,46,1,8.83,52.35,2790231,2790289
13800,47,35,1,10.89,45.24,2790288,2790335
13801,54,42,1,9.48,52.51,2790334,2790388
13802,72,22,1,7.11,21.63,2790387,2790459
13803,62,30,1,8.26,31.45,2790458,2790520
13804,69,32,0,7.42,33.90,2790519,2790588
13805,52,49,1,9.85,76.21,2790587,2790639
13806,70,27,1,7.31,25.36,2790638,2790708
13807,59,38,1,8.68,59.07,2790708,2790767
13808,59,59,0,8.68,90.49,2790766,2790825
13809,65,28,1,7.88,31.25,2790824,2790889
13810,42,60,0,12.19,227.82,2790888,2790930
13811,62,59,0,8.26,98.77,2790929,2790991
13812,94,25,0,5.45,25.55,2790990,2791084
13813,88,25,0,5.82,31.10,2791083,2791171
13814,86,53,0,5.95,46.97,2791170,2791256
13815,71,27,0,7.21,23.15,2791255,2791326
13816,95,17,1,5.39,13.25,2791325,2791420
13817,85,22,0,6.02,24.94,2791419,2791504
13818,74,53,0,6.92,61.32,2791504,2791578
13819,55,49,0,9.31,88.32,2791577,2791632
13820,80,36,1,6.40,25.79,2791631,2791711
13821,71,21,1,7.21,14.70,2791711,2791782
13822,60,31,1,8.53,31.08,2791781,2791841
13823,71,25,1,7.21,25.49,2791840,2791911
13824,67,31,1,7.64,26.02,2791910,2791977
13825,51,75,2,10.04,111.37,2791976,2792027
13826,53,30,0,9.66,54.26,2792027,2792080
13827,62,28,1,8.26,31.39,2792079,2792141
13828,53,73,0,9.66,100.79,2792140,2792193
13829,55,31,1,9.31,46.65,2792193,2792248
13830,62,20,2,8.26,25.90,2792247,2792309
13831,73,33,1,7.01,36.12,2792309,2792382
13832,56,33,1,9.14,52.23,2792381,2792437
13833,59,44,1,8.68,50.79,2792436,2792495
13834,52,61,1,9.85,91.90,2792494,2792546
13835,71,49,0,7.21,50.98,2792545,2792616
13836,62,53,0,8.26,76.84,2792615,2792677
13837,72,48,0,7.11,59.49,2792676,2792748
13838,95,25,0,5.39,24.66,2792747,2792842
13839,91,45,0,5.63,36.92,2792841,2792932
13840,77,24,0,6.65,27.94,2792931,2793008
13841,92,32,0,5.57,33.01,2793007,2793099
13842,81,27,0,6.32,24.69,2793098,2793179
13843,77,56,1,6.65,53.03,2793178,2793255
13844,68,66,0,7.53,80.63,2793254,2793322
13845,84,18,1,6.10,15.04,2793321,2793405
13846,68,29,0,7.53,28.28,2793404,2793472
13847,71,44,0,7.21,40.87,2793471,2793542
13848,54,75,0,9.48,110.14,2793541,2793595
13849,73,25,1,7.01,18.64,2793594,2793667
13850,61,34,1,8.39,43.19,2793666,2793727
13851,73,30,0,7.01,24.86,2793726,2793799
13852,65,30,0,7.88,25.34,2793798,2793863
13853,61,30,0,8.39,37.22,2793863,2793924
13854,53,35,1,9.66,65.96,2793923,2793976
13855,54,49,0,9.48,75.03,2793975,2794029
13856,40,93,4,12.80,193.71,2794028,2794068
13857,62,27,1,8.26,28.84,2794067,2794129
13858,67,39,1,7.64,30.83,2794129,2794196
13859,56,42,1,9.14,67.12,2794195,2794251
13860,73,29,0,7.01,33.22,2794250,2794323
13861,58,37,0,8.83,57.38,2794322,2794380
13862,64,30,0,8.00,44.34,2794379,2794443
13863,68,30,1,7.53,36.28,2794442,2794510
13864,56,47,0,9.14,102.23,2794509,2794565
13865,74,45,0,6.92,48.18,2794564,2794638
13866,121,24,0,4.23,19.27,2794637,2794758
13867,73,33,0,7.01,37.60,2794757,2794830
13868,62,145,1,8.26,328.64,2794830,2794892
13869,77,20,1,6.65,19.55,2794891,2794968
13870,87,23,0,5.89,21.78,2794967,2795054
13871,78,25,0,6.56,22.04,2795053,2795131
13872,59,29,0,8.68,40.46,2795130,2795189
13873,78,21,0,6.56,16.63,2795188,2795266
13874,76,25,1,6.74,25.72,2795265,2795341
13875,77,24,1,6.65,20.07,2795340,2795417
13876,68,18,1,7.53,16.04,2795416,2795484
13877,59,31,1,8.68,43.37,2795483,2795542
13878,56,34,1,9.14,47.66,2795541,2795597
13879,57,31,0,8.98,40.12,2795596,2795653
13880,60,28,1,8.53,37.18,2795652,2795712
13881,64,42,0,8.00,46.81,2795712,2795776
13882,65,48,1,7.88,55.43,2795775,2795840
13883,28,157,1,18.29,1520.42,2795840,2795868
13884,68,35,1,7.53,39.98,2795867,2795935
13885,59,63,0,8.68,77.24,2795934,2795993
13886,61,42,0,8.39,62.73,2795992,2796053
13887,83,20,0,6.17,22.94,2796052,2796135
13888,70,23,0,7.31,29.07,2796134,2796204
13889,65,26,0,7.88,37.74,2796203,2796268
13890,65,37,1,7.88,40.82,2796267,2796332
13891,80,37,0,6.40,33.72,2796331,2796411
13892,104,20,0,4.92,21.67,2796410,2796514
13893,83,24,0,6.17,31.63,2796513,2796596
13894,79,23,1,6.48,19.95,2796595,2796674
13895,62,34,0,8.26,51.19,2796673,2796735
13896,68,77,1,7.53,87.46,2796734,2796802
13897,88,23,0,5.82,17.54,2796801,2796889
13898,78,37,1,6.56,29.68,2796888,2796966
13899,63,26,0,8.13,46.24,2796965,2797028
13900,55,57,0,9.31,62.50,2797027,2797082
13901,57,75,0,8.98,107.21,2797081,2797138
13902,75,19,0,6.83,14.94,2797137,2797212
13903,66,39,1,7.76,39.12,2797211,2797277
13904,65,24,1,7.88,27.62,2797276,2797341
13905,53,39,2,9.66,63.24,2797341,2797394
13906,51,37,1,10.04,61.25,2797393,2797444
13907,44,92,1,11.64,180.05,2797443,2797487
13908,63,26,1,8.13,27.03,2797486,2797549
13909,64,24,0,8.00,26.12,2797548,2797612
13910,70,24,0,7.31,22.82,2797611,2797681
13911,66,33,1,7.76,31.40,2797680,2797746
13912,69,22,1,7.42,22.68,2797745,2797814
13913,67,23,1,7.64,25.69,2797813,2797880
13914,60,26,1,8.53,33.78,2797879,2797939
13915,53,69,0,9.66,103.81,2797938,2797991
13916,63,72,0,8.13,105.79,2797990,2798053
13917,80,36,0,6.40,39.84,2798052,2798132
13918,106,32,0,4.83,33.37,2798131,2798237
13919,98,26,0,5.22,18.28,2798236,2798334
13920,95,30,0,5.39,27.77,2798333,2798428
13921,78,43,0,6.56,32.04,2798427,2798505
13922,77,29,1,6.65,24.07,2798504,2798581
13923,77,25,0,6.65,26.93,2798581,2798658
13924,74,28,1,6.92,26.59,2798657,2798731
13925,78,47,1,6.56,40.35,2798730,2798808
13926,73,35,0,7.01,26.45,2798807,2798880
13927,63,19,1,8.13,19.16,2798879,2798942
13928,80,19,0,6.40,16.61,2798941,2799021
13929,67,32,0,7.64,30.92,2799020,2799087
13930,62,24,1,8.26,19.26,2799086,2799148
13931,64,33,1,8.00,35.97,2799147,2799211
13932,54,26,3,9.48,23.66,2799210,2799264
13933,67,21,1,7.64,24.68,2799263,2799330
13934,77,46,1,6.65,35.11,2799329,2799406
13935,52,35,0,9.85,54.13,2799405,2799457
13936,64,23,0,8.00,27.34,2799456,2799520
13937,33,122,1,15.52,448.31,2799519,2799552
13938,70,37,1,7.31,30.42,2799551,2799621
13939,68,29,0,7.53,32.72,2799620,2799688
13940,63,29,1,8.13,23.79,2799687,2799750
13941,62,43,1,8.26,75.80,2799750,2799812
13942,78,29,0,6.56,34.37,2799811,2799889
13943,92,22,0,5.57,19.57,2799888,2799980
13944,117,19,0,4.38,15.72,2799980,2800097
13945,76,29,0,6.74,32.88,2800096,2800172
13946,84,29,0,6.10,19.66,2800171,2800255
13947,77,36,0,6.65,33.81,2800254,2800331
13948,76,38,1,6.74,33.98,2800330,2800406
13949,79,26,1,6.48,21.29,2800405,2800484
13950,60,30,2,8.53,28.75,2800483,2800543
13951,48,29,3,10.67,31.26,2800542,2800590
13952,59,42,0,8.68,42.83,2800590,2800649
13953,71,25,1,7.21,22.39,2800648,2800719
13954,56,39,1,9.14,64.27,2800718,2800774
13955,56,23,1,9.14,28.23,2800773,2800829
13956,61,42,0,8.39,47.88,2800828,2800889
13957,50,42,2,10.24,46.22,2800888,2800938
13958,62,34,1,8.26,28.90,2800938,2801000
13959,58,30,2,8.83,38.94,2800999,2801057
13960,66,21,0,7.76,26.70,2801057,2801123
13961,75,24,1,6.83,21.05,2801122,2801197
13962,51,25,0,10.04,35.96,2801197,2801248
13963,82,28,1,6.24,16.94,2801247,2801329
13964,42,52,1,12.19,107.58,2801328,2801370
13965,76,26,0,6.74,24.75,2801370,2801446
13966,70,26,1,7.31,24.93,2801445,2801515
13967,46,60,1,11.13,137.90,2801514,2801560
13968,65,55,0,7.88,96.08,2801559,2801624
13969,109,24,0,4.70,18.08,2801623,2801732
13970,72,39,0,7.11,52.82,2801731,2801803
13971,92,33,0,5.57,46.07,2801803,2801895
13972,70,27,0,7.31,37.93,2801894,2801964
13973,74,31,1,6.92,32.37,2801963,2802037
13974,70,32,0,7.31,40.10,2802037,2802107
13975,78,29,0,6.56,29.25,2802106,2802184
13976,86,23,0,5.95,23.00,2802184,2802270
13977,67,34,0,7.64,30.05,2802269,2802336
13978,75,23,1,6.83,23.90,2802335,2802410
13979,65,30,1,7.88,32.72,2802409,2802474
13980,62,26,0,8.26,23.26,2802474,2802536
13981,69,23,1,7.42,26.59,2802535,2802604
13982,67,22,0,7.64,18.62,2802603,2802670
13983,47,64,1,10.89,119.84,2802669,2802716
13984,61,45,1,8.39,44.40,2802716,2802777
13985,43,102,3,11.91,238.60,2802776,2802819
13986,49,49,2,10.45,61.39,2802818,2802867
13987,67,55,1,7.64,51.10,2802866,2802933
13988,67,28,1,7.64,27.78,2802932,2802999
13989,67,25,1,7.64,27.81,2802998,2803065
13990,56,24,1,9.14,39.77,2803064,2803120
13991,53,38,0,9.66,60.41,2803120,2803173
13992,65,33,0,7.88,36.08,2803172,2803237
13993,58,65,0,8.83,96.83,2803236,2803294
13994,29,173,1,17.66,980.92,2803293,2803322
13995,57,42,1,8.98,47.03,2803321,2803378
13996,93,22,0,5.51,21.63,2803377,2803470
13997,80,25,0,6.40,22.39,2803470,2803550
13998,83,58,0,6.17,83.18,2803550,2803633
13999,87,49,0,5.89,52.81,2803632,2803719
14000,65,37,0,7.88,41.03,2803718,2803783
14001,72,32,0,7.11,31.96,2803782,2803854
14002,75,45,0,6.83,47.00,2803853,2803928
14003,77,37,0,6.65,41.50,2803928,2804005
14004,60,43,1,8.53,47.15,2804004,2804064
14005,56,89,0,9.14,198.02,2804063,2804119
14006,68,43,0,7.53,35.81,2804118,2804186
14007,52,30,1,9.85,53.90,2804185,2804237
14008,69,45,1,7.42,41.87,2804236,2804305
14009,57,26,2,8.98,31.10,2804304,2804361
14010,71,25,0,7.21,24.67,2804360,2804431
14011,65,24,1,7.88,21.83,2804430,2804495
14012,73,18,1,7.01,16.18,2804494,2804567
14013,54,45,1,9.48,71.47,2804566,2804620
14014,63,42,0,8.13,53.98,2804619,2804682
14015,43,30,3,11.91,47.62,2804682,2804725
14016,59,38,1,8.68,37.44,2804724,2804783
14017,59,27,2,8.68,25.91,2804782,2804841
14018,65,27,1,7.88,32.26,2804841,2804906
14019,69,28,0,7.42,35.40,2804905,2804974
14020,54,30,1,9.48,47.51,2804973,2805027
14021,64,25,0,8.00,28.47,2805026,2805090
14022,46,51,0,11.13,119.55,2805089,2805135
14023,62,38,0,8.26,54.80,2805134,2805196
14024,31,195,1,16.52,1121.99,2805195,2805226
14025,56,56,0,9.14,78.80,2805225,2805281
14026,46,99,1,11.13,291.59,2805280,2805326
14027,41,99,1,12.49,350.84,2805325,2805366
14028,72,30,0,7.11,45.85,2805365,2805437
14029,96,37,0,5.33,32.12,2805436,2805532
14030,97,20,0,5.28,15.50,2805532,2805629
14031,76,41,0,6.74,38.67,2805628,2805704
14032,81,20,1,6.32,16.69,2805704,2805785
14033,75,83,1,6.83,102.44,2805784,2805859
14034,80,26,1,6.40,25.79,2805858,2805938
14035,74,56,0,6.92,49.34,2805937,2806011
14036,67,25,0,7.64,27.27,2806010,2806077
14037,54,52,0,9.48,80.25,2806076,2806130
14038,55,71,1,9.31,105.23,2806129,2806184
14039,65,20,0,7.88,19.18,2806183,2806248
14040,71,47,0,7.21,41.69,2806247,2806318
14041,57,25,0,8.98,24.58,2806317,2806374
14042,74,23,0,6.92,26.32,2806373,2806447
14043,65,21,1,7.88,20.23,2806446,2806511
14044,56,59,1,9.14,83.80,2806510,2806566
14045,50,32,1,10.24,37.82,2806565,2806615
14046,56,42,2,9.14,45.12,2806615,2806671
14047,69,36,0,7.42,49.75,2806670,2806739
14048,75,26,0,6.83,24.38,2806738,2806813
14049,71,52,0,7.21,56.00,2806812,2806883
14050,64,37,1,8.00,39.81,2806882,2806946
14051,74,25,0,6.92,22.26,2806945,2807019
14052,67,35,0,7.64,42.14,2807018,2807085
14053,59,34,1,8.68,57.34,2807084,2807143
14054,59,43,0,8.68,61.40,2807142,2807201
14055,77,30,0,6.65,37.50,2807201,2807278
14056,90,22,0,5.69,20.17,2807278,2807368
14057,100,45,0,5.12,35.91,2807367,2807467
14058,97,28,0,5.28,20.30,2807467,2807564
14059,78,26,0,6.56,24.02,2807563,2807641
14060,77,38,1,6.65,35.03,2807641,2807718
14061,68,54,0,7.53,61.66,2807717,2807785
14062,84,48,0,6.10,42.06,2807784,2807868
14063,80,27,0,6.40,32.59,2807867,2807947
14064,82,44,0,6.24,39.89,2807946,2808028
14065,60,40,1,8.53,47.38,2808027,2808087
14066,69,23,0,7.42,20.39,2808086,2808155
14067,73,47,0,7.01,45.38,2808154,2808227
14068,56,39,2,9.14,47.37,2808226,2808282
14069,63,49,0,8.13,56.40,2808282,2808345
14070,67,24,1,7.64,28.32,2808344,2808411
14071,39,78,2,13.13,223.65,2808410,2808449
14072,52,80,2,9.85,119.63,2808448,2808500
14073,65,23,1,7.88,32.02,2808499,2808564
14074,78,17,0,6.56,12.81,2808563,2808641
14075,69,23,1,7.42,29.78,2808641,2808710
14076,58,31,1,8.83,46.52,2808709,2808767
14077,60,31,1,8.53,46.52,2808767,2808827
14078,40,42,1,12.80,77.26,2808826,2808866
14079,35,44,1,14.63,119.20,2808865,2808900
14080,69,27,1,7.42,34.91,2808899,2808968
14081,67,30,1,7.64,38.29,2808968,2809035
14082,51,31,1,10.04,61.96,2809034,2809085
14083,58,30,0,8.83,54.49,2809084,2809142
14084,57,31,0,8.98,47.39,2809141,2809198
14085,68,39,0,7.53,48.60,2809198,2809266
14086,95,28,0,5.39,28.47,2809265,2809360
14087,93,34,0,5.51,25.91,2809360,2809453
14088,75,20,1,6.83,18.94,2809452,2809527
14089,70,28,0,7.31,22.76,2809526,2809596
14090,64,47,0,8.00,64.31,2809595,2809659
14091,82,33,1,6.24,25.89,2809658,2809740
14092,57,36,0,8.98,40.75,2809740,2809797
14093,75,34,0,6.83,25.40,2809796,2809871
14094,72,19,0,7.11,17.27,2809870,2809942
14095,50,32,2,10.24,44.22,2809941,2809991
14096,60,30,1,8.53,61.72,2809990,2810050
14097,64,27,0,8.00,27.53,2810049,2810113
14098,72,23,1,7.11,23.68,2810112,2810184
14099,57,31,1,8.98,34.72,2810183,2810240
14100,64,23,1,8.00,19.59,2810239,2810303
14101,54,45,2,9.48,39.81,2810302,2810356
14102,56,45,1,9.14,68.52,2810355,2810411
14103,63,21,1,8.13,18.27,2810410,2810473
14104,53,95,0,9.66,165.36,2810473,2810526
14105,58,43,1,8.83,56.94,2810525,2810583
14106,63,35,1,8.13,39.54,2810582,2810645
14107,64,118,1,8.00,219.94,2810644,2810708
14108,62,29,1,8.26,30.26,2810707,2810769
14109,64,52,1,8.00,47.19,2810769,2810833
14110,64,48,0,8.00,63.53,2810832,2810896
14111,64,29,1,8.00,29.50,2810895,2810959
14112,74,29,0,6.92,25.43,2810958,2811032
14113,68,33,0,7.53,46.78,2811031,2811099
14114,75,38,0,6.83,41.45,2811098,2811173
14115,100,20,0,5.12,20.83,2811172,2811272
14116,95,55,0,5.39,44.79,2811271,2811366
14117,79,46,0,6.48,33.92,2811365,2811444
14118,84,30,0,6.10,24.56,2811443,2811527
14119,68,71,0,7.53,83.31,2811526,2811594
14120,79,34,1,6.48,28.71,2811594,2811673
14121,74,26,0,6.92,29.48,2811673,2811747
14122,69,49,0,7.42,84.79,2811746,2811815
14123,63,24,1,8.13,24.36,2811814,2811877
14124,67,26,0,7.64,33.69,2811876,2811943
14125,48,99,1,10.67,217.89,2811943,2811991
14126,73,35,0,7.01,29.71,2811990,2812063
14127,59,36,2,8.68,33.95,2812062,2812121
14128,53,38,0,9.66,47.21,2812120,2812173
14129,64,41,0,8.00,44.81,2812173,2812237
14130,72,21,0,7.11,19.02,2812236,2812308
14131,59,22,1,8.68,23.10,2812307,2812366
14132,61,33,1,8.39,37.62,2812365,2812426
14133,55,60,1,9.31,82.18,2812425,2812480
14134,88,19,0,5.82,15.38,2812479,2812567
14135,59,32,0,8.68,53.20,2812566,2812625
14136,61,24,0,8.39,35.26,2812624,2812685
14137,66,33,1,7.76,38.64,2812684,2812750
14138,63,34,0,8.13,36.40,2812749,2812812
14139,56,61,0,9.14,106.16,2812811,2812867
14140,84,41,0,6.10,41.11,2812866,2812950
14141,97,23,0,5.28,19.25,2812949,2813046
14142,101,42,0,5.07,37.77,2813045,2813146
14143,69,18,0,7.42,20.85,2813145,2813214
14144,63,145,0,8.13,320.33,2813214,2813277
14145,76,42,1,6.74,38.90,2813276,2813352
14146,90,18,1,5.69,15.21,2813352,2813442
14147,68,65,1,7.53,85.04,2813441,2813509
14148,58,38,2,8.83,39.63,2813508,2813566
14149,74,31,0,6.92,36.70,2813565,2813639
14150,43,115,0,11.91,365.99,2813638,2813681
14151,50,54,1,10.24,106.26,2813680,2813730
14152,64,32,0,8.00,25.53,2813729,2813793
14153,69,26,0,7.42,38.48,2813792,2813861
14154,50,48,1,10.24,55.50,2813860,2813910
14155,58,36,1,8.83,35.76,2813909,2813967
14156,59,23,0,8.68,27.44,2813966,2814025
14157,46,70,1,11.13,171.59,2814024,2814070
14158,61,23,1,8.39,27.19,2814069,2814130
14159,63,25,0,8.13,29.76,2814129,2814192
14160,65,20,0,7.88,22.35,2814191,2814256
14161,59,44,2,8.68,44.12,2814256,2814315
14162,70,28,1,7.31,22.64,2814314,2814384
14163,36,75,2,14.22,269.51,2814383,2814419
14164,68,23,0,7.53,27.78,2814418,2814486
14165,49,41,0,10.45,84.25,2814485,2814534
14166,70,87,0,7.31,121.22,2814533,2814603
14167,75,34,0,6.83,44.60,2814602,2814677
14168,82,44,0,6.24,55.57,2814676,2814758
14169,100,24,0,5.12,21.21,2814758,2814858
14170,83,28,0,6.17,18.07,2814857,2814940
14171,84,30,1,6.10,27.37,2814939,2815023
14172,74,28,0,6.92,29.32,2815022,2815096
14173,87,19,0,5.89,17.53,2815095,2815182
14174,67,28,1,7.64,26.92,2815181,2815248
14175,61,22,1,8.39,22.04,2815247,2815308
14176,50,42,1,10.24,67.34,2815307,2815357
14177,64,40,1,8.00,40.38,2815356,2815420
14178,61,30,1,8.39,38.30,2815419,2815480
14179,65,24,1,7.88,25.71,2815479,2815544
14180,46,45,2,11.13,67.77,2815544,2815590
14181,49,65,2,10.45,113.59,2815590,2815639
14182,56,22,2,9.14,26.94,2815638,2815694
14183,66,30,1,7.76,25.40,2815693,2815759
14184,62,32,1,8.26,43.45,2815758,2815820
14185,63,49,1,8.13,45.44,2815819,2815882
14186,58,94,1,8.83,160.69,2815881,2815939
14187,66,25,1,7.76,24.55,2815938,2816004
14188,75,25,0,6.83,19.80,2816003,2816078
14189,59,37,1,8.68,48.18,2816077,2816136
14190,74,28,0,6.92,26.99,2816135,2816209
14191,73,30,0,7.01,30.51,2816208,2816281
14192,63,33,1,8.13,39.67,2816280,2816343
14193,108,27,0,4.74,25.19,2816342,2816450
14194,64,71,0,8.00,104.84,2816449,2816513
14195,114,42,0,4.49,29.93,2816512,2816626
14196,75,20,1,6.83,21.18,2816625,2816700
14197,77,28,1,6.65,27.21,2816699,2816776
14198,87,35,0,5.89,27.25,2816775,2816862
14199,80,27,0,6.40,26.81,2816861,2816941
14200,76,22,0,6.74,24.80,2816940,2817016
14201,94,19,0,5.45,15.20,2817016,2817110
14202,61,48,1,8.39,47.98,2817109,2817170
14203,60,29,1,8.53,39.72,2817169,2817229
14204,59,27,1,8.68,34.52,2817228,2817287
14205,54,53,1,9.48,78.21,2817286,2817340
14206,62,50,0,8.26,60.90,2817339,2817401
14207,65,33,0,7.88,36.60,2817400,2817465
14208,58,40,1,8.83,44.66,2817464,2817522
14209,53,47,1,9.66,59.28,2817521,2817574
14210,66,71,0,7.76,82.94,2817573,2817639
14211,57,37,2,8.98,34.65,2817638,2817695
14212,60,28,0,8.53,33.15,2817694,2817754
14213,66,19,0,7.76,22.55,2817753,2817819
14214,81,23,0,6.32,22.24,2817818,2817899
14215,43,51,1,11.91,113.90,2817898,2817941
14216,65,30,0,7.88,44.29,2817940,2818005
14217,52,34,1,9.85,79.51,2818004,2818056
14218,63,35,1,8.13,44.90,2818055,2818118
14219,74,38,0,6.92,31.34,2818117,2818191
14220,83,32,0,6.17,31.42,2818190,2818273
14221,88,26,0,5.82,32.26,2818273,2818361
14222,98,29,0,5.22,28.34,2818361,2818459
14223,73,49,1,7.01,50.34,2818459,2818532
14224,83,33,1,6.17,28.31,2818531,2818614
14225,75,38,0,6.83,38.17,2818613,2818688
14226,80,30,0,6.40,23.51,2818687,2818767
14227,71,28,1,7.21,33.29,2818766,2818837
14228,85,29,1,6.02,29.20,2818837,2818922
14229,74,20,1,6.92,19.89,2818921,2818995
14230,63,72,0,8.13,94.11,2818994,2819057
14231,60,74,1,8.53,103.62,2819056,2819116
14232,85,24,0,6.02,14.09,2819115,2819200
14233,68,24,1,7.53,24.98,2819199,2819267
14234,56,45,1,9.14,72.05,2819266,2819322
14235,53,26,1,9.66,34.19,2819321,2819374
14236,47,37,1,10.89,57.67,2819373,2819420
14237,63,34,1,8.13,21.22,2819419,2819482
14238,62,31,1,8.26,40.39,2819481,2819543
14239,57,35,1,8.98,41.28,2819542,2819599
14240,63,26,0,8.13,25.41,2819598,2819661
14241,85,23,1,6.02,17.76,2819660,2819745
14242,65,54,0,7.88,58.45,2819744,2819809
14243,60,51,1,8.53,54.82,2819809,2819869
14244,46,96,1,11.13,239.20,2819868,2819914
14245,65,45,1,7.88,55.80,2819913,2819978
14246,63,76,0,8.13,113.22,2819977,2820040
14247,32,200,1,16.00,1175.69,2820039,2820071
14248,65,25,1,7.88,23.83,2820070,2820135
14249,50,99,0,10.24,245.42,2820134,2820184
14250,85,22,0,6.02,25.53,2820183,2820268
14251,100,32,0,5.12,24.59,2820267,2820367
14252,90,33,0,5.69,24.64,2820367,2820457
14253,65,48,0,7.88,57.09,2820456,2820521
14254,68,39,1,7.53,32.81,2820520,2820588
14255,79,39,0,6.48,40.33,2820587,2820666
14256,84,27,1,6.10,18.61,2820666,2820750
14257,75,30,1,6.83,16.38,2820749,2820824
14258,83,35,0,6.17,27.56,2820823,2820906
14259,52,38,1,9.85,51.75,2820905,2820957
14260,69,55,1,7.42,46.85,2820957,2821026
14261,64,39,2,8.00,37.09,2821025,2821089
14262,81,21,0,6.32,21.08,2821088,2821169
14263,66,26,1,7.76,26.43,2821168,2821234
14264,52,41,2,9.85,58.32,2821233,2821285
14265,71,27,1,7.21,26.11,2821284,2821355
14266,60,25,1,8.53,27.22,2821354,2821414
14267,49,44,3,10.45,43.80,2821413,2821462
14268,69,21,0,7.42,20.79,2821461,2821530
14269,72,24,0,7.11,22.88,2821530,2821602
14270,80,24,1,6.40,15.56,2821601,2821681
14271,70,34,0,7.31,31.24,2821680,2821750
14272,56,39,0,9.14,54.94,2821749,2821805
14273,67,33,0,7.64,42.38,2821804,2821871
14274,61,24,0,8.39,42.34,2821870,2821931
14275,51,76,0,10.04,136.39,2821930,2821981
14276,49,112,0,10.45,260.49,2821980,2822029
14277,82,29,0,6.24,38.23,2822028,2822110
14278,56,56,0,9.14,119.52,2822109,2822165
14279,94,28,0,5.45,30.16,2822164,2822258
14280,95,21,0,5.39,20.30,2822257,2822352
14281,54,43,0,9.48,97.84,2822351,2822405
14282,76,26,1,6.74,23.30,2822404,2822480
14283,81,20,0,6.32,17.08,2822479,2822560
14284,84,28,0,6.10,21.28,2822559,2822643
14285,68,25,1,7.53,28.54,2822642,2822710
14286,74,50,1,6.92,44.94,2822709,2822783
14287,70,22,1,7.31,18.36,2822782,2822852
14288,68,17,2,7.53,12.28,2822851,2822919
14289,66,28,1,7.76,31.55,2822918,2822984
14290,59,41,1,8.68,46.18,2822983,2823042
14291,65,28,1,7.88,24.42,2823041,2823106
14292,63,42,0,8.13,41.70,2823105,2823168
14293,52,46,0,9.85,100.71,2823167,2823219
14294,71,22,1,7.21,17.91,2823218,2823289
14295,58,30,0,8.83,43.63,2823288,2823346
14296,58,46,1,8.83,50.28,2823345,2823403
14297,70,28,0,7.31,28.42,2823402,2823472
14298,73,48,0,7.01,45.14,2823471,2823544
14299,70,18,1,7.31,17.24,2823543,2823613
14300,62,29,2,8.26,33.55,2823612,2823674
14301,57,27,0,8.98,53.42,2823673,2823730
14302,63,28,1,8.13,36.59,2823729,2823792
14303,53,42,2,9.66,66.19,2823792,2823845
14304,66,33,0,7.76,48.61,2823844,2823910
14305,96,26,0,5.33,23.93,2823910,2824006
14306,86,49,0,5.95,51.35,2824005,2824091
14307,92,43,0,5.57,42.79,2824090,2824182
14308,91,22,1,5.63,18.94,2824181,2824272
14309,88,20,0,5.82,13.40,2824272,2824360
14310,88,25,0,5.82,19.44,2824360,2824448
14311,65,70,0,7.88,118.11,2824447,2824512
14312,61,27,0,8.39,43.62,2824511,2824572
14313,77,51,1,6.65,50.51,2824571,2824648
14314,63,23,0,8.13,24.87,2824647,2824710
14315,53,44,1,9.66,58.19,2824709,2824762
14316,61,40,1,8.39,52.44,2824761,2824822
14317,64,32,1,8.00,25.09,2824821,2824885
14318,57,28,1,8.98,31.28,2824884,2824941
14319,54,52,1,9.48,66.18,2824941,2824995
14320,68,30,1,7.53,34.90,2824994,2825062
14321,55,50,1,9.31,107.56,2825061,2825116
14322,80,23,0,6.40,21.46,2825115,2825195
14323,70,28,0,7.31,21.39,2825195,2825265
14324,65,39,0,7.88,52.57,2825264,2825329
14325,50,68,0,10.24,109.74,2825328,2825378
14326,71,38,0,7.21,45.27,2825377,2825448
14327,65,35,1,7.88,40.63,2825448,2825513
14328,58,50,0,8.83,82.80,2825512,2825570
14329,91,27,0,5.63,28.85,2825569,2825660
14330,103,23,0,4.97,20.46,2825660,2825763
14331,79,23,0,6.48,23.95,2825762,2825841
14332,71,31,0,7.21,24.93,2825840,2825911
14333,87,22,1,5.89,20.06,2825910,2825997
14334,74,60,0,6.92,64.64,2825996,2826070
14335,56,46,1,9.14,54.94,2826070,2826126
14336,73,29,0,7.01,32.29,2826125,2826198
14337,73,20,0,7.01,17.27,2826198,2826271
14338,73,23,0,7.01,21.66,2826270,2826343
14339,77,29,1,6.65,23.58,2826342,2826419
14340,68,24,2,7.53,18.19,2826418,2826486
14341,43,69,2,11.91,171.71,2826485,2826528
14342,61,38,1,8.39,36.63,2826527,2826588
14343,42,108,1,12.19,277.58,2826587,2826629
14344,60,26,0,8.53,28.75,2826628,2826688
14345,75,26,1,6.83,22.25,2826687,2826762
14346,73,20,0,7.01,18.62,2826761,2826834
14347,58,32,0,8.83,31.80,2826833,2826891
14348,45,171,0,11.38,640.06,2826890,2826935
14349,71,27,1,7.21,30.98,2826934,2827005
14350,45,99,0,11.38,259.44,2827004,2827049
14351,45,56,0,11.38,109.70,2827048,2827093
14352,72,30,0,7.11,41.29,2827092,2827164
14353,61,22,0,8.39,28.83,2827163,2827224
14354,71,30,0,7.21,39.91,2827223,2827294
14355,67,70,0,7.64,91.01,2827293,2827360
14356,94,22,0,5.45,19.95,2827359,2827453
14357,84,44,0,6.10,48.35,2827452,2827536
14358,84,23,0,6.10,29.90,2827535,2827619
14359,71,23,1,7.21,28.79,2827618,2827689
14360,78,28,0,6.56,27.22,2827688,2827766
14361,98,49,0,5.22,29.52,2827765,2827863
14362,64,32,0,8.00,44.88,2827863,2827927
14363,76,57,1,6.74,50.17,2827927,2828003
14364,66,27,1,7.76,35.94,2828002,2828068
14365,55,79,1,9.31,113.34,2828067,2828122
14366,59,48,1,8.68,47.27,2828121,2828180
14367,71,23,1,7.21,24.17,2828179,2828250
14368,65,34,0,7.88,33.98,2828250,2828315
14369,48,55,1,10.67,102.89,2828314,2828362
14370,57,28,1,8.98,31.56,2828361,2828418
14371,59,24,1,8.68,29.68,2828417,2828476
14372,51,30,1,10.04,48.00,2828476,2828527
14373,41,81,2,12.49,153.96,2828526,2828567
14374,51,42,2,10.04,61.17,2828566,2828617
14375,60,26,0,8.53,31.38,2828616,2828676
14376,69,27,1,7.42,35.26,2828675,2828744
14377,57,46,1,8.98,63.77,2828744,2828801
14378,70,18,1,7.31,15.93,2828800,2828870
14379,62,28,2,8.26,24.64,2828869,2828931
14380,65,45,0,7.88,44.66,2828930,2828995
14381,45,58,1,11.38,112.68,2828994,2829039
14382,59,42,1,8.68,49.27,2829038,2829097
14383,66,33,0,7.76,49.21,2829096,2829162
14384,74,39,0,6.92,48.40,2829161,2829235
14385,101,19,0,5.07,21.83,2829234,2829335
14386,115,19,0,4.45,13.69,2829334,2829449
14387,71,95,1,7.21,123.35,2829448,2829519
14388,79,31,0,6.48,21.49,2829518,2829597
14389,83,17,0,6.17,20.14,2829596,2829679
14390,73,36,1,7.01,34.75,2829678,2829751
14391,77,19,0,6.65,17.92,2829750,2829827
14392,54,49,0,9.48,64.18,2829826,2829880
14393,41,106,1,12.49,297.32,2829879,2829920
14394,64,23,1,8.00,22.56,2829919,2829983
14395,67,31,0,7.64,33.87,2829982,2830049
14396,63,36,1,8.13,35.83,2830048,2830111
14397,48,60,1,10.67,88.43,2830111,2830159
14398,56,39,0,9.14,62.87,2830158,2830214
14399,60,25,1,8.53,24.25,2830213,2830273
14400,45,30,1,11.38,42.95,2830273,2830318
14401,64,39,1,8.00,31.50,2830317,2830381
14402,63,25,0,8.13,28.08,2830380,2830443
14403,67,25,0,7.64,34.77,2830443,2830510
14404,50,33,2,10.24,37.54,2830509,2830559
14405,59,65,1,8.68,86.25,2830558,2830617
14406,63,26,0,8.13,31.57,2830616,2830679
14407,44,53,2,11.64,106.19,2830679,2830723
14408,66,32,0,7.76,42.82,2830722,2830788
14409,51,79,0,10.04,149.72,2830787,2830838
14410,71,22,0,7.21,27.86,2830837,2830908
14411,90,24,0,5.69,23.50,2830907,2830997
14412,99,32,0,5.17,28.95,2830996,2831095
14413,109,31,0,4.70,24.36,2831094,2831203
14414,92,97,0,5.57,103.75,2831203,2831295
14415,86,33,1,5.95,24.65,2831294,2831380
14416,90,33,0,5.69,23.48,2831379,2831469
14417,77,37,0,6.65,35.42,2831468,2831545
14418,75,25,0,6.83,29.88,2831544,2831619
14419,68,32,1,7.53,33.78,2831618,2831686
14420,62,39,2,8.26,34.71,2831685,2831747
14421,56,64,0,9.14,73.91,2831746,2831802
14422,61,22,2,8.39,24.01,2831801,2831862
14423,75,30,1,6.83,21.08,2831861,2831936
14424,65,39,1,7.88,27.37,2831936,2832001
14425,56,33,1,9.14,46.84,2832000,2832056
14426,50,47,1,10.24,68.10,2832055,2832105
14427,63,28,0,8.13,29.73,2832104,2832167
14428,60,28,1,8.53,24.85,2832166,2832226
14429,50,35,1,10.24,38.34,2832225,2832275
14430,66,25,1,7.76,22.91,2832274,2832340
14431,63,35,1,8.13,31.38,2832340,2832403
14432,59,53,1,8.68,64.63,2832402,2832461
14433,86,21,1,5.95,18.56,2832461,2832547
14434,66,23,1,7.76,32.03,2832547,2832613
14435,63,26,1,8.13,29.48,2832612,2832675
14436,72,28,1,7.11,28.60,2832674,2832746
14437,64,57,1,8.00,84.19,2832745,2832809
14438,98,35,0,5.22,27.99,2832809,2832907
14439,76,87,0,6.74,116.25,2832906,2832982
14440,90,36,0,5.69,30.48,2832981,2833071
14441,57,27,1,8.98,35.25,2833070,2833127
14442,73,24,0,7.01,26.18,2833126,2833199
14443,84,24,1,6.10,14.99,2833198,2833282
14444,85,29,0,6.02,20.21,2833281,2833366
14445,74,26,1,6.92,27.62,2833365,2833439
14446,73,26,0,7.01,24.23,2833438,2833511
14447,73,21,1,7.01,19.52,2833510,2833583
14448,56,35,1,9.14,37.34,2833582,2833638
14449,58,38,2,8.83,38.00,2833637,2833695
14450,59,51,1,8.68,68.49,2833694,2833753
14451,75,31,0,6.83,28.89,2833752,2833827
14452,53,34,1,9.66,49.55,2833826,2833879
14453,67,24,1,7.64,22.32,2833879,2833946
14454,77,26,0,6.65,27.06,2833945,2834022
14455,51,22,1,10.04,27.84,2834021,2834072
14456,63,33,1,8.13,32.05,2834071,2834134
14457,67,41,0,7.64,34.86,2834133,2834200
14458,70,25,2,7.31,19.53,2834199,2834269
14459,69,28,1,7.42,27.03,2834268,2834337
14460,63,33,2,8.13,29.89,2834336,2834399
14461,55,38,2,9.31,38.18,2834398,2834453
14462,71,23,1,7.21,22.14,2834452,2834523
14463,67,30,1,7.64,30.26,2834522,2834589
14464,53,41,1,9.66,58.45,2834588,2834641
14465,69,27,0,7.42,39.11,2834641,2834710
14466,59,42,0,8.68,65.20,2834709,2834768
14467,50,46,1,10.24,74.58,2834767,2834817
14468,61,39,0,8.39,52.99,2834816,2834877
14469,71,30,0,7.21,41.41,2834876,2834947
14470,82,22,0,6.24,30.18,2834946,2835028
14471,100,18,0,5.12,14.83,2835028,2835128
14472,77,52,1,6.65,43.79,2835127,2835204
14473,70,21,1,7.31,20.59,2835204,2835274
14474,74,24,1,6.92,21.91,2835273,2835347
14475,84,23,0,6.10,25.23,2835346,2835430
14476,85,22,0,6.02,18.35,2835429,2835514
14477,68,44,1,7.53,47.98,2835513,2835581
14478,76,32,0,6.74,30.04,2835580,2835656
14479,86,20,1,5.95,11.74,2835655,2835741
14480,50,60,1,10.24,80.22,2835740,2835790
14481,61,43,1,8.39,48.66,2835789,2835850
14482,47,105,0,10.89,263.92,2835849,2835896
14483,61,30,0,8.39,43.91,2835895,2835956
14484,67,28,1,7.64,23.16,2835955,2836022
14485,59,39,1,8.68,46.93,2836022,2836081
14486,62,41,1,8.26,50.61,2836080,2836142
14487,57,29,1,8.98,32.51,2836142,2836199
14488,60,21,0,8.53,25.92,2836198,2836258
14489,65,50,1,7.88,50.91,2836257,2836322
14490,81,25,0,6.32,21.77,2836321,2836402
14491,55,34,1,9.31,38.10,2836401,2836456
14492,60,33,0,8.53,35.72,2836456,2836516
14493,55,42,1,9.31,55.60,2836515,2836570
14494,54,61,0,9.48,82.29,2836570,2836624
14495,73,32,1,7.01,30.53,2836623,2836696
14496,42,96,1,12.19,235.20,2836695,2836737
14497,61,60,0,8.39,80.93,2836736,2836797
14498,66,28,1,7.76,34.58,2836796,2836862
14499,87,29,0,5.89,37.07,2836861,2836948
14500,85,35,0,6.02,42.92,2836947,2837032
14501,107,24,0,4.79,21.72,2837031,2837138
14502,80,25,0,6.40,19.91,2837137,2837217
14503,77,30,1,6.65,27.81,2837216,2837293
14504,85,30,0,6.02,27.79,2837292,2837377
14505,73,31,0,7.01,30.10,2837376,2837449
14506,84,23,1,6.10,21.92,2837448,2837532
14507,75,49,0,6.83,46.52,2837531,2837606
14508,55,57,1,9.31,73.81,2837605,2837660
14509,67,26,1,7.64,26.71,2837659,2837726
14510,63,36,2,8.13,43.22,2837725,2837788
14511,66,26,1,7.76,24.52,2837787,2837853
14512,68,22,1,7.53,24.16,2837852,2837920
14513,61,32,0,8.39,28.44,2837919,2837980
14514,70,28,1,7.31,23.50,2837979,2838049
14515,50,59,1,10.24,126.70,2838048,2838098
14516,59,39,1,8.68,45.61,2838097,2838156
14517,53,29,1,9.66,30.98,2838155,2838208
14518,47,32,2,10.89,49.07,2838207,2838254
14519,61,29,1,8.39,34.83,2838253,2838314
14520,61,29,2,8.39,31.22,2838313,2838374
14521,66,31,0,7.76,36.58,2838373,2838439
14522,78,26,1,6.56,21.63,2838438,2838516
14523,48,36,2,10.67,47.22,2838515,2838563
14524,81,24,0,6.32,16.05,2838562,2838643
14525,50,35,0,10.24,62.62,2838642,2838692
14526,71,26,0,7.21,38.00,2838691,2838762
14527,51,39,1,10.04,62.19,2838761,2838812
14528,42,48,1,12.19,82.49,2838811,2838853
14529,73,51,0,7.01,55.08,2838853,2838926
14530,72,22,0,7.11,23.65,2838925,2838997
14531,113,25,0,4.53,23.63,2838996,2839109
14532,92,52,0,5.57,50.90,2839108,2839200
14533,80,20,1,6.40,18.29,2839199,2839279
14534,64,28,1,8.00,34.19,2839278,2839342
14535,62,54,0,8.26,92.09,2839341,2839403
14536,79,23,1,6.48,20.35,2839402,2839481
14537,81,26,0,6.32,27.58,2839480,2839561
14538,60,84,1,8.53,119.45,2839561,2839621
14539,83,17,0,6.17,13.78,2839620,2839703
14540,62,54,1,8.26,78.06,2839702,2839764
14541,70,32,1,7.31,27.39,2839763,2839833
14542,54,37,0,9.48,72.03,2839833,2839887
14543,59,38,0,8.68,47.85,2839886,2839945
14544,52,28,1,9.85,36.55,2839944,2839996
14545,69,32,0,7.42,28.85,2839995,2840064
14546,69,27,0,7.42,27.35,2840063,2840132
14547,62,37,1,8.26,35.51,2840131,2840193
14548,58,30,2,8.83,28.80,2840192,2840250
14549,39,105,2,13.13,247.19,2840250,2840289
14550,51,39,1,10.04,50.63,2840288,2840339
14551,66,27,1,7.76,29.64,2840338,2840404
14552,63,52,1,8.13,51.48,2840403,2840466
14553,74,50,0,6.92,56.02,2840465,2840539
14554,57,27,1,8.98,27.84,2840539,2840596
14555,46,55,2,11.13,117.50,2840595,2840641
14556,71,28,0,7.21,41.24,2840641,2840712
14557,49,40,1,10.45,79.47,2840711,2840760
14558,61,57,0,8.39,104.83,2840759,2840820
14559,92,22,0,5.57,17.18,2840819,2840911
14560,97,28,0,5.28,34.94,2840910,2841007
14561,84,26,0,6.10,24.01,2841006,2841090
14562,68,32,0,7.53,45.40,2841089,2841157
14563,79,42,1,6.48,38.60,2841156,2841235
14564,80,20,0,6.40,21.64,2841234,2841314
14565,60,52,1,8.53,91.08,2841313,2841373
14566,57,36,1,8.98,38.65,2841372,2841429
14567,61,77,0,8.39,108.34,2841428,2841489
14568,70,28,1,7.31,31.56,2841489,2841559
14569,63,39,1,8.13,37.95,2841558,2841621
14570,55,47,1,9.31,53.81,2841620,2841675
14571,73,21,1,7.01,17.85,2841674,2841747
14572,61,52,2,8.39,52.93,2841746,2841807
14573,61,44,1,8.39,60.57,2841807,2841868
14574,56,42,1,9.14,56.94,2841867,2841923
14575,66,40,0,7.76,49.85,2841922,2841988
14576,60,32,1,8.53,30.02,2841987,2842047
14577,54,37,1,9.48,49.06,2842046,2842100
14578,47,35,1,10.89,60.22,2842099,2842146
14579,64,38,0,8.00,45.09,2842145,2842209
14580,77,29,0,6.65,22.93,2842208,2842285
14581,72,24,0,7.11,26.13,2842284,2842356
14582,71,22,1,7.21,21.52,2842355,2842426
14583,69,27,0,7.42,31.87,2842425,2842494
14584,42,52,1,12.19,105.68,2842493,2842535
14585,52,54,1,9.85,94.48,2842535,2842587
14586,56,26,1,9.14,47.94,2842586,2842642
14587,58,42,0,8.83,75.52,2842641,2842699
14588,72,32,0,7.11,53.49,2842698,2842770
14589,79,31,0,6.48,40.27,2842769,2842848
14590,88,30,0,5.82,35.33,2842848,2842936
14591,75,80,0,6.83,158.70,2842936,2843011
14592,73,30,0,7.01,37.71,2843010,2843083
14593,66,20,1,7.76,20.76,2843082,2843148
14594,82,57,0,6.24,48.18,2843147,2843229
14595,49,47,1,10.45,95.64,2843229,2843278
14596,78,24,0,6.56,24.78,2843277,2843355
14597,83,27,0,6.17,16.31,2843355,2843438
14598,63,57,1,8.13,99.03,2843437,2843500
14599,82,32,0,6.24,22.99,2843499,2843581
14600,49,31,1,10.45,58.12,2843580,2843629
14601,73,26,0,7.01,23.71,2843628,2843701
14602,54,27,0,9.48,33.06,2843700,2843754
14603,66,18,1,7.76,16.70,2843753,2843819
14604,64,27,1,8.00,27.75,2843818,2843882
14605,62,34,1,8.26,35.61,2843881,2843943
14606,41,91,2,12.49,272.44,2843942,2843983
14607,65,24,1,7.88,27.40,2843982,2844047
14608,54,39,1,9.48,44.47,2844046,2844100
14609,41,122,0,12.49,366.25,2844099,2844140
14610,69,27,1,7.42,29.90,2844139,2844208
14611,52,36,1,9.85,47.63,2844207,2844259
14612,62,19,2,8.26,17.68,2844258,2844320
14613,75,23,1,6.83,23.45,2844319,2844394
14614,71,50,0,7.21,75.04,2844393,2844464
14615,57,29,1,8.98,38.16,2844463,2844520
14616,77,31,0,6.65,23.45,2844519,2844596
14617,63,45,0,8.13,84.56,2844595,2844658
14618,47,37,0,10.89,59.97,2844657,2844704
14619,64,28,0,8.00,37.75,2844703,2844767
14620,64,50,0,8.00,77.12,2844766,2844830
14621,80,30,0,6.40,29.64,2844829,2844909
14622,101,43,0,5.07,33.61,2844908,2845009
14623,91,25,0,5.63,25.97,2845008,2845099
14624,67,31,0,7.64,33.45,2845098,2845165
14625,68,30,1,7.53,35.75,2845164,2845232
14626,78,29,0,6.56,22.32,2845232,2845310
14627,82,25,0,6.24,25.01,2845309,2845391
14628,69,31,1,7.42,37.84,2845390,2845459
14629,60,31,1,8.53,34.45,2845458,2845518
14630,78,21,1,6.56,18.37,2845517,2845595
14631,70,26,1,7.31,24.30,2845594,2845664
14632,59,24,1,8.68,22.96,2845663,2845722
14633,62,24,1,8.26,20.39,2845721,2845783
14634,70,26,1,7.31,28.62,2845782,2845852
14635,60,33,1,8.53,41.85,2845851,2845911
14636,62,38,1,8.26,33.74,2845910,2845972
14637,61,28,0,8.39,37.62,2845971,2846032
14638,53,69,1,9.66,129.17,2846031,2846084
14639,60,26,1,8.53,37.42,2846083,2846143
14640,57,41,1,8.98,44.12,2846142,2846199
14641,53,51,2,9.66,73.32,2846199,2846252
14642,62,27,1,8.26,31.19,2846251,2846313
14643,56,44,1,9.14,67.23,2846312,2846368
14644,67,26,0,7.64,34.32,2846367,2846434
14645,60,22,1,8.53,32.88,2846433,2846493
14646,55,45,0,9.31,74.18,2846492,2846547
14647,61,24,0,8.39,34.70,2846546,2846607
14648,52,96,1,9.85,197.63,2846606,2846658
14649,56,43,0,9.14,58.09,2846658,2846714
14650,52,38,0,9.85,79.25,2846714,2846766
14651,41,95,0,12.49,341.81,2846765,2846806
14652,72,42,0,7.11,52.82,2846805,2846877
14653,78,35,0,6.56,49.32,2846876,2846954
14654,83,29,0,6.17,40.86,2846953,2847036
14655,72,49,0,7.11,58.77,2847035,2847107
14656,86,25,0,5.95,21.09,2847106,2847192
14657,82,37,1,6.24,27.40,2847191,2847273
14658,84,27,0,6.10,17.71,2847272,2847356
14659,75,37,0,6.83,38.54,2847356,2847431
14660,60,31,0,8.53,37.32,2847430,2847490
14661,76,27,1,6.74,25.09,2847489,2847565
14662,77,30,0,6.65,27.81,2847564,2847641
14663,64,21,0,8.00,23.62,2847640,2847704
14664,61,30,1,8.39,40.40,2847703,2847764
14665,64,30,1,8.00,31.56,2847763,2847827
14666,79,20,1,6.48,16.86,2847826,2847905
14667,65,28,1,7.88,29.06,2847904,2847969
14668,58,37,0,8.83,43.04,2847969,2848027
14669,59,21,0,8.68,24.08,2848027,2848086
14670,69,32,0,7.42,32.48,2848085,2848154
14671,58,22,2,8.83,17.25,2848154,2848212
14672,44,86,1,11.64,159.41,2848211,2848255
14673,52,54,2,9.85,63.25,2848254,2848306
14674,53,69,1,9.66,101.02,2848305,2848358
14675,73,23,0,7.01,17.16,2848357,2848430
14676,69,61,0,7.42,68.97,2848429,2848498
14677,57,43,1,8.98,44.72,2848497,2848554
14678,62,28,1,8.26,39.77,2848553,2848615
14679,46,45,0,11.13,75.81,2848614,2848660
14680,76,47,0,6.74,40.77,2848659,2848735
14681,56,68,1,9.14,108.12,2848734,2848790
14682,58,39,1,8.83,65.32,2848789,2848847
14683,59,31,1,8.68,46.66,2848846,2848905
14684,82,36,0,6.24,38.67,2848904,2848986
14685,82,27,0,6.24,31.99,2848985,2849067
14686,106,22,0,4.83,12.71,2849066,2849172
14687,64,27,1,8.00,33.09,2849171,2849235
14688,81,31,0,6.32,19.53,2849235,2849316
14689,83,27,1,6.17,27.54,2849315,2849398
14690,82,18,0,6.24,14.84,2849397,2849479
14691,83,27,1,6.17,19.66,2849478,2849561
14692,54,30,2,9.48,42.21,2849561,2849615
14693,87,18,0,5.89,14.24,2849615,2849702
14694,63,24,0,8.13,29.19,2849701,2849764
14695,56,27,1,9.14,30.19,2849763,2849819
14696,51,39,1,10.04,72.47,2849818,2849869
14697,72,25,1,7.11,28.43,2849868,2849940
14698,69,47,1,7.42,42.19,2849939,2850008
14699,70,29,0,7.31,25.13,2850007,2850077
14700,53,48,0,9.66,67.70,2850076,2850129
14701,61,28,1,8.39,30.44,2850128,2850189
14702,51,33,2,10.04,51.84,2850188,2850239
14703,47,55,1,10.89,83.71,2850238,2850285
14704,57,34,1,8.98,43.70,2850284,2850341
14705,66,67,1,7.76,68.61,2850340,2850406
14706,59,37,1,8.68,40.46,2850405,2850464
14707,75,26,1,6.83,25.74,2850463,2850538
14708,63,34,2,8.13,32.59,2850537,2850600
14709,64,45,0,8.00,54.62,2850599,2850663
14710,52,31,1,9.85,53.32,2850662,2850714
14711,66,28,0,7.76,36.58,2850713,2850779
14712,58,35,0,8.83,53.25,2850778,2850836
14713,65,30,0,7.88,43.15,2850835,2850900
14714,68,27,0,7.53,39.46,2850899,2850967
14715,83,24,0,6.17,21.63,2850966,2851049
14716,93,28,0,5.51,27.11,2851048,2851141
14717,106,26,0,4.83,28.07,2851140,2851246
14718,64,39,1,8.00,52.28,2851245,2851309
14719,90,22,0,5.69,18.48,2851308,2851398
14720,73,26,0,7.01,32.48,2851397,2851470
14721,73,25,1,7.01,27.00,2851469,2851542
14722,55,47,1,9.31,69.63,2851541,2851596
14723,63,31,0,8.13,32.90,2851595,2851658
14724,70,31,1,7.31,23.87,2851657,2851727
14725,74,41,0,6.92,31.48,2851726,2851800
14726,53,42,1,9.66,56.53,2851800,2851853
14727,55,54,1,9.31,87.52,2851852,2851907
14728,56,35,2,9.14,38.69,2851906,2851962
14729,57,40,1,8.98,56.96,2851961,2852018
14730,56,63,1,9.14,77.44,2852017,2852073
14731,72,23,0,7.11,32.54,2852072,2852144
14732,61,24,1,8.39,30.30,2852143,2852204
14733,65,38,0,7.88,38.60,2852203,2852268
14734,53,61,1,9.66,131.81,2852267,2852320
14735,74,30,0,6.92,37.02,2852319,2852393
14736,62,45,0,8.26,48.58,2852393,2852455
14737,69,27,0,7.42,44.42,2852455,2852524
14738,80,32,0,6.40,31.42,2852523,2852603
14739,95,32,0,5.39,27.35,2852602,2852697
14740,84,21,1,6.10,15.44,2852696,2852780
14741,78,32,0,6.56,29.43,2852780,2852858
14742,78,18,0,6.56,15.35,2852857,2852935
14743,72,29,0,7.11,28.90,2852934,2853006
14744,58,27,2,8.83,29.80,2853005,2853063
14745,69,21,1,7.42,18.39,2853062,2853131
14746,55,27,1,9.31,39.81,2853130,2853185
14747,74,50,1,6.92,39.97,2853184,2853258
14748,72,34,0,7.11,24.18,2853257,2853329
14749,46,39,1,11.13,60.72,2853328,2853374
14750,61,32,1,8.39,42.99,2853374,2853435
14751,61,33,1,8.39,29.58,2853434,2853495
14752,47,34,1,10.89,44.44,2853494,2853541
14753,61,27,2,8.39,34.40,2853540,2853601
14754,56,38,1,9.14,59.98,2853601,2853657
14755,73,25,1,7.01,23.71,2853656,2853729
14756,54,73,2,9.48,108.14,2853728,2853782
14757,57,44,1,8.98,71.56,2853781,2853838
14758,65,26,1,7.88,34.63,2853837,2853902
14759,57,61,1,8.98,78.72,2853902,2853959
14760,62,31,0,8.26,43.03,2853958,2854020
14761,67,46,0,7.64,60.38,2854019,2854086
14762,49,111,0,10.45,299.15,2854085,2854134
14763,70,38,0,7.31,46.93,2854133,2854203
14764,92,34,0,5.57,36.09,2854202,2854294
14765,96,32,0,5.33,33.76,2854293,2854389
14766,73,42,0,7.01,50.29,2854388,2854461
14767,64,52,1,8.00,66.12,2854460,2854524
14768,79,24,1,6.48,18.48,2854523,2854602
14769,79,20,0,6.48,21.14,2854601,2854680
14770,77,22,0,6.65,18.77,2854679,2854756
14771,86,33,0,5.95,26.60,2854755,2854841
14772,60,36,1,8.53,39.62,2854840,2854900
14773,53,37,1,9.66,59.32,2854899,2854952
14774,52,66,1,9.85,108.51,2854951,2855003
14775,70,36,0,7.31,39.82,2855002,2855072
14776,57,72,1,8.98,95.46,2855071,2855128
14777,40,100,0,12.80,261.91,2855127,2855167
14778,53,37,1,9.66,54.94,2855166,2855219
14779,55,32,2,9.31,34.90,2855218,2855273
14780,37,108,2,13.84,349.05,2855272,2855309
14781,43,45,0,11.91,98.69,2855309,2855352
14782,64,26,1,8.00,26.31,2855351,2855415
14783,61,42,1,8.39,55.12,2855414,2855475
14784,75,33,0,6.83,35.29,2855474,2855549
14785,72,28,1,7.11,21.96,2855548,2855620
14786,75,24,1,6.83,21.82,2855619,2855694
14787,61,26,1,8.39,46.53,2855693,2855754
14788,53,49,0,9.66,76.56,2855753,2855806
14789,73,26,0,7.01,25.30,2855806,2855879
14790,61,51,0,8.39,106.47,2855878,2855939
14791,81,29,0,6.32,27.70,2855938,2856019
14792,95,33,0,5.39,29.92,2856018,2856113
14793,115,25,0,4.45,24.07,2856112,2856227
14794,77,22,1,6.65,23.63,2856226,2856303
14795,77,20,0,6.65,19.68,2856302,2856379
14796,69,32,0,7.42,41.90,2856378,2856447
14797,61,28,1,8.39,37.94,2856446,2856507
14798,69,32,1,7.42,36.13,2856506,2856575
14799,60,29,1,8.53,31.22,2856574,2856634
14800,62,29,1,8.26,38.58,2856633,2856695
14801,73,26,0,7.01,22.95,2856695,2856768
14802,69,27,1,7.42,17.29,2856767,2856836
14803,54,22,2,9.48,19.95,2856835,2856889
14804,46,46,1,11.13,103.55,2856888,2856934
14805,60,34,0,8.53,53.25,2856933,2856993
14806,54,40,1,9.48,56.95,2856993,2857047
14807,67,28,1,7.64,31.72,2857046,2857113
14808,57,30,1,8.98,35.56,2857112,2857169
14809,69,60,0,7.42,67.08,2857168,2857237
14810,45,49,0,11.38,139.61,2857236,2857281
14811,59,43,0,8.68,44.39,2857280,2857339
14812,56,51,0,9.14,97.48,2857339,2857395
14813,64,28,0,8.00,47.12,2857394,2857458
14814,62,30,1,8.26,47.68,2857457,2857519
14815,82,28,0,6.24,29.94,2857518,2857600
14816,112,25,0,4.57,20.26,2857599,2857711
14817,120,17,0,4.27,15.28,2857710,2857830
14818,90,25,1,5.69,18.70,2857830,2857920
14819,64,44,1,8.00,54.41,2857919,2857983
14820,86,20,0,5.95,21.88,2857982,2858068
14821,80,22,1,6.40,15.94,2858067,2858147
14822,67,44,0,7.64,53.60,2858146,2858213
14823,79,26,1,6.48,23.84,2858212,2858291
14824,48,43,2,10.67,61.10,2858290,2858338
14825,60,33,1,8.53,36.15,2858337,2858397
14826,78,20,0,6.56,19.63,2858396,2858474
14827,65,25,0,7.88,22.91,2858473,2858538
14828,46,59,1,11.13,93.24,2858537,2858583
14829,63,65,0,8.13,75.89,2858582,2858645
14830,69,38,1,7.42,26.48,2858644,2858713
14831,44,48,2,11.64,91.96,2858712,2858756
14832,58,34,1,8.83,46.52,2858755,2858813
14833,65,36,0,7.88,43.31,2858812,2858877
14834,60,45,1,8.53,55.75,2858876,2858936
14835,65,25,1,7.88,27.25,2858936,2859001
14836,55,42,1,9.31,64.40,2859001,2859056
14837,65,52,0,7.88,53.40,2859055,2859120
14838,71,26,0,7.21,34.08,2859119,2859190
14839,71,28,0,7.21,27.60,2859189,2859260
14840,73,27,0,7.01,35.96,2859259,2859332
14841,76,34,0,6.74,31.64,2859331,2859407
14842,96,27,0,5.33,28.28,2859406,2859502
14843,83,54,0,6.17,74.04,2859502,2859585
14844,69,30,0,7.42,38.77,2859584,2859653
14845,87,25,0,5.89,19.07,2859652,2859739
14846,73,26,0,7.01,30.42,2859738,2859811
14847,73,34,0,7.01,36.78,2859810,2859883
14848,49,40,1,10.45,55.31,2859882,2859931
14849,55,56,0,9.31,99.89,2859930,2859985
14850,51,28,1,10.04,38.63,2859984,2860035
14851,72,32,1,7.11,20.71,2860035,2860107
14852,55,41,1,9.31,40.83,2860106,2860161
14853,67,30,0,7.64,29.90,2860160,2860227
14854,65,37,1,7.88,43.12,2860226,2860291
14855,59,52,1,8.68,56.42,2860290,2860349
14856,53,34,1,9.66,46.75,2860348,2860401
14857,53,77,1,9.66,109.77,2860400,2860453
14858,62,26,2,8.26,32.03,2860452,2860514
14859,62,43,1,8.26,44.90,2860513,2860575
14860,70,24,1,7.31,28.70,2860574,2860644
14861,49,31,1,10.45,49.51,2860643,2860692
14862,51,110,0,10.04,222.94,2860691,2860742
14863,55,32,1,9.31,40.83,2860741,2860796
14864,71,33,0,7.21,40.39,2860795,2860866
14865,63,22,1,8.13,29.13,2860865,2860928
14866,48,67,0,10.67,121.06,2860927,2860975
14867,42,103,0,12.19,274.20,2860974,2861016
14868,53,75,0,9.66,141.77,2861015,2861068
14869,77,25,0,6.65,38.05,2861067,2861144
14870,104,25,0,4.92,18.51,2861143,2861247
14871,86,29,0,5.95,37.09,2861246,2861332
14872,96,20,0,5.33,16.85,2861331,2861427
14873,86,43,0,5.95,29.93,2861426,2861512
14874,75,33,0,6.83,32.06,2861511,2861586
14875,82,26,0,6.24,27.23,2861585,2861667
14876,65,26,1,7.88,29.71,2861666,2861731
14877,71,26,1,7.21,27.46,2861730,2861801
14878,61,37,1,8.39,45.81,2861800,2861861
14879,58,38,1,8.83,53.07,2861860,2861918
14880,60,24,1,8.53,27.38,2861917,2861977
14881,59,34,2,8.68,29.91,2861976,2862035
14882,64,63,1,8.00,80.69,2862035,2862099
14883,66,31,0,7.76,35.40,2862098,2862164
14884,53,36,1,9.66,39.28,2862163,2862216
14885,67,29,1,7.64,30.68,2862216,2862283
14886,66,34,0,7.76,38.73,2862282,2862348
14887,63,34,0,8.13,34.78,2862347,2862410
14888,70,19,1,7.31,18.19,2862409,2862479
14889,70,28,0,7.31,41.67,2862478,2862548
14890,67,22,0,7.64,34.53,2862547,2862614
14891,62,48,1,8.26,61.84,2862613,2862675
14892,58,39,0,8.83,66.07,2862674,2862732
14893,75,22,0,6.83,24.92,2862732,2862807
14894,87,24,0,5.89,32.35,2862806,2862893
14895,81,46,0,6.32,61.21,2862892,2862973
14896,74,31,0,6.92,37.64,2862972,2863046
14897,88,19,0,5.82,13.24,2863045,2863133
14898,59,43,0,8.68,57.30,2863132,2863191
14899,88,32,0,5.82,24.08,2863190,2863278
14900,54,22,1,9.48,26.58,2863277,2863331
14901,66,24,0,7.76,27.67,2863330,2863396
14902,79,23,1,6.48,17.46,2863395,2863474
14903,57,36,1,8.98,47.07,2863473,2863530
14904,64,25,2,8.00,27.28,2863529,2863593
14905,44,63,1,11.64,104.60,2863592,2863636
14906,66,29,1,7.76,26.76,2863635,2863701
14907,56,28,0,9.14,35.37,2863700,2863756
14908,58,28,2,8.83,33.90,2863755,2863813
14909,62,35,0,8.26,38.80,2863812,2863874
14910,50,37,0,10.24,57.82,2863873,2863923
14911,68,47,1,7.53,50.31,2863922,2863990
14912,58,44,0,8.83,56.35,2863989,2864047
14913,59,34,1,8.68,44.46,2864046,2864105
14914,62,36,1,8.26,43.68,2864105,2864167
14915,48,37,1,10.67,59.81,2864166,2864214
14916,76,41,0,6.74,45.01,2864213,2864289
14917,58,38,1,8.83,44.90,2864288,2864346
14918,47,32,1,10.89,55.67,2864345,2864392
14919,69,45,0,7.42,48.85,2864391,2864460
14920,92,20,0,5.57,17.68,2864459,2864551
14921,106,28,0,4.83,25.93,2864550,2864656
14922,98,19,0,5.22,18.30,2864655,2864753
14923,98,18,0,5.22,16.01,2864752,2864850
14924,58,45,1,8.83,82.32,2864849,2864907
14925,78,56,1,6.56,57.63,2864906,2864984
14926,84,17,0,6.10,17.01,2864983,2865067
14927,81,36,0,6.32,24.61,2865066,2865147
14928,73,23,0,7.01,19.36,2865146,2865219
14929,61,44,1,8.39,61.26,2865218,2865279
14930,56,32,2,9.14,42.12,2865278,2865334
14931,62,21,0,8.26,28.13,2865334,2865396
14932,68,38,0,7.53,33.10,2865395,2865463
14933,61,34,0,8.39,42.30,2865462,2865523
14934,63,24,1,8.13,22.49,2865522,2865585
14935,42,70,2,12.19,153.39,2865584,2865626
14936,46,85,1,11.13,176.24,2865625,2865671
14937,57,41,1,8.98,52.02,2865670,2865727
14938,47,33,1,10.89,50.65,2865726,2865773
14939,56,31,1,9.14,32.52,2865772,2865828
14940,69,36,1,7.42,25.58,2865827,2865896
14941,64,35,0,8.00,55.00,2865895,2865959
14942,70,33,1,7.31,36.22,2865958,2866028
14943,60,27,0,8.53,28.85,2866027,2866087
14944,68,37,0,7.53,49.54,2866086,2866154
14945,52,78,1,9.85,132.67,2866153,2866205
14946,65,53,0,7.88,61.09,2866204,2866269
14947,54,41,1,9.48,70.25,2866268,2866322
14948,53,103,0,9.66,214.94,2866321,2866374
14949,79,23,0,6.48,22.81,2866373,2866452
14950,94,49,0,5.45,40.08,2866451,2866545
14951,105,40,0,4.88,25.96,2866544,2866649
14952,102,22,0,5.02,17.27,2866648,2866750
14953,63,47,1,8.13,50.78,2866749,2866812
14954,79,41,0,6.48,37.39,2866811,2866890
14955,66,33,0,7.76,37.97,2866889,2866955
14956,77,25,0,6.65,24.33,2866954,2867031
14957,79,33,0,6.48,26.33,2867030,2867109
14958,58,56,1,8.83,62.25,2867108,2867166
14959,53,42,1,9.66,62.41,2867165,2867218
14960,66,36,0,7.76,48.18,2867217,2867283
14961,74,24,1,6.92,20.70,2867282,2867356
14962,58,23,1,8.83,24.76,2867355,2867413
14963,59,64,1,8.68,91.03,2867412,2867471
14964,53,57,1,9.66,85.51,2867470,2867523
14965,53,29,2,9.66,39.51,2867522,2867575
14966,45,69,1,11.38,128.19,2867574,2867619
14967,58,56,1,8.83,61.28,2867618,2867676
14968,59,33,1,8.68,39.85,2867675,2867734
14969,62,103,0,8.26,171.64,2867733,2867795
14970,57,35,1,8.98,50.72,2867794,2867851
14971,81,34,1,6.32,22.64,2867850,2867931
14972,57,51,0,8.98,59.77,2867930,2867987
14973,53,38,2,9.66,65.51,2867987,2868040
14974,73,23,0,7.01,28.70,2868039,2868112
14975,56,34,0,9.14,46.80,2868111,2868167
14976,61,29,1,8.39,39.06,2868166,2868227
14977,59,45,0,8.68,65.74,2868226,2868285
14978,56,113,0,9.14,231.44,2868285,2868341
14979,65,44,1,7.88,74.54,2868340,2868405
14980,77,27,0,6.65,36.72,2868405,2868482
14981,89,33,0,5.75,41.62,2868481,2868570
14982,97,36,0,5.28,31.77,2868570,2868667
14983,78,48,1,6.56,45.19,2868666,2868744
14984,87,36,1,5.89,34.06,2868744,2868831
14985,88,29,0,5.82,21.42,2868830,2868918
14986,71,28,0,7.21,31.97,2868917,2868988
14987,64,31,1,8.00,42.59,2868987,2869051
14988,61,32,0,8.39,36.86,2869050,2869111
14989,56,29,0,9.14,34.66,2869110,2869166
14990,65,32,1,7.88,31.52,2869165,2869230
14991,70,19,2,7.31,13.24,2869230,2869300
14992,63,37,0,8.13,34.87,2869299,2869362
14993,56,87,0,9.14,154.02,2869361,2869417
14994,63,31,1,8.13,30.33,2869416,2869479
14995,40,52,1,12.80,101.86,2869478,2869518
14996,65,31,0,7.88,27.46,2869517,2869582
14997,69,24,1,7.42,24.56,2869581,2869650
14998,63,39,1,8.13,38.52,2869649,2869712
14999,76,22,1,6.74,22.38,2869712,2869788
15000,63,23,1,8.13,26.94,2869787,2869850
15001,59,38,2,8.68,51.03,2869849,2869908
15002,56,31,1,9.14,39.69,2869907,2869963
15003,75,41,0,6.83,43.48,2869962,2870037
15004,45,105,1,11.38,257.70,2870036,2870081
15005,58,46,0,8.83,67.32,2870080,2870138
15006,55,113,0,9.31,277.89,2870137,2870192
15007,62,44,1,8.26,53.87,2870191,2870253
15008,57,112,0,8.98,221.74,2870252,2870309
15009,104,26,0,4.92,19.65,2870308,2870412
15010,102,43,0,5.02,27.69,2870411,2870513
15011,96,23,0,5.33,16.22,2870512,2870608
15012,82,30,0,6.24,28.65,2870607,2870689
15013,72,31,0,7.11,32.46,2870688,2870760
15014,68,45,0,7.53,42.69,2870759,2870827
15015,60,38,1,8.53,43.22,2870826,2870886
15016,61,42,1,8.39,63.09,2870885,2870946
15017,77,19,1,6.65,15.32,2870945,2871022
15018,62,25,1,8.26,29.26,2871021,2871083
15019,62,28,0,8.26,34.84,2871082,2871144
15020,63,26,0,8.13,23.89,2871143,2871206
15021,58,63,1,8.83,77.97,2871205,2871263
15022,59,42,1,8.68,57.10,2871262,2871321
15023,68,26,1,7.53,23.81,2871320,2871388
15024,59,31,1,8.68,35.34,2871388,2871447
15025,55,43,1,9.31,56.76,2871447,2871502
15026,62,21,1,8.26,21.39,2871501,2871563
15027,67,52,1,7.64,49.78,2871562,2871629
15028,52,52,1,9.85,73.78,2871628,2871680
15029,46,88,0,11.13,197.55,2871679,2871725
15030,69,39,0,7.42,52.56,2871724,2871793
15031,59,24,1,8.68,27.20,2871792,2871851
15032,62,38,0,8.26,54.97,2871850,2871912
15033,55,30,0,9.31,54.65,2871911,2871966
15034,70,51,0,7.31,62.67,2871965,2872035
15035,89,30,0,5.75,33.33,2872034,2872123
15036,100,34,0,5.12,24.21,2872122,2872222
15037,77,30,0,6.65,25.92,2872221,2872298
15038,69,50,1,7.42,41.61,2872297,2872366
15039,85,24,1,6.02,26.23,2872365,2872450
15040,73,20,0,7.01,21.14,2872449,2872522
15041,57,43,2,8.98,40.61,2872521,2872578
15042,61,27,0,8.39,22.73,2872577,2872638
15043,70,53,0,7.31,58.76,2872637,2872707
15044,60,27,0,8.53,31.78,2872706,2872766
15045,64,40,0,8.00,39.84,2872765,2872829
15046,60,28,1,8.53,33.52,2872828,2872888
15047,48,37,0,10.67,55.31,2872887,2872935
15048,62,30,0,8.26,39.09,2872934,2872996
15049,60,28,1,8.53,28.42,2872995,2873055
15050,62,50,1,8.26,71.64,2873054,2873116
15051,70,23,0,7.31,20.30,2873115,2873185
15052,57,28,1,8.98,34.51,2873184,2873241
15053,48,52,1,10.67,79.39,2873240,2873288
15054,72,35,0,7.11,32.57,2873288,2873360
15055,46,75,1,11.13,174.55,2873359,2873405
15056,71,32,0,7.21,33.01,2873404,2873475
15057,64,35,1,8.00,51.91,2873474,2873538
15058,78,26,0,6.56,29.81,2873537,2873615
15059,99,27,0,5.17,25.37,2873614,2873713
15060,89,33,0,5.75,27.87,2873713,2873802
15061,72,36,0,7.11,38.99,2873801,2873873
15062,82,16,0,6.24,13.67,2873872,2873954
15063,79,48,0,6.48,43.01,2873953,2874032
15064,92,54,0,5.57,41.44,2874031,2874123
15065,51,47,1,10.04,65.45,2874122,2874173
15066,55,27,1,9.31,38.29,2874172,2874227
15067,55,51,1,9.31,67.74,2874226,2874281
15068,66,35,1,7.76,41.09,2874280,2874346
15069,65,24,1,7.88,21.25,2874345,2874410
15070,51,48,0,10.04,72.86,2874409,2874460
15071,64,22,0,8.00,23.53,2874459,2874523
15072,48,26,1,10.67,34.85,2874522,2874570
15073,61,32,0,8.39,39.03,2874570,2874631
15074,54,29,2,9.48,37.40,2874631,2874685
15075,55,62,1,9.31,90.14,2874684,2874739
15076,62,37,0,8.26,44.13,2874738,2874800
15077,46,38,2,11.13,67.29,2874799,2874845
15078,57,44,0,8.98,72.58,2874844,2874901
15079,63,69,1,8.13,100.84,2874900,2874963
15080,61,37,1,8.39,50.50,2874962,2875023
15081,64,56,0,8.00,100.31,2875022,2875086
15082,73,35,0,7.01,51.90,2875086,2875159
15083,100,28,0,5.12,22.49,2875158,2875258
15084,88,34,0,5.82,32.06,2875257,2875345
15085,86,45,0,5.95,41.30,2875344,2875430
15086,62,37,1,8.26,62.00,2875429,2875491
15087,70,37,1,7.31,43.22,2875490,2875560
15088,69,28,0,7.42,29.87,2875560,2875629
15089,62,46,0,8.26,78.90,2875628,2875690
15090,61,24,1,8.39,27.75,2875689,2875750
15091,57,25,1,8.98,29.14,2875749,2875806
15092,69,38,1,7.42,35.11,2875805,2875874
15093,60,40,0,8.53,44.88,2875873,2875933
15094,43,39,1,11.91,76.64,2875932,2875975
15095,61,37,0,8.39,39.71,2875974,2876035
15096,52,96,1,9.85,172.01,2876034,2876086
15097,46,37,1,11.13,68.37,2876085,2876131
15098,57,25,3,8.98,19.00,2876131,2876188
15099,48,63,2,10.67,96.06,2876187,2876235
15100,68,26,1,7.53,24.34,2876234,2876302
15101,51,105,0,10.04,220.67,2876302,2876353
15102,65,33,1,7.88,39.71,2876352,2876417
15103,53,48,1,9.66,84.07,2876416,2876469
15104,64,34,0,8.00,53.28,2876468,2876532
15105,59,35,0,8.68,52.52,2876531,2876590
15106,71,39,0,7.21,37.88,2876589,2876660
15107,62,39,0,8.26,59.87,2876659,2876721
15108,100,27,0,5.12,30.67,2876720,2876820
15109,117,29,0,4.38,19.11,2876820,2876937
15110,60,76,0,8.53,113.62,2876936,2876996
15111,85,37,1,6.02,27.15,2876995,2877080
15112,95,36,0,5.39,23.88,2877079,2877174
15113,60,44,0,8.53,50.55,2877173,2877233
15114,66,26,1,7.76,28.40,2877233,2877299
15115,44,75,1,11.64,188.23,2877298,2877342
15116,50,40,1,10.24,69.42,2877341,2877391
15117,61,28,0,8.39,31.81,2877390,2877451
15118,69,31,1,7.42,35.08,2877450,2877519
15119,61,30,1,8.39,33.32,2877518,2877579
15120,69,24,1,7.42,21.17,2877578,2877647
15121,61,28,1,8.39,36.17,2877646,2877707
15122,62,30,0,8.26,34.87,2877706,2877768
15123,50,36,2,10.24,50.70,2877767,2877817
15124,65,23,1,7.88,24.32,2877817,2877882
15125,67,42,1,7.64,47.96,2877881,2877948
15126,72,21,0,7.11,22.60,2877947,2878019
15127,60,41,1,8.53,42.72,2878018,2878078
15128,69,38,0,7.42,39.78,2878077,2878146
15129,29,52,1,17.66,222.36,2878145,2878174
15130,60,56,0,8.53,77.55,2878173,2878233
15131,69,30,1,7.42,33.32,2878232,2878301
15132,47,39,1,10.89,70.56,2878300,2878347
15133,50,131,0,10.24,327.70,2878346,2878396
15134,69,31,0,7.42,37.14,2878395,2878464
15135,66,34,0,7.76,40.37,2878463,2878529
15136,78,33,0,6.56,33.94,2878528,2878606
15137,111,25,0,4.61,20.69,2878605,2878716
15138,98,36,0,5.22,42.87,2878716,2878814
15139,64,31,0,8.00,27.94,2878813,2878877
15140,69,36,1,7.42,46.59,2878876,2878945
15141,84,51,0,6.10,44.71,2878944,2879028
15142,70,52,2,7.31,53.42,2879027,2879097
15143,59,36,0,8.68,50.39,2879097,2879156
15144,66,20,0,7.76,23.73,2879155,2879221
15145,60,59,0,8.53,70.62,2879220,2879280
15146,56,45,1,9.14,53.05,2879279,2879335
15147,76,22,0,6.74,21.25,2879334,2879410
15148,66,24,1,7.76,18.15,2879409,2879475
15149,45,47,1,11.38,88.72,2879474,2879519
15150,64,23,2,8.00,22.44,2879518,2879582
15151,76,24,1,6.74,15.61,2879581,2879657
15152,51,49,1,10.04,67.29,2879656,2879707
15153,58,22,1,8.83,24.56,2879706,2879764
15154,59,32,2,8.68,46.46,2879763,2879822
15155,60,28,1,8.53,30.25,2879821,2879881
15156,73,33,1,7.01,33.93,2879880,2879953
15157,55,58,1,9.31,74.43,2879952,2880007
15158,72,23,1,7.11,24.96,2880006,2880078
15159,44,36,1,11.64,61.46,2880077,2880121
15160,82,27,0,6.24,21.55,2880120,2880202
15161,64,28,1,8.00,40.25,2880201,2880265
15162,69,41,0,7.42,56.79,2880264,2880333
15163,68,25,0,7.53,37.16,2880332,2880400
15164,81,27,0,6.32,26.42,2880400,2880481
15165,107,28,0,4.79,18.52,2880480,2880587
15166,98,17,0,5.22,17.26,2880586,2880684
15167,83,20,0,6.17,21.83,2880683,2880766
15168,80,23,1,6.40,18.96,2880765,2880845
15169,78,21,0,6.56,19.04,2880844,2880922
15170,61,66,1,8.39,81.32,2880921,2880982
15171,79,27,1,6.48,21.95,2880981,2881060
15172,60,41,0,8.53,63.22,2881059,2881119
15173,58,33,1,8.83,46.90,2881118,2881176
15174,60,29,0,8.53,36.12,2881175,2881235
15175,76,45,0,6.74,34.33,2881234,2881310
15176,57,33,2,8.98,36.33,2881309,2881366
15177,60,43,1,8.53,47.78,2881365,2881425
15178,55,54,1,9.31,83.38,2881424,2881479
15179,62,40,1,8.26,63.29,2881478,2881540
15180,52,29,2,9.85,40.71,2881539,2881591
15181,57,27,0,8.98,28.33,2881590,2881647
15182,56,33,1,9.14,37.30,2881646,2881702
15183,55,54,0,9.31,74.07,2881701,2881756
15184,71,22,1,7.21,21.15,2881755,2881826
15185,58,72,1,8.83,106.04,2881825,2881883
15186,59,46,1,8.68,57.10,2881883,2881942
15187,46,63,1,11.13,112.33,2881941,2881987
15188,71,56,0,7.21,58.79,2881986,2882057
15189,53,79,1,9.66,131.47,2882056,2882109
15190,58,37,0,8.83,58.73,2882108,2882166
15191,81,35,0,6.32,34.44,2882165,2882246
15192,59,52,1,8.68,78.46,2882245,2882304
15193,105,19,0,4.88,14.36,2882304,2882409
15194,93,66,0,5.51,72.96,2882409,2882502
15195,88,28,0,5.82,36.04,2882501,2882589
15196,96,35,0,5.33,26.72,2882588,2882684
15197,70,35,0,7.31,39.10,2882683,2882753
15198,88,31,0,5.82,21.31,2882752,2882840
15199,66,44,1,7.76,39.79,2882839,2882905
15200,77,52,1,6.65,45.16,2882904,2882981
15201,58,25,0,8.83,28.11,2882980,2883038
15202,69,23,0,7.42,25.14,2883037,2883106
15203,56,67,1,9.14,106.84,2883105,2883161
15204,65,33,1,7.88,23.55,2883160,2883225
15205,57,26,1,8.98,32.02,2883225,2883282
15206,49,28,3,10.45,41.68,2883281,2883330
15207,60,44,1,8.53,50.12,2883329,2883389
15208,53,37,2,9.66,42.41,2883388,2883441
15209,54,25,1,9.48,22.10,2883440,2883494
15210,53,31,0,9.66,43.28,2883493,2883546
15211,64,29,1,8.00,31.16,2883545,2883609
15212,64,39,0,8.00,44.50,2883608,2883672
15213,61,28,1,8.39,42.50,2883671,2883732
15214,71,30,0,7.21,27.41,2883731,2883802
15215,71,48,0,7.21,64.03,2883801,2883872
15216,71,30,0,7.21,38.73,2883871,2883942
15217,79,66,0,6.48,71.49,2883941,2884020
15218,100,30,0,5.12,22.75,2884020,2884120
15219,84,40,0,6.10,45.18,2884119,2884203
15220,81,33,0,6.32,26.98,2884202,2884283
15221,67,35,1,7.64,30.95,2884282,2884349
15222,85,22,0,6.02,25.79,2884348,2884433
15223,65,25,1,7.88,29.80,2884432,2884497
15224,84,32,0,6.10,23.66,2884496,2884580
15225,58,29,1,8.83,36.11,2884580,2884638
15226,63,27,1,8.13,29.03,2884637,2884700
15227,51,57,2,10.04,76.51,2884699,2884750
15228,67,40,1,7.64,38.11,2884749,2884816
15229,74,28,0,6.92,25.78,2884815,2884889
15230,62,26,0,8.26,30.00,2884888,2884950
15231,47,50,0,10.89,72.10,2884949,2884996
15232,61,51,0,8.39,51.75,2884995,2885056
15233,57,40,0,8.98,49.10,2885056,2885113
15234,37,43,4,13.84,100.24,2885112,2885149
15235,64,28,1,8.00,30.25,2885148,2885212
15236,65,24,0,7.88,30.54,2885211,2885276
15237,63,36,1,8.13,37.89,2885276,2885339
15238,73,23,0,7.01,16.81,2885338,2885411
15239,56,27,1,9.14,28.55,2885410,2885466
15240,66,53,0,7.76,51.97,2885465,2885531
15241,66,32,0,7.76,44.43,2885531,2885597
15242,58,36,0,8.83,48.80,2885596,2885654
15243,70,23,0,7.31,21.64,2885653,2885723
15244,62,30,0,8.26,51.03,2885722,2885784
15245,39,119,0,13.13,655.80,2885783,2885822
15246,76,37,0,6.74,49.54,2885821,2885897
15247,99,28,0,5.17,24.45,2885896,2885995
15248,66,60,1,7.76,101.94,2885994,2886060
15249,83,68,0,6.17,75.42,2886059,2886142
15250,83,30,0,6.17,25.78,2886141,2886224
15251,83,38,1,6.17,25.92,2886223,2886306
15252,82,24,1,6.24,18.21,2886305,2886387
15253,73,58,1,7.01,68.89,2886386,2886459
15254,57,49,1,8.98,62.93,2886458,2886515
15255,66,47,0,7.76,73.67,2886514,2886580
15256,55,38,1,9.31,58.76,2886579,2886634
15257,60,33,0,8.53,51.35,2886633,2886693
15258,69,22,0,7.42,24.19,2886692,2886761
15259,54,35,1,9.48,42.18,2886760,2886814
15260,52,50,1,9.85,85.75,2886813,2886865
15261,67,32,1,7.64,25.51,2886864,2886931
15262,54,35,1,9.48,37.95,2886930,2886984
15263,42,51,1,12.19,95.73,2886984,2887026
15264,58,21,1,8.83,21.11,2887025,2887083
15265,63,28,1,8.13,25.67,2887082,2887145
15266,55,43,2,9.31,52.76,2887144,2887199
15267,64,29,0,8.00,40.28,2887198,2887262
15268,61,41,1,8.39,42.34,2887261,2887322
15269,71,26,0,7.21,23.63,2887321,2887392
15270,42,49,3,12.19,76.44,2887391,2887433
15271,44,76,1,11.64,140.10,2887432,2887476
15272,57,33,0,8.98,42.16,2887475,2887532
15273,69,48,0,7.42,49.98,2887531,2887600
15274,65,32,1,7.88,42.66,2887599,2887664
15275,68,29,0,7.53,29.63,2887663,2887731
15276,49,119,1,10.45,340.33,2887730,2887779
15277,62,33,0,8.26,59.09,2887778,2887840
15278,88,30,0,5.82,31.97,2887839,2887927
15279,92,36,0,5.57,30.70,2887926,2888018
15280,100,31,0,5.12,24.17,2888017,2888117
15281,73,37,1,7.01,53.85,2888116,2888189
15282,79,17,1,6.48,15.59,2888188,2888267
15283,77,41,1,6.65,41.11,2888266,2888343
15284,68,24,1,7.53,24.48,2888342,2888410
15285,62,35,1,8.26,53.16,2888409,2888471
15286,79,37,1,6.48,31.67,2888470,2888549
15287,56,40,1,9.14,55.62,2888548,2888604
15288,53,52,1,9.66,64.90,2888603,2888656
15289,65,77,0,7.88,100.91,2888655,2888720
15290,58,31,1,8.83,33.32,2888719,2888777
15291,74,24,2,6.92,13.26,2888777,2888851
15292,49,43,2,10.45,85.06,2888850,2888899
15293,48,43,0,10.67,57.68,2888898,2888946
15294,68,26,1,7.53,26.54,2888946,2889014
15295,38,99,2,13.47,262.30,2889013,2889051
15296,57,39,2,8.98,54.54,2889050,2889107
15297,56,39,1,9.14,54.37,2889106,2889162
15298,62,25,1,8.26,19.90,2889161,2889223
15299,69,25,1,7.42,27.14,2889222,2889291
15300,54,32,1,9.48,40.14,2889290,2889344
15301,57,52,1,8.98,74.23,2889343,2889400
15302,40,36,0,12.80,67.86,2889399,2889439
15303,65,37,0,7.88,43.95,2889438,2889503
15304,69,23,0,7.42,21.90,2889503,2889572
15305,54,31,0,9.48,46.18,2889571,2889625
15306,54,66,0,9.48,163.21,2889624,2889678
15307,60,43,0,8.53,60.22,2889678,2889738
15308,66,66,0,7.76,95.64,2889737,2889803
15309,86,36,0,5.95,36.35,2889802,2889888
15310,98,21,0,5.22,20.64,2889887,2889985
15311,109,44,0,4.70,31.55,2889984,2890093
15312,75,41,0,6.83,31.98,2890092,2890167
15313,85,35,0,6.02,26.66,2890166,2890251
15314,85,20,0,6.02,18.73,2890250,2890335
15315,52,34,1,9.85,50.36,2890334,2890386
15316,84,25,0,6.10,22.32,2890385,2890469
15317,53,39,1,9.66,42.15,2890468,2890521
15318,51,68,1,10.04,96.31,2890520,2890571
15319,72,43,1,7.11,36.02,2890570,2890642
15320,70,26,1,7.31,29.07,2890641,2890711
15321,65,22,1,7.88,22.14,2890710,2890775
15322,56,28,2,9.14,31.55,2890774,2890830
15323,59,49,0,8.68,74.49,2890829,2890888
15324,51,50,1,10.04,80.63,2890887,2890938
15325,48,48,2,10.67,66.68,2890937,2890985
15326,40,46,2,12.80,111.56,2890984,2891024
15327,51,29,1,10.04,42.63,2891023,2891074
15328,62,51,1,8.26,63.16,2891073,2891135
15329,64,20,1,8.00,19.34,2891134,2891198
15330,66,35,1,7.76,31.82,2891197,2891263
15331,45,36,2,11.38,59.21,2891262,2891307
15332,53,37,2,9.66,54.30,2891307,2891360
15333,64,38,0,8.00,38.16,2891359,2891423
15334,57,76,1,8.98,154.33,2891422,2891479
15335,56,38,1,9.14,40.12,2891478,2891534
15336,55,62,1,9.31,102.03,2891533,2891588
15337,60,54,1,8.53,78.18,2891587,2891647
15338,56,112,0,9.14,228.69,2891646,2891702
15339,79,41,0,6.48,31.87,2891701,2891780
15340,69,49,0,7.42,71.08,2891779,2891848
15341,96,28,0,5.33,23.81,2891847,2891943
15342,95,24,0,5.39,24.89,2891942,2892037
15343,83,37,0,6.17,25.39,2892036,2892119
15344,76,66,0,6.74,64.01,2892118,2892194
15345,71,30,0,7.21,26.84,2892193,2892264
15346,76,22,0,6.74,24.35,2892263,2892339
15347,82,24,0,6.24,22.06,2892338,2892420
15348,70,27,0,7.31,32.50,2892420,2892490
15349,50,39,1,10.24,50.02,2892490,2892540
15350,59,30,1,8.68,36.08,2892539,2892598
15351,68,28,0,7.53,33.34,2892597,2892665
15352,69,24,1,7.42,24.59,2892665,2892734
15353,54,45,1,9.48,71.88,2892733,2892787
15354,55,47,1,9.31,52.76,2892786,2892841
15355,59,31,0,8.68,42.46,2892840,2892899
15356,51,40,2,10.04,55.88,2892898,2892949
15357,44,38,2,11.64,51.87,2892948,2892992
15358,59,28,2,8.68,38.08,2892991,2893050
15359,54,46,2,9.48,50.51,2893049,2893103
15360,56,42,0,9.14,48.12,2893102,2893158
15361,71,21,0,7.21,20.65,2893157,2893228
15362,65,35,0,7.88,33.40,2893227,2893292
15363,60,53,1,8.53,60.48,2893291,2893351
15364,52,70,0,9.85,117.28,2893350,2893402
15365,69,46,0,7.42,67.55,2893401,2893470
15366,49,59,0,10.45,126.25,2893469,2893518
15367,58,30,0,8.83,44.94,2893517,2893575
15368,62,38,0,8.26,54.55,2893574,2893636
15369,45,50,0,11.38,118.19,2893636,2893681
15370,86,35,0,5.95,27.93,2893680,2893766
15371,83,55,0,6.17,53.37,2893765,2893848
15372,78,43,0,6.56,64.02,2893847,2893925
15373,85,42,0,6.02,47.36,2893924,2894009
15374,67,23,1,7.64,29.60,2894008,2894075
15375,79,28,1,6.48,19.21,2894074,2894153
15376,78,42,0,6.56,36.27,2894152,2894230
15377,79,25,1,6.48,20.76,2894229,2894308
15378,78,22,1,6.56,16.02,2894307,2894385
15379,67,36,1,7.64,41.60,2894384,2894451
15380,55,40,1,9.31,48.61,2894450,2894505
15381,59,32,0,8.68,36.42,2894504,2894563
15382,54,100,1,9.48,174.92,2894562,2894616
15383,79,31,0,6.48,19.77,2894615,2894694
15384,61,32,0,8.39,30.50,2894694,2894755
15385,49,66,0,10.45,121.15,2894754,2894803
15386,63,34,1,8.13,40.94,2894802,2894865
15387,53,28,1,9.66,37.47,2894864,2894917
15388,56,31,1,9.14,46.84,2894916,2894972
15389,72,21,1,7.11,16.68,2894971,2895043
15390,63,37,1,8.13,43.13,2895042,2895105
15391,54,47,1,9.48,68.06,2895104,2895158
15392,55,38,1,9.31,52.47,2895158,2895213
15393,64,27,2,8.00,24.03,2895212,2895276
15394,59,31,1,8.68,35.13,2895275,2895334
15395,55,42,0,9.31,59.05,2895333,2895388
15396,57,45,1,8.98,61.91,2895388,2895445
15397,45,47,1,11.38,107.61,2895444,2895489
15398,57,42,0,8.98,50.40,2895488,2895545
15399,66,38,0,7.76,54.46,2895544,2895610
15400,88,28,0,5.82,30.13,2895609,2895697
15401,81,20,0,6.32,21.38,2895697,2895778
15402,128,39,0,4.00,20.81,2895777,2895905
15403,107,26,0,4.79,25.70,2895904,2896011
15404,73,26,1,7.01,24.62,2896010,2896083
15405,92,21,0,5.57,15.46,2896083,2896175
15406,95,23,0,5.39,17.29,2896174,2896269
15407,85,39,1,6.02,31.34,2896268,2896353
15408,60,35,1,8.53,42.28,2896352,2896412
15409,74,49,0,6.92,43.83,2896411,2896485
15410,63,25,0,8.13,26.52,2896484,2896547
15411,54,34,0,9.48,63.10,2896546,2896600
15412,75,21,1,6.83,17.32,2896599,2896674
15413,76,23,0,6.74,19.59,2896673,2896749
15414,50,99,2,10.24,185.54,2896748,2896798
15415,50,33,2,10.24,51.22,2896797,2896847
15416,60,52,1,8.53,56.88,2896847,2896907
15417,47,33,2,10.89,47.92,2896906,2896953
15418,45,61,1,11.38,88.86,2896952,2896997
15419,56,27,2,9.14,35.69,2896996,2897052
15420,64,47,0,8.00,49.84,2897051,2897115
15421,65,21,2,7.88,17.65,2897115,2897180
15422,64,22,1,8.00,27.53,2897179,2897243
15423,58,30,2,8.83,35.73,2897243,2897301
15424,49,32,0,10.45,53.84,2897300,2897349
15425,56,31,1,9.14,45.52,2897348,2897404
15426,78,23,0,6.56,23.99,2897403,2897481
15427,71,29,1,7.21,27.12,2897480,2897551
15428,56,37,0,9.14,58.23,2897550,2897606
15429,53,34,0,9.66,52.87,2897605,2897658
15430,60,48,0,8.53,96.32,2897657,2897717
15431,64,34,0,8.00,40.81,2897716,2897780
15432,88,29,0,5.82,30.63,2897780,2897868
15433,99,35,0,5.17,31.07,2897867,2897966
15434,102,19,0,5.02,20.00,2897965,2898067
15435,78,20,1,6.56,13.81,2898066,2898144
15436,65,41,0,7.88,60.94,2898143,2898208
15437,57,59,1,8.98,78.89,2898207,2898264
15438,58,95,1,8.83,162.94,2898263,2898321
15439,51,57,2,10.04,99.57,2898321,2898372
15440,60,31,0,8.53,41.75,2898371,2898431
15441,57,52,1,8.98,63.28,2898430,2898487
15442,55,41,1,9.31,55.09,2898486,2898541
15443,63,25,2,8.13,23.06,2898540,2898603
15444,66,23,1,7.76,21.67,2898602,2898668
15445,67,25,0,7.64,22.26,2898667,2898734
15446,54,30,0,9.48,45.21,2898734,2898788
15447,67,25,1,7.64,26.65,2898787,2898854
15448,58,52,0,8.83,75.76,2898853,2898911
15449,50,36,1,10.24,57.10,2898910,2898960
15450,62,49,2,8.26,52.45,2898959,2899021
15451,51,106,2,10.04,218.94,2899020,2899071
15452,61,33,1,8.39,44.76,2899070,2899131
15453,49,59,1,10.45,109.96,2899131,2899180
15454,62,33,1,8.26,36.16,2899179,2899241
15455,76,49,0,6.74,52.56,2899240,2899316
15456,71,38,0,7.21,42.03,2899315,2899386
15457,53,32,0,9.66,63.77,2899385,2899438
15458,71,44,0,7.21,60.98,2899437,2899508
15459,49,49,0,10.45,123.02,2899507,2899556
15460,73,61,1,7.01,76.86,2899555,2899628
15461,83,26,0,6.17,31.18,2899627,2899710
15462,87,75,0,5.89,82.54,2899709,2899796
15463,106,48,0,4.83,35.42,2899795,2899901
15464,83,23,1,6.17,18.43,2899900,2899983
15465,86,22,0,5.95,21.86,2899982,2900068
15466,60,84,1,8.53,143.62,2900067,2900127
15467,80,16,0,6.40,16.11,2900126,2900206
15468,62,49,1,8.26,57.61,2900205,2900267
15469,57,35,2,8.98,44.44,2900267,2900324
15470,79,29,0,6.48,23.72,2900323,2900402
15471,63,20,1,8.13,20.52,2900401,2900464
15472,50,75,2,10.24,118.02,2900464,2900514
15473,57,39,1,8.98,58.65,2900513,2900570
15474,69,26,1,7.42,21.14,2900569,2900638
15475,69,24,1,7.42,23.78,2900637,2900706
15476,43,53,1,11.91,122.50,2900705,2900748
15477,61,32,1,8.39,33.52,2900748,2900809
15478,42,54,3,12.19,92.11,2900808,2900850
15479,50,37,1,10.24,59.10,2900849,2900899
15480,68,17,1,7.53,13.98,2900898,2900966
15481,64,39,0,8.00,54.31,2900965,2901029
15482,55,86,0,9.31,144.47,2901028,2901083
15483,50,56,2,10.24,72.06,2901082,2901132
15484,66,21,1,7.76,24.15,2901131,2901197
15485,43,40,0,11.91,73.62,2901196,2901239
15486,67,39,0,7.64,50.56,2901239,2901306
15487,65,25,0,7.88,27.18,2901305,2901370
15488,61,54,0,8.39,64.17,2901369,2901430
15489,79,30,0,6.48,29.87,2901429,2901508
15490,53,54,0,9.66,126.49,2901507,2901560
15491,63,39,0,8.13,48.49,2901559,2901622
15492,82,38,0,6.24,48.65,2901621,2901703
15493,86,24,0,5.95,35.84,2901702,2901788
15494,116,23,0,4.41,14.09,2901788,2901904
15495,73,44,1,7.01,36.95,2901903,2901976
15496,80,31,0,6.40,28.91,2901975,2902055
15497,68,53,0,7.53,53.51,2902054,2902122
15498,73,16,0,7.01,18.26,2902121,2902194
15499,69,48,0,7.42,51.32,2902193,2902262
15500,53,62,1,9.66,119.73,2902261,2902314
15501,69,30,0,7.42,31.40,2902313,2902382
15502,45,37,1,11.38,60.86,2902381,2902426
15503,53,90,1,9.66,235.36,2902425,2902478
15504,53,97,1,9.66,184.34,2902477,2902530
15505,62,61,0,8.26,78.93,2902529,2902591
15506,61,34,0,8.39,41.26,2902590,2902651
15507,66,20,2,7.76,21.76,2902650,2902716
15508,53,42,1,9.66,70.22,2902715,2902768
15509,61,48,0,8.39,58.27,2902767,2902828
15510,55,43,1,9.31,63.23,2902827,2902882
15511,45,54,3,11.38,76.28,2902881,2902926
15512,56,25,0,9.14,34.80,2902925,2902981
15513,72,20,1,7.11,21.68,2902980,2903052
15514,65,31,1,7.88,32.97,2903051,2903116
15515,54,47,1,9.48,59.77,2903115,2903169
15516,72,31,0,7.11,33.24,2903168,2903240
15517,49,45,1,10.45,80.66,2903239,2903288
15518,59,27,1,8.68,50.86,2903287,2903346
15519,55,49,0,9.31,84.65,2903345,2903400
15520,57,28,1,8.98,44.68,2903399,2903456
15521,53,30,1,9.66,61.81,2903455,2903508
15522,52,52,0,9.85,82.63,2903507,2903559
15523,59,70,0,8.68,105.34,2903558,2903617
15524,65,36,0,7.88,54.02,2903616,2903681
15525,77,36,0,6.65,31.89,2903680,2903757
15526,97,41,0,5.28,37.58,2903756,2903853
15527,80,29,1,6.40,31.37,2903852,2903932
15528,83,35,0,6.17,26.00,2903931,2904014
15529,74,30,1,6.92,30.45,2904013,2904087
15530,74,36,1,6.92,39.16,2904087,2904161
15531,71,53,0,7.21,61.88,2904160,2904231
15532,75,19,1,6.83,15.80,2904230,2904305
15533,60,32,2,8.53,33.42,2904304,2904364
15534,52,38,0,9.85,61.75,2904363,2904415
15535,62,42,0,8.26,34.13,2904414,2904476
15536,72,29,0,7.11,27.07,2904475,2904547
15537,65,40,0,7.88,40.88,2904546,2904611
15538,62,32,0,8.26,37.06,2904610,2904672
15539,59,30,1,8.68,35.44,2904671,2904730
15540,52,24,2,9.85,26.82,2904729,2904781
15541,52,27,1,9.85,42.01,2904781,2904833
15542,59,45,1,8.68,53.44,2904832,2904891
15543,63,30,2,8.13,28.84,2904891,2904954
15544,66,24,0,7.76,28.64,2904954,2905020
15545,65,24,1,7.88,27.43,2905019,2905084
15546,64,28,1,8.00,29.16,2905083,2905147
15547,43,36,1,11.91,81.06,2905146,2905189
15548,57,53,1,8.98,68.26,2905188,2905245
15549,56,42,1,9.14,85.59,2905244,2905300
15550,60,34,0,8.53,53.75,2905300,2905360
15551,58,48,0,8.83,69.25,2905359,2905417
15552,81,33,0,6.32,31.01,2905416,2905497
15553,63,26,0,8.13,38.90,2905496,2905559
15554,103,34,0,4.97,28.09,2905558,2905661
15555,89,29,0,5.75,33.51,2905660,2905749
15556,122,32,0,4.20,23.70,2905748,2905870
15557,69,46,1,7.42,56.85,2905869,2905938
15558,73,36,0,7.01,31.38,2905938,2906011
15559,76,52,1,6.74,62.83,2906010,2906086
15560,81,50,1,6.32,36.86,2906085,2906166
15561,74,26,1,6.92,22.53,2906165,2906239
15562,68,27,0,7.53,23.07,2906238,2906306
15563,52,59,1,9.85,92.01,2906305,2906357
15564,62,25,0,8.26,25.39,2906356,2906418
15565,59,45,0,8.68,40.66,2906417,2906476
15566,58,55,1,8.83,71.14,2906475,2906533
15567,66,33,1,7.76,39.21,2906533,2906599
15568,59,39,0,8.68,46.46,2906598,2906657
15569,56,30,1,9.14,35.34,2906656,2906712
15570,60,41,0,8.53,42.92,2906711,2906771
15571,45,56,3,11.38,83.21,2906770,2906815
15572,45,39,1,11.38,57.21,2906814,2906859
15573,56,43,2,9.14,50.69,2906858,2906914
15574,64,29,0,8.00,30.47,2906913,2906977
15575,60,35,1,8.53,49.05,2906976,2907036
15576,61,34,0,8.39,37.35,2907035,2907096
15577,57,44,0,8.98,63.35,2907095,2907152
15578,62,56,0,8.26,78.03,2907151,2907213
15579,59,36,0,8.68,69.20,2907212,2907271
15580,75,39,0,6.83,39.26,2907270,2907345
15581,57,39,0,8.98,71.56,2907344,2907401
15582,89,41,0,5.75,57.26,2907401,2907490
15583,76,35,0,6.74,39.77,2907489,2907565
15584,106,43,0,4.83,32.24,2907564,2907670
15585,74,27,0,6.92,17.29,2907670,2907744
15586,69,34,0,7.42,33.20,2907743,2907812
15587,92,25,1,5.57,19.92,2907811,2907903
15588,72,41,0,7.11,51.07,2907902,2907974
15589,66,86,1,7.76,114.09,2907973,2908039
15590,68,29,1,7.53,29.07,2908038,2908106
15591,80,27,1,6.40,21.54,2908106,2908186
15592,72,29,1,7.11,26.90,2908186,2908258
15593,68,23,1,7.53,24.51,2908257,2908325
15594,67,18,0,7.64,19.81,2908324,2908391
15595,69,21,0,7.42,18.21,2908390,2908459
15596,58,31,0,8.83,40.90,2908458,2908516
15597,59,50,1,8.68,57.20,2908515,2908574
15598,58,29,0,8.83,41.87,2908573,2908631
15599,63,33,0,8.13,37.86,2908630,2908693
15600,51,31,2,10.04,43.65,2908693,2908744
15601,51,49,1,10.04,67.06,2908743,2908794
15602,62,24,2,8.26,29.90,2908794,2908856
15603,53,50,0,9.66,76.94,2908855,2908908
15604,46,45,1,11.13,112.59,2908907,2908953
15605,63,21,2,8.13,20.36,2908952,2909015
15606,75,21,1,6.83,18.20,2909014,2909089
15607,45,58,2,11.38,105.84,2909088,2909133
15608,76,73,0,6.74,85.64,2909132,2909208
15609,48,81,1,10.67,141.89,2909207,2909255
15610,49,65,1,10.45,125.51,2909254,2909303
15611,57,39,0,8.98,72.89,2909302,2909359
15612,71,102,0,7.21,149.72,2909358,2909429
15613,99,41,0,5.17,27.23,2909429,2909528
15614,68,44,0,7.53,64.40,2909527,2909595
15615,71,25,0,7.21,31.18,2909594,2909665
15616,64,58,0,8.00,79.78,2909664,2909728
15617,79,20,1,6.48,17.82,2909727,2909806
15618,81,18,1,6.32,19.11,2909805,2909886
15619,76,24,0,6.74,23.88,2909885,2909961
15620,84,23,0,6.10,19.92,2909960,2910044
15621,57,25,2,8.98,28.44,2910043,2910100
15622,84,28,1,6.10,19.92,2910099,2910183
15623,67,27,0,7.64,32.68,2910182,2910249
15624,52,30,0,9.85,45.90,2910248,2910300
15625,63,23,1,8.13,24.56,2910299,2910362
15626,55,23,2,9.31,34.25,2910361,2910416
15627,62,21,0,8.26,23.13,2910416,2910478
15628,50,32,1,10.24,56.82,2910477,2910527
15629,50,44,1,10.24,59.46,2910526,2910576
15630,54,35,1,9.48,43.69,2910575,2910629
15631,64,23,1,8.00,21.62,2910628,2910692
15632,55,46,0,9.31,73.09,2910691,2910746
15633,48,50,1,10.67,87.56,2910745,2910793
15634,57,33,0,8.98,44.75,2910792,2910849
15635,46,77,1,11.13,150.37,2910848,2910894
15636,57,37,1,8.98,45.95,2910893,2910950
15637,65,49,0,7.88,71.18,2910949,2911014
15638,63,23,0,8.13,34.17,2911013,2911076
15639,62,28,1,8.26,41.87,2911075,2911137
15640,73,55,0,7.01,62.31,2911136,2911209
15641,95,30,0,5.39,25.75,2911209,2911304
15642,75,30,0,6.83,43.77,2911303,2911378
15643,68,68,1,7.53,93.37,2911377,2911445
15644,66,39,0,7.76,42.79,2911444,2911510
15645,62,29,0,8.26,49.35,2911509,2911571
15646,80,33,1,6.40,26.61,2911570,2911650
15647,73,21,1,7.01,21.44,2911650,2911723
15648,66,30,1,7.76,31.79,2911722,2911788
15649,63,71,1,8.13,118.52,2911787,2911850
15650,47,31,1,10.89,47.37,2911849,2911896
15651,59,23,1,8.68,34.25,2911895,2911954
15652,52,30,1,9.85,36.63,2911953,2912005
15653,74,18,1,6.92,21.26,2912004,2912078
15654,54,36,1,9.48,61.58,2912077,2912131
15655,59,26,0,8.68,25.54,2912130,2912189
15656,60,35,1,8.53,34.52,2912188,2912248
15657,37,67,1,13.84,249.38,2912247,2912284
15658,48,26,3,10.67,27.47,2912283,2912331
15659,65,32,1,7.88,29.55,2912330,2912395
15660,52,53,1,9.85,88.17,2912394,2912446
15661,69,26,1,7.42,31.43,2912445,2912514
15662,67,24,1,7.64,23.19,2912513,2912580
15663,60,38,1,8.53,36.72,2912579,2912639
15664,48,60,1,10.67,131.85,2912638,2912686
15665,68,41,0,7.53,45.78,2912685,2912753
15666,63,46,0,8.13,53.83,2912752,2912815
15667,55,63,0,9.31,98.80,2912814,2912869
15668,51,105,0,10.04,253.76,2912868,2912919
15669,66,36,0,7.76,56.58,2912918,2912984
15670,126,17,0,4.06,12.00,2912983,2913109
15671,109,19,0,4.70,20.50,2913108,2913217
15672,58,74,0,8.83,120.11,2913216,2913274
15673,71,32,1,7.21,27.94,2913273,2913344
15674,83,67,1,6.17,58.43,2913343,2913426
15675,78,30,1,6.56,29.63,2913425,2913503
15676,72,23,0,7.11,21.82,2913502,2913574
15677,85,21,0,6.02,17.81,2913573,2913658
15678,69,25,0,7.42,34.07,2913657,2913726
15679,68,22,1,7.53,21.13,2913726,2913794
15680,46,60,0,11.13,165.11,2913794,2913840
15681,54,48,0,9.48,85.36,2913839,2913893
15682,41,54,0,12.49,178.15,2913892,2913933
15683,51,29,2,10.04,41.49,2913932,2913983
15684,71,22,0,7.21,21.15,2913982,2914053
15685,67,28,0,7.64,25.39,2914052,2914119
15686,54,66,0,9.48,102.84,2914118,2914172
15687,61,40,0,8.39,43.58,2914172,2914233
15688,43,39,4,11.91,51.15,2914232,2914275
15689,53,32,1,9.66,46.94,2914275,2914328
15690,60,45,1,8.53,45.22,2914327,2914387
15691,49,87,3,10.45,156.00,2914386,2914435
15692,65,48,0,7.88,49.49,2914434,2914499
15693,60,41,0,8.53,40.45,2914498,2914558
15694,60,37,1,8.53,48.02,2914557,2914617
15695,48,51,1,10.67,98.31,2914616,2914664
15696,83,26,0,6.17,26.41,2914664,2914747
15697,62,24,0,8.26,41.22,2914746,2914808
15698,70,40,0,7.31,52.96,2914807,2914877
15699,56,39,1,9.14,56.37,2914876,2914932
15700,83,28,0,6.17,34.14,2914932,2915015
15701,101,19,0,5.07,19.43,2915014,2915115
15702,107,18,0,4.79,13.20,2915114,2915221
15703,63,35,0,8.13,39.67,2915220,2915283
15704,72,50,0,7.11,50.88,2915282,2915354
15705,82,46,1,6.24,41.28,2915353,2915435
15706,66,37,1,7.76,44.24,2915435,2915501
15707,74,70,0,6.92,73.34,2915501,2915575
15708,70,33,1,7.31,43.27,2915575,2915645
15709,71,48,1,7.21,49.91,2915644,2915715
15710,65,40,1,7.88,45.62,2915714,2915779
15711,59,34,1,8.68,45.98,2915778,2915837
15712,63,26,0,8.13,26.52,2915836,2915899
15713,53,60,0,9.66,97.96,2915898,2915951
15714,67,34,1,7.64,26.92,2915950,2916017
15715,59,74,1,8.68,101.30,2916016,2916075
15716,55,24,1,9.31,23.70,2916074,2916129
15717,53,37,0,9.66,48.34,2916129,2916182
15718,49,67,2,10.45,107.35,2916181,2916230
15719,58,26,1,8.83,34.42,2916229,2916287
15720,59,43,0,8.68,47.64,2916286,2916345
15721,63,35,2,8.13,37.13,2916344,2916407
15722,68,29,0,7.53,38.34,2916406,2916474
15723,59,33,0,8.68,45.68,2916473,2916532
15724,64,50,0,8.00,50.94,2916531,2916595
15725,53,44,0,9.66,66.94,2916594,2916647
15726,76,29,0,6.74,30.75,2916646,2916722
15727,52,45,1,9.85,59.67,2916721,2916773
15728,72,41,0,7.11,47.90,2916772,2916844
15729,68,57,1,7.53,59.63,2916843,2916911
15730,84,47,0,6.10,39.23,2916910,2916994
15731,104,42,0,4.92,38.69,2916993,2917097
15732,98,36,0,5.22,30.26,2917096,2917194
15733,76,40,1,6.74,27.19,2917193,2917269
15734,72,38,0,7.11,45.29,2917268,2917340
15735,72,32,0,7.11,27.82,2917339,2917411
15736,64,33,1,8.00,37.81,2917410,2917474
15737,66,31,1,7.76,30.46,2917473,2917539
15738,65,42,0,7.88,51.52,2917538,2917603
15739,70,80,0,7.31,129.42,2917603,2917673
15740,63,91,0,8.13,148.81,2917672,2917735
15741,49,27,2,10.45,39.23,2917734,2917783
15742,63,50,2,8.13,42.46,2917782,2917845
15743,46,72,1,11.13,151.16,2917844,2917890
15744,61,27,0,8.39,33.85,2917890,2917951
15745,56,24,0,9.14,29.44,2917950,2918006
15746,60,23,1,8.53,26.75,2918005,2918065
15747,43,54,1,11.91,129.81,2918064,2918107
15748,67,26,0,7.64,23.10,2918106,2918173
15749,40,45,3,12.80,119.41,2918172,2918212
15750,56,58,1,9.14,64.62,2918211,2918267
15751,54,22,1,9.48,27.73,2918266,2918320
15752,64,31,1,8.00,28.16,2918319,2918383
15753,66,40,0,7.76,35.64,2918382,2918448
15754,63,26,2,8.13,28.36,2918447,2918510
15755,64,21,3,8.00,23.31,2918509,2918573
15756,58,35,0,8.83,50.63,2918572,2918630
15757,49,105,0,10.45,342.49,2918629,2918678
15758,56,39,0,9.14,57.80,2918677,2918733
15759,67,34,0,7.64,42.80,2918732,2918799
15760,69,30,0,7.42,31.75,2918798,2918867
15761,102,27,0,5.02,18.61,2918866,2918968
15762,81,58,0,6.32,67.21,2918967,2919048
15763,104,33,0,4.92,28.92,2919047,2919151
15764,69,30,1,7.42,36.59,2919150,2919219
15765,71,26,1,7.21,32.03,2919218,2919289
15766,87,22,0,5.89,19.99,2919288,2919375
15767,64,78,0,8.00,97.16,2919374,2919438
15768,70,28,1,7.31,33.93,2919437,2919507
15769,78,24,0,6.56,24.60,2919507,2919585
15770,73,32,0,7.01,32.45,2919584,2919657
15771,69,33,0,7.42,34.59,2919656,2919725
15772,53,32,0,9.66,54.00,2919724,2919777
15773,55,55,0,9.31,84.54,2919776,2919831
15774,69,31,1,7.42,29.03,2919830,2919899
15775,65,40,1,7.88,41.37,2919898,2919963
15776,66,22,0,7.76,27.46,2919962,2920028
15777,51,31,1,10.04,40.35,2920027,2920078
15778,50,52,1,10.24,75.30,2920077,2920127
15779,62,25,1,8.26,32.61,2920126,2920188
15780,53,33,1,9.66,54.71,2920187,2920240
15781,67,28,0,7.64,29.81,2920240,2920307
15782,49,69,1,10.45,121.51,2920306,2920355
15783,75,17,1,6.83,18.33,2920354,2920429
15784,40,70,1,12.80,208.46,2920429,2920469
15785,65,22,1,7.88,21.15,2920468,2920533
15786,71,29,0,7.21,33.83,2920532,2920603
15787,87,30,0,5.89,25.14,2920602,2920689
15788,64,47,0,8.00,52.25,2920689,2920753
15789,73,25,0,7.01,35.60,2920752,2920825
15790,87,44,0,5.89,41.48,2920824,2920911
15791,87,29,0,5.89,33.87,2920910,2920997
15792,101,22,0,5.07,23.00,2920996,2921097
15793,68,24,0,7.53,29.57,2921096,2921164
15794,68,43,1,7.53,43.28,2921163,2921231
15795,72,28,1,7.11,27.04,2921230,2921302
15796,75,40,1,6.83,37.42,2921301,2921376
15797,81,22,1,6.32,17.03,2921375,2921456
15798,72,38,0,7.11,37.63,2921456,2921528
15799,55,51,0,9.31,73.20,2921527,2921582
15800,69,38,0,7.42,46.10,2921582,2921651
15801,53,49,1,9.66,60.41,2921650,2921703
15802,61,20,1,8.39,22.53,2921702,2921763
15803,63,33,1,8.13,34.62,2921762,2921825
15804,62,24,1,8.26,22.03,2921824,2921886
15805,63,48,0,8.13,52.43,2921885,2921948
15806,42,99,2,12.19,217.68,2921947,2921989
15807,53,37,1,9.66,59.81,2921988,2922041
15808,58,27,2,8.83,31.52,2922041,2922099
15809,52,39,0,9.85,50.86,2922098,2922150
15810,54,28,0,9.48,30.25,2922150,2922204
15811,53,41,0,9.66,59.77,2922203,2922256
15812,62,37,1,8.26,38.80,2922255,2922317
15813,55,58,1,9.31,87.20,2922317,2922372
15814,69,34,0,7.42,44.21,2922371,2922440
15815,52,43,2,9.85,50.90,2922439,2922491
15816,52,46,1,9.85,95.36,2922490,2922542
15817,50,63,0,10.24,115.62,2922541,2922591
15818,58,62,0,8.83,96.07,2922590,2922648
15819,76,25,0,6.74,28.67,2922647,2922723
15820,89,19,0,5.75,23.38,2922723,2922812
15821,69,52,0,7.42,45.37,2922811,2922880
15822,80,19,0,6.40,19.47,2922879,2922959
15823,63,35,0,8.13,38.17,2922958,2923021
15824,79,25,0,6.48,27.31,2923020,2923099
15825,59,56,1,8.68,69.71,2923098,2923157
15826,74,31,1,6.92,26.75,2923156,2923230
15827,68,48,1,7.53,48.78,2923229,2923297
15828,57,30,1,8.98,33.74,2923296,2923353
15829,55,53,0,9.31,60.76,2923352,2923407
15830,49,51,1,10.45,87.88,2923406,2923455
15831,61,39,1,8.39,54.50,2923454,2923515
15832,71,35,0,7.21,23.43,2923514,2923585
15833,54,40,0,9.48,69.18,2923584,2923638
15834,50,41,1,10.24,75.74,2923638,2923688
15835,54,29,1,9.48,39.25,2923687,2923741
15836,60,30,1,8.53,30.25,2923740,2923800
15837,60,42,1,8.53,44.18,2923799,2923859
15838,58,34,0,8.83,52.87,2923858,2923916
15839,64,22,3,8.00,14.41,2923915,2923979
15840,51,161,0,10.04,496.08,2923978,2924029
15841,46,36,0,11.13,74.98,2924029,2924075
15842,37,58,0,13.84,121.54,2924074,2924111
15843,59,49,1,8.68,74.29,2924110,2924169
15844,68,25,0,7.53,38.81,2924168,2924236
15845,49,38,1,10.45,67.76,2924235,2924284
15846,66,46,0,7.76,52.24,2924284,2924350
15847,68,22,0,7.53,34.93,2924349,2924417
15848,99,25,0,5.17,22.63,2924416,2924515
15849,90,58,0,5.69,55.08,2924514,2924604
15850,101,44,0,5.07,38.56,2924603,2924704
15851,77,29,1,6.65,40.49,2924703,2924780
15852,70,24,1,7.31,24.44,2924779,2924849
15853,72,25,1,7.11,27.27,2924848,2924920
15854,76,48,0,6.74,37.06,2924919,2924995
15855,70,35,1,7.31,39.16,2924994,2925064
15856,69,34,0,7.42,43.81,2925063,2925132
15857,74,23,1,6.92,22.51,2925131,2925205
15858,75,27,1,6.83,20.52,2925204,2925279
15859,46,37,0,11.13,66.29,2925278,2925324
15860,59,50,1,8.68,84.32,2925323,2925382
15861,60,26,2,8.53,24.98,2925381,2925441
15862,58,30,1,8.83,42.69,2925440,2925498
15863,63,25,1,8.13,26.56,2925497,2925560
15864,51,50,0,10.04,81.88,2925559,2925610
15865,51,45,0,10.04,66.86,2925609,2925660
15866,60,34,1,8.53,36.38,2925659,2925719
15867,45,27,2,11.38,34.81,2925718,2925763
15868,51,30,0,10.04,44.00,2925762,2925813
15869,69,33,1,7.42,32.48,2925812,2925881
15870,57,47,0,8.98,51.84,2925880,2925937
15871,66,26,1,7.76,30.46,2925936,2926002
15872,57,37,1,8.98,64.44,2926001,2926058
15873,34,161,0,15.06,713.47,2926057,2926091
15874,55,26,0,9.31,44.03,2926090,2926145
15875,66,31,1,7.76,31.64,2926144,2926210
15876,50,49,1,10.24,124.86,2926209,2926259
15877,59,57,0,8.68,76.15,2926258,2926317
15878,56,44,0,9.14,77.02,2926316,2926372
15879,116,17,0,4.41,16.93,2926372,2926488
15880,78,25,1,6.56,30.78,2926488,2926566
15881,91,20,0,5.63,21.60,2926565,2926656
15882,66,44,0,7.76,50.55,2926656,2926722
15883,89,20,0,5.75,10.23,2926721,2926810
15884,90,23,0,5.69,20.55,2926809,2926899
15885,72,38,0,7.11,29.15,2926898,2926970
15886,72,39,0,7.11,36.13,2926969,2927041
15887,84,45,0,6.10,32.32,2927040,2927124
15888,72,68,1,7.11,69.15,2927123,2927195
15889,61,35,0,8.39,43.42,2927194,2927255
15890,52,34,1,9.85,53.98,2927255,2927307
15891,65,28,1,7.88,24.54,2927306,2927371
15892,64,24,0,8.00,32.19,2927370,2927434
15893,65,38,0,7.88,33.22,2927434,2927499
15894,61,28,1,8.39,29.88,2927498,2927559
15895,66,44,0,7.76,37.73,2927559,2927625
15896,57,61,1,8.98,73.42,2927625,2927682
15897,40,56,1,12.80,111.21,2927681,2927721
15898,58,28,1,8.83,28.52,2927720,2927778
15899,68,23,2,7.53,17.34,2927777,2927845
15900,79,18,1,6.48,18.17,2927844,2927923
15901,55,36,2,9.31,48.72,2927922,2927977
15902,61,90,0,8.39,129.45,2927976,2928037
15903,57,53,1,8.98,68.44,2928036,2928093
15904,67,27,0,7.64,35.69,2928092,2928159
15905,53,28,1,9.66,47.17,2928159,2928212
15906,56,38,1,9.14,52.66,2928211,2928267
15907,65,26,1,7.88,46.51,2928266,2928331
15908,39,119,1,13.13,434.27,2928330,2928369
15909,62,52,0,8.26,68.03,2928368,2928430
15910,71,31,0,7.21,43.80,2928429,2928500
15911,91,28,0,5.63,31.18,2928499,2928590
15912,66,44,0,7.76,81.30,2928589,2928655
15913,77,43,0,6.65,41.79,2928654,2928731
15914,61,23,1,8.39,23.94,2928730,2928791
15915,75,34,0,6.83,36.28,2928790,2928865
15916,70,34,0,7.31,36.87,2928864,2928934
15917,76,25,1,6.74,16.35,2928933,2929009
15918,82,25,0,6.24,27.31,2929009,2929091
15919,76,26,0,6.74,21.96,2929090,2929166
15920,75,25,0,6.83,20.94,2929165,2929240
15921,48,51,2,10.67,98.68,2929239,2929287
15922,57,26,1,8.98,23.39,2929286,2929343
15923,71,30,1,7.21,26.65,2929342,2929413
15924,61,26,1,8.39,38.21,2929412,2929473
15925,49,43,1,10.45,66.04,2929472,2929521
15926,43,75,1,11.91,208.60,2929520,2929563
15927,63,32,1,8.13,30.52,2929562,2929625
15928,52,50,1,9.85,64.51,2929624,2929676
15929,53,33,2,9.66,45.02,2929675,2929728
15930,60,22,2,8.53,23.02,2929727,2929787
15931,71,31,1,7.21,28.14,2929786,2929857
15932,58,46,1,8.83,42.97,2929856,2929914
15933,57,36,1,8.98,43.95,2929913,2929970
15934,59,25,0,8.68,29.00,2929969,2930028
15935,47,51,1,10.89,92.52,2930027,2930074
15936,81,16,0,6.32,12.51,2930073,2930154
15937,40,61,1,12.80,122.96,2930153,2930193
15938,57,37,1,8.98,60.51,2930193,2930250
15939,59,43,0,8.68,68.49,2930249,2930308
15940,61,36,0,8.39,41.26,2930307,2930368
15941,89,32,0,5.75,26.95,2930367,2930456
15942,94,21,1,5.45,18.29,2930455,2930549
15943,84,49,0,6.10,58.13,2930548,2930632
15944,67,23,1,7.64,34.44,2930631,2930698
15945,73,24,0,7.01,25.30,2930697,2930770
15946,60,29,1,8.53,42.18,2930769,2930829
15947,81,23,1,6.32,20.96,2930828,2930909
15948,60,60,1,8.53,76.85,2930908,2930968
15949,74,53,0,6.92,47.91,2930967,2931041
15950,63,31,1,8.13,41.60,2931040,2931103
15951,55,34,0,9.31,57.23,2931103,2931158
15952,53,43,0,9.66,59.85,2931157,2931210
15953,60,47,0,8.53,73.45,2931209,2931269
15954,49,56,1,10.45,85.55,2931268,2931317
15955,50,43,2,10.24,61.42,2931316,2931366
15956,65,25,0,7.88,34.78,2931365,2931430
15957,61,41,1,8.39,46.80,2931429,2931490
15958,67,27,0,7.64,28.74,2931489,2931556
15959,49,51,1,10.45,111.02,2931556,2931605
15960,47,33,1,10.89,67.12,2931604,2931651
15961,57,49,1,8.98,73.18,2931650,2931707
15962,47,47,3,10.89,75.03,2931706,2931753
15963,52,40,3,9.85,47.36,2931752,2931804
15964,59,32,1,8.68,43.74,2931803,2931862
15965,52,29,2,9.85,38.09,2931861,2931913
15966,62,39,1,8.26,41.87,2931912,2931974
15967,64,23,1,8.00,25.50,2931974,2932038
15968,57,85,0,8.98,162.54,2932037,2932094
15969,64,37,1,8.00,44.38,2932093,2932157
15970,42,79,0,12.19,199.11,2932156,2932198
15971,72,29,0,7.11,38.13,2932197,2932269
15972,57,40,1,8.98,65.53,2932268,2932325
15973,74,34,0,6.92,53.80,2932324,2932398
15974,110,26,0,4.65,14.79,2932397,2932507
15975,91,27,0,5.63,33.64,2932506,2932597
15976,55,51,1,9.31,72.76,2932596,2932651
15977,69,30,1,7.42,48.42,2932650,2932719
15978,77,26,1,6.65,28.05,2932718,2932795
15979,81,34,0,6.32,31.67,2932794,2932875
15980,67,69,0,7.64,86.08,2932874,2932941
15981,67,30,1,7.64,38.68,2932941,2933008
15982,85,29,1,6.02,24.92,2933007,2933092
15983,80,31,0,6.40,29.06,2933091,2933171
15984,60,38,2,8.53,36.15,2933170,2933230
15985,60,27,1,8.53,35.12,2933229,2933289
15986,70,36,0,7.31,31.87,2933288,2933358
15987,64,16,1,8.00,16.97,2933357,2933421
15988,66,23,0,7.76,20.91,2933420,2933486
15989,50,62,2,10.24,83.66,2933486,2933536
15990,44,45,1,11.64,65.19,2933535,2933579
15991,58,28,1,8.83,27.90,2933578,2933636
15992,52,46,1,9.85,76.59,2933635,2933687
15993,54,59,1,9.48,82.95,2933686,2933740
15994,59,28,1,8.68,27.20,2933740,2933799
15995,56,31,1,9.14,30.59,2933798,2933854
15996,63,42,2,8.13,60.43,2933854,2933917
15997,70,56,1,7.31,60.36,2933916,2933986
15998,70,42,0,7.31,44.76,2933985,2934055
15999,48,43,1,10.67,64.56,2934055,2934103
16000,57,32,1,8.98,47.53,2934102,2934159
16001,59,68,0,8.68,99.24,2934158,2934217
16002,80,33,0,6.40,35.61,2934216,2934296
16003,81,30,0,6.32,38.12,2934295,2934376
16004,92,26,0,5.57,20.68,2934375,2934467
16005,75,31,0,6.83,38.12,2934466,2934541
16006,64,35,0,8.00,48.84,2934540,2934604
16007,70,24,0,7.31,27.16,2934603,2934673
16008,74,50,0,6.92,43.10,2934672,2934746
16009,78,24,0,6.56,21.32,2934745,2934823
16010,85,26,0,6.02,20.07,2934823,2934908
16011,86,27,1,5.95,19.04,2934907,2934993
16012,60,87,0,8.53,130.78,2934992,2935052
16013,28,107,2,18.29,628.13,2935051,2935079
16014,47,46,2,10.89,69.12,2935078,2935125
16015,49,71,1,10.45,116.25,2935124,2935173
16016,55,29,1,9.31,36.83,2935172,2935227
16017,69,28,1,7.42,30.45,2935226,2935295
16018,56,45,1,9.14,56.16,2935294,2935350
16019,55,23,1,9.31,32.29,2935349,2935404
16020,62,32,0,8.26,43.03,2935403,2935465
16021,53,30,1,9.66,39.66,2935464,2935517
16022,46,24,1,11.13,30.29,2935516,2935562
16023,65,22,0,7.88,17.95,2935562,2935627
16024,58,30,1,8.83,51.63,2935626,2935684
16025,55,57,1,9.31,75.38,2935683,2935738
16026,53,27,0,9.66,42.98,2935737,2935790
16027,37,48,2,13.84,125.05,2935789,2935826
16028,51,33,1,10.04,58.00,2935826,2935877
16029,42,62,0,12.19,109.54,2935876,2935918
16030,77,24,0,6.65,23.06,2935918,2935995
16031,55,29,0,9.31,50.00,2935995,2936050
16032,67,22,1,7.64,28.86,2936049,2936116
16033,65,27,0,7.88,42.26,2936115,2936180
16034,85,31,0,6.02,33.93,2936179,2936264
16035,90,29,0,5.69,31.70,2936263,2936353
16036,70,43,0,7.31,62.13,2936352,2936422
16037,67,39,1,7.64,46.80,2936422,2936489
16038,70,53,0,7.31,51.22,2936489,2936559
16039,71,49,1,7.21,64.14,2936558,2936629
16040,82,20,0,6.24,27.72,2936629,2936711
16041,75,39,0,6.83,33.80,2936710,2936785
16042,74,17,1,6.92,14.59,2936785,2936859
16043,93,17,1,5.51,11.82,2936858,2936951
16044,55,49,0,9.31,72.00,2936950,2937005
16045,45,41,1,11.38,70.24,2937005,2937050
16046,58,27,1,8.83,29.32,2937049,2937107
16047,69,38,0,7.42,34.74,2937106,2937175
16048,58,34,2,8.83,39.00,2937174,2937232
16049,59,32,1,8.68,47.54,2937231,2937290
16050,58,33,1,8.83,49.63,2937289,2937347
16051,46,39,2,11.13,66.33,2937346,2937392
16052,53,47,1,9.66,68.49,2937391,2937444
16053,61,30,1,8.39,32.27,2937443,2937504
16054,55,80,2,9.31,127.92,2937503,2937558
16055,57,29,1,8.98,33.07,2937557,2937614
16056,59,31,3,8.68,26.22,2937613,2937672
16057,72,22,1,7.11,18.43,2937671,2937743
16058,51,60,1,10.04,129.25,2937742,2937793
16059,57,51,1,8.98,71.67,2937792,2937849
16060,56,40,0,9.14,52.73,2937848,2937904
16061,68,39,0,7.53,38.43,2937903,2937971
16062,61,46,0,8.39,70.50,2937970,2938031
16063,75,38,0,6.83,48.62,2938030,2938105
16064,85,33,0,6.02,30.75,2938104,2938189
16065,99,32,0,5.17,39.23,2938189,2938288
16066,77,39,0,6.65,49.47,2938287,2938364
16067,72,22,0,7.11,29.02,2938363,2938435
16068,82,20,0,6.24,18.23,2938434,2938516
16069,83,23,0,6.17,18.65,2938515,2938598
16070,73,22,0,7.01,20.31,2938597,2938670
16071,79,24,0,6.48,20.63,2938670,2938749
16072,62,44,0,8.26,61.84,2938749,2938811
16073,84,21,1,6.10,15.92,2938810,2938894
16074,63,29,1,8.13,34.59,2938893,2938956
16075,64,38,0,8.00,40.06,2938955,2939019
16076,69,26,1,7.42,25.66,2939018,2939087
16077,59,38,0,8.68,37.17,2939086,2939145
16078,52,43,0,9.85,67.40,2939144,2939196
16079,57,29,1,8.98,25.60,2939196,2939253
16080,55,43,0,9.31,49.12,2939253,2939308
16081,57,66,0,8.98,89.60,2939307,2939364
16082,49,35,2,10.45,46.57,2939363,2939412
16083,55,31,1,9.31,56.40,2939411,2939466
16084,67,30,0,7.64,31.69,2939465,2939532
16085,57,64,0,8.98,106.26,2939531,2939588
16086,67,25,1,7.64,30.23,2939587,2939654
16087,73,24,0,7.01,26.59,2939653,2939726
16088,69,34,0,7.42,33.69,2939725,2939794
16089,96,27,0,5.33,24.20,2939793,2939889
16090,99,23,0,5.17,20.04,2939888,2939987
16091,75,44,0,6.83,35.05,2939987,2940062
16092,78,25,0,6.56,21.37,2940061,2940139
16093,93,17,0,5.51,14.51,2940138,2940231
16094,72,40,1,7.11,42.32,2940230,2940302
16095,88,19,0,5.82,14.22,2940301,2940389
16096,59,39,0,8.68,52.73,2940389,2940448
16097,56,53,1,9.14,87.80,2940447,2940503
16098,51,43,1,10.04,59.06,2940502,2940553
16099,64,61,1,8.00,66.00,2940552,2940616
16100,66,29,1,7.76,30.37,2940615,2940681
16101,63,23,0,8.13,32.81,2940680,2940743
16102,60,30,1,8.53,36.92,2940742,2940802
16103,53,36,0,9.66,51.02,2940801,2940854
16104,57,31,1,8.98,40.37,2940853,2940910
16105,65,22,1,7.88,25.80,2940909,2940974
16106,52,40,2,9.85,59.21,2940973,2941025
16107,65,20,1,7.88,16.20,2941024,2941089
16108,60,42,1,8.53,55.22,2941088,2941148
16109,41,37,4,12.49,57.47,2941147,2941188
16110,49,34,0,10.45,57.68,2941188,2941237
16111,77,31,0,6.65,35.06,2941236,2941313
16112,59,39,0,8.68,59.20,2941312,2941371
16113,66,39,1,7.76,51.76,2941370,2941436
16114,57,36,1,8.98,64.05,2941435,2941492
16115,76,51,0,6.74,49.56,2941491,2941567
16116,88,22,0,5.82,26.35,2941566,2941654
16117,95,26,0,5.39,30.53,2941653,2941748
16118,76,26,0,6.74,26.75,2941747,2941823
16119,72,31,0,7.11,25.13,2941822,2941894
16120,76,19,1,6.74,19.51,2941893,2941969
16121,45,79,2,11.38,212.32,2941968,2942013
16122,66,31,1,7.76,41.94,2942012,2942078
16123,85,18,0,6.02,16.66,2942077,2942162
16124,71,23,0,7.21,25.97,2942161,2942232
16125,51,81,0,10.04,167.53,2942231,2942282
16126,61,57,0,8.39,68.11,2942281,2942342
16127,61,24,1,8.39,27.32,2942341,2942402
16128,65,24,0,7.88,25.12,2942401,2942466
16129,58,24,1,8.83,35.63,2942465,2942523
16130,56,50,0,9.14,59.34,2942522,2942578
16131,51,38,0,10.04,54.12,2942578,2942629
16132,56,51,1,9.14,69.30,2942628,2942684
16133,39,91,1,13.13,287.86,2942684,2942723
16134,51,43,1,10.04,49.45,2942722,2942773
16135,56,24,1,9.14,33.02,2942772,2942828
16136,58,38,1,8.83,44.21,2942827,2942885
16137,57,30,1,8.98,33.42,2942884,2942941
16138,55,33,2,9.31,38.36,2942940,2942995
16139,66,33,0,7.76,33.79,2942994,2943060
16140,37,161,1,13.84,636.35,2943059,2943096
16141,39,116,1,13.13,390.37,2943095,2943134
16142,73,26,0,7.01,26.45,2943133,2943206
16143,59,34,0,8.68,63.44,2943205,2943264
16144,66,43,1,7.76,58.67,2943264,2943330
16145,54,61,0,9.48,111.88,2943329,2943383
16146,81,22,0,6.32,23.01,2943382,2943463
16147,83,55,0,6.17,67.90,2943462,2943545
16148,77,29,0,6.65,34.54,2943544,2943621
16149,89,35,0,5.75,30.39,2943620,2943709
16150,78,24,1,6.56,21.76,2943708,2943786
16151,79,37,1,6.48,31.24,2943786,2943865
16152,77,45,0,6.65,40.23,2943864,2943941
16153,55,44,1,9.31,70.36,2943940,2943995
16154,60,37,0,8.53,39.92,2943994,2944054
16155,72,37,1,7.11,36.38,2944054,2944126
16156,62,40,0,8.26,59.32,2944125,2944187
16157,43,41,1,11.91,79.01,2944186,2944229
16158,32,67,2,16.00,295.06,2944228,2944260
16159,64,68,0,8.00,76.03,2944259,2944323
16160,53,46,0,9.66,54.41,2944322,2944375
16161,68,32,0,7.53,41.10,2944374,2944442
16162,63,28,1,8.13,33.03,2944441,2944504
16163,56,24,2,9.14,33.12,2944503,2944559
16164,48,33,1,10.67,56.35,2944558,2944606
16165,53,20,0,9.66,21.81,2944605,2944658
16166,44,57,1,11.64,130.87,2944657,2944701
16167,47,36,0,10.89,53.24,2944700,2944747
16168,64,31,0,8.00,38.12,2944746,2944810
16169,63,23,2,8.13,20.08,2944809,2944872
16170,54,61,1,9.48,74.81,2944871,2944925
16171,50,41,0,10.24,87.66,2944924,2944974
16172,27,111,1,18.96,533.37,2944973,2945000
16173,59,32,0,8.68,47.47,2944999,2945058
16174,60,41,1,8.53,53.65,2945057,2945117
16175,52,30,0,9.85,47.75,2945116,2945168
16176,53,68,0,9.66,130.45,2945167,2945220
16177,66,42,1,7.76,41.58,2945219,2945285
16178,70,45,0,7.31,43.93,2945284,2945354
16179,100,17,0,5.12,17.73,2945353,2945453
16180,94,26,0,5.45,27.72,2945452,2945546
16181,56,63,1,9.14,107.12,2945545,2945601
16182,58,76,0,8.83,132.56,2945600,2945658
16183,85,23,1,6.02,18.33,2945657,2945742
16184,78,36,0,6.56,29.09,2945742,2945820
16185,71,25,0,7.21,33.97,2945819,2945890
16186,69,52,1,7.42,47.87,2945889,2945958
16187,55,68,0,9.31,133.70,2945957,2946012
16188,64,66,1,8.00,90.47,2946011,2946075
16189,60,73,1,8.53,102.28,2946074,2946134
16190,53,49,1,9.66,58.56,2946133,2946186
16191,58,45,1,8.83,45.28,2946185,2946243
16192,64,25,1,8.00,24.84,2946242,2946306
16193,59,66,1,8.68,87.17,2946305,2946364
16194,61,28,0,8.39,30.83,2946363,2946424
16195,61,42,1,8.39,39.94,2946423,2946484
16196,55,31,2,9.31,36.29,2946483,2946538
16197,49,27,1,10.45,35.31,2946537,2946586
16198,69,29,0,7.42,30.13,2946585,2946654
16199,62,33,1,8.26,46.19,2946653,2946715
16200,47,51,1,10.89,110.73,2946714,2946761
16201,54,48,2,9.48,50.84,2946760,2946814
16202,60,47,2,8.53,49.42,2946813,2946873
16203,50,36,0,10.24,53.34,2946872,2946922
16204,65,41,0,7.88,65.12,2946921,2946986
16205,57,24,1,8.98,30.12,2946985,2947042
16206,67,43,0,7.64,47.60,2947041,2947108
16207,74,27,0,6.92,34.45,2947107,2947181
16208,74,43,0,6.92,50.75,2947180,2947254
16209,107,24,0,4.79,19.07,2947253,2947360
16210,83,27,0,6.17,40.24,2947359,2947442
16211,74,30,1,6.92,40.26,2947441,2947515
16212,62,25,1,8.26,29.16,2947514,2947576
16213,61,58,1,8.39,106.44,2947575,2947636
16214,74,26,0,6.92,27.29,2947635,2947709
16215,78,32,1,6.56,33.89,2947708,2947786
16216,66,109,1,7.76,172.76,2947786,2947852
16217,44,75,1,11.64,216.60,2947851,2947895
16218,70,48,0,7.31,51.47,2947894,2947964
16219,59,38,1,8.68,51.54,2947963,2948022
16220,46,86,0,11.13,171.50,2948021,2948067
16221,62,24,1,8.26,24.71,2948066,2948128
16222,60,55,0,8.53,59.95,2948127,2948187
16223,70,23,1,7.31,22.79,2948186,2948256
16224,55,31,2,9.31,43.38,2948255,2948310
16225,54,39,1,9.48,60.55,2948309,2948363
16226,51,36,1,10.04,42.90,2948362,2948413
16227,51,28,1,10.04,46.27,2948412,2948463
16228,62,47,1,8.26,52.03,2948462,2948524
16229,51,29,2,10.04,32.08,2948523,2948574
16230,60,39,0,8.53,57.82,2948573,2948633
16231,38,50,1,13.47,146.35,2948632,2948670
16232,48,113,0,10.67,276.72,2948670,2948718
16233,65,33,0,7.88,38.94,2948717,2948782
16234,61,31,0,8.39,42.73,2948781,2948842
16235,60,58,0,8.53,110.02,2948841,2948901
16236,52,35,1,9.85,48.40,2948900,2948952
16237,54,24,1,9.48,40.03,2948951,2949005
16238,56,31,0,9.14,43.23,2949004,2949060
16239,58,49,0,8.83,91.56,2949059,2949117
16240,72,34,0,7.11,36.02,2949116,2949188
16241,69,48,1,7.42,72.77,2949187,2949256
16242,68,67,0,7.53,80.37,2949255,2949323
16243,81,22,0,6.32,22.74,2949322,2949403
16244,77,29,0,6.65,25.73,2949402,2949479
16245,67,59,1,7.64,64.35,2949478,2949545
16246,57,30,1,8.98,36.26,2949544,2949601
16247,68,23,0,7.53,27.98,2949600,2949668
16248,50,42,2,10.24,82.38,2949667,2949717
16249,45,29,2,11.38,46.77,2949717,2949762
16250,58,24,2,8.83,29.28,2949761,2949819
16251,60,77,1,8.53,112.38,2949818,2949878
16252,58,40,0,8.83,53.76,2949877,2949935
16253,63,35,1,8.13,33.19,2949935,2949998
16254,42,61,2,12.19,108.63,2949997,2950039
16255,50,77,0,10.24,134.94,2950038,2950088
16256,66,28,1,7.76,28.97,2950087,2950153
16257,61,62,0,8.39,86.04,2950152,2950213
16258,45,44,2,11.38,66.46,2950212,2950257
16259,62,25,2,8.26,31.71,2950256,2950318
16260,56,33,1,9.14,43.16,2950317,2950373
16261,57,87,0,8.98,151.03,2950372,2950429
16262,57,91,0,8.98,167.56,2950428,2950485
16263,82,41,0,6.24,49.67,2950484,2950566
16264,105,31,0,4.88,24.97,2950566,2950671
16265,59,70,0,8.68,108.46,2950670,2950729
16266,88,34,0,5.82,39.42,2950728,2950816
16267,92,36,0,5.57,33.85,2950816,2950908
16268,74,17,0,6.92,15.24,2950908,2950982
16269,78,28,0,6.56,29.73,2950981,2951059
16270,79,44,1,6.48,45.74,2951058,2951137
16271,82,20,0,6.24,20.04,2951137,2951219
16272,79,27,0,6.48,20.50,2951218,2951297
16273,72,38,1,7.11,39.49,2951296,2951368
16274,58,53,0,8.83,70.97,2951368,2951426
16275,57,28,1,8.98,36.86,2951425,2951482
16276,53,28,2,9.66,43.77,2951482,2951535
16277,58,30,2,8.83,29.45,2951535,2951593
16278,57,38,0,8.98,57.42,2951593,2951650
16279,57,54,1,8.98,63.14,2951650,2951707
16280,55,38,2,9.31,46.47,2951706,2951761
16281,46,56,0,11.13,114.94,2951761,2951807
16282,56,33,1,9.14,30.98,2951806,2951862
16283,59,27,3,8.68,29.03,2951861,2951920
16284,64,36,2,8.00,40.91,2951919,2951983
16285,57,32,1,8.98,41.03,2951982,2952039
16286,56,42,0,9.14,59.09,2952038,2952094
16287,56,32,2,9.14,34.66,2952093,2952149
16288,40,97,2,12.80,242.96,2952148,2952188
16289,43,39,3,11.91,55.48,2952187,2952230
16290,54,33,1,9.48,54.92,2952229,2952283
16291,48,89,0,10.67,303.35,2952282,2952330
16292,62,40,0,8.26,51.39,2952329,2952391
16293,54,35,0,9.48,58.40,2952390,2952444
16294,61,29,0,8.39,48.57,2952443,2952504
16295,64,29,0,8.00,41.66,2952503,2952567
16296,81,37,0,6.32,40.14,2952566,2952647
16297,91,27,0,5.63,22.70,2952646,2952737
16298,88,41,0,5.82,41.67,2952736,2952824
16299,59,37,1,8.68,43.85,2952824,2952883
16300,79,26,0,6.48,26.63,2952882,2952961
16301,67,38,1,7.64,45.72,2952960,2953027
16302,72,32,1,7.11,48.96,2953027,2953099
16303,74,22,0,6.92,22.70,2953098,2953172
16304,61,49,0,8.39,82.30,2953171,2953232
16305,59,24,2,8.68,34.12,2953231,2953290
16306,56,42,1,9.14,62.87,2953289,2953345
16307,56,44,1,9.14,72.37,2953344,2953400
16308,60,45,1,8.53,43.88,2953399,2953459
16309,47,66,2,10.89,104.95,2953458,2953505
16310,62,34,1,8.26,41.32,2953504,2953566
16311,61,24,3,8.39,22.04,2953565,2953626
16312,48,55,0,10.67,83.76,2953626,2953674
16313,55,43,1,9.31,66.80,2953673,2953728
16314,55,38,1,9.31,36.29,2953727,2953782
16315,52,28,1,9.85,34.90,2953781,2953833
16316,62,22,1,8.26,17.35,2953832,2953894
16317,62,25,2,8.26,24.06,2953893,2953955
16318,56,30,1,9.14,36.44,2953954,2954010
16319,54,52,0,9.48,68.25,2954010,2954064
16320,57,28,1,8.98,34.19,2954063,2954120
16321,60,33,1,8.53,46.82,2954119,2954179
16322,43,62,0,11.91,223.81,2954178,2954221
16323,73,33,0,7.01,37.03,2954220,2954293
16324,92,34,0,5.57,28.25,2954292,2954384
16325,113,31,0,4.53,25.77,2954383,2954496
16326,91,32,0,5.63,25.40,2954495,2954586
16327,101,45,0,5.07,30.84,2954585,2954686
16328,75,44,0,6.83,38.86,2954685,2954760
16329,71,32,1,7.21,22.79,2954759,2954830
16330,74,47,0,6.92,49.26,2954829,2954903
16331,67,52,1,7.64,76.08,2954902,2954969
16332,62,41,0,8.26,56.16,2954969,2955031
16333,83,19,1,6.17,19.06,2955031,2955114
16334,68,31,0,7.53,39.19,2955113,2955181
16335,54,66,1,9.48,160.84,2955180,2955234
16336,54,28,1,9.48,30.73,2955233,2955287
16337,62,28,0,8.26,29.00,2955286,2955348
16338,57,58,2,8.98,59.88,2955347,2955404
16339,59,36,1,8.68,41.40,2955403,2955462
16340,49,38,1,10.45,56.00,2955461,2955510
16341,51,44,2,10.04,47.14,2955509,2955560
16342,51,25,1,10.04,36.16,2955559,2955610
16343,58,35,2,8.83,35.32,2955609,2955667
16344,61,34,1,8.39,35.78,2955666,2955727
16345,67,24,0,7.64,34.11,2955726,2955793
16346,59,59,0,8.68,73.88,2955792,2955851
16347,39,51,2,13.13,126.73,2955850,2955889
16348,70,25,1,7.31,25.70,2955888,2955958
16349,70,30,0,7.31,36.82,2955957,2956027
16350,52,33,1,9.85,56.36,2956026,2956078
16351,49,78,1,10.45,138.08,2956077,2956126
16352,68,29,0,7.53,39.07,2956125,2956193
16353,59,40,1,8.68,48.79,2956192,2956251
16354,88,29,0,5.82,26.29,2956250,2956338
16355,69,32,0,7.42,31.69,2956337,2956406
16356,63,37,1,8.13,39.83,2956405,2956468
16357,77,23,1,6.65,29.84,2956467,2956544
16358,68,60,1,7.53,75.37,2956543,2956611
16359,69,51,1,7.42,63.63,2956610,2956679
16360,78,36,0,6.56,35.99,2956679,2956757
16361,55,31,0,9.31,46.83,2956756,2956811
16362,53,32,1,9.66,38.34,2956810,2956863
16363,62,32,1,8.26,31.90,2956862,2956924
16364,41,77,2,12.49,243.71,2956923,2956964
16365,59,51,1,8.68,51.27,2956963,2957022
16366,55,51,1,9.31,57.05,2957021,2957076
16367,55,33,1,9.31,38.98,2957075,2957130
16368,64,31,0,8.00,33.69,2957129,2957193
16369,51,26,3,10.04,35.84,2957192,2957243
16370,49,39,1,10.45,47.72,2957242,2957291
16371,54,39,1,9.48,48.03,2957291,2957345
16372,58,39,1,8.83,45.11,2957344,2957402
16373,42,119,0,12.19,329.49,2957401,2957443
16374,53,70,1,9.66,98.75,2957442,2957495
16375,60,49,2,8.53,62.02,2957494,2957554
16376,60,25,2,8.53,37.78,2957554,2957614
16377,58,67,1,8.83,94.04,2957613,2957671
16378,69,29,0,7.42,35.58,2957670,2957739
16379,48,54,1,10.67,106.64,2957738,2957786
16380,54,76,1,9.48,107.10,2957785,2957839
16381,63,46,0,8.13,56.81,2957838,2957901
16382,66,37,0,7.76,49.70,2957900,2957966
16383,93,29,0,5.51,23.02,2957965,2958058
16384,116,41,0,4.41,24.57,2958057,2958173
16385,83,24,0,6.17,24.00,2958172,2958255
16386,78,21,0,6.56,16.35,2958255,2958333
16387,72,36,1,7.11,44.88,2958332,2958404
16388,68,63,0,7.53,72.28,2958403,2958471
16389,73,33,1,7.01,34.12,2958470,2958543
16390,83,21,0,6.17,22.98,2958542,2958625
16391,67,26,0,7.64,22.11,2958624,2958691
16392,60,30,1,8.53,38.68,2958690,2958750
16393,61,39,1,8.39,39.55,2958749,2958810
16394,67,29,1,7.64,29.27,2958809,2958876
16395,53,50,1,9.66,64.90,2958875,2958928
16396,70,20,1,7.31,18.27,2958927,2958997
16397,69,19,1,7.42,19.32,2958996,2959065
16398,53,28,1,9.66,37.09,2959064,2959117
16399,48,96,2,10.67,187.01,2959116,2959164
16400,55,27,1,9.31,33.01,2959164,2959219
16401,46,54,1,11.13,107.33,2959219,2959265
16402,58,37,2,8.83,40.94,2959264,2959322
16403,71,21,1,7.21,20.56,2959321,2959392
16404,43,98,1,11.91,219.01,2959391,2959434
16405,55,54,1,9.31,86.58,2959433,2959488
16406,47,35,0,10.89,83.88,2959487,2959534
16407,65,43,0,7.88,59.12,2959533,2959598
16408,55,54,0,9.31,77.27,2959597,2959652
16409,63,23,1,8.13,26.78,2959651,2959714
16410,56,41,0,9.14,54.23,2959713,2959769
16411,64,32,0,8.00,44.28,2959768,2959832
16412,75,49,0,6.83,67.66,2959831,2959906
16413,63,67,0,8.13,105.79,2959905,2959968
16414,86,62,0,5.95,61.70,2959967,2960053
16415,71,32,0,7.21,34.45,2960052,2960123
16416,70,46,0,7.31,42.70,2960122,2960192
16417,86,18,1,5.95,14.02,2960191,2960277
16418,72,26,0,7.11,29.18,2960276,2960348
16419,86,22,0,5.95,17.70,2960348,2960434
16420,69,63,0,7.42,65.61,2960433,2960502
16421,74,30,1,6.92,24.86,2960501,2960575
16422,69,23,0,7.42,18.33,2960574,2960643
16423,55,39,0,9.31,46.29,2960642,2960697
16424,65,26,0,7.88,29.65,2960696,2960761
16425,59,44,1,8.68,42.90,2960761,2960820
16426,60,35,1,8.53,32.18,2960819,2960879
16427,57,38,1,8.98,60.58,2960878,2960935
16428,45,36,1,11.38,66.72,2960934,2960979
16429,57,23,1,8.98,27.53,2960978,2961035
16430,59,33,1,8.68,36.59,2961034,2961093
16431,62,26,1,8.26,33.32,2961092,2961154
16432,58,32,0,8.83,33.90,2961153,2961211
16433,58,31,1,8.83,36.42,2961210,2961268
16434,67,44,0,7.64,64.71,2961267,2961334
16435,55,33,1,9.31,57.16,2961333,2961388
16436,71,27,0,7.21,32.39,2961387,2961458
16437,54,39,2,9.48,72.92,2961457,2961511
16438,99,36,0,5.17,23.96,2961510,2961609
16439,105,19,0,4.88,18.53,2961609,2961714
16440,65,49,1,7.88,48.42,2961713,2961778
16441,78,38,0,6.56,36.50,2961777,2961855
16442,92,16,0,5.57,13.31,2961854,2961946
16443,68,19,1,7.53,19.93,2961945,2962013
16444,70,33,1,7.31,37.36,2962012,2962082
16445,62,34,2,8.26,37.29,2962081,2962143
16446,67,17,1,7.64,18.23,2962142,2962209
16447,67,46,0,7.64,45.54,2962208,2962275
16448,55,30,2,9.31,41.52,2962274,2962329
16449,63,57,1,8.13,61.57,2962328,2962391
16450,58,29,1,8.83,32.97,2962390,2962448
16451,56,36,2,9.14,40.23,2962447,2962503
16452,66,26,1,7.76,21.24,2962502,2962568
16453,43,32,2,11.91,54.55,2962567,2962610
16454,46,59,1,11.13,96.37,2962609,2962655
16455,55,22,2,9.31,22.98,2962654,2962709
16456,59,34,0,8.68,43.88,2962708,2962767
16457,58,31,2,8.83,33.59,2962766,2962824
16458,55,57,1,9.31,75.60,2962823,2962878
16459,67,23,0,7.64,26.83,2962877,2962944
16460,64,32,0,8.00,40.16,2962944,2963008
16461,45,49,0,11.38,119.97,2963007,2963052
16462,52,59,1,9.85,94.01,2963051,2963103
16463,55,51,0,9.31,87.38,2963102,2963157
16464,47,86,0,10.89,197.80,2963156,2963203
16465,89,35,0,5.75,31.85,2963202,2963291
16466,87,30,0,5.89,33.62,2963290,2963377
16467,95,24,0,5.39,22.60,2963376,2963471
16468,80,41,0,6.40,48.14,2963470,2963550
16469,65,52,1,7.88,54.69,2963549,2963614
16470,77,34,0,6.65,35.24,2963613,2963690
16471,78,47,0,6.56,53.53,2963690,2963768
16472,73,24,1,7.01,24.26,2963767,2963840
16473,71,26,1,7.21,25.29,2963840,2963911
16474,58,60,1,8.83,107.69,2963910,2963968
16475,56,44,1,9.14,50.87,2963967,2964023
16476,60,30,1,8.53,37.65,2964022,2964082
16477,62,36,1,8.26,35.55,2964081,2964143
16478,67,29,0,7.64,30.83,2964142,2964209
16479,62,42,2,8.26,52.19,2964209,2964271
16480,52,53,1,9.85,69.59,2964270,2964322
16481,60,28,1,8.53,32.38,2964322,2964382
16482,50,40,1,10.24,45.74,2964381,2964431
16483,54,46,1,9.48,45.77,2964430,2964484
16484,53,71,1,9.66,128.75,2964483,2964536
16485,61,34,2,8.39,43.48,2964536,2964597
16486,53,56,1,9.66,74.94,2964596,2964649
16487,67,37,1,7.64,39.54,2964648,2964715
16488,49,44,1,10.45,69.27,2964714,2964763
16489,31,125,4,16.52,466.96,2964762,2964793
16490,46,33,1,11.13,53.20,2964792,2964838
16491,67,23,0,7.64,34.95,2964837,2964904
16492,59,35,1,8.68,55.10,2964903,2964962
16493,53,56,1,9.66,89.28,2964961,2965014
16494,64,39,0,8.00,55.19,2965014,2965078
16495,81,27,0,6.32,35.30,2965078,2965159
16496,93,42,0,5.51,38.96,2965158,2965251
16497,80,32,0,6.40,36.71,2965250,2965330
16498,88,18,0,5.82,24.26,2965329,2965417
16499,68,38,0,7.53,42.81,2965416,2965484
16500,68,25,1,7.53,25.34,2965483,2965551
16501,98,20,1,5.22,14.93,2965550,2965648
16502,80,31,0,6.40,23.79,2965647,2965727
16503,65,56,1,7.88,66.05,2965726,2965791
16504,75,25,0,6.83,26.60,2965790,2965865
16505,59,54,1,8.68,96.96,2965864,2965923
16506,59,95,0,8.68,146.79,2965922,2965981
16507,48,54,1,10.67,78.85,2965981,2966029
16508,55,33,1,9.31,56.25,2966028,2966083
16509,69,27,1,7.42,27.55,2966082,2966151
16510,56,61,0,9.14,76.23,2966150,2966206
16511,56,42,0,9.14,57.23,2966205,2966261
16512,45,60,2,11.38,102.95,2966260,2966305
16513,55,33,0,9.31,46.25,2966304,2966359
16514,33,62,3,15.52,195.22,2966359,2966392
16515,54,31,1,9.48,29.29,2966391,2966445
16516,65,28,1,7.88,29.12,2966444,2966509
16517,65,19,0,7.88,21.74,2966508,2966573
16518,54,52,2,9.48,65.21,2966572,2966626
16519,68,42,1,7.53,45.75,2966626,2966694
16520,59,28,1,8.68,38.12,2966693,2966752
16521,69,32,0,7.42,34.74,2966751,2966820
16522,66,26,1,7.76,28.30,2966819,2966885
16523,64,34,0,8.00,34.31,2966884,2966948
16524,65,43,0,7.88,64.45,2966947,2967012
16525,53,75,0,9.66,200.71,2967011,2967064
16526,69,45,0,7.42,53.78,2967064,2967133
16527,100,24,0,5.12,19.21,2967132,2967232
16528,91,25,0,5.63,25.00,2967231,2967322
16529,71,48,0,7.21,46.31,2967321,2967392
16530,78,26,1,6.56,26.35,2967391,2967469
16531,85,20,0,6.02,17.58,2967468,2967553
16532,70,22,1,7.31,24.96,2967552,2967622
16533,79,30,1,6.48,27.62,2967621,2967700
16534,63,30,0,8.13,34.52,2967699,2967762
16535,55,34,1,9.31,54.61,2967761,2967816
16536,49,68,1,10.45,95.43,2967815,2967864
16537,55,28,2,9.31,34.76,2967863,2967918
16538,56,54,1,9.14,60.87,2967917,2967973
16539,58,30,0,8.83,32.87,2967972,2968030
16540,46,50,1,11.13,112.68,2968029,2968075
16541,48,33,1,10.67,46.18,2968075,2968123
16542,48,31,2,10.67,38.26,2968122,2968170
16543,61,31,0,8.39,39.35,2968169,2968230
16544,66,29,2,7.76,26.12,2968229,2968295
16545,68,27,2,7.53,31.10,2968294,2968362
16546,70,25,1,7.31,23.64,2968361,2968431
16547,45,48,1,11.38,93.75,2968430,2968475
16548,84,25,0,6.10,22.16,2968474,2968558
16549,55,44,0,9.31,70.21,2968557,2968612
16550,72,39,0,7.11,55.63,2968611,2968683
16551,82,36,0,6.24,30.33,2968682,2968764
16552,83,27,0,6.17,34.94,2968763,2968846
16553,102,23,0,5.02,25.18,2968845,2968947
16554,73,24,0,7.01,27.96,2968946,2969019
16555,81,28,0,6.32,22.46,2969019,2969100
16556,93,25,0,5.51,15.15,2969099,2969192
16557,81,25,1,6.32,25.90,2969191,2969272
16558,70,19,1,7.31,22.64,2969271,2969341
16559,68,38,1,7.53,34.40,2969340,2969408
16560,60,26,2,8.53,25.88,2969407,2969467
16561,66,22,1,7.76,23.06,2969466,2969532
16562,58,42,1,8.83,47.38,2969531,2969589
16563,63,26,1,8.13,32.75,2969588,2969651
16564,40,43,0,12.80,79.11,2969650,2969690
16565,53,44,1,9.66,41.09,2969689,2969742
16566,66,20,2,7.76,21.64,2969741,2969807
16567,68,32,0,7.53,28.84,2969806,2969874
16568,50,46,1,10.24,90.94,2969873,2969923
16569,64,26,0,8.00,29.06,2969922,2969986
16570,64,49,0,8.00,82.41,2969986,2970050
16571,55,33,0,9.31,55.81,2970049,2970104
16572,68,34,0,7.53,31.51,2970104,2970172
16573,51,44,0,10.04,80.63,2970172,2970223
16574,76,45,0,6.74,50.09,2970222,2970298
16575,84,61,0,6.10,72.87,2970297,2970381
16576,89,20,0,5.75,25.04,2970381,2970470
16577,54,55,1,9.48,91.77,2970469,2970523
16578,68,33,1,7.53,42.96,2970522,2970590
16579,43,62,0,11.91,123.29,2970590,2970633
16580,75,47,0,6.83,38.44,2970632,2970707
16581,79,40,0,6.48,40.78,2970707,2970786
16582,66,47,0,7.76,49.37,2970785,2970851
16583,51,35,2,10.04,48.12,2970850,2970901
16584,59,25,1,8.68,30.32,2970900,2970959
16585,64,24,0,8.00,32.59,2970958,2971022
16586,60,28,1,8.53,28.58,2971021,2971081
16587,52,64,2,9.85,90.67,2971080,2971132
16588,53,39,0,9.66,41.81,2971131,2971184
16589,39,51,3,13.13,105.55,2971183,2971222
16590,46,30,2,11.13,41.46,2971221,2971267
16591,53,28,0,9.66,35.85,2971266,2971319
16592,55,69,1,9.31,111.12,2971318,2971373
16593,53,24,1,9.66,28.83,2971372,2971425
16594,71,45,1,7.21,38.98,2971424,2971495
16595,64,33,0,8.00,52.12,2971494,2971558
16596,58,28,1,8.83,42.52,2971558,2971616
16597,53,40,0,9.66,67.21,2971615,2971668
16598,74,37,0,6.92,52.64,2971667,2971741
16599,82,40,0,6.24,42.33,2971740,2971822
16600,83,44,1,6.17,42.84,2971821,2971904
16601,89,36,0,5.75,31.42,2971904,2971993
16602,61,45,0,8.39,54.89,2971993,2972054
16603,73,31,0,7.01,28.31,2972053,2972126
16604,73,39,1,7.01,32.42,2972125,2972198
16605,85,25,1,6.02,19.03,2972197,2972282
16606,53,60,0,9.66,100.07,2972281,2972334
16607,66,44,1,7.76,45.43,2972333,2972399
16608,57,73,0,8.98,138.09,2972398,2972455
16609,61,37,1,8.39,55.85,2972454,2972515
16610,70,30,1,7.31,26.39,2972514,2972584
16611,47,50,0,10.89,92.73,2972584,2972631
16612,49,64,1,10.45,135.92,2972630,2972679
16613,59,25,0,8.68,23.88,2972679,2972738
16614,47,68,2,10.89,93.12,2972738,2972785
16615,58,31,1,8.83,35.83,2972784,2972842
16616,60,24,1,8.53,35.32,2972841,2972901
16617,52,64,1,9.85,92.67,2972900,2972952
16618,59,29,1,8.68,44.96,2972951,2973010
16619,59,36,0,8.68,50.25,2973009,2973068
16620,47,45,1,10.89,88.35,2973068,2973115
16621,62,37,0,8.26,47.51,2973114,2973176
16622,67,26,1,7.64,35.87,2973175,2973242
16623,96,21,0,5.33,17.62,2973241,2973337
16624,127,33,0,4.03,19.09,2973336,2973463
16625,83,30,1,6.17,30.69,2973463,2973546
16626,75,28,0,6.83,38.25,2973545,2973620
16627,65,27,1,7.88,43.68,2973619,2973684
16628,66,26,1,7.76,34.27,2973683,2973749
16629,73,39,1,7.01,29.90,2973748,2973821
16630,56,66,1,9.14,94.05,2973821,2973877
16631,59,30,1,8.68,35.68,2973876,2973935
16632,65,29,0,7.88,25.68,2973934,2973999
16633,67,51,1,7.64,47.75,2973998,2974065
16634,63,27,1,8.13,31.19,2974064,2974127
16635,50,41,1,10.24,65.46,2974127,2974177
16636,54,30,1,9.48,44.95,2974176,2974230
16637,40,104,3,12.80,241.16,2974229,2974269
16638,50,19,0,10.24,22.30,2974268,2974318
16639,40,92,2,12.80,214.21,2974317,2974357
16640,63,31,1,8.13,27.29,2974357,2974420
16641,62,33,1,8.26,29.93,2974419,2974481
16642,46,54,1,11.13,94.81,2974480,2974526
16643,62,27,1,8.26,27.55,2974525,2974587
16644,68,23,1,7.53,29.69,2974586,2974654
16645,72,21,0,7.11,24.77,2974653,2974725
16646,64,85,0,8.00,127.62,2974724,2974788
16647,49,42,1,10.45,72.74,2974787,2974836
16648,60,30,1,8.53,38.78,2974836,2974896
16649,71,26,0,7.21,30.84,2974895,2974966
16650,63,30,0,8.13,52.78,2974965,2975028
16651,89,35,0,5.75,43.76,2975027,2975116
16652,87,29,0,5.89,37.23,2975115,2975202
16653,78,46,0,6.56,67.50,2975201,2975279
16654,60,63,1,8.53,97.22,2975278,2975338
16655,64,24,1,8.00,23.16,2975338,2975402
16656,78,35,0,6.56,32.78,2975402,2975480
16657,86,27,0,5.95,20.63,2975479,2975565
16658,68,47,0,7.53,45.69,2975564,2975632
16659,76,31,0,6.74,28.67,2975631,2975707
16660,60,33,1,8.53,32.58,2975707,2975767
16661,57,43,1,8.98,48.72,2975766,2975823
16662,55,43,0,9.31,74.18,2975822,2975877
16663,60,25,0,8.53,37.45,2975876,2975936
16664,61,35,2,8.39,41.88,2975935,2975996
16665,63,30,1,8.13,30.46,2975995,2976058
16666,59,25,1,8.68,26.76,2976057,2976116
16667,68,23,1,7.53,26.48,2976115,2976183
16668,49,35,1,10.45,37.96,2976182,2976231
16669,56,30,2,9.14,34.55,2976230,2976286
16670,61,26,1,8.39,32.53,2976285,2976346
16671,65,27,0,7.88,29.62,2976345,2976410
16672,60,35,1,8.53,47.42,2976410,2976470
16673,72,28,0,7.11,27.52,2976470,2976542
16674,40,33,1,12.80,58.31,2976541,2976581
16675,47,63,1,10.89,138.39,2976580,2976627
16676,53,88,1,9.66,156.94,2976626,2976679
16677,55,27,1,9.31,37.09,2976678,2976733
16678,49,42,0,10.45,91.59,2976732,2976781
16679,59,58,0,8.68,114.05,2976780,2976839
16680,87,22,0,5.89,23.69,2976838,2976925
16681,94,28,0,5.45,24.99,2976924,2977018
16682,82,35,1,6.24,31.09,2977017,2977099
16683,100,22,0,5.12,20.85,2977098,2977198
16684,55,34,1,9.31,45.49,2977197,2977252
16685,70,27,0,7.31,26.99,2977251,2977321
16686,61,75,1,8.39,109.45,2977320,2977381
16687,73,35,1,7.01,27.00,2977380,2977453
16688,65,29,1,7.88,26.02,2977453,2977518
16689,71,17,1,7.21,14.96,2977517,2977588
16690,69,21,0,7.42,24.68,2977587,2977656
16691,54,40,0,9.48,55.88,2977656,2977710
16692,55,30,1,9.31,45.30,2977710,2977765
16693,53,45,4,9.66,61.47,2977764,2977817
16694,67,42,1,7.64,45.63,2977816,2977883
16695,61,37,1,8.39,43.32,2977883,2977944
16696,57,38,1,8.98,40.65,2977943,2978000
16697,59,31,2,8.68,28.66,2977999,2978058
16698,51,35,2,10.04,39.88,2978057,2978108
16699,44,46,2,11.64,84.37,2978107,2978151
16700,49,30,1,10.45,44.08,2978150,2978199
16701,59,24,1,8.68,26.52,2978198,2978257
16702,61,33,1,8.39,41.12,2978256,2978317
16703,59,32,2,8.68,29.34,2978316,2978375
16704,60,27,0,8.53,28.85,2978375,2978435
16705,53,34,2,9.66,43.02,2978434,2978487
16706,63,37,0,8.13,41.79,2978486,2978549
16707,49,49,1,10.45,81.02,2978548,2978597
16708,57,32,1,8.98,35.84,2978596,2978653
16709,63,36,0,8.13,55.92,2978652,2978715
16710,64,45,0,8.00,67.69,2978715,2978779
16711,89,26,0,5.75,28.01,2978778,2978867
16712,83,44,0,6.17,54.04,2978866,2978949
16713,85,43,0,6.02,51.81,2978949,2979034
16714,62,36,0,8.26,42.74,2979033,2979095
16715,63,37,1,8.13,41.79,2979094,2979157
16716,83,19,0,6.17,15.56,2979157,2979240
16717,78,46,0,6.56,44.12,2979239,2979317
16718,69,45,0,7.42,51.43,2979317,2979386
16719,72,31,0,7.11,35.49,2979385,2979457
16720,84,20,0,6.10,13.51,2979456,2979540
16721,61,40,1,8.39,44.73,2979539,2979600
16722,57,43,1,8.98,57.10,2979600,2979657
16723,58,34,1,8.83,39.32,2979656,2979714
16724,65,24,1,7.88,29.62,2979713,2979778
16725,52,29,1,9.85,55.05,2979777,2979829
16726,46,72,0,11.13,155.46,2979828,2979874
16727,51,28,1,10.04,30.55,2979873,2979924
16728,66,26,0,7.76,26.12,2979923,2979989
16729,56,39,1,9.14,38.37,2979988,2980044
16730,56,36,1,9.14,48.69,2980043,2980099
16731,72,33,1,7.11,36.13,2980098,2980170
16732,33,46,1,15.52,150.98,2980169,2980202
16733,43,50,1,11.91,82.97,2980201,2980244
16734,61,34,0,8.39,51.75,2980244,2980305
16735,50,37,1,10.24,70.22,2980304,2980354
16736,58,42,0,8.83,67.83,2980354,2980412
16737,47,55,0,10.89,139.75,2980411,2980458
16738,66,28,0,7.76,36.27,2980457,2980523
16739,79,64,0,6.48,64.78,2980522,2980601
16740,92,27,0,5.57,24.64,2980600,2980692
16741,80,28,0,6.40,29.04,2980691,2980771
16742,82,28,0,6.24,21.92,2980770,2980852
16743,80,27,0,6.40,27.41,2980851,2980931
16744,70,38,0,7.31,34.93,2980930,2981000
16745,61,37,1,8.39,40.83,2980999,2981060
16746,47,34,1,10.89,69.71,2981059,2981106
16747,63,32,1,8.13,33.89,2981105,2981168
16748,65,29,1,7.88,32.69,2981167,2981232
16749,45,54,2,11.38,104.01,2981231,2981276
16750,66,21,1,7.76,22.64,2981275,2981341
16751,60,25,1,8.53,27.95,2981340,2981400
16752,45,34,1,11.38,51.66,2981399,2981444
16753,54,46,1,9.48,53.03,2981443,2981497
16754,63,27,0,8.13,29.41,2981496,2981559
16755,45,54,2,11.38,74.32,2981558,2981603
16756,48,32,0,10.67,52.35,2981602,2981650
16757,56,33,1,9.14,44.02,2981649,2981705
16758,62,41,1,8.26,43.58,2981704,2981766
16759,58,31,0,8.83,36.80,2981765,2981823
16760,65,31,0,7.88,33.74,2981822,2981887
16761,57,38,1,8.98,54.72,2981886,2981943
16762,71,25,0,7.21,26.73,2981942,2982013
16763,61,32,1,8.39,32.63,2982012,2982073
16764,67,30,1,7.64,40.80,2982072,2982139
16765,61,40,0,8.39,54.11,2982138,2982199
16766,85,33,0,6.02,30.99,2982198,2982283
16767,86,46,0,5.95,41.79,2982282,2982368
16768,97,26,0,5.28,20.37,2982368,2982465
16769,107,39,0,4.79,30.58,2982465,2982572
16770,62,25,1,8.26,36.58,2982571,2982633
16771,71,27,1,7.21,26.28,2982632,2982703
16772,78,30,0,6.56,24.09,2982702,2982780
16773,81,18,0,6.32,17.16,2982779,2982860
16774,64,44,0,8.00,63.94,2982860,2982924
16775,59,63,1,8.68,96.93,2982923,2982982
16776,77,29,1,6.65,24.64,2982981,2983058
16777,66,38,1,7.76,33.55,2983057,2983123
16778,47,86,1,10.89,149.37,2983122,2983169
16779,56,32,2,9.14,38.02,2983168,2983224
16780,72,22,1,7.11,18.63,2983224,2983296
16781,66,38,1,7.76,41.70,2983295,2983361
16782,64,27,2,8.00,23.47,2983360,2983424
16783,53,27,2,9.66,39.58,2983423,2983476
16784,52,34,0,9.85,43.48,2983475,2983527
16785,50,29,3,10.24,37.34,2983526,2983576
16786,61,41,1,8.39,45.55,2983575,2983636
16787,45,61,2,11.38,91.39,2983635,2983680
16788,66,26,1,7.76,24.94,2983679,2983745
16789,63,22,1,8.13,23.70,2983744,2983807
16790,44,79,1,11.64,139.32,2983806,2983850
16791,36,49,2,14.22,90.06,2983849,2983885
16792,53,62,1,9.66,117.21,2983884,2983937
16793,67,51,1,7.64,57.42,2983936,2984003
16794,48,108,1,10.67,257.68,2984002,2984050
16795,68,52,0,7.53,76.46,2984049,2984117
16796,68,30,1,7.53,34.78,2984116,2984184
16797,110,21,0,4.65,22.50,2984183,2984293
16798,99,23,0,5.17,20.77,2984292,2984391
16799,101,21,0,5.07,19.33,2984390,2984491
16800,62,25,1,8.26,26.71,2984490,2984552
16801,76,25,0,6.74,30.40,2984551,2984627
16802,72,32,1,7.11,27.18,2984626,2984698
16803,77,30,0,6.65,31.60,2984697,2984774
16804,60,80,1,8.53,104.55,2984773,2984833
16805,76,33,0,6.74,30.27,2984832,2984908
16806,69,24,1,7.42,25.84,2984907,2984976
16807,59,64,0,8.68,86.08,2984975,2985034
16808,54,30,1,9.48,37.36,2985033,2985087
16809,55,41,1,9.31,51.41,2985086,2985141
16810,59,45,0,8.68,52.56,2985140,2985199
16811,54,59,0,9.48,72.62,2985198,2985252
16812,62,25,1,8.26,28.84,2985252,2985314
16813,43,68,2,11.91,160.60,2985313,2985356
16814,68,40,0,7.53,42.57,2985355,2985423
16815,47,40,2,10.89,53.33,2985422,2985469
16816,37,50,1,13.84,105.92,2985469,2985506
16817,47,33,1,10.89,75.71,2985505,2985552
16818,64,47,1,8.00,53.22,2985551,2985615
16819,47,45,1,10.89,76.73,2985615,2985662
16820,51,56,2,10.04,92.70,2985661,2985712
16821,55,57,1,9.31,80.07,2985711,2985766
16822,41,161,2,12.49,578.74,2985765,2985806
16823,44,71,1,11.64,164.46,2985805,2985849
16824,61,48,1,8.39,63.42,2985848,2985909
16825,59,61,1,8.68,80.22,2985908,2985967
16826,50,31,0,10.24,55.86,2985966,2986016
16827,60,30,0,8.53,48.12,2986015,2986075
16828,46,63,0,11.13,119.37,2986074,2986120
16829,78,45,0,6.56,49.73,2986119,2986197
16830,97,24,0,5.28,23.11,2986196,2986293
16831,79,35,0,6.48,42.10,2986292,2986371
16832,80,47,0,6.40,63.79,2986370,2986450
16833,51,106,1,10.04,233.41,2986449,2986500
16834,74,33,0,6.92,27.59,2986499,2986573
16835,68,31,2,7.53,26.28,2986572,2986640
16836,80,32,0,6.40,23.09,2986639,2986719
16837,69,27,1,7.42,31.49,2986718,2986787
16838,71,29,1,7.21,24.76,2986787,2986858
16839,81,32,0,6.32,26.27,2986857,2986938
16840,54,48,1,9.48,89.25,2986937,2986991
16841,52,25,1,9.85,40.44,2986991,2987043
16842,51,28,2,10.04,33.02,2987042,2987093
16843,58,30,2,8.83,33.42,2987092,2987150
16844,48,74,2,10.67,120.10,2987149,2987197
16845,58,79,1,8.83,127.42,2987197,2987255
16846,46,59,0,11.13,141.07,2987254,2987300
16847,50,49,0,10.24,91.10,2987299,2987349
16848,64,28,1,8.00,25.47,2987348,2987412
16849,50,39,2,10.24,59.42,2987411,2987461
16850,59,32,1,8.68,33.47,2987460,2987519
16851,71,23,0,7.21,21.32,2987518,2987589
16852,60,52,2,8.53,60.55,2987588,2987648
16853,63,32,0,8.13,36.71,2987648,2987711
16854,63,26,1,8.13,30.40,2987710,2987773
16855,56,33,1,9.14,54.59,2987772,2987828
16856,60,53,1,8.53,97.62,2987827,2987887
16857,58,29,0,8.83,40.32,2987886,2987944
16858,63,43,1,8.13,53.48,2987943,2988006
16859,58,42,0,8.83,59.32,2988005,2988063
16860,55,50,0,9.31,86.50,2988062,2988117
16861,95,16,0,5.39,15.06,2988116,2988211
16862,95,34,0,5.39,32.55,2988210,2988305
16863,107,23,0,4.79,15.91,2988304,2988411
16864,63,64,2,8.13,85.16,2988410,2988473
16865,50,38,0,10.24,74.14,2988472,2988522
16866,89,32,0,5.75,20.61,2988521,2988610
16867,67,38,0,7.64,47.75,2988609,2988676
16868,62,43,0,8.26,56.51,2988675,2988737
16869,72,23,1,7.11,29.27,2988736,2988808
16870,51,71,1,10.04,120.39,2988807,2988858
16871,59,62,1,8.68,84.46,2988857,2988916
16872,61,27,1,8.39,35.09,2988915,2988976
16873,60,28,1,8.53,40.78,2988975,2989035
16874,53,59,1,9.66,111.92,2989034,2989087
16875,58,26,1,8.83,33.32,2989086,2989144
16876,64,44,0,8.00,44.75,2989143,2989207
16877,55,39,1,9.31,50.18,2989206,2989261
16878,45,49,2,11.38,96.95,2989260,2989305
16879,64,27,1,8.00,25.12,2989304,2989368
16880,57,23,1,8.98,21.63,2989367,2989424
16881,69,21,2,7.42,18.42,2989423,2989492
16882,45,67,1,11.38,169.70,2989491,2989536
16883,36,96,3,14.22,244.90,2989535,2989571
16884,54,38,2,9.48,57.69,2989570,2989624
16885,55,31,0,9.31,42.21,2989624,2989679
16886,50,79,1,10.24,141.38,2989678,2989728
16887,62,48,0,8.26,72.42,2989727,2989789
16888,62,25,0,8.26,34.45,2989788,2989850
16889,56,53,0,9.14,73.02,2989849,2989905
16890,59,30,1,8.68,61.27,2989904,2989963
16891,57,55,0,8.98,86.19,2989962,2990019
16892,77,52,0,6.65,47.34,2990018,2990095
16893,95,25,0,5.39,30.41,2990094,2990189
16894,91,33,0,5.63,38.78,2990188,2990279
16895,71,36,0,7.21,43.12,2990278,2990349
16896,79,39,0,6.48,27.67,2990348,2990427
16897,71,40,1,7.21,34.87,2990426,2990497
16898,69,99,1,7.42,142.59,2990496,2990565
16899,63,46,0,8.13,63.73,2990564,2990627
16900,83,26,0,6.17,22.72,2990626,2990709
16901,57,34,0,8.98,67.46,2990708,2990765
16902,48,93,0,10.67,190.97,2990764,2990812
16903,64,37,2,8.00,41.53,2990811,2990875
16904,67,26,0,7.64,24.14,2990874,2990941
16905,58,43,1,8.83,41.73,2990941,2990999
16906,54,62,0,9.48,70.62,2990998,2991052
16907,50,33,1,10.24,49.30,2991051,2991101
16908,51,50,2,10.04,83.25,2991100,2991151
16909,51,31,0,10.04,58.55,2991150,2991201
16910,58,38,2,8.83,33.94,2991200,2991258
16911,49,51,1,10.45,83.76,2991257,2991306
16912,66,29,2,7.76,19.58,2991305,2991371
16913,59,50,1,8.68,56.08,2991370,2991429
16914,59,60,1,8.68,66.15,2991428,2991487
16915,66,30,1,7.76,35.79,2991486,2991552
16916,28,80,1,18.29,304.06,2991551,2991579
16917,46,32,2,11.13,47.24,2991578,2991624
16918,53,54,0,9.66,92.87,2991623,2991676
16919,60,32,1,8.53,46.95,2991675,2991735
16920,77,26,0,6.65,28.64,2991734,2991811
16921,63,29,1,8.13,30.56,2991810,2991873
16922,55,37,0,9.31,71.70,2991872,2991927
16923,70,37,1,7.31,45.73,2991926,2991996
16924,84,28,0,6.10,27.13,2991995,2992079
16925,76,63,0,6.74,90.04,2992078,2992154
16926,77,44,0,6.65,41.81,2992153,2992230
16927,78,32,0,6.56,31.94,2992230,2992308
16928,72,27,1,7.11,27.65,2992307,2992379
16929,70,36,1,7.31,32.62,2992378,2992448
16930,77,28,0,6.65,23.97,2992447,2992524
16931,69,31,0,7.42,35.49,2992524,2992593
16932,78,48,1,6.56,36.94,2992592,2992670
16933,70,42,1,7.31,34.96,2992669,2992739
16934,66,19,0,7.76,20.55,2992738,2992804
16935,60,30,1,8.53,29.98,2992803,2992863
16936,54,35,1,9.48,50.73,2992862,2992916
16937,46,60,0,11.13,152.03,2992915,2992961
16938,60,25,1,8.53,26.48,2992960,2993020
16939,56,38,1,9.14,53.66,2993019,2993075
16940,59,32,1,8.68,35.88,2993074,2993133
16941,51,36,1,10.04,59.61,2993132,2993183
16942,42,49,2,12.19,74.01,2993182,2993224
16943,46,77,2,11.13,143.68,2993223,2993269
16944,50,23,1,10.24,38.14,2993268,2993318
16945,63,42,1,8.13,49.16,2993317,2993380
16946,57,25,1,8.98,32.30,2993379,2993436
16947,55,21,1,9.31,27.45,2993435,2993490
16948,61,35,1,8.39,35.98,2993489,2993550
16949,42,63,1,12.19,138.39,2993549,2993591
16950,60,65,0,8.53,105.12,2993590,2993650
16951,55,37,0,9.31,62.07,2993649,2993704
16952,49,51,0,10.45,103.15,2993703,2993752
16953,49,43,0,10.45,88.29,2993751,2993800
16954,61,29,1,8.39,39.45,2993799,2993860
16955,73,45,0,7.01,56.40,2993859,2993932
16956,95,42,0,5.39,30.72,2993931,2994026
16957,76,71,0,6.74,76.90,2994026,2994102
16958,105,48,0,4.88,40.95,2994101,2994206
16959,67,25,1,7.64,33.42,2994205,2994272
16960,75,28,0,6.83,27.98,2994271,2994346
16961,75,61,0,6.83,76.41,2994346,2994421
16962,69,42,0,7.42,57.26,2994420,2994489
16963,65,44,1,7.88,69.00,2994488,2994553
16964,60,53,1,8.53,64.22,2994552,2994612
16965,74,58,0,6.92,56.21,2994611,2994685
16966,46,52,1,11.13,93.94,2994684,2994730
16967,61,24,1,8.39,26.21,2994729,2994790
16968,54,26,1,9.48,39.69,2994789,2994843
16969,63,30,1,8.13,32.90,2994843,2994906
16970,58,50,1,8.83,55.04,2994905,2994963
16971,51,27,1,10.04,29.29,2994962,2995013
16972,63,20,0,8.13,19.29,2995013,2995076
16973,39,41,1,13.13,73.80,2995075,2995114
16974,53,45,2,9.66,57.85,2995113,2995166
16975,59,31,2,8.68,34.42,2995165,2995224
16976,60,72,1,8.53,99.88,2995223,2995283
16977,62,35,2,8.26,40.26,2995282,2995344
16978,54,35,1,9.48,57.51,2995343,2995397
16979,46,46,1,11.13,71.03,2995396,2995442
16980,50,31,0,10.24,40.02,2995441,2995491
16981,63,31,0,8.13,42.75,2995490,2995553
16982,72,67,0,7.11,75.52,2995552,2995624
16983,53,45,1,9.66,71.09,2995623,2995676
16984,55,29,1,9.31,45.63,2995675,2995730
16985,65,47,1,7.88,64.69,2995729,2995794
16986,70,23,0,7.31,28.76,2995794,2995864
16987,94,21,0,5.45,16.61,2995863,2995957
16988,75,38,0,6.83,50.06,2995956,2996031
16989,92,36,0,5.57,44.68,2996030,2996122
16990,61,38,1,8.39,82.14,2996122,2996183
16991,67,36,1,7.64,35.04,2996182,2996249
16992,78,27,1,6.56,28.35,2996248,2996326
16993,63,40,1,8.13,62.97,2996326,2996389
16994,67,61,1,7.64,73.93,2996388,2996455
16995,69,41,0,7.42,48.88,2996454,2996523
16996,76,32,1,6.74,34.59,2996522,2996598
16997,61,28,1,8.39,37.26,2996597,2996658
16998,40,94,1,12.80,277.06,2996657,2996697
16999,55,33,1,9.31,42.21,2996696,2996751
17000,59,50,1,8.68,60.35,2996750,2996809
17001,56,42,0,9.14,56.44,2996808,2996864
17002,60,27,1,8.53,32.68,2996863,2996923
17003,47,60,0,10.89,99.84,2996923,2996970
17004,63,27,1,8.13,29.09,2996969,2997032
17005,60,25,1,8.53,25.92,2997032,2997092
17006,45,30,1,11.38,57.39,2997092,2997137
17007,64,46,1,8.00,42.78,2997136,2997200
17008,57,40,0,8.98,36.23,2997199,2997256
17009,62,24,1,8.26,30.97,2997255,2997317
17010,44,117,1,11.64,333.64,2997316,2997360
17011,62,36,0,8.26,46.09,2997359,2997421
17012,36,78,2,14.22,250.34,2997420,2997456
17013,56,46,1,9.14,53.77,2997455,2997511
17014,70,38,0,7.31,35.27,2997510,2997580
17015,58,42,1,8.83,48.87,2997579,2997637
17016,66,34,0,7.76,50.67,2997636,2997702
17017,96,22,0,5.33,18.85,2997701,2997797
17018,65,42,0,7.88,65.43,2997796,2997861
17019,100,37,0,5.12,25.93,2997860,2997960
17020,84,52,0,6.10,63.37,2997960,2998044
17021,73,27,0,7.01,35.08,2998044,2998117
17022,74,25,1,6.92,26.94,2998116,2998190
17023,82,23,1,6.24,20.50,2998189,2998271
17024,70,26,1,7.31,22.10,2998270,2998340
17025,63,45,0,8.13,43.25,2998339,2998402
17026,89,25,0,5.75,18.30,2998401,2998490
17027,56,38,1,9.14,60.41,2998489,2998545
17028,58,34,1,8.83,54.94,2998544,2998602
17029,69,24,1,7.42,28.91,2998601,2998670
17030,57,33,1,8.98,37.60,2998670,2998727
17031,64,33,0,8.00,36.78,2998726,2998790
17032,53,52,1,9.66,95.32,2998789,2998842
17033,60,19,1,8.53,22.15,2998841,2998901
17034,50,33,0,10.24,41.30,2998900,2998950
17035,35,71,2,14.63,209.78,2998949,2998984
17036,46,35,1,11.13,63.42,2998983,2999029
17037,58,27,2,8.83,31.14,2999028,2999086
17038,58,42,1,8.83,63.80,2999085,2999143
17039,56,38,1,9.14,50.98,2999142,2999198
17040,55,68,0,9.31,95.49,2999197,2999252
17041,51,42,2,10.04,64.82,2999251,2999302
17042,41,61,1,12.49,134.15,2999301,2999342
17043,51,52,0,10.04,109.53,2999341,2999392
17044,48,31,1,10.67,51.72,2999391,2999439
17045,61,46,1,8.39,64.70,2999438,2999499
17046,51,78,0,10.04,120.08,2999498,2999549
17047,51,31,0,10.04,56.63,2999548,2999599
17048,58,49,1,8.83,76.69,2999598,2999656
17049,58,54,0,8.83,95.66,2999655,2999713
17050,66,61,0,7.76,90.34,2999713,2999779
17051,81,31,0,6.32,43.50,2999778,2999859
17052,74,57,0,6.92,58.97,2999858,2999932
17053,81,47,0,6.32,43.23,2999932,3000013
17054,75,19,1,6.83,18.17,3000012,3000087
17055,76,35,1,6.74,27.88,3000087,3000163
17056,82,35,0,6.24,33.04,3000162,3000244
17057,72,35,1,7.11,31.85,3000243,3000315
17058,82,29,1,6.24,25.57,3000315,3000397
17059,67,31,0,7.64,28.95,3000396,3000463
17060,70,25,0,7.31,25.13,3000463,3000533
17061,50,64,1,10.24,124.90,3000532,3000582
17062,64,45,1,8.00,48.22,3000581,3000645
17063,61,28,1,8.39,30.30,3000644,3000705
17064,59,36,1,8.68,36.66,3000704,3000763
17065,48,28,1,10.67,48.85,3000762,3000810
17066,59,32,0,8.68,37.57,3000809,3000868
17067,45,45,3,11.38,62.81,3000867,3000912
17068,48,27,1,10.67,47.72,3000911,3000959
17069,52,31,1,9.85,36.90,3000958,3001010
17070,66,24,1,7.76,24.85,3001009,3001075
17071,58,44,0,8.83,62.94,3001074,3001132
17072,58,33,0,8.83,38.94,3001131,3001189
17073,65,21,1,7.88,20.20,3001189,3001254
17074,59,40,0,8.68,63.68,3001253,3001312
17075,65,27,1,7.88,34.35,3001311,3001376
17076,48,43,0,10.67,90.18,3001375,3001423
17077,56,32,0,9.14,53.09,3001422,3001478
17078,59,35,1,8.68,40.52,3001477,3001536
17079,63,35,0,8.13,47.06,3001536,3001599
17080,84,27,0,6.10,20.28,3001598,3001682
17081,89,26,0,5.75,30.82,3001682,3001771
17082,97,31,0,5.28,35.48,3001770,3001867
17083,64,46,1,8.00,64.25,3001866,3001930
17084,84,19,1,6.10,17.16,3001929,3002013
17085,62,38,1,8.26,53.80,3002012,3002074
17086,76,23,0,6.74,25.17,3002073,3002149
17087,70,26,1,7.31,31.02,3002148,3002218
17088,72,39,0,7.11,31.24,3002218,3002290
17089,79,27,0,6.48,22.93,3002289,3002368
17090,60,25,0,8.53,34.72,3002367,3002427
17091,48,33,0,10.67,56.81,3002426,3002474
17092,54,50,0,9.48,76.25,3002473,3002527
17093,59,34,0,8.68,49.78,3002527,3002586
17094,48,55,2,10.67,86.68,3002586,3002634
17095,61,21,1,8.39,15.65,3002633,3002694
17096,64,17,0,8.00,17.72,3002693,3002757
17097,56,34,0,9.14,42.80,3002756,3002812
17098,51,51,1,10.04,68.82,3002811,3002862
17099,45,50,0,11.38,99.44,3002861,3002906
17100,53,24,1,9.66,34.34,3002906,3002959
17101,52,53,1,9.85,75.17,3002958,3003010
17102,61,29,1,8.39,34.80,3003009,3003070
17103,46,151,2,11.13,469.64,3003070,3003116
17104,52,48,1,9.85,61.90,3003115,3003167
17105,37,90,1,13.84,226.19,3003166,3003203
17106,70,36,1,7.31,33.67,3003202,3003272
17107,58,38,1,8.83,50.87,3003271,3003329
17108,52,34,1,9.85,40.21,3003328,3003380
17109,59,37,0,8.68,68.29,3003380,3003439
17110,80,21,1,6.40,26.44,3003438,3003518
17111,109,38,0,4.70,32.54,3003517,3003626
17112,83,41,0,6.17,29.08,3003625,3003708
17113,94,30,0,5.45,36.42,3003707,3003801
17114,79,22,0,6.48,16.02,3003801,3003880
17115,75,56,1,6.83,41.34,3003879,3003954
17116,75,34,1,6.83,35.72,3003953,3004028
17117,65,46,1,7.88,39.98,3004027,3004092
17118,65,79,0,7.88,108.60,3004092,3004157
17119,69,33,0,7.42,41.87,3004156,3004225
17120,58,77,0,8.83,108.76,3004224,3004282
17121,79,30,1,6.48,23.92,3004281,3004360
17122,52,55,1,9.85,95.82,3004359,3004411
17123,59,35,0,8.68,48.73,3004410,3004469
17124,64,46,1,8.00,43.75,3004468,3004532
17125,56,28,2,9.14,39.62,3004531,3004587
17126,62,21,0,8.26,27.32,3004586,3004648
17127,51,44,1,10.04,72.74,3004647,3004698
17128,52,70,2,9.85,96.78,3004697,3004749
17129,54,39,2,9.48,53.77,3004749,3004803
17130,67,26,0,7.64,21.81,3004802,3004869
17131,45,56,2,11.38,108.37,3004868,3004913
17132,59,32,1,8.68,37.74,3004912,3004971
17133,68,33,0,7.53,33.31,3004970,3005038
17134,28,50,2,18.29,213.13,3005037,3005065
17135,41,58,3,12.49,135.42,3005064,3005105
17136,61,47,1,8.39,68.47,3005104,3005165
17137,58,44,0,8.83,63.94,3005164,3005222
17138,50,37,1,10.24,67.98,3005221,3005271
17139,56,59,1,9.14,75.30,3005270,3005326
17140,61,51,0,8.39,66.50,3005325,3005386
17141,58,31,1,8.83,44.66,3005385,3005443
17142,52,116,0,9.85,327.82,3005443,3005495
17143,121,21,0,4.23,16.43,3005494,3005615
17144,52,78,0,9.85,179.05,3005615,3005667
17145,103,29,0,4.97,19.29,3005667,3005770
17146,74,23,0,6.92,26.24,3005769,3005843
17147,62,26,1,8.26,36.58,3005842,3005904
17148,76,37,0,6.74,38.59,3005903,3005979
17149,80,22,0,6.40,21.44,3005978,3006058
17150,82,27,0,6.24,27.33,3006058,3006140
17151,77,39,0,6.65,33.21,3006140,3006217
17152,74,27,0,6.92,26.67,3006216,3006290
17153,46,54,1,11.13,84.07,3006289,3006335
17154,52,59,1,9.85,107.55,3006334,3006386
17155,57,28,1,8.98,32.54,3006386,3006443
17156,65,19,2,7.88,17.18,3006442,3006507
17157,55,47,2,9.31,47.78,3006507,3006562
17158,52,53,2,9.85,82.28,3006561,3006613
17159,55,70,1,9.31,112.43,3006612,3006667
17160,54,27,2,9.48,38.51,3006666,3006720
17161,51,106,1,10.04,215.21,3006719,3006770
17162,51,44,1,10.04,82.39,3006770,3006821
17163,55,32,0,9.31,48.54,3006820,3006875
17164,61,37,0,8.39,43.98,3006874,3006935
17165,62,30,0,8.26,30.87,3006934,3006996
17166,65,20,2,7.88,19.49,3006995,3007060
17167,56,26,1,9.14,36.91,3007059,3007115
17168,47,146,1,10.89,427.63,3007114,3007161
17169,53,63,0,9.66,148.53,3007160,3007213
17170,50,49,0,10.24,101.86,3007212,3007262
17171,73,32,0,7.01,43.55,3007261,3007334
17172,89,23,0,5.75,21.06,3007334,3007423
17173,84,27,0,6.10,38.42,3007422,3007506
17174,66,23,1,7.76,28.46,3007505,3007571
17175,106,49,0,4.83,46.48,3007570,3007676
17176,61,29,0,8.39,28.50,3007675,3007736
17177,74,57,0,6.92,59.78,3007735,3007809
17178,77,31,1,6.65,24.20,3007808,3007885
17179,74,23,1,6.92,29.10,3007885,3007959
17180,71,42,1,7.21,32.76,3007959,3008030
17181,60,37,0,8.53,51.08,3008029,3008089
17182,72,38,0,7.11,51.35,3008088,3008160
17183,76,29,0,6.74,27.69,3008159,3008235
17184,67,26,0,7.64,32.68,3008234,3008301
17185,47,75,2,10.89,132.56,3008300,3008347
17186,55,40,0,9.31,55.27,3008346,3008401
17187,57,27,1,8.98,37.70,3008400,3008457
17188,55,37,1,9.31,40.47,3008456,3008511
17189,50,53,2,10.24,69.74,3008510,3008560
17190,44,49,1,11.64,85.37,3008559,3008603
17191,56,33,0,9.14,35.05,3008602,3008658
17192,61,36,2,8.39,36.11,3008657,3008718
17193,58,41,0,8.83,48.18,3008717,3008775
17194,55,32,0,9.31,40.18,3008775,3008830
17195,28,116,1,18.29,493.20,3008829,3008857
17196,81,22,0,6.32,25.65,3008856,3008937
17197,64,27,1,8.00,30.22,3008936,3009000
17198,57,35,0,8.98,59.81,3008999,3009056
17199,49,26,1,10.45,43.31,3009055,3009104
17200,50,57,0,10.24,91.66,3009103,3009153
17201,81,53,0,6.32,49.01,3009152,3009233
17202,105,21,0,4.88,19.38,3009232,3009337
17203,83,29,0,6.17,22.65,3009336,3009419
17204,68,39,1,7.53,43.84,3009419,3009487
17205,72,45,0,7.11,46.68,3009486,3009558
17206,75,27,1,6.83,22.86,3009557,3009632
17207,75,34,0,6.83,31.00,3009631,3009706
17208,68,26,1,7.53,28.98,3009705,3009773
17209,57,45,1,8.98,61.53,3009772,3009829
17210,55,50,1,9.31,51.81,3009828,3009883
17211,52,62,1,9.85,93.75,3009883,3009935
17212,57,45,1,8.98,49.98,3009934,3009991
17213,63,26,1,8.13,26.24,3009991,3010054
17214,55,32,2,9.31,43.05,3010053,3010108
17215,46,69,1,11.13,114.37,3010108,3010154
17216,48,38,3,10.67,44.18,3010153,3010201
17217,57,19,1,8.98,18.47,3010200,3010257
17218,65,28,0,7.88,32.23,3010256,3010321
17219,48,47,1,10.67,71.31,3010320,3010368
17220,48,104,1,10.67,217.14,3010367,3010415
17221,55,63,0,9.31,89.41,3010414,3010469
17222,46,51,2,11.13,89.29,3010468,3010514
17223,30,170,2,17.07,895.66,3010513,3010543
17224,70,25,0,7.31,32.39,3010542,3010612
17225,63,50,0,8.13,51.63,3010611,3010674
17226,58,34,1,8.83,40.73,3010673,3010731
17227,50,57,0,10.24,96.82,3010731,3010781
17228,49,43,0,10.45,106.74,3010780,3010829
17229,63,36,0,8.13,50.84,3010828,3010891
17230,79,34,0,6.48,48.25,3010890,3010969
17231,91,61,0,5.63,55.88,3010968,3011059
17232,101,20,0,5.07,20.42,3011058,3011159
17233,73,24,0,7.01,27.08,3011158,3011231
17234,66,30,0,7.76,38.79,3011230,3011296
17235,57,25,1,8.98,44.05,3011295,3011352
17236,74,34,0,6.92,38.26,3011351,3011425
17237,72,34,1,7.11,29.46,3011424,3011496
17238,73,39,0,7.01,33.58,3011495,3011568
17239,69,27,1,7.42,29.95,3011567,3011636
17240,73,36,0,7.01,37.79,3011635,3011708
17241,58,29,0,8.83,45.73,3011708,3011766
17242,40,93,0,12.80,248.16,3011765,3011805
17243,57,21,0,8.98,24.16,3011804,3011861
17244,59,47,0,8.68,58.42,3011860,3011919
17245,61,28,1,8.39,37.78,3011919,3011980
17246,51,62,0,10.04,98.98,3011979,3012030
17247,48,32,0,10.67,56.31,3012029,3012077
17248,48,56,1,10.67,79.68,3012076,3012124
17249,43,47,2,11.91,78.83,3012123,3012166
17250,50,49,1,10.24,58.02,3012165,3012215
17251,39,114,2,13.13,337.34,3012214,3012253
17252,50,86,1,10.24,150.54,3012252,3012302
17253,61,22,2,8.39,17.03,3012301,3012362
17254,56,113,1,9.14,234.48,3012361,3012417
17255,45,48,2,11.38,91.92,3012416,3012461
17256,47,54,1,10.89,125.92,3012460,3012507
17257,71,37,0,7.21,46.96,3012506,3012577
17258,61,38,0,8.39,40.86,3012576,3012637
17259,58,38,1,8.83,56.63,3012636,3012694
17260,63,49,0,8.13,51.60,3012693,3012756
17261,68,29,0,7.53,40.07,3012755,3012823
17262,67,92,0,7.64,152.89,3012822,3012889
17263,80,85,0,6.40,111.39,3012888,3012968
17264,76,28,0,6.74,34.61,3012967,3013043
17265,71,49,0,7.21,104.28,3013042,3013113
17266,67,24,1,7.64,25.13,3013113,3013180
17267,66,34,1,7.76,48.73,3013179,3013245
17268,58,55,1,8.83,100.42,3013244,3013302
17269,70,67,0,7.31,70.87,3013302,3013372
17270,64,24,0,8.00,38.06,3013371,3013435
17271,72,40,1,7.11,32.57,3013434,3013506
17272,79,45,1,6.48,46.12,3013505,3013584
17273,56,34,0,9.14,45.59,3013583,3013639
17274,56,24,1,9.14,30.44,3013639,3013695
17275,52,32,0,9.85,51.98,3013695,3013747
17276,49,32,2,10.45,54.37,3013746,3013795
17277,62,53,1,8.26,58.42,3013794,3013856
17278,54,23,1,9.48,22.32,3013855,3013909
17279,44,46,2,11.64,132.55,3013908,3013952
17280,45,37,1,11.38,58.77,3013951,3013996
17281,43,47,3,11.91,85.99,3013995,3014038
17282,38,38,3,13.47,81.30,3014038,3014076
17283,46,33,2,11.13,60.11,3014075,3014121
17284,55,25,2,9.31,37.38,3014120,3014175
17285,63,20,1,8.13,16.30,3014175,3014238
17286,62,25,0,8.26,25.84,3014237,3014299
17287,65,47,0,7.88,62.75,3014298,3014363
17288,41,46,1,12.49,70.59,3014362,3014403
17289,30,141,2,17.07,688.46,3014402,3014432
17290,55,60,0,9.31,90.69,3014431,3014486
17291,61,39,0,8.39,50.47,3014485,3014546
17292,45,45,1,11.38,77.66,3014545,3014590
17293,60,28,1,8.53,39.85,3014589,3014649
17294,59,57,0,8.68,80.22,3014648,3014707
17295,57,37,0,8.98,76.23,3014706,3014763
17296,85,27,0,6.02,26.28,3014762,3014847
17297,85,45,0,6.02,50.28,3014846,3014931
17298,87,28,0,5.89,30.35,3014930,3015017
17299,65,70,0,7.88,97.65,3015016,3015081
17300,85,22,0,6.02,18.54,3015080,3015165
17301,79,30,1,6.48,29.90,3015164,3015243
17302,60,59,1,8.53,100.18,3015242,3015302
17303,61,54,1,8.39,82.83,3015301,3015362
17304,77,20,0,6.65,20.80,3015361,3015438
17305,77,31,0,6.65,23.01,3015438,3015515
17306,65,73,0,7.88,136.69,3015514,3015579
17307,65,23,0,7.88,24.57,3015578,3015643
17308,69,27,0,7.42,26.07,3015642,3015711
17309,51,35,2,10.04,54.82,3015710,3015761
17310,54,53,0,9.48,92.66,3015760,3015814
17311,58,29,2,8.83,27.87,3015813,3015871
17312,53,28,0,9.66,35.96,3015870,3015923
17313,44,57,3,11.64,106.41,3015922,3015966
17314,61,27,1,8.39,24.63,3015965,3016026
17315,42,60,2,12.19,114.68,3016025,3016067
17316,51,42,0,10.04,53.17,3016066,3016117
17317,63,22,1,8.13,25.29,3016116,3016179
17318,65,26,1,7.88,28.88,3016178,3016243
17319,61,26,1,8.39,25.35,3016242,3016303
17320,53,44,2,9.66,57.05,3016302,3016355
17321,54,82,1,9.48,144.95,3016354,3016408
17322,56,37,1,9.14,57.48,3016407,3016463
17323,42,48,1,12.19,132.63,3016462,3016504
17324,70,27,0,7.31,27.53,3016503,3016573
17325,56,54,0,9.14,80.19,3016572,3016628
17326,69,43,0,7.42,49.87,3016627,3016696
17327,88,24,0,5.82,25.35,3016696,3016784
17328,112,24,0,4.57,20.35,3016783,3016895
17329,81,26,0,6.32,27.80,3016894,3016975
17330,72,38,0,7.11,38.74,3016974,3017046
17331,69,34,1,7.42,36.30,3017045,3017114
17332,64,36,1,8.00,51.06,3017113,3017177
17333,71,33,1,7.21,31.97,3017176,3017247
17334,75,21,0,6.83,24.28,3017247,3017322
17335,66,29,1,7.76,29.21,3017321,3017387
17336,75,18,1,6.83,13.98,3017386,3017461
17337,62,43,0,8.26,64.03,3017460,3017522
17338,47,46,1,10.89,88.69,3017521,3017568
17339,65,47,0,7.88,47.06,3017567,3017632
17340,64,38,1,8.00,38.66,3017631,3017695
17341,55,80,1,9.31,123.30,3017694,3017749
17342,57,64,0,8.98,83.77,3017748,3017805
17343,56,38,0,9.14,55.44,3017804,3017860
17344,40,95,3,12.80,255.41,3017859,3017899
17345,53,30,1,9.66,33.88,3017899,3017952
17346,46,39,1,11.13,68.03,3017951,3017997
17347,57,78,1,8.98,117.46,3017996,3018053
17348,57,45,1,8.98,50.44,3018052,3018109
17349,53,24,1,9.66,40.41,3018108,3018161
17350,55,61,0,9.31,91.27,3018160,3018215
17351,58,38,1,8.83,45.80,3018214,3018272
17352,43,43,1,11.91,90.46,3018271,3018314
17353,50,52,1,10.24,101.54,3018314,3018364
17354,51,97,0,10.04,228.00,3018363,3018414
17355,97,21,0,5.28,20.12,3018413,3018510
17356,78,37,0,6.56,55.25,3018509,3018587
17357,87,48,0,5.89,56.49,3018586,3018673
17358,79,31,0,6.48,31.01,3018672,3018751
17359,58,50,1,8.83,82.94,3018750,3018808
17360,53,88,1,9.66,147.92,3018807,3018860
17361,65,45,0,7.88,47.22,3018859,3018924
17362,67,36,0,7.64,44.86,3018923,3018990
17363,59,37,1,8.68,57.17,3018989,3019048
17364,69,29,1,7.42,35.81,3019047,3019116
17365,51,31,0,10.04,36.90,3019115,3019166
17366,48,65,1,10.67,90.85,3019165,3019213
17367,62,34,1,8.26,35.09,3019212,3019274
17368,56,72,1,9.14,102.66,3019273,3019329
17369,57,64,1,8.98,86.19,3019328,3019385
17370,48,46,1,10.67,99.93,3019384,3019432
17371,55,38,2,9.31,55.12,3019431,3019486
17372,51,28,1,10.04,27.37,3019485,3019536
17373,39,72,2,13.13,140.83,3019535,3019574
17374,57,27,1,8.98,33.60,3019573,3019630
17375,55,51,0,9.31,69.67,3019629,3019684
17376,62,27,0,8.26,22.90,3019683,3019745
17377,58,26,2,8.83,25.97,3019744,3019802
17378,62,22,1,8.26,30.29,3019801,3019863
17379,26,76,2,19.69,369.83,3019862,3019888
17380,51,91,1,10.04,178.04,3019887,3019938
17381,52,53,0,9.85,77.98,3019937,3019989
17382,52,40,0,9.85,65.86,3019988,3020040
17383,50,26,2,10.24,45.86,3020039,3020089
17384,68,30,0,7.53,29.96,3020088,3020156
17385,62,37,0,8.26,53.22,3020155,3020217
17386,86,22,0,5.95,21.16,3020216,3020302
17387,88,33,0,5.82,31.17,3020301,3020389
17388,89,40,0,5.75,45.62,3020388,3020477
17389,80,27,0,6.40,34.77,3020476,3020556
17390,59,46,0,8.68,69.03,3020555,3020614
17391,81,22,0,6.32,16.56,3020613,3020694
17392,84,21,0,6.10,17.61,3020694,3020778
17393,79,25,0,6.48,17.34,3020778,3020857
17394,74,41,0,6.92,36.40,3020856,3020930
17395,79,26,0,6.48,20.12,3020929,3021008
17396,72,30,1,7.11,26.93,3021007,3021079
17397,60,72,2,8.53,87.45,3021078,3021138
17398,53,77,1,9.66,117.09,3021137,3021190
17399,56,33,1,9.14,42.52,3021189,3021245
17400,58,36,1,8.83,49.97,3021244,3021302
17401,59,27,0,8.68,36.05,3021301,3021360
17402,55,37,0,9.31,49.01,3021359,3021414
17403,51,31,2,10.04,50.51,3021413,3021464
17404,58,21,0,8.83,22.59,3021463,3021521
17405,48,29,1,10.67,54.26,3021520,3021568
17406,50,58,1,10.24,115.70,3021567,3021617
17407,56,26,1,9.14,34.62,3021616,3021672
17408,58,24,3,8.83,24.25,3021671,3021729
17409,48,70,3,10.67,103.35,3021728,3021776
17410,57,37,0,8.98,51.00,3021775,3021832
17411,49,32,2,10.45,53.19,3021831,3021880
17412,58,60,0,8.83,102.42,3021879,3021937
17413,62,23,0,8.26,33.06,3021937,3021999
17414,43,63,1,11.91,119.57,3021998,3022041
17415,53,50,1,9.66,82.22,3022040,3022093
17416,57,42,0,8.98,69.03,3022092,3022149
17417,77,32,0,6.65,40.12,3022148,3022225
17418,82,34,0,6.24,34.04,3022224,3022306
17419,79,34,0,6.48,50.58,3022305,3022384
17420,75,94,0,6.83,128.22,3022383,3022458
17421,89,20,0,5.75,16.16,3022457,3022546
17422,65,57,1,7.88,72.63,3022545,3022610
17423,62,43,1,8.26,49.32,3022609,3022671
17424,87,73,1,5.89,67.30,3022670,3022757
17425,73,33,0,7.01,29.36,3022756,3022829
17426,70,77,0,7.31,93.93,3022828,3022898
17427,79,36,1,6.48,31.77,3022897,3022976
17428,60,70,1,8.53,94.98,3022975,3023035
17429,63,44,0,8.13,41.44,3023034,3023097
17430,56,46,0,9.14,42.87,3023096,3023152
17431,48,33,1,10.67,56.64,3023152,3023200
17432,62,30,2,8.26,33.84,3023199,3023261
17433,53,39,2,9.66,56.41,3023260,3023313
17434,49,48,2,10.45,58.86,3023313,3023362
17435,51,34,2,10.04,48.00,3023361,3023412
17436,56,44,1,9.14,54.91,3023411,3023467
17437,48,47,3,10.67,54.39,3023466,3023514
17438,51,23,1,10.04,24.98,3023514,3023565
17439,65,25,1,7.88,21.18,3023564,3023629
17440,57,30,1,8.98,33.81,3023628,3023685
17441,57,29,1,8.98,32.05,3023684,3023741
17442,60,29,1,8.53,38.22,3023740,3023800
17443,51,44,1,10.04,56.90,3023799,3023850
17444,58,46,1,8.83,57.32,3023849,3023907
17445,67,29,0,7.64,31.66,3023906,3023973
17446,53,33,1,9.66,52.34,3023972,3024025
17447,61,33,0,8.39,41.78,3024024,3024085
17448,54,51,2,9.48,101.43,3024084,3024138
17449,64,35,0,8.00,43.03,3024137,3024201
17450,94,28,0,5.45,31.91,3024200,3024294
17451,87,26,0,5.89,25.99,3024293,3024380
17452,101,17,0,5.07,14.70,3024380,3024481
17453,75,22,0,6.83,23.29,3024480,3024555
17454,65,30,0,7.88,27.49,3024554,3024619
17455,63,54,1,8.13,62.05,3024618,3024681
17456,67,20,1,7.64,16.29,3024680,3024747
17457,66,41,1,7.76,44.85,3024746,3024812
17458,61,70,0,8.39,106.66,3024811,3024872
17459,66,62,1,7.76,64.18,3024871,3024937
17460,52,62,1,9.85,129.05,3024936,3024988
17461,51,43,1,10.04,62.08,3024988,3025039
17462,62,28,0,8.26,33.87,3025038,3025100
17463,48,54,1,10.67,104.76,3025099,3025147
17464,71,29,1,7.21,19.29,3025146,3025217
17465,61,31,0,8.39,35.91,3025216,3025277
17466,60,30,2,8.53,34.75,3025276,3025336
17467,38,50,4,13.47,82.57,3025335,3025373
17468,51,57,0,10.04,100.23,3025373,3025424
17469,53,35,1,9.66,48.15,3025423,3025476
17470,46,41,1,11.13,57.94,3025475,3025521
17471,48,52,1,10.67,85.64,3025520,3025568
17472,71,26,0,7.21,21.38,3025567,3025638
17473,49,88,0,10.45,158.98,3025637,3025686
17474,51,61,0,10.04,87.53,3025685,3025736
17475,64,24,1,8.00,26.91,3025735,3025799
17476,57,35,1,8.98,46.75,3025798,3025855
17477,65,25,1,7.88,30.51,3025855,3025920
17478,61,39,1,8.39,52.34,3025920,3025981
17479,50,78,0,10.24,229.10,3025980,3026030
17480,58,54,0,8.83,99.52,3026029,3026087
17481,54,38,1,9.48,73.84,3026087,3026141
17482,73,41,0,7.01,47.79,3026140,3026213
17483,79,53,0,6.48,61.39,3026212,3026291
17484,73,35,0,7.01,41.85,3026290,3026363
17485,85,28,0,6.02,34.56,3026362,3026447
17486,78,36,0,6.56,32.12,3026446,3026524
17487,71,55,0,7.21,49.24,3026523,3026594
17488,64,32,1,8.00,41.84,3026593,3026657
17489,76,26,1,6.74,26.17,3026656,3026732
17490,67,41,1,7.64,61.42,3026731,3026798
17491,80,31,0,6.40,25.01,3026797,3026877
17492,76,37,1,6.74,34.17,3026876,3026952
17493,44,95,0,11.64,233.28,3026951,3026995
17494,66,40,0,7.76,48.85,3026994,3027060
17495,58,34,0,8.83,41.90,3027059,3027117
17496,53,31,0,9.66,50.90,3027116,3027169
17497,54,46,2,9.48,52.84,3027168,3027222
17498,49,46,2,10.45,72.70,3027221,3027270
17499,55,34,0,9.31,50.00,3027269,3027324
17500,64,43,0,8.00,43.22,3027323,3027387
17501,59,41,0,8.68,57.95,3027386,3027445
17502,44,58,1,11.64,79.96,3027444,3027488
17503,51,43,0,10.04,70.23,3027487,3027538
17504,59,23,1,8.68,18.79,3027537,3027596
17505,60,27,2,8.53,31.52,3027595,3027655
17506,63,23,2,8.13,18.14,3027655,3027718
17507,55,44,1,9.31,61.30,3027717,3027772
17508,45,46,1,11.38,85.39,3027771,3027816
17509,56,54,0,9.14,77.55,3027815,3027871
17510,66,54,0,7.76,75.61,3027870,3027936
17511,52,36,1,9.85,49.67,3027935,3027987
17512,56,30,1,9.14,45.44,3027986,3028042
17513,46,52,1,11.13,119.11,3028041,3028087
17514,68,23,1,7.53,31.04,3028087,3028155
17515,128,16,0,4.00,12.02,3028154,3028282
17516,76,35,0,6.74,48.27,3028281,3028357
17517,102,27,0,5.02,19.04,3028356,3028458
17518,63,64,1,8.13,118.24,3028457,3028520
17519,68,21,0,7.53,17.19,3028519,3028587
17520,69,25,1,7.42,21.35,3028587,3028656
17521,75,18,1,6.83,13.42,3028655,3028730
17522,72,21,1,7.11,22.27,3028729,3028801
17523,82,18,0,6.24,18.14,3028800,3028882
17524,68,29,0,7.53,33.54,3028881,3028949
17525,59,30,1,8.68,40.93,3028948,3029007
17526,45,55,2,11.38,79.79,3029006,3029051
17527,59,30,1,8.68,25.47,3029050,3029109
17528,62,47,0,8.26,60.84,3029108,3029170
17529,56,27,1,9.14,36.62,3029169,3029225
17530,48,68,1,10.67,141.64,3029224,3029272
17531,55,32,0,9.31,48.03,3029271,3029326
17532,46,36,0,11.13,68.42,3029325,3029371
17533,46,40,1,11.13,87.90,3029370,3029416
17534,55,42,1,9.31,57.60,3029415,3029470
17535,51,25,1,10.04,36.47,3029469,3029520
17536,60,29,1,8.53,39.02,3029519,3029579
17537,65,22,0,7.88,27.83,3029579,3029644
17538,47,46,1,10.89,85.46,3029643,3029690
17539,44,80,1,11.64,159.28,3029689,3029733
17540,45,52,1,11.38,109.66,3029732,3029777
17541,74,26,0,6.92,22.86,3029777,3029851
17542,57,39,1,8.98,49.77,3029850,3029907
17543,52,60,0,9.85,112.67,3029907,3029959
17544,52,76,0,9.85,133.48,3029958,3030010
17545,56,76,0,9.14,123.84,3030009,3030065
17546,86,22,0,5.95,28.65,3030064,3030150
17547,104,36,0,4.92,24.49,3030149,3030253
17548,79,41,0,6.48,53.29,3030253,3030332
17549,75,41,0,6.83,44.65,3030331,3030406
17550,75,68,0,6.83,67.18,3030405,3030480
17551,75,21,0,6.83,23.69,3030479,3030554
17552,62,66,0,8.26,109.55,3030553,3030615
17553,67,33,1,7.64,45.78,3030614,3030681
17554,62,45,1,8.26,67.90,3030680,3030742
17555,72,26,1,7.11,32.27,3030742,3030814
17556,89,34,1,5.75,19.13,3030814,3030903
17557,69,55,0,7.42,48.45,3030903,3030972
17558,46,53,1,11.13,84.29,3030971,3031017
17559,60,59,1,8.53,71.38,3031016,3031076
17560,62,66,0,8.26,78.16,3031075,3031137
17561,57,46,1,8.98,54.89,3031136,3031193
17562,55,34,2,9.31,29.78,3031192,3031247
17563,47,45,1,10.89,71.97,3031246,3031293
17564,59,35,1,8.68,34.63,3031292,3031351
17565,45,35,3,11.38,59.79,3031350,3031395
17566,58,47,1,8.83,41.28,3031395,3031453
17567,61,52,1,8.39,56.14,3031452,3031513
17568,58,34,2,8.83,33.45,3031512,3031570
17569,54,26,1,9.48,36.36,3031569,3031623
17570,50,34,2,10.24,50.30,3031622,3031672
17571,61,41,1,8.39,53.29,3031671,3031732
17572,67,46,0,7.64,61.81,3031731,3031798
17573,70,33,0,7.31,34.27,3031797,3031867
17574,48,33,0,10.67,65.64,3031866,3031914
17575,67,43,0,7.64,62.02,3031913,3031980
17576,64,31,0,8.00,40.84,3031979,3032043
17577,75,35,0,6.83,40.33,3032042,3032117
17578,88,54,0,5.82,50.33,3032116,3032204
17579,67,31,0,7.64,49.78,3032203,3032270
17580,91,56,0,5.63,48.70,3032270,3032361
17581,54,56,0,9.48,82.69,3032361,3032415
17582,70,77,1,7.31,90.96,3032415,3032485
17583,45,62,2,11.38,143.12,3032485,3032530
17584,73,21,1,7.01,20.04,3032529,3032602
17585,69,26,0,7.42,33.72,3032601,3032670
17586,67,47,0,7.64,73.45,3032669,3032736
17587,65,32,1,7.88,36.14,3032735,3032800
17588,85,24,0,6.02,17.01,3032799,3032884
17589,68,50,0,7.53,44.04,3032884,3032952
17590,55,52,1,9.31,78.94,3032951,3033006
17591,39,111,2,13.13,299.80,3033005,3033044
17592,50,39,1,10.24,60.82,3033043,3033093
17593,62,26,0,8.26,31.80,3033092,3033154
17594,62,38,1,8.26,42.64,3033153,3033215
17595,47,31,0,10.89,43.80,3033214,3033261
17596,46,46,2,11.13,93.85,3033260,3033306
17597,51,43,2,10.04,62.94,3033305,3033356
17598,41,84,1,12.49,167.52,3033355,3033396
17599,44,120,1,11.64,302.37,3033395,3033439
17600,54,45,1,9.48,55.77,3033438,3033492
17601,60,33,1,8.53,28.95,3033491,3033551
17602,47,85,2,10.89,176.31,3033550,3033597
17603,62,55,1,8.26,58.61,3033596,3033658
17604,41,57,2,12.49,114.54,3033657,3033698
17605,56,39,0,9.14,59.12,3033697,3033753
17606,63,34,0,8.13,41.32,3033753,3033816
17607,50,29,1,10.24,60.26,3033816,3033866
17608,64,28,1,8.00,38.09,3033865,3033929
17609,75,22,0,6.83,30.52,3033928,3034003
17610,76,28,0,6.74,24.75,3034002,3034078
17611,98,20,0,5.22,21.99,3034078,3034176
17612,96,41,0,5.33,34.18,3034175,3034271
17613,81,58,0,6.32,112.39,3034271,3034352
17614,65,34,0,7.88,32.23,3034351,3034416
17615,75,29,0,6.83,25.85,3034416,3034491
17616,83,29,1,6.17,28.57,3034490,3034573
17617,72,75,0,7.11,82.74,3034572,3034644
17618,86,17,1,5.95,13.67,3034643,3034729
17619,80,34,1,6.40,25.29,3034728,3034808
17620,58,34,1,8.83,55.63,3034807,3034865
17621,44,43,1,11.64,70.50,3034864,3034908
17622,56,40,0,9.14,61.30,3034908,3034964
17623,52,49,0,9.85,72.17,3034963,3035015
17624,62,34,1,8.26,41.39,3035014,3035076
17625,45,40,1,11.38,72.86,3035075,3035120
17626,54,34,1,9.48,44.06,3035119,3035173
17627,55,31,0,9.31,46.61,3035172,3035227
17628,40,69,1,12.80,197.21,3035226,3035266
17629,50,31,1,10.24,36.26,3035265,3035315
17630,54,34,1,9.48,41.10,3035314,3035368
17631,63,31,1,8.13,38.52,3035367,3035430
17632,72,27,1,7.11,22.90,3035429,3035501
17633,33,161,2,15.52,715.10,3035500,3035533
17634,42,68,1,12.19,198.34,3035532,3035574
17635,72,47,0,7.11,44.93,3035573,3035645
17636,57,51,0,8.98,74.86,3035644,3035701
17637,53,33,1,9.66,58.00,3035700,3035753
17638,93,31,0,5.51,28.34,3035752,3035845
17639,77,94,0,6.65,115.19,3035844,3035921
17640,64,29,0,8.00,44.78,3035920,3035984
17641,85,31,0,6.02,36.26,3035983,3036068
17642,56,60,0,9.14,80.80,3036067,3036123
17643,83,22,0,6.17,19.80,3036122,3036205
17644,71,46,1,7.21,60.31,3036205,3036276
17645,67,51,1,7.64,49.07,3036275,3036342
17646,78,20,0,6.56,15.12,3036341,3036419
17647,72,23,0,7.11,24.46,3036418,3036490
17648,48,67,1,10.67,103.85,3036489,3036537
17649,48,43,1,10.67,86.56,3036536,3036584
17650,51,32,0,10.04,36.59,3036583,3036634
17651,65,29,1,7.88,25.06,3036633,3036698
17652,62,43,1,8.26,38.35,3036697,3036759
17653,43,53,2,11.91,89.71,3036759,3036802
17654,53,29,0,9.66,37.02,3036801,3036854
17655,39,52,2,13.13,117.29,3036853,3036892
17656,43,26,3,11.91,36.13,3036891,3036934
17657,66,22,1,7.76,29.64,3036933,3036999
17658,59,26,0,8.68,29.47,3036998,3037057
17659,67,20,1,7.64,15.90,3037056,3037123
17660,61,43,1,8.39,40.27,3037122,3037183
17661,58,36,1,8.83,52.97,3037182,3037240
17662,55,86,1,9.31,136.32,3037240,3037295
17663,59,166,0,8.68,455.03,3037294,3037353
17664,57,45,0,8.98,75.46,3037352,3037409
17665,45,51,2,11.38,69.17,3037408,3037453
17666,46,134,1,11.13,409.20,3037452,3037498
17667,67,60,0,7.64,84.20,3037497,3037564
17668,61,52,1,8.39,56.63,3037563,3037624
17669,85,24,0,6.02,24.49,3037623,3037708
17670,93,39,0,5.51,34.42,3037708,3037801
17671,89,32,0,5.75,26.91,3037801,3037890
17672,71,73,0,7.21,93.58,3037889,3037960
17673,86,26,0,5.95,19.97,3037960,3038046
17674,73,35,1,7.01,28.42,3038045,3038118
17675,63,33,1,8.13,53.06,3038117,3038180
17676,74,56,0,6.92,47.21,3038179,3038253
17677,72,49,1,7.11,46.93,3038252,3038324
17678,63,55,1,8.13,61.57,3038324,3038387
17679,69,57,1,7.42,61.00,3038387,3038456
17680,61,42,1,8.39,50.93,3038455,3038516
17681,41,50,1,12.49,156.69,3038515,3038556
17682,40,77,0,12.80,213.36,3038556,3038596
17683,53,35,1,9.66,47.92,3038595,3038648
17684,74,27,0,6.92,18.70,3038647,3038721
17685,56,55,1,9.14,62.80,3038720,3038776
17686,52,35,2,9.85,46.67,3038775,3038827
17687,63,27,1,8.13,39.79,3038826,3038889
17688,55,33,0,9.31,42.72,3038889,3038944
17689,43,47,2,11.91,71.20,3038943,3038986
17690,48,41,2,10.67,80.76,3038985,3039033
17691,59,36,1,8.68,37.27,3039032,3039091
17692,53,37,1,9.66,38.38,3039091,3039144
17693,44,63,2,11.64,135.23,3039143,3039187
17694,56,31,3,9.14,35.48,3039186,3039242
17695,68,35,1,7.53,37.60,3039241,3039309
17696,65,34,0,7.88,54.78,3039308,3039373
17697,51,27,1,10.04,52.74,3039372,3039423
17698,54,37,0,9.48,58.25,3039422,3039476
17699,80,30,0,6.40,33.87,3039475,3039555
17700,72,29,1,7.11,28.24,3039554,3039626
17701,58,97,0,8.83,180.56,3039625,3039683
17702,106,34,0,4.83,25.27,3039682,3039788
17703,74,25,0,6.92,31.86,3039787,3039861
17704,90,26,0,5.69,24.28,3039860,3039950
17705,69,50,0,7.42,52.65,3039950,3040019
17706,62,31,1,8.26,40.35,3040018,3040080
17707,70,50,0,7.31,48.10,3040080,3040150
17708,76,73,1,6.74,76.35,3040149,3040225
17709,80,31,0,6.40,26.96,3040224,3040304
17710,83,18,1,6.17,16.89,3040303,3040386
17711,67,67,1,7.64,90.80,3040385,3040452
17712,71,44,1,7.21,49.88,3040451,3040522
17713,61,33,1,8.39,40.04,3040521,3040582
17714,44,118,2,11.64,292.46,3040581,3040625
17715,60,68,2,8.53,92.22,3040624,3040684
17716,48,29,1,10.67,42.47,3040683,3040731
17717,58,23,2,8.83,18.14,3040730,3040788
17718,51,32,1,10.04,55.80,3040787,3040838
17719,63,44,1,8.13,48.71,3040837,3040900
17720,34,67,0,15.06,138.17,3040899,3040933
17721,40,62,1,12.80,151.01,3040932,3040972
17722,61,26,0,8.39,31.52,3040971,3041032
17723,59,32,0,8.68,48.83,3041031,3041090
17724,52,27,1,9.85,27.94,3041090,3041142
17725,71,24,1,7.21,30.45,3041141,3041212
17726,44,30,1,11.64,47.91,3041211,3041255
17727,47,58,1,10.89,90.35,3041254,3041301
17728,55,37,1,9.31,48.61,3041300,3041355
17729,65,28,1,7.88,32.78,3041354,3041419
17730,50,44,0,10.24,84.42,3041418,3041468
17731,54,34,0,9.48,47.84,3041467,3041521
17732,61,46,0,8.39,65.85,3041520,3041581
17733,73,39,0,7.01,47.25,3041580,3041653
17734,100,26,0,5.12,27.11,3041652,3041752
17735,88,58,0,5.82,59.92,3041751,3041839
17736,93,26,0,5.51,25.93,3041838,3041931
17737,61,55,0,8.39,84.80,3041930,3041991
17738,70,22,1,7.31,23.19,3041990,3042060
17739,54,134,0,9.48,317.29,3042059,3042113
17740,55,108,0,9.31,219.52,3042112,3042167
17741,61,33,0,8.39,53.48,3042166,3042227
17742,76,28,1,6.74,24.09,3042227,3042303
17743,69,49,1,7.42,47.69,3042302,3042371
17744,65,52,1,7.88,58.11,3042370,3042435
17745,64,43,1,8.00,54.28,3042434,3042498
17746,39,60,2,13.13,122.37,3042497,3042536
17747,51,45,1,10.04,74.51,3042536,3042587
17748,56,36,1,9.14,41.23,3042586,3042642
17749,58,27,0,8.83,36.66,3042641,3042699
17750,51,32,1,10.04,34.04,3042698,3042749
17751,55,32,1,9.31,44.98,3042748,3042803
17752,52,31,1,9.85,41.82,3042803,3042855
17753,41,104,0,12.49,260.64,3042854,3042895
17754,47,36,2,10.89,44.27,3042894,3042941
17755,49,36,2,10.45,33.43,3042940,3042989
17756,64,28,0,8.00,27.53,3042988,3043052
17757,54,49,0,9.48,83.21,3043051,3043105
17758,48,31,1,10.67,55.39,3043104,3043152
17759,49,49,1,10.45,84.29,3043151,3043200
17760,52,53,1,9.85,77.59,3043199,3043251
17761,34,83,1,15.06,225.29,3043250,3043284
17762,49,51,1,10.45,112.98,3043283,3043332
17763,54,48,1,9.48,74.14,3043331,3043385
17764,55,23,2,9.31,36.14,3043384,3043439
17765,45,57,1,11.38,117.17,3043439,3043484
17766,57,53,0,8.98,76.33,3043483,3043540
17767,46,52,0,11.13,101.03,3043539,3043585
17768,69,33,0,7.42,39.37,3043584,3043653
17769,91,22,0,5.63,19.82,3043652,3043743
17770,90,48,0,5.69,90.79,3043742,3043832
17771,73,33,0,7.01,51.60,3043831,3043904
17772,93,26,0,5.51,23.20,3043903,3043996
17773,77,46,0,6.65,36.93,3043995,3044072
17774,73,19,0,7.01,20.07,3044071,3044144
17775,70,27,1,7.31,23.39,3044143,3044213
17776,78,27,1,6.56,22.14,3044213,3044291
17777,66,25,1,7.76,31.91,3044290,3044356
17778,74,25,0,6.92,26.91,3044356,3044430
17779,61,33,0,8.39,38.34,3044429,3044490
17780,58,32,1,8.83,48.56,3044489,3044547
17781,47,125,1,10.89,312.99,3044546,3044593
17782,55,48,1,9.31,47.60,3044592,3044647
17783,63,36,1,8.13,34.62,3044646,3044709
17784,46,35,1,11.13,73.37,3044708,3044754
17785,49,43,1,10.45,57.68,3044753,3044802
17786,50,56,1,10.24,82.38,3044801,3044851
17787,41,171,0,12.49,660.88,3044850,3044891
17788,53,37,1,9.66,48.30,3044890,3044943
17789,63,29,1,8.13,30.21,3044942,3045005
17790,58,43,0,8.83,62.63,3045004,3045062
17791,53,30,1,9.66,40.49,3045061,3045114
17792,37,39,1,13.84,78.03,3045113,3045150
17793,62,35,0,8.26,52.55,3045149,3045211
17794,51,63,0,10.04,124.19,3045210,3045261
17795,64,49,0,8.00,58.34,3045260,3045324
17796,88,26,0,5.82,20.74,3045323,3045411
17797,63,50,0,8.13,100.65,3045410,3045473
17798,71,39,0,7.21,53.27,3045472,3045543
17799,78,55,0,6.56,64.86,3045542,3045620
17800,83,35,1,6.17,33.47,3045620,3045703
17801,80,28,0,6.40,21.04,3045702,3045782
17802,61,31,0,8.39,45.78,3045781,3045842
17803,62,42,1,8.26,50.87,3045841,3045903
17804,67,31,0,7.64,34.77,3045902,3045969
17805,64,19,0,8.00,20.72,3045968,3046032
17806,79,57,0,6.48,50.15,3046032,3046111
17807,63,27,0,8.13,33.63,3046110,3046173
17808,48,72,1,10.67,120.97,3046173,3046221
17809,56,35,1,9.14,41.30,3046220,3046276
17810,70,27,1,7.31,28.30,3046275,3046345
17811,59,27,1,8.68,33.54,3046344,3046403
17812,57,31,2,8.98,29.42,3046402,3046459
17813,48,36,2,10.67,42.35,3046458,3046506
17814,65,29,0,7.88,34.32,3046505,3046570
17815,50,31,2,10.24,37.62,3046569,3046619
17816,51,61,0,10.04,99.92,3046618,3046669
17817,54,46,1,9.48,77.84,3046668,3046722
17818,51,48,0,10.04,68.78,3046721,3046772
17819,49,51,3,10.45,82.45,3046771,3046820
17820,61,37,0,8.39,45.68,3046819,3046880
17821,47,48,1,10.89,108.65,3046879,3046926
17822,37,53,1,13.84,147.16,3046925,3046962
17823,65,45,0,7.88,46.29,3046961,3047026
17824,60,26,1,8.53,40.82,3047025,3047085
17825,46,70,1,11.13,118.98,3047084,3047130
17826,58,42,1,8.83,63.25,3047129,3047187
17827,61,36,1,8.39,37.98,3047186,3047247
17828,75,54,0,6.83,53.80,3047246,3047321
17829,95,45,0,5.39,54.24,3047320,3047415
17830,77,39,0,6.65,39.97,3047414,3047491
17831,95,26,0,5.39,33.82,3047490,3047585
17832,64,33,1,8.00,36.00,3047584,3047648
17833,68,29,0,7.53,34.54,3047647,3047715
17834,65,31,1,7.88,38.11,3047714,3047779
17835,71,34,0,7.21,26.48,3047778,3047849
17836,79,27,1,6.48,25.49,3047848,3047927
17837,74,41,0,6.92,38.56,3047927,3048001
17838,82,20,0,6.24,20.31,3048000,3048082
17839,60,35,0,8.53,39.35,3048081,3048141
17840,66,38,1,7.76,39.27,3048140,3048206
17841,46,116,0,11.13,282.37,3048205,3048251
17842,53,37,1,9.66,42.90,3048250,3048303
17843,43,129,2,11.91,359.85,3048302,3048345
17844,60,47,1,8.53,47.12,3048344,3048404
17845,56,34,1,9.14,39.44,3048403,3048459
17846,51,36,0,10.04,60.82,3048458,3048509
17847,57,28,1,8.98,24.54,3048508,3048565
17848,46,29,0,11.13,40.68,3048564,3048610
17849,47,43,2,10.89,64.10,3048609,3048656
17850,43,30,2,11.91,38.32,3048655,3048698
17851,55,31,0,9.31,45.63,3048698,3048753
17852,61,33,1,8.39,36.34,3048753,3048814
17853,55,39,1,9.31,51.12,3048813,3048868
17854,67,43,1,7.64,45.66,3048867,3048934
17855,35,82,4,14.63,200.63,3048933,3048968
17856,48,47,0,10.67,103.64,3048967,3049015
17857,54,35,1,9.48,68.21,3049014,3049068
17858,63,28,1,8.13,41.38,3049067,3049130
17859,55,34,0,9.31,43.78,3049129,3049184
17860,70,30,0,7.31,39.36,3049184,3049254
17861,57,64,0,8.98,105.21,3049253,3049310
17862,72,59,0,7.11,71.38,3049309,3049381
17863,83,40,0,6.17,42.84,3049380,3049463
17864,67,58,0,7.64,72.23,3049462,3049529
17865,74,44,0,6.92,61.43,3049528,3049602
17866,69,55,0,7.42,62.42,3049602,3049671
17867,68,34,0,7.53,48.01,3049670,3049738
17868,68,28,0,7.53,36.22,3049738,3049806
17869,70,36,0,7.31,31.10,3049805,3049875
17870,59,48,1,8.68,60.69,3049875,3049934
17871,65,36,0,7.88,46.82,3049933,3049998
17872,76,41,0,6.74,37.09,3049997,3050073
17873,71,68,1,7.21,86.05,3050072,3050143
17874,61,25,0,8.39,35.12,3050142,3050203
17875,43,195,2,11.91,821.85,3050202,3050245
17876,45,69,1,11.38,121.57,3050244,3050289
17877,56,38,0,9.14,53.19,3050289,3050345
17878,58,26,0,8.83,29.69,3050344,3050402
17879,50,53,1,10.24,72.62,3050401,3050451
17880,61,39,1,8.39,35.68,3050450,3050511
17881,46,45,1,11.13,88.68,3050510,3050556
17882,56,24,1,9.14,28.34,3050555,3050611
17883,43,32,1,11.91,52.74,3050610,3050653
17884,63,24,0,8.13,24.11,3050652,3050715
17885,64,18,1,8.00,17.97,3050714,3050778
17886,54,37,1,9.48,55.06,3050777,3050831
17887,55,29,1,9.31,30.40,3050830,3050885
17888,65,63,0,7.88,77.37,3050884,3050949
17889,30,54,4,17.07,158.33,3050948,3050978
17890,48,56,0,10.67,120.26,3050977,3051025
17891,56,38,0,9.14,73.23,3051025,3051081
17892,59,32,0,8.68,60.66,3051080,3051139
17893,57,48,1,8.98,58.58,3051139,3051196
17894,48,99,0,10.67,220.47,3051195,3051243
17895,76,30,0,6.74,37.77,3051243,3051319
17896,53,43,0,9.66,91.05,3051318,3051371
17897,82,41,0,6.24,37.99,3051370,3051452
17898,83,35,0,6.17,48.69,3051451,3051534
17899,106,29,0,4.83,24.86,3051533,3051639
17900,80,20,0,6.40,18.61,3051638,3051718
17901,76,18,0,6.74,17.48,3051718,3051794
17902,68,65,1,7.53,71.31,3051794,3051862
17903,79,35,1,6.48,29.54,3051862,3051941
17904,57,55,1,8.98,80.37,3051940,3051997
17905,69,26,0,7.42,26.27,3051996,3052065
17906,72,49,1,7.11,50.68,3052064,3052136
17907,60,70,1,8.53,96.48,3052135,3052195
17908,61,24,0,8.39,28.83,3052194,3052255
17909,69,45,1,7.42,43.20,3052254,3052323
17910,63,51,1,8.13,59.48,3052322,3052385
17911,50,46,0,10.24,70.82,3052384,3052434
17912,60,56,1,8.53,66.62,3052433,3052493
17913,49,74,1,10.45,110.94,3052493,3052542
17914,51,48,2,10.04,61.33,3052541,3052592
17915,56,41,1,9.14,40.59,3052591,3052647
17916,41,60,0,12.49,150.59,3052646,3052687
17917,58,28,1,8.83,26.66,3052686,3052744
17918,44,34,2,11.64,57.32,3052743,3052787
17919,56,34,1,9.14,41.80,3052786,3052842
17920,61,26,2,8.39,31.42,3052841,3052902
17921,52,31,1,9.85,60.86,3052901,3052953
17922,45,45,1,11.38,72.37,3052952,3052997
17923,63,28,1,8.13,29.70,3052996,3053059
17924,53,51,1,9.66,89.39,3053058,3053111
17925,61,45,0,8.39,65.85,3053110,3053171
17926,56,44,0,9.14,75.16,3053170,3053226
17927,45,50,2,11.38,80.50,3053225,3053270
17928,63,44,0,8.13,56.21,3053269,3053332
17929,63,32,1,8.13,41.41,3053331,3053394
17930,63,37,0,8.13,71.76,3053393,3053456
17931,84,32,0,6.10,31.11,3053455,3053539
17932,107,24,0,4.79,20.30,3053538,3053645
17933,82,47,0,6.24,60.38,3053644,3053726
17934,65,37,1,7.88,53.18,3053725,3053790
17935,69,74,0,7.42,95.20,3053789,3053858
17936,73,30,1,7.01,33.82,3053858,3053931
17937,72,39,0,7.11,33.77,3053930,3054002
17938,70,30,0,7.31,27.67,3054002,3054072
17939,74,31,1,6.92,24.45,3054071,3054145
17940,72,41,1,7.11,37.24,3054144,3054216
17941,81,20,1,6.32,13.16,3054216,3054297
17942,61,43,1,8.39,47.16,3054297,3054358
17943,54,59,0,9.48,82.81,3054357,3054411
17944,56,25,1,9.14,29.48,3054411,3054467
17945,57,33,1,8.98,43.42,3054467,3054524
17946,57,25,1,8.98,32.75,3054524,3054581
17947,56,33,1,9.14,52.94,3054580,3054636
17948,44,31,1,11.64,55.60,3054635,3054679
17949,51,29,1,10.04,42.12,3054678,3054729
17950,57,27,1,8.98,30.79,3054728,3054785
17951,49,54,2,10.45,83.51,3054785,3054834
17952,58,23,2,8.83,21.32,3054834,3054892
17953,51,35,1,10.04,54.08,3054891,3054942
17954,42,42,1,12.19,70.44,3054941,3054983
17955,46,37,1,11.13,68.77,3054982,3055028
17956,63,51,0,8.13,56.33,3055027,3055090
17957,42,77,1,12.19,242.82,3055089,3055131
17958,45,57,0,11.38,106.77,3055130,3055175
17959,53,38,1,9.66,69.96,3055174,3055227
17960,69,51,0,7.42,76.39,3055226,3055295
17961,87,34,0,5.89,32.65,3055294,3055381
17962,57,35,1,8.98,53.03,3055380,3055437
17963,81,32,0,6.32,31.70,3055436,3055517
17964,74,31,0,6.92,33.78,3055516,3055590
17965,69,27,0,7.42,33.32,3055589,3055658
17966,88,19,1,5.82,16.31,3055657,3055745
17967,72,21,1,7.11,25.18,3055744,3055816
17968,93,15,0,5.51,12.08,3055815,3055908
17969,73,34,0,7.01,36.92,3055907,3055980
17970,45,50,1,11.38,99.35,3055979,3056024
17971,58,33,1,8.83,39.63,3056023,3056081
17972,54,31,1,9.48,35.14,3056080,3056134
17973,44,64,2,11.64,118.55,3056133,3056177
17974,60,30,1,8.53,35.75,3056177,3056237
17975,56,40,1,9.14,57.48,3056236,3056292
17976,36,70,3,14.22,155.78,3056291,3056327
17977,52,36,1,9.85,47.01,3056326,3056378
17978,49,54,1,10.45,68.53,3056377,3056426
17979,59,23,0,8.68,28.73,3056425,3056484
17980,57,20,1,8.98,19.88,3056483,3056540
17981,50,39,2,10.24,49.66,3056540,3056590
17982,50,56,1,10.24,74.42,3056589,3056639
17983,59,57,1,8.68,80.79,3056638,3056697
17984,45,25,0,11.38,43.30,3056696,3056741
17985,41,94,1,12.49,246.25,3056740,3056781
17986,58,31,0,8.83,54.76,3056780,3056838
17987,55,34,0,9.31,59.63,3056837,3056892
17988,42,58,1,12.19,125.92,3056891,3056933
17989,36,65,3,14.22,215.17,3056932,3056968
17990,61,34,0,8.39,45.98,3056967,3057028
17991,54,44,0,9.48,71.88,3057027,3057081
17992,80,28,0,6.40,29.29,3057080,3057160
17993,78,30,0,6.56,31.86,3057159,3057237
17994,95,35,0,5.39,32.41,3057236,3057331
17995,93,33,0,5.51,29.11,3057330,3057423
17996,70,36,0,7.31,45.67,3057422,3057492
17997,82,24,1,6.24,22.57,3057491,3057573
17998,73,28,0,7.01,27.55,3057572,3057645
17999,65,54,0,7.88,54.08,3057644,3057709
18000,58,80,1,8.83,142.63,3057708,3057766
18001,58,45,1,8.83,57.80,3057765,3057823
18002,65,43,1,7.88,53.46,3057823,3057888
18003,66,24,1,7.76,26.82,3057887,3057953
18004,80,19,1,6.40,17.64,3057952,3058032
18005,59,21,2,8.68,21.17,3058031,3058090
18006,61,28,1,8.39,30.89,3058090,3058151
18007,46,107,1,11.13,261.85,3058151,3058197
18008,51,55,0,10.04,107.53,3058196,3058247
18009,58,38,1,8.83,43.73,3058246,3058304
18010,47,45,1,10.89,78.18,3058303,3058350
18011,49,40,2,10.45,57.10,3058349,3058398
18012,69,27,0,7.42,29.20,3058397,3058466
18013,55,26,1,9.31,43.78,3058465,3058520
18014,48,36,2,10.67,63.76,3058519,3058567
18015,61,38,1,8.39,44.04,3058566,3058627
18016,64,36,0,8.00,38.88,3058626,3058690
18017,61,39,0,8.39,59.26,3058689,3058750
18018,53,38,0,9.66,71.85,3058749,3058802
18019,51,43,1,10.04,75.61,3058801,3058852
18020,71,28,0,7.21,29.63,3058851,3058922
18021,67,26,0,7.64,34.41,3058922,3058989
18022,74,64,0,6.92,85.59,3058988,3059062
18023,82,43,0,6.24,44.65,3059061,3059143
18024,79,39,0,6.48,49.09,3059142,3059221
18025,78,41,0,6.56,38.89,3059220,3059298
18026,70,26,0,7.31,27.62,3059298,3059368
18027,68,37,0,7.53,42.43,3059367,3059435
18028,81,24,1,6.32,22.56,3059435,3059516
18029,77,17,1,6.65,15.45,3059516,3059593
18030,79,28,0,6.48,24.33,3059592,3059671
18031,56,44,0,9.14,66.37,3059670,3059726
18032,50,41,1,10.24,63.42,3059725,3059775
18033,54,80,1,9.48,125.25,3059774,3059828
18034,53,23,1,9.66,22.11,3059827,3059880
18035,60,40,1,8.53,42.08,3059879,3059939
18036,59,29,0,8.68,42.32,3059938,3059997
18037,58,50,1,8.83,75.04,3059996,3060054
18038,47,31,1,10.89,42.52,3060053,3060100
18039,48,32,1,10.67,55.81,3060099,3060147
18040,60,30,1,8.53,32.45,3060146,3060206
18041,51,95,1,10.04,186.39,3060205,3060256
18042,54,64,0,9.48,89.88,3060255,3060309
18043,44,102,2,11.64,220.28,3060308,3060352
18044,60,35,0,8.53,34.05,3060351,3060411
18045,51,30,2,10.04,41.25,3060410,3060461
18046,46,61,0,11.13,124.07,3060460,3060506
18047,58,48,0,8.83,72.14,3060505,3060563
18048,48,34,0,10.67,75.93,3060562,3060610
18049,50,48,1,10.24,95.62,3060610,3060660
18050,62,34,0,8.26,60.74,3060659,3060721
18051,66,24,0,7.76,29.06,3060720,3060786
18052,58,112,0,8.83,258.97,3060785,3060843
18053,90,30,0,5.69,34.19,3060842,3060932
18054,62,55,0,8.26,82.87,3060931,3060993
18055,91,30,0,5.63,26.12,3060992,3061083
18056,67,26,1,7.64,22.47,3061082,3061149
18057,71,35,0,7.21,37.74,3061148,3061219
18058,73,30,0,7.01,32.59,3061218,3061291
18059,68,23,0,7.53,26.43,3061290,3061358
18060,63,46,0,8.13,54.56,3061357,3061420
18061,59,31,0,8.68,33.17,3061419,3061478
18062,85,31,0,6.02,20.02,3061477,3061562
18063,70,62,1,7.31,72.84,3061561,3061631
18064,66,24,0,7.76,27.70,3061630,3061696
18065,56,44,1,9.14,70.37,3061695,3061751
18066,52,73,1,9.85,108.82,3061750,3061802
18067,60,34,1,8.53,28.58,3061801,3061861
18068,49,39,1,10.45,68.74,3061860,3061909
18069,53,70,1,9.66,98.83,3061908,3061961
18070,43,43,2,11.91,77.43,3061960,3062003
18071,63,26,0,8.13,28.90,3062002,3062065
18072,54,25,1,9.48,32.10,3062064,3062118
18073,58,28,2,8.83,34.52,3062117,3062175
18074,54,43,2,9.48,47.06,3062174,3062228
18075,59,20,1,8.68,19.17,3062227,3062286
18076,58,35,0,8.83,47.94,3062285,3062343
18077,57,33,1,8.98,56.51,3062342,3062399
18078,46,68,1,11.13,128.81,3062398,3062444
18079,53,34,1,9.66,43.47,3062443,3062496
18080,43,60,1,11.91,163.39,3062495,3062538
18081,67,50,0,7.64,61.42,3062537,3062604
18082,45,46,1,11.38,93.70,3062603,3062648
18083,57,34,0,8.98,54.30,3062647,3062704
18084,66,39,0,7.76,71.94,3062703,3062769
18085,62,45,0,8.26,59.58,3062769,3062831
18086,70,32,0,7.31,47.10,3062830,3062900
18087,77,32,0,6.65,41.14,3062899,3062976
18088,89,42,0,5.75,37.80,3062975,3063064
18089,83,18,0,6.17,23.18,3063063,3063146
18090,57,33,1,8.98,47.53,3063146,3063203
18091,76,29,0,6.74,29.25,3063202,3063278
18092,59,33,1,8.68,51.10,3063277,3063336
18093,60,61,0,8.53,84.08,3063335,3063395
18094,65,46,1,7.88,53.65,3063394,3063459
18095,59,30,1,8.68,45.03,3063458,3063517
18096,62,92,1,8.26,145.29,3063517,3063579
18097,66,51,0,7.76,57.82,3063578,3063644
18098,43,103,0,11.91,244.97,3063643,3063686
18099,51,39,0,10.04,70.31,3063686,3063737
18100,58,30,1,8.83,40.00,3063736,3063794
18101,63,28,0,8.13,23.89,3063793,3063856
18102,61,29,1,8.39,34.04,3063855,3063916
18103,56,22,1,9.14,22.41,3063915,3063971
18104,58,21,1,8.83,20.73,3063970,3064028
18105,32,112,2,16.00,547.31,3064027,3064059
18106,60,26,1,8.53,32.85,3064058,3064118
18107,50,54,1,10.24,106.58,3064118,3064168
18108,48,51,2,10.67,92.68,3064167,3064215
18109,61,34,1,8.39,37.42,3064214,3064275
18110,62,24,1,8.26,27.61,3064274,3064336
18111,38,71,0,13.47,166.46,3064335,3064373
18112,61,48,0,8.39,52.73,3064372,3064433
18113,64,36,2,8.00,40.88,3064432,3064496
18114,50,28,1,10.24,49.38,3064495,3064545
18115,57,32,0,8.98,47.81,3064544,3064601
18116,70,26,0,7.31,34.16,3064600,3064670
18117,42,39,0,12.19,82.20,3064670,3064712
18118,58,48,0,8.83,72.45,3064711,3064769
18119,50,31,1,10.24,62.22,3064768,3064818
18120,59,45,0,8.68,68.56,3064817,3064876
18121,88,35,0,5.82,34.81,3064875,3064963
18122,94,24,0,5.45,22.29,3064962,3065056
18123,55,69,0,9.31,102.00,3065055,3065110
18124,85,20,0,6.02,25.55,3065109,3065194
18125,78,18,1,6.56,16.86,3065193,3065271
18126,70,26,0,7.31,28.53,3065271,3065341
18127,63,53,0,8.13,56.94,3065340,3065403
18128,83,27,0,6.17,28.09,3065402,3065485
18129,84,29,1,6.10,20.18,3065485,3065569
18130,59,58,1,8.68,67.10,3065568,3065627
18131,93,17,0,5.51,12.44,3065626,3065719
18132,73,31,1,7.01,38.70,3065718,3065791
18133,55,48,0,9.31,55.30,3065790,3065845
18134,49,53,2,10.45,77.88,3065844,3065893
18135,49,60,1,10.45,80.57,3065892,3065941
18136,63,58,0,8.13,62.36,3065940,3066003
18137,62,32,1,8.26,26.84,3066002,3066064
18138,62,25,0,8.26,26.00,3066063,3066125
18139,58,34,1,8.83,37.25,3066124,3066182
18140,55,25,2,9.31,28.54,3066181,3066236
18141,46,74,1,11.13,175.42,3066235,3066281
18142,49,29,1,10.45,38.08,3066281,3066330
18143,52,52,2,9.85,67.63,3066330,3066382
18144,43,37,2,11.91,47.29,3066381,3066424
18145,54,40,0,9.48,49.58,3066423,3066477
18146,48,72,1,10.67,125.10,3066476,3066524
18147,46,47,2,11.13,108.46,3066523,3066569
18148,47,35,2,10.89,66.48,3066568,3066615
18149,68,47,0,7.53,56.16,3066614,3066682
18150,67,31,0,7.64,42.71,3066681,3066748
18151,81,45,0,6.32,40.96,3066747,3066828
18152,75,29,0,6.83,40.04,3066827,3066902
18153,76,26,0,6.74,28.54,3066901,3066977
18154,61,29,1,8.39,33.78,3066976,3067037
18155,72,25,1,7.11,32.88,3067036,3067108
18156,57,56,0,8.98,79.10,3067107,3067164
18157,61,33,1,8.39,42.01,3067163,3067224
18158,62,27,1,8.26,28.09,3067223,3067285
18159,76,27,0,6.74,24.22,3067284,3067360
18160,70,27,0,7.31,27.50,3067359,3067429
18161,60,29,1,8.53,31.48,3067428,3067488
18162,65,54,0,7.88,55.52,3067488,3067553
18163,57,28,0,8.98,40.02,3067552,3067609
18164,52,42,1,9.85,63.71,3067608,3067660
18165,58,58,1,8.83,68.80,3067659,3067717
18166,62,25,0,8.26,26.39,3067716,3067778
18167,53,27,1,9.66,38.98,3067777,3067830
18168,57,36,2,8.98,40.96,3067829,3067886
18169,50,36,1,10.24,72.90,3067886,3067936
18170,68,22,1,7.53,21.37,3067935,3068003
18171,37,49,2,13.84,124.30,3068002,3068039
18172,49,58,0,10.45,73.35,3068038,3068087
18173,53,49,1,9.66,64.41,3068086,3068139
18174,54,28,1,9.48,40.99,3068138,3068192
18175,40,33,1,12.80,65.61,3068191,3068231
18176,60,39,1,8.53,51.42,3068230,3068290
18177,87,21,0,5.89,23.04,3068289,3068376
18178,90,30,0,5.69,29.97,3068375,3068465
18179,89,21,0,5.75,23.92,3068464,3068553
18180,52,41,1,9.85,54.75,3068552,3068604
18181,79,25,0,6.48,24.43,3068603,3068682
18182,52,99,1,9.85,184.51,3068681,3068733
18183,63,58,1,8.13,83.63,3068732,3068795
18184,78,28,1,6.56,25.30,3068794,3068872
18185,65,37,1,7.88,38.97,3068871,3068936
18186,76,25,1,6.74,18.14,3068935,3069011
18187,69,21,1,7.42,21.78,3069010,3069079
18188,50,55,1,10.24,119.10,3069078,3069128
18189,57,33,1,8.98,43.74,3069127,3069184
18190,47,36,2,10.89,48.69,3069183,3069230
18191,54,44,0,9.48,57.92,3069229,3069283
18192,49,75,3,10.45,111.84,3069282,3069331
18193,46,40,1,11.13,72.85,3069330,3069376
18194,61,23,3,8.39,17.19,3069375,3069436
18195,49,47,1,10.45,104.61,3069435,3069484
18196,47,56,3,10.89,99.46,3069483,3069530
18197,57,53,1,8.98,74.47,3069529,3069586
18198,34,52,2,15.06,120.35,3069585,3069619
18199,35,40,3,14.63,91.60,3069618,3069653
18200,62,32,0,8.26,60.16,3069652,3069714
18201,60,48,0,8.53,68.82,3069713,3069773
18202,44,37,0,11.64,72.55,3069772,3069816
18203,50,68,0,10.24,122.50,3069815,3069865
18204,66,60,0,7.76,77.06,3069864,3069930
18205,92,23,0,5.57,22.16,3069929,3070021
18206,91,30,0,5.63,22.78,3070020,3070111
18207,82,37,0,6.24,35.38,3070111,3070193
18208,70,53,0,7.31,56.64,3070192,3070262
18209,76,24,0,6.74,18.14,3070262,3070338
18210,74,27,1,6.92,25.32,3070337,3070411
18211,53,164,0,9.66,472.94,3070410,3070463
18212,68,51,0,7.53,47.48,3070463,3070531
18213,66,57,1,7.76,79.52,3070530,3070596
18214,59,40,0,8.68,60.73,3070596,3070655
18215,48,70,0,10.67,109.47,3070654,3070702
18216,58,49,1,8.83,47.90,3070701,3070759
18217,45,33,2,11.38,44.90,3070758,3070803
18218,59,52,1,8.68,60.93,3070802,3070861
18219,56,26,1,9.14,27.73,3070860,3070916
18220,42,38,1,12.19,71.58,3070915,3070957
18221,61,47,1,8.39,47.16,3070956,3071017
18222,50,38,0,10.24,48.38,3071016,3071066
18223,51,33,1,10.04,48.59,3071066,3071117
18224,55,31,0,9.31,49.81,3071116,3071171
18225,61,47,2,8.39,38.57,3071171,3071232
18226,44,35,2,11.64,62.19,3071231,3071275
18227,61,54,0,8.39,72.01,3071274,3071335
18228,50,63,0,10.24,111.66,3071335,3071385
18229,50,37,1,10.24,74.22,3071384,3071434
18230,48,38,0,10.67,69.31,3071433,3071481
18231,61,67,0,8.39,118.86,3071480,3071541
18232,68,90,0,7.53,135.19,3071540,3071608
18233,70,94,0,7.31,130.99,3071607,3071677
18234,82,35,0,6.24,39.67,3071677,3071759
18235,63,38,0,8.13,64.27,3071758,3071821
18236,81,20,0,6.32,18.69,3071820,3071901
18237,72,28,1,7.11,34.60,3071901,3071973
18238,74,54,0,6.92,50.83,3071972,3072046
18239,69,31,1,7.42,29.35,3072045,3072114
18240,77,22,0,6.65,18.59,3072113,3072190
18241,66,90,0,7.76,123.40,3072190,3072256
18242,58,33,1,8.83,41.35,3072255,3072313
18243,49,48,1,10.45,71.31,3072312,3072361
18244,70,20,2,7.31,14.10,3072360,3072430
18245,44,57,1,11.64,131.78,3072429,3072473
18246,57,21,0,8.98,24.89,3072472,3072529
18247,45,67,2,11.38,110.99,3072529,3072574
18248,60,32,2,8.53,28.52,3072574,3072634
18249,43,51,2,11.91,110.18,3072633,3072676
18250,56,34,1,9.14,37.91,3072675,3072731
18251,51,58,1,10.04,85.37,3072731,3072782
18252,40,67,1,12.80,146.71,3072781,3072821
18253,62,27,0,8.26,23.13,3072820,3072882
18254,49,35,2,10.45,45.80,3072881,3072930
18255,55,35,1,9.31,52.65,3072929,3072984
18256,40,71,3,12.80,167.96,3072983,3073023
18257,56,77,1,9.14,137.84,3073022,3073078
18258,58,42,0,8.83,56.94,3073077,3073135
18259,50,31,0,10.24,48.74,3073134,3073184
18260,46,44,1,11.13,63.85,3073183,3073229
18261,57,51,0,8.98,116.12,3073228,3073285
18262,53,89,0,9.66,193.32,3073285,3073338
18263,78,82,0,6.56,129.12,3073337,3073415
18264,96,24,0,5.33,20.62,3073414,3073510
18265,54,55,0,9.48,130.69,3073509,3073563
18266,94,25,0,5.45,24.14,3073562,3073656
18267,66,53,0,7.76,58.79,3073655,3073721
18268,61,70,1,8.39,109.62,3073721,3073782
18269,76,37,1,6.74,28.11,3073781,3073857
18270,76,26,1,6.74,24.72,3073856,3073932
18271,66,36,1,7.76,45.27,3073932,3073998
18272,69,40,0,7.42,44.53,3073997,3074066
18273,79,35,0,6.48,30.27,3074065,3074144
18274,67,28,0,7.64,33.48,3074143,3074210
18275,61,36,0,8.39,52.27,3074209,3074270
18276,47,32,1,10.89,54.39,3074269,3074316
18277,56,54,1,9.14,76.34,3074315,3074371
18278,55,48,0,9.31,49.81,3074370,3074425
18279,53,65,1,9.66,107.09,3074424,3074477
18280,62,26,0,8.26,30.00,3074476,3074538
18281,52,46,2,9.85,58.01,3074537,3074589
18282,53,43,2,9.66,55.24,3074588,3074641
18283,44,46,0,11.64,92.46,3074640,3074684
18284,46,36,1,11.13,53.42,3074683,3074729
18285,48,30,2,10.67,42.43,3074728,3074776
18286,59,31,1,8.68,24.96,3074775,3074834
18287,57,32,1,8.98,37.63,3074833,3074890
18288,48,85,1,10.67,149.76,3074889,3074937
18289,52,45,1,9.85,65.36,3074936,3074988
18290,48,46,1,10.67,79.39,3074987,3075035
18291,49,55,0,10.45,125.15,3075034,3075083
18292,49,43,1,10.45,89.43,3075082,3075131
18293,54,46,0,9.48,58.51,3075131,3075185
18294,48,71,1,10.67,127.26,3075184,3075232
18295,42,50,0,12.19,117.11,3075231,3075273
18296,72,29,0,7.11,35.40,3075272,3075344
18297,66,72,0,7.76,101.88,3075343,3075409
18298,74,35,0,6.92,44.89,3075408,3075482
18299,71,37,0,7.21,42.00,3075481,3075552
18300,87,35,0,5.89,34.58,3075551,3075638
18301,68,40,0,7.53,36.43,3075637,3075705
18302,75,23,0,6.83,23.58,3075704,3075779
18303,74,32,1,6.92,24.26,3075778,3075852
18304,71,24,1,7.21,24.34,3075852,3075923
18305,70,27,1,7.31,24.70,3075922,3075992
18306,68,46,1,7.53,59.37,3075991,3076059
18307,59,39,1,8.68,59.47,3076058,3076117
18308,84,33,0,6.10,24.78,3076116,3076200
18309,64,33,1,8.00,42.69,3076199,3076263
18310,47,49,1,10.89,88.10,3076262,3076309
18311,50,43,2,10.24,57.22,3076308,3076358
18312,46,50,0,11.13,95.20,3076357,3076403
18313,57,36,0,8.98,38.54,3076402,3076459
18314,60,21,0,8.53,18.95,3076459,3076519
18315,50,44,1,10.24,53.74,3076519,3076569
18316,64,31,1,8.00,31.69,3076568,3076632
18317,36,113,2,14.22,543.12,3076631,3076667
18318,50,30,1,10.24,46.66,3076666,3076716
18319,56,37,0,9.14,47.37,3076715,3076771
18320,54,21,2,9.48,24.69,3076770,3076824
18321,52,56,2,9.85,78.17,3076823,3076875
18322,49,48,2,10.45,76.00,3076874,3076923
18323,35,68,1,14.63,170.18,3076922,3076957
18324,41,40,1,12.49,79.03,3076956,3076997
18325,44,47,2,11.64,78.19,3076996,3077040
18326,52,43,0,9.85,80.78,3077039,3077091
18327,49,35,1,10.45,55.92,3077090,3077139
18328,54,30,0,9.48,38.25,3077138,3077192
18329,61,33,1,8.39,55.68,3077191,3077252
18330,62,83,0,8.26,122.22,3077251,3077313
18331,82,48,0,6.24,38.06,3077312,3077394
18332,95,49,0,5.39,40.89,3077393,3077488
18333,59,40,0,8.68,70.49,3077487,3077546
18334,82,55,0,6.24,61.99,3077546,3077628
18335,71,37,0,7.21,38.56,3077627,3077698
18336,83,28,1,6.17,17.30,3077697,3077780
18337,75,19,1,6.83,17.00,3077779,3077854
18338,59,34,1,8.68,48.05,3077853,3077912
18339,68,65,0,7.53,67.69,3077912,3077980
18340,78,33,0,6.56,33.07,3077979,3078057
18341,73,32,0,7.01,34.10,3078056,3078129
18342,61,96,1,8.39,169.94,3078128,3078189
18343,72,28,0,7.11,27.57,3078188,3078260
18344,64,35,0,8.00,32.22,3078259,3078323
18345,56,35,1,9.14,42.77,3078322,3078378
18346,65,26,0,7.88,28.72,3078377,3078442
18347,64,32,0,8.00,33.44,3078442,3078506
18348,43,55,0,11.91,89.67,3078505,3078548
18349,61,33,0,8.39,34.17,3078547,3078608
18350,52,49,0,9.85,75.44,3078607,3078659
18351,42,53,3,12.19,86.82,3078658,3078700
18352,54,29,0,9.48,47.88,3078699,3078753
18353,56,42,0,9.14,69.87,3078752,3078808
18354,57,38,1,8.98,47.25,3078807,3078864
18355,63,18,1,8.13,13.86,3078864,3078927
18356,49,30,2,10.45,38.17,3078926,3078975
18357,41,54,1,12.49,131.96,3078974,3079015
18358,67,42,0,7.64,55.96,3079014,3079081
18359,51,28,3,10.04,29.37,3079080,3079131
18360,53,51,0,9.66,92.60,3079130,3079183
18361,66,52,0,7.76,59.61,3079182,3079248
18362,67,58,0,7.64,105.69,3079247,3079314
18363,101,33,0,5.07,24.80,3079313,3079414
18364,55,51,0,9.31,96.10,3079413,3079468
18365,80,51,0,6.40,50.74,3079467,3079547
18366,94,23,0,5.45,21.03,3079546,3079640
18367,80,21,0,6.40,23.51,3079639,3079719
18368,58,41,1,8.83,69.45,3079718,3079776
18369,65,67,1,7.88,72.02,3079776,3079841
18370,70,27,1,7.31,25.19,3079841,3079911
18371,69,45,1,7.42,47.69,3079911,3079980
18372,74,35,0,6.92,33.37,3079979,3080053
18373,60,28,1,8.53,28.18,3080052,3080112
18374,70,23,0,7.31,27.56,3080111,3080181
18375,68,19,2,7.53,21.04,3080180,3080248
18376,57,70,1,8.98,92.75,3080248,3080305
18377,45,46,1,11.38,63.66,3080304,3080349
18378,60,30,0,8.53,38.72,3080348,3080408
18379,60,27,0,8.53,41.42,3080407,3080467
18380,48,33,2,10.67,41.06,3080467,3080515
18381,46,89,0,11.13,191.42,3080514,3080560
18382,57,55,0,8.98,67.60,3080559,3080616
18383,47,30,2,10.89,22.95,3080615,3080662
18384,48,48,1,10.67,96.31,3080661,3080709
18385,67,16,1,7.64,17.57,3080708,3080775
18386,60,61,1,8.53,83.02,3080774,3080834
18387,57,28,2,8.98,34.51,3080833,3080890
18388,80,31,0,6.40,34.21,3080889,3080969
18389,46,84,1,11.13,177.81,3080968,3081014
18390,50,40,1,10.24,76.50,3081014,3081064
18391,56,43,0,9.14,84.05,3081063,3081119
18392,75,34,0,6.83,38.65,3081119,3081194
18393,100,17,0,5.12,17.47,3081193,3081293
18394,85,34,0,6.02,50.26,3081293,3081378
18395,73,21,1,7.01,21.11,3081377,3081450
18396,78,32,1,6.56,30.94,3081449,3081527
18397,69,23,1,7.42,28.30,3081526,3081595
18398,66,35,2,7.76,31.18,3081594,3081660
18399,90,27,1,5.69,24.79,3081659,3081749
18400,67,40,1,7.64,44.05,3081748,3081815
18401,55,106,1,9.31,207.92,3081814,3081869
18402,52,40,0,9.85,64.51,3081868,3081920
18403,65,38,1,7.88,38.63,3081920,3081985
18404,62,28,1,8.26,26.74,3081984,3082046
18405,48,51,1,10.67,99.06,3082045,3082093
18406,59,42,2,8.68,48.25,3082092,3082151
18407,54,25,3,9.48,27.10,3082150,3082204
18408,43,84,0,11.91,191.57,3082204,3082247
18409,63,35,1,8.13,42.65,3082246,3082309
18410,57,25,1,8.98,26.30,3082308,3082365
18411,58,29,1,8.83,30.59,3082364,3082422
18412,49,51,1,10.45,81.88,3082422,3082471
18413,58,34,2,8.83,39.63,3082470,3082528
18414,37,44,1,13.84,102.46,3082527,3082564
18415,30,97,1,17.07,354.66,3082563,3082593
18416,68,35,1,7.53,31.46,3082592,3082660
18417,58,68,0,8.83,94.87,3082659,3082717
18418,55,35,1,9.31,63.52,3082716,3082771
18419,40,41,1,12.80,86.51,3082770,3082810
18420,63,25,0,8.13,34.30,3082810,3082873
18421,85,42,0,6.02,45.76,3082872,3082957
18422,56,32,0,9.14,54.55,3082956,3083012
18423,102,22,0,5.02,23.84,3083011,3083113
18424,74,38,0,6.92,64.51,3083112,3083186
18425,86,27,0,5.95,26.60,3083185,3083271
18426,74,37,1,6.92,31.02,3083270,3083344
18427,66,44,0,7.76,39.91,3083343,3083409
18428,66,29,0,7.76,33.43,3083408,3083474
18429,70,27,1,7.31,27.04,3083473,3083543
18430,76,44,0,6.74,39.33,3083542,3083618
18431,79,20,0,6.48,20.88,3083617,3083696
18432,73,22,0,7.01,20.07,3083696,3083769
18433,57,75,0,8.98,115.84,3083768,3083825
18434,53,52,0,9.66,69.32,3083824,3083877
18435,55,65,1,9.31,75.41,3083876,3083931
18436,52,23,2,9.85,27.75,3083930,3083982
18437,59,33,1,8.68,40.93,3083981,3084040
18438,54,53,1,9.48,63.36,3084039,3084093
18439,54,34,0,9.48,50.62,3084093,3084147
18440,47,104,0,10.89,223.92,3084146,3084193
18441,55,29,1,9.31,31.09,3084192,3084247
18442,56,25,0,9.14,37.09,3084246,3084302
18443,54,47,1,9.48,62.25,3084301,3084355
18444,57,32,1,8.98,34.05,3084355,3084412
18445,68,23,0,7.53,20.96,3084411,3084479
18446,57,25,1,8.98,24.30,3084479,3084536
18447,55,30,1,9.31,43.74,3084535,3084590
18448,46,86,1,11.13,188.77,3084589,3084635
18449,65,101,0,7.88,161.65,3084635,3084700
18450,43,62,0,11.91,119.29,3084699,3084742
18451,57,45,0,8.98,72.33,3084741,3084798
18452,55,61,0,9.31,113.05,3084797,3084852
18453,55,27,2,9.31,36.07,3084852,3084907
18454,83,20,0,6.17,25.10,3084906,3084989
18455,87,36,0,5.89,39.89,3084988,3085075
18456,58,59,1,8.83,88.63,3085074,3085132
18457,86,26,0,5.95,26.74,3085131,3085217
18458,63,52,0,8.13,68.97,3085216,3085279
18459,70,69,0,7.31,83.59,3085278,3085348
18460,71,23,0,7.21,22.05,3085347,3085418
18461,62,39,0,8.26,48.39,3085417,3085479
18462,72,38,1,7.11,34.15,3085478,3085550
18463,87,26,0,5.89,20.79,3085550,3085637
18464,68,42,0,7.53,55.34,3085636,3085704
18465,75,72,0,6.83,76.04,3085704,3085779
18466,69,22,0,7.42,26.65,3085778,3085847
18467,60,27,1,8.53,24.98,3085846,3085906
18468,52,30,0,9.85,37.13,3085905,3085957
18469,63,37,1,8.13,35.79,3085956,3086019
18470,57,37,1,8.98,49.14,3086018,3086075
18471,59,35,1,8.68,38.96,3086074,3086133
18472,60,35,0,8.53,49.22,3086132,3086192
18473,41,57,1,12.49,126.30,3086191,3086232
18474,51,62,1,10.04,78.63,3086232,3086283
18475,63,18,2,8.13,14.87,3086282,3086345
18476,52,41,2,9.85,51.01,3086344,3086396
18477,49,76,2,10.45,114.53,3086396,3086445
18478,70,20,0,7.31,20.96,3086444,3086514
18479,42,79,1,12.19,171.01,3086513,3086555
18480,24,84,2,21.33,475.56,3086554,3086578
18481,31,63,3,16.52,230.25,3086577,3086608
18482,49,49,1,10.45,71.27,3086607,3086656
18483,47,94,1,10.89,188.65,3086655,3086702
18484,51,78,1,10.04,135.61,3086701,3086752
18485,52,35,1,9.85,50.25,3086752,3086804
18486,52,48,0,9.85,102.44,3086803,3086855
18487,68,29,0,7.53,41.54,3086854,3086922
18488,75,29,0,6.83,32.52,3086921,3086996
18489,76,35,0,6.74,59.11,3086996,3087072
18490,73,28,0,7.01,30.97,3087071,3087144
18491,99,29,0,5.17,29.37,3087143,3087242
18492,40,108,2,12.80,295.71,3087241,3087281
18493,61,48,1,8.39,75.71,3087281,3087342
18494,65,66,1,7.88,92.63,3087341,3087406
18495,60,52,0,8.53,71.68,3087406,3087466
18496,59,32,1,8.68,40.69,3087465,3087524
18497,62,43,1,8.26,74.55,3087523,3087585
18498,73,32,0,7.01,30.51,3087584,3087657
18499,84,23,0,6.10,18.13,3087656,3087740
18500,57,40,1,8.98,71.63,3087739,3087796
18501,58,24,1,8.83,35.04,3087795,3087853
18502,58,34,2,8.83,44.59,3087852,3087910
18503,66,24,0,7.76,25.61,3087909,3087975
18504,58,29,1,8.83,34.94,3087974,3088032
18505,53,32,1,9.66,56.87,3088031,3088084
18506,56,41,2,9.14,52.84,3088083,3088139
18507,53,53,1,9.66,75.92,3088138,3088191
18508,50,34,1,10.24,85.78,3088190,3088240
18509,48,70,0,10.67,189.10,3088239,3088287
18510,48,37,2,10.67,62.97,3088286,3088334
18511,43,56,2,11.91,97.85,3088334,3088377
18512,57,24,1,8.98,34.96,3088376,3088433
18513,55,40,0,9.31,70.58,3088432,3088487
18514,54,27,1,9.48,31.81,3088486,3088540
18515,49,38,3,10.45,42.29,3088539,3088588
18516,48,38,1,10.67,67.31,3088588,3088636
18517,58,26,1,8.83,37.83,3088635,3088693
18518,65,48,1,7.88,55.34,3088692,3088757
18519,49,78,1,10.45,125.55,3088757,3088806
18520,53,33,2,9.66,35.62,3088805,3088858
18521,70,27,0,7.31,25.82,3088857,3088927
18522,62,36,1,8.26,46.97,3088926,3088988
18523,76,49,0,6.74,55.33,3088987,3089063
18524,69,50,0,7.42,60.91,3089062,3089131
18525,96,23,0,5.33,20.78,3089130,3089226
18526,76,35,0,6.74,35.27,3089225,3089301
18527,74,41,0,6.92,48.83,3089300,3089374
18528,70,53,1,7.31,53.96,3089373,3089443
18529,55,40,1,9.31,56.65,3089442,3089497
18530,77,28,1,6.65,28.93,3089496,3089573
18531,66,28,0,7.76,34.64,3089572,3089638
18532,68,39,0,7.53,33.69,3089637,3089705
18533,81,21,0,6.32,16.51,3089704,3089785
18534,50,66,0,10.24,162.90,3089784,3089834
18535,51,89,0,10.04,166.31,3089833,3089884
18536,69,24,1,7.42,17.20,3089883,3089952
18537,54,85,0,9.48,154.88,3089951,3090005
18538,42,50,1,12.19,106.92,3090004,3090046
18539,57,33,0,8.98,46.89,3090045,3090102
18540,52,33,1,9.85,62.75,3090101,3090153
18541,58,35,1,8.83,41.07,3090152,3090210
18542,60,39,0,8.53,43.55,3090209,3090269
18543,57,47,1,8.98,58.26,3090268,3090325
18544,45,47,3,11.38,72.50,3090324,3090369
18545,55,20,2,9.31,21.96,3090368,3090423
18546,44,48,0,11.64,83.91,3090422,3090466
18547,54,89,1,9.48,145.81,3090465,3090519
18548,49,111,1,10.45,249.64,3090518,3090567
18549,48,45,1,10.67,79.47,3090566,3090614
18550,36,56,1,14.22,215.12,3090613,3090649
18551,32,68,3,16.00,234.38,3090648,3090680
18552,48,51,0,10.67,122.31,3090679,3090727
18553,56,38,1,9.14,79.41,3090726,3090782
18554,48,29,1,10.67,27.64,3090781,3090829
18555,62,118,0,8.26,223.74,3090828,3090890
18556,60,47,0,8.53,60.82,3090889,3090949
18557,74,26,0,6.92,34.64,3090948,3091022
18558,98,17,0,5.22,18.66,3091021,3091119
18559,80,37,0,6.40,50.76,3091118,3091198
18560,73,28,1,7.01,33.19,3091198,3091271
18561,76,22,1,6.74,21.09,3091270,3091346
18562,56,29,1,9.14,39.48,3091345,3091401
18563,81,38,0,6.32,33.65,3091400,3091481
18564,76,24,0,6.74,21.61,3091480,3091556
18565,73,30,1,7.01,21.47,3091556,3091629
18566,50,61,1,10.24,122.94,3091628,3091678
18567,83,18,1,6.17,14.12,3091677,3091760
18568,62,74,0,8.26,115.03,3091759,3091821
18569,73,23,1,7.01,18.84,3091820,3091893
18570,52,32,1,9.85,53.36,3091892,3091944
18571,57,30,1,8.98,35.95,3091943,3092000
18572,49,54,0,10.45,68.86,3091999,3092048
18573,65,29,1,7.88,31.77,3092047,3092112
18574,54,20,1,9.48,27.47,3092111,3092165
18575,62,40,1,8.26,42.13,3092164,3092226
18576,50,28,2,10.24,34.66,3092225,3092275
18577,59,33,0,8.68,55.78,3092274,3092333
18578,44,57,1,11.64,102.46,3092332,3092376
18579,14,93,5,36.57,1107.82,3092375,3092389
18580,56,48,1,9.14,70.77,3092388,3092444
18581,54,43,1,9.48,52.66,3092443,3092497
18582,60,30,1,8.53,38.32,3092496,3092556
18583,58,25,1,8.83,29.73,3092555,3092613
18584,68,20,1,7.53,24.25,3092612,3092680
18585,34,84,1,15.06,222.70,3092679,3092713
18586,36,52,0,14.22,180.78,3092712,3092748
18587,44,49,1,11.64,107.10,3092747,3092791
18588,68,26,1,7.53,31.46,3092790,3092858
18589,48,50,1,10.67,115.01,3092857,3092905
18590,51,31,0,10.04,37.65,3092904,3092955
18591,49,32,0,10.45,91.47,3092954,3093003
18592,77,44,0,6.65,56.18,3093002,3093079
18593,76,25,0,6.74,28.56,3093079,3093155
18594,95,24,0,5.39,23.42,3093154,3093249
18595,71,27,0,7.21,38.45,3093248,3093319
18596,77,18,0,6.65,19.68,3093318,3093395
18597,52,57,2,9.85,84.17,3093394,3093446
18598,70,37,0,7.31,44.84,3093445,3093515
18599,70,26,1,7.31,29.27,3093514,3093584
18600,72,43,1,7.11,35.46,3093583,3093655
18601,64,60,1,8.00,63.72,3093654,3093718
18602,79,30,1,6.48,25.36,3093718,3093797
18603,70,30,1,7.31,27.44,3093796,3093866
18604,74,22,0,6.92,28.83,3093865,3093939
18605,60,58,1,8.53,53.92,3093938,3093998
18606,48,43,1,10.67,60.93,3093997,3094045
18607,56,34,1,9.14,44.05,3094044,3094100
18608,65,31,1,7.88,29.89,3094099,3094164
18609,55,31,1,9.31,39.96,3094163,3094218
18610,53,38,1,9.66,45.77,3094217,3094270
18611,43,69,2,11.91,186.97,3094269,3094312
18612,57,35,1,8.98,30.61,3094311,3094368
18613,43,36,2,11.91,70.36,3094367,3094410
18614,55,35,1,9.31,37.30,3094409,3094464
18615,52,41,1,9.85,75.59,3094463,3094515
18616,53,88,1,9.66,144.49,3094514,3094567
18617,60,53,1,8.53,65.52,3094566,3094626
18618,57,29,0,8.98,29.42,3094625,3094682
18619,70,21,1,7.31,21.47,3094681,3094751
18620,28,63,4,18.29,248.56,3094751,3094779
18621,41,88,0,12.49,236.15,3094778,3094819
18622,59,49,1,8.68,69.91,3094818,3094877
18623,53,31,1,9.66,61.55,3094876,3094929
18624,49,53,1,10.45,92.41,3094928,3094977
18625,72,32,0,7.11,26.35,3094976,3095048
18626,68,25,0,7.53,40.13,3095047,3095115
18627,79,53,0,6.48,44.98,3095114,3095193
18628,97,50,0,5.28,33.23,3095192,3095289
18629,45,87,0,11.38,290.72,3095288,3095333
18630,72,40,1,7.11,33.21,3095332,3095404
18631,90,16,0,5.69,12.64,3095403,3095493
18632,74,47,0,6.92,39.80,3095492,3095566
18633,70,24,0,7.31,25.39,3095565,3095635
18634,73,28,1,7.01,27.41,3095634,3095707
18635,59,36,0,8.68,45.91,3095706,3095765
18636,67,42,0,7.64,70.65,3095764,3095831
18637,86,20,1,5.95,15.63,3095830,3095916
18638,65,23,1,7.88,26.78,3095915,3095980
18639,48,44,1,10.67,77.64,3095980,3096028
18640,59,35,0,8.68,28.15,3096027,3096086
18641,61,31,1,8.39,33.91,3096086,3096147
18642,66,43,1,7.76,35.61,3096146,3096212
18643,64,31,0,8.00,31.72,3096211,3096275
18644,51,35,2,10.04,55.33,3096274,3096325
18645,63,44,1,8.13,38.52,3096325,3096388
18646,39,73,1,13.13,287.34,3096387,3096426
18647,44,46,2,11.64,99.69,3096425,3096469
18648,35,99,4,14.63,241.03,3096468,3096503
18649,54,28,2,9.48,22.69,3096502,3096556
18650,55,30,1,9.31,40.98,3096555,3096610
18651,55,77,1,9.31,110.65,3096609,3096664
18652,55,35,3,9.31,52.40,3096663,3096718
18653,64,32,1,8.00,33.81,3096717,3096781
18654,56,53,0,9.14,63.52,3096780,3096836
18655,52,37,0,9.85,68.05,3096835,3096887
18656,45,65,1,11.38,127.08,3096886,3096931
18657,59,30,0,8.68,57.03,3096930,3096989
18658,52,32,1,9.85,52.78,3096988,3097040
18659,77,66,0,6.65,81.01,3097039,3097116
18660,86,20,0,5.95,22.28,3097115,3097201
18661,61,42,1,8.39,77.06,3097200,3097261
18662,97,27,0,5.28,28.06,3097261,3097358
18663,50,78,0,10.24,175.02,3097357,3097407
18664,65,57,0,7.88,85.25,3097406,3097471
18665,66,26,1,7.76,29.46,3097470,3097536
18666,62,81,1,8.26,120.71,3097535,3097597
18667,64,37,0,8.00,44.69,3097596,3097660
18668,77,44,0,6.65,55.21,3097659,3097736
18669,68,32,1,7.53,36.25,3097735,3097803
18670,68,35,0,7.53,30.10,3097802,3097870
18671,89,23,0,5.75,17.71,3097869,3097958
18672,69,20,1,7.42,20.91,3097957,3098026
18673,31,178,2,16.52,935.86,3098025,3098056
18674,47,30,2,10.89,36.65,3098055,3098102
18675,47,34,1,10.89,68.27,3098101,3098148
18676,70,32,0,7.31,26.27,3098147,3098217
18677,53,36,0,9.66,59.62,3098216,3098269
18678,50,82,0,10.24,195.94,3098268,3098318
18679,44,69,1,11.64,185.55,3098317,3098361
18680,43,45,2,11.91,71.76,3098360,3098403
18681,46,57,0,11.13,75.59,3098402,3098448
18682,50,37,1,10.24,65.38,3098447,3098497
18683,47,37,2,10.89,76.65,3098496,3098543
18684,54,37,1,9.48,47.88,3098542,3098596
18685,71,25,0,7.21,22.34,3098595,3098666
18686,50,44,0,10.24,66.14,3098665,3098715
18687,36,36,3,14.22,70.06,3098714,3098750
18688,51,34,1,10.04,47.76,3098749,3098800
18689,46,91,1,11.13,173.50,3098799,3098845
18690,62,37,0,8.26,58.74,3098845,3098907
18691,46,59,1,11.13,132.16,3098906,3098952
18692,55,34,0,9.31,58.54,3098951,3099006
18693,57,52,0,8.98,64.47,3099005,3099062
18694,79,38,0,6.48,35.59,3099061,3099140
18695,73,63,0,7.01,104.95,3099139,3099212
18696,95,29,0,5.39,28.03,3099212,3099307
18697,74,34,0,6.92,36.48,3099306,3099380
18698,45,140,1,11.38,436.99,3099379,3099424
18699,70,27,1,7.31,28.27,3099423,3099493
18700,67,29,1,7.64,42.17,3099493,3099560
18701,61,33,1,8.39,40.86,3099559,3099620
18702,79,30,1,6.48,24.07,3099619,3099698
18703,68,37,0,7.53,52.63,3099698,3099766
18704,74,26,1,6.92,29.13,3099765,3099839
18705,75,30,0,6.83,22.14,3099838,3099913
18706,61,42,1,8.39,47.42,3099912,3099973
18707,60,29,1,8.53,31.82,3099973,3100033
18708,56,39,0,9.14,60.77,3100032,3100088
18709,45,47,2,11.38,73.48,3100087,3100132
18710,67,28,1,7.64,30.80,3100131,3100198
18711,67,27,1,7.64,21.84,3100197,3100264
18712,47,44,1,10.89,90.78,3100263,3100310
18713,52,29,0,9.85,43.90,3100309,3100361
18714,43,71,3,11.91,181.62,3100361,3100404
18715,46,34,2,11.13,39.42,3100403,3100449
18716,57,49,1,8.98,49.14,3100448,3100505
18717,56,50,1,9.14,66.55,3100504,3100560
18718,51,39,1,10.04,52.70,3100559,3100610
18719,53,30,1,9.66,44.00,3100609,3100662
18720,70,34,1,7.31,38.22,3100661,3100731
18721,39,60,3,13.13,145.19,3100730,3100769
18722,44,50,0,11.64,121.55,3100768,3100812
18723,43,82,1,11.91,224.13,3100811,3100854
18724,62,30,0,8.26,41.58,3100853,3100915
18725,42,83,0,12.19,215.58,3100914,3100956
18726,48,53,1,10.67,97.97,3100955,3101003
18727,61,39,0,8.39,61.39,3101003,3101064
18728,49,83,0,10.45,173.15,3101064,3101113
18729,72,45,0,7.11,75.13,3101112,3101184
18730,93,38,0,5.51,27.41,3101183,3101276
18731,60,51,0,8.53,104.22,3101276,3101336
18732,84,32,0,6.10,33.97,3101335,3101419
18733,76,28,0,6.74,42.98,3101419,3101495
18734,63,54,1,8.13,67.22,3101494,3101557
18735,64,45,0,8.00,60.06,3101556,3101620
18736,66,36,0,7.76,44.30,3101619,3101685
18737,80,20,0,6.40,14.89,3101684,3101764
18738,66,48,0,7.76,42.55,3101763,3101829
18739,64,34,2,8.00,40.25,3101828,3101892
18740,75,20,1,6.83,22.04,3101891,3101966
18741,71,32,0,7.21,41.32,3101965,3102036
18742,48,43,1,10.67,81.26,3102035,3102083
18743,46,40,2,11.13,60.29,3102083,3102129
18744,56,29,1,9.14,41.16,3102128,3102184
18745,57,48,1,8.98,51.88,3102183,3102240
18746,60,23,0,8.53,22.18,3102239,3102299
18747,46,47,1,11.13,94.50,3102298,3102344
18748,50,37,2,10.24,62.14,3102344,3102394
18749,50,39,1,10.24,58.42,3102393,3102443
18750,57,27,0,8.98,35.25,3102442,3102499
18751,51,39,2,10.04,49.76,3102498,3102549
18752,59,26,0,8.68,36.52,3102548,3102607
18753,60,42,1,8.53,48.65,3102606,3102666
18754,60,27,1,8.53,28.28,3102665,3102725
18755,43,48,2,11.91,90.88,3102724,3102767
18756,51,34,0,10.04,71.10,3102766,3102817
18757,56,34,1,9.14,40.55,3102816,3102872
18758,59,33,0,8.68,41.57,3102871,3102930
18759,54,31,0,9.48,39.36,3102929,3102983
18760,42,57,1,12.19,159.96,3102982,3103024
18761,55,27,0,9.31,37.78,3103023,3103078
18762,47,44,0,10.89,120.35,3103078,3103125
18763,52,43,0,9.85,97.51,3103125,3103177
18764,75,59,0,6.83,75.18,3103176,3103251
18765,95,42,0,5.39,32.83,3103250,3103345
18766,53,48,0,9.66,98.90,3103344,3103397
18767,54,54,0,9.48,99.10,3103396,3103450
18768,91,18,0,5.63,11.97,3103449,3103540
18769,71,18,1,7.21,17.88,3103539,3103610
18770,65,47,0,7.88,53.06,3103609,3103674
18771,70,22,1,7.31,24.64,3103673,3103743
18772,71,25,1,7.21,27.55,3103742,3103813
18773,73,49,0,7.01,52.95,3103812,3103885
18774,73,41,1,7.01,47.08,3103884,3103957
18775,58,56,0,8.83,65.87,3103956,3104014
18776,39,91,1,13.13,219.75,3104013,3104052
18777,50,37,2,10.24,46.82,3104051,3104101
18778,51,43,0,10.04,85.57,3104100,3104151
18779,52,48,1,9.85,78.25,3104150,3104202
18780,47,82,2,10.89,171.84,3104201,3104248
18781,57,29,1,8.98,35.70,3104247,3104304
18782,41,62,2,12.49,149.71,3104304,3104345
18783,54,43,0,9.48,60.29,3104345,3104399
18784,47,50,1,10.89,93.67,3104399,3104446
18785,52,40,1,9.85,54.28,3104445,3104497
18786,34,71,2,15.06,236.53,3104496,3104530
18787,66,30,2,7.76,26.43,3104530,3104596
18788,45,51,1,11.38,123.66,3104595,3104640
18789,34,65,2,15.06,177.76,3104639,3104673
18790,59,30,1,8.68,34.22,3104672,3104731
18791,58,29,1,8.83,33.38,3104730,3104788
18792,44,34,2,11.64,79.41,3104787,3104831
18793,36,82,0,14.22,201.62,3104830,3104866
18794,34,63,0,15.06,276.23,3104865,3104899
18795,55,61,0,9.31,97.63,3104898,3104953
18796,55,57,0,9.31,110.18,3104952,3105007
18797,54,51,0,9.48,94.06,3105006,3105060
18798,62,43,0,8.26,52.97,3105059,3105121
18799,77,23,0,6.65,26.75,3105121,3105198
18800,87,29,0,5.89,30.29,3105197,3105284
18801,89,18,0,5.75,18.61,3105283,3105372
18802,80,30,0,6.40,29.44,3105371,3105451
18803,58,54,1,8.83,102.63,3105450,3105508
18804,72,28,1,7.11,24.77,3105507,3105579
18805,60,62,1,8.53,81.42,3105578,3105638
18806,67,24,1,7.64,25.16,3105637,3105704
18807,58,49,0,8.83,85.35,3105703,3105761
18808,61,42,1,8.39,53.85,3105760,3105821
18809,72,39,0,7.11,39.32,3105820,3105892
18810,74,36,0,6.92,40.72,3105891,3105965
18811,66,50,0,7.76,64.58,3105964,3106030
18812,53,37,1,9.66,54.71,3106029,3106082
18813,46,131,2,11.13,348.68,3106081,3106127
18814,54,41,1,9.48,65.58,3106126,3106180
18815,51,35,1,10.04,46.04,3106179,3106230
18816,58,37,1,8.83,47.56,3106229,3106287
18817,54,26,1,9.48,34.14,3106286,3106340
18818,52,46,1,9.85,78.05,3106340,3106392
18819,54,28,1,9.48,41.88,3106392,3106446
18820,53,62,1,9.66,90.71,3106445,3106498
18821,47,24,1,10.89,28.56,3106497,3106544
18822,51,30,1,10.04,34.70,3106543,3106594
18823,46,75,2,11.13,140.24,3106594,3106640
18824,50,42,1,10.24,63.98,3106639,3106689
18825,64,20,1,8.00,21.78,3106688,3106752
18826,37,168,1,13.84,709.16,3106752,3106789
18827,65,31,1,7.88,41.95,3106788,3106853
18828,36,41,2,14.22,109.78,3106852,3106888
18829,50,56,1,10.24,97.46,3106887,3106937
18830,42,107,1,12.19,274.58,3106936,3106978
18831,45,48,1,11.38,78.99,3106977,3107022
18832,34,62,2,15.06,197.82,3107021,3107055
18833,47,47,0,10.89,102.52,3107054,3107101
18834,33,68,1,15.52,196.55,3107100,3107133
18835,62,52,1,8.26,74.19,3107132,3107194
18836,78,32,0,6.56,40.45,3107193,3107271
18837,79,33,0,6.48,33.11,3107270,3107349
18838,84,30,0,6.10,32.28,3107348,3107432
18839,64,30,1,8.00,36.00,3107432,3107496
18840,74,59,0,6.92,79.21,3107495,3107569
18841,56,49,1,9.14,54.23,3107568,3107624
18842,70,20,0,7.31,17.82,3107623,3107693
18843,63,63,1,8.13,72.40,3107692,3107755
18844,65,37,1,7.88,42.85,3107754,3107819
18845,59,36,0,8.68,54.73,3107818,3107877
18846,79,41,1,6.48,32.30,3107876,3107955
18847,61,35,1,8.39,43.32,3107954,3108015
18848,65,29,0,7.88,46.32,3108014,3108079
18849,52,51,1,9.85,80.36,3108078,3108130
18850,45,86,2,11.38,166.46,3108129,3108174
18851,60,25,1,8.53,27.75,3108173,3108233
18852,45,61,1,11.38,114.81,3108232,3108277
18853,51,40,1,10.04,61.53,3108276,3108327
18854,48,67,1,10.67,121.64,3108326,3108374
18855,53,45,1,9.66,52.15,3108373,3108426
18856,54,28,2,9.48,31.81,3108425,3108479
18857,61,27,1,8.39,26.76,3108478,3108539
18858,65,27,1,7.88,29.83,3108538,3108603
18859,53,33,1,9.66,40.11,3108602,3108655
18860,59,30,0,8.68,40.35,3108654,3108713
18861,38,53,1,13.47,127.83,3108712,3108750
18862,58,31,1,8.83,46.83,3108750,3108808
18863,57,64,0,8.98,121.63,3108807,3108864
18864,43,38,1,11.91,67.62,3108863,3108906
18865,56,54,1,9.14,83.94,3108905,3108961
18866,84,36,0,6.10,30.92,3108960,3109044
18867,86,29,0,5.95,25.63,3109043,3109129
18868,77,40,0,6.65,53.06,3109128,3109205
18869,93,25,0,5.51,22.79,3109204,3109297
18870,77,26,1,6.65,23.11,3109296,3109373
18871,71,26,1,7.21,32.96,3109373,3109444
18872,75,29,1,6.83,31.82,3109444,3109519
18873,87,21,0,5.89,19.18,3109518,3109605
18874,80,33,1,6.40,22.09,3109605,3109685
18875,49,42,1,10.45,67.64,3109684,3109733
18876,54,26,0,9.48,30.66,3109732,3109786
18877,53,32,1,9.66,51.88,3109785,3109838
18878,52,37,0,9.85,70.44,3109837,3109889
18879,58,27,0,8.83,40.35,3109889,3109947
18880,58,35,1,8.83,34.69,3109946,3110004
18881,53,38,2,9.66,47.24,3110004,3110057
18882,59,34,1,8.68,41.64,3110056,3110115
18883,38,101,2,13.47,261.62,3110114,3110152
18884,55,43,0,9.31,46.43,3110151,3110206
18885,48,69,1,10.67,108.97,3110205,3110253
18886,56,50,1,9.14,56.52,3110252,3110308
18887,67,32,0,7.64,35.93,3110307,3110374
18888,60,26,1,8.53,36.48,3110373,3110433
18889,48,44,2,10.67,71.43,3110432,3110480
18890,37,64,1,13.84,185.33,3110479,3110516
18891,37,52,1,13.84,105.70,3110515,3110552
18892,58,28,0,8.83,37.04,3110551,3110609
18893,58,35,0,8.83,67.59,3110608,3110666
18894,46,37,1,11.13,63.72,3110665,3110711
18895,62,30,0,8.26,59.32,3110710,3110772
18896,71,28,0,7.21,34.36,3110771,3110842
18897,101,21,0,5.07,19.35,3110841,3110942
18898,74,46,0,6.92,47.94,3110941,3111015
18899,79,41,0,6.48,42.07,3111014,3111093
18900,77,29,0,6.65,23.97,3111092,3111169
18901,74,31,1,6.92,31.86,3111168,3111242
18902,60,79,0,8.53,127.45,3111241,3111301
18903,78,19,1,6.56,17.14,3111300,3111378
18904,66,37,1,7.76,45.21,3111377,3111443
18905,61,44,1,8.39,82.21,3111442,3111503
18906,66,57,1,7.76,65.70,3111502,3111568
18907,74,37,1,6.92,34.83,3111567,3111641
18908,66,28,0,7.76,34.27,3111640,3111706
18909,51,35,0,10.04,59.10,3111705,3111756
18910,53,64,1,9.66,88.56,3111755,3111808
18911,50,31,2,10.24,49.10,3111807,3111857
18912,57,40,0,8.98,45.25,3111856,3111913
18913,52,32,1,9.85,50.17,3111912,3111964
18914,65,22,0,7.88,26.08,3111963,3112028
18915,47,33,2,10.89,46.56,3112027,3112074
18916,43,42,1,11.91,97.29,3112073,3112116
18917,45,68,2,11.38,98.77,3112115,3112160
18918,50,35,3,10.24,43.30,3112159,3112209
18919,53,35,1,9.66,46.53,3112208,3112261
18920,52,32,0,9.85,45.44,3112261,3112313
18921,56,49,1,9.14,66.87,3112312,3112368
18922,51,36,0,10.04,52.90,3112367,3112418
18923,60,28,1,8.53,32.52,3112417,3112477
18924,62,24,1,8.26,31.64,3112476,3112538
18925,43,38,1,11.91,88.69,3112537,3112580
18926,59,52,1,8.68,63.34,3112579,3112638
18927,48,48,1,10.67,81.60,3112637,3112685
18928,53,54,0,9.66,92.87,3112684,3112737
18929,61,44,0,8.39,53.88,3112736,3112797
18930,64,47,0,8.00,77.00,3112796,3112860
18931,66,82,0,7.76,103.43,3112859,3112925
18932,85,34,0,6.02,40.35,3112924,3113009
18933,83,39,0,6.17,46.12,3113008,3113091
18934,82,50,0,6.24,34.72,3113090,3113172
18935,62,38,0,8.26,47.32,3113171,3113233
18936,76,20,1,6.74,20.48,3113232,3113308
18937,60,36,0,8.53,45.82,3113307,3113367
18938,65,33,1,7.88,35.09,3113367,3113432
18939,60,41,1,8.53,49.25,3113431,3113491
18940,57,58,0,8.98,104.47,3113490,3113547
18941,83,17,0,6.17,17.39,3113546,3113629
18942,74,36,0,6.92,37.75,3113628,3113702
18943,62,28,0,8.26,41.61,3113702,3113764
18944,56,79,0,9.14,126.62,3113763,3113819
18945,57,33,1,8.98,42.75,3113818,3113875
18946,67,47,1,7.64,40.92,3113874,3113941
18947,59,44,0,8.68,46.08,3113940,3113999
18948,46,44,2,11.13,51.64,3113998,3114044
18949,47,41,0,10.89,66.69,3114043,3114090
18950,45,25,1,11.38,37.21,3114089,3114134
18951,57,36,0,8.98,34.68,3114133,3114190
18952,38,123,2,13.47,370.35,3114189,3114227
18953,48,41,1,10.67,52.01,3114226,3114274
18954,55,52,1,9.31,58.18,3114273,3114328
18955,57,46,1,8.98,43.63,3114327,3114384
18956,49,49,2,10.45,56.45,3114383,3114432
18957,59,24,2,8.68,29.00,3114431,3114490
18958,61,50,0,8.39,62.27,3114489,3114550
18959,60,26,2,8.53,34.58,3114549,3114609
18960,42,38,3,12.19,72.39,3114608,3114650
18961,57,43,0,8.98,69.00,3114649,3114706
18962,57,38,0,8.98,70.23,3114705,3114762
18963,37,73,1,13.84,178.35,3114761,3114798
18964,60,33,1,8.53,34.35,3114798,3114858
18965,58,31,0,8.83,50.21,3114857,3114915
18966,54,73,0,9.48,168.47,3114914,3114968
18967,58,62,0,8.83,121.76,3114967,3115025
18968,76,51,0,6.74,74.51,3115024,3115100
18969,69,41,0,7.42,67.26,3115099,3115168
18970,70,40,0,7.31,45.24,3115167,3115237
18971,83,22,0,6.17,21.15,3115236,3115319
18972,69,39,0,7.42,48.16,3115318,3115387
18973,70,55,1,7.31,57.13,3115386,3115456
18974,82,25,1,6.24,19.40,3115455,3115537
18975,68,24,0,7.53,37.75,3115536,3115604
18976,62,99,1,8.26,163.32,3115603,3115665
18977,80,17,1,6.40,15.84,3115665,3115745
18978,65,22,1,7.88,20.08,3115744,3115809
18979,60,30,1,8.53,26.58,3115809,3115869
18980,51,26,0,10.04,30.98,3115868,3115919
18981,58,46,1,8.83,66.63,3115918,3115976
18982,62,21,1,8.26,21.68,3115975,3116037
18983,52,23,2,9.85,31.01,3116036,3116088
18984,56,38,2,9.14,41.23,3116087,3116143
18985,53,32,1,9.66,48.11,3116142,3116195
18986,46,28,2,11.13,44.98,3116194,3116240
18987,48,27,1,10.67,35.76,3116239,3116287
18988,57,24,1,8.98,33.60,3116286,3116343
18989,45,29,4,11.38,38.10,3116342,3116387
18990,60,25,1,8.53,33.65,3116386,3116446
18991,56,26,2,9.14,35.23,3116445,3116501
18992,53,38,1,9.66,40.56,3116501,3116554
18993,37,45,3,13.84,94.46,3116553,3116590
18994,44,45,1,11.64,100.41,3116589,3116633
18995,38,57,2,13.47,116.57,3116632,3116670
18996,57,40,1,8.98,67.84,3116669,3116726
18997,60,29,1,8.53,32.88,3116725,3116785
18998,48,34,1,10.67,64.10,3116784,3116832
18999,66,37,0,7.76,47.03,3116831,3116897
19000,54,57,1,9.48,115.84,3116896,3116950
19001,66,41,1,7.76,62.21,3116949,3117015
19002,85,21,0,6.02,22.28,3117014,3117099
19003,81,41,0,6.32,45.28,3117098,3117179
19004,70,48,1,7.31,47.73,3117178,3117248
19005,69,30,0,7.42,51.75,3117247,3117316
19006,67,26,1,7.64,26.86,3117315,3117382
19007,71,30,1,7.21,31.72,3117381,3117452
19008,58,32,1,8.83,41.63,3117451,3117509
19009,73,22,0,7.01,28.45,3117508,3117581
19010,70,28,1,7.31,30.64,3117580,3117650
19011,82,24,0,6.24,19.65,3117649,3117731
19012,71,69,0,7.21,83.24,3117730,3117801
19013,54,61,1,9.48,72.77,3117800,3117854
19014,45,58,1,11.38,112.68,3117853,3117898
19015,51,41,0,10.04,72.86,3117897,3117948
19016,40,100,1,12.80,291.31,3117948,3117988
19017,59,45,1,8.68,66.69,3117987,3118046
19018,45,52,1,11.38,87.17,3118045,3118090
19019,51,28,0,10.04,49.53,3118089,3118140
19020,46,71,1,11.13,142.55,3118139,3118185
19021,47,27,1,10.89,42.56,3118184,3118231
19022,37,118,1,13.84,345.16,3118230,3118267
19023,55,60,0,9.31,94.65,3118266,3118321
19024,62,23,1,8.26,21.61,3118321,3118383
19025,51,28,2,10.04,50.55,3118383,3118434
19026,50,27,1,10.24,43.18,3118433,3118483
19027,66,28,0,7.76,34.24,3118483,3118549
19028,62,22,0,8.26,24.09,3118548,3118610
19029,48,61,1,10.67,116.47,3118609,3118657
19030,52,40,1,9.85,77.32,3118656,3118708
19031,80,31,0,6.40,31.57,3118707,3118787
19032,75,76,0,6.83,101.18,3118786,3118861
19033,83,33,0,6.17,32.28,3118860,3118943
19034,80,40,0,6.40,36.64,3118943,3119023
19035,64,27,1,8.00,35.34,3119023,3119087
19036,81,30,1,6.32,20.22,3119087,3119168
19037,67,36,1,7.64,38.02,3119167,3119234
19038,66,23,1,7.76,32.09,3119234,3119300
19039,74,27,0,6.92,21.78,3119299,3119373
19040,58,46,2,8.83,50.35,3119373,3119431
19041,62,27,1,8.26,28.39,3119430,3119492
19042,49,37,1,10.45,39.47,3119491,3119540
19043,55,25,1,9.31,30.50,3119539,3119594
19044,54,43,1,9.48,62.18,3119593,3119647
19045,56,39,1,9.14,47.84,3119646,3119702
19046,46,38,2,11.13,76.72,3119701,3119747
19047,50,45,0,10.24,78.58,3119746,3119796
19048,53,28,0,9.66,36.56,3119795,3119848
19049,46,31,0,11.13,56.77,3119847,3119893
19050,54,59,0,9.48,77.21,3119892,3119946
19051,57,39,1,8.98,35.81,3119945,3120002
19052,63,24,1,8.13,30.90,3120002,3120065
19053,54,33,1,9.48,38.14,3120064,3120118
19054,64,34,0,8.00,37.81,3120117,3120181
19055,50,36,1,10.24,54.98,3120180,3120230
19056,35,52,1,14.63,163.43,3120229,3120264
19057,39,59,0,13.13,118.47,3120263,3120302
19058,68,25,0,7.53,29.22,3120302,3120370
19059,45,59,1,11.38,146.95,3120369,3120414
19060,51,40,0,10.04,61.72,3120413,3120464
19061,60,38,0,8.53,61.18,3120463,3120523
19062,56,35,0,9.14,59.87,3120522,3120578
19063,67,99,0,7.64,165.24,3120577,3120644
19064,67,37,0,7.64,49.60,3120643,3120710
19065,70,48,1,7.31,62.64,3120710,3120780
19066,88,27,0,5.82,31.49,3120779,3120867
19067,73,59,0,7.01,76.12,3120866,3120939
19068,63,26,1,8.13,34.02,3120938,3121001
19069,63,38,0,8.13,44.71,3121000,3121063
19070,74,21,1,6.92,18.72,3121063,3121137
19071,62,47,0,8.26,65.77,3121136,3121198
19072,54,30,0,9.48,41.99,3121197,3121251
19073,65,70,1,7.88,104.60,3121250,3121315
19074,33,217,2,15.52,1336.49,3121314,3121347
19075,55,48,0,9.31,84.14,3121346,3121401
19076,71,28,1,7.21,24.42,3121400,3121471
19077,52,31,1,9.85,41.01,3121470,3121522
19078,35,46,1,14.63,105.83,3121521,3121556
19079,43,64,1,11.91,169.25,3121556,3121599
19080,55,38,0,9.31,52.18,3121598,3121653
19081,58,52,1,8.83,68.76,3121652,3121710
19082,35,61,1,14.63,199.89,3121709,3121744
19083,51,29,2,10.04,42.16,3121743,3121794
19084,47,35,2,10.89,53.63,3121793,3121840
19085,41,53,4,12.49,74.98,3121839,3121880
19086,35,117,3,14.63,380.69,3121879,3121914
19087,49,43,1,10.45,64.45,3121913,3121962
19088,39,71,1,13.13,182.88,3121961,3122000
19089,62,29,1,8.26,35.90,3122000,3122062
19090,57,31,1,8.98,28.61,3122061,3122118
19091,59,37,1,8.68,40.69,3122117,3122176
19092,48,27,1,10.67,36.68,3122175,3122223
19093,31,49,3,16.52,129.09,3122222,3122253
19094,41,49,1,12.49,110.88,3122252,3122293
19095,54,30,1,9.48,51.66,3122292,3122346
19096,53,39,0,9.66,57.32,3122346,3122399
19097,62,30,0,8.26,32.42,3122398,3122460
19098,31,104,1,16.52,545.73,3122459,3122490
19099,59,148,0,8.68,354.46,3122489,3122548
19100,45,126,0,11.38,352.59,3122547,3122592
19101,71,38,0,7.21,47.04,3122591,3122662
19102,64,57,0,8.00,108.31,3122661,3122725
19103,61,59,1,8.39,84.07,3122724,3122785
19104,78,34,0,6.56,44.43,3122784,3122862
19105,47,138,0,10.89,415.67,3122861,3122908
19106,92,32,0,5.57,19.77,3122907,3122999
19107,76,31,1,6.74,30.46,3122998,3123074
19108,65,48,1,7.88,46.75,3123073,3123138
19109,86,17,0,5.95,13.49,3123137,3123223
19110,55,83,1,9.31,125.09,3123222,3123277
19111,90,30,0,5.69,17.37,3123276,3123366
19112,66,26,1,7.76,28.91,3123365,3123431
19113,51,32,1,10.04,50.08,3123430,3123481
19114,53,35,1,9.66,37.43,3123480,3123533
19115,47,33,1,10.89,59.16,3123532,3123579
19116,53,39,0,9.66,69.66,3123578,3123631
19117,50,47,1,10.24,66.10,3123630,3123680
19118,55,49,0,9.31,71.96,3123679,3123734
19119,47,65,1,10.89,108.35,3123733,3123780
19120,50,65,0,10.24,96.78,3123779,3123829
19121,59,31,1,8.68,30.52,3123828,3123887
19122,40,65,3,12.80,110.51,3123886,3123926
19123,41,53,1,12.49,75.62,3123925,3123966
19124,49,47,1,10.45,58.53,3123965,3124014
19125,62,41,0,8.26,55.29,3124013,3124075
19126,53,29,1,9.66,42.90,3124074,3124127
19127,58,24,2,8.83,25.90,3124126,3124184
19128,60,27,2,8.53,32.85,3124183,3124243
19129,48,65,1,10.67,106.89,3124242,3124290
19130,23,142,1,22.26,823.67,3124289,3124312
19131,39,94,2,13.13,255.60,3124311,3124350
19132,79,35,1,6.48,33.62,3124349,3124428
19133,50,32,1,10.24,51.38,3124427,3124477
19134,52,38,0,9.85,89.98,3124476,3124528
19135,50,47,0,10.24,81.58,3124527,3124577
19136,75,31,1,6.83,38.60,3124576,3124651
19137,101,25,0,5.07,19.91,3124651,3124752
19138,56,48,0,9.14,96.44,3124751,3124807
19139,82,46,0,6.24,57.31,3124806,3124888
19140,71,48,0,7.21,48.22,3124887,3124958
19141,60,37,1,8.53,41.88,3124957,3125017
19142,64,70,0,8.00,90.16,3125016,3125080
19143,59,51,1,8.68,80.52,3125079,3125138
19144,72,32,0,7.11,29.90,3125138,3125210
19145,63,51,0,8.13,72.40,3125209,3125272
19146,72,33,1,7.11,27.71,3125271,3125343
19147,54,41,1,9.48,48.36,3125342,3125396
19148,60,55,1,8.53,58.92,3125395,3125455
19149,40,94,1,12.80,227.11,3125454,3125494
19150,55,33,1,9.31,33.27,3125493,3125548
19151,45,118,1,11.38,287.75,3125547,3125592
19152,53,37,1,9.66,50.00,3125591,3125644
19153,62,35,2,8.26,25.39,3125643,3125705
19154,52,68,1,9.85,140.28,3125704,3125756
19155,48,42,1,10.67,67.01,3125755,3125803
19156,42,51,1,12.19,90.15,3125802,3125844
19157,41,87,1,12.49,219.52,3125843,3125884
19158,55,24,2,9.31,28.76,3125883,3125938
19159,28,158,2,18.29,807.63,3125937,3125965
19160,52,37,1,9.85,44.78,3125964,3126016
19161,56,32,0,9.14,34.02,3126015,3126071
19162,53,25,1,9.66,28.26,3126070,3126123
19163,35,125,2,14.63,387.60,3126123,3126158
19164,52,33,2,9.85,50.86,3126158,3126210
19165,46,60,1,11.13,99.59,3126209,3126255
19166,61,53,0,8.39,70.53,3126254,3126315
19167,36,159,1,14.22,697.01,3126314,3126350
19168,56,33,1,9.14,52.52,3126349,3126405
19169,55,58,0,9.31,114.90,3126404,3126459
19170,57,33,1,8.98,49.10,3126458,3126515
19171,41,58,0,12.49,211.08,3126514,3126555
19172,63,36,0,8.13,57.29,3126554,3126617
19173,78,36,0,6.56,38.84,3126616,3126694
19174,72,38,0,7.11,48.27,3126693,3126765
19175,76,31,0,6.74,36.35,3126764,3126840
19176,68,30,0,7.53,50.40,3126840,3126908
19177,67,44,0,7.64,77.48,3126907,3126974
19178,62,26,1,8.26,35.09,3126973,3127035
19179,64,72,0,8.00,98.81,3127035,3127099
19180,64,31,1,8.00,37.66,3127098,3127162
19181,59,62,0,8.68,97.24,3127161,3127220
19182,69,26,0,7.42,29.08,3127219,3127288
19183,65,32,1,7.88,42.42,3127287,3127352
19184,57,62,0,8.98,84.44,3127351,3127408
19185,43,66,1,11.91,103.43,3127407,3127450
19186,44,42,1,11.64,107.91,3127449,3127493
19187,52,33,1,9.85,37.25,3127492,3127544
19188,54,51,0,9.48,65.06,3127543,3127597
19189,65,30,1,7.88,34.14,3127596,3127661
19190,56,26,1,9.14,37.84,3127660,3127716
19191,52,40,1,9.85,55.25,3127715,3127767
19192,54,27,1,9.48,35.47,3127766,3127820
19193,49,41,1,10.45,87.80,3127819,3127868
19194,45,27,1,11.38,27.97,3127867,3127912
19195,39,49,1,13.13,103.03,3127911,3127950
19196,55,24,1,9.31,34.58,3127949,3128004
19197,68,21,0,7.53,20.84,3128003,3128071
19198,57,39,0,8.98,57.84,3128070,3128127
19199,67,57,1,7.64,56.44,3128126,3128193
19200,40,43,1,12.80,111.21,3128192,3128232
19201,34,64,2,15.06,195.29,3128231,3128265
19202,39,49,3,13.13,134.11,3128264,3128303
19203,43,31,3,11.91,49.57,3128302,3128345
19204,47,51,1,10.89,92.39,3128344,3128391
19205,57,35,1,8.98,52.72,3128390,3128447
19206,38,78,1,13.47,226.41,3128446,3128484
19207,45,41,2,11.38,83.88,3128483,3128528
19208,51,36,0,10.04,75.21,3128527,3128578
19209,47,61,2,10.89,170.95,3128578,3128625
19210,77,33,0,6.65,43.21,3128624,3128701
19211,76,39,0,6.74,54.22,3128700,3128776
19212,58,51,1,8.83,75.66,3128775,3128833
19213,78,56,0,6.56,55.91,3128832,3128910
19214,56,61,1,9.14,75.98,3128909,3128965
19215,59,57,0,8.68,84.46,3128965,3129024
19216,64,22,1,8.00,29.84,3129024,3129088
19217,58,28,1,8.83,44.21,3129087,3129145
19218,76,20,1,6.74,17.35,3129144,3129220
19219,55,38,1,9.31,78.98,3129219,3129274
19220,69,32,0,7.42,26.62,3129273,3129342
19221,76,26,1,6.74,26.09,3129341,3129417
19222,53,36,0,9.66,54.87,3129416,3129469
19223,41,76,1,12.49,178.98,3129468,3129509
19224,42,75,1,12.19,192.11,3129508,3129550
19225,52,51,1,9.85,98.21,3129549,3129601
19226,60,27,1,8.53,31.48,3129600,3129660
19227,40,64,2,12.80,185.56,3129659,3129699
19228,54,53,0,9.48,76.88,3129698,3129752
19229,32,45,1,16.00,144.31,3129751,3129783
19230,51,43,0,10.04,69.14,3129783,3129834
19231,25,70,4,20.48,479.29,3129833,3129858
19232,55,37,2,9.31,51.30,3129857,3129912
19233,37,73,2,13.84,179.11,3129911,3129948
19234,40,56,1,12.80,119.56,3129947,3129987
19235,54,29,0,9.48,33.55,3129986,3130040
19236,54,26,1,9.48,34.66,3130039,3130093
19237,53,47,0,9.66,53.39,3130092,3130145
19238,44,40,1,11.64,99.32,3130144,3130188
19239,44,95,1,11.64,214.00,3130187,3130231
19240,50,79,2,10.24,140.02,3130231,3130281
19241,24,104,4,21.33,431.64,3130280,3130304
19242,30,115,2,17.07,427.60,3130303,3130333
19243,31,155,2,16.52,722.57,3130332,3130363
19244,69,61,0,7.42,81.29,3130362,3130431
19245,48,53,0,10.67,143.10,3130430,3130478
19246,47,56,1,10.89,97.63,3130477,3130524
19247,51,36,0,10.04,81.37,3130523,3130574
19248,61,38,0,8.39,52.04,3130573,3130634
19249,79,41,0,6.48,43.84,3130633,3130712
19250,64,66,0,8.00,131.53,3130711,3130775
19251,84,47,0,6.10,54.32,3130774,3130858
19252,62,57,1,8.26,78.16,3130857,3130919
19253,75,25,0,6.83,32.60,3130918,3130993
19254,61,56,0,8.39,64.11,3130992,3131053
19255,73,31,0,7.01,33.00,3131052,3131125
19256,64,58,1,8.00,67.03,3131124,3131188
19257,68,35,0,7.53,55.07,3131187,3131255
19258,77,34,1,6.65,33.89,3131254,3131331
19259,59,63,1,8.68,108.39,3131330,3131389
19260,61,37,0,8.39,54.53,3131388,3131449
19261,62,51,0,8.26,56.93,3131448,3131510
19262,48,80,0,10.67,187.18,3131509,3131557
19263,51,32,2,10.04,50.74,3131556,3131607
19264,63,28,1,8.13,28.33,3131606,3131669
19265,46,83,1,11.13,152.46,3131668,3131714
19266,57,45,1,8.98,56.02,3131713,3131770
19267,39,47,2,13.13,141.24,3131770,3131809
19268,48,71,1,10.67,118.64,3131808,3131856
19269,50,34,1,10.24,54.34,3131855,3131905
19270,52,22,1,9.85,33.86,3131904,3131956
19271,48,32,1,10.67,64.43,3131955,3132003
19272,60,30,1,8.53,38.75,3132002,3132062
19273,56,38,1,9.14,45.23,3132062,3132118
19274,51,31,1,10.04,44.39,3132117,3132168
19275,59,25,1,8.68,30.42,3132167,3132226
19276,62,26,1,8.26,26.84,3132225,3132287
19277,45,51,0,11.38,104.19,3132286,3132331
19278,50,35,1,10.24,61.34,3132330,3132380
19279,67,31,1,7.64,27.16,3132379,3132446
19280,51,39,1,10.04,74.35,3132445,3132496
19281,66,28,0,7.76,34.61,3132495,3132561
19282,61,63,0,8.39,105.94,3132560,3132621
19283,83,53,0,6.17,59.15,3132620,3132703
19284,80,39,0,6.40,55.59,3132702,3132782
19285,86,27,0,5.95,29.46,3132781,3132867
19286,74,29,0,6.92,39.67,3132866,3132940
19287,77,42,1,6.65,51.55,3132939,3133016
19288,71,32,1,7.21,33.35,3133015,3133086
19289,64,33,0,8.00,42.88,3133085,3133149
19290,66,30,0,7.76,34.70,3133148,3133214
19291,55,92,0,9.31,161.16,3133213,3133268
19292,68,28,0,7.53,35.01,3133267,3133335
19293,79,23,0,6.48,20.93,3133334,3133413
19294,58,75,0,8.83,105.63,3133412,3133470
19295,49,44,0,10.45,61.64,3133469,3133518
19296,51,35,1,10.04,57.68,3133517,3133568
19297,48,45,1,10.67,75.97,3133567,3133615
19298,51,71,1,10.04,104.00,3133614,3133665
19299,57,33,1,8.98,42.93,3133665,3133722
19300,52,45,1,9.85,79.21,3133721,3133773
19301,54,45,1,9.48,60.10,3133772,3133826
19302,49,44,1,10.45,80.17,3133826,3133875
19303,59,49,0,8.68,56.63,3133874,3133933
19304,44,44,1,11.64,58.91,3133932,3133976
19305,40,49,2,12.80,112.16,3133975,3134015
19306,56,29,1,9.14,33.94,3134014,3134070
19307,51,47,2,10.04,58.94,3134069,3134120
19308,48,59,2,10.67,101.47,3134119,3134167
19309,47,46,0,10.89,65.46,3134167,3134214
19310,42,60,0,12.19,138.73,3134213,3134255
19311,55,50,1,9.31,78.32,3134254,3134309
19312,44,61,2,11.64,98.91,3134308,3134352
19313,36,50,0,14.22,142.45,3134351,3134387
19314,58,23,2,8.83,29.80,3134386,3134444
19315,53,34,0,9.66,56.71,3134443,3134496
19316,52,46,1,9.85,70.28,3134495,3134547
19317,50,54,0,10.24,88.18,3134546,3134596
19318,68,28,0,7.53,28.16,3134595,3134663
19319,101,27,0,5.07,23.91,3134662,3134763
19320,74,36,0,6.92,52.37,3134763,3134837
19321,70,43,0,7.31,64.96,3134837,3134907
19322,63,76,0,8.13,123.95,3134907,3134970
19323,79,46,0,6.48,37.79,3134969,3135048
19324,72,26,0,7.11,26.90,3135047,3135119
19325,80,27,0,6.40,22.54,3135119,3135199
19326,82,23,0,6.24,20.60,3135198,3135280
19327,70,27,1,7.31,36.16,3135280,3135350
19328,81,49,1,6.32,41.21,3135349,3135430
19329,48,64,0,10.67,136.26,3135429,3135477
19330,49,46,2,10.45,59.27,3135476,3135525
19331,57,29,0,8.98,33.74,3135524,3135581
19332,46,35,2,11.13,43.20,3135580,3135626
19333,56,100,1,9.14,213.27,3135625,3135681
19334,54,40,1,9.48,43.06,3135680,3135734
19335,41,131,1,12.49,422.49,3135733,3135774
19336,56,41,1,9.14,56.44,3135773,3135829
19337,42,64,1,12.19,121.44,3135828,3135870
19338,53,43,0,9.66,52.45,3135869,3135922
19339,50,48,1,10.24,63.98,3135921,3135971
19340,62,32,2,8.26,37.71,3135970,3136032
19341,53,29,0,9.66,46.94,3136032,3136085
19342,54,48,0,9.48,65.03,3136084,3136138
19343,33,54,1,15.52,187.70,3136137,3136170
19344,52,43,1,9.85,76.13,3136169,3136221
19345,42,59,1,12.19,172.15,3136220,3136262
19346,51,42,1,10.04,69.10,3136261,3136312
19347,64,44,0,8.00,83.72,3136311,3136375
19348,63,38,0,8.13,49.19,3136374,3136437
19349,85,24,0,6.02,23.08,3136436,3136521
19350,88,41,0,5.82,42.69,3136520,3136608
19351,75,54,0,6.83,57.34,3136607,3136682
19352,70,25,0,7.31,29.47,3136681,3136751
19353,62,35,1,8.26,51.68,3136750,3136812
19354,46,156,1,11.13,500.11,3136812,3136858
19355,69,38,0,7.42,44.71,3136857,3136926
19356,48,34,0,10.67,74.60,3136925,3136973
19357,59,65,1,8.68,131.37,3136972,3137031
19358,66,36,1,7.76,31.30,3137030,3137096
19359,48,44,1,10.67,56.97,3137095,3137143
19360,59,86,1,8.68,136.79,3137142,3137201
19361,48,35,0,10.67,44.26,3137200,3137248
19362,57,31,1,8.98,38.82,3137247,3137304
19363,41,109,1,12.49,271.57,3137303,3137344
19364,47,66,3,10.89,86.39,3137343,3137390
19365,59,33,0,8.68,41.30,3137389,3137448
19366,46,61,1,11.13,117.24,3137447,3137493
19367,52,68,1,9.85,90.82,3137492,3137544
19368,48,48,0,10.67,78.26,3137543,3137591
19369,50,25,2,10.24,33.90,3137590,3137640
19370,64,23,1,8.00,31.66,3137639,3137703
19371,56,34,1,9.14,30.80,3137702,3137758
19372,41,39,1,12.49,90.40,3137757,3137798
19373,63,18,1,8.13,19.86,3137797,3137860
19374,63,27,0,8.13,30.71,3137859,3137922
19375,40,48,2,12.80,110.66,3137921,3137961
19376,40,58,2,12.80,128.11,3137960,3138000
19377,44,66,1,11.64,178.28,3137999,3138043
19378,51,88,0,10.04,193.84,3138042,3138093
19379,50,33,1,10.24,67.30,3138092,3138142
19380,47,51,1,10.89,106.65,3138141,3138188
19381,54,80,0,9.48,177.88,3138187,3138241
19382,60,33,1,8.53,55.62,3138241,3138301
19383,81,45,0,6.32,45.45,3138300,3138381
19384,75,92,0,6.83,135.05,3138380,3138455
19385,73,52,0,7.01,55.74,3138454,3138527
19386,78,27,0,6.56,31.96,3138527,3138605
19387,85,39,0,6.02,31.86,3138605,3138690
19388,79,36,0,6.48,34.25,3138690,3138769
19389,65,32,0,7.88,41.28,3138768,3138833
19390,70,28,1,7.31,23.67,3138832,3138902
19391,63,28,1,8.13,29.54,3138901,3138964
19392,68,36,0,7.53,34.10,3138963,3139031
19393,62,43,0,8.26,53.51,3139030,3139092
19394,64,59,1,8.00,76.53,3139091,3139155
19395,43,74,2,11.91,216.64,3139154,3139197
19396,45,64,3,11.38,113.17,3139196,3139241
19397,48,48,1,10.67,79.68,3139240,3139288
19398,61,26,1,8.39,29.42,3139287,3139348
19399,61,25,1,8.39,28.57,3139348,3139409
19400,54,68,2,9.48,89.29,3139409,3139463
19401,55,52,0,9.31,68.07,3139462,3139517
19402,39,62,1,13.13,149.60,3139516,3139555
19403,39,72,1,13.13,163.50,3139554,3139593
19404,48,40,1,10.67,114.85,3139592,3139640
19405,34,53,3,15.06,98.06,3139639,3139673
19406,48,35,3,10.67,40.26,3139672,3139720
19407,46,76,2,11.13,131.94,3139719,3139765
19408,52,41,1,9.85,42.44,3139764,3139816
19409,44,40,1,11.64,76.82,3139815,3139859
19410,42,50,2,12.19,101.11,3139858,3139900
19411,54,52,1,9.48,80.51,3139899,3139953
19412,40,34,2,12.80,57.46,3139952,3139992
19413,27,61,2,18.96,267.67,3139991,3140018
19414,46,43,1,11.13,85.90,3140017,3140063
19415,31,70,0,16.52,244.70,3140062,3140093
19416,50,45,1,10.24,78.82,3140092,3140142
19417,55,34,1,9.31,49.45,3140141,3140196
19418,57,28,0,8.98,41.81,3140195,3140252
19419,58,39,1,8.83,66.56,3140251,3140309
19420,41,73,1,12.49,189.76,3140308,3140349
19421,57,93,0,8.98,244.54,3140349,3140406
19422,73,35,0,7.01,58.53,3140406,3140479
19423,47,53,0,10.89,111.97,3140478,3140525
19424,95,29,0,5.39,30.83,3140524,3140619
19425,86,22,0,5.95,22.18,3140619,3140705
19426,57,44,1,8.98,57.84,3140704,3140761
19427,50,134,1,10.24,348.02,3140760,3140810
19428,73,31,1,7.01,31.19,3140809,3140882
19429,68,46,1,7.53,45.31,3140881,3140949
19430,65,44,0,7.88,58.69,3140948,3141013
19431,62,94,0,8.26,154.06,3141012,3141074
19432,50,69,0,10.24,151.62,3141073,3141123
19433,52,39,1,9.85,66.32,3141122,3141174
19434,66,24,0,7.76,30.12,3141173,3141239
19435,60,33,0,8.53,37.58,3141238,3141298
19436,53,51,1,9.66,61.62,3141298,3141351
19437,49,31,1,10.45,53.55,3141350,3141399
19438,64,22,1,8.00,28.41,3141398,3141462
19439,56,27,1,9.14,29.34,3141461,3141517
19440,56,42,1,9.14,63.27,3141516,3141572
19441,37,71,2,13.84,236.19,3141572,3141609
19442,55,30,1,9.31,42.76,3141608,3141663
19443,39,50,3,13.13,76.68,3141662,3141701
19444,39,102,4,13.13,229.65,3141701,3141740
19445,48,24,2,10.67,28.68,3141739,3141787
19446,48,98,1,10.67,215.01,3141786,3141834
19447,44,62,1,11.64,123.23,3141833,3141877
19448,51,36,1,10.04,45.96,3141876,3141927
19449,48,51,1,10.67,92.06,3141926,3141974
19450,62,21,2,8.26,23.00,3141973,3142035
19451,36,54,2,14.22,151.73,3142034,3142070
19452,33,55,1,15.52,233.70,3142069,3142102
19453,64,50,1,8.00,52.25,3142101,3142165
19454,54,32,1,9.48,52.21,3142164,3142218
19455,58,52,0,8.83,98.56,3142217,3142275
19456,53,43,0,9.66,63.77,3142274,3142327
19457,63,37,0,8.13,55.86,3142326,3142389
19458,81,30,0,6.32,45.30,3142388,3142469
19459,89,24,0,5.75,20.41,3142469,3142558
19460,82,22,0,6.24,23.33,3142557,3142639
19461,70,63,0,7.31,91.93,3142638,3142708
19462,67,45,0,7.64,56.68,3142707,3142774
19463,79,41,0,6.48,31.79,3142773,3142852
19464,74,28,0,6.92,31.07,3142851,3142925
19465,75,27,0,6.83,24.52,3142924,3142999
19466,66,27,0,7.76,34.34,3142998,3143064
19467,53,123,0,9.66,294.98,3143063,3143116
19468,84,24,0,6.10,19.32,3143115,3143199
19469,59,40,0,8.68,74.79,3143198,3143257
19470,70,16,1,7.31,15.79,3143256,3143326
19471,55,27,1,9.31,32.21,3143325,3143380
19472,54,32,0,9.48,47.69,3143379,3143433
19473,57,35,1,8.98,35.63,3143432,3143489
19474,56,18,1,9.14,22.69,3143488,3143544
19475,61,26,1,8.39,25.85,3143544,3143605
19476,45,54,2,11.38,89.75,3143604,3143649
19477,40,48,1,12.80,138.36,3143648,3143688
19478,49,26,0,10.45,36.82,3143687,3143736
19479,45,52,1,11.38,75.66,3143735,3143780
19480,46,31,2,11.13,54.24,3143780,3143826
19481,62,38,0,8.26,40.16,3143825,3143887
19482,60,29,1,8.53,25.85,3143886,3143946
19483,50,35,1,10.24,55.42,3143945,3143995
19484,55,34,1,9.31,48.40,3143994,3144049
19485,59,29,1,8.68,38.73,3144048,3144107
19486,36,51,1,14.22,157.67,3144106,3144142
19487,48,46,1,10.67,84.39,3144141,3144189
19488,69,35,0,7.42,39.63,3144188,3144257
19489,41,51,1,12.49,103.08,3144256,3144297
19490,29,160,2,17.66,832.92,3144296,3144325
19491,70,28,1,7.31,34.50,3144324,3144394
19492,64,27,0,8.00,50.50,3144393,3144457
19493,80,43,0,6.40,32.59,3144456,3144536
19494,79,34,0,6.48,41.57,3144535,3144614
19495,88,22,0,5.82,24.24,3144613,3144701
19496,83,28,0,6.17,26.72,3144700,3144783
19497,82,22,0,6.24,19.79,3144782,3144864
19498,63,38,1,8.13,54.65,3144863,3144926
19499,67,33,1,7.64,36.29,3144926,3144993
19500,64,70,0,8.00,90.34,3144992,3145056
19501,69,32,0,7.42,34.97,3145055,3145124
19502,65,33,1,7.88,38.97,3145123,3145188
19503,79,23,1,6.48,17.57,3145187,3145266
19504,59,47,0,8.68,49.78,3145265,3145324
19505,51,32,1,10.04,29.84,3145323,3145374
19506,44,51,1,11.64,78.14,3145373,3145417
19507,39,173,2,13.13,695.19,3145416,3145455
19508,59,28,1,8.68,40.05,3145454,3145513
19509,54,36,1,9.48,37.77,3145512,3145566
19510,54,37,2,9.48,36.88,3145565,3145619
19511,51,32,2,10.04,58.86,3145618,3145669
19512,43,57,0,11.91,143.43,3145668,3145711
19513,58,35,1,8.83,25.59,3145710,3145768
19514,54,73,1,9.48,97.58,3145767,3145821
19515,56,30,0,9.14,32.69,3145821,3145877
19516,38,70,2,13.47,288.46,3145876,3145914
19517,44,126,1,11.64,333.87,3145913,3145957
19518,50,49,1,10.24,102.42,3145956,3146006
19519,18,90,5,28.44,586.14,3146005,3146023
19520,42,73,1,12.19,165.82,3146022,3146064
19521,47,83,1,10.89,173.37,3146063,3146110
19522,41,91,2,12.49,273.42,3146109,3146150
19523,43,56,0,11.91,122.74,3146149,3146192
19524,64,32,2,8.00,32.22,3146191,3146255
19525,62,26,1,8.26,42.09,3146254,3146316
19526,77,44,0,6.65,48.18,3146315,3146392
19527,74,41,0,6.92,54.97,3146391,3146465
19528,72,43,0,7.11,67.13,3146464,3146536
19529,62,39,1,8.26,53.48,3146535,3146597
19530,62,27,1,8.26,34.48,3146596,3146658
19531,68,23,0,7.53,31.25,3146657,3146725
19532,75,37,0,6.83,40.65,3146724,3146799
19533,72,26,0,7.11,35.35,3146798,3146870
19534,53,48,0,9.66,74.49,3146869,3146922
19535,55,35,1,9.31,47.52,3146922,3146977
19536,58,29,2,8.83,25.25,3146976,3147034
19537,54,42,1,9.48,55.14,3147033,3147087
19538,54,27,1,9.48,34.06,3147086,3147140
19539,51,50,1,10.04,75.02,3147139,3147190
19540,61,28,2,8.39,26.01,3147189,3147250
19541,54,40,2,9.48,46.55,3147249,3147303
19542,54,51,2,9.48,71.81,3147302,3147356
19543,40,108,0,12.80,337.06,3147355,3147395
19544,40,101,0,12.80,281.61,3147394,3147434
19545,52,65,2,9.85,86.13,3147433,3147485
19546,43,45,1,11.91,88.83,3147485,3147528
19547,49,48,2,10.45,61.19,3147527,3147576
19548,64,28,1,8.00,31.53,3147575,3147639
19549,54,22,0,9.48,30.69,3147638,3147692
19550,46,66,1,11.13,116.11,3147691,3147737
19551,55,34,1,9.31,47.16,3147736,3147791
19552,55,95,1,9.31,176.69,3147790,3147845
19553,40,83,2,12.80,167.61,3147844,3147884
19554,46,55,1,11.13,116.46,3147883,3147929
19555,59,39,2,8.68,42.73,3147929,3147988
19556,49,86,1,10.45,142.70,3147987,3148036
19557,63,27,1,8.13,44.21,3148035,3148098
19558,56,40,0,9.14,83.80,3148098,3148154
19559,73,42,0,7.01,63.05,3148153,3148226
19560,63,56,0,8.13,64.87,3148225,3148288
19561,70,88,0,7.31,146.62,3148287,3148357
19562,53,48,1,9.66,99.17,3148356,3148409
19563,93,31,0,5.51,24.72,3148408,3148501
19564,78,36,0,6.56,41.02,3148500,3148578
19565,75,48,0,6.83,39.05,3148577,3148652
19566,63,21,0,8.13,25.03,3148651,3148714
19567,60,36,1,8.53,52.62,3148713,3148773
19568,66,22,1,7.76,23.52,3148772,3148838
19569,77,21,0,6.65,19.03,3148837,3148914
19570,79,32,0,6.48,21.54,3148913,3148992
19571,58,32,1,8.83,42.38,3148991,3149049
19572,32,68,2,16.00,225.19,3149048,3149080
19573,50,51,1,10.24,103.90,3149079,3149129
19574,43,87,1,11.91,178.18,3149128,3149171
19575,47,61,3,10.89,90.69,3149170,3149217
19576,60,30,1,8.53,33.02,3149217,3149277
19577,53,46,1,9.66,48.56,3149276,3149329
19578,57,38,0,8.98,44.51,3149328,3149385
19579,54,26,1,9.48,41.21,3149384,3149438
19580,51,42,2,10.04,69.02,3149437,3149488
19581,44,28,1,11.64,57.78,3149487,3149531
19582,29,49,3,17.66,139.19,3149530,3149559
19583,49,71,1,10.45,117.59,3149558,3149607
19584,55,27,1,9.31,31.23,3149606,3149661
19585,31,115,3,16.52,428.06,3149660,3149691
19586,45,30,3,11.38,45.88,3149690,3149735
19587,54,26,1,9.48,31.92,3149734,3149788
19588,39,199,1,13.13,943.55,3149787,3149826
19589,64,31,0,8.00,35.50,3149825,3149889
19590,32,80,2,16.00,226.06,3149889,3149921
19591,40,102,2,12.80,248.41,3149920,3149960
19592,50,61,1,10.24,130.18,3149959,3150009
19593,54,50,1,9.48,109.77,3150008,3150062
19594,54,29,0,9.48,54.77,3150061,3150115
19595,46,33,1,11.13,40.07,3150114,3150160
19596,58,68,0,8.83,103.73,3150159,3150217
19597,51,38,1,10.04,84.08,3150216,3150267
19598,65,39,0,7.88,76.69,3150266,3150331
19599,55,68,1,9.31,146.80,3150330,3150385
19600,55,71,0,9.31,114.80,3150384,3150439
19601,66,29,1,7.76,37.03,3150438,3150504
19602,73,47,0,7.01,58.42,3150504,3150577
19603,89,29,0,5.75,23.26,3150576,3150665
19604,73,35,0,7.01,37.90,3150664,3150737
19605,72,27,1,7.11,21.32,3150736,3150808
19606,75,27,1,6.83,23.00,3150808,3150883
19607,61,46,0,8.39,56.96,3150882,3150943
19608,57,27,1,8.98,28.61,3150942,3150999
19609,76,43,0,6.74,46.14,3150998,3151074
19610,64,74,0,8.00,86.78,3151073,3151137
19611,57,28,1,8.98,27.35,3151136,3151193
19612,47,44,1,10.89,51.84,3151192,3151239
19613,56,30,1,9.14,32.98,3151238,3151294
19614,54,34,1,9.48,53.10,3151293,3151347
19615,50,26,3,10.24,26.06,3151346,3151396
19616,58,30,0,8.83,31.87,3151395,3151453
19617,50,45,1,10.24,80.86,3151452,3151502
19618,50,32,1,10.24,52.62,3151501,3151551
19619,54,67,1,9.48,89.99,3151551,3151605
19620,43,107,3,11.91,249.57,3151604,3151647
19621,49,32,1,10.45,53.92,3151646,3151695
19622,56,31,2,9.14,34.91,3151694,3151750
19623,49,39,0,10.45,57.59,3151749,3151798
19624,43,69,1,11.91,115.94,3151797,3151840
19625,59,30,2,8.68,35.44,3151840,3151899
19626,50,75,1,10.24,134.82,3151898,3151948
19627,34,100,1,15.06,308.64,3151947,3151981
19628,32,146,2,16.00,654.12,3151980,3152012
19629,43,50,0,11.91,125.15,3152011,3152054
19630,68,37,1,7.53,40.28,3152053,3152121
19631,47,56,2,10.89,90.48,3152120,3152167
19632,54,25,1,9.48,38.14,3152166,3152220
19633,51,42,0,10.04,79.33,3152219,3152270
19634,37,71,1,13.84,179.92,3152269,3152306
19635,73,41,0,7.01,50.64,3152305,3152378
19636,72,31,0,7.11,48.88,3152377,3152449
19637,73,24,0,7.01,35.00,3152449,3152522
19638,72,71,0,7.11,114.65,3152521,3152593
19639,66,34,0,7.76,54.94,3152592,3152658
19640,66,42,1,7.76,58.85,3152657,3152723
19641,71,37,1,7.21,40.25,3152722,3152793
19642,69,51,0,7.42,58.39,3152792,3152861
19643,75,31,0,6.83,29.90,3152860,3152935
19644,51,90,1,10.04,170.70,3152934,3152985
19645,75,30,1,6.83,27.37,3152984,3153059
19646,52,44,1,9.85,56.59,3153058,3153110
19647,67,23,0,7.64,26.77,3153110,3153177
19648,49,39,1,10.45,75.64,3153176,3153225
19649,41,58,1,12.49,178.98,3153224,3153265
19650,44,36,1,11.64,56.10,3153264,3153308
19651,49,40,1,10.45,57.76,3153307,3153356
19652,37,110,2,13.84,304.84,3153355,3153392
19653,66,25,1,7.76,25.64,3153391,3153457
19654,52,42,1,9.85,59.82,3153456,3153508
19655,35,61,0,14.63,191.60,3153507,3153542
19656,51,31,1,10.04,56.98,3153541,3153592
19657,60,44,1,8.53,42.62,3153591,3153651
19658,41,41,3,12.49,74.74,3153650,3153691
19659,52,29,2,9.85,39.32,3153690,3153742
19660,56,24,2,9.14,25.48,3153742,3153798
19661,47,33,2,10.89,42.82,3153798,3153845
19662,42,91,1,12.19,214.58,3153845,3153887
19663,53,26,3,9.66,27.21,3153886,3153939
19664,48,31,1,10.67,53.01,3153938,3153986
19665,55,34,0,9.31,57.89,3153985,3154040
19666,25,56,3,20.48,230.17,3154039,3154064
19667,27,58,1,18.96,225.29,3154064,3154091
19668,54,44,0,9.48,68.51,3154090,3154144
19669,64,54,0,8.00,53.62,3154143,3154207
19670,55,32,0,9.31,49.49,3154206,3154261
19671,49,36,0,10.45,49.39,3154261,3154310
19672,51,73,0,10.04,134.98,3154309,3154360
19673,45,36,1,11.38,79.79,3154359,3154404
19674,54,61,0,9.48,92.18,3154403,3154457
19675,73,35,0,7.01,37.68,3154456,3154529
19676,74,56,0,6.92,82.37,3154528,3154602
19677,68,44,0,7.53,49.75,3154601,3154669
19678,57,45,1,8.98,64.33,3154668,3154725
19679,68,23,1,7.53,23.46,3154724,3154792
19680,73,35,1,7.01,29.11,3154791,3154864
19681,58,43,1,8.83,65.11,3154864,3154922
19682,60,67,1,8.53,79.95,3154921,3154981
19683,69,45,1,7.42,35.46,3154980,3155049
19684,68,25,1,7.53,28.22,3155049,3155117
19685,65,38,1,7.88,36.14,3155116,3155181
19686,55,40,1,9.31,68.43,3155180,3155235
19687,47,80,1,10.89,148.10,3155234,3155281
19688,50,66,1,10.24,83.82,3155280,3155330
19689,48,45,2,10.67,72.68,3155329,3155377
19690,48,62,1,10.67,99.93,3155376,3155424
19691,64,29,1,8.00,30.81,3155423,3155487
19692,52,79,1,9.85,155.90,3155486,3155538
19693,53,28,1,9.66,29.92,3155537,3155590
19694,59,26,1,8.68,28.01,3155589,3155648
19695,57,43,1,8.98,49.88,3155647,3155704
19696,48,21,1,10.67,27.06,3155703,3155751
19697,49,36,2,10.45,57.27,3155750,3155799
19698,65,21,1,7.88,21.62,3155798,3155863
19699,54,29,1,9.48,38.40,3155862,3155916
19700,71,20,0,7.21,15.72,3155915,3155986
19701,56,39,0,9.14,60.52,3155985,3156041
19702,42,35,1,12.19,84.39,3156040,3156082
19703,35,86,3,14.63,313.66,3156081,3156116
19704,31,146,0,16.52,624.70,3156115,3156146
19705,36,69,1,14.22,203.12,3156145,3156181
19706,43,86,2,11.91,198.22,3156180,3156223
19707,41,97,0,12.49,364.10,3156222,3156263
19708,35,88,0,14.63,257.32,3156262,3156297
19709,60,37,0,8.53,48.08,3156297,3156357
19710,46,67,1,11.13,150.29,3156356,3156402
19711,76,25,0,6.74,29.33,3156401,3156477
19712,82,21,0,6.24,23.99,3156476,3156558
19713,55,51,0,9.31,80.54,3156557,3156612
19714,74,67,0,6.92,99.67,3156611,3156685
19715,88,26,0,5.82,24.06,3156684,3156772
19716,74,27,1,6.92,28.64,3156771,3156845
19717,63,26,1,8.13,32.49,3156844,3156907
19718,62,45,1,8.26,64.61,3156906,3156968
19719,57,27,1,8.98,32.89,3156967,3157024
19720,73,45,0,7.01,47.93,3157023,3157096
19721,62,41,1,8.26,52.48,3157095,3157157
19722,81,39,1,6.32,28.79,3157156,3157237
19723,41,40,2,12.49,81.23,3157236,3157277
19724,50,31,1,10.24,63.30,3157276,3157326
19725,55,59,1,9.31,69.01,3157326,3157381
19726,50,48,0,10.24,80.94,3157381,3157431
19727,48,67,1,10.67,116.47,3157430,3157478
19728,61,29,0,8.39,40.37,3157477,3157538
19729,46,71,0,11.13,137.59,3157537,3157583
19730,53,27,1,9.66,40.53,3157582,3157635
19731,57,42,1,8.98,40.61,3157634,3157691
19732,34,159,2,15.06,682.64,3157690,3157724
19733,46,45,3,11.13,62.33,3157723,3157769
19734,52,26,1,9.85,37.63,3157769,3157821
19735,54,32,2,9.48,33.29,3157820,3157874
19736,55,53,1,9.31,60.94,3157873,3157928
19737,57,25,2,8.98,34.65,3157928,3157985
19738,46,42,2,11.13,64.55,3157984,3158030
19739,59,41,0,8.68,52.73,3158029,3158088
19740,61,86,0,8.39,124.27,3158087,3158148
19741,45,31,0,11.38,56.86,3158147,3158192
19742,38,52,1,13.47,127.72,3158191,3158229
19743,55,94,0,9.31,167.78,3158228,3158283
19744,70,30,0,7.31,33.90,3158282,3158352
19745,85,22,0,6.02,26.73,3158351,3158436
19746,73,72,0,7.01,94.92,3158435,3158508
19747,67,34,1,7.64,34.41,3158507,3158574
19748,82,22,0,6.24,21.28,3158573,3158655
19749,78,44,0,6.56,37.68,3158655,3158733
19750,78,34,0,6.56,32.27,3158732,3158810
19751,83,29,1,6.17,21.73,3158809,3158892
19752,71,44,1,7.21,52.31,3158891,3158962
19753,61,60,1,8.39,66.27,3158961,3159022
19754,53,43,0,9.66,57.09,3159021,3159074
19755,47,36,1,10.89,46.27,3159073,3159120
19756,47,31,2,10.89,60.14,3159119,3159166
19757,56,34,0,9.14,42.44,3159166,3159222
19758,46,40,2,11.13,64.50,3159221,3159267
19759,48,36,1,10.67,70.01,3159266,3159314
19760,32,59,2,16.00,161.75,3159313,3159345
19761,46,42,3,11.13,59.77,3159344,3159390
19762,48,30,3,10.67,41.81,3159389,3159437
19763,43,38,1,11.91,60.88,3159436,3159479
19764,51,41,2,10.04,55.17,3159478,3159529
19765,59,58,0,8.68,64.46,3159528,3159587
19766,45,34,3,11.38,69.35,3159586,3159631
19767,33,136,1,15.52,726.31,3159630,3159663
19768,27,108,2,18.96,472.41,3159662,3159689
19769,44,57,1,11.64,122.55,3159688,3159732
19770,41,66,2,12.49,199.27,3159731,3159772
19771,48,39,0,10.67,69.35,3159771,3159819
19772,41,95,0,12.49,237.03,3159818,3159859
19773,53,39,0,9.66,72.83,3159858,3159911
19774,81,49,0,6.32,48.17,3159910,3159991
19775,75,61,0,6.83,97.93,3159990,3160065
19776,70,63,1,7.31,70.67,3160064,3160134
19777,65,73,0,7.88,101.37,3160133,3160198
19778,58,47,1,8.83,69.59,3160197,3160255
19779,76,31,1,6.74,25.38,3160254,3160330
19780,60,25,1,8.53,32.88,3160329,3160389
19781,67,54,0,7.64,51.54,3160388,3160455
19782,64,48,1,8.00,63.34,3160454,3160518
19783,58,67,1,8.83,105.80,3160517,3160575
19784,69,26,0,7.42,25.26,3160574,3160643
19785,61,23,1,8.39,21.03,3160642,3160703
19786,66,23,0,7.76,25.18,3160702,3160768
19787,57,35,2,8.98,40.19,3160767,3160824
19788,57,78,1,8.98,110.72,3160823,3160880
19789,56,31,2,9.14,27.84,3160879,3160935
19790,50,39,1,10.24,60.82,3160934,3160984
19791,54,31,0,9.48,48.55,3160983,3161037
19792,50,60,0,10.24,98.54,3161036,3161086
19793,44,37,2,11.64,58.46,3161085,3161129
19794,51,37,1,10.04,54.74,3161128,3161179
19795,56,33,1,9.14,41.34,3161178,3161234
19796,54,26,1,9.48,34.10,3161233,3161287
19797,63,39,2,8.13,47.98,3161287,3161350
19798,51,68,1,10.04,135.76,3161349,3161400
19799,57,42,1,8.98,51.25,3161399,3161456
19800,35,35,5,14.63,63.32,3161455,3161490
19801,45,67,0,11.38,157.39,3161489,3161534
19802,40,155,1,12.80,578.11,3161533,3161573
19803,66,42,0,7.76,49.70,3161572,3161638
19804,42,50,2,12.19,119.39,3161637,3161679
19805,31,77,1,16.52,284.31,3161678,3161709
19806,53,45,0,9.66,86.75,3161708,3161761
19807,40,92,0,12.80,337.76,3161760,3161800
19808,54,57,2,9.48,108.03,3161799,3161853
19809,83,66,0,6.17,69.15,3161852,3161935
19810,75,27,0,6.83,24.12,3161934,3162009
19811,82,30,0,6.24,32.55,3162008,3162090
19812,69,40,0,7.42,44.50,3162090,3162159
19813,61,52,1,8.39,88.17,3162158,3162219
19814,61,37,1,8.39,46.99,3162218,3162279
19815,63,30,1,8.13,29.44,3162278,3162341
19816,70,26,1,7.31,32.79,3162340,3162410
19817,50,65,1,10.24,135.18,3162409,3162459
19818,55,33,1,9.31,39.92,3162458,3162513
19819,70,28,1,7.31,30.42,3162512,3162582
19820,64,33,0,8.00,42.84,3162581,3162645
19821,60,23,1,8.53,29.65,3162644,3162704
19822,54,38,2,9.48,59.88,3162703,3162757
19823,48,38,1,10.67,50.51,3162756,3162804
19824,46,42,2,11.13,74.46,3162803,3162849
19825,62,31,1,8.26,34.74,3162848,3162910
19826,54,31,1,9.48,36.06,3162909,3162963
19827,54,30,0,9.48,53.62,3162962,3163016
19828,41,56,2,12.49,98.98,3163015,3163056
19829,50,35,2,10.24,54.90,3163055,3163105
19830,53,51,0,9.66,86.19,3163104,3163157
19831,52,32,1,9.85,48.40,3163156,3163208
19832,34,99,3,15.06,326.70,3163207,3163241
19833,59,40,1,8.68,42.59,3163240,3163299
19834,41,81,2,12.49,185.66,3163298,3163339
19835,57,26,2,8.98,27.35,3163338,3163395
19836,48,42,2,10.67,76.56,3163394,3163442
19837,49,34,1,10.45,39.23,3163441,3163490
19838,52,44,2,9.85,68.09,3163489,3163541
19839,46,29,1,11.13,58.29,3163540,3163586
19840,42,39,1,12.19,97.34,3163585,3163627
19841,41,93,1,12.49,259.42,3163626,3163667
19842,55,68,0,9.31,105.16,3163666,3163721
19843,49,34,1,10.45,48.70,3163720,3163769
19844,68,36,0,7.53,48.37,3163768,3163836
19845,48,93,0,10.67,183.51,3163835,3163883
19846,60,40,0,8.53,83.62,3163882,3163942
19847,81,24,0,6.32,24.49,3163941,3164022
19848,85,26,0,6.02,34.52,3164021,3164106
19849,81,42,0,6.32,43.60,3164105,3164186
19850,62,42,1,8.26,52.80,3164186,3164248
19851,81,29,0,6.32,27.60,3164247,3164328
19852,83,31,1,6.17,30.24,3164327,3164410
19853,81,23,0,6.32,23.11,3164409,3164490
19854,63,82,1,8.13,122.78,3164489,3164552
19855,64,27,1,8.00,33.97,3164552,3164616
19856,82,38,1,6.24,23.82,3164615,3164697
19857,63,26,0,8.13,24.46,3164696,3164759
19858,49,46,1,10.45,74.94,3164758,3164807
19859,52,41,1,9.85,63.36,3164806,3164858
19860,47,38,2,10.89,51.58,3164857,3164904
19861,63,24,0,8.13,18.33,3164903,3164966
19862,64,42,1,8.00,40.75,3164965,3165029
19863,57,66,0,8.98,82.12,3165028,3165085
19864,55,31,1,9.31,39.23,3165084,3165139
19865,50,31,1,10.24,40.86,3165138,3165188
19866,46,54,1,11.13,96.98,3165187,3165233
19867,40,39,2,12.80,71.71,3165232,3165272
19868,48,63,2,10.67,93.43,3165271,3165319
19869,52,28,1,9.85,52.21,3165318,3165370
19870,52,44,0,9.85,59.67,3165370,3165422
19871,60,23,1,8.53,31.05,3165421,3165481
19872,50,47,1,10.24,72.42,3165480,3165530
19873,61,22,1,8.39,29.29,3165529,3165590
19874,41,53,2,12.49,99.86,3165589,3165630
19875,46,49,1,11.13,71.94,3165629,3165675
19876,44,36,1,11.64,75.05,3165674,3165718
19877,57,45,0,8.98,82.19,3165717,3165774
19878,44,52,1,11.64,72.05,3165773,3165817
19879,55,28,0,9.31,46.83,3165816,3165871
19880,60,46,0,8.53,90.45,3165871,3165931
19881,74,27,0,6.92,29.89,3165931,3166005
19882,67,64,0,7.64,79.39,3166004,3166071
19883,47,71,0,10.89,159.58,3166070,3166117
19884,71,29,0,7.21,55.24,3166116,3166187
19885,79,29,0,6.48,48.86,3166186,3166265
19886,58,69,2,8.83,81.32,3166264,3166322
19887,66,28,1,7.76,34.34,3166321,3166387
19888,69,27,1,7.42,33.63,3166386,3166455
19889,75,20,1,6.83,16.12,3166454,3166529
19890,70,23,0,7.31,25.90,3166528,3166598
19891,57,51,0,8.98,77.77,3166597,3166654
19892,80,24,1,6.40,23.16,3166653,3166733
19893,66,33,0,7.76,28.91,3166732,3166798
19894,52,58,1,9.85,80.90,3166797,3166849
19895,54,30,1,9.48,42.66,3166849,3166903
19896,45,42,1,11.38,53.21,3166902,3166947
19897,49,47,3,10.45,52.90,3166946,3166995
19898,58,29,2,8.83,26.38,3166994,3167052
19899,54,36,1,9.48,33.51,3167051,3167105
19900,47,53,1,10.89,84.01,3167104,3167151
19901,42,112,2,12.19,329.44,3167150,3167192
19902,50,40,2,10.24,37.22,3167191,3167241
19903,47,25,3,10.89,40.56,3167240,3167287
19904,60,27,1,8.53,32.65,3167286,3167346
19905,46,39,3,11.13,46.68,3167346,3167392
19906,62,60,1,8.26,80.09,3167391,3167453
19907,51,40,1,10.04,55.53,3167453,3167504
19908,38,61,0,13.47,164.09,3167503,3167541
19909,19,102,0,26.95,652.26,3167540,3167559
19910,37,122,0,13.84,674.78,3167558,3167595
19911,65,43,0,7.88,57.46,3167594,3167659
19912,41,101,1,12.49,242.93,3167658,3167699
19913,39,124,1,13.13,397.09,3167698,3167737
19914,67,33,0,7.64,43.36,3167736,3167803
19915,74,47,0,6.92,55.97,3167803,3167877
19916,66,44,0,7.76,55.21,3167876,3167942
19917,85,37,0,6.02,48.12,3167941,3168026
19918,73,29,1,7.01,37.27,3168025,3168098
19919,78,29,0,6.56,22.25,3168097,3168175
19920,71,72,0,7.21,85.29,3168174,3168245
19921,69,24,1,7.42,18.36,3168244,3168313
19922,74,40,0,6.92,47.37,3168312,3168386
19923,75,20,0,6.83,22.73,3168385,3168460
19924,76,31,1,6.74,31.85,3168459,3168535
19925,58,30,1,8.83,33.59,3168534,3168592
19926,53,45,1,9.66,65.55,3168591,3168644
19927,55,53,1,9.31,72.76,3168643,3168698
19928,44,44,2,11.64,74.19,3168697,3168741
19929,49,35,1,10.45,60.78,3168740,3168789
19930,50,28,1,10.24,42.06,3168788,3168838
19931,30,92,1,17.07,273.06,3168837,3168867
19932,51,41,1,10.04,54.00,3168866,3168917
19933,57,24,2,8.98,23.56,3168916,3168973
19934,50,45,1,10.24,65.22,3168972,3169022
19935,53,35,2,9.66,48.07,3169021,3169074
19936,35,128,1,14.63,597.20,3169073,3169108
19937,36,62,3,14.22,114.40,3169107,3169143
19938,36,118,3,14.22,402.51,3169142,3169178
19939,45,48,1,11.38,107.75,3169177,3169222
19940,61,25,1,8.39,38.11,3169221,3169282
19941,56,47,2,9.14,64.62,3169281,3169337
19942,44,82,0,11.64,161.78,3169337,3169381
19943,44,54,1,11.64,139.82,3169380,3169424
19944,61,39,0,8.39,50.70,3169423,3169484
19945,71,36,0,7.21,58.98,3169483,3169554
19946,83,37,0,6.17,37.25,3169553,3169636
19947,73,36,0,7.01,39.49,3169635,3169708
19948,62,66,1,8.26,83.22,3169707,3169769
19949,50,72,1,10.24,154.58,3169768,3169818
19950,63,32,0,8.13,48.46,3169817,3169880
19951,62,23,0,8.26,32.39,3169880,3169942
19952,56,38,1,9.14,71.19,3169942,3169998
19953,88,19,0,5.82,14.99,3169997,3170085
19954,63,39,0,8.13,37.76,3170084,3170147
19955,51,79,0,10.04,135.65,3170147,3170198
19956,49,42,1,10.45,80.17,3170197,3170246
19957,52,33,1,9.85,45.44,3170245,3170297
19958,54,40,1,9.48,64.25,3170296,3170350
19959,36,79,3,14.22,270.45,3170349,3170385
19960,57,36,1,8.98,42.51,3170385,3170442
19961,57,34,0,8.98,41.84,3170441,3170498
19962,45,38,3,11.38,52.86,3170497,3170542
19963,35,50,4,14.63,120.52,3170541,3170576
19964,55,37,0,9.31,51.67,3170575,3170630
19965,46,96,0,11.13,217.03,3170629,3170675
19966,50,56,2,10.24,67.46,3170674,3170724
19967,58,40,1,8.83,42.18,3170723,3170781
19968,34,144,1,15.06,561.58,3170780,3170814
19969,32,99,3,16.00,342.94,3170814,3170846
19970,60,43,1,8.53,54.85,3170845,3170905
19971,43,57,1,11.91,125.76,3170904,3170947
19972,47,50,1,10.89,102.31,3170946,3170993
19973,34,187,0,15.06,964.76,3170992,3171026
19974,54,64,1,9.48,96.21,3171025,3171079
19975,83,35,0,6.17,42.41,3171078,3171161
19976,53,49,0,9.66,116.11,3171160,3171213
19977,62,39,0,8.26,64.09,3171212,3171274
19978,74,27,0,6.92,31.32,3171274,3171348
19979,65,29,0,7.88,29.55,3171347,3171412
19980,66,49,1,7.76,70.27,3171411,3171477
19981,66,26,0,7.76,26.00,3171476,3171542
19982,57,30,1,8.98,34.54,3171542,3171599
19983,71,43,0,7.21,45.72,3171598,3171669
19984,61,44,1,8.39,50.47,3171668,3171729
19985,71,18,0,7.21,21.21,3171728,3171799
19986,47,111,1,10.89,245.33,3171798,3171845
19987,53,32,1,9.66,44.34,3171844,3171897
19988,47,72,1,10.89,113.58,3171896,3171943
19989,57,31,1,8.98,38.02,3171942,3171999
19990,48,39,2,10.67,67.56,3171998,3172046
19991,37,67,2,13.84,183.97,3172045,3172082
19992,57,30,1,8.98,45.32,3172081,3172138
19993,38,56,2,13.47,152.51,3172137,3172175
19994,53,30,1,9.66,42.00,3172174,3172227
19995,58,25,0,8.83,33.00,3172226,3172284
19996,48,51,3,10.67,56.18,3172284,3172332
19997,45,40,0,11.38,69.52,3172331,3172376
19998,48,53,1,10.67,81.56,3172375,3172423
19999,35,62,1,14.63,246.75,3172422,3172457
20000,41,71,0,12.49,193.76,3172456,3172497
20001,56,47,0,9.14,66.48,3172496,3172552
20002,55,34,1,9.31,49.89,3172551,3172606
20003,51,95,0,10.04,181.41,3172605,3172656
20004,59,40,1,8.68,82.12,3172655,3172714
20005,77,35,0,6.65,34.90,3172713,3172790
20006,82,28,0,6.24,35.09,3172789,3172871
20007,63,74,0,8.13,120.90,3172870,3172933
20008,50,41,0,10.24,100.70,3172933,3172983
20009,78,28,0,6.56,29.07,3172983,3173061
20010,68,60,1,7.53,68.28,3173061,3173129
20011,51,57,1,10.04,90.12,3173128,3173179
20012,75,42,0,6.83,42.25,3173178,3173253
20013,59,50,0,8.68,66.69,3173253,3173312
20014,60,68,1,8.53,101.68,3173312,3173372
20015,53,49,0,9.66,88.98,3173371,3173424
20016,41,108,2,12.49,276.10,3173423,3173464
20017,46,45,1,11.13,80.81,3173463,3173509
20018,43,84,1,11.91,180.08,3173508,3173551
20019,41,53,1,12.49,97.23,3173550,3173591
20020,56,66,2,9.14,84.16,3173590,3173646
20021,47,44,0,10.89,109.33,3173645,3173692
20022,66,32,0,7.76,38.70,3173691,3173757
20023,39,73,2,13.13,260.52,3173756,3173795
20024,43,71,0,11.91,210.46,3173794,3173837
20025,51,37,1,10.04,45.29,3173837,3173888
20026,46,87,0,11.13,157.07,3173887,3173933
20027,59,27,1,8.68,24.90,3173932,3173991
20028,47,42,1,10.89,69.03,3173991,3174038
20029,43,35,2,11.91,71.06,3174037,3174080
20030,58,35,2,8.83,46.42,3174079,3174137
20031,49,51,1,10.45,51.88,3174136,3174185
20032,49,62,1,10.45,116.49,3174184,3174233
20033,43,32,1,11.91,61.62,3174232,3174275
20034,28,74,2,18.29,352.92,3174274,3174302
20035,61,34,0,8.39,44.50,3174301,3174362
20036,43,32,2,11.91,68.83,3174361,3174404
20037,44,54,2,11.64,138.14,3174403,3174447
20038,59,36,0,8.68,49.51,3174446,3174505
20039,39,47,2,13.13,111.80,3174504,3174543
20040,57,32,0,8.98,50.30,3174542,3174599
20041,46,64,0,11.13,166.33,3174598,3174644
20042,84,41,0,6.10,41.82,3174643,3174727
20043,79,31,0,6.48,38.38,3174726,3174805
20044,86,39,0,5.95,56.46,3174804,3174890
20045,56,41,2,9.14,60.69,3174889,3174945
20046,73,29,0,7.01,30.56,3174944,3175017
20047,67,65,0,7.64,83.84,3175017,3175084
20048,55,35,1,9.31,41.92,3175083,3175138
20049,66,41,1,7.76,52.46,3175137,3175203
20050,58,54,0,8.83,88.38,3175202,3175260
20051,41,122,1,12.49,374.44,3175259,3175300
20052,69,38,0,7.42,33.23,3175299,3175368
20053,48,62,1,10.67,201.10,3175367,3175415
20054,60,73,1,8.53,99.95,3175414,3175474
20055,54,36,1,9.48,47.58,3175473,3175527
20056,63,36,0,8.13,35.38,3175527,3175590
20057,46,37,1,11.13,55.68,3175589,3175635
20058,49,50,1,10.45,68.74,3175634,3175683
20059,66,27,1,7.76,21.94,3175682,3175748
20060,58,35,1,8.83,48.21,3175747,3175805
20061,44,56,1,11.64,146.37,3175804,3175848
20062,56,39,0,9.14,46.52,3175847,3175903
20063,50,35,1,10.24,67.06,3175902,3175952
20064,45,35,3,11.38,53.04,3175951,3175996
20065,44,57,1,11.64,81.60,3175995,3176039
20066,52,35,0,9.85,52.40,3176038,3176090
20067,49,42,1,10.45,66.08,3176090,3176139
20068,52,31,3,9.85,32.71,3176138,3176190
20069,54,30,1,9.48,33.51,3176189,3176243
20070,66,41,1,7.76,46.85,3176242,3176308
20071,34,59,2,15.06,186.47,3176307,3176341
20072,53,30,1,9.66,49.73,3176340,3176393
20073,60,50,0,8.53,80.78,3176392,3176452
20074,57,37,0,8.98,66.72,3176451,3176508
20075,60,29,0,8.53,37.85,3176507,3176567
20076,64,49,0,8.00,56.78,3176567,3176631
20077,74,45,0,6.92,49.72,3176631,3176705
20078,76,41,0,6.74,53.67,3176704,3176780
20079,69,46,0,7.42,68.27,3176779,3176848
20080,78,37,0,6.56,53.96,3176848,3176926
20081,61,125,0,8.39,256.99,3176925,3176986
20082,76,27,1,6.74,22.14,3176985,3177061
20083,65,47,0,7.88,52.78,3177060,3177125
20084,84,23,1,6.10,20.85,3177124,3177208
20085,67,34,0,7.64,35.45,3177207,3177274
20086,77,22,0,6.65,17.76,3177273,3177350
20087,75,30,0,6.83,29.88,3177349,3177424
20088,54,36,2,9.48,42.40,3177424,3177478
20089,69,22,1,7.42,21.78,3177477,3177546
20090,51,29,0,10.04,47.02,3177545,3177596
20091,51,61,2,10.04,76.43,3177595,3177646
20092,48,60,2,10.67,70.06,3177645,3177693
20093,46,50,1,11.13,95.90,3177692,3177738
20094,51,48,1,10.04,94.39,3177737,3177788
20095,56,27,1,9.14,35.16,3177787,3177843
20096,53,44,1,9.66,59.66,3177842,3177895
20097,33,68,2,15.52,193.76,3177894,3177927
20098,45,46,2,11.38,81.17,3177926,3177971
20099,55,33,1,9.31,45.60,3177970,3178025
20100,42,73,3,12.19,131.49,3178025,3178067
20101,39,34,0,13.13,61.60,3178066,3178105
20102,39,129,2,13.13,404.16,3178104,3178143
20103,61,40,0,8.39,42.50,3178142,3178203
20104,58,30,1,8.83,37.80,3178202,3178260
20105,50,46,1,10.24,75.50,3178259,3178309
20106,51,35,1,10.04,43.41,3178308,3178359
20107,53,32,2,9.66,48.49,3178358,3178411
20108,60,23,1,8.53,29.15,3178411,3178471
20109,58,32,1,8.83,52.07,3178470,3178528
20110,52,53,1,9.85,88.21,3178527,3178579
20111,47,40,2,10.89,71.92,3178578,3178625
20112,48,56,1,10.67,112.68,3178624,3178672
20113,55,31,0,9.31,58.29,3178671,3178726
20114,80,56,0,6.40,62.12,3178725,3178805
20115,79,20,0,6.48,25.26,3178804,3178883
20116,69,39,0,7.42,50.88,3178883,3178952
20117,77,48,0,6.65,55.16,3178951,3179028
20118,69,28,1,7.42,28.10,3179027,3179096
20119,72,40,0,7.11,45.88,3179095,3179167
20120,63,39,1,8.13,60.21,3179166,3179229
20121,87,19,0,5.89,12.29,3179228,3179315
20122,76,25,1,6.74,23.09,3179314,3179390
20123,59,24,0,8.68,39.24,3179389,3179448
20124,86,30,0,5.95,24.11,3179447,3179533
20125,69,29,0,7.42,32.68,3179532,3179601
20126,56,51,0,9.14,64.48,3179600,3179656
20127,49,41,0,10.45,65.68,3179655,3179704
20128,48,29,1,10.67,48.22,3179703,3179751
20129,42,54,0,12.19,128.11,3179750,3179792
20130,54,35,0,9.48,49.58,3179791,3179845
20131,64,27,1,8.00,21.34,3179844,3179908
20132,53,33,1,9.66,37.70,3179907,3179960
20133,46,69,1,11.13,144.42,3179959,3180005
20134,41,37,2,12.49,75.76,3180004,3180045
20135,44,54,1,11.64,81.28,3180044,3180088
20136,48,53,0,10.67,58.51,3180087,3180135
20137,47,42,2,10.89,67.16,3180134,3180181
20138,58,34,1,8.83,40.97,3180180,3180238
20139,50,29,1,10.24,38.10,3180237,3180287
20140,57,53,1,8.98,62.65,3180286,3180343
20141,53,108,1,9.66,213.92,3180342,3180395
20142,35,64,3,14.63,159.66,3180394,3180429
20143,28,54,3,18.29,207.42,3180428,3180456
20144,44,44,1,11.64,85.91,3180455,3180499
20145,47,44,1,10.89,66.86,3180498,3180545
20146,35,213,2,14.63,1235.83,3180544,3180579
20147,56,55,1,9.14,64.27,3180578,3180634
20148,56,37,1,9.14,45.37,3180633,3180689
20149,48,54,1,10.67,98.18,3180688,3180736
20150,40,90,1,12.80,355.41,3180736,3180776
20151,58,44,0,8.83,54.56,3180775,3180833
20152,83,26,0,6.17,25.88,3180832,3180915
20153,70,69,0,7.31,91.36,3180914,3180984
20154,93,26,0,5.51,24.14,3180983,3181076
20155,63,28,1,8.13,51.35,3181075,3181138
20156,71,28,0,7.21,34.00,3181137,3181208
20157,59,35,0,8.68,42.93,3181207,3181266
20158,55,40,0,9.31,72.29,3181265,3181320
20159,56,46,1,9.14,54.69,3181319,3181375
20160,64,43,1,8.00,55.62,3181374,3181438
20161,69,23,1,7.42,22.97,3181437,3181506
20162,77,28,0,6.65,21.24,3181505,3181582
20163,64,42,0,8.00,41.31,3181581,3181645
20164,61,32,0,8.39,45.35,3181645,3181706
20165,60,51,1,8.53,59.82,3181705,3181765
20166,67,32,0,7.64,23.93,3181764,3181831
20167,58,47,1,8.83,65.90,3181830,3181888
20168,68,31,0,7.53,35.25,3181887,3181955
20169,38,63,1,13.47,182.83,3181954,3181992
20170,54,100,1,9.48,178.47,3181991,3182045
20171,39,72,2,13.13,209.50,3182044,3182083
20172,42,55,3,12.19,108.77,3182082,3182124
20173,49,62,0,10.45,100.94,3182123,3182172
20174,55,25,0,9.31,33.92,3182171,3182226
20175,63,39,1,8.13,40.97,3182225,3182288
20176,56,31,1,9.14,45.77,3182287,3182343
20177,45,55,1,11.38,107.08,3182342,3182387
20178,38,38,3,13.47,100.83,3182386,3182424
20179,48,80,0,10.67,161.60,3182423,3182471
20180,56,46,0,9.14,75.77,3182471,3182527
20181,47,52,0,10.89,135.07,3182526,3182573
20182,49,39,1,10.45,63.10,3182572,3182621
20183,47,41,0,10.89,71.29,3182620,3182667
20184,56,59,1,9.14,93.80,3182666,3182722
20185,83,18,0,6.17,19.01,3182721,3182804
20186,87,34,0,5.89,38.79,3182803,3182890
20187,52,35,1,9.85,62.21,3182889,3182941
20188,53,52,0,9.66,99.70,3182940,3182993
20189,58,60,0,8.83,81.59,3182992,3183050
20190,56,88,0,9.14,147.02,3183049,3183105
20191,64,38,1,8.00,44.44,3183104,3183168
20192,73,28,1,7.01,36.92,3183167,3183240
20193,74,28,0,6.92,29.72,3183239,3183313
20194,66,40,0,7.76,68.40,3183312,3183378
20195,54,34,1,9.48,38.99,3183377,3183431
20196,61,32,1,8.39,39.85,3183430,3183491
20197,43,51,1,11.91,67.34,3183490,3183533
20198,56,44,1,9.14,60.48,3183532,3183588
20199,53,49,1,9.66,80.56,3183587,3183640
20200,57,40,1,8.98,47.95,3183639,3183696
20201,45,24,2,11.38,36.24,3183695,3183740
20202,50,47,1,10.24,60.34,3183739,3183789
20203,52,31,0,9.85,55.40,3183788,3183840
20204,53,34,0,9.66,45.28,3183839,3183892
20205,35,54,3,14.63,111.03,3183891,3183926
20206,46,43,2,11.13,62.68,3183925,3183971
20207,54,35,1,9.48,49.99,3183970,3184024
20208,49,32,2,10.45,36.41,3184023,3184072
20209,50,32,1,10.24,48.38,3184071,3184121
20210,52,60,1,9.85,86.13,3184120,3184172
20211,46,32,1,11.13,64.11,3184171,3184217
20212,27,58,4,18.96,208.26,3184217,3184244
20213,49,58,0,10.45,138.57,3184243,3184292
20214,42,41,0,12.19,113.58,3184291,3184333
20215,69,24,0,7.42,23.14,3184332,3184401
20216,54,44,1,9.48,53.06,3184400,3184454
20217,55,40,0,9.31,63.05,3184453,3184508
20218,55,69,0,9.31,123.09,3184507,3184562
20219,62,52,0,8.26,90.09,3184561,3184623
20220,45,81,0,11.38,335.70,3184622,3184667
20221,63,41,0,8.13,76.40,3184666,3184729
20222,88,28,0,5.82,42.47,3184729,3184817
20223,72,36,0,7.11,35.29,3184816,3184888
20224,67,80,0,7.64,118.11,3184887,3184954
20225,62,63,1,8.26,78.71,3184953,3185015
20226,77,20,1,6.65,17.81,3185014,3185091
20227,65,34,0,7.88,44.26,3185090,3185155
20228,70,30,0,7.31,24.39,3185154,3185224
20229,60,29,1,8.53,43.48,3185223,3185283
20230,80,53,0,6.40,62.19,3185282,3185362
20231,80,29,1,6.40,30.61,3185361,3185441
20232,49,86,0,10.45,215.35,3185440,3185489
20233,49,96,0,10.45,178.41,3185489,3185538
20234,43,54,0,11.91,183.57,3185537,3185580
20235,47,51,3,10.89,64.05,3185579,3185626
20236,60,27,1,8.53,27.75,3185625,3185685
20237,55,35,2,9.31,42.21,3185685,3185740
20238,61,32,1,8.39,34.47,3185739,3185800
20239,55,21,2,9.31,20.21,3185799,3185854
20240,47,50,0,10.89,101.41,3185853,3185900
20241,54,31,2,9.48,36.69,3185899,3185953
20242,50,38,1,10.24,65.54,3185952,3186002
20243,48,53,1,10.67,96.22,3186001,3186049
20244,52,25,2,9.85,27.44,3186048,3186100
20245,48,54,1,10.67,84.31,3186099,3186147
20246,56,25,1,9.14,31.84,3186146,3186202
20247,51,42,1,10.04,67.25,3186202,3186253
20248,35,89,1,14.63,271.78,3186252,3186287
20249,43,100,1,11.91,239.29,3186286,3186329
20250,44,134,0,11.64,529.69,3186329,3186373
20251,42,81,0,12.19,225.25,3186372,3186414
20252,37,55,1,13.84,157.54,3186413,3186450
20253,42,56,1,12.19,142.87,3186449,3186491
20254,41,54,1,12.49,137.18,3186490,3186531
20255,49,54,1,10.45,107.72,3186530,3186579
20256,55,38,1,9.31,64.18,3186578,3186633
20257,76,35,0,6.74,36.46,3186632,3186708
20258,62,83,0,8.26,149.48,3186707,3186769
20259,67,52,0,7.64,56.80,3186768,3186835
20260,79,32,0,6.48,38.30,3186834,3186913
20261,44,80,1,11.64,184.91,3186912,3186956
20262,53,86,0,9.66,165.62,3186955,3187008
20263,67,41,1,7.64,37.54,3187008,3187075
20264,51,72,1,10.04,134.31,3187074,3187125
20265,71,24,0,7.21,27.41,3187124,3187195
20266,79,22,0,6.48,18.93,3187195,3187274
20267,77,35,0,6.65,37.66,3187273,3187350
20268,68,42,1,7.53,40.96,3187349,3187417
20269,68,92,1,7.53,121.25,3187416,3187484
20270,61,30,0,8.39,53.55,3187483,3187544
20271,52,34,1,9.85,46.44,3187543,3187595
20272,42,80,0,12.19,146.49,3187594,3187636
20273,54,38,1,9.48,54.03,3187635,3187689
20274,55,75,1,9.31,108.21,3187688,3187743
20275,52,51,1,9.85,89.28,3187742,3187794
20276,46,49,1,11.13,86.72,3187793,3187839
20277,49,29,2,10.45,43.84,3187838,3187887
20278,44,60,2,11.64,76.19,3187886,3187930
20279,45,60,1,11.38,119.66,3187929,3187974
20280,52,77,1,9.85,124.78,3187973,3188025
20281,45,61,1,11.38,103.70,3188024,3188069
20282,44,68,1,11.64,142.55,3188068,3188112
20283,51,30,3,10.04,42.98,3188111,3188162
20284,54,41,1,9.48,59.62,3188161,3188215
20285,43,97,1,11.91,280.18,3188214,3188257
20286,39,45,0,13.13,94.37,3188256,3188295
20287,36,81,1,14.22,223.28,3188294,3188330
20288,25,74,2,20.48,291.69,3188329,3188354
20289,60,38,1,8.53,47.05,3188354,3188414
20290,66,34,0,7.76,40.12,3188413,3188479
20291,47,38,1,10.89,62.14,3188478,3188525
20292,48,47,1,10.67,61.35,3188524,3188572
20293,52,73,0,9.85,179.28,3188571,3188623
20294,57,33,1,8.98,51.14,3188622,3188679
20295,75,36,0,6.83,39.82,3188678,3188753
20296,82,35,0,6.24,36.31,3188752,3188834
20297,59,59,0,8.68,97.57,3188834,3188893
20298,78,29,0,6.56,34.17,3188892,3188970
20299,50,89,0,10.24,202.06,3188969,3189019
20300,65,27,0,7.88,26.78,3189019,3189084
20301,70,28,0,7.31,25.16,3189083,3189153
20302,43,113,2,11.91,273.71,3189153,3189196
20303,55,47,1,9.31,62.90,3189195,3189250
20304,67,24,2,7.64,23.07,3189250,3189317
20305,65,31,1,7.88,24.88,3189316,3189381
20306,59,62,1,8.68,67.85,3189380,3189439
20307,60,30,0,8.53,36.32,3189438,3189498
20308,60,23,1,8.53,27.72,3189497,3189557
20309,51,56,1,10.04,98.27,3189556,3189607
20310,35,69,1,14.63,268.92,3189606,3189641
20311,53,32,2,9.66,38.45,3189640,3189693
20312,62,20,2,8.26,18.51,3189692,3189754
20313,51,47,2,10.04,68.39,3189753,3189804
20314,44,60,0,11.64,100.78,3189804,3189848
20315,52,27,2,9.85,37.32,3189847,3189899
20316,61,24,0,8.39,27.09,3189899,3189960
20317,53,25,1,9.66,28.68,3189960,3190013
20318,42,31,2,12.19,57.49,3190012,3190054
20319,38,62,2,13.47,171.72,3190053,3190091
20320,53,42,1,9.66,52.90,3190090,3190143
20321,57,25,1,8.98,37.42,3190142,3190199
20322,47,38,0,10.89,78.73,3190198,3190245
20323,51,55,2,10.04,91.10,3190245,3190296
20324,38,81,1,13.47,196.35,3190295,3190333
20325,42,50,0,12.19,113.11,3190332,3190374
20326,43,39,1,11.91,83.67,3190373,3190416
20327,47,93,1,10.89,241.37,3190416,3190463
20328,50,42,1,10.24,99.74,3190462,3190512
20329,53,23,0,9.66,30.45,3190511,3190564
20330,49,50,0,10.45,90.25,3190563,3190612
20331,40,119,0,12.80,342.51,3190611,3190651
20332,78,26,0,6.56,29.94,3190650,3190728
20333,71,56,0,7.21,73.15,3190727,3190798
20334,83,52,0,6.17,50.74,3190797,3190880
20335,82,41,0,6.24,39.60,3190879,3190961
20336,67,40,0,7.64,55.19,3190961,3191028
20337,76,60,1,6.74,77.19,3191027,3191103
20338,63,29,0,8.13,32.11,3191102,3191165
20339,60,43,1,8.53,61.45,3191164,3191224
20340,50,35,1,10.24,73.70,3191223,3191273
20341,72,21,1,7.11,26.29,3191272,3191344
20342,71,32,0,7.21,30.65,3191344,3191415
20343,71,29,0,7.21,38.31,3191414,3191485
20344,81,22,1,6.32,21.03,3191484,3191565
20345,62,26,1,8.26,30.32,3191565,3191627
20346,52,43,1,9.85,69.40,3191626,3191678
20347,40,124,0,12.80,382.36,3191677,3191717
20348,51,42,2,10.04,60.08,3191716,3191767
20349,48,38,2,10.67,61.93,3191766,3191814
20350,54,60,1,9.48,76.29,3191814,3191868
20351,48,42,2,10.67,80.93,3191867,3191915
20352,42,72,2,12.19,157.30,3191914,3191956
20353,57,46,1,8.98,57.10,3191955,3192012
20354,41,89,1,12.49,178.10,3192011,3192052
20355,45,59,1,11.38,122.81,3192051,3192096
20356,55,30,2,9.31,45.89,3192095,3192150
20357,60,25,1,8.53,33.88,3192149,3192209
20358,49,55,1,10.45,74.49,3192208,3192257
20359,48,37,1,10.67,64.43,3192256,3192304
20360,54,44,1,9.48,62.81,3192303,3192357
20361,25,102,2,20.48,551.13,3192356,3192381
20362,55,42,0,9.31,75.70,3192380,3192435
20363,51,104,0,10.04,219.84,3192434,3192485
20364,54,46,1,9.48,60.25,3192484,3192538
20365,42,49,2,12.19,94.20,3192537,3192579
20366,55,56,0,9.31,104.21,3192578,3192633
20367,44,162,0,11.64,562.05,3192632,3192676
20368,73,46,0,7.01,55.00,3192675,3192748
20369,76,71,0,6.74,75.72,3192747,3192823
20370,83,42,0,6.17,75.22,3192822,3192905
20371,66,28,0,7.76,44.30,3192904,3192970
20372,54,40,1,9.48,65.58,3192969,3193023
20373,69,58,0,7.42,53.95,3193022,3193091
20374,75,30,1,6.83,25.74,3193090,3193165
20375,77,26,0,6.65,25.84,3193164,3193241
20376,60,41,0,8.53,52.72,3193241,3193301
20377,52,38,1,9.85,70.32,3193300,3193352
20378,65,29,2,7.88,32.88,3193351,3193416
20379,60,25,1,8.53,43.38,3193415,3193475
20380,64,44,1,8.00,50.28,3193474,3193538
20381,63,59,1,8.13,70.84,3193537,3193600
20382,52,45,2,9.85,70.21,3193599,3193651
20383,57,27,1,8.98,40.58,3193650,3193707
20384,43,47,1,11.91,79.85,3193706,3193749
20385,57,98,1,8.98,165.88,3193748,3193805
20386,53,65,1,9.66,91.39,3193804,3193857
20387,45,36,0,11.38,86.50,3193856,3193901
20388,35,113,1,14.63,391.72,3193900,3193935
20389,45,86,1,11.38,172.55,3193934,3193979
20390,54,46,1,9.48,54.95,3193978,3194032
20391,42,53,2,12.19,112.06,3194031,3194073
20392,46,32,2,11.13,52.11,3194072,3194118
20393,37,59,3,13.84,160.14,3194117,3194154
20394,44,27,2,11.64,43.82,3194153,3194197
20395,52,49,2,9.85,74.78,3194196,3194248
20396,59,38,1,8.68,51.40,3194247,3194306
20397,59,49,2,8.68,64.63,3194305,3194364
20398,26,146,2,19.69,744.21,3194363,3194389
20399,47,41,1,10.89,81.75,3194388,3194435
20400,46,39,1,11.13,66.94,3194434,3194480
20401,36,84,2,14.22,230.45,3194479,3194515
20402,35,67,0,14.63,198.75,3194514,3194549
20403,44,63,3,11.64,111.78,3194549,3194593
20404,44,41,1,11.64,112.60,3194592,3194636
20405,39,90,1,13.13,290.42,3194635,3194674
20406,51,36,0,10.04,90.82,3194673,3194724
20407,74,29,1,6.92,39.53,3194723,3194797
20408,77,32,0,6.65,50.46,3194796,3194873
20409,60,78,0,8.53,110.75,3194872,3194932
20410,70,21,0,7.31,34.99,3194931,3195001
20411,42,91,1,12.19,228.87,3195000,3195042
20412,63,36,1,8.13,52.78,3195041,3195104
20413,52,61,1,9.85,135.05,3195103,3195155
20414,69,21,0,7.42,21.46,3195154,3195223
20415,64,60,0,8.00,72.38,3195222,3195286
20416,65,42,1,7.88,45.18,3195285,3195350
20417,74,34,1,6.92,31.37,3195349,3195423
20418,66,41,1,7.76,47.15,3195422,3195488
20419,45,77,1,11.38,174.06,3195487,3195532
20420,54,37,1,9.48,56.62,3195531,3195585
20421,49,30,1,10.45,56.57,3195584,3195633
20422,51,37,1,10.04,47.10,3195632,3195683
20423,52,44,0,9.85,64.75,3195682,3195734
20424,49,102,1,10.45,242.17,3195733,3195782
20425,55,43,1,9.31,58.83,3195781,3195836
20426,54,32,1,9.48,41.81,3195835,3195889
20427,47,45,1,10.89,67.16,3195888,3195935
20428,43,60,1,11.91,133.29,3195934,3195977
20429,52,38,1,9.85,41.36,3195976,3196028
20430,32,94,1,16.00,288.50,3196027,3196059
20431,36,61,1,14.22,152.56,3196058,3196094
20432,45,44,0,11.38,85.57,3196093,3196138
20433,52,30,1,9.85,46.13,3196137,3196189
20434,59,40,1,8.68,49.68,3196188,3196247
20435,54,41,0,9.48,64.99,3196246,3196300
20436,61,20,1,8.39,24.57,3196299,3196360
20437,31,72,2,16.52,213.73,3196359,3196390
20438,43,67,1,11.91,121.29,3196389,3196432
20439,52,85,1,9.85,146.28,3196431,3196483
20440,59,39,1,8.68,49.98,3196482,3196541
20441,46,79,2,11.13,138.42,3196540,3196586
20442,54,39,0,9.48,70.14,3196585,3196639
20443,57,57,0,8.98,86.47,3196638,3196695
20444,63,39,0,8.13,59.70,3196694,3196757
20445,60,43,0,8.53,61.65,3196756,3196816
20446,63,32,0,8.13,72.30,3196815,3196878
20447,58,46,0,8.83,68.18,3196877,3196935
20448,93,36,0,5.51,33.54,3196934,3197027
20449,45,58,1,11.38,121.79,3197026,3197071
20450,66,32,0,7.76,47.97,3197070,3197136
20451,60,39,1,8.53,47.98,3197135,3197195
20452,75,26,1,6.83,23.72,3197195,3197270
20453,72,25,1,7.11,22.52,3197269,3197341
20454,61,33,1,8.39,47.52,3197340,3197401
20455,68,38,0,7.53,37.75,3197400,3197468
20456,74,26,1,6.92,25.43,3197467,3197541
20457,62,68,0,8.26,92.51,3197540,3197602
20458,62,31,0,8.26,29.84,3197601,3197663
20459,45,81,1,11.38,164.77,3197662,3197707
20460,49,29,2,10.45,31.68,3197706,3197755
20461,59,29,2,8.68,24.96,3197755,3197814
20462,66,41,1,7.76,41.85,3197813,3197879
20463,52,25,2,9.85,28.86,3197879,3197931
20464,46,40,1,11.13,79.77,3197931,3197977
20465,49,41,2,10.45,63.10,3197976,3198025
20466,53,37,1,9.66,65.39,3198024,3198077
20467,37,52,0,13.84,122.51,3198076,3198113
20468,37,73,1,13.84,253.11,3198112,3198149
20469,61,26,1,8.39,26.04,3198148,3198209
20470,52,41,1,9.85,48.90,3198208,3198260
20471,60,70,0,8.53,93.15,3198259,3198319
20472,59,36,1,8.68,45.71,3198318,3198377
20473,37,76,1,13.84,223.38,3198376,3198413
20474,40,94,1,12.80,284.01,3198412,3198452
20475,47,107,1,10.89,313.12,3198451,3198498
20476,50,40,1,10.24,62.94,3198497,3198547
20477,43,38,1,11.91,79.39,3198546,3198589
20478,44,41,1,11.64,96.28,3198588,3198632
20479,56,34,0,9.14,57.02,3198631,3198687
20480,81,40,0,6.32,39.92,3198686,3198767
20481,54,103,1,9.48,241.95,3198767,3198821
20482,70,49,0,7.31,68.07,3198821,3198891
20483,82,44,0,6.24,53.96,3198890,3198972
20484,61,52,0,8.39,78.73,3198971,3199032
20485,49,40,1,10.45,69.31,3199031,3199080
20486,75,39,1,6.83,40.14,3199079,3199154
20487,72,30,1,7.11,29.74,3199153,3199225
20488,60,35,1,8.53,44.52,3199224,3199284
20489,77,24,0,6.65,22.70,3199283,3199360
20490,67,42,1,7.64,44.05,3199359,3199426
20491,66,24,0,7.76,28.15,3199425,3199491
20492,71,33,1,7.21,37.10,3199490,3199561
20493,52,61,0,9.85,109.59,3199560,3199612
20494,51,38,1,10.04,65.61,3199611,3199662
20495,51,35,1,10.04,60.04,3199661,3199712
20496,46,55,0,11.13,90.33,3199711,3199757
20497,54,32,1,9.48,44.58,3199756,3199810
20498,59,47,1,8.68,59.74,3199809,3199868
20499,57,35,1,8.98,45.00,3199867,3199924
20500,52,40,1,9.85,51.75,3199924,3199976
20501,37,102,0,13.84,314.73,3199975,3200012
20502,54,41,1,9.48,46.58,3200011,3200065
20503,39,68,1,13.13,142.42,3200064,3200103
20504,42,44,1,12.19,65.44,3200103,3200145
20505,38,57,2,13.47,131.20,3200144,3200182
20506,58,35,0,8.83,39.83,3200182,3200240
20507,40,53,2,12.80,157.01,3200240,3200280
20508,58,23,1,8.83,24.66,3200280,3200338
20509,50,34,1,10.24,52.26,3200337,3200387
20510,48,32,1,10.67,53.31,3200386,3200434
20511,19,171,1,26.95,1363.21,3200433,3200452
20512,42,39,1,12.19,76.87,3200451,3200493
20513,58,38,0,8.83,69.07,3200492,3200550
20514,52,48,0,9.85,68.13,3200549,3200601
20515,38,200,1,13.47,967.25,3200600,3200638
20516,55,76,0,9.31,139.67,3200637,3200692
20517,57,50,0,8.98,74.05,3200691,3200748
20518,73,46,0,7.01,56.15,3200747,3200820
20519,79,39,0,6.48,33.95,3200819,3200898
20520,62,59,0,8.26,73.06,3200897,3200959
20521,92,54,0,5.57,48.98,3200958,3201050
20522,47,53,1,10.89,106.69,3201049,3201096
20523,62,53,0,8.26,71.64,3201096,3201158
20524,60,42,1,8.53,53.65,3201157,3201217
20525,62,80,1,8.26,111.71,3201217,3201279
20526,72,26,0,7.11,30.32,3201278,3201350
20527,62,50,1,8.26,63.29,3201349,3201411
20528,53,62,1,9.66,110.56,3201410,3201463
20529,53,65,1,9.66,88.49,3201462,3201515
20530,71,28,1,7.21,31.18,3201514,3201585
20531,64,30,1,8.00,31.97,3201584,3201648
20532,63,29,1,8.13,30.78,3201647,3201710
20533,47,48,2,10.89,95.67,3201709,3201756
20534,44,119,1,11.64,315.64,3201755,3201799
20535,45,121,0,11.38,326.72,3201798,3201843
20536,42,87,2,12.19,181.44,3201842,3201884
20537,51,31,0,10.04,34.16,3201883,3201934
20538,50,55,1,10.24,73.14,3201933,3201983
20539,52,29,1,9.85,46.78,3201982,3202034
20540,50,44,1,10.24,72.14,3202034,3202084
20541,43,35,3,11.91,59.76,3202083,3202126
20542,50,46,2,10.24,55.70,3202125,3202175
20543,49,43,1,10.45,65.64,3202174,3202223
20544,49,60,1,10.45,112.00,3202222,3202271
20545,51,29,2,10.04,46.90,3202270,3202321
20546,60,21,2,8.53,24.95,3202321,3202381
20547,46,59,2,11.13,114.77,3202380,3202426
20548,34,72,1,15.06,167.11,3202426,3202460
20549,35,63,1,14.63,176.98,3202459,3202494
20550,58,31,0,8.83,43.73,3202493,3202551
20551,59,69,2,8.68,82.76,3202550,3202609
20552,39,70,1,13.13,213.29,3202608,3202647
20553,65,23,1,7.88,21.03,3202646,3202711
20554,57,56,0,8.98,84.30,3202710,3202767
20555,58,124,0,8.83,251.52,3202766,3202824
20556,59,39,0,8.68,62.15,3202823,3202882
20557,62,109,0,8.26,227.68,3202881,3202943
20558,82,29,1,6.24,36.84,3202942,3203024
20559,67,60,0,7.64,84.53,3203023,3203090
20560,59,95,0,8.68,163.88,3203089,3203148
20561,66,24,2,7.76,25.88,3203147,3203213
20562,74,40,1,6.92,33.29,3203213,3203287
20563,79,20,1,6.48,16.38,3203286,3203365
20564,69,49,0,7.42,52.27,3203364,3203433
20565,63,25,1,8.13,33.67,3203432,3203495
20566,72,46,1,7.11,43.07,3203494,3203566
20567,58,34,0,8.83,43.83,3203565,3203623
20568,62,31,0,8.26,44.48,3203622,3203684
20569,53,34,1,9.66,49.92,3203683,3203736
20570,49,64,2,10.45,88.78,3203735,3203784
20571,56,25,1,9.14,31.80,3203783,3203839
20572,61,25,2,8.39,27.78,3203838,3203899
20573,59,31,0,8.68,41.07,3203899,3203958
20574,55,49,2,9.31,61.92,3203957,3204012
20575,45,88,1,11.38,181.17,3204011,3204056
20576,52,49,0,9.85,54.94,3204055,3204107
20577,50,31,1,10.24,50.50,3204106,3204156
20578,33,54,2,15.52,107.64,3204155,3204188
20579,45,30,1,11.38,43.48,3204187,3204232
20580,55,28,1,9.31,40.65,3204231,3204286
20581,53,25,0,9.66,38.41,3204286,3204339
20582,53,52,1,9.66,73.43,3204338,3204391
20583,50,60,1,10.24,95.34,3204390,3204440
20584,54,53,1,9.48,81.69,3204439,3204493
20585,37,60,1,13.84,147.87,3204492,3204529
20586,64,37,0,8.00,46.59,3204528,3204592
20587,55,34,0,9.31,52.65,3204591,3204646
20588,46,97,1,11.13,217.16,3204645,3204691
20589,69,44,0,7.42,68.77,3204690,3204759
20590,69,39,1,7.42,55.87,3204758,3204827
20591,88,30,0,5.82,31.49,3204826,3204914
20592,55,97,0,9.31,180.00,3204913,3204968
20593,74,56,0,6.92,78.59,3204967,3205041
20594,72,32,0,7.11,40.85,3205040,3205112
20595,60,74,1,8.53,121.78,3205111,3205171
20596,58,32,1,8.83,53.87,3205170,3205228
20597,71,28,0,7.21,26.48,3205228,3205299
20598,62,35,1,8.26,42.42,3205298,3205360
20599,47,71,1,10.89,97.92,3205359,3205406
20600,65,63,1,7.88,63.49,3205405,3205470
20601,49,50,2,10.45,68.74,3205469,3205518
20602,75,26,1,6.83,27.05,3205517,3205592
20603,56,29,1,9.14,42.23,3205591,3205647
20604,57,28,1,8.98,33.46,3205646,3205703
20605,49,53,0,10.45,84.33,3205702,3205751
20606,61,30,1,8.39,32.24,3205750,3205811
20607,44,87,1,11.64,160.05,3205811,3205855
20608,60,26,2,8.53,30.38,3205854,3205914
20609,62,31,1,8.26,26.68,3205914,3205976
20610,54,49,1,9.48,51.47,3205975,3206029
20611,36,70,2,14.22,240.56,3206028,3206064
20612,49,29,1,10.45,52.90,3206063,3206112
20613,55,27,2,9.31,34.40,3206111,3206166
20614,47,27,1,10.89,36.95,3206166,3206213
20615,31,77,2,16.52,322.06,3206212,3206243
20616,53,40,1,9.66,52.98,3206242,3206295
20617,42,51,1,12.19,104.73,3206294,3206336
20618,48,30,1,10.67,51.51,3206336,3206384
20619,50,23,2,10.24,28.90,3206383,3206433
20620,58,49,1,8.83,76.76,3206432,3206490
20621,32,152,2,16.00,680.25,3206489,3206521
20622,48,58,0,10.67,125.22,3206520,3206568
20623,55,47,0,9.31,84.29,3206567,3206622
20624,48,80,1,10.67,143.93,3206621,3206669
20625,55,64,1,9.31,94.69,3206669,3206724
20626,51,33,0,10.04,53.45,3206723,3206774
20627,73,42,0,7.01,47.88,3206773,3206846
20628,43,96,0,11.91,241.48,3206845,3206888
20629,72,37,0,7.11,55.88,3206887,3206959
20630,60,30,1,8.53,43.98,3206959,3207019
20631,75,33,0,6.83,56.38,3207019,3207094
20632,58,36,1,8.83,46.00,3207093,3207151
20633,62,37,1,8.26,63.19,3207150,3207212
20634,60,32,1,8.53,33.65,3207211,3207271
20635,70,50,1,7.31,41.47,3207270,3207340
20636,80,43,1,6.40,35.12,3207339,3207419
20637,61,27,1,8.39,39.19,3207418,3207479
20638,59,53,2,8.68,66.63,3207478,3207537
20639,71,37,1,7.21,38.14,3207537,3207608
20640,58,111,1,8.83,205.42,3207607,3207665
20641,53,43,1,9.66,64.60,3207664,3207717
20642,55,75,1,9.31,116.80,3207716,3207771
20643,52,52,1,9.85,80.94,3207770,3207822
20644,48,46,1,10.67,74.14,3207822,3207870
20645,53,39,2,9.66,60.71,3207869,3207922
20646,50,53,1,10.24,75.46,3207921,3207971
20647,39,37,0,13.13,98.57,3207970,3208009
20648,44,80,0,11.64,173.10,3208008,3208052
20649,44,68,2,11.64,140.10,3208051,3208095
20650,35,61,1,14.63,186.92,3208094,3208129
20651,43,51,2,11.91,118.27,3208129,3208172
20652,52,37,1,9.85,62.63,3208171,3208223
20653,51,32,1,10.04,44.55,3208222,3208273
20654,56,39,1,9.14,57.37,3208272,3208328
20655,42,54,2,12.19,161.30,3208327,3208369
20656,45,38,1,11.38,76.86,3208368,3208413
20657,23,64,3,22.26,272.89,3208412,3208435
20658,29,96,1,17.66,383.95,3208434,3208463
20659,44,49,0,11.64,126.23,3208462,3208506
20660,34,77,2,15.06,231.82,3208505,3208539
20661,58,37,1,8.83,53.28,3208538,3208596
20662,56,41,1,9.14,64.37,3208595,3208651
20663,52,29,2,9.85,39.78,3208650,3208702
20664,58,28,0,8.83,58.73,3208701,3208759
20665,69,32,0,7.42,46.62,3208759,3208828
20666,60,24,0,8.53,36.45,3208827,3208887
20667,68,40,0,7.53,56.16,3208887,3208955
20668,75,31,0,6.83,51.34,3208954,3209029
20669,84,35,0,6.10,40.25,3209028,3209112
20670,66,38,0,7.76,54.55,3209111,3209177
20671,71,35,0,7.21,46.81,3209176,3209247
20672,62,78,0,8.26,98.97,3209247,3209309
20673,76,29,0,6.74,31.88,3209308,3209384
20674,57,108,0,8.98,210.72,3209383,3209440
20675,59,37,1,8.68,47.68,3209439,3209498
20676,68,42,1,7.53,47.63,3209497,3209565
20677,89,31,0,5.75,23.62,3209564,3209653
20678,65,58,1,7.88,61.86,3209652,3209717
20679,62,34,1,8.26,41.55,3209717,3209779
20680,41,110,1,12.49,287.76,3209778,3209819
20681,52,41,0,9.85,58.48,3209818,3209870
20682,59,43,0,8.68,61.20,3209869,3209928
20683,44,88,0,11.64,199.14,3209927,3209971
20684,49,41,3,10.45,48.61,3209970,3210019
20685,40,80,1,12.80,170.41,3210018,3210058
20686,43,68,2,11.91,138.55,3210057,3210100
20687,37,65,3,13.84,132.62,3210099,3210136
20688,50,38,1,10.24,68.50,3210135,3210185
20689,49,57,1,10.45,69.39,3210184,3210233
20690,53,77,1,9.66,133.13,3210232,3210285
20691,45,59,0,11.38,132.68,3210284,3210329
20692,24,114,4,21.33,627.22,3210328,3210352
20693,29,68,1,17.66,216.09,3210351,3210380
20694,45,55,0,11.38,92.86,3210379,3210424
20695,61,25,1,8.39,39.65,3210424,3210485
20696,63,22,0,8.13,26.97,3210484,3210547
20697,58,51,0,8.83,71.04,3210546,3210604
20698,39,108,1,13.13,415.80,3210603,3210642
20699,78,85,0,6.56,113.50,3210641,3210719
20700,70,37,0,7.31,54.99,3210719,3210789
20701,91,54,0,5.63,44.26,3210788,3210879
20702,64,27,1,8.00,32.56,3210878,3210942
20703,54,37,1,9.48,59.88,3210941,3210995
20704,68,30,1,7.53,43.81,3210994,3211062
20705,62,22,0,8.26,30.61,3211061,3211123
20706,44,91,2,11.64,197.55,3211122,3211166
20707,49,68,0,10.45,120.12,3211165,3211214
20708,75,22,0,6.83,15.69,3211213,3211288
20709,60,46,1,8.53,67.62,3211287,3211347
20710,51,47,1,10.04,73.88,3211346,3211397
20711,57,29,2,8.98,31.70,3211397,3211454
20712,54,50,1,9.48,62.62,3211453,3211507
20713,27,110,1,18.96,382.48,3211506,3211533
20714,57,32,1,8.98,31.60,3211532,3211589
20715,53,32,2,9.66,47.58,3211588,3211641
20716,59,46,1,8.68,48.08,3211641,3211700
20717,46,71,1,11.13,118.24,3211699,3211745
20718,57,23,1,8.98,34.47,3211744,3211801
20719,50,36,3,10.24,46.42,3211800,3211850
20720,35,50,3,14.63,111.20,3211849,3211884
20721,48,47,1,10.67,56.43,3211883,3211931
20722,60,26,1,8.53,31.12,3211930,3211990
20723,56,24,1,9.14,29.62,3211989,3212045
20724,52,28,1,9.85,38.05,3212045,3212097
20725,48,31,1,10.67,66.10,3212096,3212144
20726,55,42,1,9.31,86.43,3212144,3212199
20727,32,99,0,16.00,331.94,3212198,3212230
20728,57,40,1,8.98,64.40,3212230,3212287
20729,31,122,2,16.52,539.28,3212286,3212317
20730,53,31,1,9.66,46.34,3212316,3212369
20731,45,62,0,11.38,136.86,3212368,3212413
20732,43,54,0,11.91,133.76,3212412,3212455
20733,68,21,0,7.53,29.90,3212454,3212522
20734,70,38,0,7.31,50.30,3212521,3212591
20735,84,54,0,6.10,66.18,3212591,3212675
20736,64,85,0,8.00,140.78,3212674,3212738
20737,53,70,0,9.66,147.88,3212738,3212791
20738,66,40,0,7.76,55.58,3212790,3212856
20739,69,44,1,7.42,52.01,3212855,3212924
20740,67,35,1,7.64,37.19,3212923,3212990
20741,51,52,1,10.04,69.41,3212989,3213040
20742,64,31,1,8.00,32.88,3213039,3213103
20743,49,32,2,10.45,50.21,3213102,3213151
20744,66,35,1,7.76,38.46,3213150,3213216
20745,59,39,1,8.68,49.74,3213215,3213274
20746,49,34,1,10.45,72.12,3213273,3213322
20747,45,99,0,11.38,236.99,3213321,3213366
20748,57,39,0,8.98,59.32,3213365,3213422
20749,47,32,1,10.89,51.33,3213421,3213468
20750,55,26,0,9.31,32.87,3213467,3213522
20751,60,45,1,8.53,46.65,3213521,3213581
20752,62,35,0,8.26,50.84,3213580,3213642
20753,41,67,2,12.49,210.79,3213641,3213682
20754,53,35,1,9.66,43.05,3213681,3213734
20755,42,58,1,12.19,113.96,3213733,3213775
20756,50,30,2,10.24,49.18,3213774,3213824
20757,46,37,3,11.13,54.29,3213824,3213870
20758,55,29,2,9.31,26.80,3213870,3213925
20759,48,33,1,10.67,51.06,3213924,3213972
20760,48,70,1,10.67,128.26,3213971,3214019
20761,44,50,1,11.64,93.41,3214018,3214062
20762,51,60,2,10.04,100.78,3214061,3214112
20763,51,38,1,10.04,53.06,3214111,3214162
20764,35,58,1,14.63,170.86,3214161,3214196
20765,40,71,0,12.80,193.91,3214195,3214235
20766,35,133,1,14.63,465.83,3214234,3214269
20767,63,45,0,8.13,60.75,3214268,3214331
20768,51,39,1,10.04,75.88,3214330,3214381
20769,30,68,0,17.07,346.06,3214380,3214410
20770,67,46,1,7.64,63.16,3214409,3214476
20771,90,24,0,5.69,17.10,3214475,3214565
20772,87,35,0,5.89,31.25,3214564,3214651
20773,79,33,1,6.48,44.38,3214650,3214729
20774,65,31,0,7.88,60.11,3214728,3214793
20775,42,67,1,12.19,147.39,3214792,3214834
20776,65,126,1,7.88,240.78,3214833,3214898
20777,58,57,1,8.83,93.49,3214897,3214955
20778,60,46,1,8.53,50.62,3214954,3215014
20779,65,58,0,7.88,82.11,3215014,3215079
20780,48,101,0,10.67,205.26,3215078,3215126
20781,58,30,1,8.83,43.76,3215126,3215184
20782,35,114,1,14.63,438.35,3215184,3215219
20783,80,23,0,6.40,23.06,3215218,3215298
20784,59,74,1,8.68,131.40,3215297,3215356
20785,64,23,1,8.00,28.72,3215355,3215419
20786,52,83,1,9.85,145.21,3215418,3215470
20787,42,53,1,12.19,113.01,3215469,3215511
20788,50,39,1,10.24,68.46,3215510,3215560
20789,53,75,1,9.66,124.94,3215559,3215612
20790,60,36,1,8.53,44.45,3215611,3215671
20791,45,62,1,11.38,100.06,3215670,3215715
20792,48,30,2,10.67,52.72,3215715,3215763
20793,52,31,2,9.85,39.82,3215762,3215814
20794,41,29,2,12.49,51.66,3215813,3215854
20795,56,31,1,9.14,45.44,3215853,3215909
20796,69,30,2,7.42,19.26,3215908,3215977
20797,43,69,0,11.91,134.97,3215977,3216020
20798,60,32,2,8.53,37.32,3216019,3216079
20799,54,39,1,9.48,50.84,3216078,3216132
20800,30,112,2,17.07,409.60,3216131,3216161
20801,27,128,2,18.96,573.96,3216160,3216187
20802,35,69,1,14.63,238.69,3216186,3216221
20803,38,169,1,13.47,698.57,3216220,3216258
20804,62,25,1,8.26,36.00,3216257,3216319
20805,42,52,2,12.19,117.77,3216318,3216360
20806,53,46,0,9.66,62.71,3216359,3216412
20807,62,27,0,8.26,42.80,3216411,3216473
20808,51,55,0,10.04,99.06,3216472,3216523
20809,38,88,1,13.47,330.25,3216522,3216560
20810,84,27,0,6.10,26.68,3216559,3216643
20811,92,28,0,5.57,29.90,3216642,3216734
20812,77,39,0,6.65,50.36,3216733,3216810
20813,65,44,0,7.88,58.14,3216810,3216875
20814,61,56,1,8.39,64.21,3216875,3216936
20815,45,75,1,11.38,224.01,3216935,3216980
20816,52,102,1,9.85,194.94,3216979,3217031
20817,64,24,0,8.00,28.62,3217030,3217094
20818,64,41,1,8.00,48.12,3217093,3217157
20819,61,49,0,8.39,69.16,3217156,3217217
20820,75,19,0,6.83,23.50,3217216,3217291
20821,69,39,1,7.42,43.98,3217290,3217359
20822,54,53,0,9.48,82.81,3217358,3217412
20823,55,31,0,9.31,33.92,3217411,3217466
20824,50,38,1,10.24,60.10,3217466,3217516
20825,41,60,2,12.49,106.74,3217515,3217556
20826,56,38,1,9.14,43.94,3217555,3217611
20827,50,44,0,10.24,79.46,3217610,3217660
20828,46,54,2,11.13,85.50,3217659,3217705
20829,28,122,4,18.29,551.28,3217705,3217733
20830,55,30,0,9.31,49.16,3217732,3217787
20831,48,31,1,10.67,42.56,3217786,3217834
20832,48,37,2,10.67,45.18,3217833,3217881
20833,49,46,1,10.45,60.82,3217880,3217929
20834,48,57,1,10.67,91.97,3217928,3217976
20835,42,95,2,12.19,234.34,3217975,3218017
20836,51,56,1,10.04,71.88,3218016,3218067
20837,60,36,1,8.53,45.15,3218066,3218126
20838,58,24,0,8.83,28.49,3218125,3218183
20839,31,50,3,16.52,156.70,3218182,3218213
20840,39,59,1,13.13,180.73,3218213,3218252
20841,53,30,1,9.66,58.00,3218251,3218304
20842,47,50,0,10.89,120.22,3218303,3218350
20843,43,70,0,11.91,147.57,3218349,3218392
20844,51,47,0,10.04,97.76,3218391,3218442
20845,37,89,2,13.84,260.41,3218441,3218478
20846,71,40,0,7.21,48.76,3218477,3218548
20847,80,27,0,6.40,37.92,3218547,3218627
20848,82,36,1,6.24,40.89,3218626,3218708
20849,89,32,0,5.75,32.10,3218707,3218796
20850,53,64,0,9.66,99.39,3218795,3218848
20851,67,39,0,7.64,55.48,3218847,3218914
20852,55,58,2,9.31,84.61,3218913,3218968
20853,67,22,1,7.64,23.66,3218967,3219034
20854,68,44,1,7.53,43.69,3219033,3219101
20855,71,30,1,7.21,30.76,3219100,3219171
20856,56,80,1,9.14,134.27,3219170,3219226
20857,40,54,3,12.80,113.36,3219225,3219265
20858,70,32,1,7.31,31.39,3219264,3219334
20859,64,39,1,8.00,50.16,3219333,3219397
20860,44,47,1,11.64,102.87,3219396,3219440
20861,50,36,1,10.24,70.74,3219439,3219489
20862,48,44,1,10.67,79.97,3219488,3219536
20863,59,31,2,8.68,33.44,3219536,3219595
20864,64,29,1,8.00,31.34,3219594,3219658
20865,49,32,2,10.45,45.10,3219657,3219706
20866,56,20,1,9.14,28.98,3219705,3219761
20867,54,25,1,9.48,47.10,3219761,3219815
20868,46,34,2,11.13,62.50,3219814,3219860
20869,44,58,1,11.64,100.82,3219859,3219903
20870,50,34,2,10.24,40.58,3219902,3219952
20871,56,24,2,9.14,28.94,3219951,3220007
20872,56,31,1,9.14,36.84,3220006,3220062
20873,52,33,2,9.85,48.17,3220062,3220114
20874,48,79,1,10.67,139.43,3220113,3220161
20875,39,69,0,13.13,156.98,3220160,3220199
20876,54,98,0,9.48,207.55,3220198,3220252
20877,36,84,1,14.22,234.17,3220251,3220287
20878,48,67,0,10.67,120.72,3220286,3220334
20879,38,41,2,13.47,91.57,3220333,3220371
20880,40,59,1,12.80,135.01,3220370,3220410
20881,44,58,1,11.64,105.46,3220409,3220453
20882,42,93,0,12.19,304.96,3220452,3220494
20883,64,36,0,8.00,78.00,3220494,3220558
20884,77,34,0,6.65,34.80,3220557,3220634
20885,79,45,0,6.48,60.53,3220633,3220712
20886,68,81,0,7.53,114.07,3220711,3220779
20887,68,38,0,7.53,55.66,3220778,3220846
20888,65,46,0,7.88,80.38,3220845,3220910
20889,63,35,0,8.13,37.86,3220909,3220972
20890,69,32,1,7.42,27.17,3220971,3221040
20891,82,22,1,6.24,20.43,3221040,3221122
20892,66,25,0,7.76,27.70,3221121,3221187
20893,65,34,1,7.88,32.54,3221186,3221251
20894,80,28,1,6.40,21.71,3221250,3221330
20895,71,34,1,7.21,35.46,3221329,3221400
20896,62,21,0,8.26,21.29,3221399,3221461
20897,55,38,2,9.31,43.96,3221460,3221515
20898,51,44,1,10.04,51.14,3221514,3221565
20899,49,35,2,10.45,57.19,3221564,3221613
20900,57,24,1,8.98,31.42,3221612,3221669
20901,45,33,2,11.38,54.81,3221668,3221713
20902,46,34,0,11.13,55.90,3221712,3221758
20903,45,41,1,11.38,50.15,3221757,3221802
20904,44,47,1,11.64,86.78,3221801,3221845
20905,46,97,1,11.13,197.42,3221844,3221890
20906,60,22,0,8.53,28.52,3221889,3221949
20907,54,43,1,9.48,60.32,3221948,3222002
20908,38,49,2,13.47,115.30,3222001,3222039
20909,29,96,2,17.66,363.88,3222038,3222067
20910,39,45,0,13.13,105.19,3222066,3222105
20911,55,55,1,9.31,112.50,3222104,3222159
20912,61,34,0,8.39,53.26,3222158,3222219
20913,53,42,0,9.66,77.05,3222218,3222271
20914,34,100,1,15.06,679.82,3222270,3222304
20915,52,36,0,9.85,65.01,3222303,3222355
20916,86,21,0,5.95,22.90,3222354,3222440
20917,87,32,0,5.89,37.25,3222440,3222527
20918,49,79,0,10.45,213.64,3222526,3222575
20919,63,36,1,8.13,52.43,3222574,3222637
20920,66,57,0,7.76,65.55,3222636,3222702
20921,68,36,1,7.53,31.66,3222701,3222769
20922,69,36,0,7.42,42.91,3222768,3222837
20923,52,83,1,9.85,144.25,3222836,3222888
20924,57,53,1,8.98,75.14,3222888,3222945
20925,69,39,0,7.42,64.10,3222944,3223013
20926,49,34,1,10.45,67.02,3223012,3223061
20927,53,52,0,9.66,70.38,3223060,3223113
20928,62,23,1,8.26,22.84,3223112,3223174
20929,58,39,1,8.83,45.14,3223173,3223231
20930,53,65,1,9.66,91.13,3223230,3223283
20931,59,67,1,8.68,83.81,3223282,3223341
20932,38,91,1,13.47,263.99,3223340,3223378
20933,42,59,3,12.19,143.25,3223377,3223419
20934,38,46,0,13.47,117.99,3223418,3223456
20935,44,55,2,11.64,109.28,3223455,3223499
20936,39,57,0,13.13,173.09,3223498,3223537
20937,49,60,2,10.45,115.19,3223536,3223585
20938,60,25,1,8.53,30.75,3223584,3223644
20939,52,65,1,9.85,87.71,3223643,3223695
20940,59,39,1,8.68,49.54,3223694,3223753
20941,54,40,1,9.48,63.81,3223752,3223806
20942,34,72,2,15.06,223.53,3223805,3223839
20943,47,60,1,10.89,121.46,3223838,3223885
20944,39,135,1,13.13,420.73,3223884,3223923
20945,45,60,0,11.38,145.70,3223922,3223967
20946,39,34,3,13.13,75.34,3223966,3224005
20947,54,26,1,9.48,31.58,3224005,3224059
20948,45,55,0,11.38,105.92,3224058,3224103
20949,58,27,0,8.83,55.63,3224102,3224160
20950,75,41,0,6.83,46.92,3224159,3224234
20951,88,37,0,5.82,44.67,3224233,3224321
20952,78,40,0,6.56,45.71,3224320,3224398
20953,71,46,0,7.21,67.41,3224397,3224468
20954,73,37,0,7.01,43.79,3224467,3224540
20955,36,113,2,14.22,388.40,3224539,3224575
20956,61,57,1,8.39,69.71,3224574,3224635
20957,56,45,1,9.14,53.98,3224634,3224690
20958,62,42,0,8.26,58.13,3224690,3224752
20959,62,28,1,8.26,46.39,3224751,3224813
20960,43,53,0,11.91,122.97,3224812,3224855
20961,82,28,0,6.24,21.62,3224855,3224937
20962,69,23,1,7.42,24.82,3224936,3225005
20963,53,50,1,9.66,55.62,3225004,3225057
20964,49,39,1,10.45,54.25,3225056,3225105
20965,41,45,2,12.49,74.59,3225104,3225145
20966,42,43,1,12.19,104.54,3225145,3225187
20967,42,73,1,12.19,168.20,3225186,3225228
20968,37,42,1,13.84,146.19,3225227,3225264
20969,42,66,2,12.19,119.01,3225263,3225305
20970,56,32,0,9.14,46.44,3225304,3225360
20971,40,59,1,12.80,149.61,3225359,3225399
20972,40,103,2,12.80,293.96,3225398,3225438
20973,53,54,1,9.66,77.36,3225437,3225490
20974,36,71,1,14.22,207.34,3225489,3225525
20975,48,31,2,10.67,66.22,3225524,3225572
20976,55,60,1,9.31,92.18,3225571,3225626
20977,56,24,2,9.14,28.66,3225625,3225681
20978,36,100,2,14.22,300.84,3225680,3225716
20979,53,50,2,9.66,56.75,3225716,3225769
20980,56,32,1,9.14,47.37,3225768,3225824
20981,31,61,2,16.52,212.64,3225823,3225854
20982,32,75,2,16.00,327.56,3225853,3225885
20983,52,24,0,9.85,35.67,3225884,3225936
20984,45,55,0,11.38,144.59,3225935,3225980
20985,44,78,1,11.64,186.32,3225979,3226023
20986,57,53,0,8.98,70.61,3226022,3226079
20987,50,91,0,10.24,182.26,3226078,3226128
20988,55,133,1,9.31,320.32,3226127,3226182
20989,59,38,0,8.68,66.29,3226181,3226240
20990,83,29,0,6.17,30.86,3226239,3226322
20991,64,86,0,8.00,169.06,3226321,3226385
20992,76,68,0,6.74,90.33,3226384,3226460
20993,51,139,1,10.04,365.21,3226459,3226510
20994,75,47,1,6.83,51.21,3226509,3226584
20995,62,26,0,8.26,37.80,3226584,3226646
20996,55,39,0,9.31,62.65,3226645,3226700
20997,55,37,0,9.31,61.89,3226699,3226754
20998,56,25,2,9.14,29.41,3226753,3226809
20999,69,37,0,7.42,36.01,3226808,3226877
21000,69,25,0,7.42,28.13,3226876,3226945
21001,56,36,1,9.14,57.98,3226944,3227000
21002,64,50,0,8.00,57.94,3226999,3227063
21003,55,32,0,9.31,51.38,3227062,3227117
21004,52,25,0,9.85,35.48,3227116,3227168
21005,41,54,2,12.49,83.52,3227168,3227209
21006,47,50,1,10.89,103.03,3227208,3227255
21007,50,49,1,10.24,91.14,3227255,3227305
21008,55,29,1,9.31,30.18,3227304,3227359
21009,46,44,2,11.13,86.29,3227358,3227404
21010,53,27,1,9.66,26.34,3227403,3227456
21011,39,39,1,13.13,70.52,3227455,3227494
21012,43,80,2,11.91,155.85,3227493,3227536
21013,65,44,1,7.88,53.95,3227536,3227601
21014,57,39,1,8.98,52.12,3227600,3227657
21015,52,28,1,9.85,44.21,3227656,3227708
21016,38,90,1,13.47,339.99,3227707,3227745
21017,30,80,1,17.07,189.53,3227744,3227774
21018,34,44,0,15.06,131.00,3227773,3227807
21019,39,50,0,13.13,133.60,3227806,3227845
21020,47,137,1,10.89,377.16,3227844,3227891
21021,53,36,1,9.66,66.68,3227891,3227944
21022,62,38,1,8.26,51.32,3227943,3228005
21023,43,52,0,11.91,115.94,3228005,3228048
21024,41,90,1,12.49,353.23,3228047,3228088
21025,45,48,1,11.38,94.59,3228087,3228132
21026,48,76,0,10.67,185.22,3228131,3228179
21027,36,87,1,14.22,270.62,3228178,3228214
21028,73,50,0,7.01,54.51,3228213,3228286
21029,66,43,0,7.76,71.46,3228285,3228351
21030,57,58,0,8.98,95.88,3228350,3228407
21031,80,51,0,6.40,66.47,3228406,3228486
21032,60,59,1,8.53,79.62,3228485,3228545
21033,83,24,1,6.17,24.12,3228544,3228627
21034,41,61,1,12.49,168.10,3228627,3228668
21035,60,62,1,8.53,83.02,3228667,3228727
21036,58,26,0,8.83,41.25,3228726,3228784
21037,66,37,0,7.76,44.55,3228783,3228849
21038,46,45,1,11.13,116.85,3228848,3228894
21039,69,23,1,7.42,26.91,3228894,3228963
21040,68,28,0,7.53,33.57,3228962,3229030
21041,64,39,1,8.00,40.06,3229029,3229093
21042,63,29,1,8.13,34.90,3229092,3229155
21043,54,23,1,9.48,28.10,3229154,3229208
21044,54,46,1,9.48,48.36,3229207,3229261
21045,56,66,2,9.14,103.37,3229260,3229316
21046,43,52,2,11.91,97.99,3229315,3229358
21047,54,48,1,9.48,57.62,3229357,3229411
21048,41,52,1,12.49,103.62,3229410,3229451
21049,51,65,1,10.04,79.49,3229450,3229501
21050,47,48,1,10.89,87.16,3229500,3229547
21051,36,77,3,14.22,170.34,3229546,3229582
21052,45,59,1,11.38,123.92,3229581,3229626
21053,53,29,1,9.66,47.66,3229625,3229678
21054,60,29,2,8.53,39.08,3229677,3229737
21055,44,50,2,11.64,88.46,3229736,3229780
21056,54,49,1,9.48,76.73,3229779,3229833
21057,53,28,1,9.66,38.07,3229832,3229885
21058,40,55,2,12.80,137.61,3229885,3229925
21059,59,37,0,8.68,54.32,3229924,3229983
21060,46,41,1,11.13,95.42,3229982,3230028
21061,34,130,1,15.06,556.11,3230027,3230061
21062,55,28,1,9.31,47.23,3230060,3230115
21063,57,36,1,8.98,54.19,3230114,3230171
21064,87,21,0,5.89,23.48,3230170,3230257
21065,81,33,0,6.32,43.16,3230257,3230338
21066,65,42,0,7.88,85.18,3230337,3230402
21067,89,34,0,5.75,27.92,3230401,3230490
21068,75,34,1,6.83,41.37,3230489,3230564
21069,63,31,1,8.13,32.94,3230563,3230626
21070,79,21,1,6.48,17.14,3230625,3230704
21071,65,40,1,7.88,39.40,3230703,3230768
21072,61,28,1,8.39,40.50,3230767,3230828
21073,54,64,1,9.48,115.40,3230827,3230881
21074,53,44,1,9.66,56.90,3230880,3230933
21075,65,28,0,7.88,37.00,3230932,3230997
21076,76,21,0,6.74,17.54,3230996,3231072
21077,57,43,1,8.98,56.26,3231071,3231128
21078,54,52,0,9.48,77.40,3231128,3231182
21079,51,29,1,10.04,40.08,3231182,3231233
21080,58,27,1,8.83,28.32,3231232,3231290
21081,63,56,1,8.13,55.67,3231289,3231352
21082,55,24,2,9.31,22.47,3231351,3231406
21083,50,49,3,10.24,76.82,3231405,3231455
21084,49,26,0,10.45,37.47,3231454,3231503
21085,48,41,1,10.67,70.56,3231502,3231550
21086,65,18,1,7.88,15.89,3231549,3231614
21087,52,58,1,9.85,102.25,3231614,3231666
21088,57,46,1,8.98,75.10,3231665,3231722
21089,36,74,1,14.22,181.23,3231721,3231757
21090,56,30,1,9.14,42.44,3231756,3231812
21091,58,44,0,8.83,83.83,3231811,3231869
21092,52,30,1,9.85,37.17,3231869,3231921
21093,44,80,0,11.64,236.78,3231920,3231964
21094,54,53,0,9.48,85.69,3231963,3232017
21095,83,35,0,6.17,35.15,3232016,3232099
21096,87,29,0,5.89,27.32,3232098,3232185
21097,50,85,0,10.24,260.26,3232184,3232234
21098,60,34,0,8.53,44.98,3232233,3232293
21099,71,47,0,7.21,43.80,3232292,3232363
21100,76,23,1,6.74,23.06,3232362,3232438
21101,57,29,1,8.98,37.35,3232437,3232494
21102,65,40,0,7.88,49.25,3232493,3232558
21103,61,45,1,8.39,71.45,3232557,3232618
21104,50,79,0,10.24,158.14,3232617,3232667
21105,41,97,1,12.49,255.08,3232666,3232707
21106,58,76,0,8.83,130.66,3232706,3232764
21107,75,19,0,6.83,18.54,3232763,3232838
21108,59,34,1,8.68,41.13,3232837,3232896
21109,64,20,0,8.00,21.06,3232895,3232959
21110,53,64,2,9.66,90.30,3232958,3233011
21111,57,58,1,8.98,81.49,3233011,3233068
21112,49,41,1,10.45,67.10,3233067,3233116
21113,47,58,1,10.89,90.52,3233115,3233162
21114,50,32,1,10.24,63.46,3233161,3233211
21115,49,51,1,10.45,81.39,3233211,3233260
21116,42,50,2,12.19,114.20,3233259,3233301
21117,34,87,1,15.06,337.88,3233300,3233334
21118,49,54,1,10.45,62.25,3233333,3233382
21119,49,92,0,10.45,172.33,3233381,3233430
21120,63,31,1,8.13,44.43,3233429,3233492
21121,59,51,2,8.68,52.39,3233491,3233550
21122,24,114,1,21.33,934.89,3233550,3233574
21123,36,74,2,14.22,202.06,3233573,3233609
21124,60,26,0,8.53,31.02,3233609,3233669
21125,53,36,2,9.66,53.81,3233668,3233721
21126,68,34,0,7.53,40.51,3233720,3233788
21127,80,72,0,6.40,73.04,3233788,3233868
21128,71,30,0,7.21,45.86,3233868,3233939
21129,83,48,0,6.17,58.45,3233938,3234021
21130,62,41,1,8.26,49.29,3234020,3234082
21131,68,33,0,7.53,47.78,3234081,3234149
21132,62,47,0,8.26,69.61,3234148,3234210
21133,78,24,1,6.56,25.02,3234210,3234288
21134,66,38,1,7.76,40.64,3234287,3234353
21135,71,18,1,7.21,17.43,3234352,3234423
21136,64,51,0,8.00,55.72,3234422,3234486
21137,43,76,2,11.91,147.34,3234486,3234529
21138,64,34,1,8.00,36.50,3234529,3234593
21139,76,25,1,6.74,19.88,3234592,3234668
21140,58,41,0,8.83,48.45,3234667,3234725
21141,54,39,0,9.48,48.21,3234724,3234778
21142,55,33,0,9.31,47.16,3234777,3234832
21143,61,22,0,8.39,23.81,3234831,3234892
21144,42,44,1,12.19,90.73,3234891,3234933
21145,52,39,0,9.85,51.82,3234932,3234984
21146,60,53,1,8.53,56.02,3234983,3235043
21147,35,92,1,14.63,288.80,3235042,3235077
21148,45,68,2,11.38,125.70,3235076,3235121
21149,43,38,1,11.91,54.83,3235120,3235163
21150,39,61,2,13.13,124.68,3235162,3235201
21151,54,47,1,9.48,59.73,3235200,3235254
21152,51,60,1,10.04,102.35,3235253,3235304
21153,49,28,1,10.45,55.19,3235303,3235352
21154,40,45,1,12.80,106.96,3235351,3235391
21155,36,43,1,14.22,104.62,3235390,3235426
21156,60,52,1,8.53,96.85,3235425,3235485
21157,48,61,1,10.67,123.93,3235484,3235532
21158,47,108,0,10.89,230.01,3235531,3235578
21159,34,61,0,15.06,229.06,3235578,3235612
21160,45,62,0,11.38,148.77,3235611,3235656
21161,53,95,0,9.66,208.56,3235655,3235708
21162,72,68,0,7.11,75.99,3235707,3235779
21163,59,41,0,8.68,74.83,3235778,3235837
21164,62,26,0,8.26,46.55,3235836,3235898
21165,54,47,1,9.48,58.62,3235897,3235951
21166,69,24,0,7.42,27.61,3235950,3236019
21167,65,43,1,7.88,51.09,3236018,3236083
21168,58,35,1,8.83,44.73,3236083,3236141
21169,70,35,1,7.31,34.33,3236140,3236210
21170,62,34,0,8.26,34.22,3236209,3236271
21171,63,29,0,8.13,31.79,3236270,3236333
21172,54,69,0,9.48,114.32,3236332,3236386
21173,51,78,1,10.04,159.76,3236385,3236436
21174,60,90,1,8.53,130.58,3236435,3236495
21175,67,30,1,7.64,35.16,3236494,3236561
21176,51,24,1,10.04,26.55,3236560,3236611
21177,46,52,1,11.13,89.42,3236611,3236657
21178,44,37,1,11.64,69.64,3236656,3236700
21179,48,48,0,10.67,87.68,3236699,3236747
21180,44,77,0,11.64,150.46,3236746,3236790
21181,57,31,2,8.98,29.53,3236789,3236846
21182,43,49,1,11.91,106.32,3236846,3236889
21183,40,77,1,12.80,214.11,3236888,3236928
21184,47,42,1,10.89,71.88,3236927,3236974
21185,33,162,1,15.52,716.61,3236973,3237006
21186,46,21,3,11.13,23.98,3237005,3237051
21187,42,61,1,12.19,156.25,3237050,3237092
21188,51,80,2,10.04,147.45,3237091,3237142
21189,55,29,1,9.31,45.34,3237141,3237196
21190,47,50,1,10.89,101.41,3237196,3237243
21191,34,114,0,15.06,382.06,3237242,3237276
21192,64,30,1,8.00,27.25,3237275,3237339
21193,49,33,1,10.45,54.74,3237338,3237387
21194,62,44,0,8.26,54.22,3237386,3237448
21195,27,220,0,18.96,1621.00,3237447,3237474
21196,69,33,0,7.42,46.79,3237473,3237542
21197,82,29,0,6.24,39.87,3237541,3237623
21198,92,30,0,5.57,28.03,3237622,3237714
21199,50,89,1,10.24,163.14,3237713,3237763
21200,67,28,0,7.64,35.57,3237762,3237829
21201,63,34,0,8.13,53.76,3237828,3237891
21202,71,23,1,7.21,26.53,3237891,3237962
21203,57,60,0,8.98,86.47,3237961,3238018
21204,67,44,0,7.64,46.59,3238017,3238084
21205,72,29,1,7.11,29.88,3238084,3238156
21206,53,50,1,9.66,93.51,3238155,3238208
21207,50,39,1,10.24,73.54,3238207,3238257
21208,57,29,1,8.98,41.84,3238256,3238313
21209,48,32,1,10.67,43.14,3238312,3238360
21210,60,36,0,8.53,45.88,3238360,3238420
21211,56,40,2,9.14,55.34,3238420,3238476
21212,56,37,0,9.14,42.52,3238476,3238532
21213,53,39,1,9.66,55.96,3238531,3238584
21214,51,39,1,10.04,60.31,3238583,3238634
21215,58,28,3,8.83,23.73,3238633,3238691
21216,51,51,2,10.04,66.67,3238690,3238741
21217,42,162,1,12.19,573.06,3238741,3238783
21218,49,31,2,10.45,53.68,3238782,3238831
21219,48,117,1,10.67,281.26,3238830,3238878
21220,45,46,1,11.38,103.08,3238877,3238922
21221,24,96,2,21.33,440.47,3238921,3238945
21222,43,52,0,11.91,128.13,3238944,3238987
21223,53,32,1,9.66,57.09,3238987,3239040
21224,49,55,0,10.45,102.57,3239039,3239088
21225,34,91,1,15.06,284.11,3239087,3239121
21226,41,54,3,12.49,114.88,3239120,3239161
21227,53,40,1,9.66,68.98,3239160,3239213
21228,46,37,0,11.13,90.37,3239212,3239258
21229,69,36,0,7.42,48.85,3239258,3239327
21230,68,27,0,7.53,43.43,3239326,3239394
21231,79,38,0,6.48,41.69,3239393,3239472
21232,59,73,0,8.68,119.81,3239471,3239530
21233,66,36,0,7.76,51.88,3239529,3239595
21234,64,34,1,8.00,42.38,3239594,3239658
21235,65,36,1,7.88,47.15,3239657,3239722
21236,58,48,1,8.83,57.07,3239722,3239780
21237,55,51,1,9.31,75.70,3239779,3239834
21238,38,88,0,13.47,246.78,3239833,3239871
21239,57,48,1,8.98,68.89,3239870,3239927
21240,51,91,0,10.04,285.02,3239927,3239978
21241,53,46,1,9.66,70.71,3239977,3240030
21242,56,31,1,9.14,40.66,3240029,3240085
21243,58,31,1,8.83,30.73,3240085,3240143
21244,46,58,3,11.13,120.24,3240142,3240188
21245,53,37,1,9.66,56.64,3240187,3240240
21246,41,91,1,12.49,229.37,3240239,3240280
21247,62,28,1,8.26,30.09,3240279,3240341
21248,49,63,1,10.45,114.78,3240340,3240389
21249,41,52,1,12.49,158.20,3240388,3240429
21250,34,177,1,15.06,839.29,3240428,3240462
21251,48,36,1,10.67,60.06,3240461,3240509
21252,55,35,1,9.31,43.30,3240508,3240563
21253,56,27,1,9.14,38.84,3240562,3240618
21254,47,57,1,10.89,102.65,3240617,3240664
21255,38,165,1,13.47,652.93,3240663,3240701
21256,33,150,1,15.52,671.46,3240700,3240733
21257,45,53,2,11.38,94.37,3240733,3240778
21258,13,159,4,39.38,1881.01,3240777,3240790
21259,36,51,2,14.22,143.51,3240789,3240825
21260,51,45,1,10.04,89.96,3240824,3240875
21261,64,33,1,8.00,42.62,3240874,3240938
21262,51,41,0,10.04,76.67,3240937,3240988
21263,45,70,0,11.38,143.04,3240987,3241032
21264,37,105,3,13.84,319.70,3241031,3241068
21265,58,41,0,8.83,56.63,3241067,3241125
21266,90,39,0,5.69,32.50,3241124,3241214
21267,55,41,1,9.31,84.18,3241213,3241268
21268,81,25,0,6.32,35.16,3241267,3241348
21269,60,45,0,8.53,44.78,3241347,3241407
21270,62,26,0,8.26,36.09,3241406,3241468
21271,75,30,1,6.83,22.41,3241467,3241542
21272,69,27,1,7.42,30.82,3241541,3241610
21273,67,47,1,7.64,40.98,3241609,3241676
21274,57,29,1,8.98,39.03,3241675,3241732
21275,79,22,0,6.48,18.33,3241731,3241810
21276,72,19,1,7.11,20.54,3241809,3241881
21277,50,71,0,10.24,129.26,3241880,3241930
21278,61,30,1,8.39,39.65,3241929,3241990
21279,48,48,0,10.67,85.47,3241989,3242037
21280,67,26,0,7.64,24.71,3242036,3242103
21281,61,29,0,8.39,34.07,3242102,3242163
21282,47,62,0,10.89,121.92,3242162,3242209
21283,45,29,1,11.38,58.68,3242208,3242253
21284,48,34,1,10.67,62.60,3242252,3242300
21285,49,34,1,10.45,48.86,3242300,3242349
21286,47,36,0,10.89,40.69,3242349,3242396
21287,62,18,1,8.26,16.35,3242395,3242457
21288,47,40,1,10.89,77.63,3242456,3242503
21289,62,64,0,8.26,84.61,3242502,3242564
21290,60,32,0,8.53,51.22,3242563,3242623
21291,35,114,1,14.63,436.40,3242622,3242657
21292,24,86,2,21.33,453.47,3242656,3242680
21293,46,44,1,11.13,76.64,3242679,3242725
21294,39,99,0,13.13,271.45,3242724,3242763
21295,45,116,0,11.38,297.84,3242762,3242807
21296,26,114,3,19.69,591.67,3242806,3242832
21297,41,106,1,12.49,286.64,3242831,3242872
21298,47,36,2,10.89,56.86,3242871,3242918
21299,51,57,1,10.04,85.29,3242917,3242968
21300,41,76,0,12.49,188.64,3242967,3243008
21301,48,65,0,10.67,163.81,3243007,3243055
21302,64,78,0,8.00,154.38,3243054,3243118
21303,63,39,0,8.13,64.17,3243117,3243180
21304,75,45,0,6.83,69.10,3243179,3243254
21305,95,21,0,5.39,17.75,3243253,3243348
21306,63,36,1,8.13,62.81,3243348,3243411
21307,56,71,1,9.14,109.52,3243411,3243467
21308,64,60,1,8.00,88.88,3243466,3243530
21309,69,32,1,7.42,43.55,3243529,3243598
21310,62,28,0,8.26,40.90,3243597,3243659
21311,55,131,1,9.31,291.49,3243658,3243713
21312,46,56,1,11.13,131.50,3243712,3243758
21313,66,46,2,7.76,60.76,3243758,3243824
21314,66,35,1,7.76,38.70,3243823,3243889
21315,40,115,0,12.80,300.96,3243889,3243929
21316,50,53,1,10.24,75.02,3243929,3243979
21317,41,50,1,12.49,107.08,3243978,3244019
21318,41,40,0,12.49,86.44,3244018,3244059
21319,52,60,1,9.85,98.71,3244058,3244110
21320,51,40,2,10.04,55.02,3244109,3244160
21321,52,60,1,9.85,75.05,3244159,3244211
21322,39,78,1,13.13,223.55,3244210,3244249
21323,55,36,0,9.31,52.18,3244248,3244303
21324,35,65,3,14.63,157.09,3244302,3244337
21325,51,41,1,10.04,63.88,3244336,3244387
21326,45,51,1,11.38,93.70,3244386,3244431
21327,45,24,1,11.38,33.79,3244430,3244475
21328,48,33,1,10.67,61.43,3244474,3244522
21329,53,33,1,9.66,48.56,3244522,3244575
21330,50,32,2,10.24,58.46,3244574,3244624
21331,37,61,1,13.84,144.19,3244623,3244660
21332,33,67,2,15.52,184.13,3244659,3244692
21333,49,90,1,10.45,181.88,3244691,3244740
21334,54,26,1,9.48,37.77,3244740,3244794
21335,44,40,1,11.64,82.05,3244793,3244837
21336,47,72,0,10.89,150.69,3244836,3244883
21337,45,39,1,11.38,68.68,3244882,3244927
21338,62,39,0,8.26,55.64,3244926,3244988
21339,77,39,0,6.65,36.49,3244987,3245064
21340,63,101,0,8.13,187.16,3245063,3245126
21341,49,60,0,10.45,151.47,3245125,3245174
21342,75,38,0,6.83,45.45,3245173,3245248
21343,67,100,0,7.64,146.38,3245247,3245314
21344,66,57,1,7.76,65.15,3245313,3245379
21345,60,31,1,8.53,55.92,3245378,3245438
21346,76,40,1,6.74,36.19,3245438,3245514
21347,66,50,1,7.76,60.94,3245513,3245579
21348,76,22,1,6.74,18.56,3245578,3245654
21349,68,39,0,7.53,44.75,3245653,3245721
21350,47,41,0,10.89,97.29,3245720,3245767
21351,59,25,1,8.68,28.01,3245766,3245825
21352,56,32,0,9.14,28.84,3245824,3245880
21353,57,35,1,8.98,44.79,3245879,3245936
21354,56,26,2,9.14,35.27,3245935,3245991
21355,60,22,1,8.53,24.02,3245990,3246050
21356,47,88,1,10.89,170.44,3246049,3246096
21357,57,37,0,8.98,43.18,3246095,3246152
21358,52,67,1,9.85,112.78,3246151,3246203
21359,34,88,3,15.06,216.29,3246202,3246236
21360,55,28,2,9.31,32.54,3246235,3246290
21361,52,51,1,9.85,76.36,3246289,3246341
21362,48,58,0,10.67,131.51,3246340,3246388
21363,59,34,1,8.68,34.83,3246387,3246446
21364,62,27,1,8.26,32.26,3246445,3246507
21365,41,42,1,12.49,101.32,3246506,3246547
21366,25,92,1,20.48,470.81,3246546,3246571
21367,47,35,2,10.89,71.07,3246570,3246617
21368,60,38,1,8.53,59.08,3246616,3246676
21369,48,50,1,10.67,64.43,3246675,3246723
21370,47,46,1,10.89,96.35,3246722,3246769
21371,47,60,1,10.89,144.95,3246768,3246815
21372,72,38,0,7.11,43.29,3246814,3246886
21373,92,30,0,5.57,26.18,3246885,3246977
21374,65,89,0,7.88,136.91,3246977,3247042
21375,89,32,0,5.75,28.64,3247042,3247131
21376,62,60,0,8.26,90.26,3247130,3247192
21377,76,22,0,6.74,23.72,3247191,3247267
21378,57,38,1,8.98,54.47,3247266,3247323
21379,65,58,0,7.88,71.49,3247323,3247388
21380,62,78,1,8.26,117.87,3247387,3247449
21381,50,40,1,10.24,57.66,3247449,3247499
21382,57,39,1,8.98,59.32,3247498,3247555
21383,65,62,1,7.88,74.32,3247554,3247619
21384,63,86,1,8.13,114.08,3247618,3247681
21385,41,56,1,12.49,155.76,3247680,3247721
21386,56,27,1,9.14,39.69,3247720,3247776
21387,57,27,0,8.98,36.19,3247775,3247832
21388,39,46,2,13.13,116.57,3247831,3247870
21389,56,31,2,9.14,36.02,3247869,3247925
21390,57,37,1,8.98,53.81,3247924,3247981
21391,51,51,1,10.04,63.65,3247980,3248031
21392,47,53,1,10.89,83.67,3248030,3248077
21393,49,26,3,10.45,28.00,3248076,3248125
21394,46,71,1,11.13,112.46,3248124,3248170
21395,42,86,2,12.19,201.06,3248169,3248211
21396,52,65,1,9.85,85.59,3248210,3248262
21397,58,45,1,8.83,45.35,3248261,3248319
21398,62,35,1,8.26,35.77,3248318,3248380
21399,31,73,0,16.52,299.60,3248379,3248410
21400,36,61,1,14.22,187.51,3248409,3248445
21401,37,90,2,13.84,214.95,3248444,3248481
21402,50,40,1,10.24,74.98,3248480,3248530
21403,45,33,1,11.38,61.48,3248529,3248574
21404,61,36,1,8.39,44.21,3248573,3248634
21405,37,99,0,13.84,362.14,3248633,3248670
21406,56,52,0,9.14,90.23,3248669,3248725
21407,83,32,0,6.17,42.62,3248724,3248807
21408,79,37,0,6.48,49.67,3248806,3248885
21409,59,80,0,8.68,126.83,3248884,3248943
21410,57,43,1,8.98,81.98,3248943,3249000
21411,60,36,1,8.53,45.35,3248999,3249059
21412,52,99,0,9.85,200.25,3249059,3249111
21413,51,40,0,10.04,88.90,3249110,3249161
21414,57,31,0,8.98,47.88,3249160,3249217
21415,60,40,0,8.53,44.25,3249216,3249276
21416,63,27,1,8.13,35.25,3249275,3249338
21417,46,65,1,11.13,120.37,3249337,3249383
21418,52,33,1,9.85,63.40,3249382,3249434
21419,66,30,1,7.76,36.03,3249433,3249499
21420,30,63,1,17.07,203.40,3249498,3249528
21421,42,104,2,12.19,289.44,3249527,3249569
21422,56,38,1,9.14,42.30,3249568,3249624
21423,43,35,3,11.91,68.04,3249623,3249666
21424,32,112,1,16.00,489.19,3249665,3249697
21425,46,34,1,11.13,59.94,3249696,3249742
21426,45,54,1,11.38,84.72,3249741,3249786
21427,37,53,1,13.84,152.14,3249785,3249822
21428,41,47,1,12.49,86.40,3249821,3249862
21429,41,79,1,12.49,175.91,3249861,3249902
21430,67,20,1,7.64,18.29,3249901,3249968
21431,49,40,1,10.45,68.04,3249967,3250016
21432,54,36,0,9.48,44.25,3250016,3250070
21433,56,20,2,9.14,20.66,3250070,3250126
21434,44,57,2,11.64,130.37,3250125,3250169
21435,35,53,1,14.63,140.98,3250168,3250203
21436,51,33,0,10.04,63.49,3250202,3250253
21437,59,31,0,8.68,46.12,3250252,3250311
21438,62,32,0,8.26,44.19,3250310,3250372
21439,54,82,1,9.48,163.55,3250371,3250425
21440,60,43,0,8.53,58.45,3250424,3250484
21441,72,40,0,7.11,59.96,3250483,3250555
21442,76,25,0,6.74,35.11,3250554,3250630
21443,63,71,1,8.13,129.63,3250630,3250693
21444,98,20,0,5.22,18.68,3250692,3250790
21445,64,68,1,8.00,87.16,3250789,3250853
21446,67,89,0,7.64,193.42,3250852,3250919
21447,54,36,2,9.48,63.10,3250918,3250972
21448,69,48,1,7.42,42.19,3250971,3251040
21449,68,40,1,7.53,49.60,3251039,3251107
21450,61,26,1,8.39,35.39,3251106,3251167
21451,57,49,0,8.98,57.56,3251166,3251223
21452,73,27,1,7.01,28.18,3251223,3251296
21453,66,42,0,7.76,49.06,3251295,3251361
21454,63,27,0,8.13,38.33,3251360,3251423
21455,54,30,0,9.48,48.88,3251422,3251476
21456,43,62,1,11.91,117.85,3251476,3251519
21457,41,87,1,12.49,259.13,3251518,3251559
21458,61,25,1,8.39,27.06,3251558,3251619
21459,61,22,1,8.39,24.57,3251618,3251679
21460,48,59,0,10.67,116.51,3251678,3251726
21461,47,37,2,10.89,60.69,3251725,3251772
21462,51,78,1,10.04,132.23,3251771,3251822
21463,46,34,1,11.13,53.07,3251821,3251867
21464,55,21,1,9.31,19.85,3251866,3251921
21465,45,52,2,11.38,89.79,3251920,3251965
21466,69,21,0,7.42,19.92,3251964,3252033
21467,52,55,2,9.85,67.44,3252032,3252084
21468,53,34,1,9.66,56.00,3252084,3252137
21469,37,55,2,13.84,134.62,3252136,3252173
21470,24,174,1,21.33,1232.56,3252172,3252196
21471,50,39,1,10.24,79.86,3252195,3252245
21472,68,21,0,7.53,25.54,3252244,3252312
21473,53,33,0,9.66,53.28,3252311,3252364
21474,61,30,1,8.39,33.71,3252363,3252424
21475,42,65,0,12.19,148.11,3252423,3252465
21476,52,53,1,9.85,105.17,3252464,3252516
21477,48,125,0,10.67,354.26,3252515,3252563
21478,59,46,0,8.68,60.96,3252562,3252621
21479,86,49,0,5.95,49.35,3252620,3252706
21480,69,43,0,7.42,59.29,3252705,3252774
21481,69,54,0,7.42,80.85,3252773,3252842
21482,67,48,1,7.64,70.92,3252841,3252908
21483,63,25,0,8.13,30.02,3252907,3252970
21484,71,55,0,7.21,53.15,3252969,3253040
21485,67,31,1,7.64,32.80,3253039,3253106
21486,75,29,1,6.83,26.76,3253106,3253181
21487,74,39,0,6.92,36.02,3253180,3253254
21488,75,47,0,6.83,43.85,3253253,3253328
21489,70,37,1,7.31,42.39,3253328,3253398
21490,46,77,1,11.13,167.72,3253397,3253443
21491,51,27,2,10.04,38.43,3253442,3253493
21492,41,40,2,12.49,76.25,3253492,3253533
21493,49,35,2,10.45,40.17,3253533,3253582
21494,42,47,3,12.19,107.20,3253581,3253623
21495,45,87,2,11.38,180.46,3253622,3253667
21496,56,55,1,9.14,99.66,3253666,3253722
21497,38,70,2,13.47,234.88,3253721,3253759
21498,45,59,2,11.38,98.10,3253758,3253803
21499,48,49,1,10.67,80.51,3253802,3253850
21500,52,57,1,9.85,79.05,3253849,3253901
21501,31,88,2,16.52,473.86,3253900,3253931
21502,45,38,1,11.38,81.21,3253930,3253975
21503,38,90,3,13.47,202.25,3253974,3254012
21504,36,165,2,14.22,680.17,3254011,3254047
21505,53,56,0,9.66,91.05,3254047,3254100
21506,42,47,1,12.19,107.87,3254099,3254141
21507,49,45,1,10.45,88.12,3254140,3254189
21508,18,182,1,28.44,1975.25,3254188,3254206
21509,24,146,2,21.33,872.72,3254205,3254229
21510,43,48,1,11.91,98.41,3254228,3254271
21511,45,34,1,11.38,88.01,3254270,3254315
21512,50,36,1,10.24,74.62,3254314,3254364
21513,45,43,1,11.38,85.04,3254363,3254408
21514,48,42,0,10.67,90.72,3254407,3254455
21515,58,44,0,8.83,80.83,3254454,3254512
21516,46,42,0,11.13,84.33,3254511,3254557
21517,85,32,0,6.02,45.15,3254556,3254641
21518,56,79,0,9.14,112.23,3254640,3254696
21519,72,38,0,7.11,66.21,3254695,3254767
21520,54,90,0,9.48,194.69,3254766,3254820
21521,73,36,0,7.01,51.22,3254819,3254892
21522,50,36,1,10.24,55.62,3254891,3254941
21523,71,28,0,7.21,31.97,3254940,3255011
21524,63,27,1,8.13,27.98,3255010,3255073
21525,66,28,1,7.76,37.24,3255073,3255139
21526,73,18,0,7.01,17.16,3255138,3255211
21527,54,52,0,9.48,77.84,3255210,3255264
21528,70,40,1,7.31,40.36,3255263,3255333
21529,55,56,0,9.31,93.30,3255332,3255387
21530,32,224,1,16.00,1430.38,3255386,3255418
21531,56,46,0,9.14,70.37,3255417,3255473
21532,61,22,0,8.39,36.01,3255472,3255533
21533,61,32,0,8.39,35.55,3255532,3255593
21534,56,24,1,9.14,32.34,3255592,3255648
21535,45,117,1,11.38,296.32,3255647,3255692
21536,52,29,0,9.85,43.48,3255691,3255743
21537,55,50,2,9.31,54.32,3255742,3255797
21538,52,83,1,9.85,147.55,3255796,3255848
21539,52,51,1,9.85,54.51,3255847,3255899
21540,50,51,2,10.24,67.06,3255898,3255948
21541,42,64,2,12.19,119.39,3255947,3255989
21542,45,49,2,11.38,66.50,3255988,3256033
21543,58,68,0,8.83,94.07,3256032,3256090
21544,49,42,1,10.45,66.17,3256089,3256138
21545,41,87,1,12.49,245.27,3256137,3256178
21546,46,62,1,11.13,150.03,3256177,3256223
21547,44,47,1,11.64,99.14,3256222,3256266
21548,25,106,0,20.48,558.73,3256265,3256290
21549,58,43,1,8.83,44.87,3256290,3256348
21550,57,45,0,8.98,75.03,3256347,3256404
21551,62,51,1,8.26,65.39,3256403,3256465
21552,39,131,1,13.13,453.80,3256464,3256503
21553,52,45,1,9.85,111.28,3256502,3256554
21554,47,78,0,10.89,195.29,3256553,3256600
21555,63,59,0,8.13,88.81,3256599,3256662
21556,84,28,0,6.10,33.97,3256661,3256745
21557,78,67,0,6.56,69.19,3256744,3256822
21558,64,99,0,8.00,150.78,3256821,3256885
21559,86,27,0,5.95,24.28,3256885,3256971
21560,77,42,0,6.65,49.21,3256970,3257047
21561,80,33,1,6.40,19.69,3257046,3257126
21562,70,23,1,7.31,27.93,3257125,3257195
21563,77,23,0,6.65,23.21,3257195,3257272
21564,58,79,0,8.83,121.94,3257272,3257330
21565,79,58,0,6.48,50.40,3257329,3257408
21566,71,64,1,7.21,70.03,3257407,3257478
21567,73,23,0,7.01,23.38,3257477,3257550
21568,59,31,0,8.68,38.01,3257549,3257608
21569,52,33,0,9.85,48.94,3257607,3257659
21570,44,37,0,11.64,77.10,3257658,3257702
21571,47,66,1,10.89,98.95,3257701,3257748
21572,44,53,1,11.64,137.37,3257747,3257791
21573,48,97,1,10.67,204.39,3257791,3257839
21574,38,55,0,13.47,169.46,3257838,3257876
21575,46,52,1,11.13,66.64,3257875,3257921
21576,47,42,0,10.89,65.50,3257920,3257967
21577,34,62,3,15.06,127.82,3257967,3258001
21578,39,80,2,13.13,175.24,3258000,3258039
21579,45,34,2,11.38,45.52,3258038,3258083
21580,37,44,1,13.84,103.92,3258082,3258119
21581,42,63,3,12.19,110.30,3258118,3258160
21582,49,49,2,10.45,83.59,3258159,3258208
21583,53,39,1,9.66,52.11,3258207,3258260
21584,39,123,1,13.13,384.68,3258259,3258298
21585,44,68,1,11.64,163.14,3258297,3258341
21586,27,48,1,18.96,186.18,3258340,3258367
21587,34,50,1,15.06,156.11,3258366,3258400
21588,51,74,1,10.04,126.55,3258399,3258450
21589,38,51,1,13.47,208.72,3258449,3258487
21590,49,36,1,10.45,69.51,3258486,3258535
21591,38,103,0,13.47,280.04,3258534,3258572
21592,49,41,0,10.45,99.51,3258571,3258620
21593,67,22,1,7.64,21.10,3258620,3258687
21594,85,30,0,6.02,31.72,3258686,3258771
21595,81,34,0,6.32,43.18,3258770,3258851
21596,67,79,0,7.64,154.56,3258850,3258917
21597,65,43,0,7.88,54.63,3258917,3258982
21598,46,70,1,11.13,166.24,3258981,3259027
21599,67,25,0,7.64,27.01,3259026,3259093
21600,59,57,2,8.68,95.40,3259092,3259151
21601,39,58,1,13.13,196.27,3259150,3259189
21602,50,52,1,10.24,90.34,3259189,3259239
21603,59,34,1,8.68,51.17,3259238,3259297
21604,66,60,1,7.76,77.70,3259296,3259362
21605,39,61,3,13.13,148.88,3259361,3259400
21606,64,39,1,8.00,47.16,3259399,3259463
21607,65,38,0,7.88,41.18,3259462,3259527
21608,40,43,2,12.80,103.36,3259526,3259566
21609,48,33,1,10.67,60.89,3259566,3259614
21610,54,56,1,9.48,75.92,3259613,3259667
21611,48,63,2,10.67,132.72,3259666,3259714
21612,51,55,1,10.04,84.27,3259713,3259764
21613,54,37,1,9.48,49.88,3259763,3259817
21614,54,28,1,9.48,34.66,3259816,3259870
21615,43,52,1,11.91,118.74,3259869,3259912
21616,46,57,1,11.13,98.37,3259912,3259958
21617,45,54,1,11.38,96.86,3259957,3260002
21618,53,27,1,9.66,32.00,3260001,3260054
21619,62,33,1,8.26,29.93,3260053,3260115
21620,55,38,2,9.31,45.56,3260114,3260169
21621,53,33,1,9.66,35.81,3260168,3260221
21622,26,90,2,19.69,573.60,3260220,3260246
21623,35,83,2,14.63,258.35,3260245,3260280
21624,49,38,1,10.45,71.59,3260279,3260328
21625,47,98,1,10.89,221.12,3260327,3260374
21626,49,93,1,10.45,195.68,3260373,3260422
21627,45,56,0,11.38,152.06,3260421,3260466
21628,61,45,0,8.39,71.98,3260465,3260526
21629,67,37,0,7.64,57.33,3260526,3260593
21630,89,81,0,5.75,80.68,3260592,3260681
21631,82,39,0,6.24,56.53,3260680,3260762
21632,63,44,1,8.13,62.21,3260761,3260824
21633,54,47,0,9.48,90.40,3260823,3260877
21634,51,87,0,10.04,173.88,3260876,3260927
21635,63,34,0,8.13,43.92,3260926,3260989
21636,66,34,1,7.76,42.37,3260988,3261054
21637,43,55,0,11.91,106.69,3261053,3261096
21638,71,37,1,7.21,28.22,3261095,3261166
21639,56,33,1,9.14,40.69,3261165,3261221
21640,70,69,0,7.31,83.73,3261221,3261291
21641,53,59,0,9.66,79.96,3261290,3261343
21642,51,38,0,10.04,53.45,3261342,3261393
21643,52,69,1,9.85,116.71,3261392,3261444
21644,60,25,2,8.53,35.98,3261443,3261503
21645,70,29,1,7.31,26.50,3261502,3261572
21646,35,90,1,14.63,420.06,3261571,3261606
21647,53,28,1,9.66,36.19,3261605,3261658
21648,53,40,1,9.66,57.55,3261657,3261710
21649,41,65,3,12.49,205.96,3261709,3261750
21650,52,35,1,9.85,68.25,3261749,3261801
21651,55,46,1,9.31,66.25,3261800,3261855
21652,54,38,1,9.48,53.99,3261854,3261908
21653,53,31,0,9.66,35.09,3261907,3261960
21654,47,36,0,10.89,78.73,3261959,3262006
21655,54,57,1,9.48,81.40,3262005,3262059
21656,34,77,1,15.06,252.00,3262058,3262092
21657,54,81,0,9.48,145.69,3262091,3262145
21658,54,74,1,9.48,127.99,3262144,3262198
21659,52,32,0,9.85,52.25,3262197,3262249
21660,70,45,0,7.31,53.82,3262248,3262318
21661,67,50,0,7.64,59.01,3262317,3262384
21662,66,33,1,7.76,33.58,3262383,3262449
21663,75,26,0,6.83,34.73,3262448,3262523
21664,76,49,0,6.74,69.90,3262522,3262598
21665,94,57,0,5.45,47.03,3262597,3262691
21666,46,44,1,11.13,103.64,3262690,3262736
21667,71,37,1,7.21,49.01,3262735,3262806
21668,54,158,1,9.48,443.92,3262806,3262860
21669,53,46,1,9.66,64.41,3262860,3262913
21670,61,63,0,8.39,85.26,3262912,3262973
21671,60,31,0,8.53,49.02,3262972,3263032
21672,57,51,2,8.98,65.77,3263031,3263088
21673,62,53,0,8.26,85.84,3263087,3263149
21674,64,48,1,8.00,56.81,3263148,3263212
21675,59,28,2,8.68,37.74,3263211,3263270
21676,47,90,0,10.89,183.58,3263269,3263316
21677,50,33,1,10.24,57.62,3263315,3263365
21678,51,59,1,10.04,106.47,3263364,3263415
21679,53,42,1,9.66,66.34,3263414,3263467
21680,57,45,0,8.98,43.84,3263466,3263523
21681,50,46,1,10.24,98.70,3263522,3263572
21682,46,103,0,11.13,212.46,3263572,3263618
21683,43,93,1,11.91,204.46,3263617,3263660
21684,56,42,1,9.14,40.62,3263659,3263715
21685,52,27,2,9.85,33.28,3263714,3263766
21686,57,32,1,8.98,33.74,3263765,3263822
21687,53,34,1,9.66,46.75,3263821,3263874
21688,47,29,1,10.89,41.03,3263873,3263920
21689,54,46,0,9.48,85.47,3263919,3263973
21690,52,64,1,9.85,91.63,3263972,3264024
21691,56,34,1,9.14,66.91,3264023,3264079
21692,32,63,1,16.00,241.06,3264078,3264110
21693,35,38,1,14.63,112.18,3264109,3264144
21694,45,36,1,11.38,69.75,3264143,3264188
21695,49,64,1,10.45,129.10,3264187,3264236
21696,52,33,1,9.85,44.28,3264235,3264287
21697,53,41,1,9.66,50.11,3264286,3264339
21698,58,34,0,8.83,56.00,3264338,3264396
21699,43,47,0,11.91,113.48,3264395,3264438
21700,78,31,0,6.56,40.89,3264437,3264515
21701,78,29,0,6.56,29.76,3264515,3264593
21702,60,59,1,8.53,86.05,3264592,3264652
21703,82,32,0,6.24,49.16,3264651,3264733
21704,45,35,1,11.38,81.12,3264732,3264777
21705,66,38,0,7.76,42.34,3264776,3264842
21706,67,29,1,7.64,29.01,3264842,3264909
21707,53,34,1,9.66,62.19,3264908,3264961
21708,65,30,1,7.88,25.92,3264961,3265026
21709,66,61,1,7.76,72.55,3265026,3265092
21710,49,59,0,10.45,80.70,3265091,3265140
21711,64,30,1,8.00,33.94,3265139,3265203
21712,64,34,1,8.00,44.34,3265202,3265266
21713,44,86,1,11.64,198.73,3265265,3265309
21714,53,36,2,9.66,51.96,3265309,3265362
21715,53,59,0,9.66,80.00,3265361,3265414
21716,55,34,2,9.31,32.10,3265413,3265468
21717,51,55,1,10.04,73.41,3265467,3265518
21718,43,66,2,11.91,111.29,3265517,3265560
21719,62,30,1,8.26,36.06,3265560,3265622
21720,52,93,1,9.85,176.59,3265621,3265673
21721,42,50,0,12.19,110.63,3265672,3265714
21722,46,36,1,11.13,52.68,3265713,3265759
21723,55,63,1,9.31,94.61,3265758,3265813
21724,56,38,1,9.14,49.84,3265813,3265869
21725,59,19,0,8.68,22.73,3265868,3265927
21726,51,100,1,10.04,186.43,3265926,3265977
21727,46,44,1,11.13,97.59,3265976,3266022
21728,43,100,2,11.91,233.57,3266021,3266064
21729,41,63,1,12.49,147.08,3266063,3266104
21730,56,38,1,9.14,60.41,3266103,3266159
21731,52,45,1,9.85,69.32,3266158,3266210
21732,67,33,0,7.64,39.93,3266209,3266276
21733,53,39,0,9.66,46.87,3266275,3266328
21734,51,50,1,10.04,93.21,3266327,3266378
21735,38,110,1,13.47,357.09,3266377,3266415
21736,65,46,0,7.88,72.91,3266414,3266479
21737,45,164,0,11.38,609.04,3266478,3266523
21738,69,31,0,7.42,38.27,3266522,3266591
21739,76,24,0,6.74,30.43,3266590,3266666
21740,59,45,1,8.68,56.39,3266665,3266724
21741,67,25,0,7.64,33.99,3266724,3266791
21742,53,62,1,9.66,118.49,3266790,3266843
21743,72,32,0,7.11,32.38,3266842,3266914
21744,70,28,0,7.31,29.84,3266913,3266983
21745,69,22,0,7.42,22.91,3266982,3267051
21746,58,32,2,8.83,31.25,3267050,3267108
21747,81,30,0,6.32,33.90,3267107,3267188
21748,51,63,1,10.04,136.70,3267187,3267238
21749,65,26,0,7.88,36.60,3267237,3267302
21750,51,55,1,10.04,92.47,3267301,3267352
21751,56,52,1,9.14,73.62,3267351,3267407
21752,44,60,2,11.64,100.91,3267406,3267450
21753,56,43,1,9.14,60.16,3267449,3267505
21754,57,55,1,8.98,62.61,3267504,3267561
21755,55,33,1,9.31,47.74,3267560,3267615
21756,54,37,1,9.48,41.43,3267614,3267668
21757,46,26,2,11.13,33.33,3267667,3267713
21758,40,44,0,12.80,80.21,3267712,3267752
21759,54,36,1,9.48,36.81,3267751,3267805
21760,46,47,1,11.13,110.24,3267804,3267850
21761,41,39,2,12.49,80.35,3267849,3267890
21762,40,45,2,12.80,93.06,3267889,3267929
21763,57,30,1,8.98,41.32,3267928,3267985
21764,49,46,1,10.45,69.68,3267985,3268034
21765,32,62,3,16.00,209.56,3268033,3268065
21766,41,40,1,12.49,93.62,3268064,3268105
21767,51,35,0,10.04,50.31,3268105,3268156
21768,44,43,2,11.64,88.46,3268155,3268199
21769,43,96,0,11.91,237.81,3268198,3268241
21770,40,88,0,12.80,304.11,3268240,3268280
21771,58,54,0,8.83,86.69,3268279,3268337
21772,74,36,0,6.92,46.05,3268336,3268410
21773,50,44,0,10.24,110.46,3268409,3268459
21774,72,62,0,7.11,73.85,3268459,3268531
21775,67,57,0,7.64,67.13,3268530,3268597
21776,54,54,1,9.48,128.47,3268596,3268650
21777,54,38,1,9.48,45.58,3268650,3268704
21778,61,37,1,8.39,48.04,3268703,3268764
21779,44,39,1,11.64,79.14,3268763,3268807
21780,63,59,0,8.13,65.09,3268806,3268869
21781,59,30,1,8.68,50.42,3268868,3268927
21782,35,91,1,14.63,339.55,3268926,3268961
21783,39,152,2,13.13,534.57,3268960,3268999
21784,57,51,1,8.98,76.47,3268998,3269055
21785,63,35,0,8.13,40.75,3269055,3269118
21786,59,45,0,8.68,60.12,3269117,3269176
21787,52,26,0,9.85,39.90,3269175,3269227
21788,61,25,1,8.39,28.04,3269226,3269287
21789,53,30,1,9.66,47.77,3269286,3269339
21790,57,31,1,8.98,49.81,3269338,3269395
21791,60,31,0,8.53,35.88,3269394,3269454
21792,49,50,1,10.45,71.51,3269453,3269502
21793,47,45,2,10.89,81.84,3269502,3269549
21794,35,68,2,14.63,225.09,3269548,3269583
21795,45,40,3,11.38,53.75,3269582,3269627
21796,43,59,3,11.91,104.55,3269626,3269669
21797,46,67,1,11.13,129.59,3269668,3269714
21798,44,30,2,11.64,62.78,3269713,3269757
21799,29,81,1,17.66,247.81,3269756,3269785
21800,21,113,2,24.38,986.52,3269784,3269805
21801,39,80,1,13.13,211.80,3269804,3269843
21802,49,83,0,10.45,145.76,3269842,3269891
21803,42,45,0,12.19,88.87,3269890,3269932
21804,53,47,0,9.66,82.22,3269931,3269984
21805,47,37,1,10.89,64.35,3269984,3270031
21806,77,26,0,6.65,31.58,3270030,3270107
21807,53,128,0,9.66,336.22,3270106,3270159
21808,69,60,0,7.42,79.40,3270158,3270227
21809,54,68,0,9.48,142.55,3270226,3270280
21810,70,24,0,7.31,26.36,3270279,3270349
21811,67,30,0,7.64,32.35,3270348,3270415
21812,75,20,2,6.83,17.61,3270414,3270489
21813,52,93,2,9.85,212.48,3270489,3270541
21814,43,91,1,11.91,189.43,3270540,3270583
21815,72,37,0,7.11,38.96,3270582,3270654
21816,49,49,0,10.45,79.92,3270653,3270702
21817,55,47,0,9.31,60.69,3270701,3270756
21818,51,47,2,10.04,68.39,3270756,3270807
21819,42,59,2,12.19,156.44,3270806,3270848
21820,61,33,2,8.39,24.96,3270847,3270908
21821,36,192,1,14.22,934.17,3270907,3270943
21822,34,58,1,15.06,132.06,3270942,3270976
21823,51,41,1,10.04,78.82,3270975,3271026
21824,38,46,2,13.47,92.14,3271025,3271063
21825,36,53,2,14.22,156.90,3271062,3271098
21826,51,46,1,10.04,67.80,3271097,3271148
21827,60,52,1,8.53,59.95,3271147,3271207
21828,49,78,1,10.45,170.90,3271207,3271256
21829,46,32,1,11.13,62.68,3271255,3271301
21830,44,48,1,11.64,95.05,3271300,3271344
21831,42,43,1,12.19,92.44,3271343,3271385
21832,41,45,1,12.49,84.69,3271384,3271425
21833,39,61,0,13.13,213.45,3271424,3271463
21834,56,61,0,9.14,103.55,3271462,3271518
21835,70,35,0,7.31,43.22,3271517,3271587
21836,72,33,0,7.11,36.18,3271587,3271659
21837,76,58,0,6.74,66.09,3271659,3271735
21838,62,44,0,8.26,63.48,3271734,3271796
21839,63,50,1,8.13,48.56,3271796,3271859
21840,61,91,1,8.39,144.89,3271858,3271919
21841,63,55,1,8.13,70.05,3271918,3271981
21842,62,72,0,8.26,111.09,3271980,3272042
21843,65,30,1,7.88,30.29,3272042,3272107
21844,65,30,0,7.88,40.08,3272106,3272171
21845,35,197,2,14.63,1054.46,3272170,3272205
21846,55,28,1,9.31,36.25,3272204,3272259
21847,52,34,1,9.85,45.94,3272258,3272310
21848,44,62,4,11.64,141.60,3272309,3272353
21849,57,29,0,8.98,45.03,3272352,3272409
21850,52,48,1,9.85,71.94,3272408,3272460
21851,49,61,1,10.45,86.41,3272459,3272508
21852,48,43,1,10.67,72.01,3272507,3272555
21853,32,86,1,16.00,273.69,3272554,3272586
21854,53,35,1,9.66,44.45,3272585,3272638
21855,44,43,2,11.64,56.64,3272637,3272681
21856,47,53,1,10.89,128.90,3272680,3272727
21857,40,60,1,12.80,160.56,3272726,3272766
21858,32,65,2,16.00,207.25,3272766,3272798
21859,18,107,3,28.44,946.36,3272797,3272815
21860,35,66,1,14.63,214.86,3272814,3272849
21861,54,36,1,9.48,67.92,3272848,3272902
21862,48,43,0,10.67,85.68,3272901,3272949
21863,55,31,0,9.31,49.89,3272948,3273003
21864,72,21,0,7.11,28.60,3273002,3273074
21865,70,49,0,7.31,69.36,3273073,3273143
21866,77,35,0,6.65,45.37,3273142,3273219
21867,64,40,1,8.00,60.06,3273218,3273282
21868,56,37,0,9.14,80.91,3273282,3273338
21869,71,25,0,7.21,27.72,3273337,3273408
21870,66,32,0,7.76,39.91,3273407,3273473
21871,54,40,1,9.48,67.92,3273472,3273526
21872,53,36,1,9.66,45.36,3273525,3273578
21873,65,38,0,7.88,48.69,3273577,3273642
21874,67,57,0,7.64,63.78,3273641,3273708
21875,57,31,1,8.98,44.02,3273707,3273764
21876,56,25,1,9.14,32.05,3273763,3273819
21877,41,117,2,12.49,296.69,3273818,3273859
21878,61,69,0,8.39,86.27,3273858,3273919
21879,45,28,3,11.38,41.66,3273918,3273963
21880,43,65,2,11.91,123.90,3273962,3274005
21881,47,42,0,10.89,66.90,3274004,3274051
21882,45,41,2,11.38,76.41,3274050,3274095
21883,44,52,2,11.64,76.78,3274094,3274138
21884,50,28,1,10.24,41.50,3274137,3274187
21885,47,65,1,10.89,120.82,3274186,3274233
21886,50,87,1,10.24,173.94,3274232,3274282
21887,35,76,3,14.63,181.09,3274281,3274316
21888,23,93,1,22.26,611.50,3274315,3274338
21889,49,34,1,10.45,45.02,3274337,3274386
21890,58,35,0,8.83,55.76,3274385,3274443
21891,54,62,0,9.48,92.10,3274442,3274496
21892,37,53,1,13.84,160.14,3274495,3274532
21893,96,26,0,5.33,23.18,3274531,3274627
21894,57,50,1,8.98,90.79,3274626,3274683
21895,63,55,0,8.13,105.92,3274682,3274745
21896,59,81,0,8.68,147.40,3274744,3274803
21897,65,44,0,7.88,51.37,3274802,3274867
21898,64,46,1,8.00,42.59,3274866,3274930
21899,64,35,0,8.00,51.25,3274929,3274993
21900,57,50,0,8.98,67.91,3274992,3275049
21901,47,36,0,10.89,60.69,3275048,3275095
21902,63,39,1,8.13,46.68,3275094,3275157
21903,61,42,1,8.39,55.19,3275156,3275217
21904,46,33,0,11.13,55.90,3275216,3275262
21905,51,29,1,10.04,40.35,3275261,3275312
21906,50,48,0,10.24,78.54,3275311,3275361
21907,51,29,1,10.04,32.63,3275360,3275411
21908,39,102,1,13.13,267.09,3275410,3275449
21909,55,97,1,9.31,159.05,3275448,3275503
21910,62,22,1,8.26,27.68,3275502,3275564
21911,52,84,1,9.85,136.48,3275563,3275615
21912,58,27,1,8.83,24.97,3275614,3275672
21913,53,47,2,9.66,81.88,3275671,3275724
21914,43,76,1,11.91,138.83,3275723,3275766
21915,50,44,0,10.24,64.78,3275765,3275815
21916,55,32,1,9.31,27.78,3275814,3275869
21917,53,36,0,9.66,50.60,3275868,3275921
21918,57,32,0,8.98,38.72,3275920,3275977
21919,45,97,0,11.38,195.75,3275976,3276021
21920,43,81,1,11.91,171.99,3276020,3276063
21921,55,31,1,9.31,35.56,3276062,3276117
21922,44,101,1,11.64,267.64,3276116,3276160
21923,44,69,0,11.64,177.60,3276159,3276203
21924,38,115,0,13.47,475.93,3276202,3276240
21925,64,101,0,8.00,168.38,3276239,3276303
21926,77,63,0,6.65,63.14,3276302,3276379
21927,64,44,0,8.00,61.19,3276378,3276442
21928,73,24,0,7.01,26.78,3276441,3276514
21929,54,59,1,9.48,101.29,3276513,3276567
21930,58,49,1,8.83,50.97,3276566,3276624
21931,67,39,0,7.64,46.56,3276624,3276691
21932,73,24,1,7.01,18.45,3276690,3276763
21933,45,73,1,11.38,142.41,3276762,3276807
21934,56,41,0,9.14,56.62,3276806,3276862
21935,51,47,1,10.04,74.59,3276861,3276912
21936,64,40,1,8.00,38.53,3276911,3276975
21937,57,30,0,8.98,42.37,3276974,3277031
21938,56,41,1,9.14,53.34,3277030,3277086
21939,61,34,1,8.39,42.47,3277085,3277146
21940,52,67,1,9.85,104.36,3277145,3277197
21941,40,79,2,12.80,150.16,3277196,3277236
21942,48,65,1,10.67,97.31,3277235,3277283
21943,57,73,1,8.98,101.84,3277282,3277339
21944,56,59,1,9.14,82.87,3277338,3277394
21945,51,74,1,10.04,137.33,3277393,3277444
21946,59,37,0,8.68,40.25,3277443,3277502
21947,58,51,1,8.83,58.25,3277501,3277559
21948,33,92,2,15.52,246.31,3277558,3277591
21949,36,87,2,14.22,290.56,3277590,3277626
21950,50,31,1,10.24,49.74,3277625,3277675
21951,48,49,1,10.67,106.43,3277674,3277722
21952,53,25,1,9.66,37.88,3277721,3277774
21953,48,44,2,10.67,73.47,3277773,3277821
21954,59,60,0,8.68,78.18,3277820,3277879
21955,61,49,1,8.39,65.22,3277878,3277939
21956,54,63,1,9.48,120.14,3277938,3277992
21957,49,49,0,10.45,64.25,3277991,3278040
21958,56,43,0,9.14,75.44,3278039,3278095
21959,57,61,0,8.98,91.91,3278094,3278151
21960,61,50,0,8.39,86.73,3278150,3278211
21961,70,70,0,7.31,82.36,3278210,3278280
21962,62,40,0,8.26,58.48,3278279,3278341
21963,79,31,0,6.48,33.44,3278340,3278419
21964,70,61,0,7.31,75.96,3278418,3278488
21965,44,50,2,11.64,120.37,3278487,3278531
21966,53,62,0,9.66,129.58,3278530,3278583
21967,63,30,1,8.13,42.43,3278583,3278646
21968,73,21,1,7.01,21.55,3278645,3278718
21969,64,33,0,8.00,38.75,3278717,3278781
21970,65,62,0,7.88,82.85,3278780,3278845
21971,61,34,1,8.39,47.39,3278844,3278905
21972,49,37,0,10.45,44.94,3278904,3278953
21973,48,63,0,10.67,112.31,3278952,3279000
21974,55,32,1,9.31,42.10,3278999,3279054
21975,60,26,1,8.53,23.32,3279053,3279113
21976,59,41,1,8.68,51.91,3279112,3279171
21977,58,71,1,8.83,102.45,3279170,3279228
21978,44,50,1,11.64,130.55,3279227,3279271
21979,50,29,0,10.24,42.46,3279270,3279320
21980,55,36,2,9.31,35.38,3279319,3279374
21981,54,35,1,9.48,30.36,3279373,3279427
21982,55,27,0,9.31,29.49,3279426,3279481
21983,63,22,1,8.13,23.67,3279480,3279543
21984,55,36,0,9.31,68.21,3279542,3279597
21985,39,34,1,13.13,85.86,3279596,3279635
21986,38,55,0,13.47,145.88,3279634,3279672
21987,40,66,1,12.80,188.66,3279671,3279711
21988,39,46,1,13.13,127.34,3279710,3279749
21989,40,86,1,12.80,284.06,3279748,3279788
21990,41,70,0,12.49,233.91,3279787,3279828
21991,43,51,0,11.91,152.69,3279827,3279870
21992,68,27,0,7.53,37.16,3279869,3279937
21993,47,41,1,10.89,88.56,3279936,3279983
21994,56,40,0,9.14,78.87,3279982,3280038
21995,84,19,0,6.10,21.80,3280037,3280121
21996,81,55,0,6.32,58.09,3280120,3280201
21997,70,49,0,7.31,65.44,3280201,3280271
21998,83,27,0,6.17,31.83,3280271,3280354
21999,56,37,1,9.14,48.19,3280353,3280409
22000,64,43,1,8.00,50.06,3280408,3280472
22001,73,19,1,7.01,23.90,3280471,3280544
22002,56,62,1,9.14,116.80,3280543,3280599
22003,52,33,0,9.85,74.28,3280598,3280650
22004,65,33,0,7.88,30.11,3280649,3280714
22005,50,133,1,10.24,336.90,3280713,3280763
22006,62,34,2,8.26,31.19,3280763,3280825
22007,65,47,1,7.88,58.17,3280824,3280889
22008,39,125,2,13.13,388.73,3280888,3280927
22009,53,40,1,9.66,68.41,3280926,3280979
22010,63,39,1,8.13,36.30,3280979,3281042
22011,52,74,2,9.85,114.21,3281041,3281093
22012,44,67,0,11.64,121.41,3281092,3281136
22013,59,38,0,8.68,49.88,3281135,3281194
22014,44,59,2,11.64,93.14,3281193,3281237
22015,29,124,1,17.66,665.33,3281236,3281265
22016,58,28,1,8.83,29.21,3281264,3281322
22017,54,42,0,9.48,47.36,3281321,3281375
22018,51,38,1,10.04,64.00,3281374,3281425
22019,53,34,1,9.66,60.04,3281424,3281477
22020,63,36,1,8.13,34.17,3281476,3281539
22021,42,56,2,12.19,111.34,3281538,3281580
22022,35,86,1,14.63,275.15,3281579,3281614
22023,41,67,1,12.49,136.69,3281613,3281654
22024,63,31,0,8.13,39.00,3281653,3281716
22025,59,50,0,8.68,76.49,3281715,3281774
22026,43,129,0,11.91,398.50,3281773,3281816
22027,78,30,0,6.56,23.43,3281815,3281893
22028,80,32,0,6.40,37.09,3281892,3281972
22029,77,40,0,6.65,44.90,3281971,3282048
22030,59,46,0,8.68,92.66,3282047,3282106
22031,50,79,1,10.24,137.10,3282105,3282155
22032,69,52,1,7.42,57.35,3282154,3282223
22033,65,69,1,7.88,83.92,3282222,3282287
22034,74,36,1,6.92,34.05,3282287,3282361
22035,61,56,0,8.39,56.73,3282360,3282421
22036,54,74,1,9.48,122.62,3282420,3282474
22037,60,43,0,8.53,93.58,3282473,3282533
22038,45,98,1,11.38,330.37,3282532,3282577
22039,60,30,1,8.53,48.58,3282576,3282636
22040,45,67,1,11.38,113.70,3282635,3282680
22041,60,34,0,8.53,47.08,3282679,3282739
22042,51,52,1,10.04,67.80,3282738,3282789
22043,66,35,1,7.76,40.40,3282788,3282854
22044,58,23,0,8.83,29.21,3282853,3282911
22045,44,30,2,11.64,54.96,3282910,3282954
22046,53,34,1,9.66,45.77,3282953,3283006
22047,47,49,1,10.89,68.90,3283005,3283052
22048,55,29,1,9.31,39.01,3283051,3283106
22049,55,24,1,9.31,38.98,3283106,3283161
22050,48,44,0,10.67,93.39,3283161,3283209
22051,49,82,1,10.45,222.41,3283208,3283257
22052,33,52,1,15.52,129.64,3283256,3283289
22053,40,59,0,12.80,189.11,3283288,3283328
22054,41,118,1,12.49,400.44,3283327,3283368
22055,55,41,1,9.31,75.20,3283367,3283422
22056,48,43,0,10.67,87.97,3283421,3283469
22057,53,49,0,9.66,80.71,3283468,3283521
22058,37,91,0,13.84,297.76,3283520,3283557
22059,56,48,1,9.14,57.94,3283556,3283612
22060,99,21,0,5.17,21.66,3283611,3283710
22061,58,52,0,8.83,111.45,3283709,3283767
22062,77,62,1,6.65,65.55,3283767,3283844
22063,65,39,1,7.88,52.97,3283843,3283908
22064,61,48,0,8.39,59.42,3283907,3283968
22065,67,59,0,7.64,62.35,3283967,3284034
22066,56,36,1,9.14,56.37,3284033,3284089
22067,51,91,1,10.04,207.68,3284088,3284139
22068,56,60,1,9.14,92.02,3284138,3284194
22069,52,38,0,9.85,67.32,3284193,3284245
22070,50,47,1,10.24,109.26,3284244,3284294
22071,39,74,1,13.13,161.03,3284293,3284332
22072,48,40,2,10.67,75.51,3284331,3284379
22073,56,35,1,9.14,38.87,3284378,3284434
22074,51,44,2,10.04,74.74,3284433,3284484
22075,44,36,1,11.64,90.60,3284484,3284528
22076,52,46,1,9.85,52.71,3284527,3284579
22077,54,46,1,9.48,55.62,3284578,3284632
22078,42,47,1,12.19,73.20,3284631,3284673
22079,54,35,0,9.48,49.43,3284672,3284726
22080,52,33,2,9.85,35.86,3284726,3284778
22081,56,43,0,9.14,62.69,3284778,3284834
22082,63,29,0,8.13,32.65,3284833,3284896
22083,37,69,2,13.84,186.57,3284895,3284932
22084,26,120,3,19.69,493.75,3284931,3284957
22085,49,65,1,10.45,111.51,3284956,3285005
22086,51,38,0,10.04,70.86,3285004,3285055
22087,35,121,3,14.63,372.06,3285054,3285089
22088,53,50,1,9.66,97.24,3285088,3285141
22089,66,29,0,7.76,41.70,3285140,3285206
22090,67,117,0,7.64,212.53,3285205,3285272
22091,69,100,0,7.42,147.49,3285271,3285340
22092,51,52,1,10.04,119.45,3285339,3285390
22093,79,36,0,6.48,47.69,3285389,3285468
22094,62,63,0,8.26,121.03,3285467,3285529
22095,68,28,1,7.53,34.81,3285528,3285596
22096,60,57,1,8.53,71.92,3285596,3285656
22097,70,50,0,7.31,58.27,3285655,3285725
22098,71,36,1,7.21,30.45,3285725,3285796
22099,81,36,0,6.32,32.22,3285795,3285876
22100,81,40,0,6.32,32.66,3285875,3285956
22101,64,30,1,8.00,41.59,3285955,3286019
22102,62,27,0,8.26,34.22,3286019,3286081
22103,58,45,1,8.83,44.73,3286080,3286138
22104,45,35,2,11.38,58.95,3286138,3286183
22105,48,65,2,10.67,103.60,3286182,3286230
22106,52,44,1,9.85,77.28,3286229,3286281
22107,52,33,1,9.85,53.13,3286280,3286332
22108,50,34,1,10.24,63.98,3286331,3286381
22109,49,43,1,10.45,82.57,3286380,3286429
22110,47,66,2,10.89,95.20,3286428,3286475
22111,51,40,1,10.04,57.49,3286474,3286525
22112,36,71,2,14.22,214.23,3286524,3286560
22113,51,29,1,10.04,47.88,3286559,3286610
22114,50,98,1,10.24,180.74,3286609,3286659
22115,50,42,2,10.24,57.98,3286658,3286708
22116,52,41,1,9.85,71.17,3286707,3286759
22117,39,70,1,13.13,216.37,3286758,3286797
22118,45,55,2,11.38,97.88,3286796,3286841
22119,34,70,0,15.06,165.41,3286840,3286874
22120,44,96,1,11.64,210.64,3286874,3286918
22121,51,27,1,10.04,52.47,3286917,3286968
22122,35,59,1,14.63,211.26,3286967,3287002
22123,41,66,2,12.49,179.81,3287001,3287042
22124,46,106,0,11.13,272.90,3287041,3287087
22125,46,42,1,11.13,77.64,3287086,3287132
22126,51,50,1,10.04,113.29,3287131,3287182
22127,77,35,0,6.65,49.86,3287181,3287258
22128,66,33,0,7.76,61.49,3287257,3287323
22129,57,73,0,8.98,117.84,3287322,3287379
22130,90,32,0,5.69,30.35,3287378,3287468
22131,55,55,0,9.31,64.83,3287467,3287522
22132,54,32,1,9.48,64.69,3287521,3287575
22133,47,44,2,10.89,96.99,3287574,3287621
22134,47,47,1,10.89,102.78,3287621,3287668
22135,58,25,1,8.83,25.49,3287667,3287725
22136,65,35,1,7.88,43.68,3287725,3287790
22137,66,27,1,7.76,26.67,3287789,3287855
22138,52,70,1,9.85,132.94,3287854,3287906
22139,81,29,0,6.32,29.25,3287905,3287986
22140,64,26,1,8.00,30.16,3287985,3288049
22141,55,32,1,9.31,37.01,3288048,3288103
22142,58,35,2,8.83,30.45,3288102,3288160
22143,57,35,0,8.98,49.88,3288160,3288217
22144,34,98,1,15.06,338.11,3288216,3288250
22145,40,58,0,12.80,128.71,3288249,3288289
22146,47,76,1,10.89,164.31,3288288,3288335
22147,52,42,1,9.85,60.36,3288334,3288386
22148,33,106,0,15.52,348.31,3288386,3288419
22149,43,40,1,11.91,87.25,3288418,3288461
22150,42,77,2,12.19,190.58,3288460,3288502
22151,47,45,2,10.89,78.95,3288501,3288548
22152,40,68,1,12.80,170.16,3288547,3288587
22153,62,24,1,8.26,28.74,3288586,3288648
22154,50,47,0,10.24,89.50,3288648,3288698
22155,55,27,2,9.31,34.03,3288697,3288752
22156,52,26,0,9.85,46.75,3288751,3288803
22157,58,32,2,8.83,48.21,3288802,3288860
22158,47,62,1,10.89,114.48,3288859,3288906
22159,33,95,1,15.52,343.34,3288905,3288938
22160,38,102,1,13.47,304.41,3288937,3288975
22161,53,58,0,9.66,95.36,3288974,3289027
22162,53,31,1,9.66,37.02,3289026,3289079
22163,45,48,1,11.38,102.41,3289078,3289123
22164,43,59,1,11.91,167.71,3289122,3289165
22165,40,63,0,12.80,177.16,3289164,3289204
22166,39,137,1,13.13,463.03,3289203,3289242
22167,23,193,1,22.26,1564.19,3289241,3289264
22168,71,68,0,7.21,97.10,3289263,3289334
22169,100,17,0,5.12,15.95,3289334,3289434
22170,61,53,0,8.39,109.32,3289434,3289495
22171,65,33,0,7.88,55.31,3289494,3289559
22172,71,43,0,7.21,58.39,3289558,3289629
22173,57,65,0,8.98,88.54,3289628,3289685
22174,74,36,1,6.92,34.78,3289684,3289758
22175,62,42,0,8.26,60.26,3289757,3289819
22176,86,18,0,5.95,15.56,3289818,3289904
22177,63,18,1,8.13,23.54,3289903,3289966
22178,77,28,1,6.65,28.10,3289965,3290042
22179,57,77,1,8.98,107.46,3290041,3290098
22180,56,34,0,9.14,52.30,3290097,3290153
22181,59,54,1,8.68,64.63,3290153,3290212
22182,46,80,0,11.13,166.59,3290211,3290257
22183,37,132,1,13.84,433.81,3290256,3290293
22184,54,46,1,9.48,67.40,3290292,3290346
22185,52,57,1,9.85,90.21,3290345,3290397
22186,51,56,1,10.04,85.72,3290396,3290447
22187,36,87,2,14.22,218.28,3290446,3290482
22188,39,63,3,13.13,146.06,3290481,3290520
22189,53,60,0,9.66,96.68,3290519,3290572
22190,27,164,1,18.96,904.18,3290571,3290598
22191,47,25,2,10.89,29.67,3290597,3290644
22192,47,118,0,10.89,274.05,3290643,3290690
22193,44,41,2,11.64,75.96,3290689,3290733
22194,45,66,1,11.38,109.26,3290732,3290777
22195,57,77,1,8.98,107.95,3290776,3290833
22196,63,30,0,8.13,36.97,3290832,3290895
22197,30,150,2,17.07,682.60,3290894,3290924
22198,33,50,3,15.52,156.01,3290923,3290956
22199,41,53,0,12.49,125.08,3290955,3290996
22200,43,44,0,11.91,97.48,3290995,3291038
22201,43,78,0,11.91,178.88,3291037,3291080
22202,49,67,0,10.45,110.86,3291079,3291128
22203,45,57,1,11.38,125.04,3291127,3291172
22204,50,56,0,10.24,131.98,3291171,3291221
22205,35,255,0,14.63,1729.72,3291220,3291255
22206,59,42,0,8.68,75.30,3291254,3291313
22207,79,32,0,6.48,35.54,3291312,3291391
22208,73,46,0,7.01,72.92,3291390,3291463
22209,59,48,1,8.68,69.74,3291462,3291521
22210,76,54,0,6.74,79.72,3291520,3291596
22211,66,58,0,7.76,71.73,3291595,3291661
22212,76,18,0,6.74,19.27,3291660,3291736
22213,61,45,0,8.39,54.27,3291735,3291796
22214,60,35,1,8.53,47.92,3291795,3291855
22215,37,97,0,13.84,349.05,3291854,3291891
22216,69,80,0,7.42,93.17,3291890,3291959
22217,60,26,0,8.53,42.92,3291958,3292018
22218,57,19,0,8.98,24.02,3292017,3292074
22219,75,23,1,6.83,19.08,3292074,3292149
22220,76,34,0,6.74,37.88,3292148,3292224
22221,56,41,0,9.14,44.02,3292223,3292279
22222,35,54,2,14.63,109.83,3292278,3292313
22223,57,29,1,8.98,29.18,3292312,3292369
22224,56,52,1,9.14,74.12,3292368,3292424
22225,64,22,1,8.00,25.12,3292423,3292487
22226,42,76,2,12.19,188.11,3292486,3292528
22227,46,36,1,11.13,71.68,3292527,3292573
22228,44,64,2,11.64,121.10,3292572,3292616
22229,52,53,2,9.85,70.44,3292615,3292667
22230,47,27,2,10.89,39.63,3292667,3292714
22231,37,50,1,13.84,142.89,3292713,3292750
22232,52,36,0,9.85,63.32,3292749,3292801
22233,41,38,1,12.49,67.81,3292800,3292841
22234,53,33,1,9.66,51.85,3292840,3292893
22235,56,29,0,9.14,37.05,3292892,3292948
22236,60,37,1,8.53,43.22,3292947,3293007
22237,45,57,1,11.38,99.57,3293006,3293051
22238,21,123,1,24.38,867.57,3293050,3293071
22239,39,156,1,13.13,574.01,3293070,3293109
22240,63,38,1,8.13,51.48,3293108,3293171
22241,48,48,1,10.67,75.35,3293170,3293218
22242,62,33,0,8.26,43.58,3293217,3293279
22243,48,69,0,10.67,141.35,3293278,3293326
22244,72,28,0,7.11,39.21,3293325,3293397
22245,86,35,0,5.95,26.07,3293396,3293482
22246,73,54,0,7.01,58.92,3293481,3293554
22247,78,85,0,6.56,99.76,3293553,3293631
22248,65,63,0,7.88,81.03,3293631,3293696
22249,66,30,0,7.76,50.52,3293696,3293762
22250,67,23,0,7.64,33.04,3293761,3293828
22251,50,175,1,10.24,569.90,3293828,3293878
22252,63,29,1,8.13,31.54,3293877,3293940
22253,63,31,1,8.13,36.05,3293939,3294002
22254,69,33,0,7.42,39.43,3294001,3294070
22255,56,31,1,9.14,46.44,3294069,3294125
22256,83,30,0,6.17,20.26,3294125,3294208
22257,54,86,1,9.48,139.62,3294207,3294261
22258,45,132,1,11.38,393.57,3294260,3294305
22259,56,25,2,9.14,20.59,3294304,3294360
22260,51,43,2,10.04,66.23,3294359,3294410
22261,47,30,1,10.89,43.54,3294409,3294456
22262,36,177,0,14.22,830.51,3294455,3294491
22263,66,21,1,7.76,25.52,3294490,3294556
22264,54,26,1,9.48,30.95,3294556,3294610
22265,47,29,1,10.89,41.84,3294610,3294657
22266,46,38,1,11.13,49.50,3294656,3294702
22267,59,35,1,8.68,31.47,3294701,3294760
22268,53,30,0,9.66,36.49,3294760,3294813
22269,49,34,2,10.45,43.55,3294812,3294861
22270,42,78,1,12.19,167.58,3294860,3294902
22271,49,47,0,10.45,53.76,3294901,3294950
22272,42,100,1,12.19,231.58,3294949,3294991
22273,60,25,1,8.53,29.25,3294990,3295050
22274,54,42,1,9.48,72.21,3295049,3295103
22275,56,27,2,9.14,34.73,3295103,3295159
22276,38,28,1,13.47,75.99,3295159,3295197
22277,41,49,0,12.49,128.25,3295196,3295237
22278,51,65,1,10.04,120.90,3295236,3295287
22279,48,39,0,10.67,71.10,3295286,3295334
22280,57,28,0,8.98,42.65,3295333,3295390
22281,42,63,0,12.19,179.49,3295389,3295431
22282,43,79,1,11.91,264.41,3295430,3295473
22283,67,30,0,7.64,40.23,3295472,3295539
22284,72,40,0,7.11,57.63,3295538,3295610
22285,77,44,0,6.65,72.83,3295609,3295686
22286,53,43,0,9.66,67.36,3295685,3295738
22287,67,45,1,7.64,66.11,3295737,3295804
22288,58,81,1,8.83,130.52,3295803,3295861
22289,70,27,1,7.31,35.02,3295860,3295930
22290,63,33,1,8.13,38.62,3295929,3295992
22291,67,34,0,7.64,46.44,3295991,3296058
22292,56,38,1,9.14,60.48,3296057,3296113
22293,57,42,1,8.98,70.86,3296113,3296170
22294,30,189,3,17.07,1081.46,3296169,3296199
22295,72,30,0,7.11,34.43,3296198,3296270
22296,72,46,1,7.11,35.85,3296269,3296341
22297,53,34,0,9.66,56.34,3296340,3296393
22298,51,58,1,10.04,95.92,3296392,3296443
22299,42,104,2,12.19,260.73,3296442,3296484
22300,48,44,2,10.67,64.22,3296483,3296531
22301,35,49,4,14.63,97.49,3296530,3296565
22302,44,89,1,11.64,175.32,3296564,3296608
22303,48,74,0,10.67,146.85,3296607,3296655
22304,51,30,2,10.04,41.76,3296654,3296705
22305,46,43,1,11.13,72.07,3296704,3296750
22306,47,59,1,10.89,125.20,3296749,3296796
22307,50,45,2,10.24,63.42,3296795,3296845
22308,48,61,1,10.67,95.39,3296844,3296892
22309,55,26,0,9.31,32.25,3296891,3296946
22310,49,51,1,10.45,70.78,3296945,3296994
22311,52,40,1,9.85,52.21,3296993,3297045
22312,47,61,1,10.89,131.71,3297044,3297091
22313,44,63,1,11.64,133.37,3297090,3297134
22314,28,51,3,18.29,197.78,3297133,3297161
22315,22,195,1,23.27,1544.65,3297160,3297182
22316,28,193,1,18.29,1175.06,3297181,3297209
22317,41,75,2,12.49,161.18,3297208,3297249
22318,30,163,1,17.07,1061.33,3297248,3297278
22319,57,46,0,8.98,56.86,3297277,3297334
22320,45,91,2,11.38,183.12,3297333,3297378
22321,41,56,0,12.49,128.30,3297377,3297418
22322,43,55,0,11.91,199.85,3297417,3297460
22323,42,100,0,12.19,315.73,3297459,3297501
22324,65,55,0,7.88,76.17,3297500,3297565
22325,83,64,0,6.17,65.03,3297564,3297647
22326,64,50,0,8.00,73.25,3297646,3297710
22327,65,43,0,7.88,67.62,3297710,3297775
22328,85,78,0,6.02,85.06,3297774,3297859
22329,45,55,1,11.38,152.59,3297858,3297903
22330,64,43,0,8.00,82.22,3297902,3297966
22331,55,53,1,9.31,107.56,3297965,3298020
22332,64,53,0,8.00,58.38,3298019,3298083
22333,68,28,1,7.53,31.48,3298082,3298150
22334,61,39,1,8.39,44.21,3298150,3298211
22335,66,91,1,7.76,133.06,3298210,3298276
22336,46,47,3,11.13,91.03,3298276,3298322
22337,76,28,0,6.74,31.04,3298321,3298397
22338,63,28,2,8.13,31.51,3298396,3298459
22339,52,34,0,9.85,51.28,3298459,3298511
22340,47,30,2,10.89,48.78,3298510,3298557
22341,55,55,1,9.31,82.50,3298556,3298611
22342,49,85,0,10.45,154.61,3298610,3298659
22343,47,41,2,10.89,49.88,3298658,3298705
22344,47,40,1,10.89,53.80,3298704,3298751
22345,42,104,1,12.19,428.44,3298750,3298792
22346,52,64,1,9.85,87.94,3298791,3298843
22347,52,30,1,9.85,43.28,3298842,3298894
22348,44,35,1,11.64,56.19,3298893,3298937
22349,51,42,1,10.04,67.88,3298936,3298987
22350,48,30,1,10.67,52.47,3298986,3299034
22351,39,85,1,13.13,212.21,3299033,3299072
22352,54,44,0,9.48,55.73,3299071,3299125
22353,52,26,1,9.85,36.05,3299124,3299176
22354,52,29,1,9.85,39.09,3299176,3299228
22355,53,38,1,9.66,40.56,3299227,3299280
22356,53,41,1,9.66,70.07,3299279,3299332
22357,54,31,1,9.48,41.84,3299331,3299385
22358,44,92,0,11.64,198.60,3299384,3299428
22359,44,46,1,11.64,89.91,3299428,3299472
22360,29,200,1,17.66,1263.95,3299471,3299500
22361,56,76,0,9.14,143.02,3299499,3299555
22362,41,79,0,12.49,236.64,3299554,3299595
22363,38,129,1,13.47,457.09,3299594,3299632
22364,77,29,0,6.65,45.11,3299631,3299708
22365,60,33,0,8.53,50.32,3299708,3299768
22366,67,42,0,7.64,77.33,3299767,3299834
22367,63,49,0,8.13,55.13,3299833,3299896
22368,71,58,0,7.21,79.18,3299895,3299966
22369,44,86,1,11.64,213.14,3299966,3300010
22370,76,26,0,6.74,22.80,3300009,3300085
22371,65,31,1,7.88,32.14,3300084,3300149
22372,60,40,2,8.53,49.28,3300148,3300208
22373,70,27,0,7.31,21.50,3300207,3300277
22374,56,46,1,9.14,50.55,3300276,3300332
22375,65,54,1,7.88,58.75,3300331,3300396
22376,62,39,1,8.26,55.32,3300396,3300458
22377,63,28,0,8.13,32.11,3300457,3300520
22378,53,48,0,9.66,65.66,3300519,3300572
22379,54,32,1,9.48,54.21,3300571,3300625
22380,47,38,1,10.89,83.80,3300624,3300671
22381,52,52,1,9.85,62.17,3300670,3300722
22382,55,39,0,9.31,50.87,3300721,3300776
22383,48,27,1,10.67,41.64,3300775,3300823
22384,38,38,2,13.47,105.67,3300822,3300860
22385,58,53,1,8.83,62.35,3300859,3300917
22386,59,26,1,8.68,34.01,3300916,3300975
22387,51,36,3,10.04,51.72,3300974,3301025
22388,49,53,1,10.45,79.15,3301024,3301073
22389,45,75,1,11.38,124.19,3301072,3301117
22390,33,54,2,15.52,172.86,3301116,3301149
22391,55,35,1,9.31,32.72,3301148,3301203
22392,53,29,2,9.66,34.49,3301202,3301255
22393,61,22,1,8.39,23.03,3301254,3301315
22394,61,35,1,8.39,45.68,3301314,3301375
22395,61,33,1,8.39,40.14,3301374,3301435
22396,49,40,1,10.45,63.10,3301434,3301483
22397,42,93,1,12.19,227.34,3301482,3301524
22398,50,65,1,10.24,116.06,3301523,3301573
22399,48,58,1,10.67,106.39,3301572,3301620
22400,40,140,1,12.80,455.41,3301619,3301659
22401,42,187,0,12.19,772.49,3301658,3301700
22402,45,48,1,11.38,109.75,3301699,3301744
22403,55,55,1,9.31,135.23,3301743,3301798
22404,73,46,0,7.01,60.84,3301797,3301870
22405,58,54,0,8.83,84.25,3301869,3301927
22406,100,37,0,5.12,33.15,3301926,3302026
22407,78,53,0,6.56,67.25,3302025,3302103
22408,49,49,1,10.45,87.88,3302102,3302151
22409,60,58,0,8.53,84.68,3302150,3302210
22410,69,32,0,7.42,33.32,3302209,3302278
22411,69,56,1,7.42,57.95,3302277,3302346
22412,59,54,1,8.68,94.90,3302345,3302404
22413,67,39,1,7.64,36.23,3302403,3302470
22414,71,72,1,7.21,90.34,3302469,3302540
22415,45,61,2,11.38,91.08,3302539,3302584
22416,69,42,0,7.42,47.49,3302584,3302653
22417,36,198,1,14.22,1127.40,3302652,3302688
22418,61,45,1,8.39,62.57,3302688,3302749
22419,47,52,0,10.89,90.31,3302748,3302795
22420,50,43,2,10.24,50.30,3302794,3302844
22421,48,47,0,10.67,63.93,3302843,3302891
22422,47,39,1,10.89,62.69,3302890,3302937
22423,55,25,0,9.31,32.65,3302936,3302991
22424,47,53,1,10.89,122.78,3302991,3303038
22425,60,26,0,8.53,20.05,3303038,3303098
22426,49,50,2,10.45,79.80,3303097,3303146
22427,44,47,1,11.64,92.82,3303145,3303189
22428,49,35,1,10.45,61.76,3303188,3303237
22429,43,63,2,11.91,117.57,3303236,3303279
22430,61,23,1,8.39,28.89,3303278,3303339
22431,50,30,1,10.24,48.78,3303338,3303388
22432,60,28,1,8.53,34.48,3303387,3303447
22433,59,37,0,8.68,54.96,3303446,3303505
22434,38,89,2,13.47,321.67,3303504,3303542
22435,30,67,3,17.07,217.26,3303541,3303571
22436,44,42,2,11.64,83.46,3303570,3303614
22437,37,48,2,13.84,97.49,3303613,3303650
22438,41,120,1,12.49,322.10,3303650,3303691
22439,44,55,1,11.64,94.60,3303691,3303735
22440,43,53,1,11.91,105.48,3303734,3303777
22441,42,67,0,12.19,151.63,3303776,3303818
22442,58,48,0,8.83,81.69,3303817,3303875
22443,53,44,0,9.66,102.38,3303874,3303927
22444,86,27,0,5.95,30.02,3303926,3304012
22445,84,29,0,6.10,36.94,3304011,3304095
22446,68,31,0,7.53,40.13,3304094,3304162
22447,65,49,0,7.88,92.20,3304161,3304226
22448,54,48,1,9.48,68.81,3304225,3304279
22449,68,29,0,7.53,37.48,3304278,3304346
22450,69,32,1,7.42,30.13,3304346,3304415
22451,78,26,0,6.56,23.94,3304414,3304492
22452,58,56,1,8.83,76.32,3304491,3304549
22453,63,41,1,8.13,41.03,3304548,3304611
22454,73,39,1,7.01,57.08,3304610,3304683
22455,43,61,1,11.91,206.55,3304682,3304725
22456,70,38,1,7.31,41.36,3304724,3304794
22457,63,39,1,8.13,47.16,3304793,3304856
22458,37,123,2,13.84,470.24,3304855,3304892
22459,54,89,0,9.48,148.92,3304891,3304945
22460,47,29,2,10.89,41.03,3304944,3304991
22461,45,82,2,11.38,158.24,3304991,3305036
22462,52,45,1,9.85,53.17,3305035,3305087
22463,42,55,0,12.19,118.39,3305086,3305128
22464,57,31,1,8.98,38.23,3305127,3305184
22465,50,38,1,10.24,51.14,3305183,3305233
22466,51,38,1,10.04,58.94,3305232,3305283
22467,47,57,1,10.89,133.63,3305282,3305329
22468,56,48,1,9.14,50.73,3305328,3305384
22469,42,38,1,12.19,95.01,3305383,3305425
22470,40,55,1,12.80,88.66,3305424,3305464
22471,41,51,2,12.49,112.15,3305463,3305504
22472,57,44,1,8.98,52.65,3305504,3305561
22473,54,52,2,9.48,69.84,3305560,3305614
22474,51,47,0,10.04,62.63,3305613,3305664
22475,22,64,3,23.27,338.20,3305663,3305685
22476,30,66,1,17.07,221.26,3305684,3305714
22477,40,49,1,12.80,125.91,3305713,3305753
22478,60,28,0,8.53,39.15,3305752,3305812
22479,50,64,1,10.24,139.18,3305811,3305861
22480,44,49,1,11.64,96.05,3305861,3305905
22481,35,164,1,14.63,748.69,3305905,3305940
22482,45,67,0,11.38,142.99,3305939,3305984
22483,57,53,0,8.98,86.51,3305983,3306040
22484,81,24,0,6.32,33.65,3306039,3306120
22485,79,41,0,6.48,52.48,3306119,3306198
22486,60,56,0,8.53,107.68,3306198,3306258
22487,90,39,0,5.69,41.33,3306258,3306348
22488,59,31,1,8.68,39.24,3306347,3306406
22489,90,19,0,5.69,16.66,3306405,3306495
22490,66,55,1,7.76,65.37,3306494,3306560
22491,67,33,1,7.64,37.45,3306559,3306626
22492,71,22,1,7.21,21.49,3306625,3306696
22493,57,49,1,8.98,76.51,3306695,3306752
22494,61,24,1,8.39,35.68,3306751,3306812
22495,64,48,1,8.00,67.38,3306811,3306875
22496,62,46,0,8.26,50.42,3306875,3306937
22497,53,35,1,9.66,53.36,3306936,3306989
22498,51,40,1,10.04,77.92,3306989,3307040
22499,56,25,1,9.14,24.44,3307040,3307096
22500,60,33,1,8.53,40.22,3307095,3307155
22501,35,109,2,14.63,344.35,3307154,3307189
22502,48,33,2,10.67,49.56,3307188,3307236
22503,48,54,1,10.67,84.89,3307235,3307283
22504,46,48,2,11.13,90.46,3307282,3307328
22505,44,40,1,11.64,72.82,3307327,3307371
22506,54,36,1,9.48,39.77,3307370,3307424
22507,45,75,1,11.38,243.30,3307423,3307468
22508,43,42,2,11.91,75.53,3307467,3307510
22509,59,29,1,8.68,35.54,3307509,3307568
22510,48,32,1,10.67,48.51,3307567,3307615
22511,41,46,1,12.49,91.08,3307614,3307655
22512,48,55,3,10.67,101.97,3307654,3307702
22513,46,29,2,11.13,47.81,3307701,3307747
22514,51,55,0,10.04,70.90,3307746,3307797
22515,49,65,1,10.45,106.94,3307796,3307845
22516,45,51,0,11.38,108.37,3307845,3307890
22517,54,31,2,9.48,42.18,3307889,3307943
22518,47,48,0,10.89,103.46,3307942,3307989
22519,55,46,2,9.31,67.60,3307988,3308043
22520,46,59,1,11.13,100.85,3308042,3308088
22521,40,80,2,12.80,226.21,3308088,3308128
22522,36,91,1,14.22,239.56,3308127,3308163
22523,39,51,1,13.13,152.37,3308162,3308201
22524,49,76,0,10.45,128.70,3308200,3308249
22525,84,36,0,6.10,41.11,3308248,3308332
22526,55,33,0,9.31,68.00,3308331,3308386
22527,78,53,0,6.56,72.48,3308385,3308463
22528,56,103,0,9.14,213.16,3308462,3308518
22529,63,41,0,8.13,62.78,3308517,3308580
22530,51,58,1,10.04,115.14,3308579,3308630
22531,51,65,0,10.04,97.65,3308629,3308680
22532,65,46,1,7.88,52.75,3308679,3308744
22533,64,45,0,8.00,51.28,3308743,3308807
22534,32,210,1,16.00,1278.62,3308806,3308838
22535,59,67,1,8.68,104.63,3308837,3308896
22536,51,52,1,10.04,91.84,3308895,3308946
22537,68,43,1,7.53,46.13,3308945,3309013
22538,45,81,1,11.38,207.48,3309012,3309057
22539,44,36,1,11.64,57.96,3309056,3309100
22540,69,26,0,7.42,30.71,3309099,3309168
22541,60,33,1,8.53,40.55,3309167,3309227
22542,61,27,0,8.39,38.44,3309226,3309287
22543,47,39,1,10.89,62.14,3309286,3309333
22544,45,40,1,11.38,73.75,3309332,3309377
22545,51,25,1,10.04,36.86,3309376,3309427
22546,50,39,1,10.24,81.58,3309426,3309476
22547,42,78,1,12.19,174.15,3309475,3309517
22548,49,58,1,10.45,112.74,3309516,3309565
22549,27,165,0,18.96,1035.89,3309564,3309591
22550,35,63,2,14.63,196.06,3309590,3309625
22551,38,70,2,13.47,168.78,3309625,3309663
22552,50,47,1,10.24,83.02,3309662,3309712
22553,40,48,1,12.80,110.26,3309711,3309751
22554,44,44,3,11.64,69.82,3309750,3309794
22555,46,48,2,11.13,103.24,3309793,3309839
22556,56,31,2,9.14,35.91,3309838,3309894
22557,49,43,1,10.45,76.98,3309893,3309942
22558,35,82,1,14.63,190.69,3309941,3309976
22559,54,62,1,9.48,79.29,3309975,3310029
22560,29,73,3,17.66,287.61,3310028,3310057
22561,29,67,1,17.66,327.40,3310056,3310085
22562,27,102,1,18.96,438.04,3310084,3310111
22563,18,123,3,28.44,753.58,3310110,3310128
22564,42,121,0,12.19,358.92,3310127,3310169
22565,38,34,0,13.47,83.14,3310168,3310206
22566,30,154,1,17.07,823.06,3310205,3310235
22567,35,67,4,14.63,148.35,3310234,3310269
22568,38,110,1,13.47,322.72,3310269,3310307
22569,54,48,0,9.48,110.25,3310306,3310360
22570,71,63,1,7.21,75.66,3310359,3310430
22571,95,22,0,5.39,25.33,3310429,3310524
22572,60,136,0,8.53,315.38,3310523,3310583
22573,68,45,0,7.53,87.04,3310582,3310650
22574,86,44,0,5.95,43.32,3310650,3310736
22575,46,96,1,11.13,245.50,3310735,3310781
22576,76,47,0,6.74,61.77,3310780,3310856
22577,52,58,0,9.85,84.82,3310855,3310907
22578,61,30,2,8.39,35.35,3310906,3310967
22579,61,41,1,8.39,42.99,3310966,3311027
22580,63,29,1,8.13,43.54,3311027,3311090
22581,70,31,0,7.31,29.44,3311089,3311159
22582,60,62,0,8.53,93.05,3311158,3311218
22583,44,74,1,11.64,231.87,3311217,3311261
22584,68,27,0,7.53,36.37,3311260,3311328
22585,69,44,0,7.42,52.13,3311327,3311396
22586,54,70,1,9.48,127.18,3311395,3311449
22587,55,131,1,9.31,298.36,3311449,3311504
22588,62,19,0,8.26,20.55,3311503,3311565
22589,47,39,1,10.89,66.27,3311564,3311611
22590,58,24,1,8.83,25.04,3311610,3311668
22591,56,77,0,9.14,114.23,3311667,3311723
22592,50,44,2,10.24,46.62,3311722,3311772
22593,54,58,1,9.48,73.32,3311771,3311825
22594,50,45,0,10.24,69.94,3311824,3311874
22595,37,76,2,13.84,167.38,3311873,3311910
22596,45,57,2,11.38,94.24,3311909,3311954
22597,41,67,1,12.49,108.79,3311953,3311994
22598,54,60,1,9.48,94.40,3311993,3312047
22599,55,32,1,9.31,35.63,3312046,3312101
22600,50,39,1,10.24,59.26,3312101,3312151
22601,43,40,2,11.91,86.18,3312151,3312194
22602,57,47,1,8.98,50.23,3312193,3312250
22603,51,43,2,10.04,58.63,3312249,3312300
22604,49,32,1,10.45,57.19,3312299,3312348
22605,59,34,1,8.68,44.01,3312347,3312406
22606,39,71,1,13.13,259.70,3312405,3312444
22607,38,105,0,13.47,313.46,3312443,3312481
22608,34,100,2,15.06,271.17,3312480,3312514
22609,83,22,0,6.17,32.41,3312513,3312596
22610,80,41,0,6.40,47.44,3312595,3312675
22611,61,44,1,8.39,50.14,3312674,3312735
22612,69,32,0,7.42,56.30,3312734,3312803
22613,74,32,0,6.92,49.83,3312802,3312876
22614,82,32,0,6.24,38.96,3312875,3312957
22615,66,55,0,7.76,82.61,3312956,3313022
22616,64,47,1,8.00,46.44,3313021,3313085
22617,69,29,1,7.42,25.32,3313084,3313153
22618,52,56,1,9.85,114.90,3313152,3313204
22619,74,25,1,6.92,21.24,3313203,3313277
22620,73,38,0,7.01,37.49,3313276,3313349
22621,61,29,1,8.39,39.09,3313348,3313409
22622,65,52,1,7.88,72.42,3313408,3313473
22623,68,26,1,7.53,25.87,3313472,3313540
22624,52,38,1,9.85,74.01,3313539,3313591
22625,40,52,3,12.80,104.26,3313590,3313630
22626,59,23,0,8.68,27.10,3313630,3313689
22627,61,25,1,8.39,28.44,3313688,3313749
22628,35,113,1,14.63,334.80,3313748,3313783
22629,55,27,1,9.31,40.14,3313782,3313837
22630,51,40,1,10.04,50.74,3313836,3313887
22631,65,26,1,7.88,30.45,3313886,3313951
22632,46,37,1,11.13,63.85,3313950,3313996
22633,49,52,1,10.45,80.66,3313995,3314044
22634,41,62,2,12.49,111.27,3314043,3314084
22635,47,42,1,10.89,63.97,3314083,3314130
22636,55,28,1,9.31,38.36,3314129,3314184
22637,43,43,1,11.91,82.46,3314183,3314226
22638,56,46,0,9.14,54.09,3314225,3314281
22639,61,60,1,8.39,91.22,3314280,3314341
22640,52,58,2,9.85,90.25,3314340,3314392
22641,22,68,1,23.27,387.38,3314391,3314413
22642,23,78,3,22.26,390.37,3314412,3314435
22643,41,50,1,12.49,124.44,3314434,3314475
22644,34,64,1,15.06,203.76,3314474,3314508
22645,47,64,1,10.89,96.01,3314507,3314554
22646,39,56,0,13.13,128.52,3314553,3314592
22647,34,66,1,15.06,219.64,3314591,3314625
22648,37,70,0,13.84,151.97,3314624,3314661
22649,51,30,1,10.04,51.10,3314660,3314711
22650,53,39,1,9.66,62.87,3314711,3314764
22651,76,50,0,6.74,65.22,3314763,3314839
22652,72,47,0,7.11,65.38,3314838,3314910
22653,80,35,0,6.40,53.87,3314909,3314989
22654,85,71,0,6.02,73.79,3314988,3315073
22655,68,60,0,7.53,68.54,3315072,3315140
22656,69,38,0,7.42,53.14,3315140,3315209
22657,61,19,1,8.39,19.48,3315208,3315269
22658,70,25,1,7.31,19.67,3315268,3315338
22659,58,78,0,8.83,109.76,3315337,3315395
22660,75,21,0,6.83,18.44,3315394,3315469
22661,62,49,0,8.26,59.03,3315468,3315530
22662,65,27,0,7.88,34.45,3315529,3315594
22663,61,31,1,8.39,27.78,3315594,3315655
22664,69,37,1,7.42,27.32,3315654,3315723
22665,56,54,1,9.14,82.23,3315722,3315778
22666,50,36,2,10.24,57.82,3315777,3315827
22667,66,21,0,7.76,21.30,3315826,3315892
22668,51,35,1,10.04,62.86,3315891,3315942
22669,46,29,2,11.13,38.11,3315941,3315987
22670,48,54,1,10.67,95.81,3315986,3316034
22671,47,61,2,10.89,133.88,3316033,3316080
22672,49,110,1,10.45,240.45,3316079,3316128
22673,45,141,0,11.38,425.44,3316127,3316172
22674,35,61,3,14.63,173.78,3316172,3316207
22675,57,27,0,8.98,34.54,3316206,3316263
22676,54,31,0,9.48,38.36,3316262,3316316
22677,41,86,1,12.49,235.13,3316315,3316356
22678,53,30,1,9.66,34.07,3316355,3316408
22679,49,30,1,10.45,46.82,3316407,3316456
22680,44,36,2,11.64,87.78,3316455,3316499
22681,51,60,1,10.04,91.06,3316498,3316549
22682,55,48,1,9.31,78.87,3316548,3316603
22683,50,48,1,10.24,73.50,3316602,3316652
22684,37,65,2,13.84,157.22,3316651,3316688
22685,34,139,1,15.06,523.06,3316687,3316721
22686,44,50,1,11.64,98.60,3316720,3316764
22687,43,64,1,11.91,135.20,3316764,3316807
22688,34,56,2,15.06,252.29,3316806,3316840
22689,40,72,0,12.80,167.56,3316839,3316879
22690,51,60,0,10.04,104.35,3316878,3316929
22691,41,55,0,12.49,229.52,3316928,3316969
22692,46,41,1,11.13,74.03,3316968,3317014
22693,56,37,1,9.14,54.98,3317014,3317070
22694,87,69,0,5.89,68.40,3317070,3317157
22695,73,54,0,7.01,68.15,3317157,3317230
22696,48,94,0,10.67,215.72,3317229,3317277
22697,67,35,0,7.64,48.92,3317276,3317343
22698,74,37,1,6.92,41.91,3317342,3317416
22699,69,37,0,7.42,36.33,3317416,3317485
22700,67,26,1,7.64,29.69,3317484,3317551
22701,72,26,0,7.11,23.43,3317551,3317623
22702,75,33,1,6.83,32.57,3317622,3317697
22703,59,37,1,8.68,49.10,3317696,3317755
22704,66,38,0,7.76,37.82,3317754,3317820
22705,49,115,2,10.45,268.33,3317819,3317868
22706,71,20,0,7.21,21.07,3317867,3317938
22707,60,48,1,8.53,64.88,3317937,3317997
22708,52,35,0,9.85,48.28,3317996,3318048
22709,63,31,0,8.13,38.11,3318047,3318110
22710,62,29,1,8.26,26.35,3318109,3318171
22711,45,44,2,11.38,72.19,3318170,3318215
22712,51,44,3,10.04,58.59,3318214,3318265
22713,54,32,1,9.48,32.77,3318264,3318318
22714,48,35,2,10.67,61.64,3318317,3318365
22715,65,44,0,7.88,47.25,3318364,3318429
22716,42,106,2,12.19,247.20,3318428,3318470
22717,50,39,2,10.24,53.66,3318469,3318519
22718,45,49,1,11.38,108.19,3318518,3318563
22719,42,62,2,12.19,101.87,3318562,3318604
22720,49,39,1,10.45,59.02,3318603,3318652
22721,57,37,1,8.98,39.63,3318651,3318708
22722,55,34,1,9.31,40.32,3318707,3318762
22723,53,50,1,9.66,84.87,3318761,3318814
22724,48,144,1,10.67,443.56,3318813,3318861
22725,29,76,0,17.66,272.36,3318860,3318889
22726,30,79,1,17.07,306.80,3318888,3318918
22727,48,37,3,10.67,49.76,3318917,3318965
22728,60,41,0,8.53,55.68,3318964,3319024
22729,34,97,1,15.06,311.58,3319023,3319057
22730,35,64,0,14.63,230.06,3319056,3319091
22731,27,161,1,18.96,870.92,3319090,3319117
22732,47,120,0,10.89,325.84,3319117,3319164
22733,36,70,1,14.22,284.28,3319163,3319199
22734,57,31,1,8.98,48.33,3319198,3319255
22735,58,33,0,8.83,73.97,3319254,3319312
22736,68,53,0,7.53,81.93,3319311,3319379
22737,47,59,0,10.89,149.92,3319378,3319425
22738,89,29,0,5.75,27.22,3319424,3319513
22739,60,51,1,8.53,83.58,3319512,3319572
22740,54,45,1,9.48,90.40,3319571,3319625
22741,64,27,1,8.00,37.84,3319624,3319688
22742,43,103,1,11.91,274.04,3319688,3319731
22743,36,141,2,14.22,555.40,3319730,3319766
22744,58,44,1,8.83,57.69,3319765,3319823
22745,58,38,1,8.83,48.66,3319822,3319880
22746,52,27,1,9.85,42.17,3319879,3319931
22747,57,32,1,8.98,55.56,3319930,3319987
22748,65,28,1,7.88,32.42,3319986,3320051
22749,52,33,0,9.85,54.90,3320050,3320102
22750,54,32,1,9.48,39.36,3320101,3320155
22751,47,33,1,10.89,55.12,3320154,3320201
22752,44,26,3,11.64,42.73,3320201,3320245
22753,47,35,2,10.89,53.67,3320244,3320291
22754,50,48,2,10.24,62.86,3320290,3320340
22755,46,36,2,11.13,37.98,3320339,3320385
22756,42,44,2,12.19,105.34,3320384,3320426
22757,53,44,1,9.66,61.17,3320426,3320479
22758,47,44,1,10.89,86.27,3320478,3320525
22759,53,48,0,9.66,72.56,3320525,3320578
22760,37,67,1,13.84,236.08,3320577,3320614
22761,49,44,1,10.45,85.55,3320613,3320662
22762,49,31,1,10.45,41.88,3320661,3320710
22763,56,32,2,9.14,36.52,3320709,3320765
22764,51,35,3,10.04,47.96,3320764,3320815
22765,51,36,1,10.04,38.63,3320814,3320865
22766,42,47,1,12.19,92.54,3320864,3320906
22767,45,112,1,11.38,258.99,3320905,3320950
22768,45,36,2,11.38,79.97,3320949,3320994
22769,44,49,1,11.64,79.64,3320993,3321037
22770,51,42,1,10.04,47.10,3321036,3321087
22771,26,128,2,19.69,599.75,3321086,3321112
22772,47,36,1,10.89,60.99,3321112,3321159
22773,43,74,1,11.91,139.20,3321158,3321201
22774,55,33,1,9.31,70.10,3321200,3321255
22775,60,41,0,8.53,61.22,3321254,3321314
22776,50,38,0,10.24,94.06,3321313,3321363
22777,55,62,0,9.31,155.81,3321362,3321417
22778,96,33,0,5.33,36.53,3321416,3321512
22779,64,77,0,8.00,120.56,3321511,3321575
22780,29,128,1,17.66,697.12,3321574,3321603
22781,48,48,0,10.67,122.26,3321602,3321650
22782,60,53,0,8.53,100.12,3321649,3321709
22783,50,45,1,10.24,87.82,3321708,3321758
22784,62,67,0,8.26,95.13,3321758,3321820
22785,65,38,1,7.88,43.62,3321819,3321884
22786,50,122,1,10.24,327.98,3321883,3321933
22787,54,25,1,9.48,31.18,3321932,3321986
22788,71,53,0,7.21,56.25,3321985,3322056
22789,67,27,0,7.64,33.54,3322055,3322122
22790,50,74,0,10.24,156.66,3322121,3322171
22791,45,73,0,11.38,158.86,3322170,3322215
22792,65,62,1,7.88,72.17,3322214,3322279
22793,68,70,1,7.53,93.34,3322279,3322347
22794,54,61,1,9.48,101.29,3322346,3322400
22795,49,51,2,10.45,73.06,3322399,3322448
22796,51,30,1,10.04,47.53,3322447,3322498
22797,48,88,0,10.67,211.68,3322497,3322545
22798,40,106,1,12.80,308.36,3322544,3322584
22799,48,46,2,10.67,74.14,3322583,3322631
22800,44,77,1,11.64,173.60,3322630,3322674
22801,56,30,0,9.14,31.02,3322673,3322729
22802,35,176,2,14.63,805.55,3322728,3322763
22803,51,42,2,10.04,58.27,3322763,3322814
22804,39,62,2,13.13,133.65,3322813,3322852
22805,39,89,2,13.13,220.62,3322852,3322891
22806,42,31,2,12.19,60.11,3322890,3322932
22807,52,37,0,9.85,75.75,3322931,3322983
22808,46,76,0,11.13,132.90,3322982,3323028
22809,57,39,0,8.98,44.37,3323027,3323084
22810,57,27,1,8.98,43.46,3323083,3323140
22811,43,59,0,11.91,121.39,3323139,3323182
22812,28,64,3,18.29,210.13,3323181,3323209
22813,33,76,1,15.52,254.73,3323208,3323241
22814,28,76,2,18.29,386.28,3323240,3323268
22815,42,60,1,12.19,121.68,3323267,3323309
22816,56,65,0,9.14,87.73,3323308,3323364
22817,33,66,2,15.52,194.80,3323363,3323396
22818,26,107,2,19.69,567.60,3323396,3323422
22819,49,55,0,10.45,92.82,3323421,3323470
22820,36,123,0,14.22,506.23,3323469,3323505
22821,30,90,0,17.07,328.46,3323504,3323534
22822,67,48,0,7.64,55.48,3323533,3323600
22823,72,41,0,7.11,55.52,3323599,3323671
22824,56,108,0,9.14,247.34,3323670,3323726
22825,67,32,0,7.64,50.05,3323725,3323792
22826,78,31,0,6.56,45.68,3323791,3323869
22827,54,60,1,9.48,86.99,3323869,3323923
22828,56,32,1,9.14,54.84,3323923,3323979
22829,54,57,0,9.48,103.69,3323978,3324032
22830,57,29,0,8.98,46.82,3324032,3324089
22831,46,73,2,11.13,170.98,3324088,3324134
22832,65,27,1,7.88,36.75,3324133,3324198
22833,69,35,1,7.42,52.19,3324197,3324266
22834,65,40,0,7.88,50.38,3324266,3324331
22835,58,47,0,8.83,56.56,3324330,3324388
22836,74,28,1,6.92,27.62,3324387,3324461
22837,66,32,1,7.76,36.15,3324460,3324526
22838,58,34,0,8.83,51.18,3324526,3324584
22839,57,32,2,8.98,39.10,3324583,3324640
22840,46,82,2,11.13,164.59,3324640,3324686
22841,40,49,1,12.80,131.16,3324685,3324725
22842,55,34,2,9.31,34.40,3324724,3324779
22843,57,45,2,8.98,53.74,3324778,3324835
22844,49,47,1,10.45,65.96,3324834,3324883
22845,41,71,2,12.49,184.69,3324882,3324923
22846,42,38,0,12.19,96.58,3324922,3324964
22847,36,67,1,14.22,230.40,3324963,3324999
22848,51,50,2,10.04,86.63,3324998,3325049
22849,37,57,3,13.84,125.38,3325048,3325085
22850,53,62,1,9.66,78.83,3325084,3325137
22851,53,70,2,9.66,108.11,3325136,3325189
22852,32,57,1,16.00,189.50,3325188,3325220
22853,53,29,1,9.66,41.02,3325219,3325272
22854,43,36,4,11.91,53.90,3325271,3325314
22855,54,43,0,9.48,77.47,3325313,3325367
22856,42,72,2,12.19,177.49,3325367,3325409
22857,13,183,4,39.38,2101.62,3325408,3325421
22858,40,74,0,12.80,212.51,3325420,3325460
22859,46,42,0,11.13,90.72,3325459,3325505
22860,40,103,1,12.80,274.41,3325504,3325544
22861,34,63,0,15.06,241.53,3325543,3325577
22862,36,90,1,14.22,303.90,3325577,3325613
22863,50,67,0,10.24,123.86,3325612,3325662
22864,21,207,1,24.38,1855.38,3325661,3325682
22865,39,105,0,13.13,291.24,3325681,3325720
22866,75,71,0,6.83,91.18,3325719,3325794
22867,74,44,0,6.92,46.91,3325793,3325867
22868,73,35,0,7.01,58.78,3325866,3325939
22869,48,98,0,10.67,359.22,3325939,3325987
22870,67,49,0,7.64,65.93,3325986,3326053
22871,54,61,1,9.48,112.03,3326052,3326106
22872,57,35,0,8.98,66.47,3326106,3326163
22873,61,58,0,8.39,95.16,3326162,3326223
22874,50,44,1,10.24,63.50,3326223,3326273
22875,64,42,1,8.00,54.19,3326272,3326336
22876,57,52,1,8.98,78.54,3326336,3326393
22877,55,69,0,9.31,115.09,3326392,3326447
22878,55,73,1,9.31,101.52,3326447,3326502
22879,25,84,1,20.48,301.61,3326501,3326526
22880,59,42,1,8.68,67.68,3326525,3326584
22881,55,61,1,9.31,88.47,3326583,3326638
22882,49,112,1,10.45,260.90,3326637,3326686
22883,44,47,2,11.64,96.91,3326685,3326729
22884,46,42,0,11.13,69.72,3326728,3326774
22885,43,67,1,11.91,125.39,3326773,3326816
22886,46,82,1,11.13,169.42,3326815,3326861
22887,49,36,2,10.45,59.15,3326860,3326909
22888,55,50,0,9.31,78.36,3326908,3326963
22889,57,42,1,8.98,59.28,3326962,3327019
22890,57,34,2,8.98,38.82,3327018,3327075
22891,44,52,0,11.64,106.82,3327074,3327118
22892,51,42,2,10.04,52.00,3327117,3327168
22893,59,42,1,8.68,39.30,3327167,3327226
22894,44,62,0,11.64,106.23,3327226,3327270
22895,54,41,1,9.48,47.66,3327270,3327324
22896,37,63,4,13.84,128.73,3327323,3327360
22897,57,29,1,8.98,43.88,3327359,3327416
22898,50,77,2,10.24,126.98,3327415,3327465
22899,62,34,2,8.26,40.16,3327464,3327526
22900,43,105,1,11.91,282.46,3327525,3327568
22901,28,62,2,18.29,227.56,3327567,3327595
22902,30,125,1,17.07,515.53,3327594,3327624
22903,28,54,1,18.29,210.99,3327623,3327651
22904,35,78,1,14.63,256.86,3327650,3327685
22905,49,56,1,10.45,128.41,3327684,3327733
22906,38,134,1,13.47,474.72,3327732,3327770
22907,42,60,0,12.19,119.54,3327769,3327811
22908,47,67,0,10.89,183.16,3327810,3327857
22909,24,236,0,21.33,2143.97,3327856,3327880
22910,40,97,0,12.80,247.66,3327879,3327919
22911,72,30,0,7.11,61.13,3327918,3327990
22912,57,74,0,8.98,129.98,3327989,3328046
22913,69,38,0,7.42,72.97,3328045,3328114
22914,73,30,0,7.01,33.74,3328113,3328186
22915,71,45,0,7.21,61.97,3328185,3328256
22916,54,39,1,9.48,75.36,3328255,3328309
22917,77,34,0,6.65,31.21,3328309,3328386
22918,68,34,1,7.53,35.37,3328386,3328454
22919,63,36,0,8.13,54.33,3328453,3328516
22920,62,32,1,8.26,39.93,3328515,3328577
22921,63,31,1,8.13,41.76,3328576,3328639
22922,58,43,1,8.83,55.25,3328638,3328696
22923,28,210,3,18.29,1402.35,3328695,3328723
22924,68,29,1,7.53,32.66,3328722,3328790
22925,46,136,0,11.13,425.07,3328789,3328835
22926,32,136,1,16.00,582.44,3328834,3328866
22927,60,41,0,8.53,55.42,3328865,3328925
22928,43,46,0,11.91,92.50,3328924,3328967
22929,47,36,0,10.89,67.46,3328966,3329013
22930,58,32,2,8.83,32.07,3329012,3329070
22931,47,38,1,10.89,62.86,3329070,3329117
22932,48,50,1,10.67,76.89,3329116,3329164
22933,48,97,1,10.67,200.76,3329163,3329211
22934,55,39,0,9.31,53.41,3329210,3329265
22935,53,54,0,9.66,109.32,3329264,3329317
22936,34,69,0,15.06,287.17,3329316,3329350
22937,42,56,3,12.19,94.68,3329349,3329391
22938,53,62,1,9.66,81.51,3329390,3329443
22939,51,45,1,10.04,68.63,3329442,3329493
22940,47,58,1,10.89,91.33,3329492,3329539
22941,55,30,2,9.31,30.87,3329538,3329593
22942,51,28,1,10.04,46.27,3329592,3329643
22943,57,39,0,8.98,61.32,3329642,3329699
22944,61,24,1,8.39,31.71,3329698,3329759
22945,61,42,1,8.39,48.50,3329758,3329819
22946,43,59,2,11.91,114.22,3329818,3329861
22947,49,50,1,10.45,114.94,3329860,3329909
22948,36,102,0,14.22,311.45,3329908,3329944
22949,46,48,1,11.13,67.77,3329943,3329989
22950,46,58,2,11.13,92.20,3329988,3330034
22951,54,42,0,9.48,97.69,3330034,3330088
22952,46,91,0,11.13,197.46,3330088,3330134
22953,66,47,0,7.76,62.09,3330133,3330199
22954,80,32,1,6.40,30.57,3330198,3330278
22955,74,33,0,6.92,54.13,3330278,3330352
22956,65,28,1,7.88,40.63,3330351,3330416
22957,53,86,0,9.66,192.64,3330416,3330469
22958,71,31,1,7.21,37.72,3330468,3330539
22959,52,49,1,9.85,87.48,3330538,3330590
22960,71,35,0,7.21,43.88,3330589,3330660
22961,73,19,0,7.01,20.86,3330659,3330732
22962,65,21,1,7.88,31.65,3330731,3330796
22963,62,49,0,8.26,53.45,3330795,3330857
22964,55,40,1,9.31,69.74,3330856,3330911
22965,70,30,1,7.31,34.82,3330910,3330980
22966,47,46,1,10.89,99.16,3330979,3331026
22967,56,42,0,9.14,51.19,3331025,3331081
22968,42,35,0,12.19,73.82,3331080,3331122
22969,50,60,1,10.24,84.02,3331121,3331171
22970,54,26,1,9.48,30.66,3331170,3331224
22971,60,30,1,8.53,34.82,3331223,3331283
22972,43,80,0,11.91,180.97,3331282,3331325
22973,60,35,1,8.53,43.22,3331324,3331384
22974,61,27,1,8.39,25.65,3331383,3331444
22975,37,58,1,13.84,181.54,3331443,3331480
22976,43,54,2,11.91,111.15,3331479,3331522
22977,55,50,1,9.31,77.05,3331522,3331577
22978,45,54,1,11.38,91.70,3331576,3331621
22979,46,47,3,11.13,67.11,3331620,3331666
22980,48,44,1,10.67,86.35,3331666,3331714
22981,45,51,1,11.38,85.21,3331713,3331758
22982,48,38,1,10.67,43.22,3331757,3331805
22983,65,29,0,7.88,28.20,3331804,3331869
22984,40,52,1,12.80,137.96,3331868,3331908
22985,23,90,2,22.26,414.89,3331907,3331930
22986,34,49,1,15.06,99.53,3331929,3331963
22987,34,37,1,15.06,117.53,3331962,3331996
22988,44,37,1,11.64,65.37,3331995,3332039
22989,35,111,2,14.63,329.60,3332038,3332073
22990,25,173,1,20.48,1218.49,3332072,3332097
22991,44,45,0,11.64,105.05,3332096,3332140
22992,33,152,1,15.52,718.92,3332140,3332173
22993,40,38,1,12.80,78.46,3332172,3332212
22994,37,147,0,13.84,604.46,3332211,3332248
22995,38,119,2,13.47,388.04,3332247,3332285
22996,54,43,1,9.48,85.32,3332285,3332339
22997,66,45,0,7.76,76.49,3332338,3332404
22998,76,43,0,6.74,55.19,3332403,3332479
22999,35,83,1,14.63,367.09,3332478,3332513
23000,62,38,0,8.26,81.32,3332512,3332574
23001,65,42,0,7.88,55.06,3332574,3332639
23002,47,57,2,10.89,113.84,3332638,3332685
23003,72,21,0,7.11,22.38,3332684,3332756
23004,78,30,1,6.56,19.53,3332755,3332833
23005,59,79,0,8.68,117.91,3332832,3332891
23006,63,32,0,8.13,45.19,3332891,3332954
23007,61,54,1,8.39,71.19,3332953,3333014
23008,36,155,2,14.22,672.17,3333013,3333049
23009,43,109,2,11.91,285.99,3333048,3333091
23010,73,30,0,7.01,34.89,3333090,3333163
23011,56,39,1,9.14,64.19,3333162,3333218
23012,56,29,1,9.14,39.91,3333218,3333274
23013,57,26,1,8.98,27.63,3333273,3333330
23014,44,56,2,11.64,104.10,3333329,3333373
23015,49,69,0,10.45,106.33,3333372,3333421
23016,49,37,1,10.45,60.78,3333420,3333469
23017,44,58,3,11.64,84.78,3333468,3333512
23018,41,126,1,12.49,374.88,3333511,3333552
23019,55,23,1,9.31,37.12,3333551,3333606
23020,62,25,0,8.26,28.55,3333606,3333668
23021,51,38,2,10.04,40.94,3333667,3333718
23022,27,89,2,18.96,391.52,3333717,3333744
23023,41,168,1,12.49,637.96,3333743,3333784
23024,56,30,1,9.14,37.80,3333783,3333839
23025,41,49,2,12.49,85.13,3333838,3333879
23026,36,94,0,14.22,282.40,3333878,3333914
23027,41,60,1,12.49,108.64,3333913,3333954
23028,48,34,3,10.67,44.06,3333953,3334001
23029,34,68,2,15.06,230.11,3334000,3334034
23030,48,40,2,10.67,51.64,3334033,3334081
23031,47,56,2,10.89,111.12,3334081,3334128
23032,68,28,0,7.53,36.54,3334127,3334195
23033,36,138,0,14.22,630.01,3334194,3334230
23034,18,127,2,28.44,1016.58,3334229,3334247
23035,28,52,0,18.29,178.42,3334246,3334274
23036,44,47,1,11.64,115.14,3334273,3334317
23037,26,111,1,19.69,480.83,3334316,3334342
23038,46,38,1,11.13,76.59,3334341,3334387
23039,49,38,0,10.45,72.37,3334386,3334435
23040,34,102,0,15.06,320.64,3334434,3334468
23041,42,49,1,12.19,101.39,3334467,3334509
23042,49,55,0,10.45,99.64,3334508,3334557
23043,83,30,0,6.17,34.21,3334557,3334640
23044,80,43,0,6.40,49.92,3334639,3334719
23045,32,124,1,16.00,528.88,3334718,3334750
23046,68,50,0,7.53,62.72,3334749,3334817
23047,61,44,1,8.39,63.78,3334816,3334877
23048,58,39,1,8.83,52.80,3334877,3334935
23049,45,74,1,11.38,237.52,3334934,3334979
23050,58,27,2,8.83,27.73,3334978,3335036
23051,52,33,0,9.85,52.59,3335035,3335087
23052,63,31,1,8.13,37.76,3335086,3335149
23053,51,70,1,10.04,146.98,3335149,3335200
23054,55,41,0,9.31,59.45,3335199,3335254
23055,64,29,1,8.00,36.16,3335253,3335317
23056,56,44,1,9.14,66.12,3335316,3335372
23057,41,92,2,12.49,301.23,3335371,3335412
23058,47,44,1,10.89,89.67,3335411,3335458
23059,43,44,1,11.91,95.76,3335457,3335500
23060,47,37,1,10.89,56.22,3335499,3335546
23061,48,47,1,10.67,86.64,3335545,3335593
23062,62,47,0,8.26,68.26,3335592,3335654
23063,44,31,1,11.64,52.87,3335653,3335697
23064,43,109,1,11.91,268.55,3335696,3335739
23065,56,27,1,9.14,32.34,3335738,3335794
23066,56,33,2,9.14,42.09,3335794,3335850
23067,35,72,1,14.63,247.38,3335849,3335884
23068,44,81,2,11.64,175.50,3335883,3335927
23069,44,63,3,11.64,111.87,3335926,3335970
23070,36,124,1,14.22,407.01,3335969,3336005
23071,45,58,1,11.38,120.10,3336004,3336049
23072,57,30,1,8.98,41.18,3336048,3336105
23073,41,46,1,12.49,93.71,3336104,3336145
23074,45,40,1,11.38,73.88,3336145,3336190
23075,50,59,1,10.24,110.14,3336189,3336239
23076,50,32,1,10.24,65.06,3336238,3336288
23077,52,52,1,9.85,84.40,3336288,3336340
23078,20,113,3,25.60,800.84,3336339,3336359
23079,14,124,3,36.57,1234.10,3336358,3336372
23080,26,90,1,19.69,503.98,3336371,3336397
23081,33,74,2,15.52,278.80,3336396,3336429
23082,42,43,2,12.19,95.58,3336428,3336470
23083,48,92,1,10.67,221.51,3336469,3336517
23084,36,83,0,14.22,276.12,3336516,3336552
23085,39,139,1,13.13,458.42,3336551,3336590
23086,55,31,0,9.31,64.54,3336589,3336644
23087,26,125,2,19.69,992.98,3336643,3336669
23088,39,82,1,13.13,234.32,3336669,3336708
23089,73,40,0,7.01,61.63,3336707,3336780
23090,80,34,0,6.40,28.82,3336779,3336859
23091,59,33,1,8.68,76.15,3336858,3336917
23092,51,90,0,10.04,290.67,3336916,3336967
23093,30,299,0,17.07,2818.66,3336966,3336996
23094,48,146,0,10.67,458.85,3336995,3337043
23095,58,30,1,8.83,31.73,3337042,3337100
23096,59,38,1,8.68,47.98,3337099,3337158
23097,58,36,0,8.83,52.35,3337157,3337215
23098,64,75,0,8.00,111.97,3337214,3337278
23099,61,32,1,8.39,48.14,3337278,3337339
23100,65,29,0,7.88,40.05,3337338,3337403
23101,54,39,0,9.48,60.77,3337402,3337456
23102,56,42,1,9.14,56.34,3337456,3337512
23103,56,52,1,9.14,86.44,3337511,3337567
23104,58,25,1,8.83,34.94,3337566,3337624
23105,55,34,1,9.31,49.30,3337623,3337678
23106,49,42,1,10.45,82.29,3337677,3337726
23107,54,55,1,9.48,96.51,3337726,3337780
23108,37,87,2,13.84,242.46,3337779,3337816
23109,52,91,1,9.85,169.90,3337815,3337867
23110,49,30,2,10.45,50.49,3337866,3337915
23111,54,33,2,9.48,50.18,3337914,3337968
23112,52,29,2,9.85,41.28,3337967,3338019
23113,58,44,1,8.83,44.90,3338018,3338076
23114,42,39,2,12.19,100.01,3338075,3338117
23115,43,55,1,11.91,100.50,3338116,3338159
23116,47,61,2,10.89,102.95,3338158,3338205
23117,38,40,2,13.47,79.99,3338204,3338242
23118,49,38,1,10.45,56.37,3338241,3338290
23119,51,27,1,10.04,37.92,3338289,3338340
23120,53,33,1,9.66,40.87,3338339,3338392
23121,52,51,0,9.85,69.90,3338391,3338443
23122,52,57,1,9.85,114.75,3338442,3338494
23123,58,47,1,8.83,77.00,3338493,3338551
23124,33,126,3,15.52,477.28,3338550,3338583
23125,23,67,2,22.26,413.58,3338582,3338605
23126,40,63,2,12.80,133.06,3338604,3338644
23127,46,42,0,11.13,69.03,3338644,3338690
23128,55,61,1,9.31,97.70,3338689,3338744
23129,46,73,1,11.13,142.94,3338743,3338789
23130,56,72,0,9.14,121.69,3338788,3338844
23131,48,155,0,10.67,493.64,3338843,3338891
23132,73,35,0,7.01,44.84,3338890,3338963
23133,65,46,0,7.88,53.77,3338962,3339027
23134,78,45,0,6.56,71.27,3339026,3339104
23135,83,49,0,6.17,67.35,3339103,3339186
23136,60,55,0,8.53,66.62,3339185,3339245
23137,64,41,1,8.00,59.06,3339245,3339309
23138,48,56,0,10.67,106.60,3339308,3339356
23139,56,57,0,9.14,103.80,3339355,3339411
23140,59,95,1,8.68,161.47,3339411,3339470
23141,55,78,0,9.31,190.21,3339469,3339524
23142,74,23,1,6.92,25.10,3339523,3339597
23143,64,33,1,8.00,42.78,3339596,3339660
23144,45,42,1,11.38,67.17,3339659,3339704
23145,68,30,0,7.53,33.43,3339703,3339771
23146,68,57,1,7.53,56.01,3339770,3339838
23147,51,60,1,10.04,103.33,3339838,3339889
23148,48,39,0,10.67,79.31,3339888,3339936
23149,52,61,0,9.85,92.71,3339936,3339988
23150,54,47,0,9.48,73.36,3339987,3340041
23151,45,70,2,11.38,125.48,3340040,3340085
23152,64,32,0,8.00,38.00,3340084,3340148
23153,49,55,1,10.45,85.84,3340147,3340196
23154,56,29,2,9.14,28.87,3340195,3340251
23155,34,70,1,15.06,216.82,3340250,3340284
23156,49,51,1,10.45,88.53,3340283,3340332
23157,64,38,1,8.00,42.09,3340331,3340395
23158,41,88,2,12.49,207.86,3340394,3340435
23159,47,92,1,10.89,176.52,3340434,3340481
23160,55,41,1,9.31,53.34,3340480,3340535
23161,56,32,0,9.14,40.73,3340534,3340590
23162,49,47,1,10.45,65.31,3340589,3340638
23163,54,51,2,9.48,93.88,3340637,3340691
23164,62,31,1,8.26,46.87,3340690,3340752
23165,40,62,1,12.80,139.06,3340751,3340791
23166,24,94,2,21.33,514.56,3340790,3340814
23167,31,64,1,16.52,221.60,3340813,3340844
23168,46,39,1,11.13,78.77,3340843,3340889
23169,45,63,0,11.38,104.10,3340888,3340933
23170,49,55,1,10.45,89.80,3340932,3340981
23171,37,46,0,13.84,188.03,3340980,3341017
23172,35,76,2,14.63,279.49,3341016,3341051
23173,43,77,0,11.91,243.48,3341050,3341093
23174,86,26,0,5.95,28.86,3341092,3341178
23175,65,53,0,7.88,65.74,3341177,3341242
23176,51,96,0,10.04,257.21,3341242,3341293
23177,48,126,0,10.67,344.89,3341292,3341340
23178,70,41,1,7.31,50.30,3341339,3341409
23179,54,43,1,9.48,75.25,3341408,3341462
23180,73,30,1,7.01,34.53,3341461,3341534
23181,64,28,1,8.00,34.81,3341533,3341597
23182,53,56,1,9.66,115.51,3341596,3341649
23183,40,78,1,12.80,258.71,3341648,3341688
23184,56,59,1,9.14,90.30,3341688,3341744
23185,59,53,1,8.68,83.00,3341743,3341802
23186,35,179,1,14.63,853.72,3341801,3341836
23187,69,35,0,7.42,63.08,3341835,3341904
23188,52,138,1,9.85,354.59,3341903,3341955
23189,61,58,1,8.39,75.88,3341954,3342015
23190,72,20,0,7.11,21.29,3342014,3342086
23191,54,35,1,9.48,44.58,3342085,3342139
23192,41,47,1,12.49,106.49,3342138,3342179
23193,59,32,1,8.68,32.32,3342178,3342237
23194,40,105,2,12.80,269.91,3342236,3342276
23195,47,48,1,10.89,71.29,3342275,3342322
23196,55,60,1,9.31,77.38,3342321,3342376
23197,58,38,0,8.83,46.45,3342375,3342433
23198,51,42,2,10.04,66.51,3342432,3342483
23199,49,32,2,10.45,49.31,3342482,3342531
23200,54,36,0,9.48,46.18,3342530,3342584
23201,37,66,3,13.84,144.57,3342583,3342620
23202,45,83,1,11.38,164.86,3342619,3342664
23203,59,29,2,8.68,29.57,3342663,3342722
23204,48,87,1,10.67,187.31,3342721,3342769
23205,50,45,2,10.24,58.42,3342768,3342818
23206,46,43,1,11.13,71.33,3342817,3342863
23207,48,34,0,10.67,83.81,3342862,3342910
23208,50,44,1,10.24,82.10,3342909,3342959
23209,48,33,1,10.67,59.56,3342958,3343006
23210,53,49,0,9.66,144.38,3343006,3343059
23211,52,62,1,9.85,119.28,3343058,3343110
23212,76,46,0,6.74,71.04,3343109,3343185
23213,57,93,1,8.98,161.42,3343184,3343241
23214,52,34,1,9.85,103.25,3343240,3343292
23215,62,58,1,8.26,79.84,3343291,3343353
23216,54,31,1,9.48,55.40,3343352,3343406
23217,46,130,0,11.13,369.07,3343406,3343452
23218,73,56,0,7.01,48.84,3343451,3343524
23219,70,40,1,7.31,36.53,3343523,3343593
23220,90,19,0,5.69,17.04,3343592,3343682
23221,33,151,1,15.52,666.49,3343681,3343714
23222,74,74,1,6.92,82.78,3343713,3343787
23223,43,91,1,11.91,193.34,3343786,3343829
23224,49,79,1,10.45,216.98,3343828,3343877
23225,52,23,1,9.85,30.40,3343876,3343928
23226,55,31,1,9.31,45.56,3343927,3343982
23227,43,51,0,11.91,112.92,3343982,3344025
23228,53,44,1,9.66,51.39,3344024,3344077
23229,51,70,1,10.04,102.98,3344076,3344127
23230,53,26,3,9.66,30.19,3344126,3344179
23231,34,53,2,15.06,143.88,3344179,3344213
23232,48,70,0,10.67,176.56,3344212,3344260
23233,48,61,2,10.67,100.01,3344259,3344307
23234,42,33,1,12.19,58.30,3344306,3344348
23235,50,41,2,10.24,52.42,3344347,3344397
23236,55,35,2,9.31,48.98,3344396,3344451
23237,46,40,1,11.13,65.59,3344450,3344496
23238,58,25,1,8.83,37.00,3344495,3344553
23239,51,45,1,10.04,102.63,3344552,3344603
23240,42,58,2,12.19,128.77,3344602,3344644
23241,47,47,2,10.89,80.99,3344643,3344690
23242,18,110,2,28.44,641.47,3344689,3344707
23243,26,71,1,19.69,421.60,3344706,3344732
23244,28,66,5,18.29,212.35,3344731,3344759
23245,26,58,2,19.69,222.06,3344758,3344784
23246,37,87,0,13.84,210.62,3344783,3344820
23247,28,131,3,18.29,565.35,3344820,3344848
23248,58,34,0,8.83,43.42,3344847,3344905
23249,46,51,1,11.13,124.77,3344904,3344950
23250,58,33,0,8.83,66.87,3344949,3345007
23251,38,74,0,13.47,226.67,3345006,3345044
23252,57,34,1,8.98,55.18,3345044,3345101
23253,22,333,0,23.27,4662.02,3345100,3345122
23254,69,54,0,7.42,61.72,3345121,3345190
23255,65,83,0,7.88,159.98,3345189,3345254
23256,79,47,0,6.48,44.88,3345253,3345332
23257,74,31,0,6.92,38.91,3345331,3345405
23258,52,41,1,9.85,58.36,3345404,3345456
23259,65,51,0,7.88,55.03,3345455,3345520
23260,55,33,2,9.31,35.09,3345519,3345574
23261,60,44,2,8.53,47.88,3345574,3345634
23262,64,54,1,8.00,63.69,3345633,3345697
23263,61,25,0,8.39,23.35,3345696,3345757
23264,63,41,1,8.13,49.03,3345757,3345820
23265,62,31,0,8.26,35.06,3345819,3345881
23266,70,70,1,7.31,82.79,3345880,3345950
23267,60,24,2,8.53,33.08,3345949,3346009
23268,57,30,0,8.98,32.40,3346009,3346066
23269,60,29,1,8.53,31.92,3346065,3346125
23270,57,42,1,8.98,49.46,3346124,3346181
23271,61,29,1,8.39,25.85,3346180,3346241
23272,46,35,2,11.13,50.55,3346240,3346286
23273,44,64,1,11.64,122.87,3346285,3346329
23274,56,31,2,9.14,30.91,3346328,3346384
23275,55,35,1,9.31,54.98,3346383,3346438
23276,51,41,2,10.04,57.49,3346437,3346488
23277,50,38,1,10.24,58.54,3346487,3346537
23278,44,49,0,11.64,82.82,3346537,3346581
23279,46,83,1,11.13,150.98,3346581,3346627
23280,37,143,2,13.84,507.87,3346626,3346663
23281,47,85,1,10.89,152.18,3346662,3346709
23282,52,35,2,9.85,52.86,3346708,3346760
23283,52,35,1,9.85,40.59,3346759,3346811
23284,47,45,0,10.89,78.82,3346810,3346857
23285,45,47,1,11.38,81.88,3346856,3346901
23286,50,36,1,10.24,58.74,3346900,3346950
23287,56,40,2,9.14,52.44,3346949,3347005
23288,44,48,1,11.64,102.23,3347004,3347048
23289,46,67,0,11.13,158.77,3347047,3347093
23290,46,42,1,11.13,72.03,3347092,3347138
23291,51,36,1,10.04,42.31,3347137,3347188
23292,52,36,1,9.85,77.86,3347187,3347239
23293,42,79,0,12.19,211.39,3347238,3347280
23294,43,50,0,11.91,108.41,3347280,3347323
23295,76,32,0,6.74,50.17,3347322,3347398
23296,52,42,1,9.85,94.48,3347397,3347449
23297,74,44,0,6.92,71.97,3347448,3347522
23298,30,55,2,17.07,287.66,3347521,3347551
23299,73,37,0,7.01,54.84,3347550,3347623
23300,57,40,1,8.98,58.96,3347622,3347679
23301,71,59,0,7.21,73.21,3347678,3347749
23302,62,58,1,8.26,66.19,3347748,3347810
23303,67,27,1,7.64,32.56,3347809,3347876
23304,60,39,0,8.53,77.85,3347875,3347935
23305,72,35,0,7.11,44.18,3347935,3348007
23306,58,51,1,8.83,63.94,3348006,3348064
23307,43,64,1,11.91,114.22,3348063,3348106
23308,77,54,0,6.65,53.24,3348105,3348182
23309,49,174,2,10.45,575.59,3348181,3348230
23310,50,31,0,10.24,50.90,3348229,3348279
23311,60,29,0,8.53,51.42,3348278,3348338
23312,53,51,0,9.66,68.19,3348337,3348390
23313,47,35,1,10.89,41.75,3348390,3348437
23314,52,52,1,9.85,82.59,3348436,3348488
23315,44,47,2,11.64,72.91,3348487,3348531
23316,64,20,1,8.00,20.28,3348530,3348594
23317,47,37,1,10.89,61.92,3348594,3348641
23318,49,37,1,10.45,64.94,3348640,3348689
23319,36,56,1,14.22,202.78,3348688,3348724
23320,37,68,0,13.84,168.73,3348724,3348761
23321,58,55,1,8.83,65.49,3348760,3348818
23322,44,39,1,11.64,70.64,3348817,3348861
23323,54,28,2,9.48,36.55,3348860,3348914
23324,50,46,1,10.24,67.90,3348913,3348963
23325,49,39,1,10.45,69.64,3348962,3349011
23326,48,45,1,10.67,84.06,3349010,3349058
23327,54,38,1,9.48,63.43,3349057,3349111
23328,54,41,0,9.48,69.62,3349110,3349164
23329,54,38,0,9.48,83.06,3349163,3349217
23330,38,119,0,13.47,391.93,3349216,3349254
23331,65,25,1,7.88,35.40,3349253,3349318
23332,53,34,2,9.66,64.90,3349318,3349371
23333,42,49,0,12.19,113.58,3349370,3349412
23334,51,76,0,10.04,139.53,3349412,3349463
23335,56,48,1,9.14,72.16,3349463,3349519
23336,77,23,0,6.65,24.38,3349518,3349595
23337,39,60,1,13.13,160.01,3349595,3349634
23338,73,33,0,7.01,49.16,3349633,3349706
23339,72,24,0,7.11,35.43,3349705,3349777
23340,80,29,0,6.40,34.07,3349776,3349856
23341,59,34,1,8.68,55.20,3349855,3349914
23342,80,28,0,6.40,21.89,3349913,3349993
23343,55,37,1,9.31,56.76,3349992,3350047
23344,77,19,1,6.65,20.25,3350046,3350123
23345,75,31,1,6.83,28.25,3350123,3350198
23346,60,90,0,8.53,140.62,3350197,3350257
23347,52,83,1,9.85,137.13,3350256,3350308
23348,71,64,0,7.21,66.90,3350307,3350378
23349,79,32,1,6.48,30.07,3350377,3350456
23350,67,37,1,7.64,45.24,3350455,3350522
23351,57,66,0,8.98,100.89,3350522,3350579
23352,58,28,1,8.83,40.56,3350578,3350636
23353,50,40,1,10.24,61.66,3350636,3350686
23354,59,59,1,8.68,83.68,3350686,3350745
23355,52,31,1,9.85,56.09,3350744,3350796
23356,51,31,1,10.04,46.27,3350795,3350846
23357,52,26,2,9.85,31.94,3350845,3350897
23358,57,26,1,8.98,25.25,3350896,3350953
23359,53,34,2,9.66,51.17,3350952,3351005
23360,60,31,0,8.53,49.35,3351004,3351064
23361,53,49,1,9.66,58.71,3351063,3351116
23362,28,63,2,18.29,187.56,3351115,3351143
23363,28,61,1,18.29,244.78,3351142,3351170
23364,30,63,1,17.07,287.33,3351169,3351199
23365,41,45,2,12.49,101.71,3351199,3351240
23366,21,87,3,24.38,565.95,3351239,3351260
23367,46,43,1,11.13,90.72,3351259,3351305
23368,59,28,1,8.68,42.22,3351304,3351363
23369,47,31,1,10.89,58.86,3351362,3351409
23370,58,84,1,8.83,147.73,3351408,3351466
23371,55,48,1,9.31,88.03,3351465,3351520
23372,80,28,0,6.40,28.74,3351520,3351600
23373,75,53,0,6.83,75.48,3351599,3351674
23374,87,35,0,5.89,42.84,3351673,3351760
23375,69,36,0,7.42,34.71,3351759,3351828
23376,77,25,0,6.65,27.68,3351828,3351905
23377,60,21,1,8.53,30.15,3351904,3351964
23378,52,60,1,9.85,75.75,3351963,3352015
23379,60,36,1,8.53,46.22,3352014,3352074
23380,75,22,0,6.83,18.94,3352074,3352149
23381,67,43,0,7.64,48.11,3352148,3352215
23382,58,38,1,8.83,74.14,3352214,3352272
23383,81,25,1,6.32,19.72,3352272,3352353
23384,63,30,0,8.13,32.27,3352352,3352415
23385,44,54,1,11.64,134.00,3352414,3352458
23386,43,39,2,11.91,47.25,3352457,3352500
23387,41,111,0,12.49,411.42,3352499,3352540
23388,42,52,1,12.19,125.44,3352539,3352581
23389,42,53,2,12.19,93.20,3352580,3352622
23390,35,90,1,14.63,236.98,3352621,3352656
23391,36,48,2,14.22,135.12,3352655,3352691
23392,39,63,0,13.13,158.68,3352691,3352730
23393,48,33,1,10.67,48.10,3352729,3352777
23394,53,36,0,9.66,49.73,3352776,3352829
23395,39,33,2,13.13,47.91,3352828,3352867
23396,47,61,1,10.89,125.46,3352866,3352913
23397,47,46,2,10.89,79.75,3352912,3352959
23398,42,53,3,12.19,89.82,3352958,3353000
23399,19,92,1,26.95,694.47,3352999,3353018
23400,38,55,1,13.47,136.99,3353017,3353055
23401,40,67,2,12.80,154.86,3353054,3353094
23402,32,110,0,16.00,387.12,3353093,3353125
23403,43,92,2,11.91,192.27,3353124,3353167
23404,43,103,2,11.91,224.08,3353166,3353209
23405,35,128,1,14.63,490.86,3353208,3353243
23406,48,41,1,10.67,98.51,3353242,3353290
23407,63,35,1,8.13,40.87,3353290,3353353
23408,37,119,2,13.84,363.11,3353352,3353389
23409,35,101,1,14.63,329.60,3353388,3353423
23410,45,70,0,11.38,238.99,3353422,3353467
23411,50,36,0,10.24,64.10,3353466,3353516
23412,44,96,1,11.64,220.73,3353515,3353559
23413,76,76,0,6.74,97.75,3353558,3353634
23414,68,44,0,7.53,43.37,3353633,3353701
23415,67,83,0,7.64,140.86,3353700,3353767
23416,74,31,0,6.92,43.34,3353766,3353840
23417,59,27,1,8.68,34.39,3353839,3353898
23418,54,31,1,9.48,56.69,3353897,3353951
23419,57,37,1,8.98,42.40,3353950,3354007
23420,62,35,1,8.26,46.09,3354006,3354068
23421,46,76,1,11.13,191.20,3354067,3354113
23422,35,85,1,14.63,340.00,3354112,3354147
23423,74,25,0,6.92,25.21,3354146,3354220
23424,55,36,1,9.31,43.45,3354220,3354275
23425,39,108,2,13.13,300.47,3354274,3354313
23426,70,47,0,7.31,59.96,3354312,3354382
23427,69,62,0,7.42,74.48,3354381,3354450
23428,36,94,1,14.22,301.34,3354449,3354485
23429,65,32,1,7.88,41.28,3354484,3354549
23430,54,33,0,9.48,54.58,3354549,3354603
23431,52,50,1,9.85,62.82,3354602,3354654
23432,39,101,1,13.13,286.42,3354653,3354692
23433,35,77,1,14.63,262.69,3354691,3354726
23434,47,69,1,10.89,118.65,3354725,3354772
23435,52,70,1,9.85,99.25,3354771,3354823
23436,55,22,1,9.31,31.09,3354822,3354877
23437,35,84,2,14.63,204.63,3354876,3354911
23438,49,49,0,10.45,127.76,3354910,3354959
23439,46,38,2,11.13,82.33,3354959,3355005
23440,39,44,2,13.13,81.50,3355004,3355043
23441,55,36,1,9.31,46.98,3355042,3355097
23442,51,33,2,10.04,53.80,3355096,3355147
23443,39,46,0,13.13,117.09,3355146,3355185
23444,53,28,1,9.66,28.94,3355184,3355237
23445,58,27,1,8.83,33.87,3355236,3355294
23446,48,89,1,10.67,175.72,3355293,3355341
23447,38,52,1,13.47,144.88,3355340,3355378
23448,31,62,3,16.52,182.38,3355377,3355408
23449,27,90,2,18.96,460.26,3355407,3355434
23450,51,74,1,10.04,137.45,3355433,3355484
23451,30,100,1,17.07,379.86,3355483,3355513
23452,40,55,0,12.80,152.36,3355512,3355552
23453,34,78,1,15.06,328.47,3355551,3355585
23454,50,44,0,10.24,74.74,3355584,3355634
23455,58,33,1,8.83,61.69,3355633,3355691
23456,21,298,1,24.38,3821.47,3355690,3355711
23457,54,148,0,9.48,394.10,3355710,3355764
23458,81,46,0,6.32,38.32,3355763,3355844
23459,71,32,0,7.21,42.14,3355843,3355914
23460,53,53,1,9.66,127.62,3355913,3355966
23461,80,25,0,6.40,34.21,3355965,3356045
23462,51,41,1,10.04,68.16,3356044,3356095
23463,74,49,1,6.92,47.80,3356094,3356168
23464,63,34,1,8.13,38.33,3356167,3356230
23465,62,32,1,8.26,39.55,3356229,3356291
23466,60,39,0,8.53,68.32,3356290,3356350
23467,69,23,1,7.42,26.74,3356349,3356418
23468,64,29,1,8.00,41.66,3356417,3356481
23469,69,54,1,7.42,87.32,3356480,3356549
23470,54,83,1,9.48,165.51,3356548,3356602
23471,56,72,0,9.14,109.27,3356601,3356657
23472,51,36,0,10.04,56.35,3356656,3356707
23473,56,30,1,9.14,33.55,3356706,3356762
23474,65,36,1,7.88,35.77,3356761,3356826
23475,59,46,0,8.68,50.22,3356825,3356884
23476,47,29,2,10.89,37.88,3356883,3356930
23477,40,77,2,12.80,174.36,3356929,3356969
23478,48,94,1,10.67,200.31,3356968,3357016
23479,65,33,1,7.88,37.09,3357015,3357080
23480,41,54,2,12.49,147.66,3357079,3357120
23481,49,65,1,10.45,89.55,3357119,3357168
23482,42,49,2,12.19,103.06,3357167,3357209
23483,44,53,2,11.64,109.37,3357208,3357252
23484,49,26,1,10.45,34.61,3357251,3357300
23485,57,33,0,8.98,38.86,3357300,3357357
23486,49,73,1,10.45,130.12,3357356,3357405
23487,50,50,2,10.24,68.98,3357404,3357454
23488,51,39,2,10.04,67.41,3357453,3357504
23489,47,49,2,10.89,88.18,3357503,3357550
23490,30,61,2,17.07,263.46,3357549,3357579
23491,28,57,2,18.29,228.49,3357578,3357606
23492,22,71,3,23.27,385.56,3357605,3357627
23493,31,117,0,16.52,446.25,3357626,3357657
23494,56,40,1,9.14,64.48,3357656,3357712
23495,41,97,1,12.49,247.66,3357711,3357752
23496,39,170,1,13.13,676.73,3357751,3357790
23497,55,44,0,9.31,80.61,3357789,3357844
23498,38,152,0,13.47,613.30,3357843,3357881
23499,73,37,0,7.01,33.58,3357880,3357953
23500,67,32,0,7.64,57.10,3357952,3358019
23501,58,26,0,8.83,46.76,3358019,3358077
23502,76,33,0,6.74,51.22,3358076,3358152
23503,88,34,0,5.82,34.54,3358151,3358239
23504,51,55,0,10.04,118.98,3358238,3358289
23505,51,50,0,10.04,105.45,3358288,3358339
23506,53,61,1,9.66,140.56,3358338,3358391
23507,73,20,1,7.01,21.27,3358390,3358463
23508,44,80,1,11.64,240.60,3358462,3358506
23509,59,70,1,8.68,86.69,3358505,3358564
23510,47,67,0,10.89,184.82,3358563,3358610
23511,63,41,0,8.13,40.30,3358609,3358672
23512,45,46,1,11.38,133.84,3358671,3358716
23513,47,30,1,10.89,42.86,3358715,3358762
23514,63,102,0,8.13,170.36,3358761,3358824
23515,59,60,1,8.68,96.42,3358823,3358882
23516,48,59,0,10.67,106.76,3358881,3358929
23517,47,62,1,10.89,156.01,3358928,3358975
23518,54,34,1,9.48,39.81,3358974,3359028
23519,36,102,2,14.22,358.17,3359027,3359063
23520,33,122,3,15.52,467.04,3359062,3359095
23521,60,30,1,8.53,34.58,3359094,3359154
23522,55,73,1,9.31,104.00,3359153,3359208
23523,50,31,2,10.24,42.70,3359207,3359257
23524,38,50,1,13.47,127.67,3359256,3359294
23525,41,70,1,12.49,174.49,3359293,3359334
23526,52,39,1,9.85,65.75,3359333,3359385
23527,43,72,2,11.91,137.34,3359384,3359427
23528,48,62,2,10.67,127.43,3359426,3359474
23529,42,64,2,12.19,186.01,3359473,3359515
23530,54,35,1,9.48,46.18,3359514,3359568
23531,42,135,1,12.19,399.82,3359568,3359610
23532,47,67,1,10.89,176.31,3359609,3359656
23533,59,46,1,8.68,55.00,3359655,3359714
23534,51,26,0,10.04,33.61,3359713,3359764
23535,29,95,1,17.66,427.95,3359763,3359792
23536,38,59,1,13.47,179.25,3359791,3359829
23537,33,51,2,15.52,139.89,3359828,3359861
23538,50,44,0,10.24,85.26,3359860,3359910
23539,51,37,0,10.04,74.04,3359909,3359960
23540,42,45,0,12.19,83.11,3359959,3360001
23541,39,86,1,13.13,215.19,3360000,3360039
23542,46,75,0,11.13,177.81,3360038,3360084
23543,38,79,0,13.47,204.20,3360083,3360121
23544,47,51,1,10.89,109.29,3360120,3360167
23545,78,64,0,6.56,73.02,3360167,3360245
23546,40,168,1,12.80,670.56,3360244,3360284
23547,58,47,1,8.83,76.11,3360283,3360341
23548,75,38,0,6.83,48.84,3360340,3360415
23549,56,122,0,9.14,279.19,3360414,3360470
23550,54,95,1,9.48,187.14,3360469,3360523
23551,54,43,2,9.48,63.69,3360522,3360576
23552,64,40,1,8.00,44.66,3360575,3360639
23553,69,29,1,7.42,35.20,3360638,3360707
23554,63,53,1,8.13,55.03,3360706,3360769
23555,56,50,1,9.14,89.34,3360768,3360824
23556,63,41,1,8.13,51.06,3360823,3360886
23557,52,94,1,9.85,168.67,3360886,3360938
23558,49,67,0,10.45,113.27,3360937,3360986
23559,89,38,1,5.75,24.19,3360986,3361075
23560,42,113,0,12.19,414.34,3361074,3361116
23561,55,31,1,9.31,57.12,3361115,3361170
23562,56,27,1,9.14,39.27,3361170,3361226
23563,52,34,0,9.85,56.67,3361225,3361277
23564,48,29,2,10.67,33.26,3361276,3361324
23565,41,55,2,12.49,128.20,3361323,3361364
23566,48,115,0,10.67,254.10,3361363,3361411
23567,53,72,0,9.66,119.21,3361411,3361464
23568,35,54,2,14.63,164.00,3361463,3361498
23569,44,32,1,11.64,64.91,3361497,3361541
23570,50,48,1,10.24,75.54,3361540,3361590
23571,48,44,0,10.67,108.51,3361589,3361637
23572,43,43,3,11.91,68.36,3361636,3361679
23573,40,53,1,12.80,164.61,3361678,3361718
23574,48,52,0,10.67,80.22,3361718,3361766
23575,65,32,1,7.88,32.85,3361765,3361830
23576,56,36,1,9.14,41.80,3361829,3361885
23577,59,27,0,8.68,26.73,3361884,3361943
23578,59,41,0,8.68,55.13,3361942,3362001
23579,55,86,1,9.31,134.43,3362000,3362055
23580,33,107,2,15.52,361.22,3362054,3362087
23581,41,79,1,12.49,219.86,3362086,3362127
23582,18,132,2,28.44,1215.58,3362126,3362144
23583,37,88,1,13.84,284.41,3362143,3362180
23584,44,48,1,11.64,99.87,3362179,3362223
23585,34,41,2,15.06,139.23,3362222,3362256
23586,55,71,0,9.31,138.80,3362255,3362310
23587,29,312,1,17.66,3116.78,3362309,3362338
23588,44,44,1,11.64,102.73,3362337,3362381
23589,78,23,0,6.56,33.02,3362381,3362459
23590,71,29,0,7.21,53.07,3362458,3362529
23591,46,99,0,11.13,258.94,3362528,3362574
23592,52,54,0,9.85,113.21,3362573,3362625
23593,87,33,0,5.89,32.54,3362625,3362712
23594,27,127,3,18.96,771.07,3362711,3362738
23595,62,40,1,8.26,57.74,3362737,3362799
23596,53,59,1,9.66,125.13,3362798,3362851
23597,38,124,1,13.47,513.35,3362850,3362888
23598,48,60,2,10.67,139.43,3362887,3362935
23599,52,48,2,9.85,68.48,3362934,3362986
23600,70,27,0,7.31,28.16,3362985,3363055
23601,64,46,1,8.00,64.91,3363054,3363118
23602,55,35,1,9.31,57.49,3363117,3363172
23603,58,39,1,8.83,52.76,3363171,3363229
23604,60,41,0,8.53,57.18,3363228,3363288
23605,46,56,1,11.13,117.16,3363287,3363333
23606,55,40,0,9.31,53.38,3363332,3363387
23607,47,34,1,10.89,51.07,3363386,3363433
23608,43,34,0,11.91,62.27,3363433,3363476
23609,46,59,2,11.13,120.77,3363475,3363521
23610,46,104,1,11.13,231.59,3363520,3363566
23611,53,31,1,9.66,40.53,3363565,3363618
23612,42,57,1,12.19,97.92,3363617,3363659
23613,60,41,1,8.53,38.98,3363658,3363718
23614,54,84,2,9.48,131.51,3363717,3363771
23615,54,31,1,9.48,59.69,3363770,3363824
23616,40,55,1,12.80,180.21,3363823,3363863
23617,62,31,0,8.26,28.55,3363862,3363924
23618,55,30,1,9.31,41.34,3363923,3363978
23619,49,35,2,10.45,53.23,3363977,3364026
23620,56,26,1,9.14,22.84,3364025,3364081
23621,51,30,1,10.04,36.08,3364080,3364131
23622,40,52,3,12.80,123.71,3364130,3364170
23623,45,49,2,11.38,105.35,3364169,3364214
23624,43,64,1,11.91,117.06,3364213,3364256
23625,29,189,1,17.66,1117.47,3364255,3364284
23626,36,67,1,14.22,210.73,3364283,3364319
23627,26,195,1,19.69,1493.44,3364318,3364344
23628,29,126,3,17.66,531.88,3364343,3364372
23629,38,78,2,13.47,176.35,3364371,3364409
23630,39,77,1,13.13,192.83,3364409,3364448
23631,40,57,1,12.80,108.41,3364447,3364487
23632,41,137,1,12.49,467.27,3364486,3364527
23633,43,72,0,11.91,240.78,3364526,3364569
23634,20,206,0,25.60,2063.94,3364568,3364588
23635,39,161,1,13.13,667.19,3364587,3364626
23636,78,29,0,6.56,38.99,3364625,3364703
23637,74,27,0,6.92,41.56,3364702,3364776
23638,57,51,0,8.98,87.39,3364775,3364832
23639,60,75,0,8.53,224.32,3364831,3364891
23640,37,86,1,13.84,241.54,3364890,3364927
23641,28,95,3,18.29,464.92,3364926,3364954
23642,65,39,0,7.88,65.92,3364953,3365018
23643,45,74,1,11.38,157.70,3365017,3365062
23644,49,73,1,10.45,171.64,3365061,3365110
23645,45,40,2,11.38,73.39,3365109,3365154
23646,53,53,1,9.66,72.56,3365153,3365206
23647,51,110,0,10.04,234.16,3365205,3365256
23648,48,50,1,10.67,81.43,3365255,3365303
23649,66,29,1,7.76,34.24,3365302,3365368
23650,48,74,1,10.67,124.72,3365368,3365416
23651,48,43,1,10.67,66.60,3365415,3365463
23652,61,55,0,8.39,78.83,3365462,3365523
23653,33,111,1,15.52,546.98,3365522,3365555
23654,39,74,1,13.13,217.09,3365555,3365594
23655,44,38,1,11.64,64.78,3365593,3365637
23656,41,71,1,12.49,151.27,3365636,3365677
23657,48,42,2,10.67,87.43,3365676,3365724
23658,43,49,1,11.91,91.94,3365723,3365766
23659,41,71,1,12.49,184.25,3365765,3365806
23660,54,31,1,9.48,52.21,3365805,3365859
23661,50,35,1,10.24,85.86,3365859,3365909
23662,48,57,0,10.67,100.10,3365908,3365956
23663,48,50,2,10.67,84.47,3365955,3366003
23664,39,65,2,13.13,127.96,3366002,3366041
23665,50,32,1,10.24,53.14,3366040,3366090
23666,42,28,2,12.19,34.77,3366089,3366131
23667,54,29,1,9.48,37.73,3366130,3366184
23668,56,35,1,9.14,44.55,3366183,3366239
23669,39,61,4,13.13,118.62,3366238,3366277
23670,28,153,1,18.29,1115.06,3366276,3366304
23671,62,38,2,8.26,38.90,3366303,3366365
23672,42,43,1,12.19,101.30,3366364,3366406
23673,36,67,2,14.22,212.23,3366405,3366441
23674,31,67,1,16.52,304.89,3366440,3366471
23675,33,67,2,15.52,229.83,3366471,3366504
23676,53,61,2,9.66,70.49,3366503,3366556
23677,54,45,0,9.48,66.92,3366555,3366609
23678,38,82,2,13.47,233.30,3366608,3366646
23679,37,62,3,13.84,187.92,3366646,3366683
23680,50,101,0,10.24,225.06,3366682,3366732
23681,49,42,1,10.45,58.82,3366731,3366780
23682,57,63,0,8.98,123.25,3366779,3366836
23683,79,26,0,6.48,27.49,3366835,3366914
23684,76,56,0,6.74,76.17,3366913,3366989
23685,49,73,0,10.45,169.84,3366988,3367037
23686,87,53,0,5.89,61.27,3367036,3367123
23687,47,45,0,10.89,83.58,3367122,3367169
23688,57,67,1,8.98,122.58,3367168,3367225
23689,55,35,1,9.31,56.90,3367224,3367279
23690,59,34,1,8.68,38.29,3367278,3367337
23691,65,40,1,7.88,49.55,3367336,3367401
23692,40,153,1,12.80,565.71,3367400,3367440
23693,55,50,1,9.31,59.96,3367439,3367494
23694,66,25,0,7.76,28.73,3367493,3367559
23695,54,44,0,9.48,67.69,3367558,3367612
23696,49,33,1,10.45,63.92,3367611,3367660
23697,60,68,1,8.53,93.38,3367659,3367719
23698,59,43,1,8.68,57.95,3367718,3367777
23699,49,36,0,10.45,59.23,3367776,3367825
23700,44,33,1,11.64,61.82,3367824,3367868
23701,41,65,1,12.49,143.57,3367867,3367908
23702,49,26,1,10.45,42.78,3367908,3367957
23703,41,72,2,12.49,133.03,3367956,3367997
23704,60,46,1,8.53,53.72,3367996,3368056
23705,54,24,1,9.48,34.25,3368055,3368109
23706,47,49,1,10.89,74.82,3368108,3368155
23707,53,33,0,9.66,47.66,3368155,3368208
23708,37,80,1,13.84,241.92,3368207,3368244
23709,45,39,1,11.38,57.57,3368243,3368288
23710,54,27,1,9.48,37.88,3368288,3368342
23711,57,30,0,8.98,55.46,3368341,3368398
23712,52,43,0,9.85,74.82,3368397,3368449
23713,64,35,0,8.00,39.59,3368448,3368512
23714,37,63,1,13.84,196.35,3368511,3368548
23715,58,25,1,8.83,33.18,3368547,3368605
23716,38,60,1,13.47,181.14,3368605,3368643
23717,8,444,2,64.00,20736.50,3368642,3368650
23718,51,35,0,10.04,56.19,3368649,3368700
23719,40,144,1,12.80,537.31,3368699,3368739
23720,42,52,0,12.19,125.30,3368738,3368780
23721,82,34,0,6.24,33.26,3368779,3368861
23722,62,54,0,8.26,78.71,3368860,3368922
23723,80,47,0,6.40,65.41,3368921,3369001
23724,56,113,0,9.14,259.37,3369000,3369056
23725,71,42,1,7.21,42.31,3369055,3369126
23726,54,54,1,9.48,95.69,3369125,3369179
23727,57,47,1,8.98,57.95,3369178,3369235
23728,51,78,1,10.04,211.45,3369234,3369285
23729,69,25,0,7.42,24.62,3369284,3369353
23730,62,43,0,8.26,49.35,3369352,3369414
23731,44,84,1,11.64,164.64,3369413,3369457
23732,61,85,0,8.39,131.78,3369456,3369517
23733,45,77,1,11.38,165.61,3369516,3369561
23734,56,30,0,9.14,48.12,3369560,3369616
23735,40,119,1,12.80,353.51,3369615,3369655
23736,51,53,0,10.04,82.23,3369654,3369705
23737,48,32,2,10.67,47.18,3369704,3369752
23738,28,123,1,18.29,503.99,3369751,3369779
23739,64,21,1,8.00,24.66,3369778,3369842
23740,46,63,1,11.13,111.11,3369841,3369887
23741,48,72,0,10.67,194.22,3369887,3369935
23742,39,72,1,13.13,184.62,3369934,3369973
23743,45,77,1,11.38,143.35,3369972,3370017
23744,35,51,2,14.63,108.69,3370016,3370051
23745,25,108,1,20.48,674.41,3370050,3370075
23746,34,142,0,15.06,564.58,3370074,3370108
23747,55,30,1,9.31,30.14,3370107,3370162
23748,38,39,3,13.47,74.99,3370161,3370199
23749,58,36,1,8.83,55.42,3370198,3370256
23750,30,101,1,17.07,485.06,3370255,3370285
23751,57,40,2,8.98,68.19,3370284,3370341
23752,55,86,1,9.31,131.27,3370340,3370395
23753,30,125,2,17.07,535.00,3370394,3370424
23754,29,97,1,17.66,370.43,3370423,3370452
23755,29,65,1,17.66,295.88,3370451,3370480
23756,43,87,1,11.91,200.46,3370479,3370522
23757,52,67,0,9.85,95.55,3370522,3370574
23758,40,109,1,12.80,342.81,3370573,3370613
23759,45,47,1,11.38,107.21,3370612,3370657
23760,43,33,1,11.91,61.53,3370656,3370699
23761,42,97,0,12.19,341.15,3370698,3370740
23762,64,34,0,8.00,41.16,3370739,3370803
23763,76,29,0,6.74,40.90,3370802,3370878
23764,51,57,1,10.04,86.74,3370877,3370928
23765,68,43,0,7.53,67.93,3370927,3370995
23766,54,56,0,9.48,107.81,3370994,3371048
23767,61,35,0,8.39,68.73,3371047,3371108
23768,57,52,1,8.98,80.30,3371107,3371164
23769,57,53,0,8.98,79.91,3371163,3371220
23770,55,51,0,9.31,64.36,3371219,3371274
23771,45,89,1,11.38,201.88,3371273,3371318
23772,73,27,1,7.01,28.59,3371317,3371390
23773,53,25,1,9.66,48.04,3371389,3371442
23774,54,45,1,9.48,90.29,3371441,3371495
23775,61,68,1,8.39,130.04,3371494,3371555
23776,54,45,0,9.48,66.81,3371555,3371609
23777,50,90,1,10.24,209.82,3371608,3371658
23778,47,34,0,10.89,58.82,3371657,3371704
23779,49,34,2,10.45,51.72,3371703,3371752
23780,47,43,1,10.89,79.54,3371751,3371798
23781,41,54,1,12.49,121.37,3371797,3371838
23782,48,44,1,10.67,70.18,3371838,3371886
23783,44,53,2,11.64,126.41,3371885,3371929
23784,39,122,0,13.13,400.21,3371928,3371967
23785,54,23,1,9.48,26.51,3371966,3372020
23786,45,39,1,11.38,81.48,3372019,3372064
23787,41,58,1,12.49,144.59,3372063,3372104
23788,40,40,1,12.80,88.01,3372103,3372143
23789,55,34,2,9.31,34.03,3372142,3372197
23790,42,51,2,12.19,112.15,3372196,3372238
23791,51,38,1,10.04,65.68,3372237,3372288
23792,55,40,1,9.31,41.92,3372287,3372342
23793,41,116,0,12.49,319.62,3372341,3372382
23794,54,30,2,9.48,49.03,3372381,3372435
23795,60,40,0,8.53,54.08,3372434,3372494
23796,35,59,2,14.63,148.58,3372493,3372528
23797,32,50,3,16.00,160.62,3372527,3372559
23798,22,103,2,23.27,650.11,3372558,3372580
23799,31,58,2,16.52,205.22,3372579,3372610
23800,34,57,1,15.06,163.94,3372609,3372643
23801,27,89,3,18.96,293.15,3372642,3372669
23802,54,41,1,9.48,77.06,3372668,3372722
23803,40,62,2,12.80,133.56,3372721,3372761
23804,27,84,2,18.96,501.89,3372760,3372787
23805,42,42,1,12.19,98.11,3372786,3372828
23806,42,110,0,12.19,369.96,3372828,3372870
23807,57,34,1,8.98,50.82,3372869,3372926
23808,56,46,0,9.14,56.69,3372925,3372981
23809,81,29,0,6.32,36.61,3372981,3373062
23810,47,35,1,10.89,63.24,3373061,3373108
23811,61,39,0,8.39,70.93,3373107,3373168
23812,54,111,1,9.48,231.14,3373167,3373221
23813,64,57,0,8.00,82.59,3373221,3373285
23814,46,43,2,11.13,76.85,3373284,3373330
23815,64,52,1,8.00,71.38,3373329,3373393
23816,44,40,2,11.64,105.73,3373392,3373436
23817,56,45,1,9.14,57.84,3373436,3373492
23818,58,31,1,8.83,31.11,3373491,3373549
23819,46,53,1,11.13,114.55,3373548,3373594
23820,61,43,1,8.39,55.22,3373593,3373654
23821,64,91,1,8.00,137.66,3373653,3373717
23822,56,40,0,9.14,55.23,3373716,3373772
23823,64,49,1,8.00,67.56,3373771,3373835
23824,58,30,1,8.83,53.49,3373834,3373892
23825,39,110,1,13.13,299.03,3373891,3373930
23826,39,145,1,13.13,509.34,3373929,3373968
23827,41,94,1,12.49,198.30,3373968,3374009
23828,42,53,1,12.19,97.87,3374008,3374050
23829,45,61,2,11.38,85.04,3374049,3374094
23830,46,62,2,11.13,94.98,3374094,3374140
23831,28,147,2,18.29,725.35,3374140,3374168
23832,51,33,0,10.04,52.16,3374167,3374218
23833,50,34,2,10.24,44.38,3374217,3374267
23834,50,27,1,10.24,45.58,3374267,3374317
23835,48,33,1,10.67,65.81,3374316,3374364
23836,43,46,3,11.91,75.53,3374364,3374407
23837,41,45,1,12.49,63.81,3374407,3374448
23838,41,65,1,12.49,114.79,3374447,3374488
23839,56,25,1,9.14,36.91,3374487,3374543
23840,47,45,2,10.89,85.50,3374542,3374589
23841,42,101,2,12.19,263.68,3374588,3374630
23842,57,50,0,8.98,69.42,3374629,3374686
23843,41,36,1,12.49,91.86,3374685,3374726
23844,28,77,2,18.29,330.20,3374725,3374753
23845,36,49,2,14.22,148.40,3374752,3374788
23846,32,100,3,16.00,313.69,3374787,3374819
23847,40,76,1,12.80,206.81,3374818,3374858
23848,49,48,2,10.45,78.49,3374857,3374906
23849,30,124,1,17.07,762.00,3374905,3374935
23850,35,98,1,14.63,344.69,3374934,3374969
23851,35,88,0,14.63,258.12,3374968,3375003
23852,56,64,1,9.14,115.12,3375002,3375058
23853,44,50,1,11.64,124.37,3375057,3375101
23854,39,106,1,13.13,421.60,3375100,3375139
23855,85,35,0,6.02,41.76,3375138,3375223
23856,56,37,0,9.14,52.48,3375222,3375278
23857,78,35,0,6.56,38.12,3375277,3375355
23858,51,40,0,10.04,90.78,3375354,3375405
23859,69,32,0,7.42,51.55,3375404,3375473
23860,59,32,1,8.68,40.39,3375472,3375531
23861,66,32,0,7.76,50.76,3375530,3375596
23862,56,49,1,9.14,52.44,3375595,3375651
23863,58,62,0,8.83,85.63,3375650,3375708
23864,65,23,0,7.88,31.89,3375707,3375772
23865,41,56,1,12.49,152.44,3375771,3375812
23866,55,71,1,9.31,131.23,3375812,3375867
23867,50,42,1,10.24,57.22,3375866,3375916
23868,46,61,1,11.13,123.64,3375915,3375961
23869,68,47,1,7.53,59.34,3375960,3376028
23870,57,39,0,8.98,73.56,3376027,3376084
23871,47,47,1,10.89,99.03,3376083,3376130
23872,37,137,0,13.84,550.35,3376130,3376167
23873,42,39,2,12.19,90.20,3376166,3376208
23874,35,118,1,14.63,441.20,3376207,3376242
23875,52,47,3,9.85,88.48,3376241,3376293
23876,31,66,0,16.52,308.31,3376293,3376324
23877,37,56,2,13.84,116.89,3376323,3376360
23878,50,31,2,10.24,41.34,3376359,3376409
23879,64,34,1,8.00,35.41,3376408,3376472
23880,42,35,2,12.19,98.58,3376471,3376513
23881,42,45,1,12.19,89.96,3376512,3376554
23882,46,50,2,11.13,85.11,3376553,3376599
23883,46,29,1,11.13,42.50,3376598,3376644
23884,51,57,1,10.04,80.39,3376643,3376694
23885,50,28,2,10.24,39.30,3376693,3376743
23886,50,44,1,10.24,70.74,3376742,3376792
23887,54,39,1,9.48,69.21,3376791,3376845
23888,36,67,0,14.22,182.67,3376844,3376880
23889,55,48,1,9.31,71.23,3376879,3376934
23890,52,47,1,9.85,87.44,3376933,3376985
23891,31,106,1,16.52,382.38,3376984,3377015
23892,51,75,0,10.04,167.49,3377014,3377065
23893,45,61,0,11.38,178.99,3377064,3377109
23894,69,42,0,7.42,71.46,3377108,3377177
23895,81,26,0,6.32,26.84,3377176,3377257
23896,74,33,0,6.92,55.59,3377257,3377331
23897,74,61,0,6.92,77.72,3377330,3377404
23898,41,50,2,12.49,126.74,3377403,3377444
23899,65,50,0,7.88,72.78,3377443,3377508
23900,48,53,1,10.67,103.68,3377507,3377555
23901,57,45,1,8.98,74.47,3377554,3377611
23902,59,48,0,8.68,67.81,3377610,3377669
23903,50,62,1,10.24,136.42,3377668,3377718
23904,56,69,1,9.14,119.12,3377717,3377773
23905,78,37,1,6.56,31.86,3377772,3377850
23906,52,33,0,9.85,67.21,3377849,3377901
23907,53,77,0,9.66,159.55,3377900,3377953
23908,47,52,1,10.89,71.16,3377952,3377999
23909,45,52,2,11.38,79.44,3377998,3378043
23910,55,36,0,9.31,56.83,3378042,3378097
23911,44,40,2,11.64,71.82,3378096,3378140
23912,58,64,1,8.83,81.66,3378140,3378198
23913,53,29,0,9.66,38.60,3378197,3378250
23914,56,51,1,9.14,74.02,3378249,3378305
23915,50,45,3,10.24,46.70,3378304,3378354
23916,42,99,0,12.19,252.49,3378353,3378395
23917,48,35,0,10.67,42.26,3378394,3378442
23918,46,33,2,11.13,52.16,3378441,3378487
23919,56,105,0,9.14,197.69,3378486,3378542
23920,43,101,0,11.91,256.74,3378541,3378584
23921,36,105,2,14.22,328.40,3378583,3378619
23922,47,77,0,10.89,140.27,3378618,3378665
23923,44,72,0,11.64,156.37,3378664,3378708
23924,45,38,3,11.38,54.59,3378708,3378753
23925,56,26,0,9.14,42.73,3378752,3378808
23926,40,144,0,12.80,523.41,3378808,3378848
23927,42,43,1,12.19,153.77,3378848,3378890
23928,89,34,0,5.75,30.97,3378889,3378978
23929,51,45,1,10.04,103.10,3378977,3379028
23930,76,30,0,6.74,38.83,3379027,3379103
23931,84,33,0,6.10,28.56,3379102,3379186
23932,46,61,1,11.13,140.50,3379185,3379231
23933,63,29,0,8.13,30.59,3379230,3379293
23934,62,36,1,8.26,40.64,3379292,3379354
23935,62,36,1,8.26,45.58,3379353,3379415
23936,68,77,1,7.53,100.01,3379414,3379482
23937,65,38,0,7.88,49.86,3379481,3379546
23938,65,31,1,7.88,49.92,3379545,3379610
23939,56,37,0,9.14,51.55,3379609,3379665
23940,65,33,0,7.88,45.49,3379665,3379730
23941,44,35,3,11.64,49.00,3379729,3379773
23942,42,59,1,12.19,93.15,3379772,3379814
23943,56,31,1,9.14,33.19,3379813,3379869
23944,51,37,2,10.04,63.02,3379868,3379919
23945,31,81,2,16.52,270.89,3379918,3379949
23946,47,35,1,10.89,55.58,3379948,3379995
23947,63,28,1,8.13,26.68,3379994,3380057
23948,42,62,2,12.19,150.96,3380056,3380098
23949,33,86,2,15.52,321.58,3380097,3380130
23950,49,63,1,10.45,97.06,3380129,3380178
23951,46,65,2,11.13,116.16,3380177,3380223
23952,40,81,1,12.80,221.66,3380222,3380262
23953,55,46,0,9.31,69.63,3380261,3380316
23954,49,85,2,10.45,154.00,3380315,3380364
23955,51,46,1,10.04,92.82,3380363,3380414
23956,47,33,1,10.89,71.58,3380413,3380460
23957,15,181,2,34.13,2459.05,3380459,3380474
23958,8,160,5,64.00,2902.00,3380473,3380481
23959,24,137,2,21.33,817.56,3380480,3380504
23960,16,170,2,32.00,2136.50,3380503,3380519
23961,37,65,1,13.84,172.57,3380518,3380555
23962,40,74,0,12.80,215.66,3380554,3380594
23963,37,68,0,13.84,218.62,3380593,3380630
23964,44,83,2,11.64,196.14,3380629,3380673
23965,43,41,0,11.91,84.27,3380672,3380715
23966,48,49,0,10.67,83.97,3380714,3380762
23967,46,70,0,11.13,200.11,3380761,3380807
23968,85,28,0,6.02,37.39,3380806,3380891
23969,52,43,1,9.85,88.63,3380890,3380942
23970,56,107,0,9.14,288.09,3380941,3380997
23971,62,38,0,8.26,77.45,3380996,3381058
23972,91,49,0,5.63,46.43,3381057,3381148
23973,65,25,1,7.88,34.97,3381147,3381212
23974,82,23,1,6.24,18.48,3381211,3381293
23975,32,232,1,16.00,1575.88,3381292,3381324
23976,51,62,1,10.04,101.92,3381323,3381374
23977,55,57,1,9.31,97.81,3381373,3381428
23978,53,59,0,9.66,126.15,3381427,3381480
23979,59,23,2,8.68,27.91,3381479,3381538
23980,53,50,1,9.66,106.41,3381537,3381590
23981,62,63,1,8.26,76.32,3381589,3381651
23982,54,92,1,9.48,155.06,3381651,3381705
23983,57,162,1,8.98,431.98,3381704,3381761
23984,57,49,1,8.98,90.65,3381760,3381817
23985,60,30,0,8.53,45.82,3381816,3381876
23986,46,36,0,11.13,87.24,3381875,3381921
23987,45,76,0,11.38,132.37,3381920,3381965
23988,52,27,1,9.85,44.05,3381964,3382016
23989,54,36,1,9.48,50.32,3382015,3382069
23990,59,34,1,8.68,42.39,3382068,3382127
23991,51,74,1,10.04,136.78,3382126,3382177
23992,44,52,2,11.64,103.82,3382176,3382220
23993,50,32,1,10.24,49.98,3382220,3382270
23994,33,55,2,15.52,124.61,3382269,3382302
23995,42,138,1,12.19,416.63,3382301,3382343
23996,57,30,1,8.98,29.25,3382342,3382399
23997,49,33,1,10.45,51.35,3382398,3382447
23998,42,63,2,12.19,120.87,3382446,3382488
23999,50,42,1,10.24,74.42,3382488,3382538
24000,51,61,1,10.04,86.35,3382537,3382588
24001,39,66,2,13.13,116.62,3382588,3382627
24002,11,264,3,46.55,6104.98,3382626,3382637
24003,34,86,1,15.06,293.00,3382636,3382670
24004,40,53,1,12.80,156.41,3382669,3382709
24005,49,54,0,10.45,82.49,3382708,3382757
24006,34,45,3,15.06,130.76,3382757,3382791
24007,45,51,2,11.38,85.35,3382790,3382835
24008,44,42,0,11.64,80.37,3382834,3382878
24009,51,110,0,10.04,269.96,3382877,3382928
24010,45,37,0,11.38,77.04,3382927,3382972
24011,65,40,0,7.88,59.43,3382971,3383036
24012,62,219,0,8.26,750.77,3383035,3383097
24013,36,101,1,14.22,413.28,3383096,3383132
24014,61,47,0,8.39,94.44,3383131,3383192
24015,72,38,0,7.11,56.43,3383191,3383263
24016,16,344,2,32.00,6781.88,3383262,3383278
24017,67,106,0,7.64,177.30,3383277,3383344
24018,58,46,0,8.83,101.04,3383343,3383401
24019,70,32,0,7.31,34.19,3383401,3383471
24020,53,56,1,9.66,103.17,3383470,3383523
24021,59,48,0,8.68,97.57,3383522,3383581
24022,66,32,1,7.76,31.70,3383580,3383646
24023,68,54,0,7.53,57.07,3383645,3383713
24024,59,41,0,8.68,72.73,3383712,3383771
24025,59,61,1,8.68,94.49,3383770,3383829
24026,60,55,1,8.53,79.25,3383828,3383888
24027,60,40,1,8.53,52.82,3383887,3383947
24028,47,56,1,10.89,101.88,3383946,3383993
24029,38,56,2,13.47,122.04,3383993,3384031
24030,38,144,1,13.47,503.62,3384030,3384068
24031,40,73,2,12.80,150.46,3384067,3384107
24032,56,42,1,9.14,52.19,3384107,3384163
24033,54,26,0,9.48,33.84,3384162,3384216
24034,47,54,1,10.89,87.41,3384215,3384262
24035,52,51,1,9.85,81.44,3384261,3384313
24036,55,37,0,9.31,50.61,3384312,3384367
24037,48,35,3,10.67,54.51,3384366,3384414
24038,43,34,1,11.91,52.32,3384413,3384456
24039,56,28,1,9.14,36.12,3384455,3384511
24040,44,46,0,11.64,112.64,3384510,3384554
24041,47,43,1,10.89,64.31,3384553,3384600
24042,50,79,1,10.24,137.58,3384599,3384649
24043,52,26,1,9.85,40.75,3384648,3384700
24044,37,73,3,13.84,254.46,3384699,3384736
24045,51,61,0,10.04,106.51,3384735,3384786
24046,52,31,1,9.85,55.59,3384785,3384837
24047,49,58,1,10.45,96.70,3384836,3384885
24048,38,56,3,13.47,164.83,3384884,3384922
24049,58,38,0,8.83,71.90,3384921,3384979
24050,49,62,0,10.45,153.06,3384978,3385027
24051,44,66,0,11.64,209.96,3385026,3385070
24052,86,36,0,5.95,26.60,3385069,3385155
24053,61,33,0,8.39,57.81,3385154,3385215
24054,47,120,0,10.89,427.20,3385214,3385261
24055,58,44,1,8.83,83.59,3385261,3385319
24056,66,115,0,7.76,209.61,3385318,3385384
24057,58,62,0,8.83,80.25,3385383,3385441
24058,50,45,0,10.24,75.54,3385440,3385490
24059,66,50,0,7.76,57.18,3385489,3385555
24060,60,59,0,8.53,90.82,3385554,3385614
24061,66,33,1,7.76,39.21,3385613,3385679
24062,74,52,1,6.92,49.62,3385679,3385753
24063,66,33,1,7.76,30.12,3385752,3385818
24064,60,23,1,8.53,30.98,3385817,3385877
24065,55,29,2,9.31,38.00,3385876,3385931
24066,34,75,1,15.06,223.58,3385930,3385964
24067,44,36,1,11.64,70.96,3385963,3386007
24068,54,59,0,9.48,92.84,3386006,3386060
24069,45,79,1,11.38,170.72,3386059,3386104
24070,40,46,1,12.80,116.31,3386103,3386143
24071,50,66,1,10.24,114.14,3386142,3386192
24072,43,32,2,11.91,49.06,3386191,3386234
24073,42,87,1,12.19,202.15,3386233,3386275
24074,50,53,2,10.24,73.30,3386274,3386324
24075,45,76,1,11.38,133.17,3386323,3386368
24076,40,51,2,12.80,132.76,3386367,3386407
24077,51,46,1,10.04,97.45,3386406,3386457
24078,49,83,1,10.45,210.04,3386456,3386505
24079,49,37,1,10.45,56.08,3386504,3386553
24080,41,104,1,12.49,301.03,3386552,3386593
24081,41,44,2,12.49,84.05,3386592,3386633
24082,26,154,0,19.69,856.83,3386632,3386658
24083,38,59,0,13.47,209.57,3386657,3386695
24084,35,72,1,14.63,256.92,3386694,3386729
24085,71,45,0,7.21,61.77,3386728,3386799
24086,65,44,0,7.88,64.54,3386798,3386863
24087,37,85,0,13.84,297.49,3386862,3386899
24088,74,34,0,6.92,43.32,3386898,3386972
24089,85,28,0,6.02,26.12,3386971,3387056
24090,71,40,1,7.21,49.01,3387055,3387126
24091,53,51,2,9.66,66.41,3387125,3387178
24092,59,63,1,8.68,100.49,3387177,3387236
24093,58,35,1,8.83,39.28,3387235,3387293
24094,68,30,1,7.53,31.60,3387292,3387360
24095,58,42,0,8.83,62.56,3387359,3387417
24096,50,94,1,10.24,201.58,3387416,3387466
24097,58,27,1,8.83,40.63,3387465,3387523
24098,55,64,1,9.31,104.18,3387523,3387578
24099,52,51,0,9.85,75.40,3387577,3387629
24100,38,158,1,13.47,694.09,3387628,3387666
24101,45,39,1,11.38,80.37,3387665,3387710
24102,46,39,2,11.13,80.29,3387710,3387756
24103,41,53,1,12.49,146.05,3387755,3387796
24104,38,109,1,13.47,386.09,3387795,3387833
24105,55,35,2,9.31,38.25,3387832,3387887
24106,42,39,1,12.19,92.63,3387886,3387928
24107,39,43,2,13.13,120.47,3387927,3387966
24108,39,56,2,13.13,147.14,3387965,3388004
24109,50,37,1,10.24,57.30,3388003,3388053
24110,49,37,2,10.45,51.39,3388052,3388101
24111,47,44,1,10.89,73.24,3388100,3388147
24112,48,43,1,10.67,68.43,3388146,3388194
24113,51,36,1,10.04,62.59,3388193,3388244
24114,29,250,2,17.66,1967.95,3388244,3388273
24115,25,184,1,20.48,1356.65,3388272,3388297
24116,26,72,2,19.69,321.83,3388296,3388322
24117,28,79,3,18.29,408.35,3388321,3388349
24118,42,44,1,12.19,83.34,3388348,3388390
24119,58,31,0,8.83,43.42,3388389,3388447
24120,61,53,1,8.39,74.21,3388446,3388507
24121,41,71,1,12.49,222.44,3388506,3388547
24122,37,66,1,13.84,183.81,3388546,3388583
24123,42,45,1,12.19,108.92,3388582,3388624
24124,37,96,1,13.84,326.46,3388624,3388661
24125,57,40,0,8.98,63.70,3388660,3388717
24126,61,160,0,8.39,400.37,3388717,3388778
24127,82,29,0,6.24,43.33,3388777,3388859
24128,65,70,0,7.88,136.97,3388858,3388923
24129,73,35,0,7.01,48.59,3388922,3388995
24130,61,59,0,8.39,70.01,3388994,3389055
24131,62,31,0,8.26,44.51,3389054,3389116
24132,55,54,1,9.31,97.92,3389116,3389171
24133,66,28,1,7.76,45.64,3389170,3389236
24134,48,79,2,10.67,124.31,3389235,3389283
24135,55,54,0,9.31,97.89,3389282,3389337
24136,70,28,1,7.31,28.93,3389337,3389407
24137,71,32,1,7.21,28.70,3389406,3389477
24138,39,81,0,13.13,222.11,3389476,3389515
24139,67,56,1,7.64,74.32,3389514,3389581
24140,66,38,0,7.76,43.18,3389580,3389646
24141,55,74,1,9.31,115.60,3389645,3389700
24142,58,30,0,8.83,40.66,3389700,3389758
24143,45,61,2,11.38,121.08,3389757,3389802
24144,46,59,0,11.13,88.85,3389801,3389847
24145,59,25,1,8.68,34.90,3389846,3389905
24146,55,37,0,9.31,38.90,3389904,3389959
24147,49,39,0,10.45,71.06,3389958,3390007
24148,55,32,1,9.31,42.07,3390006,3390061
24149,58,43,2,8.83,44.49,3390060,3390118
24150,48,49,1,10.67,62.89,3390117,3390165
24151,52,31,1,9.85,50.17,3390164,3390216
24152,59,34,1,8.68,34.39,3390215,3390274
24153,43,44,1,11.91,89.34,3390273,3390316
24154,57,45,2,8.98,49.77,3390315,3390372
24155,47,73,0,10.89,139.41,3390371,3390418
24156,30,86,1,17.07,389.60,3390417,3390447
24157,33,66,2,15.52,224.86,3390446,3390479
24158,64,33,0,8.00,50.12,3390478,3390542
24159,42,95,1,12.19,304.06,3390541,3390583
24160,49,53,1,10.45,97.64,3390582,3390631
24161,44,76,2,11.64,179.91,3390630,3390674
24162,52,36,1,9.85,62.78,3390673,3390725
24163,52,70,1,9.85,122.78,3390724,3390776
24164,58,34,0,8.83,46.83,3390775,3390833
24165,65,160,0,7.88,394.26,3390832,3390897
24166,58,54,0,8.83,90.52,3390896,3390954
24167,88,37,0,5.82,52.35,3390953,3391041
24168,61,55,1,8.39,153.39,3391040,3391101
24169,21,403,0,24.38,7195.09,3391100,3391121
24170,52,38,1,9.85,61.98,3391120,3391172
24171,65,45,1,7.88,69.71,3391171,3391236
24172,54,42,1,9.48,55.77,3391235,3391289
24173,49,80,1,10.45,158.37,3391288,3391337
24174,63,30,1,8.13,38.94,3391336,3391399
24175,51,42,0,10.04,64.47,3391398,3391449
24176,70,28,0,7.31,31.56,3391448,3391518
24177,56,45,0,9.14,71.91,3391517,3391573
24178,48,86,3,10.67,155.72,3391572,3391620
24179,77,30,0,6.65,27.19,3391619,3391696
24180,46,151,1,11.13,477.81,3391695,3391741
24181,38,79,1,13.47,329.67,3391740,3391778
24182,56,37,0,9.14,64.34,3391777,3391833
24183,49,27,1,10.45,30.78,3391832,3391881
24184,54,33,1,9.48,39.10,3391880,3391934
24185,40,57,1,12.80,97.71,3391933,3391973
24186,20,297,2,25.60,3983.64,3391972,3391992
24187,49,49,1,10.45,94.25,3391991,3392040
24188,51,49,1,10.04,85.49,3392039,3392090
24189,39,116,1,13.13,420.68,3392089,3392128
24190,37,43,1,13.84,110.73,3392127,3392164
24191,42,65,2,12.19,132.58,3392163,3392205
24192,45,45,2,11.38,61.79,3392204,3392249
24193,55,48,1,9.31,51.60,3392248,3392303
24194,53,44,1,9.66,52.15,3392302,3392355
24195,55,49,0,9.31,56.65,3392354,3392409
24196,41,94,1,12.49,224.74,3392408,3392449
24197,59,33,0,8.68,41.78,3392448,3392507
24198,43,58,1,11.91,149.39,3392506,3392549
24199,31,107,1,16.52,405.09,3392548,3392579
24200,46,48,1,11.13,94.68,3392578,3392624
24201,44,66,1,11.64,146.73,3392623,3392667
24202,34,102,1,15.06,335.53,3392666,3392700
24203,37,75,1,13.84,195.38,3392699,3392736
24204,42,42,1,12.19,104.49,3392735,3392777
24205,57,50,0,8.98,91.10,3392776,3392833
24206,42,68,1,12.19,182.06,3392832,3392874
24207,51,39,0,10.04,63.14,3392874,3392925
24208,68,49,0,7.53,90.13,3392925,3392993
24209,70,29,1,7.31,42.33,3392992,3393062
24210,47,68,1,10.89,190.90,3393061,3393108
24211,57,55,0,8.98,109.35,3393107,3393164
24212,58,46,0,8.83,79.90,3393163,3393221
24213,47,111,0,10.89,354.78,3393220,3393267
24214,65,42,1,7.88,64.75,3393266,3393331
24215,58,42,0,8.83,54.69,3393330,3393388
24216,59,41,1,8.68,68.18,3393387,3393446
24217,31,234,1,16.52,1649.54,3393445,3393476
24218,57,34,1,8.98,47.63,3393475,3393532
24219,73,37,0,7.01,29.93,3393531,3393604
24220,40,91,1,12.80,269.16,3393603,3393643
24221,81,33,1,6.32,33.35,3393642,3393723
24222,70,33,0,7.31,25.56,3393722,3393792
24223,38,97,1,13.47,243.67,3393792,3393830
24224,54,34,0,9.48,46.40,3393829,3393883
24225,46,26,0,11.13,36.37,3393882,3393928
24226,54,75,0,9.48,125.58,3393927,3393981
24227,47,61,1,10.89,83.46,3393980,3394027
24228,50,37,1,10.24,45.26,3394026,3394076
24229,31,71,2,16.52,236.96,3394075,3394106
24230,52,38,1,9.85,78.40,3394105,3394157
24231,40,55,2,12.80,124.21,3394156,3394196
24232,49,38,0,10.45,72.12,3394195,3394244
24233,36,55,1,14.22,150.67,3394243,3394279
24234,47,28,0,10.89,54.86,3394278,3394325
24235,44,58,1,11.64,117.69,3394324,3394368
24236,60,43,1,8.53,41.95,3394367,3394427
24237,47,44,3,10.89,55.71,3394427,3394474
24238,56,37,1,9.14,48.62,3394473,3394529
24239,50,29,1,10.24,37.98,3394528,3394578
24240,67,30,2,7.64,24.95,3394578,3394645
24241,39,51,2,13.13,102.47,3394644,3394683
24242,23,133,0,22.26,921.32,3394682,3394705
24243,37,47,1,13.84,105.38,3394705,3394742
24244,54,37,1,9.48,49.25,3394741,3394795
24245,41,38,0,12.49,88.49,3394794,3394835
24246,49,35,1,10.45,51.10,3394834,3394883
24247,36,89,1,14.22,242.67,3394882,3394918
24248,45,68,0,11.38,194.10,3394918,3394963
24249,41,70,1,12.49,183.62,3394962,3395003
24250,31,114,2,16.52,448.96,3395002,3395033
24251,45,80,0,11.38,196.81,3395032,3395077
24252,49,186,0,10.45,680.57,3395076,3395125
24253,45,82,2,11.38,199.84,3395124,3395169
24254,58,35,0,8.83,82.28,3395168,3395226
24255,50,99,0,10.24,246.30,3395225,3395275
24256,54,62,0,9.48,131.99,3395274,3395328
24257,67,39,1,7.64,45.04,3395327,3395394
24258,63,97,0,8.13,166.30,3395393,3395456
24259,58,31,1,8.83,42.25,3395456,3395514
24260,42,112,1,12.19,275.11,3395513,3395555
24261,52,83,0,9.85,183.44,3395554,3395606
24262,65,31,1,7.88,44.26,3395605,3395670
24263,71,23,0,7.21,28.62,3395669,3395740
24264,70,33,0,7.31,27.87,3395739,3395809
24265,44,61,0,11.64,203.73,3395808,3395852
24266,77,35,1,6.65,34.75,3395851,3395928
24267,55,39,1,9.31,64.90,3395928,3395983
24268,51,39,1,10.04,60.51,3395982,3396033
24269,43,82,1,11.91,174.04,3396033,3396076
24270,33,40,1,15.52,90.13,3396075,3396108
24271,55,51,0,9.31,78.54,3396107,3396162
24272,43,73,1,11.91,159.62,3396161,3396204
24273,39,59,1,13.13,175.65,3396204,3396243
24274,60,25,1,8.53,32.12,3396242,3396302
24275,43,43,2,11.91,88.60,3396301,3396344
24276,61,54,1,8.39,58.96,3396343,3396404
24277,50,41,2,10.24,57.50,3396404,3396454
24278,39,46,1,13.13,118.42,3396453,3396492
24279,42,60,1,12.19,147.20,3396491,3396533
24280,54,45,1,9.48,77.06,3396532,3396586
24281,51,33,1,10.04,63.29,3396585,3396636
24282,59,35,1,8.68,46.69,3396635,3396694
24283,57,54,0,8.98,79.81,3396693,3396750
24284,50,51,1,10.24,87.34,3396749,3396799
24285,34,55,1,15.06,180.53,3396798,3396832
24286,44,37,1,11.64,65.00,3396831,3396875
24287,45,49,1,11.38,101.75,3396874,3396919
24288,41,89,1,12.49,238.59,3396918,3396959
24289,48,55,0,10.67,115.97,3396958,3397006
24290,42,55,2,12.19,92.34,3397005,3397047
24291,6,111,67,85.33,236.22,3397046,3397052
24292,39,54,1,13.13,189.14,3397051,3397090
24293,21,328,1,24.38,4824.81,3397089,3397110
24294,67,85,0,7.64,146.17,3397109,3397176
24295,70,57,0,7.31,85.24,3397175,3397245
24296,68,57,0,7.53,82.16,3397244,3397312
24297,84,58,0,6.10,83.49,3397311,3397395
24298,65,31,1,7.88,52.75,3397394,3397459
24299,54,32,1,9.48,48.55,3397458,3397512
24300,50,53,1,10.24,112.30,3397511,3397561
24301,62,57,1,8.26,71.48,3397561,3397623
24302,51,49,1,10.04,70.63,3397622,3397673
24303,54,39,2,9.48,55.95,3397672,3397726
24304,52,67,1,9.85,92.51,3397725,3397777
24305,50,66,1,10.24,166.10,3397776,3397826
24306,68,40,1,7.53,41.40,3397826,3397894
24307,67,73,0,7.64,88.32,3397894,3397961
24308,84,28,1,6.10,22.30,3397960,3398044
24309,55,140,0,9.31,342.61,3398043,3398098
24310,61,35,1,8.39,59.94,3398097,3398158
24311,41,122,1,12.49,339.18,3398157,3398198
24312,54,30,1,9.48,40.25,3398197,3398251
24313,53,53,1,9.66,67.77,3398250,3398303
24314,23,105,1,22.26,577.24,3398302,3398325
24315,44,41,1,11.64,100.37,3398324,3398368
24316,48,39,2,10.67,63.89,3398367,3398415
24317,53,25,2,9.66,31.92,3398414,3398467
24318,45,61,1,11.38,123.12,3398466,3398511
24319,40,69,2,12.80,177.36,3398510,3398550
24320,53,32,1,9.66,44.15,3398549,3398602
24321,39,85,1,13.13,192.68,3398601,3398640
24322,48,64,1,10.67,121.64,3398639,3398687
24323,52,52,2,9.85,85.40,3398686,3398738
24324,41,29,1,12.49,43.62,3398737,3398778
24325,62,30,2,8.26,36.03,3398778,3398840
24326,44,38,1,11.64,57.32,3398839,3398883
24327,32,57,3,16.00,169.00,3398882,3398914
24328,25,61,2,20.48,251.77,3398913,3398938
24329,37,172,0,13.84,831.27,3398937,3398974
24330,60,38,0,8.53,62.55,3398973,3399033
24331,48,46,2,10.67,64.14,3399032,3399080
24332,60,39,0,8.53,41.02,3399079,3399139
24333,49,54,0,10.45,127.51,3399138,3399187
24334,43,115,0,11.91,337.71,3399186,3399229
24335,55,57,0,9.31,113.89,3399228,3399283
24336,74,45,0,6.92,64.89,3399282,3399356
24337,69,54,0,7.42,72.27,3399355,3399424
24338,59,37,1,8.68,68.79,3399424,3399483
24339,12,453,1,42.67,15317.72,3399482,3399494
24340,56,64,0,9.14,138.05,3399493,3399549
24341,53,68,0,9.66,189.24,3399548,3399601
24342,54,86,1,9.48,154.88,3399600,3399654
24343,55,39,1,9.31,68.65,3399653,3399708
24344,53,50,2,9.66,81.51,3399707,3399760
24345,52,81,0,9.85,154.48,3399759,3399811
24346,67,43,1,7.64,42.71,3399811,3399878
24347,68,26,0,7.53,29.75,3399877,3399945
24348,39,142,1,13.13,498.01,3399944,3399983
24349,58,54,0,8.83,78.14,3399983,3400041
24350,51,140,0,10.04,425.80,3400040,3400091
24351,49,48,1,10.45,104.49,3400090,3400139
24352,54,61,1,9.48,92.55,3400138,3400192
24353,49,48,0,10.45,78.70,3400192,3400241
24354,47,51,1,10.89,105.67,3400240,3400287
24355,48,62,0,10.67,97.01,3400286,3400334
24356,52,39,1,9.85,55.86,3400333,3400385
24357,48,74,1,10.67,147.47,3400384,3400432
24358,45,91,1,11.38,186.46,3400431,3400476
24359,50,59,1,10.24,107.98,3400475,3400525
24360,45,47,1,11.38,104.72,3400524,3400569
24361,47,30,2,10.89,53.33,3400568,3400615
24362,46,55,1,11.13,87.29,3400615,3400661
24363,42,51,1,12.19,97.73,3400660,3400702
24364,47,66,0,10.89,135.75,3400701,3400748
24365,49,37,3,10.45,49.06,3400747,3400796
24366,54,50,3,9.48,64.21,3400795,3400849
24367,43,103,1,11.91,238.64,3400848,3400891
24368,61,23,0,8.39,25.42,3400890,3400951
24369,29,105,1,17.66,491.54,3400950,3400979
24370,31,66,2,16.52,226.12,3400978,3401009
24371,30,64,1,17.07,202.66,3401008,3401038
24372,38,45,1,13.47,96.99,3401037,3401075
24373,60,33,0,8.53,44.12,3401074,3401134
24374,25,187,2,20.48,1282.25,3401133,3401158
24375,43,33,0,11.91,77.94,3401157,3401200
24376,40,50,1,12.80,127.16,3401199,3401239
24377,41,48,0,12.49,106.98,3401238,3401279
24378,28,125,1,18.29,593.70,3401279,3401307
24379,31,96,0,16.52,393.54,3401306,3401337
24380,47,96,0,10.89,218.78,3401336,3401383
24381,65,54,0,7.88,71.31,3401382,3401447
24382,58,52,0,8.83,93.56,3401446,3401504
24383,60,43,0,8.53,81.32,3401503,3401563
24384,67,29,0,7.64,44.32,3401562,3401629
24385,76,30,0,6.74,46.98,3401628,3401704
24386,33,75,3,15.52,307.95,3401703,3401736
24387,70,45,0,7.31,64.79,3401735,3401805
24388,58,34,2,8.83,52.14,3401804,3401862
24389,67,37,1,7.64,38.74,3401861,3401928
24390,50,60,0,10.24,119.66,3401928,3401978
24391,61,55,0,8.39,60.40,3401977,3402038
24392,58,43,1,8.83,81.56,3402037,3402095
24393,67,37,0,7.64,49.57,3402094,3402161
24394,57,61,1,8.98,99.39,3402160,3402217
24395,53,51,1,9.66,98.60,3402216,3402269
24396,53,83,1,9.66,181.21,3402268,3402321
24397,40,103,1,12.80,341.76,3402320,3402360
24398,48,36,1,10.67,87.35,3402359,3402407
24399,45,39,2,11.38,72.46,3402407,3402452
24400,42,123,1,12.19,335.49,3402451,3402493
24401,42,67,0,12.19,116.63,3402492,3402534
24402,37,52,1,13.84,129.97,3402533,3402570
24403,61,33,0,8.39,36.37,3402569,3402630
24404,40,66,4,12.80,132.11,3402629,3402669
24405,31,95,1,16.52,385.09,3402669,3402700
24406,39,58,1,13.13,137.96,3402699,3402738
24407,40,53,0,12.80,112.66,3402737,3402777
24408,55,36,2,9.31,42.32,3402776,3402831
24409,56,28,1,9.14,37.23,3402830,3402886
24410,50,34,2,10.24,45.58,3402886,3402936
24411,50,43,1,10.24,77.38,3402935,3402985
24412,50,36,1,10.24,71.10,3402984,3403034
24413,32,74,1,16.00,260.50,3403033,3403065
24414,43,75,1,11.91,143.81,3403064,3403107
24415,34,94,2,15.06,294.58,3403106,3403140
24416,41,103,0,12.49,311.32,3403140,3403181
24417,44,70,0,11.64,186.28,3403180,3403224
24418,51,111,0,10.04,259.10,3403223,3403274
24419,56,77,1,9.14,122.94,3403273,3403329
24420,56,155,0,9.14,416.27,3403328,3403384
24421,58,33,0,8.83,56.63,3403383,3403441
24422,56,69,1,9.14,115.52,3403441,3403497
24423,63,52,0,8.13,68.21,3403496,3403559
24424,51,66,1,10.04,137.14,3403558,3403609
24425,80,35,0,6.40,29.41,3403608,3403688
24426,55,29,1,9.31,50.80,3403687,3403742
24427,60,34,1,8.53,56.68,3403741,3403801
24428,58,50,1,8.83,64.28,3403800,3403858
24429,56,25,0,9.14,47.77,3403857,3403913
24430,63,35,0,8.13,54.21,3403912,3403975
24431,53,73,1,9.66,129.47,3403974,3404027
24432,49,61,1,10.45,93.59,3404026,3404075
24433,53,43,0,9.66,83.47,3404074,3404127
24434,39,58,2,13.13,138.42,3404126,3404165
24435,51,31,1,10.04,37.88,3404164,3404215
24436,50,34,1,10.24,48.98,3404214,3404264
24437,34,126,3,15.06,474.76,3404263,3404297
24438,45,60,1,11.38,152.01,3404296,3404341
24439,49,108,1,10.45,224.57,3404340,3404389
24440,48,33,1,10.67,64.89,3404388,3404436
24441,39,106,1,13.13,351.03,3404435,3404474
24442,43,33,1,11.91,55.06,3404473,3404516
24443,48,42,1,10.67,46.93,3404515,3404563
24444,44,80,1,11.64,199.10,3404562,3404606
24445,48,61,0,10.67,96.51,3404605,3404653
24446,49,48,1,10.45,72.70,3404653,3404702
24447,63,33,1,8.13,36.33,3404701,3404764
24448,49,34,2,10.45,57.06,3404764,3404813
24449,39,49,2,13.13,127.45,3404812,3404851
24450,28,85,1,18.29,389.63,3404850,3404878
24451,22,105,3,23.27,686.20,3404877,3404899
24452,35,53,1,14.63,127.43,3404898,3404933
24453,48,86,0,10.67,178.14,3404933,3404981
24454,47,46,1,10.89,85.16,3404980,3405027
24455,40,142,1,12.80,478.76,3405026,3405066
24456,43,45,1,11.91,101.20,3405065,3405108
24457,43,95,1,11.91,304.60,3405107,3405150
24458,42,78,0,12.19,239.44,3405149,3405191
24459,54,105,1,9.48,288.58,3405190,3405244
24460,70,45,0,7.31,58.04,3405244,3405314
24461,70,27,0,7.31,44.50,3405313,3405383
24462,61,33,0,8.39,41.35,3405382,3405443
24463,68,48,0,7.53,66.57,3405442,3405510
24464,72,24,0,7.11,32.49,3405509,3405581
24465,70,82,0,7.31,98.84,3405580,3405650
24466,59,40,1,8.68,55.40,3405649,3405708
24467,61,30,1,8.39,35.78,3405707,3405768
24468,51,69,1,10.04,149.88,3405767,3405818
24469,68,27,0,7.53,38.93,3405817,3405885
24470,72,28,1,7.11,27.65,3405884,3405956
24471,20,151,0,25.60,1647.24,3405955,3405975
24472,63,55,1,8.13,72.40,3405974,3406037
24473,55,35,0,9.31,62.58,3406036,3406091
24474,58,43,0,8.83,45.90,3406091,3406149
24475,59,24,1,8.68,30.69,3406148,3406207
24476,32,118,4,16.00,395.94,3406206,3406238
24477,63,47,0,8.13,51.63,3406237,3406300
24478,47,45,2,10.89,97.88,3406299,3406346
24479,26,113,2,19.69,476.67,3406345,3406371
24480,39,57,1,13.13,179.45,3406370,3406409
24481,55,39,2,9.31,45.45,3406409,3406464
24482,56,38,1,9.14,46.87,3406464,3406520
24483,50,38,1,10.24,62.22,3406520,3406570
24484,40,76,1,12.80,170.46,3406569,3406609
24485,43,69,3,11.91,120.36,3406609,3406652
24486,58,28,0,8.83,30.73,3406651,3406709
24487,49,72,2,10.45,143.64,3406708,3406757
24488,46,63,2,11.13,105.72,3406756,3406802
24489,37,104,1,13.84,420.84,3406801,3406838
24490,57,29,0,8.98,49.03,3406837,3406894
24491,44,45,1,11.64,102.87,3406893,3406937
24492,36,55,2,14.22,139.28,3406936,3406972
24493,22,101,2,23.27,448.20,3406971,3406993
24494,39,62,2,13.13,139.39,3406992,3407031
24495,60,35,0,8.53,54.08,3407031,3407091
24496,59,51,1,8.68,57.37,3407090,3407149
24497,48,33,0,10.67,57.64,3407148,3407196
24498,48,83,0,10.67,255.31,3407195,3407243
24499,56,35,0,9.14,57.02,3407242,3407298
24500,35,192,0,14.63,963.43,3407297,3407332
24501,56,41,1,9.14,58.44,3407331,3407387
24502,71,28,0,7.21,49.12,3407386,3407457
24503,59,31,1,8.68,35.27,3407456,3407515
24504,81,22,0,6.32,32.19,3407514,3407595
24505,69,39,0,7.42,57.08,3407595,3407664
24506,33,72,2,15.52,270.92,3407663,3407696
24507,48,59,0,10.67,102.76,3407695,3407743
24508,48,95,1,10.67,218.35,3407742,3407790
24509,73,25,1,7.01,24.56,3407789,3407862
24510,31,164,1,16.52,881.73,3407861,3407892
24511,56,38,1,9.14,45.69,3407892,3407948
24512,71,28,0,7.21,36.42,3407948,3408019
24513,75,21,1,6.83,16.38,3408018,3408093
24514,50,59,0,10.24,113.06,3408092,3408142
24515,48,66,1,10.67,154.85,3408141,3408189
24516,36,151,1,14.22,616.67,3408188,3408224
24517,62,37,1,8.26,38.58,3408224,3408286
24518,52,50,1,9.85,81.09,3408285,3408337
24519,54,22,0,9.48,31.25,3408336,3408390
24520,45,65,1,11.38,120.77,3408389,3408434
24521,46,39,1,11.13,81.16,3408433,3408479
24522,30,117,1,17.07,532.06,3408478,3408508
24523,37,70,2,13.84,250.08,3408507,3408544
24524,44,89,1,11.64,204.19,3408543,3408587
24525,48,65,1,10.67,116.43,3408586,3408634
24526,55,23,1,9.31,41.56,3408633,3408688
24527,54,41,1,9.48,51.25,3408687,3408741
24528,43,35,2,11.91,60.32,3408741,3408784
24529,41,92,2,12.49,224.10,3408783,3408824
24530,49,44,1,10.45,111.31,3408823,3408872
24531,48,33,1,10.67,53.06,3408871,3408919
24532,36,73,3,14.22,157.23,3408918,3408954
24533,38,89,2,13.47,351.62,3408953,3408991
24534,53,44,1,9.66,80.19,3408990,3409043
24535,30,56,1,17.07,173.06,3409042,3409072
24536,36,67,1,14.22,202.84,3409071,3409107
24537,37,78,2,13.84,206.08,3409106,3409143
24538,34,123,1,15.06,549.35,3409142,3409176
24539,37,103,1,13.84,296.08,3409176,3409213
24540,40,51,1,12.80,125.11,3409212,3409252
24541,44,48,1,11.64,130.14,3409251,3409295
24542,48,89,1,10.67,223.85,3409294,3409342
24543,52,41,0,9.85,76.86,3409341,3409393
24544,34,113,1,15.06,565.35,3409392,3409426
24545,85,50,0,6.02,43.11,3409425,3409510
24546,57,56,0,8.98,108.61,3409509,3409566
24547,71,45,0,7.21,66.28,3409566,3409637
24548,48,80,0,10.67,171.35,3409636,3409684
24549,56,127,1,9.14,328.37,3409683,3409739
24550,61,32,0,8.39,56.86,3409738,3409799
24551,66,48,0,7.76,59.15,3409798,3409864
24552,52,67,1,9.85,148.90,3409863,3409915
24553,56,39,0,9.14,56.19,3409914,3409970
24554,81,23,1,6.32,16.00,3409969,3410050
24555,55,35,1,9.31,51.85,3410049,3410104
24556,55,28,0,9.31,41.78,3410103,3410158
24557,62,60,0,8.26,106.06,3410157,3410219
24558,41,151,2,12.49,524.44,3410218,3410259
24559,50,102,1,10.24,204.22,3410259,3410309
24560,53,31,1,9.66,34.49,3410308,3410361
24561,48,44,1,10.67,66.18,3410360,3410408
24562,30,60,2,17.07,169.93,3410407,3410437
24563,38,120,2,13.47,440.30,3410436,3410474
24564,42,58,2,12.19,99.68,3410473,3410515
24565,48,53,1,10.67,109.01,3410515,3410563
24566,54,48,1,9.48,80.73,3410562,3410616
24567,45,84,1,11.38,255.26,3410615,3410660
24568,48,49,1,10.67,86.43,3410659,3410707
24569,46,62,1,11.13,117.37,3410706,3410752
24570,35,63,2,14.63,226.75,3410751,3410786
24571,43,46,1,11.91,101.81,3410785,3410828
24572,51,30,0,10.04,51.72,3410827,3410878
24573,39,117,1,13.13,364.62,3410877,3410916
24574,26,92,1,19.69,538.91,3410915,3410941
24575,47,46,0,10.89,105.54,3410940,3410987
24576,59,36,1,8.68,49.57,3410987,3411046
24577,26,187,1,19.69,1201.14,3411045,3411071
24578,27,101,2,18.96,603.59,3411070,3411097
24579,24,86,3,21.33,510.72,3411096,3411120
24580,37,128,0,13.84,440.51,3411119,3411156
24581,51,68,1,10.04,117.96,3411155,3411206
24582,36,66,1,14.22,267.01,3411205,3411241
24583,54,44,0,9.48,78.36,3411241,3411295
24584,26,271,1,19.69,2575.06,3411294,3411320
24585,20,309,1,25.60,4284.84,3411319,3411339
24586,35,239,1,14.63,1514.75,3411338,3411373
24587,68,49,0,7.53,85.25,3411372,3411440
24588,55,67,0,9.31,117.56,3411439,3411494
24589,60,34,0,8.53,78.15,3411493,3411553
24590,76,32,0,6.74,52.43,3411552,3411628
24591,69,31,1,7.42,34.82,3411627,3411696
24592,64,38,1,8.00,55.59,3411695,3411759
24593,40,71,2,12.80,188.86,3411758,3411798
24594,65,26,1,7.88,40.26,3411797,3411862
24595,69,27,0,7.42,25.43,3411861,3411930
24596,72,33,1,7.11,31.99,3411929,3412001
24597,58,38,2,8.83,48.49,3412000,3412058
24598,40,114,1,12.80,532.41,3412057,3412097
24599,69,36,1,7.42,47.29,3412096,3412165
24600,52,94,1,9.85,195.01,3412164,3412216
24601,30,167,1,17.07,869.60,3412215,3412245
24602,45,33,0,11.38,66.72,3412244,3412289
24603,34,112,1,15.06,383.35,3412288,3412322
24604,41,49,2,12.49,71.32,3412321,3412362
24605,36,91,2,14.22,252.95,3412361,3412397
24606,44,62,1,11.64,113.41,3412397,3412441
24607,58,51,1,8.83,55.14,3412440,3412498
24608,39,57,1,13.13,127.80,3412497,3412536
24609,58,39,1,8.83,62.59,3412535,3412593
24610,42,50,2,12.19,83.34,3412592,3412634
24611,38,93,0,13.47,276.72,3412633,3412671
24612,61,21,0,8.39,30.04,3412670,3412731
24613,55,39,1,9.31,51.16,3412730,3412785
24614,45,54,2,11.38,112.59,3412784,3412829
24615,49,64,1,10.45,129.06,3412828,3412877
24616,42,103,1,12.19,247.20,3412876,3412918
24617,28,69,3,18.29,332.70,3412918,3412946
24618,28,83,1,18.29,315.28,3412945,3412973
24619,29,63,1,17.66,294.43,3412972,3413001
24620,30,83,1,17.07,352.53,3413000,3413030
24621,38,63,1,13.47,188.83,3413029,3413067
24622,46,71,0,11.13,134.85,3413066,3413112
24623,44,51,1,11.64,99.64,3413111,3413155
24624,36,38,2,14.22,85.23,3413154,3413190
24625,47,45,0,10.89,129.50,3413189,3413236
24626,35,155,0,14.63,670.35,3413235,3413270
24627,25,114,2,20.48,708.81,3413269,3413294
24628,46,46,0,11.13,114.03,3413294,3413340
24629,64,65,0,8.00,105.97,3413339,3413403
24630,62,43,0,8.26,64.55,3413402,3413464
24631,48,88,0,10.67,190.68,3413463,3413511
24632,79,34,0,6.48,37.74,3413510,3413589
24633,64,45,0,8.00,98.91,3413588,3413652
24634,63,43,0,8.13,56.33,3413651,3413714
24635,47,38,1,10.89,72.61,3413714,3413761
24636,62,43,1,8.26,60.35,3413760,3413822
24637,64,46,1,8.00,46.47,3413821,3413885
24638,75,28,0,6.83,29.58,3413884,3413959
24639,67,28,1,7.64,30.23,3413958,3414025
24640,64,35,1,8.00,46.50,3414025,3414089
24641,49,63,1,10.45,154.25,3414089,3414138
24642,60,32,1,8.53,44.65,3414137,3414197
24643,61,33,1,8.39,33.71,3414196,3414257
24644,51,57,0,10.04,83.72,3414256,3414307
24645,59,51,1,8.68,66.83,3414306,3414365
24646,56,24,2,9.14,33.69,3414365,3414421
24647,45,68,2,11.38,111.17,3414420,3414465
24648,35,59,3,14.63,129.66,3414464,3414499
24649,61,53,1,8.39,54.83,3414498,3414559
24650,56,59,1,9.14,85.73,3414558,3414614
24651,45,52,1,11.38,80.24,3414613,3414658
24652,50,59,1,10.24,88.90,3414657,3414707
24653,47,35,1,10.89,47.88,3414706,3414753
24654,31,143,1,16.52,632.77,3414753,3414784
24655,49,45,2,10.45,59.80,3414783,3414832
24656,56,33,0,9.14,49.12,3414831,3414887
24657,44,48,2,11.64,72.46,3414886,3414930
24658,55,50,1,9.31,72.03,3414929,3414984
24659,44,68,2,11.64,149.91,3414983,3415027
24660,35,110,0,14.63,338.12,3415027,3415062
24661,34,46,2,15.06,118.53,3415061,3415095
24662,30,110,2,17.07,515.06,3415094,3415124
24663,51,29,1,10.04,39.80,3415123,3415174
24664,54,39,0,9.48,76.51,3415173,3415227
24665,41,42,1,12.49,96.05,3415226,3415267
24666,36,88,2,14.22,249.40,3415266,3415302
24667,52,113,0,9.85,248.90,3415301,3415353
24668,55,39,0,9.31,71.41,3415352,3415407
24669,40,56,2,12.80,131.41,3415406,3415446
24670,66,80,0,7.76,123.09,3415445,3415511
24671,63,84,0,8.13,127.57,3415510,3415573
24672,64,35,0,8.00,56.97,3415572,3415636
24673,73,57,1,7.01,88.89,3415635,3415708
24674,61,47,0,8.39,84.27,3415707,3415768
24675,58,59,2,8.83,75.35,3415767,3415825
24676,60,117,1,8.53,230.18,3415824,3415884
24677,62,35,1,8.26,41.19,3415883,3415945
24678,61,43,1,8.39,46.83,3415944,3416005
24679,47,43,1,10.89,79.16,3416005,3416052
24680,72,42,0,7.11,46.02,3416051,3416123
24681,68,54,0,7.53,52.66,3416122,3416190
24682,69,22,0,7.42,21.35,3416189,3416258
24683,64,85,0,8.00,119.12,3416257,3416321
24684,76,25,1,6.74,23.25,3416320,3416396
24685,40,135,2,12.80,501.61,3416395,3416435
24686,53,66,1,9.66,107.77,3416434,3416487
24687,39,88,1,13.13,195.03,3416486,3416525
24688,45,133,1,11.38,405.48,3416524,3416569
24689,44,50,2,11.64,75.41,3416568,3416612
24690,49,28,1,10.45,49.55,3416611,3416660
24691,38,62,1,13.47,129.88,3416659,3416697
24692,57,20,1,8.98,28.75,3416696,3416753
24693,38,79,1,13.47,190.57,3416752,3416790
24694,28,142,3,18.29,882.78,3416789,3416817
24695,42,67,1,12.19,162.58,3416816,3416858
24696,39,93,1,13.13,218.47,3416857,3416896
24697,31,105,0,16.52,354.51,3416895,3416926
24698,53,24,0,9.66,33.88,3416926,3416979
24699,44,41,1,11.64,60.78,3416978,3417022
24700,61,25,0,8.39,31.06,3417021,3417082
24701,50,153,1,10.24,450.34,3417081,3417131
24702,48,62,1,10.67,124.10,3417130,3417178
24703,29,106,2,17.66,416.23,3417177,3417206
24704,31,55,1,16.52,231.09,3417205,3417236
24705,46,56,0,11.13,139.59,3417235,3417281
24706,45,57,0,11.38,111.97,3417280,3417325
24707,45,51,1,11.38,103.44,3417324,3417369
24708,62,54,1,8.26,113.39,3417368,3417430
24709,42,57,0,12.19,134.30,3417429,3417471
24710,58,61,1,8.83,109.28,3417470,3417528
24711,73,37,1,7.01,41.93,3417527,3417600
24712,64,61,0,8.00,102.91,3417599,3417663
24713,54,70,0,9.48,192.29,3417662,3417716
24714,76,45,0,6.74,55.43,3417715,3417791
24715,76,33,0,6.74,45.98,3417790,3417866
24716,56,30,1,9.14,34.69,3417865,3417921
24717,67,34,0,7.64,59.36,3417920,3417987
24718,62,36,0,8.26,35.87,3417986,3418048
24719,65,64,0,7.88,78.14,3418047,3418112
24720,48,41,1,10.67,79.56,3418111,3418159
24721,81,21,1,6.32,21.03,3418158,3418239
24722,56,49,1,9.14,96.87,3418238,3418294
24723,46,50,1,11.13,102.07,3418293,3418339
24724,54,69,0,9.48,130.95,3418338,3418392
24725,57,69,1,8.98,90.58,3418391,3418448
24726,58,25,1,8.83,35.32,3418447,3418505
24727,40,90,2,12.80,226.66,3418504,3418544
24728,50,33,1,10.24,53.70,3418543,3418593
24729,49,57,1,10.45,89.72,3418592,3418641
24730,43,39,3,11.91,73.90,3418640,3418683
24731,34,59,2,15.06,205.94,3418682,3418716
24732,48,53,1,10.67,81.89,3418715,3418763
24733,50,51,2,10.24,66.26,3418762,3418812
24734,52,41,2,9.85,60.98,3418811,3418863
24735,49,72,1,10.45,125.10,3418862,3418911
24736,40,57,1,12.80,120.31,3418910,3418950
24737,49,52,1,10.45,113.15,3418949,3418998
24738,32,57,3,16.00,156.25,3418997,3419029
24739,53,43,2,9.66,70.60,3419028,3419081
24740,42,41,2,12.19,70.77,3419080,3419122
24741,53,29,2,9.66,37.62,3419121,3419174
24742,50,75,0,10.24,116.30,3419173,3419223
24743,51,67,1,10.04,127.25,3419222,3419273
24744,46,34,1,11.13,67.81,3419272,3419318
24745,51,38,1,10.04,67.33,3419317,3419368
24746,49,52,1,10.45,102.98,3419367,3419416
24747,44,49,0,11.64,105.00,3419415,3419459
24748,38,82,1,13.47,285.35,3419458,3419496
24749,48,44,1,10.67,111.31,3419495,3419543
24750,46,51,1,11.13,97.90,3419542,3419588
24751,67,55,0,7.64,85.78,3419587,3419654
24752,69,47,0,7.42,48.07,3419653,3419722
24753,60,31,0,8.53,53.68,3419721,3419781
24754,47,47,0,10.89,94.01,3419780,3419827
24755,61,96,0,8.39,214.86,3419826,3419887
24756,70,20,1,7.31,28.84,3419886,3419956
24757,57,94,0,8.98,183.60,3419955,3420012
24758,57,54,1,8.98,68.09,3420011,3420068
24759,60,55,1,8.53,97.82,3420067,3420127
24760,60,49,1,8.53,56.82,3420126,3420186
24761,79,29,0,6.48,34.40,3420185,3420264
24762,56,37,0,9.14,68.02,3420263,3420319
24763,72,33,1,7.11,43.74,3420318,3420390
24764,36,101,1,14.22,430.12,3420389,3420425
24765,45,46,1,11.38,107.66,3420424,3420469
24766,45,36,1,11.38,62.50,3420468,3420513
24767,47,35,1,10.89,70.44,3420512,3420559
24768,51,50,1,10.04,81.53,3420558,3420609
24769,51,105,1,10.04,209.25,3420609,3420660
24770,43,63,1,11.91,122.55,3420660,3420703
24771,34,92,0,15.06,355.41,3420702,3420736
24772,45,75,1,11.38,187.57,3420735,3420780
24773,33,104,0,15.52,314.55,3420779,3420812
24774,49,93,1,10.45,201.27,3420811,3420860
24775,54,25,1,9.48,42.10,3420859,3420913
24776,39,48,2,13.13,86.27,3420912,3420951
24777,33,79,1,15.52,357.76,3420950,3420983
24778,47,66,1,10.89,121.67,3420982,3421029
24779,44,30,1,11.64,52.10,3421028,3421072
24780,53,54,1,9.66,78.26,3421071,3421124
24781,48,37,1,10.67,59.43,3421123,3421171
24782,46,66,1,11.13,103.68,3421170,3421216
24783,55,39,0,9.31,52.80,3421215,3421270
24784,34,115,1,15.06,364.00,3421269,3421303
24785,41,51,2,12.49,133.76,3421302,3421343
24786,38,84,1,13.47,218.78,3421342,3421380
24787,37,98,1,13.84,358.62,3421379,3421416
24788,63,27,0,8.13,44.11,3421415,3421478
24789,42,90,1,12.19,249.11,3421477,3421519
24790,34,265,1,15.06,1912.41,3421518,3421552
24791,84,36,0,6.10,39.66,3421551,3421635
24792,47,37,1,10.89,74.56,3421634,3421681
24793,68,23,0,7.53,43.75,3421680,3421748
24794,51,56,1,10.04,104.74,3421747,3421798
24795,66,38,0,7.76,55.73,3421797,3421863
24796,43,106,1,11.91,284.32,3421862,3421905
24797,54,50,0,9.48,99.55,3421904,3421958
24798,71,25,1,7.21,24.79,3421957,3422028
24799,46,52,1,11.13,102.37,3422027,3422073
24800,70,24,1,7.31,29.30,3422072,3422142
24801,50,143,1,10.24,390.50,3422141,3422191
24802,60,39,1,8.53,66.25,3422190,3422250
24803,69,28,1,7.42,32.19,3422250,3422319
24804,47,47,1,10.89,94.27,3422319,3422366
24805,61,27,0,8.39,35.68,3422365,3422426
24806,60,34,1,8.53,34.92,3422425,3422485
24807,50,29,1,10.24,50.42,3422484,3422534
24808,65,20,1,7.88,24.32,3422533,3422598
24809,51,46,0,10.04,64.86,3422597,3422648
24810,53,33,1,9.66,58.04,3422647,3422700
24811,40,42,2,12.80,93.21,3422699,3422739
24812,46,83,2,11.13,167.11,3422738,3422784
24813,49,37,1,10.45,53.10,3422783,3422832
24814,53,122,1,9.66,276.83,3422831,3422884
24815,42,61,2,12.19,118.77,3422883,3422925
24816,53,52,2,9.66,65.88,3422924,3422977
24817,49,32,1,10.45,43.55,3422976,3423025
24818,54,105,0,9.48,209.73,3423025,3423079
24819,36,109,2,14.22,300.84,3423078,3423114
24820,21,163,1,24.38,1388.24,3423113,3423134
24821,24,89,2,21.33,508.64,3423133,3423157
24822,33,111,2,15.52,362.07,3423156,3423189
24823,23,64,1,22.26,287.67,3423188,3423211
24824,11,173,1,46.55,4242.61,3423210,3423221
24825,32,48,1,16.00,213.38,3423220,3423252
24826,19,279,2,26.95,3591.73,3423251,3423270
24827,30,122,1,17.07,617.66,3423269,3423299
24828,41,42,1,12.49,102.01,3423298,3423339
24829,48,54,1,10.67,81.31,3423339,3423387
24830,47,56,1,10.89,108.78,3423386,3423433
24831,62,49,1,8.26,67.00,3423432,3423494
24832,37,41,3,13.84,109.00,3423493,3423530
24833,38,105,1,13.47,338.72,3423529,3423567
24834,39,90,1,13.13,294.01,3423566,3423605
24835,31,324,0,16.52,3178.57,3423604,3423635
24836,76,45,0,6.74,66.72,3423634,3423710
24837,40,90,1,12.80,239.06,3423709,3423749
24838,83,43,0,6.17,47.03,3423748,3423831
24839,31,110,0,16.52,414.12,3423830,3423861
24840,80,33,0,6.40,50.99,3423860,3423940
24841,51,71,1,10.04,156.39,3423939,3423990
24842,62,70,0,8.26,96.97,3423989,3424051
24843,58,36,1,8.83,49.90,3424050,3424108
24844,63,43,1,8.13,45.44,3424107,3424170
24845,51,82,0,10.04,158.39,3424169,3424220
24846,55,52,1,9.31,93.67,3424219,3424274
24847,59,29,0,8.68,40.56,3424273,3424332
24848,51,105,0,10.04,230.16,3424331,3424382
24849,60,99,1,8.53,167.92,3424381,3424441
24850,50,106,0,10.24,239.42,3424440,3424490
24851,56,37,1,9.14,43.69,3424490,3424546
24852,48,26,0,10.67,35.31,3424545,3424593
24853,46,71,1,11.13,113.94,3424592,3424638
24854,45,34,1,11.38,53.61,3424637,3424682
24855,46,33,1,11.13,50.68,3424681,3424727
24856,26,82,4,19.69,458.67,3424726,3424752
24857,37,64,1,13.84,131.81,3424751,3424788
24858,53,29,0,9.66,44.64,3424787,3424840
24859,52,56,0,9.85,82.59,3424839,3424891
24860,42,48,2,12.19,99.11,3424890,3424932
24861,31,88,0,16.52,387.22,3424931,3424962
24862,40,65,1,12.80,166.96,3424961,3425001
24863,55,41,1,9.31,56.94,3425001,3425056
24864,41,60,1,12.49,143.96,3425055,3425096
24865,52,64,0,9.85,85.98,3425095,3425147
24866,51,29,1,10.04,43.76,3425146,3425197
24867,58,20,1,8.83,23.42,3425196,3425254
24868,46,69,0,11.13,145.77,3425253,3425299
24869,58,26,1,8.83,31.07,3425298,3425356
24870,40,41,0,12.80,102.31,3425356,3425396
24871,19,87,1,26.95,599.73,3425395,3425414
24872,32,64,1,16.00,199.12,3425413,3425445
24873,26,159,2,19.69,885.29,3425444,3425470
24874,54,35,0,9.48,62.55,3425469,3425523
24875,58,28,1,8.83,46.59,3425522,3425580
24876,19,191,0,26.95,1809.52,3425580,3425599
24877,39,63,0,13.13,197.70,3425598,3425637
24878,49,76,0,10.45,133.23,3425636,3425685
24879,45,60,1,11.38,132.37,3425684,3425729
24880,59,46,0,8.68,67.88,3425729,3425788
24881,14,315,1,36.57,6227.96,3425787,3425801
24882,64,85,0,8.00,187.84,3425800,3425864
24883,34,163,0,15.06,858.00,3425863,3425897
24884,55,43,1,9.31,64.47,3425896,3425951
24885,64,44,0,8.00,68.81,3425950,3426014
24886,61,55,1,8.39,112.44,3426013,3426074
24887,57,127,0,8.98,302.72,3426073,3426130
24888,41,133,1,12.49,391.52,3426129,3426170
24889,80,21,0,6.40,21.89,3426169,3426249
24890,54,35,0,9.48,51.58,3426248,3426302
24891,55,37,1,9.31,54.43,3426301,3426356
24892,60,34,1,8.53,37.68,3426355,3426415
24893,61,49,1,8.39,53.68,3426414,3426475
24894,54,61,1,9.48,108.88,3426474,3426528
24895,50,78,1,10.24,184.74,3426527,3426577
24896,55,55,1,9.31,88.32,3426576,3426631
24897,60,47,0,8.53,61.52,3426630,3426690
24898,71,31,0,7.21,38.31,3426689,3426760
24899,47,51,1,10.89,81.88,3426759,3426806
24900,41,36,1,12.49,69.27,3426805,3426846
24901,55,46,2,9.31,75.56,3426845,3426900
24902,48,49,1,10.67,77.39,3426899,3426947
24903,52,35,1,9.85,47.86,3426946,3426998
24904,43,41,1,11.91,89.62,3426997,3427040
24905,53,35,2,9.66,58.87,3427039,3427092
24906,39,183,1,13.13,815.29,3427091,3427130
24907,46,40,1,11.13,75.81,3427129,3427175
24908,47,115,0,10.89,267.29,3427174,3427221
24909,56,38,1,9.14,53.37,3427220,3427276
24910,48,62,1,10.67,113.89,3427275,3427323
24911,51,49,1,10.04,76.00,3427322,3427373
24912,53,41,1,9.66,50.38,3427372,3427425
24913,47,47,1,10.89,83.03,3427424,3427471
24914,56,25,2,9.14,32.05,3427470,3427526
24915,58,38,2,8.83,48.32,3427525,3427583
24916,40,62,1,12.80,147.06,3427582,3427622
24917,35,44,1,14.63,134.92,3427621,3427656
24918,45,97,0,11.38,211.70,3427655,3427700
24919,43,73,1,11.91,185.29,3427699,3427742
24920,48,38,0,10.67,82.35,3427741,3427789
24921,41,90,0,12.49,214.40,3427788,3427829
24922,53,66,1,9.66,123.36,3427828,3427881
24923,43,82,0,11.91,173.85,3427880,3427923
24924,52,54,0,9.85,136.40,3427922,3427974
24925,71,38,0,7.21,49.66,3427973,3428044
24926,65,35,0,7.88,44.72,3428043,3428108
24927,45,55,1,11.38,143.26,3428107,3428152
24928,83,69,0,6.17,74.00,3428151,3428234
24929,78,43,0,6.56,38.94,3428233,3428311
24930,45,116,0,11.38,506.32,3428310,3428355
24931,64,37,0,8.00,49.94,3428354,3428418
24932,49,48,1,10.45,120.49,3428417,3428466
24933,50,35,2,10.24,56.18,3428465,3428515
24934,72,43,1,7.11,44.71,3428514,3428586
24935,65,33,1,7.88,35.18,3428585,3428650
24936,41,158,2,12.49,785.96,3428649,3428690
24937,50,44,1,10.24,83.14,3428689,3428739
24938,58,33,1,8.83,34.49,3428738,3428796
24939,59,27,1,8.68,31.07,3428795,3428854
24940,31,148,1,16.52,629.99,3428853,3428884
24941,51,35,2,10.04,42.82,3428884,3428935
24942,62,39,1,8.26,48.90,3428934,3428996
24943,48,49,1,10.67,79.68,3428995,3429043
24944,49,47,1,10.45,68.82,3429043,3429092
24945,50,53,2,10.24,79.74,3429091,3429141
24946,58,31,1,8.83,37.11,3429140,3429198
24947,47,69,1,10.89,145.63,3429197,3429244
24948,46,56,1,11.13,111.46,3429243,3429289
24949,46,43,1,11.13,74.11,3429288,3429334
24950,48,29,2,10.67,35.18,3429333,3429381
24951,52,33,1,9.85,42.82,3429380,3429432
24952,48,42,1,10.67,59.68,3429431,3429479
24953,64,32,1,8.00,35.19,3429478,3429542
24954,49,70,1,10.45,108.94,3429541,3429590
24955,36,54,1,14.22,198.78,3429589,3429625
24956,24,117,2,21.33,586.39,3429624,3429648
24957,37,58,2,13.84,131.33,3429647,3429684
24958,57,47,0,8.98,77.63,3429683,3429740
24959,39,70,2,13.13,146.83,3429739,3429778
24960,31,68,2,16.52,316.12,3429777,3429808
24961,55,44,0,9.31,116.65,3429807,3429862
24962,31,83,1,16.52,358.12,3429861,3429892
24963,60,46,0,8.53,74.08,3429891,3429951
24964,59,50,0,8.68,95.74,3429950,3430009
24965,48,110,0,10.67,261.76,3430008,3430056
24966,60,32,0,8.53,71.78,3430055,3430115
24967,66,131,0,7.76,260.76,3430114,3430180
24968,42,120,0,12.19,370.87,3430179,3430221
24969,46,68,1,11.13,163.37,3430220,3430266
24970,53,100,1,9.66,207.55,3430266,3430319
24971,50,57,1,10.24,84.90,3430318,3430368
24972,53,39,1,9.66,79.73,3430367,3430420
24973,64,63,1,8.00,65.84,3430420,3430484
24974,51,94,0,10.04,185.57,3430483,3430534
24975,54,105,1,9.48,358.84,3430533,3430587
24976,56,92,1,9.14,172.30,3430586,3430642
24977,52,108,0,9.85,227.48,3430641,3430693
24978,58,40,0,8.83,72.11,3430692,3430750
24979,45,47,1,11.38,95.35,3430749,3430794
24980,47,33,2,10.89,45.54,3430793,3430840
24981,40,78,1,12.80,210.41,3430840,3430880
24982,52,31,1,9.85,43.05,3430880,3430932
24983,57,47,2,8.98,72.30,3430931,3430988
24984,56,37,1,9.14,47.87,3430987,3431043
24985,52,93,1,9.85,166.48,3431042,3431094
24986,42,62,0,12.19,174.73,3431093,3431135
24987,40,79,1,12.80,243.86,3431134,3431174
24988,42,50,1,12.19,114.77,3431173,3431215
24989,45,74,2,11.38,140.86,3431214,3431259
24990,36,87,0,14.22,253.34,3431258,3431294
24991,54,50,1,9.48,81.77,3431293,3431347
24992,37,80,1,13.84,252.73,3431346,3431383
24993,27,123,1,18.96,608.78,3431382,3431409
24994,43,36,1,11.91,65.94,3431408,3431451
24995,37,205,1,13.84,1059.05,3431450,3431487
24996,38,46,1,13.47,112.04,3431486,3431524
24997,37,70,1,13.84,233.27,3431523,3431560
24998,40,76,0,12.80,269.76,3431559,3431599
24999,34,144,1,15.06,602.58,3431598,3431632
25000,41,98,1,12.49,293.32,3431631,3431672
25001,50,227,0,10.24,990.62,3431671,3431721
25002,71,59,0,7.21,58.36,3431720,3431791
25003,60,79,0,8.53,167.95,3431790,3431850
25004,52,35,0,9.85,79.78,3431849,3431901
25005,69,52,0,7.42,53.92,3431901,3431970
25006,63,39,1,8.13,48.59,3431969,3432032
25007,41,75,2,12.49,229.81,3432031,3432072
25008,45,64,0,11.38,177.30,3432071,3432116
25009,59,36,1,8.68,53.54,3432115,3432174
25010,57,27,0,8.98,44.19,3432173,3432230
25011,59,63,1,8.68,87.17,3432229,3432288
25012,63,38,1,8.13,57.54,3432288,3432351
25013,48,72,0,10.67,173.93,3432350,3432398
25014,45,47,0,11.38,93.79,3432397,3432442
25015,42,65,1,12.19,128.30,3432441,3432483
25016,65,32,1,7.88,31.62,3432483,3432548
25017,52,96,1,9.85,168.48,3432547,3432599
25018,46,34,1,11.13,55.55,3432599,3432645
25019,53,56,2,9.66,73.09,3432644,3432697
25020,30,208,2,17.07,1316.46,3432696,3432726
25021,50,69,0,10.24,105.42,3432725,3432775
25022,41,57,0,12.49,153.62,3432774,3432815
25023,41,53,1,12.49,110.40,3432814,3432855
25024,51,43,1,10.04,62.47,3432854,3432905
25025,36,68,1,14.22,229.67,3432904,3432940
25026,58,36,1,8.83,35.28,3432939,3432997
25027,50,36,1,10.24,52.58,3432996,3433046
25028,48,34,1,10.67,61.31,3433045,3433093
25029,22,200,3,23.27,1713.11,3433092,3433114
25030,65,18,2,7.88,18.42,3433114,3433179
25031,51,40,1,10.04,79.29,3433178,3433229
25032,40,81,0,12.80,182.16,3433229,3433269
25033,31,75,1,16.52,332.64,3433268,3433299
25034,27,68,1,18.96,272.85,3433298,3433325
25035,37,84,2,13.84,209.16,3433325,3433362
25036,42,52,1,12.19,150.15,3433361,3433403
25037,33,120,1,15.52,495.10,3433402,3433435
25038,37,64,2,13.84,179.22,3433434,3433471
25039,44,50,1,11.64,109.41,3433470,3433514
25040,44,76,1,11.64,183.46,3433513,3433557
25041,33,172,1,15.52,833.70,3433556,3433589
25042,38,96,0,13.47,411.30,3433588,3433626
25043,53,45,0,9.66,116.87,3433625,3433678
25044,65,44,0,7.88,80.26,3433677,3433742
25045,62,41,1,8.26,48.84,3433741,3433803
25046,59,45,1,8.68,84.39,3433802,3433861
25047,62,73,0,8.26,129.42,3433861,3433923
25048,59,69,0,8.68,129.61,3433923,3433982
25049,55,27,1,9.31,37.70,3433981,3434036
25050,59,54,1,8.68,103.95,3434036,3434095
25051,54,45,1,9.48,80.47,3434094,3434148
25052,57,82,1,8.98,168.75,3434147,3434204
25053,76,33,1,6.74,27.40,3434203,3434279
25054,62,32,1,8.26,41.39,3434278,3434340
25055,54,34,1,9.48,59.88,3434339,3434393
25056,83,34,0,6.17,29.54,3434392,3434475
25057,80,32,0,6.40,28.32,3434474,3434554
25058,48,53,1,10.67,91.39,3434553,3434601
25059,30,83,2,17.07,299.00,3434600,3434630
25060,43,72,0,11.91,170.08,3434629,3434672
25061,54,41,2,9.48,52.84,3434671,3434725
25062,43,40,1,11.91,67.11,3434724,3434767
25063,55,33,1,9.31,41.63,3434766,3434821
25064,49,52,1,10.45,103.06,3434820,3434869
25065,46,41,2,11.13,61.50,3434868,3434914
25066,45,51,2,11.38,98.32,3434913,3434958
25067,54,32,1,9.48,51.77,3434957,3435011
25068,42,62,0,12.19,102.11,3435010,3435052
25069,41,30,1,12.49,59.03,3435051,3435092
25070,57,32,1,8.98,38.51,3435091,3435148
25071,32,94,2,16.00,464.31,3435147,3435179
25072,39,107,0,13.13,287.03,3435178,3435217
25073,47,41,1,10.89,69.20,3435216,3435263
25074,50,40,1,10.24,61.30,3435262,3435312
25075,52,32,2,9.85,37.32,3435311,3435363
25076,56,43,1,9.14,65.23,3435363,3435419
25077,42,78,1,12.19,180.73,3435418,3435460
25078,42,66,1,12.19,168.96,3435459,3435501
25079,35,60,0,14.63,155.49,3435500,3435535
25080,40,62,1,12.80,169.96,3435534,3435574
25081,45,63,0,11.38,124.46,3435573,3435618
25082,39,42,1,13.13,113.29,3435617,3435656
25083,37,112,0,13.84,342.78,3435655,3435692
25084,57,41,0,8.98,80.23,3435691,3435748
25085,66,44,0,7.76,66.00,3435747,3435813
25086,61,36,0,8.39,64.47,3435812,3435873
25087,68,49,0,7.53,94.51,3435872,3435940
25088,46,106,0,11.13,275.11,3435939,3435985
25089,58,106,1,8.83,187.07,3435984,3436042
25090,67,32,0,7.64,53.93,3436041,3436108
25091,77,30,1,6.65,33.29,3436108,3436185
25092,49,40,1,10.45,84.25,3436185,3436234
25093,66,45,0,7.76,57.64,3436233,3436299
25094,61,41,1,8.39,61.32,3436298,3436359
25095,61,34,1,8.39,41.52,3436358,3436419
25096,61,43,1,8.39,53.62,3436418,3436479
25097,53,57,0,9.66,136.38,3436478,3436531
25098,47,66,1,10.89,116.86,3436530,3436577
25099,59,72,1,8.68,111.85,3436576,3436635
25100,59,91,1,8.68,172.32,3436634,3436693
25101,69,29,0,7.42,30.94,3436692,3436761
25102,42,170,0,12.19,665.25,3436760,3436802
25103,48,42,0,10.67,92.76,3436801,3436849
25104,47,66,1,10.89,104.82,3436848,3436895
25105,51,59,1,10.04,101.88,3436894,3436945
25106,42,57,3,12.19,95.54,3436944,3436986
25107,28,124,2,18.29,612.49,3436985,3437013
25108,59,38,1,8.68,44.25,3437012,3437071
25109,51,42,2,10.04,75.88,3437071,3437122
25110,33,57,3,15.52,206.19,3437121,3437154
25111,38,91,1,13.47,264.51,3437153,3437191
25112,58,42,1,8.83,50.87,3437190,3437248
25113,27,78,1,18.96,312.18,3437247,3437274
25114,46,31,1,11.13,37.98,3437273,3437319
25115,43,82,1,11.91,181.94,3437319,3437362
25116,49,32,2,10.45,42.66,3437361,3437410
25117,36,89,1,14.22,226.06,3437409,3437445
25118,44,39,1,11.64,85.28,3437444,3437488
25119,50,64,1,10.24,86.46,3437488,3437538
25120,51,107,0,10.04,232.19,3437537,3437588
25121,33,76,1,15.52,245.46,3437587,3437620
25122,29,89,1,17.66,331.67,3437619,3437648
25123,10,206,2,51.20,3855.76,3437647,3437657
25124,33,76,2,15.52,243.52,3437657,3437690
25125,39,41,2,13.13,87.29,3437690,3437729
25126,52,32,1,9.85,55.36,3437728,3437780
25127,44,78,1,11.64,236.96,3437780,3437824
25128,43,73,0,11.91,148.55,3437824,3437867
25129,40,82,1,12.80,208.66,3437866,3437906
25130,45,52,1,11.38,124.99,3437905,3437950
25131,26,282,0,19.69,2806.75,3437950,3437976
25132,46,71,0,11.13,194.07,3437975,3438021
25133,64,43,0,8.00,66.97,3438020,3438084
25134,97,25,0,5.28,24.65,3438083,3438180
25135,55,40,0,9.31,46.07,3438179,3438234
25136,70,36,1,7.31,67.24,3438233,3438303
25137,56,56,1,9.14,115.98,3438302,3438358
25138,93,47,0,5.51,53.80,3438357,3438450
25139,66,30,2,7.76,34.30,3438449,3438515
25140,58,38,1,8.83,50.49,3438514,3438572
25141,56,52,1,9.14,71.87,3438571,3438627
25142,46,89,1,11.13,183.81,3438626,3438672
25143,57,66,1,8.98,82.68,3438672,3438729
25144,58,36,1,8.83,58.18,3438728,3438786
25145,56,97,1,9.14,171.41,3438785,3438841
25146,48,71,0,10.67,177.85,3438840,3438888
25147,42,126,0,12.19,410.15,3438887,3438929
25148,52,44,1,9.85,77.86,3438928,3438980
25149,43,43,2,11.91,91.71,3438980,3439023
25150,51,36,0,10.04,66.82,3439022,3439073
25151,52,86,1,9.85,147.32,3439072,3439124
25152,44,81,0,11.64,195.50,3439123,3439167
25153,52,50,0,9.85,85.51,3439166,3439218
25154,51,36,0,10.04,45.10,3439217,3439268
25155,43,37,3,11.91,62.64,3439267,3439310
25156,38,56,3,13.47,119.83,3439310,3439348
25157,47,81,1,10.89,157.80,3439347,3439394
25158,53,76,1,9.66,114.56,3439393,3439446
25159,38,63,3,13.47,151.20,3439445,3439483
25160,35,51,3,14.63,132.98,3439482,3439517
25161,47,49,0,10.89,70.82,3439516,3439563
25162,35,91,1,14.63,394.06,3439562,3439597
25163,48,50,2,10.67,65.68,3439596,3439644
25164,43,45,2,11.91,91.20,3439643,3439686
25165,40,70,1,12.80,174.51,3439686,3439726
25166,52,27,2,9.85,29.48,3439725,3439777
25167,40,96,2,12.80,281.51,3439776,3439816
25168,52,52,1,9.85,64.55,3439816,3439868
25169,42,61,1,12.19,138.73,3439867,3439909
25170,53,54,0,9.66,83.73,3439908,3439961
25171,44,75,1,11.64,163.19,3439960,3440004
25172,41,82,1,12.49,184.40,3440003,3440044
25173,44,47,0,11.64,72.10,3440043,3440087
25174,31,101,0,16.52,532.96,3440086,3440117
25175,42,62,0,12.19,217.34,3440116,3440158
25176,35,161,0,14.63,721.66,3440157,3440192
25177,5,286,10,102.40,13252.24,3440191,3440196
25178,38,157,1,13.47,639.83,3440195,3440233
25179,68,36,0,7.53,61.22,3440233,3440301
25180,64,23,0,8.00,35.62,3440300,3440364
25181,52,76,0,9.85,146.05,3440363,3440415
25182,68,90,0,7.53,144.19,3440414,3440482
25183,46,47,1,11.13,119.98,3440481,3440527
25184,44,53,1,11.64,116.82,3440526,3440570
25185,70,32,1,7.31,37.10,3440569,3440639
25186,54,32,1,9.48,46.69,3440638,3440692
25187,48,97,0,10.67,203.26,3440691,3440739
25188,57,39,1,8.98,61.07,3440738,3440795
25189,64,38,1,8.00,59.78,3440794,3440858
25190,69,46,0,7.42,63.69,3440857,3440926
25191,61,34,1,8.39,50.70,3440925,3440986
25192,68,36,1,7.53,38.90,3440985,3441053
25193,48,76,1,10.67,167.39,3441052,3441100
25194,47,68,1,10.89,101.92,3441100,3441147
25195,46,50,1,11.13,60.94,3441146,3441192
25196,33,73,5,15.52,243.70,3441191,3441224
25197,63,25,1,8.13,36.46,3441223,3441286
25198,45,84,2,11.38,175.92,3441286,3441331
25199,59,40,1,8.68,43.40,3441330,3441389
25200,46,58,0,11.13,109.59,3441388,3441434
25201,42,125,1,12.19,380.49,3441433,3441475
25202,42,34,2,12.19,63.54,3441475,3441517
25203,42,77,1,12.19,212.15,3441516,3441558
25204,54,39,1,9.48,37.77,3441557,3441611
25205,43,79,1,11.91,167.11,3441611,3441654
25206,51,36,1,10.04,51.33,3441654,3441705
25207,45,61,1,11.38,151.66,3441705,3441750
25208,56,30,1,9.14,37.12,3441749,3441805
25209,46,55,2,11.13,78.20,3441804,3441850
25210,37,57,0,13.84,147.54,3441849,3441886
25211,25,97,1,20.48,548.97,3441885,3441910
25212,29,72,1,17.66,304.85,3441909,3441938
25213,25,124,1,20.48,755.05,3441937,3441962
25214,31,201,1,16.52,1250.83,3441961,3441992
25215,55,38,2,9.31,44.98,3441991,3442046
25216,52,49,2,9.85,56.17,3442045,3442097
25217,55,55,1,9.31,99.70,3442096,3442151
25218,47,41,1,10.89,92.69,3442150,3442197
25219,60,44,0,8.53,71.35,3442196,3442256
25220,61,64,0,8.39,102.24,3442255,3442316
25221,43,42,1,11.91,87.11,3442315,3442358
25222,60,94,0,8.53,203.32,3442357,3442417
25223,66,39,1,7.76,67.24,3442416,3442482
25224,81,61,0,6.32,90.88,3442481,3442562
25225,86,73,0,5.95,95.72,3442561,3442647
25226,47,97,0,10.89,240.01,3442646,3442693
25227,52,36,0,9.85,65.55,3442693,3442745
25228,70,39,1,7.31,55.22,3442745,3442815
25229,66,25,1,7.76,35.34,3442814,3442880
25230,52,61,1,9.85,92.86,3442879,3442931
25231,61,42,1,8.39,53.39,3442930,3442991
25232,72,56,1,7.11,59.18,3442990,3443062
25233,72,34,1,7.11,39.74,3443061,3443133
25234,58,81,1,8.83,128.66,3443132,3443190
25235,54,31,0,9.48,49.58,3443189,3443243
25236,47,49,1,10.89,103.12,3443242,3443289
25237,50,26,0,10.24,49.26,3443288,3443338
25238,53,42,1,9.66,60.53,3443337,3443390
25239,50,57,1,10.24,87.86,3443389,3443439
25240,41,46,1,12.49,78.20,3443438,3443479
25241,46,88,1,11.13,193.85,3443478,3443524
25242,37,57,4,13.84,130.57,3443523,3443560
25243,51,34,1,10.04,39.37,3443559,3443610
25244,46,83,2,11.13,169.90,3443609,3443655
25245,37,47,1,13.84,127.11,3443655,3443692
25246,62,49,0,8.26,52.87,3443691,3443753
25247,47,54,0,10.89,111.97,3443752,3443799
25248,47,56,1,10.89,125.24,3443798,3443845
25249,30,98,3,17.07,312.80,3443844,3443874
25250,43,44,1,11.91,60.64,3443873,3443916
25251,48,30,1,10.67,46.64,3443915,3443963
25252,42,50,1,12.19,77.77,3443962,3444004
25253,42,50,1,12.19,107.49,3444003,3444045
25254,40,109,1,12.80,302.96,3444044,3444084
25255,43,52,1,11.91,138.55,3444083,3444126
25256,54,36,1,9.48,61.66,3444125,3444179
25257,48,46,1,10.67,95.10,3444178,3444226
25258,32,66,3,16.00,190.94,3444225,3444257
25259,16,174,4,32.00,1678.50,3444256,3444272
25260,33,63,3,15.52,184.61,3444271,3444304
25261,52,58,1,9.85,96.59,3444303,3444355
25262,54,61,1,9.48,79.36,3444354,3444408
25263,46,81,1,11.13,179.42,3444407,3444453
25264,54,39,0,9.48,75.03,3444452,3444506
25265,54,80,0,9.48,158.06,3444506,3444560
25266,33,206,1,15.52,1200.73,3444559,3444592
25267,29,295,0,17.66,2799.95,3444591,3444620
25268,50,62,0,10.24,132.38,3444619,3444669
25269,78,37,1,6.56,41.25,3444668,3444746
25270,45,114,1,11.38,296.59,3444745,3444790
25271,56,35,0,9.14,75.34,3444789,3444845
25272,61,36,0,8.39,72.60,3444844,3444905
25273,45,112,1,11.38,299.12,3444904,3444949
25274,70,50,0,7.31,88.84,3444948,3445018
25275,52,67,1,9.85,93.98,3445017,3445069
25276,70,29,0,7.31,31.96,3445068,3445138
25277,60,39,0,8.53,58.55,3445137,3445197
25278,61,36,1,8.39,41.65,3445196,3445257
25279,51,78,0,10.04,132.74,3445256,3445307
25280,51,74,1,10.04,147.92,3445306,3445357
25281,65,65,1,7.88,73.71,3445356,3445421
25282,49,59,0,10.45,129.27,3445420,3445469
25283,62,33,0,8.26,53.97,3445468,3445530
25284,50,105,1,10.24,217.58,3445529,3445579
25285,51,47,1,10.04,71.14,3445578,3445629
25286,51,36,1,10.04,57.10,3445629,3445680
25287,73,40,1,7.01,34.67,3445679,3445752
25288,47,32,1,10.89,44.56,3445751,3445798
25289,48,34,2,10.67,50.85,3445797,3445845
25290,24,297,1,21.33,3352.97,3445844,3445868
25291,40,55,1,12.80,161.91,3445867,3445907
25292,51,50,2,10.04,72.98,3445906,3445957
25293,39,52,1,13.13,151.50,3445956,3445995
25294,44,54,0,11.64,123.55,3445994,3446038
25295,34,77,2,15.06,381.41,3446037,3446071
25296,53,38,0,9.66,59.70,3446070,3446123
25297,51,53,1,10.04,70.39,3446123,3446174
25298,46,45,2,11.13,74.03,3446173,3446219
25299,48,35,0,10.67,48.85,3446219,3446267
25300,39,92,1,13.13,222.83,3446266,3446305
25301,47,47,2,10.89,66.90,3446304,3446351
25302,47,50,1,10.89,126.56,3446350,3446397
25303,53,29,1,9.66,35.28,3446396,3446449
25304,53,69,2,9.66,98.53,3446448,3446501
25305,46,105,1,11.13,285.46,3446500,3446546
25306,33,54,1,15.52,152.07,3446545,3446578
25307,41,88,1,12.49,197.91,3446577,3446618
25308,39,57,1,13.13,182.78,3446617,3446656
25309,45,106,1,11.38,295.12,3446655,3446700
25310,48,57,2,10.67,122.89,3446699,3446747
25311,57,55,1,8.98,77.77,3446746,3446803
25312,41,76,0,12.49,170.20,3446802,3446843
25313,51,112,1,10.04,262.94,3446842,3446893
25314,45,67,0,11.38,144.24,3446892,3446937
25315,41,54,0,12.49,173.62,3446936,3446977
25316,90,38,0,5.69,37.46,3446976,3447066
25317,70,27,0,7.31,29.24,3447065,3447135
25318,84,52,0,6.10,52.63,3447134,3447218
25319,46,70,0,11.13,155.33,3447217,3447263
25320,69,34,0,7.42,54.82,3447262,3447331
25321,55,51,1,9.31,77.85,3447330,3447385
25322,70,39,0,7.31,33.24,3447384,3447454
25323,62,64,2,8.26,88.77,3447453,3447515
25324,64,59,0,8.00,70.56,3447514,3447578
25325,60,58,1,8.53,88.42,3447577,3447637
25326,61,46,1,8.39,78.40,3447636,3447697
25327,61,29,1,8.39,35.26,3447696,3447757
25328,67,36,0,7.64,43.69,3447756,3447823
25329,63,39,1,8.13,67.63,3447822,3447885
25330,37,54,1,13.84,145.43,3447884,3447921
25331,59,49,1,8.68,55.37,3447920,3447979
25332,45,33,0,11.38,49.84,3447978,3448023
25333,57,68,1,8.98,96.26,3448022,3448079
25334,47,63,0,10.89,86.35,3448078,3448125
25335,53,45,1,9.66,72.00,3448124,3448177
25336,40,50,1,12.80,84.46,3448176,3448216
25337,49,51,1,10.45,74.21,3448215,3448264
25338,59,29,1,8.68,35.91,3448263,3448322
25339,50,48,2,10.24,90.66,3448322,3448372
25340,54,73,2,9.48,99.58,3448371,3448425
25341,41,61,0,12.49,182.93,3448424,3448465
25342,47,33,2,10.89,49.75,3448464,3448511
25343,55,56,1,9.31,66.50,3448510,3448565
25344,46,87,1,11.13,177.33,3448564,3448610
25345,58,36,0,8.83,42.35,3448609,3448667
25346,55,36,1,9.31,48.72,3448666,3448721
25347,51,40,1,10.04,69.21,3448720,3448771
25348,62,36,1,8.26,46.48,3448770,3448832
25349,45,56,1,11.38,122.95,3448831,3448876
25350,38,106,1,13.47,293.04,3448875,3448913
25351,30,80,1,17.07,306.93,3448912,3448942
25352,34,70,2,15.06,221.00,3448941,3448975
25353,38,57,1,13.47,130.46,3448974,3449012
25354,39,43,0,13.13,141.60,3449011,3449050
25355,30,76,2,17.07,281.13,3449049,3449079
25356,47,34,1,10.89,78.27,3449078,3449125
25357,38,143,0,13.47,498.62,3449124,3449162
25358,43,74,1,11.91,214.88,3449162,3449205
25359,51,38,0,10.04,106.39,3449204,3449255
25360,56,43,1,9.14,62.80,3449254,3449310
25361,63,44,0,8.13,79.67,3449309,3449372
25362,76,31,0,6.74,31.64,3449371,3449447
25363,51,107,0,10.04,290.63,3449446,3449497
25364,51,38,0,10.04,105.17,3449496,3449547
25365,56,92,1,9.14,177.09,3449546,3449602
25366,78,32,0,6.56,41.84,3449601,3449679
25367,48,42,1,10.67,77.35,3449678,3449726
25368,65,56,0,7.88,82.57,3449725,3449790
25369,60,37,1,8.53,53.82,3449789,3449849
25370,65,44,1,7.88,41.52,3449848,3449913
25371,56,41,1,9.14,56.27,3449912,3449968
25372,67,52,0,7.64,77.66,3449967,3450034
25373,62,40,0,8.26,55.29,3450034,3450096
25374,78,52,0,6.56,42.55,3450095,3450173
25375,41,178,1,12.49,746.30,3450172,3450213
25376,63,40,0,8.13,61.25,3450212,3450275
25377,51,26,1,10.04,40.16,3450274,3450325
25378,55,41,1,9.31,44.21,3450324,3450379
25379,49,27,2,10.45,30.94,3450378,3450427
25380,46,49,3,11.13,73.37,3450426,3450472
25381,53,39,1,9.66,56.41,3450471,3450524
25382,53,31,2,9.66,50.53,3450523,3450576
25383,59,51,1,8.68,60.01,3450575,3450634
25384,51,50,2,10.04,77.10,3450633,3450684
25385,44,72,1,11.64,157.14,3450683,3450727
25386,54,31,1,9.48,38.29,3450726,3450780
25387,42,47,1,12.19,81.30,3450779,3450821
25388,49,41,1,10.45,70.94,3450820,3450869
25389,48,41,2,10.67,67.18,3450868,3450916
25390,48,34,1,10.67,66.85,3450915,3450963
25391,40,57,1,12.80,127.11,3450962,3451002
25392,45,106,1,11.38,356.81,3451001,3451046
25393,44,102,1,11.64,269.50,3451045,3451089
25394,22,128,1,23.27,796.11,3451088,3451110
25395,24,115,2,21.33,759.06,3451109,3451133
25396,50,128,1,10.24,319.62,3451132,3451182
25397,49,39,0,10.45,63.68,3451181,3451230
25398,57,74,0,8.98,127.21,3451229,3451286
25399,43,48,1,11.91,98.55,3451285,3451328
25400,39,96,2,13.13,242.37,3451327,3451366
25401,75,53,0,6.83,70.12,3451365,3451440
25402,53,53,1,9.66,87.39,3451439,3451492
25403,60,64,1,8.53,117.08,3451491,3451551
25404,70,61,1,7.31,70.79,3451551,3451621
25405,78,32,0,6.56,43.25,3451620,3451698
25406,47,94,0,10.89,191.07,3451697,3451744
25407,65,37,0,7.88,49.22,3451743,3451808
25408,51,71,1,10.04,157.02,3451807,3451858
25409,56,40,1,9.14,69.05,3451857,3451913
25410,48,56,1,10.67,103.60,3451912,3451960
25411,60,107,0,8.53,189.98,3451959,3452019
25412,52,103,1,9.85,205.82,3452019,3452071
25413,68,40,1,7.53,54.69,3452070,3452138
25414,34,121,1,15.06,737.76,3452137,3452171
25415,32,77,0,16.00,373.56,3452171,3452203
25416,45,128,1,11.38,380.59,3452202,3452247
25417,47,36,0,10.89,57.12,3452246,3452293
25418,50,40,2,10.24,82.94,3452292,3452342
25419,43,45,1,11.91,88.74,3452341,3452384
25420,36,60,1,14.22,149.12,3452383,3452419
25421,53,28,1,9.66,45.13,3452418,3452471
25422,61,40,1,8.39,44.83,3452470,3452531
25423,37,80,3,13.84,191.81,3452530,3452567
25424,50,43,1,10.24,66.94,3452566,3452616
25425,43,79,2,11.91,195.67,3452615,3452658
25426,48,29,3,10.67,45.22,3452657,3452705
25427,33,88,1,15.52,434.31,3452704,3452737
25428,50,42,2,10.24,52.26,3452736,3452786
25429,40,150,0,12.80,523.71,3452785,3452825
25430,53,59,1,9.66,77.02,3452824,3452877
25431,51,33,0,10.04,48.35,3452876,3452927
25432,57,28,0,8.98,55.81,3452926,3452983
25433,42,40,3,12.19,71.15,3452982,3453024
25434,32,55,1,16.00,190.25,3453023,3453055
25435,28,107,3,18.29,400.28,3453054,3453082
25436,22,72,1,23.27,349.02,3453081,3453103
25437,36,73,3,14.22,168.90,3453102,3453138
25438,26,115,5,19.69,504.75,3453137,3453163
25439,45,33,2,11.38,65.48,3453162,3453207
25440,29,221,1,17.66,1556.78,3453206,3453235
25441,33,88,1,15.52,494.37,3453234,3453267
25442,34,90,1,15.06,341.35,3453266,3453300
25443,24,62,0,21.33,382.64,3453299,3453323
25444,65,34,0,7.88,57.09,3453322,3453387
25445,43,41,1,11.91,97.81,3453386,3453429
25446,28,102,1,18.29,546.63,3453428,3453456
25447,53,44,1,9.66,63.96,3453455,3453508
25448,74,42,0,6.92,65.62,3453507,3453581
25449,58,54,1,8.83,59.18,3453580,3453638
25450,54,53,1,9.48,117.25,3453637,3453691
25451,53,55,0,9.66,131.32,3453690,3453743
25452,40,63,1,12.80,157.76,3453742,3453782
25453,66,63,0,7.76,117.55,3453781,3453847
25454,54,65,1,9.48,154.10,3453846,3453900
25455,59,52,1,8.68,76.01,3453899,3453958
25456,55,64,0,9.31,106.18,3453957,3454012
25457,22,238,1,23.27,2503.83,3454011,3454033
25458,68,55,0,7.53,59.78,3454032,3454100
25459,52,46,1,9.85,101.78,3454099,3454151
25460,57,56,1,8.98,82.96,3454150,3454207
25461,52,96,1,9.85,207.48,3454207,3454259
25462,49,56,1,10.45,138.78,3454258,3454307
25463,61,53,0,8.39,81.81,3454306,3454367
25464,52,67,1,9.85,129.17,3454366,3454418
25465,38,177,1,13.47,782.83,3454417,3454455
25466,43,114,2,11.91,456.36,3454454,3454497
25467,55,33,0,9.31,46.47,3454496,3454551
25468,53,37,0,9.66,66.19,3454550,3454603
25469,45,62,1,11.38,103.48,3454602,3454647
25470,49,70,2,10.45,127.06,3454646,3454695
25471,43,69,0,11.91,183.62,3454694,3454737
25472,47,63,2,10.89,141.75,3454736,3454783
25473,41,117,1,12.49,347.81,3454782,3454823
25474,43,102,1,11.91,261.11,3454822,3454865
25475,57,25,1,8.98,31.56,3454864,3454921
25476,36,101,0,14.22,368.84,3454920,3454956
25477,56,34,1,9.14,46.87,3454955,3455011
25478,50,41,1,10.24,58.78,3455010,3455060
25479,46,66,1,11.13,121.29,3455059,3455105
25480,45,54,2,11.38,96.32,3455104,3455149
25481,47,31,1,10.89,47.92,3455149,3455196
25482,54,28,1,9.48,39.03,3455195,3455249
25483,53,36,1,9.66,43.36,3455248,3455301
25484,63,21,1,8.13,27.51,3455300,3455363
25485,54,53,1,9.48,66.21,3455362,3455416
25486,26,101,1,19.69,399.44,3455415,3455441
25487,31,61,2,16.52,224.96,3455440,3455471
25488,42,46,1,12.19,96.39,3455470,3455512
25489,49,42,1,10.45,94.33,3455511,3455560
25490,33,140,1,15.52,668.01,3455559,3455592
25491,47,48,1,10.89,104.01,3455591,3455638
25492,36,191,1,14.22,929.23,3455637,3455673
25493,63,29,0,8.13,49.44,3455672,3455735
25494,46,78,1,11.13,214.50,3455734,3455780
25495,39,71,1,13.13,226.68,3455779,3455818
25496,84,28,0,6.10,25.94,3455817,3455901
25497,66,47,0,7.76,87.40,3455900,3455966
25498,72,37,0,7.11,46.46,3455966,3456038
25499,42,82,1,12.19,349.87,3456037,3456079
25500,40,98,1,12.80,273.76,3456078,3456118
25501,79,55,0,6.48,65.34,3456118,3456197
25502,55,31,1,9.31,56.25,3456196,3456251
25503,77,30,1,6.65,27.29,3456250,3456327
25504,68,24,0,7.53,31.07,3456326,3456394
25505,76,32,1,6.74,30.75,3456393,3456469
25506,65,40,1,7.88,50.69,3456468,3456533
25507,66,29,1,7.76,35.82,3456532,3456598
25508,58,128,1,8.83,268.11,3456597,3456655
25509,60,72,1,8.53,102.68,3456654,3456714
25510,70,23,1,7.31,23.79,3456713,3456783
25511,63,22,1,8.13,20.59,3456782,3456845
25512,62,38,1,8.26,61.22,3456844,3456906
25513,43,127,1,11.91,357.71,3456905,3456948
25514,47,44,1,10.89,71.80,3456947,3456994
25515,47,50,1,10.89,83.29,3456993,3457040
25516,41,50,2,12.49,97.66,3457039,3457080
25517,56,50,2,9.14,68.59,3457079,3457135
25518,54,40,2,9.48,53.43,3457135,3457189
25519,52,45,1,9.85,64.05,3457188,3457240
25520,46,58,1,11.13,109.85,3457240,3457286
25521,41,66,1,12.49,132.69,3457285,3457326
25522,50,59,2,10.24,101.42,3457325,3457375
25523,45,29,0,11.38,46.10,3457374,3457419
25524,55,27,1,9.31,39.74,3457418,3457473
25525,50,40,0,10.24,60.14,3457472,3457522
25526,45,91,2,11.38,183.57,3457521,3457566
25527,52,62,1,9.85,115.94,3457566,3457618
25528,38,45,2,13.47,116.09,3457617,3457655
25529,56,67,1,9.14,103.69,3457655,3457711
25530,34,190,1,15.06,1051.35,3457710,3457744
25531,57,51,2,8.98,53.70,3457743,3457800
25532,30,195,1,17.07,1232.40,3457799,3457829
25533,41,48,1,12.49,119.71,3457828,3457869
25534,33,67,1,15.52,216.92,3457868,3457901
25535,39,87,0,13.13,231.19,3457900,3457939
25536,53,47,1,9.66,63.09,3457938,3457991
25537,50,123,0,10.24,315.82,3457990,3458040
25538,24,136,1,21.33,960.56,3458039,3458063
25539,48,46,1,10.67,79.43,3458062,3458110
25540,65,67,0,7.88,94.88,3458109,3458174
25541,75,27,0,6.83,34.62,3458173,3458248
25542,69,36,0,7.42,62.85,3458247,3458316
25543,64,72,0,8.00,106.84,3458315,3458379
25544,96,26,0,5.33,25.58,3458378,3458474
25545,51,47,0,10.04,111.92,3458474,3458525
25546,39,118,1,13.13,398.32,3458524,3458563
25547,54,97,0,9.48,171.81,3458563,3458617
25548,40,98,3,12.80,230.16,3458616,3458656
25549,57,34,1,8.98,42.79,3458655,3458712
25550,53,27,1,9.66,39.24,3458711,3458764
25551,63,24,1,8.13,36.08,3458763,3458826
25552,56,50,1,9.14,80.12,3458825,3458881
25553,40,50,2,12.80,149.56,3458880,3458920
25554,34,83,2,15.06,467.11,3458919,3458953
25555,44,83,2,11.64,275.28,3458952,3458996
25556,41,174,1,12.49,692.20,3458996,3459037
25557,38,123,1,13.47,372.46,3459036,3459074
25558,52,46,0,9.85,72.55,3459073,3459125
25559,39,40,0,13.13,81.19,3459124,3459163
25560,55,26,1,9.31,39.74,3459162,3459217
25561,43,105,1,11.91,247.29,3459216,3459259
25562,35,114,4,14.63,338.18,3459258,3459293
25563,36,41,1,14.22,115.67,3459292,3459328
25564,64,26,1,8.00,35.38,3459327,3459391
25565,55,43,2,9.31,51.23,3459390,3459445
25566,37,71,1,13.84,159.43,3459444,3459481
25567,36,85,1,14.22,216.56,3459480,3459516
25568,30,57,4,17.07,173.40,3459515,3459545
25569,25,89,1,20.48,522.57,3459544,3459569
25570,45,42,2,11.38,80.06,3459568,3459613
25571,52,37,1,9.85,63.21,3459612,3459664
25572,48,43,1,10.67,85.81,3459663,3459711
25573,63,22,1,8.13,23.06,3459710,3459773
25574,41,101,0,12.49,261.37,3459772,3459813
25575,39,75,1,13.13,219.45,3459812,3459851
25576,23,100,2,22.26,507.76,3459850,3459873
25577,43,96,1,11.91,225.06,3459872,3459915
25578,27,93,0,18.96,458.48,3459914,3459941
25579,2,502,10,256.00,60516.00,3459940,3459942
25580,58,29,1,8.83,50.04,3459941,3459999
25581,41,65,0,12.49,152.69,3459998,3460039
25582,47,73,1,10.89,133.29,3460038,3460085
25583,37,52,2,13.84,158.35,3460084,3460121
25584,42,83,1,12.19,309.96,3460120,3460162
25585,40,112,0,12.80,385.11,3460161,3460201
25586,76,35,0,6.74,45.56,3460200,3460276
25587,58,61,1,8.83,76.00,3460276,3460334
25588,61,68,0,8.39,114.40,3460334,3460395
25589,47,68,0,10.89,184.99,3460395,3460442
25590,62,40,1,8.26,57.29,3460441,3460503
25591,34,124,1,15.06,421.58,3460502,3460536
25592,43,91,1,11.91,226.83,3460535,3460578
25593,34,97,0,15.06,349.70,3460578,3460612
25594,47,47,1,10.89,93.37,3460612,3460659
25595,42,90,2,12.19,271.54,3460658,3460700
25596,51,80,2,10.04,140.27,3460699,3460750
25597,62,34,1,8.26,41.80,3460750,3460812
25598,47,36,1,10.89,71.80,3460811,3460858
25599,39,151,1,13.13,590.37,3460857,3460896
25600,39,104,2,13.13,400.73,3460895,3460934
25601,50,29,1,10.24,45.30,3460933,3460983
25602,53,42,1,9.66,56.19,3460982,3461035
25603,58,49,1,8.83,67.83,3461034,3461092
25604,47,31,1,10.89,49.71,3461091,3461138
25605,53,30,1,9.66,40.56,3461137,3461190
25606,45,57,1,11.38,93.39,3461189,3461234
25607,45,60,1,11.38,125.79,3461234,3461279
25608,41,83,1,12.49,270.49,3461278,3461319
25609,49,56,2,10.45,100.17,3461318,3461367
25610,50,40,0,10.24,70.66,3461367,3461417
25611,65,36,0,7.88,36.35,3461416,3461481
25612,48,39,1,10.67,57.56,3461480,3461528
25613,51,43,2,10.04,66.51,3461527,3461578
25614,48,29,2,10.67,39.76,3461577,3461625
25615,61,47,1,8.39,60.14,3461624,3461685
25616,43,38,2,11.91,72.83,3461684,3461727
25617,54,32,1,9.48,48.10,3461726,3461780
25618,44,58,1,11.64,114.73,3461779,3461823
25619,33,82,1,15.52,270.01,3461822,3461855
25620,11,274,1,46.55,6020.61,3461854,3461865
25621,33,132,3,15.52,518.37,3461864,3461897
25622,34,62,2,15.06,215.76,3461897,3461931
25623,39,86,1,13.13,218.32,3461930,3461969
25624,43,69,1,11.91,224.78,3461968,3462011
25625,37,178,1,13.84,777.65,3462010,3462047
25626,39,82,1,13.13,303.39,3462046,3462085
25627,58,70,1,8.83,144.59,3462084,3462142
25628,71,41,1,7.21,63.27,3462141,3462212
25629,28,113,1,18.29,601.49,3462211,3462239
25630,18,173,2,28.44,1703.36,3462238,3462256
25631,45,73,1,11.38,200.77,3462255,3462300
25632,17,416,1,30.12,9323.99,3462300,3462317
25633,68,33,0,7.53,56.75,3462316,3462384
25634,65,29,0,7.88,36.05,3462383,3462448
25635,64,45,0,8.00,64.94,3462447,3462511
25636,65,40,0,7.88,49.46,3462510,3462575
25637,97,22,0,5.28,25.33,3462574,3462671
25638,32,110,1,16.00,391.06,3462671,3462703
25639,65,29,0,7.88,29.34,3462702,3462767
25640,64,36,0,8.00,45.81,3462766,3462830
25641,54,43,1,9.48,82.81,3462829,3462883
25642,58,39,0,8.83,59.35,3462882,3462940
25643,57,47,1,8.98,84.82,3462939,3462996
25644,60,52,1,8.53,70.02,3462995,3463055
25645,55,42,1,9.31,70.80,3463054,3463109
25646,37,53,1,13.84,141.38,3463108,3463145
25647,65,83,0,7.88,140.35,3463144,3463209
25648,66,56,1,7.76,60.40,3463209,3463275
25649,57,93,1,8.98,144.37,3463274,3463331
25650,53,41,0,9.66,67.09,3463330,3463383
25651,45,34,1,11.38,61.79,3463382,3463427
25652,47,123,0,10.89,300.05,3463426,3463473
25653,49,58,1,10.45,84.25,3463472,3463521
25654,44,42,1,11.64,72.91,3463520,3463564
25655,52,43,1,9.85,54.82,3463563,3463615
25656,41,68,1,12.49,129.66,3463615,3463656
25657,46,63,2,11.13,131.90,3463656,3463702
25658,36,61,1,14.22,189.51,3463701,3463737
25659,62,26,2,8.26,29.97,3463736,3463798
25660,45,39,1,11.38,77.12,3463798,3463843
25661,39,43,2,13.13,104.88,3463842,3463881
25662,47,62,1,10.89,106.73,3463880,3463927
25663,50,36,1,10.24,60.22,3463926,3463976
25664,53,38,1,9.66,46.90,3463975,3464028
25665,55,26,1,9.31,28.00,3464028,3464083
25666,37,63,1,13.84,133.11,3464082,3464119
25667,45,183,0,11.38,690.68,3464118,3464163
25668,47,59,2,10.89,111.92,3464162,3464209
25669,35,70,2,14.63,148.63,3464208,3464243
25670,17,198,1,30.12,2092.22,3464242,3464259
25671,25,157,1,20.48,980.01,3464258,3464283
25672,43,58,1,11.91,154.04,3464282,3464325
25673,42,41,1,12.19,89.68,3464324,3464366
25674,38,73,1,13.47,202.14,3464366,3464404
25675,40,104,0,12.80,302.71,3464403,3464443
25676,59,40,1,8.68,70.66,3464442,3464501
25677,51,34,0,10.04,92.74,3464500,3464551
25678,61,31,0,8.39,39.91,3464550,3464611
25679,76,29,0,6.74,43.35,3464610,3464686
25680,77,45,1,6.65,36.57,3464685,3464762
25681,77,35,0,6.65,36.44,3464761,3464838
25682,27,232,1,18.96,1923.74,3464837,3464864
25683,32,138,1,16.00,563.44,3464863,3464895
25684,77,48,0,6.65,44.07,3464894,3464971
25685,50,78,1,10.24,153.50,3464971,3465021
25686,58,64,0,8.83,91.97,3465020,3465078
25687,44,133,1,11.64,445.60,3465077,3465121
25688,38,108,1,13.47,490.93,3465120,3465158
25689,70,26,1,7.31,27.70,3465157,3465227
25690,51,76,1,10.04,118.47,3465226,3465277
25691,59,63,1,8.68,133.24,3465276,3465335
25692,73,38,0,7.01,29.36,3465334,3465407
25693,39,59,2,13.13,152.83,3465406,3465445
25694,72,60,0,7.11,75.65,3465444,3465516
25695,36,85,1,14.22,325.06,3465515,3465551
25696,57,55,0,8.98,83.28,3465550,3465607
25697,54,64,0,9.48,89.25,3465606,3465660
25698,52,30,0,9.85,44.90,3465659,3465711
25699,52,44,2,9.85,63.01,3465710,3465762
25700,49,95,1,10.45,175.15,3465761,3465810
25701,38,48,3,13.47,113.88,3465809,3465847
25702,51,43,1,10.04,70.59,3465846,3465897
25703,46,88,0,11.13,172.07,3465896,3465942
25704,62,33,1,8.26,38.39,3465941,3466003
25705,41,78,2,12.49,200.30,3466002,3466043
25706,52,46,1,9.85,88.40,3466042,3466094
25707,56,27,1,9.14,37.30,3466094,3466150
25708,31,88,1,16.52,364.89,3466149,3466180
25709,54,29,1,9.48,36.99,3466179,3466233
25710,45,38,1,11.38,64.95,3466232,3466277
25711,47,30,2,10.89,42.05,3466276,3466323
25712,61,41,1,8.39,49.35,3466322,3466383
25713,48,33,0,10.67,46.85,3466382,3466430
25714,57,61,1,8.98,105.00,3466430,3466487
25715,45,32,1,11.38,52.01,3466486,3466531
25716,33,69,2,15.52,169.52,3466530,3466563
25717,37,87,3,13.84,211.81,3466562,3466599
25718,60,67,1,8.53,89.08,3466598,3466658
25719,48,74,1,10.67,133.47,3466657,3466705
25720,40,53,1,12.80,125.81,3466704,3466744
25721,47,43,1,10.89,107.80,3466743,3466790
25722,49,48,0,10.45,112.94,3466789,3466838
25723,46,55,1,11.13,137.37,3466837,3466883
25724,84,24,0,6.10,27.68,3466882,3466966
25725,52,43,1,9.85,64.25,3466965,3467017
25726,69,52,0,7.42,77.98,3467016,3467085
25727,52,38,1,9.85,91.09,3467084,3467136
25728,83,66,0,6.17,69.03,3467135,3467218
25729,76,50,1,6.74,74.54,3467217,3467293
25730,51,35,1,10.04,69.17,3467293,3467344
25731,62,32,1,8.26,29.84,3467343,3467405
25732,57,51,1,8.98,88.75,3467404,3467461
25733,52,51,1,9.85,89.67,3467460,3467512
25734,39,133,2,13.13,422.68,3467511,3467550
25735,60,57,1,8.53,68.62,3467549,3467609
25736,49,42,1,10.45,93.68,3467608,3467657
25737,53,109,0,9.66,326.00,3467656,3467709
25738,62,104,0,8.26,177.61,3467708,3467770
25739,42,80,1,12.19,145.58,3467769,3467811
25740,53,53,1,9.66,86.41,3467810,3467863
25741,41,32,1,12.49,61.23,3467862,3467903
25742,49,29,2,10.45,39.72,3467902,3467951
25743,57,38,1,8.98,50.58,3467950,3468007
25744,52,44,2,9.85,60.75,3468007,3468059
25745,43,90,2,11.91,184.78,3468058,3468101
25746,44,87,2,11.64,201.91,3468100,3468144
25747,42,48,1,12.19,120.20,3468143,3468185
25748,44,43,2,11.64,63.82,3468185,3468229
25749,45,100,2,11.38,212.19,3468228,3468273
25750,59,62,1,8.68,84.08,3468273,3468332
25751,41,63,1,12.49,158.74,3468331,3468372
25752,49,74,0,10.45,155.88,3468371,3468420
25753,43,33,2,11.91,53.62,3468420,3468463
25754,51,33,2,10.04,39.96,3468462,3468513
25755,52,46,3,9.85,53.86,3468512,3468564
25756,46,41,1,11.13,82.46,3468563,3468609
25757,54,37,1,9.48,58.29,3468608,3468662
25758,55,34,2,9.31,40.21,3468661,3468716
25759,59,37,1,8.68,41.47,3468716,3468775
25760,56,32,1,9.14,45.91,3468774,3468830
25761,29,168,0,17.66,997.05,3468829,3468858
25762,27,98,1,18.96,435.67,3468857,3468884
25763,41,45,0,12.49,117.13,3468883,3468924
25764,54,62,0,9.48,108.88,3468923,3468977
25765,40,102,2,12.80,301.91,3468976,3469016
25766,22,87,1,23.27,786.56,3469015,3469037
25767,39,84,1,13.13,287.55,3469036,3469075
25768,47,55,0,10.89,108.90,3469074,3469121
25769,51,86,0,10.04,220.47,3469120,3469171
25770,34,120,0,15.06,706.35,3469170,3469204
25771,13,217,2,39.38,4069.78,3469203,3469216
25772,37,67,1,13.84,230.14,3469215,3469252
25773,54,48,1,9.48,102.36,3469251,3469305
25774,81,37,0,6.32,49.45,3469305,3469386
25775,67,41,0,7.64,54.89,3469385,3469452
25776,70,27,0,7.31,44.62,3469451,3469521
25777,50,56,1,10.24,149.02,3469521,3469571
25778,60,39,1,8.53,74.18,3469570,3469630
25779,51,40,1,10.04,48.31,3469629,3469680
25780,62,46,1,8.26,60.84,3469679,3469741
25781,46,64,1,11.13,116.55,3469740,3469786
25782,55,49,1,9.31,68.94,3469785,3469840
25783,60,38,1,8.53,56.68,3469839,3469899
25784,50,102,1,10.24,238.78,3469898,3469948
25785,45,112,1,11.38,314.81,3469947,3469992
25786,42,127,2,12.19,368.11,3469992,3470034
25787,42,87,2,12.19,214.06,3470033,3470075
25788,61,57,1,8.39,85.12,3470074,3470135
25789,34,154,1,15.06,699.35,3470134,3470168
25790,33,73,2,15.52,295.64,3470167,3470200
25791,53,46,0,9.66,74.30,3470199,3470252
25792,50,26,1,10.24,42.70,3470251,3470301
25793,42,32,0,12.19,65.92,3470300,3470342
25794,56,29,1,9.14,34.02,3470341,3470397
25795,46,77,1,11.13,157.03,3470396,3470442
25796,41,48,2,12.49,68.64,3470441,3470482
25797,46,59,1,11.13,133.11,3470481,3470527
25798,33,200,2,15.52,1233.34,3470526,3470559
25799,57,109,1,8.98,201.56,3470558,3470615
25800,34,88,2,15.06,298.41,3470614,3470648
25801,32,66,1,16.00,210.38,3470647,3470679
25802,54,30,1,9.48,49.25,3470678,3470732
25803,49,51,1,10.45,77.96,3470731,3470780
25804,52,88,1,9.85,156.86,3470779,3470831
25805,47,70,0,10.89,127.54,3470830,3470877
25806,51,39,1,10.04,60.55,3470876,3470927
25807,47,29,1,10.89,48.35,3470926,3470973
25808,53,33,1,9.66,49.02,3470972,3471025
25809,38,83,1,13.47,281.51,3471024,3471062
25810,53,23,1,9.66,34.22,3471061,3471114
25811,32,73,1,16.00,208.94,3471113,3471145
25812,38,37,2,13.47,103.83,3471144,3471182
25813,20,99,2,25.60,704.04,3471181,3471201
25814,50,33,0,10.24,56.26,3471200,3471250
25815,41,72,2,12.49,168.44,3471249,3471290
25816,46,34,1,11.13,87.59,3471289,3471335
25817,43,67,2,11.91,110.27,3471334,3471377
25818,59,35,1,8.68,61.40,3471377,3471436
25819,48,75,1,10.67,230.01,3471435,3471483
25820,36,147,0,14.22,786.06,3471482,3471518
25821,72,43,0,7.11,75.96,3471518,3471590
25822,68,30,0,7.53,31.81,3471590,3471658
25823,63,38,1,8.13,58.81,3471657,3471720
25824,66,35,0,7.76,52.55,3471719,3471785
25825,91,26,0,5.63,35.73,3471784,3471875
25826,74,27,0,6.92,28.89,3471875,3471949
25827,62,36,1,8.26,49.32,3471948,3472010
25828,58,62,1,8.83,103.90,3472009,3472067
25829,74,43,1,6.92,45.02,3472066,3472140
25830,56,28,1,9.14,32.77,3472139,3472195
25831,80,25,0,6.40,20.26,3472194,3472274
25832,57,106,1,8.98,190.26,3472273,3472330
25833,23,180,1,22.26,1651.32,3472329,3472352
25834,76,28,0,6.74,28.59,3472351,3472427
25835,56,150,1,9.14,405.91,3472426,3472482
25836,37,78,0,13.84,272.51,3472481,3472518
25837,58,53,0,8.83,81.66,3472517,3472575
25838,53,38,0,9.66,61.62,3472574,3472627
25839,51,27,0,10.04,48.00,3472626,3472677
25840,46,41,2,11.13,82.11,3472676,3472722
25841,40,37,1,12.80,63.21,3472721,3472761
25842,51,41,2,10.04,61.49,3472760,3472811
25843,45,57,1,11.38,131.84,3472810,3472855
25844,50,68,0,10.24,106.90,3472854,3472904
25845,47,82,1,10.89,167.12,3472903,3472950
25846,13,137,3,39.38,2354.24,3472949,3472962
25847,57,41,0,8.98,51.88,3472961,3473018
25848,43,65,1,11.91,184.22,3473017,3473060
25849,49,36,1,10.45,44.49,3473059,3473108
25850,34,58,3,15.06,99.88,3473108,3473142
25851,50,26,2,10.24,33.50,3473141,3473191
25852,50,75,2,10.24,118.14,3473190,3473240
25853,46,51,1,11.13,77.46,3473239,3473285
25854,52,33,1,9.85,46.94,3473284,3473336
25855,44,51,1,11.64,128.50,3473335,3473379
25856,49,55,1,10.45,91.96,3473378,3473427
25857,49,35,1,10.45,60.57,3473426,3473475
25858,20,76,1,25.60,393.94,3473474,3473494
25859,26,63,4,19.69,265.37,3473494,3473520
25860,44,49,0,11.64,119.82,3473519,3473563
25861,51,32,1,10.04,44.39,3473562,3473613
25862,47,75,0,10.89,150.35,3473612,3473659
25863,37,62,0,13.84,168.41,3473658,3473695
25864,49,65,1,10.45,141.27,3473694,3473743
25865,51,44,0,10.04,81.76,3473742,3473793
25866,21,133,1,24.38,1336.90,3473793,3473814
25867,37,80,1,13.84,320.95,3473813,3473850
25868,20,144,3,25.60,983.64,3473849,3473869
25869,33,135,1,15.52,753.16,3473868,3473901
25870,58,41,0,8.83,65.45,3473900,3473958
25871,59,39,0,8.68,67.10,3473957,3474016
25872,39,134,2,13.13,489.96,3474015,3474054
25873,76,32,0,6.74,37.09,3474053,3474129
25874,49,66,1,10.45,189.10,3474128,3474177
25875,72,63,0,7.11,100.74,3474176,3474248
25876,55,52,1,9.31,110.40,3474247,3474302
25877,55,40,1,9.31,75.67,3474302,3474357
25878,43,52,1,11.91,139.20,3474356,3474399
25879,64,49,0,8.00,57.03,3474398,3474462
25880,61,39,1,8.39,53.26,3474461,3474522
25881,71,34,0,7.21,37.97,3474521,3474592
25882,53,28,2,9.66,43.05,3474591,3474644
25883,58,41,1,8.83,72.80,3474643,3474701
25884,61,28,1,8.39,41.58,3474700,3474761
25885,49,73,1,10.45,132.37,3474760,3474809
25886,44,46,0,11.64,94.87,3474808,3474852
25887,54,56,0,9.48,80.25,3474851,3474905
25888,46,57,0,11.13,115.46,3474904,3474950
25889,55,34,0,9.31,50.76,3474949,3475004
25890,54,40,0,9.48,67.88,3475003,3475057
25891,45,33,0,11.38,69.08,3475056,3475101
25892,44,44,1,11.64,83.19,3475100,3475144
25893,41,87,2,12.49,251.76,3475143,3475184
25894,46,52,1,11.13,85.64,3475183,3475229
25895,39,49,2,13.13,127.65,3475228,3475267
25896,44,90,1,11.64,191.14,3475266,3475310
25897,44,55,1,11.64,102.91,3475310,3475354
25898,46,42,0,11.13,73.42,3475353,3475399
25899,43,47,2,11.91,95.53,3475398,3475441
25900,46,62,1,11.13,109.33,3475440,3475486
25901,52,36,2,9.85,38.01,3475486,3475538
25902,57,61,1,8.98,68.89,3475538,3475595
25903,66,32,1,7.76,37.09,3475594,3475660
25904,33,97,1,15.52,322.55,3475659,3475692
25905,44,69,2,11.64,124.50,3475691,3475735
25906,51,47,1,10.04,104.51,3475734,3475785
25907,40,40,2,12.80,116.91,3475784,3475824
25908,31,75,1,16.52,249.80,3475823,3475854
25909,21,170,2,24.38,1507.95,3475853,3475874
25910,31,49,2,16.52,122.57,3475873,3475904
25911,44,44,0,11.64,115.50,3475903,3475947
25912,47,131,0,10.89,382.99,3475946,3475993
25913,32,108,1,16.00,455.69,3475992,3476024
25914,57,34,1,8.98,48.09,3476024,3476081
25915,52,35,0,9.85,65.40,3476080,3476132
25916,45,56,1,11.38,186.95,3476132,3476177
25917,40,107,1,12.80,328.26,3476176,3476216
25918,36,82,0,14.22,277.23,3476215,3476251
25919,76,33,0,6.74,40.30,3476251,3476327
25920,61,55,0,8.39,84.01,3476326,3476387
25921,52,39,1,9.85,79.82,3476386,3476438
25922,74,51,1,6.92,59.21,3476437,3476511
25923,53,51,0,9.66,142.87,3476510,3476563
25924,60,127,0,8.53,339.72,3476562,3476622
25925,50,40,1,10.24,76.62,3476621,3476671
25926,60,24,1,8.53,36.32,3476670,3476730
25927,63,74,0,8.13,97.32,3476729,3476792
25928,59,50,1,8.68,80.66,3476791,3476850
25929,53,98,1,9.66,313.88,3476849,3476902
25930,45,72,1,11.38,176.99,3476902,3476947
25931,65,41,1,7.88,51.15,3476946,3477011
25932,55,68,1,9.31,105.27,3477010,3477065
25933,55,69,1,9.31,100.76,3477064,3477119
25934,55,115,1,9.31,239.05,3477118,3477173
25935,63,30,1,8.13,47.38,3477173,3477236
25936,58,34,1,8.83,41.87,3477235,3477293
25937,58,32,1,8.83,37.56,3477292,3477350
25938,47,118,1,10.89,276.78,3477349,3477396
25939,50,32,1,10.24,67.02,3477395,3477445
25940,45,50,1,11.38,84.06,3477444,3477489
25941,45,59,2,11.38,100.81,3477488,3477533
25942,47,73,1,10.89,164.31,3477533,3477580
25943,51,33,3,10.04,40.08,3477579,3477630
25944,23,132,2,22.26,803.50,3477629,3477652
25945,30,165,1,17.07,863.80,3477651,3477681
25946,51,37,1,10.04,59.10,3477680,3477731
25947,43,38,1,11.91,73.99,3477730,3477773
25948,49,118,1,10.45,276.29,3477772,3477821
25949,42,65,1,12.19,156.20,3477820,3477862
25950,53,29,1,9.66,44.79,3477861,3477914
25951,50,57,2,10.24,133.14,3477913,3477963
25952,53,46,1,9.66,60.87,3477962,3478015
25953,59,39,0,8.68,58.08,3478014,3478073
25954,24,106,4,21.33,519.22,3478072,3478096
25955,24,82,2,21.33,440.64,3478095,3478119
25956,30,47,3,17.07,127.80,3478118,3478148
25957,45,39,1,11.38,81.66,3478147,3478192
25958,55,31,1,9.31,52.54,3478192,3478247
25959,66,35,1,7.76,48.12,3478246,3478312
25960,42,54,1,12.19,147.20,3478311,3478353
25961,44,92,0,11.64,344.78,3478352,3478396
25962,51,47,1,10.04,111.61,3478395,3478446
25963,79,27,0,6.48,42.58,3478445,3478524
25964,64,53,0,8.00,54.28,3478523,3478587
25965,70,27,0,7.31,38.64,3478586,3478656
25966,6,466,1,85.33,29059.56,3478655,3478661
25967,51,98,0,10.04,198.27,3478660,3478711
25968,75,34,0,6.83,40.57,3478710,3478785
25969,56,70,1,9.14,141.98,3478784,3478840
25970,57,49,1,8.98,69.00,3478839,3478896
25971,44,98,1,11.64,249.55,3478895,3478939
25972,62,40,1,8.26,58.71,3478938,3479000
25973,44,171,1,11.64,620.28,3478999,3479043
25974,62,54,0,8.26,74.64,3479042,3479104
25975,64,26,1,8.00,37.66,3479103,3479167
25976,46,40,0,11.13,102.81,3479167,3479213
25977,61,22,0,8.39,27.62,3479212,3479273
25978,42,89,0,12.19,245.30,3479272,3479314
25979,58,25,1,8.83,23.28,3479313,3479371
25980,47,33,1,10.89,59.07,3479370,3479417
25981,57,52,1,8.98,56.37,3479416,3479473
25982,38,59,2,13.47,119.93,3479472,3479510
25983,51,79,0,10.04,136.78,3479509,3479560
25984,69,22,0,7.42,21.52,3479559,3479628
25985,52,41,0,9.85,51.44,3479627,3479679
25986,32,81,1,16.00,215.00,3479678,3479710
25987,42,66,0,12.19,151.20,3479709,3479751
25988,50,36,1,10.24,39.42,3479750,3479800
25989,53,67,1,9.66,102.90,3479799,3479852
25990,55,33,1,9.31,51.70,3479852,3479907
25991,57,41,1,8.98,56.02,3479906,3479963
25992,45,106,1,11.38,268.99,3479962,3480007
25993,55,27,1,9.31,41.60,3480006,3480061
25994,18,252,1,28.44,3565.80,3480060,3480078
25995,43,57,2,11.91,104.18,3480077,3480120
25996,25,94,1,20.48,416.33,3480119,3480144
25997,18,106,4,28.44,851.25,3480143,3480161
25998,28,94,0,18.29,486.99,3480160,3480188
25999,24,102,3,21.33,585.47,3480187,3480211
26000,44,29,1,11.64,55.60,3480210,3480254
26001,46,57,1,11.13,124.03,3480253,3480299
26002,43,67,1,11.91,150.22,3480298,3480341
26003,46,75,1,11.13,144.24,3480340,3480386
26004,41,60,1,12.49,211.18,3480385,3480426
26005,61,31,1,8.39,46.27,3480425,3480486
26006,48,68,0,10.67,160.06,3480485,3480533
26007,39,213,1,13.13,1093.03,3480532,3480571
26008,69,72,0,7.42,91.61,3480570,3480639
26009,66,112,0,7.76,195.73,3480638,3480704
26010,49,63,1,10.45,100.21,3480703,3480752
26011,57,57,0,8.98,129.10,3480751,3480808
26012,69,58,1,7.42,99.61,3480807,3480876
26013,51,36,0,10.04,82.67,3480875,3480926
26014,64,125,0,8.00,242.19,3480925,3480989
26015,62,36,1,8.26,45.19,3480988,3481050
26016,76,40,0,6.74,34.77,3481050,3481126
26017,32,218,1,16.00,1397.38,3481125,3481157
26018,85,26,1,6.02,17.67,3481156,3481241
26019,66,48,0,7.76,50.18,3481240,3481306
26020,65,24,1,7.88,33.31,3481305,3481370
26021,59,42,1,8.68,65.85,3481369,3481428
26022,54,109,1,9.48,243.21,3481428,3481482
26023,56,139,1,9.14,345.30,3481481,3481537
26024,85,52,0,6.02,49.18,3481536,3481621
26025,65,41,1,7.88,45.28,3481620,3481685
26026,52,39,0,9.85,78.40,3481684,3481736
26027,52,32,1,9.85,50.78,3481735,3481787
26028,49,28,1,10.45,42.61,3481786,3481835
26029,30,87,1,17.07,352.86,3481834,3481864
26030,24,134,2,21.33,606.14,3481863,3481887
26031,58,29,1,8.83,36.28,3481886,3481944
26032,46,48,2,11.13,95.20,3481943,3481989
26033,46,50,1,11.13,100.72,3481988,3482034
26034,29,100,0,17.66,506.02,3482033,3482062
26035,40,39,0,12.80,131.86,3482061,3482101
26036,57,33,0,8.98,60.89,3482100,3482157
26037,35,51,3,14.63,125.32,3482156,3482191
26038,49,34,2,10.45,51.88,3482190,3482239
26039,52,27,0,9.85,40.36,3482238,3482290
26040,31,69,2,16.52,199.60,3482289,3482320
26041,45,38,3,11.38,57.17,3482319,3482364
26042,54,33,1,9.48,48.29,3482363,3482417
26043,51,53,1,10.04,65.25,3482416,3482467
26044,30,101,1,17.07,567.93,3482466,3482496
26045,59,61,1,8.68,86.69,3482495,3482554
26046,33,43,2,15.52,164.19,3482553,3482586
26047,33,74,0,15.52,248.86,3482585,3482618
26048,46,43,1,11.13,86.90,3482618,3482664
26049,46,80,0,11.13,175.03,3482663,3482709
26050,35,77,2,14.63,256.40,3482708,3482743
26051,41,87,2,12.49,212.25,3482743,3482784
26052,50,66,0,10.24,125.58,3482783,3482833
26053,28,117,1,18.29,910.06,3482832,3482860
26054,30,182,1,17.07,1272.06,3482859,3482889
26055,2,347,165,256.00,8281.00,3482888,3482890
26056,4,337,6,128.00,18513.50,3482889,3482893
26057,38,159,1,13.47,664.99,3482892,3482930
26058,65,37,1,7.88,52.05,3482929,3482994
26059,79,29,0,6.48,36.53,3482993,3483072
26060,50,52,1,10.24,110.66,3483071,3483121
26061,79,50,0,6.48,62.60,3483120,3483199
26062,11,420,4,46.55,14018.43,3483198,3483209
26063,80,105,0,6.40,143.11,3483208,3483288
26064,78,22,1,6.56,24.32,3483287,3483365
26065,35,80,3,14.63,344.12,3483364,3483399
26066,71,28,0,7.21,34.39,3483398,3483469
26067,62,42,1,8.26,51.26,3483469,3483531
26068,72,38,1,7.11,36.04,3483530,3483602
26069,66,51,0,7.76,60.55,3483602,3483668
26070,68,47,0,7.53,72.98,3483667,3483735
26071,62,46,1,8.26,54.87,3483734,3483796
26072,59,40,0,8.68,71.68,3483795,3483854
26073,57,71,1,8.98,109.74,3483853,3483910
26074,74,27,0,6.92,23.29,3483909,3483983
26075,62,29,0,8.26,35.58,3483982,3484044
26076,56,36,1,9.14,48.12,3484043,3484099
26077,45,36,1,11.38,61.21,3484098,3484143
26078,59,26,1,8.68,34.73,3484142,3484201
26079,41,54,1,12.49,136.49,3484200,3484241
26080,59,37,0,8.68,51.81,3484240,3484299
26081,64,31,1,8.00,39.97,3484298,3484362
26082,41,42,0,12.49,120.15,3484361,3484402
26083,50,49,0,10.24,76.34,3484401,3484451
26084,34,75,1,15.06,320.06,3484450,3484484
26085,49,87,1,10.45,164.04,3484483,3484532
26086,41,43,1,12.49,108.69,3484531,3484572
26087,37,74,0,13.84,202.73,3484571,3484608
26088,49,66,2,10.45,109.43,3484607,3484656
26089,43,56,2,11.91,76.60,3484655,3484698
26090,57,62,2,8.98,81.03,3484697,3484754
26091,54,29,0,9.48,41.92,3484753,3484807
26092,61,46,1,8.39,67.81,3484806,3484867
26093,48,47,2,10.67,63.85,3484867,3484915
26094,26,78,0,19.69,381.67,3484914,3484940
26095,21,74,3,24.38,560.05,3484939,3484960
26096,37,79,1,13.84,266.30,3484959,3484996
26097,38,109,0,13.47,381.99,3484995,3485033
26098,17,325,2,30.12,5538.93,3485032,3485049
26099,35,47,1,14.63,165.15,3485048,3485083
26100,45,49,1,11.38,102.86,3485082,3485127
26101,38,100,1,13.47,292.51,3485126,3485164
26102,46,69,0,11.13,211.59,3485163,3485209
26103,43,47,0,11.91,142.83,3485208,3485251
26104,43,50,1,11.91,138.60,3485250,3485293
26105,87,24,0,5.89,24.84,3485292,3485379
26106,68,26,0,7.53,28.43,3485379,3485447
26107,48,46,2,10.67,91.89,3485446,3485494
26108,77,57,0,6.65,64.67,3485493,3485570
26109,60,72,0,8.53,104.45,3485569,3485629
26110,79,46,1,6.48,50.20,3485628,3485707
26111,45,54,1,11.38,107.08,3485706,3485751
26112,41,73,1,12.49,178.15,3485750,3485791
26113,64,61,0,8.00,60.34,3485790,3485854
26114,66,58,0,7.76,80.70,3485853,3485919
26115,65,75,1,7.88,97.12,3485918,3485983
26116,43,147,0,11.91,498.88,3485982,3486025
26117,65,31,0,7.88,33.92,3486024,3486089
26118,89,56,0,5.75,38.82,3486089,3486178
26119,55,111,1,9.31,220.54,3486177,3486232
26120,60,47,1,8.53,53.35,3486231,3486291
26121,40,114,0,12.80,310.76,3486290,3486330
26122,72,26,1,7.11,25.71,3486329,3486401
26123,63,32,1,8.13,36.33,3486400,3486463
26124,50,48,1,10.24,77.26,3486462,3486512
26125,33,143,2,15.52,539.58,3486511,3486544
26126,49,51,1,10.45,82.57,3486543,3486592
26127,62,28,0,8.26,36.09,3486592,3486654
26128,54,41,1,9.48,67.18,3486653,3486707
26129,35,131,1,14.63,451.72,3486706,3486741
26130,34,136,1,15.06,560.76,3486740,3486774
26131,33,45,2,15.52,178.07,3486774,3486807
26132,53,45,1,9.66,63.70,3486806,3486859
26133,45,43,1,11.38,63.48,3486859,3486904
26134,50,37,1,10.24,55.38,3486904,3486954
26135,51,37,2,10.04,54.82,3486953,3487004
26136,44,50,1,11.64,151.28,3487003,3487047
26137,52,42,2,9.85,73.94,3487047,3487099
26138,37,76,1,13.84,173.00,3487098,3487135
26139,33,61,1,15.52,225.04,3487134,3487167
26140,32,44,3,16.00,127.12,3487166,3487198
26141,49,35,1,10.45,70.86,3487197,3487246
26142,42,133,0,12.19,431.20,3487245,3487287
26143,30,95,0,17.07,615.46,3487286,3487316
26144,38,154,1,13.47,655.04,3487315,3487353
26145,13,349,2,39.38,8088.39,3487352,3487365
26146,35,85,1,14.63,275.15,3487364,3487399
26147,6,472,3,85.33,29915.22,3487398,3487404
26148,51,125,0,10.04,326.16,3487403,3487454
26149,74,25,0,6.92,30.21,3487453,3487527
26150,75,45,0,6.83,57.69,3487526,3487601
26151,57,46,0,8.98,53.18,3487600,3487657
26152,79,28,1,6.48,31.34,3487657,3487736
26153,64,50,0,8.00,68.06,3487736,3487800
26154,25,125,2,20.48,772.17,3487799,3487824
26155,58,80,1,8.83,140.97,3487823,3487881
26156,65,58,1,7.88,72.66,3487880,3487945
26157,72,23,0,7.11,32.82,3487944,3488016
26158,56,57,1,9.14,100.94,3488015,3488071
26159,27,180,1,18.96,1162.11,3488070,3488097
26160,43,119,1,11.91,329.76,3488096,3488139
26161,64,45,1,8.00,54.19,3488139,3488203
26162,38,128,2,13.47,419.41,3488202,3488240
26163,61,44,0,8.39,49.26,3488239,3488300
26164,42,122,2,12.19,340.77,3488299,3488341
26165,61,32,1,8.39,31.62,3488340,3488401
26166,12,180,0,42.67,3850.72,3488400,3488412
26167,36,167,1,14.22,709.67,3488411,3488447
26168,52,31,1,9.85,44.48,3488446,3488498
26169,30,134,1,17.07,581.00,3488497,3488527
26170,65,33,1,7.88,31.03,3488526,3488591
26171,58,51,1,8.83,62.11,3488590,3488648
26172,51,49,0,10.04,70.12,3488647,3488698
26173,41,38,3,12.49,91.66,3488697,3488738
26174,54,36,1,9.48,48.29,3488737,3488791
26175,36,43,1,14.22,99.56,3488790,3488826
26176,48,31,2,10.67,50.64,3488825,3488873
26177,37,93,3,13.84,216.41,3488873,3488910
26178,28,110,2,18.29,649.13,3488909,3488937
26179,60,29,2,8.53,38.68,3488936,3488996
26180,51,34,1,10.04,59.02,3488995,3489046
26181,48,56,0,10.67,161.81,3489045,3489093
26182,44,82,1,11.64,153.14,3489092,3489136
26183,41,32,1,12.49,79.76,3489135,3489176
26184,52,37,1,9.85,63.71,3489175,3489227
26185,46,43,1,11.13,96.33,3489226,3489272
26186,55,79,1,9.31,159.09,3489271,3489326
26187,39,43,1,13.13,137.03,3489325,3489364
26188,44,49,0,11.64,133.69,3489363,3489407
26189,78,49,0,6.56,58.73,3489406,3489484
26190,52,108,0,9.85,238.98,3489484,3489536
26191,52,41,1,9.85,84.28,3489535,3489587
26192,77,28,0,6.65,33.08,3489586,3489663
26193,66,55,0,7.76,85.67,3489662,3489728
26194,49,39,2,10.45,48.82,3489727,3489776
26195,71,23,1,7.21,24.17,3489775,3489846
26196,59,34,1,8.68,34.46,3489845,3489904
26197,51,42,1,10.04,90.04,3489903,3489954
26198,63,30,0,8.13,34.46,3489953,3490016
26199,53,41,1,9.66,67.43,3490015,3490068
26200,53,43,1,9.66,71.28,3490068,3490121
26201,76,23,1,6.74,24.90,3490120,3490196
26202,43,58,1,11.91,107.94,3490195,3490238
26203,53,33,1,9.66,53.02,3490237,3490290
26204,50,118,0,10.24,266.94,3490289,3490339
26205,43,106,0,11.91,280.08,3490338,3490381
26206,48,43,1,10.67,63.60,3490380,3490428
26207,32,117,1,16.00,461.06,3490427,3490459
26208,44,62,1,11.64,136.37,3490458,3490502
26209,50,42,2,10.24,69.38,3490501,3490551
26210,53,33,1,9.66,45.43,3490550,3490603
26211,52,51,1,9.85,79.44,3490602,3490654
26212,33,59,1,15.52,150.19,3490653,3490686
26213,48,41,1,10.67,74.18,3490685,3490733
26214,53,44,1,9.66,53.13,3490732,3490785
26215,49,43,1,10.45,98.04,3490784,3490833
26216,49,25,0,10.45,44.37,3490832,3490881
26217,52,35,1,9.85,50.59,3490880,3490932
26218,43,43,1,11.91,129.15,3490931,3490974
26219,48,43,1,10.67,76.47,3490973,3491021
26220,50,37,1,10.24,69.30,3491020,3491070
26221,40,80,1,12.80,227.56,3491069,3491109
26222,30,79,0,17.07,305.00,3491108,3491138
26223,21,101,4,24.38,590.33,3491137,3491158
26224,27,121,2,18.96,642.85,3491157,3491184
26225,32,56,2,16.00,126.56,3491183,3491215
26226,38,39,4,13.47,68.14,3491214,3491252
26227,37,130,1,13.84,429.92,3491251,3491288
26228,45,77,0,11.38,212.55,3491287,3491332
26229,38,62,1,13.47,162.72,3491331,3491369
26230,36,69,1,14.22,177.62,3491368,3491404
26231,47,135,1,10.89,437.58,3491403,3491450
26232,31,138,0,16.52,616.31,3491449,3491480
26233,40,74,1,12.80,186.81,3491479,3491519
26234,47,105,1,10.89,279.12,3491518,3491565
26235,70,34,0,7.31,51.99,3491564,3491634
26236,58,61,0,8.83,85.80,3491633,3491691
26237,38,110,0,13.47,531.20,3491690,3491728
26238,51,48,0,10.04,97.72,3491727,3491778
26239,17,298,4,30.12,4710.22,3491777,3491794
26240,63,107,0,8.13,250.90,3491793,3491856
26241,53,43,1,9.66,70.19,3491855,3491908
26242,50,65,0,10.24,111.50,3491907,3491957
26243,76,29,0,6.74,31.51,3491956,3492032
26244,67,40,1,7.64,36.35,3492031,3492098
26245,62,47,1,8.26,53.64,3492097,3492159
26246,55,68,1,9.31,103.85,3492158,3492213
26247,60,41,1,8.53,78.15,3492212,3492272
26248,74,22,0,6.92,21.37,3492271,3492345
26249,69,49,1,7.42,46.04,3492344,3492413
26250,66,82,1,7.76,100.91,3492412,3492478
26251,53,37,1,9.66,68.64,3492478,3492531
26252,55,41,1,9.31,62.58,3492530,3492585
26253,41,64,1,12.49,140.40,3492584,3492625
26254,51,34,1,10.04,57.45,3492624,3492675
26255,59,34,0,8.68,50.76,3492674,3492733
26256,27,66,3,18.96,328.26,3492732,3492759
26257,35,101,1,14.63,379.55,3492758,3492793
26258,46,54,1,11.13,66.77,3492792,3492838
26259,55,32,2,9.31,50.29,3492837,3492892
26260,61,27,1,8.39,28.57,3492891,3492952
26261,50,45,0,10.24,97.18,3492951,3493001
26262,26,106,2,19.69,624.91,3493000,3493026
26263,49,47,2,10.45,82.49,3493025,3493074
26264,60,25,2,8.53,26.45,3493073,3493133
26265,38,48,2,13.47,158.09,3493132,3493170
26266,53,29,0,9.66,43.96,3493169,3493222
26267,46,37,1,11.13,58.98,3493222,3493268
26268,45,48,2,11.38,62.99,3493267,3493312
26269,52,35,1,9.85,61.28,3493311,3493363
26270,52,33,2,9.85,53.01,3493362,3493414
26271,48,54,1,10.67,107.18,3493414,3493462
26272,39,47,2,13.13,125.45,3493461,3493500
26273,32,94,2,16.00,303.00,3493499,3493531
26274,33,98,2,15.52,364.80,3493530,3493563
26275,29,101,2,17.66,431.47,3493562,3493591
26276,52,68,1,9.85,137.86,3493591,3493643
26277,47,42,1,10.89,62.48,3493642,3493689
26278,42,74,0,12.19,189.73,3493688,3493730
26279,47,30,1,10.89,59.84,3493729,3493776
26280,50,67,0,10.24,159.46,3493775,3493825
26281,28,219,1,18.29,1570.20,3493824,3493852
26282,48,39,0,10.67,98.39,3493852,3493900
26283,75,34,1,6.83,41.88,3493899,3493974
26284,64,123,0,8.00,232.66,3493973,3494037
26285,47,44,1,10.89,99.37,3494036,3494083
26286,66,50,0,7.76,76.58,3494082,3494148
26287,68,132,1,7.53,259.69,3494147,3494215
26288,50,45,1,10.24,99.70,3494214,3494264
26289,46,66,1,11.13,189.81,3494263,3494309
26290,57,48,1,8.98,80.12,3494308,3494365
26291,63,29,1,8.13,31.29,3494364,3494427
26292,62,29,0,8.26,29.09,3494426,3494488
26293,46,89,0,11.13,180.46,3494487,3494533
26294,61,32,1,8.39,48.53,3494532,3494593
26295,52,45,1,9.85,77.63,3494593,3494645
26296,55,29,1,9.31,61.49,3494644,3494699
26297,76,32,0,6.74,37.04,3494698,3494774
26298,56,51,1,9.14,75.59,3494774,3494830
26299,58,30,1,8.83,37.97,3494829,3494887
26300,50,50,1,10.24,105.30,3494886,3494936
26301,51,28,1,10.04,32.67,3494935,3494986
26302,44,43,2,11.64,85.14,3494985,3495029
26303,31,118,2,16.52,668.77,3495028,3495059
26304,44,59,0,11.64,138.69,3495058,3495102
26305,49,37,1,10.45,58.04,3495101,3495150
26306,45,42,1,11.38,81.39,3495149,3495194
26307,50,70,1,10.24,123.10,3495193,3495243
26308,56,33,1,9.14,45.30,3495242,3495298
26309,44,79,1,11.64,199.73,3495297,3495341
26310,42,49,2,12.19,123.77,3495340,3495382
26311,50,34,0,10.24,49.62,3495381,3495431
26312,42,41,2,12.19,78.34,3495430,3495472
26313,55,31,1,9.31,44.32,3495471,3495526
26314,48,56,2,10.67,117.56,3495525,3495573
26315,59,26,2,8.68,38.73,3495572,3495631
26316,35,106,1,14.63,316.12,3495630,3495665
26317,47,44,1,10.89,81.75,3495664,3495711
26318,35,101,1,14.63,498.75,3495710,3495745
26319,33,64,1,15.52,161.04,3495744,3495777
26320,37,97,2,13.84,265.87,3495776,3495813
26321,46,74,1,11.13,206.55,3495812,3495858
26322,43,49,1,11.91,126.22,3495857,3495900
26323,52,50,1,9.85,83.63,3495899,3495951
26324,55,62,0,9.31,120.47,3495950,3496005
26325,34,82,2,15.06,260.41,3496004,3496038
26326,83,24,0,6.17,27.92,3496037,3496120
26327,63,37,0,8.13,51.29,3496119,3496182
26328,61,56,0,8.39,120.89,3496181,3496242
26329,40,57,1,12.80,180.56,3496241,3496281
26330,83,27,0,6.17,32.21,3496280,3496363
26331,60,30,0,8.53,49.72,3496362,3496422
26332,58,35,0,8.83,61.90,3496421,3496479
26333,51,58,2,10.04,93.37,3496478,3496529
26334,53,36,1,9.66,57.28,3496528,3496581
26335,56,30,1,9.14,42.27,3496581,3496637
26336,79,27,1,6.48,19.84,3496636,3496715
26337,59,54,1,8.68,65.13,3496715,3496774
26338,45,60,0,11.38,127.30,3496773,3496818
26339,60,43,1,8.53,59.68,3496817,3496877
26340,49,41,1,10.45,98.74,3496876,3496925
26341,48,44,2,10.67,64.81,3496924,3496972
26342,61,32,1,8.39,37.58,3496971,3497032
26343,54,43,1,9.48,47.81,3497031,3497085
26344,48,40,1,10.67,60.43,3497084,3497132
26345,20,73,5,25.60,571.14,3497131,3497151
26346,64,36,1,8.00,43.97,3497150,3497214
26347,49,49,1,10.45,80.94,3497213,3497262
26348,37,75,1,13.84,242.95,3497261,3497298
26349,49,97,0,10.45,213.19,3497297,3497346
26350,48,47,2,10.67,60.31,3497346,3497394
26351,44,83,1,11.64,185.32,3497393,3497437
26352,56,28,1,9.14,39.48,3497436,3497492
26353,44,38,2,11.64,81.41,3497491,3497535
26354,54,30,2,9.48,47.73,3497535,3497589
26355,65,31,1,7.88,41.74,3497588,3497653
26356,41,78,2,12.49,170.35,3497652,3497693
26357,8,189,6,64.00,3368.50,3497692,3497700
26358,30,95,1,17.07,346.13,3497699,3497729
26359,26,130,1,19.69,652.91,3497728,3497754
26360,48,81,0,10.67,183.31,3497753,3497801
26361,54,75,1,9.48,144.06,3497800,3497854
26362,36,201,2,14.22,1032.23,3497853,3497889
26363,47,78,1,10.89,188.69,3497888,3497935
26364,48,38,1,10.67,79.64,3497935,3497983
26365,43,79,1,11.91,177.11,3497982,3498025
26366,78,24,0,6.56,26.22,3498024,3498102
26367,64,37,0,8.00,59.94,3498101,3498165
26368,55,147,0,9.31,399.92,3498164,3498219
26369,9,437,1,56.89,18100.10,3498218,3498227
26370,65,45,1,7.88,81.74,3498226,3498291
26371,73,32,1,7.01,39.66,3498290,3498363
26372,60,38,1,8.53,50.88,3498362,3498422
26373,60,90,0,8.53,141.68,3498421,3498481
26374,59,38,1,8.68,46.42,3498480,3498539
26375,52,61,0,9.85,111.63,3498538,3498590
26376,69,35,1,7.42,47.37,3498590,3498659
26377,61,37,1,8.39,57.52,3498658,3498719
26378,46,35,2,11.13,53.42,3498718,3498764
26379,42,41,1,12.19,108.68,3498763,3498805
26380,51,39,1,10.04,46.31,3498804,3498855
26381,62,34,1,8.26,45.13,3498854,3498916
26382,53,32,1,9.66,51.32,3498915,3498968
26383,51,54,2,10.04,72.98,3498968,3499019
26384,51,34,1,10.04,57.57,3499018,3499069
26385,40,87,1,12.80,186.71,3499068,3499108
26386,52,38,1,9.85,70.67,3499107,3499159
26387,41,68,0,12.49,161.47,3499158,3499199
26388,67,36,1,7.64,30.68,3499198,3499265
26389,51,36,1,10.04,76.39,3499264,3499315
26390,42,99,2,12.19,224.73,3499314,3499356
26391,42,136,1,12.19,414.77,3499356,3499398
26392,49,54,0,10.45,84.66,3499397,3499446
26393,56,40,1,9.14,49.62,3499445,3499501
26394,48,38,1,10.67,53.68,3499500,3499548
26395,43,63,1,11.91,126.13,3499547,3499590
26396,50,62,2,10.24,95.74,3499589,3499639
26397,46,101,2,11.13,229.90,3499638,3499684
26398,61,66,1,8.39,94.24,3499683,3499744
26399,56,27,1,9.14,33.16,3499743,3499799
26400,27,77,2,18.96,432.18,3499799,3499826
26401,17,159,0,30.12,1398.93,3499825,3499842
26402,30,122,1,17.07,591.93,3499841,3499871
26403,46,33,1,11.13,72.07,3499870,3499916
26404,52,69,1,9.85,104.21,3499915,3499967
26405,58,68,0,8.83,116.14,3499966,3500024
26406,49,52,1,10.45,89.35,3500024,3500073
26407,67,25,0,7.64,32.71,3500072,3500139
26408,91,27,0,5.63,34.34,3500138,3500229
26409,45,45,1,11.38,105.66,3500228,3500273
26410,68,44,0,7.53,70.40,3500272,3500340
26411,54,55,1,9.48,121.29,3500339,3500393
26412,77,61,0,6.65,112.31,3500393,3500470
26413,51,109,1,10.04,335.49,3500469,3500520
26414,56,90,0,9.14,177.30,3500519,3500575
26415,42,141,1,12.19,500.49,3500575,3500617
26416,65,23,0,7.88,37.15,3500616,3500681
26417,63,25,1,8.13,30.17,3500680,3500743
26418,76,26,0,6.74,27.06,3500743,3500819
26419,36,161,1,14.22,697.90,3500818,3500854
26420,68,25,0,7.53,25.66,3500853,3500921
26421,64,41,1,8.00,65.25,3500920,3500984
26422,40,99,1,12.80,334.61,3500983,3501023
26423,66,47,1,7.76,72.49,3501022,3501088
26424,50,74,1,10.24,148.22,3501087,3501137
26425,38,86,0,13.47,209.20,3501136,3501174
26426,46,70,1,11.13,132.33,3501173,3501219
26427,54,49,1,9.48,68.69,3501218,3501272
26428,34,146,1,15.06,590.58,3501271,3501305
26429,48,31,1,10.67,43.43,3501304,3501352
26430,61,29,0,8.39,34.86,3501351,3501412
26431,41,74,2,12.49,146.01,3501411,3501452
26432,43,51,1,11.91,102.22,3501451,3501494
26433,29,106,2,17.66,448.43,3501493,3501522
26434,21,111,4,24.38,1203.95,3501521,3501542
26435,62,31,1,8.26,35.87,3501541,3501603
26436,48,32,2,10.67,61.76,3501603,3501651
26437,52,55,0,9.85,91.78,3501650,3501702
26438,34,46,1,15.06,158.11,3501701,3501735
26439,48,46,2,10.67,80.39,3501734,3501782
26440,60,36,1,8.53,39.45,3501781,3501841
26441,50,42,1,10.24,49.94,3501840,3501890
26442,46,35,3,11.13,45.16,3501889,3501935
26443,42,79,2,12.19,175.15,3501934,3501976
26444,44,85,2,11.64,181.96,3501975,3502019
26445,46,64,2,11.13,135.50,3502019,3502065
26446,44,78,1,11.64,165.69,3502064,3502108
26447,48,104,0,10.67,240.68,3502107,3502155
26448,44,43,1,11.64,71.37,3502154,3502198
26449,28,66,3,18.29,288.35,3502197,3502225
26450,32,52,3,16.00,145.50,3502224,3502256
26451,29,71,1,17.66,415.67,3502255,3502284
26452,24,152,6,21.33,843.39,3502283,3502307
26453,45,53,2,11.38,91.84,3502306,3502351
26454,38,60,1,13.47,161.30,3502350,3502388
26455,38,157,1,13.47,649.09,3502387,3502425
26456,48,107,1,10.67,239.18,3502424,3502472
26457,26,101,5,19.69,491.21,3502471,3502497
26458,31,118,1,16.52,601.93,3502496,3502527
26459,40,79,0,12.80,235.21,3502527,3502567
26460,58,55,1,8.83,96.90,3502567,3502625
26461,46,39,2,11.13,73.24,3502625,3502671
26462,53,57,1,9.66,162.26,3502671,3502724
26463,79,27,0,6.48,29.72,3502724,3502803
26464,42,74,1,12.19,185.77,3502802,3502844
26465,71,67,1,7.21,96.96,3502843,3502914
26466,81,62,0,6.32,58.69,3502913,3502994
26467,58,50,0,8.83,85.04,3502993,3503051
26468,50,37,1,10.24,69.94,3503050,3503100
26469,53,101,1,9.66,255.05,3503100,3503153
26470,65,37,0,7.88,43.55,3503152,3503217
26471,49,62,1,10.45,108.90,3503216,3503265
26472,72,26,0,7.11,28.43,3503264,3503336
26473,55,51,1,9.31,66.50,3503335,3503390
26474,49,92,1,10.45,190.12,3503389,3503438
26475,56,55,1,9.14,72.98,3503437,3503493
26476,65,24,1,7.88,25.12,3503492,3503557
26477,22,267,3,23.27,2898.74,3503556,3503578
26478,67,50,1,7.64,51.27,3503577,3503644
26479,57,42,1,8.98,65.21,3503644,3503701
26480,61,29,0,8.39,38.86,3503700,3503761
26481,57,60,0,8.98,84.33,3503760,3503817
26482,49,51,1,10.45,110.66,3503817,3503866
26483,47,34,0,10.89,68.78,3503865,3503912
26484,46,36,2,11.13,61.59,3503911,3503957
26485,42,56,2,12.19,114.58,3503956,3503998
26486,26,73,4,19.69,255.14,3503997,3504023
26487,50,64,1,10.24,108.78,3504022,3504072
26488,41,69,2,12.49,159.47,3504071,3504112
26489,52,30,1,9.85,37.28,3504111,3504163
26490,50,43,1,10.24,83.78,3504162,3504212
26491,47,45,2,10.89,81.97,3504211,3504258
26492,36,117,2,14.22,409.95,3504258,3504294
26493,51,41,2,10.04,60.04,3504294,3504345
26494,46,42,2,11.13,77.98,3504344,3504390
26495,55,32,0,9.31,42.54,3504389,3504444
26496,56,28,1,9.14,36.62,3504443,3504499
26497,47,74,1,10.89,124.22,3504498,3504545
26498,51,47,0,10.04,79.06,3504544,3504595
26499,49,52,1,10.45,76.94,3504594,3504643
26500,44,85,1,11.64,190.64,3504642,3504686
26501,20,96,3,25.60,539.54,3504685,3504705
26502,25,95,2,20.48,616.01,3504704,3504729
26503,24,90,4,21.33,477.97,3504728,3504752
26504,25,73,1,20.48,562.89,3504751,3504776
26505,32,67,2,16.00,196.56,3504775,3504807
26506,42,103,1,12.19,266.49,3504806,3504848
26507,55,62,0,9.31,97.60,3504847,3504902
26508,40,65,1,12.80,156.11,3504901,3504941
26509,28,185,1,18.29,1138.70,3504940,3504968
26510,66,56,0,7.76,77.18,3504967,3505033
26511,27,121,1,18.96,678.55,3505032,3505059
26512,37,64,1,13.84,189.76,3505058,3505095
26513,79,48,1,6.48,47.46,3505094,3505173
26514,61,54,1,8.39,107.48,3505172,3505233
26515,52,49,1,9.85,73.25,3505232,3505284
26516,50,55,0,10.24,130.54,3505283,3505333
26517,52,88,1,9.85,171.09,3505332,3505384
26518,69,83,0,7.42,130.16,3505383,3505452
26519,83,29,1,6.17,36.96,3505451,3505534
26520,48,110,1,10.67,238.43,3505533,3505581
26521,69,20,0,7.42,24.04,3505580,3505649
26522,47,66,2,10.89,102.14,3505648,3505695
26523,52,100,1,9.85,213.36,3505694,3505746
26524,57,65,1,8.98,85.70,3505745,3505802
26525,64,31,1,8.00,27.56,3505801,3505865
26526,67,35,1,7.64,38.92,3505864,3505931
26527,58,86,1,8.83,150.63,3505930,3505988
26528,65,31,0,7.88,43.31,3505987,3506052
26529,32,168,1,16.00,824.38,3506051,3506083
26530,60,60,1,8.53,73.35,3506082,3506142
26531,45,105,2,11.38,266.01,3506141,3506186
26532,34,57,1,15.06,189.17,3506185,3506219
26533,36,93,2,14.22,278.84,3506218,3506254
26534,45,87,1,11.38,191.30,3506253,3506298
26535,58,41,1,8.83,37.42,3506297,3506355
26536,55,34,1,9.31,50.03,3506354,3506409
26537,54,36,2,9.48,54.51,3506408,3506462
26538,39,58,2,13.13,129.24,3506461,3506500
26539,58,44,0,8.83,56.38,3506499,3506557
26540,61,25,1,8.39,33.09,3506556,3506617
26541,57,39,1,8.98,55.32,3506616,3506673
26542,39,51,2,13.13,106.16,3506673,3506712
26543,48,90,1,10.67,177.72,3506711,3506759
26544,31,146,2,16.52,680.38,3506758,3506789
26545,63,40,1,8.13,43.98,3506788,3506851
26546,49,34,1,10.45,58.82,3506850,3506899
26547,62,26,1,8.26,26.42,3506898,3506960
26548,36,49,1,14.22,150.28,3506959,3506995
26549,50,33,1,10.24,49.66,3506994,3507044
26550,48,31,1,10.67,49.01,3507043,3507091
26551,54,22,2,9.48,29.66,3507090,3507144
26552,57,42,1,8.98,65.67,3507144,3507201
26553,54,38,2,9.48,52.25,3507200,3507254
26554,18,99,2,28.44,916.02,3507253,3507271
26555,19,92,4,26.95,532.16,3507270,3507289
26556,30,72,1,17.07,317.60,3507288,3507318
26557,46,36,1,11.13,102.50,3507317,3507363
26558,43,83,1,11.91,193.25,3507362,3507405
26559,37,47,2,13.84,110.89,3507404,3507441
26560,45,57,1,11.38,122.10,3507440,3507485
26561,51,95,0,10.04,244.63,3507484,3507535
26562,47,44,1,10.89,107.75,3507534,3507581
26563,37,125,1,13.84,417.49,3507580,3507617
26564,54,58,1,9.48,132.32,3507616,3507670
26565,62,39,0,8.26,80.29,3507669,3507731
26566,56,24,0,9.14,49.52,3507730,3507786
26567,75,40,0,6.83,61.08,3507785,3507860
26568,65,37,1,7.88,62.20,3507859,3507924
26569,83,41,1,6.17,38.84,3507923,3508006
26570,56,40,1,9.14,63.69,3508005,3508061
26571,70,31,0,7.31,42.24,3508060,3508130
26572,52,29,2,9.85,37.44,3508129,3508181
26573,62,65,1,8.26,73.58,3508180,3508242
26574,58,111,0,8.83,205.56,3508241,3508299
26575,60,46,1,8.53,49.85,3508298,3508358
26576,74,25,1,6.92,21.53,3508357,3508431
26577,45,57,0,11.38,120.81,3508430,3508475
26578,77,31,0,6.65,32.57,3508474,3508551
26579,51,143,1,10.04,390.63,3508551,3508602
26580,49,48,1,10.45,112.12,3508601,3508650
26581,40,120,1,12.80,364.91,3508649,3508689
26582,53,35,2,9.66,47.24,3508688,3508741
26583,56,40,1,9.14,58.37,3508740,3508796
26584,45,46,1,11.38,77.04,3508795,3508840
26585,6,180,8,85.33,5993.89,3508839,3508845
26586,48,58,1,10.67,82.22,3508844,3508892
26587,51,24,1,10.04,27.45,3508891,3508942
26588,45,45,1,11.38,64.81,3508941,3508986
26589,57,31,2,8.98,31.00,3508985,3509042
26590,52,55,1,9.85,79.17,3509041,3509093
26591,51,74,1,10.04,160.35,3509092,3509143
26592,46,41,1,11.13,72.94,3509142,3509188
26593,28,213,1,18.29,1445.78,3509187,3509215
26594,44,52,1,11.64,117.14,3509214,3509258
26595,47,41,1,10.89,90.65,3509257,3509304
26596,41,70,2,12.49,143.03,3509303,3509344
26597,48,32,1,10.67,48.72,3509343,3509391
26598,52,45,0,9.85,67.36,3509390,3509442
26599,46,52,1,11.13,80.68,3509441,3509487
26600,59,29,2,8.68,39.34,3509486,3509545
26601,53,33,1,9.66,44.07,3509544,3509597
26602,37,190,1,13.84,919.70,3509596,3509633
26603,55,45,1,9.31,69.34,3509632,3509687
26604,29,76,2,17.66,235.05,3509686,3509715
26605,29,76,2,17.66,291.19,3509714,3509743
26606,33,48,2,15.52,141.83,3509742,3509775
26607,36,69,1,14.22,174.06,3509774,3509810
26608,47,63,1,10.89,117.24,3509809,3509856
26609,46,68,1,11.13,128.55,3509855,3509901
26610,47,44,1,10.89,93.46,3509900,3509947
26611,42,51,1,12.19,158.96,3509946,3509988
26612,33,155,0,15.52,894.86,3509987,3510020
26613,45,49,1,11.38,76.24,3510019,3510064
26614,42,86,1,12.19,228.39,3510063,3510105
26615,20,361,1,25.60,5983.34,3510104,3510124
26616,41,234,0,12.49,1292.35,3510123,3510164
26617,73,31,0,7.01,35.90,3510163,3510236
26618,57,39,0,8.98,74.16,3510235,3510292
26619,47,133,1,10.89,539.37,3510292,3510339
26620,58,55,1,8.83,64.28,3510338,3510396
26621,77,107,0,6.65,180.70,3510395,3510472
26622,59,32,1,8.68,39.64,3510471,3510530
26623,61,36,1,8.39,55.85,3510529,3510590
26624,70,23,1,7.31,23.16,3510589,3510659
26625,64,25,1,8.00,29.12,3510658,3510722
26626,52,129,1,9.85,306.55,3510721,3510773
26627,42,71,1,12.19,296.73,3510772,3510814
26628,63,51,1,8.13,53.32,3510813,3510876
26629,74,24,1,6.92,28.75,3510875,3510949
26630,58,85,1,8.83,155.90,3510948,3511006
26631,44,161,0,11.64,583.69,3511005,3511049
26632,65,31,0,7.88,32.75,3511048,3511113
26633,62,22,0,8.26,25.68,3511112,3511174
26634,44,34,1,11.64,65.96,3511173,3511217
26635,43,95,2,11.91,225.25,3511216,3511259
26636,47,118,0,10.89,274.31,3511258,3511305
26637,43,105,1,11.91,343.71,3511304,3511347
26638,38,49,3,13.47,109.67,3511346,3511384
26639,52,34,1,9.85,45.21,3511383,3511435
26640,42,59,1,12.19,109.01,3511434,3511476
26641,37,153,0,13.84,648.14,3511475,3511512
26642,46,57,1,11.13,95.59,3511512,3511558
26643,54,41,2,9.48,63.21,3511557,3511611
26644,39,80,2,13.13,191.19,3511610,3511649
26645,52,22,1,9.85,29.82,3511648,3511700
26646,56,60,1,9.14,116.87,3511699,3511755
26647,40,60,2,12.80,113.16,3511754,3511794
26648,40,67,1,12.80,152.26,3511793,3511833
26649,54,44,0,9.48,56.14,3511832,3511886
26650,41,97,2,12.49,209.66,3511885,3511926
26651,42,51,0,12.19,143.87,3511925,3511967
26652,48,37,1,10.67,70.97,3511966,3512014
26653,54,34,1,9.48,62.18,3512014,3512068
26654,55,66,1,9.31,91.81,3512067,3512122
26655,48,37,1,10.67,74.60,3512121,3512169
26656,34,130,3,15.06,449.58,3512168,3512202
26657,41,62,1,12.49,145.18,3512201,3512242
26658,41,47,0,12.49,130.93,3512241,3512282
26659,51,58,1,10.04,120.59,3512281,3512332
26660,45,66,1,11.38,116.68,3512331,3512376
26661,33,76,2,15.52,329.40,3512375,3512408
26662,46,42,1,11.13,76.33,3512407,3512453
26663,44,158,1,11.64,541.87,3512452,3512496
26664,40,53,1,12.80,155.61,3512495,3512535
26665,30,203,1,17.07,1246.00,3512534,3512564
26666,77,25,0,6.65,23.24,3512564,3512641
26667,75,44,0,6.83,81.50,3512640,3512715
26668,47,80,1,10.89,164.95,3512714,3512761
26669,56,38,1,9.14,70.62,3512760,3512816
26670,95,31,0,5.39,27.40,3512816,3512911
26671,63,39,1,8.13,37.41,3512910,3512973
26672,47,44,1,10.89,72.01,3512972,3513019
26673,71,34,0,7.21,37.63,3513019,3513090
26674,60,50,1,8.53,97.85,3513089,3513149
26675,61,37,1,8.39,62.34,3513148,3513209
26676,60,60,1,8.53,71.72,3513208,3513268
26677,65,31,1,7.88,43.18,3513267,3513332
26678,55,54,0,9.31,109.67,3513331,3513386
26679,57,52,1,8.98,83.91,3513385,3513442
26680,63,38,1,8.13,47.95,3513441,3513504
26681,54,88,1,9.48,146.55,3513503,3513557
26682,63,109,1,8.13,189.79,3513557,3513620
26683,64,56,1,8.00,62.12,3513619,3513683
26684,37,60,1,13.84,194.78,3513682,3513719
26685,67,53,0,7.64,82.14,3513718,3513785
26686,44,47,1,11.64,87.14,3513784,3513828
26687,38,109,0,13.47,322.46,3513827,3513865
26688,52,31,1,9.85,39.32,3513864,3513916
26689,51,45,0,10.04,104.16,3513915,3513966
26690,48,73,1,10.67,115.35,3513966,3514014
26691,40,43,0,12.80,118.16,3514013,3514053
26692,41,130,1,12.49,426.84,3514052,3514093
26693,47,41,2,10.89,57.03,3514092,3514139
26694,50,31,2,10.24,43.02,3514138,3514188
26695,57,31,1,8.98,56.51,3514187,3514244
26696,64,20,1,8.00,24.97,3514243,3514307
26697,41,61,2,12.49,140.59,3514306,3514347
26698,36,84,1,14.22,329.12,3514346,3514382
26699,37,92,2,13.84,337.54,3514381,3514418
26700,44,64,1,11.64,155.87,3514417,3514461
26701,46,45,3,11.13,59.50,3514460,3514506
26702,58,41,0,8.83,50.25,3514505,3514563
26703,56,25,1,9.14,31.80,3514562,3514618
26704,44,40,3,11.64,52.14,3514617,3514661
26705,53,54,1,9.66,70.26,3514660,3514713
26706,52,27,0,9.85,33.75,3514712,3514764
26707,51,43,1,10.04,65.10,3514763,3514814
26708,57,30,2,8.98,40.37,3514813,3514870
26709,32,61,1,16.00,166.06,3514870,3514902
26710,24,128,1,21.33,695.14,3514901,3514925
26711,42,36,1,12.19,71.68,3514924,3514966
26712,51,94,0,10.04,179.61,3514965,3515016
26713,45,31,1,11.38,57.97,3515015,3515060
26714,67,38,0,7.64,54.26,3515059,3515126
26715,46,82,1,11.13,207.77,3515126,3515172
26716,19,284,2,26.95,3790.05,3515171,3515190
26717,80,32,0,6.40,48.06,3515189,3515269
26718,46,47,1,11.13,100.11,3515268,3515314
26719,63,42,1,8.13,66.17,3515314,3515377
26720,24,384,1,21.33,5759.39,3515376,3515400
26721,57,55,1,8.98,135.67,3515399,3515456
26722,26,317,1,19.69,3580.67,3515455,3515481
26723,48,136,1,10.67,500.35,3515480,3515528
26724,66,71,0,7.76,130.37,3515527,3515593
26725,67,40,1,7.64,40.83,3515592,3515659
26726,47,67,0,10.89,148.10,3515658,3515705
26727,76,30,1,6.74,33.38,3515704,3515780
26728,67,50,0,7.64,53.51,3515780,3515847
26729,63,26,0,8.13,33.83,3515846,3515909
26730,58,29,1,8.83,35.00,3515908,3515966
26731,40,129,1,12.80,425.16,3515965,3516005
26732,57,31,1,8.98,52.19,3516004,3516061
26733,49,48,1,10.45,106.57,3516060,3516109
26734,59,43,1,8.68,62.32,3516108,3516167
26735,56,58,1,9.14,85.69,3516166,3516222
26736,51,30,1,10.04,41.49,3516221,3516272
26737,85,23,1,6.02,19.01,3516271,3516356
26738,70,33,0,7.31,39.44,3516355,3516425
26739,45,65,1,11.38,151.08,3516424,3516469
26740,54,43,1,9.48,64.81,3516469,3516523
26741,47,41,0,10.89,63.20,3516522,3516569
26742,43,37,2,11.91,75.57,3516569,3516612
26743,39,183,1,13.13,799.34,3516612,3516651
26744,61,76,0,8.39,95.19,3516650,3516711
26745,48,90,1,10.67,159.43,3516710,3516758
26746,55,30,2,9.31,39.96,3516757,3516812
26747,23,111,3,22.26,943.76,3516812,3516835
26748,35,89,1,14.63,416.18,3516834,3516869
26749,56,37,0,9.14,42.27,3516868,3516924
26750,43,76,1,11.91,205.11,3516923,3516966
26751,45,44,1,11.38,71.84,3516965,3517010
26752,52,36,0,9.85,50.32,3517009,3517061
26753,53,39,1,9.66,65.92,3517060,3517113
26754,47,61,2,10.89,108.82,3517112,3517159
26755,52,35,1,9.85,53.21,3517158,3517210
26756,51,72,1,10.04,124.19,3517209,3517260
26757,35,54,3,14.63,166.06,3517259,3517294
26758,58,35,0,8.83,58.90,3517293,3517351
26759,35,66,1,14.63,189.26,3517350,3517385
26760,27,72,1,18.96,308.11,3517384,3517411
26761,32,125,1,16.00,505.62,3517410,3517442
26762,30,97,1,17.07,492.60,3517441,3517471
26763,28,71,1,18.29,366.13,3517470,3517498
26764,37,62,1,13.84,173.38,3517497,3517534
26765,52,33,1,9.85,72.28,3517533,3517585
26766,39,46,1,13.13,149.80,3517584,3517623
26767,41,118,0,12.49,567.42,3517622,3517663
26768,38,76,0,13.47,234.30,3517662,3517700
26769,33,66,1,15.52,226.25,3517699,3517732
26770,52,83,1,9.85,159.71,3517731,3517783
26771,54,79,1,9.48,294.03,3517782,3517836
26772,61,61,1,8.39,117.68,3517835,3517896
26773,64,41,0,8.00,66.47,3517895,3517959
26774,59,52,1,8.68,83.85,3517958,3518017
26775,62,69,0,8.26,160.45,3518016,3518078
26776,40,96,1,12.80,293.81,3518078,3518118
26777,45,49,0,11.38,111.61,3518117,3518162
26778,51,57,1,10.04,134.23,3518161,3518212
26779,60,54,0,8.53,67.68,3518211,3518271
26780,66,28,1,7.76,43.40,3518270,3518336
26781,39,144,1,13.13,531.80,3518335,3518374
26782,47,75,2,10.89,145.16,3518373,3518420
26783,48,34,1,10.67,57.31,3518419,3518467
26784,65,27,0,7.88,38.88,3518466,3518531
26785,68,41,0,7.53,57.87,3518531,3518599
26786,29,179,2,17.66,994.02,3518598,3518627
26787,66,26,1,7.76,31.27,3518626,3518692
26788,54,37,1,9.48,69.99,3518691,3518745
26789,37,150,2,13.84,562.73,3518744,3518781
26790,52,37,1,9.85,75.48,3518780,3518832
26791,42,103,1,12.19,293.77,3518831,3518873
26792,42,82,1,12.19,167.87,3518872,3518914
26793,51,41,0,10.04,62.04,3518913,3518964
26794,47,88,0,10.89,188.52,3518963,3519010
26795,47,39,1,10.89,67.92,3519009,3519056
26796,47,41,3,10.89,61.97,3519055,3519102
26797,40,69,3,12.80,161.11,3519101,3519141
26798,51,40,1,10.04,58.04,3519140,3519191
26799,54,39,1,9.48,59.47,3519190,3519244
26800,46,73,1,11.13,123.68,3519243,3519289
26801,57,31,0,8.98,46.23,3519288,3519345
26802,36,82,1,14.22,232.95,3519344,3519380
26803,43,32,3,11.91,62.55,3519379,3519422
26804,39,39,1,13.13,96.06,3519421,3519460
26805,39,50,2,13.13,141.29,3519459,3519498
26806,50,31,1,10.24,65.14,3519497,3519547
26807,48,58,1,10.67,124.01,3519546,3519594
26808,53,65,1,9.66,87.73,3519593,3519646
26809,41,61,2,12.49,168.20,3519645,3519686
26810,40,55,1,12.80,150.41,3519685,3519725
26811,49,55,1,10.45,105.51,3519724,3519773
26812,39,68,2,13.13,156.32,3519772,3519811
26813,62,34,1,8.26,53.61,3519810,3519872
26814,48,83,1,10.67,202.26,3519871,3519919
26815,25,86,0,20.48,495.69,3519918,3519943
26816,23,87,2,22.26,488.71,3519942,3519965
26817,19,102,2,26.95,1045.52,3519964,3519983
26818,31,88,1,16.52,375.48,3519982,3520013
26819,44,38,1,11.64,92.91,3520012,3520056
26820,48,69,1,10.67,145.89,3520055,3520103
26821,43,45,1,11.91,111.67,3520102,3520145
26822,41,41,1,12.49,88.05,3520144,3520185
26823,46,62,1,11.13,141.16,3520184,3520230
26824,44,157,0,11.64,570.55,3520229,3520273
26825,53,36,1,9.66,56.94,3520272,3520325
26826,71,41,1,7.21,51.77,3520324,3520395
26827,69,37,0,7.42,40.71,3520394,3520463
26828,51,68,1,10.04,150.59,3520462,3520513
26829,49,83,0,10.45,223.68,3520512,3520561
26830,50,65,1,10.24,107.06,3520560,3520610
26831,92,38,0,5.57,31.14,3520609,3520701
26832,59,70,1,8.68,99.37,3520700,3520759
26833,48,51,1,10.67,73.39,3520758,3520806
26834,70,35,0,7.31,39.47,3520805,3520875
26835,64,39,1,8.00,43.84,3520874,3520938
26836,44,120,1,11.64,400.46,3520938,3520982
26837,56,64,1,9.14,126.69,3520981,3521037
26838,43,61,1,11.91,134.92,3521036,3521079
26839,52,73,2,9.85,109.40,3521078,3521130
26840,66,22,0,7.76,30.18,3521129,3521195
26841,56,64,1,9.14,101.98,3521194,3521250
26842,71,24,0,7.21,31.24,3521249,3521320
26843,54,103,1,9.48,189.47,3521319,3521373
26844,57,38,1,8.98,49.84,3521372,3521429
26845,70,38,1,7.31,45.27,3521428,3521498
26846,46,107,1,11.13,297.77,3521497,3521543
26847,47,138,1,10.89,401.16,3521542,3521589
26848,32,198,1,16.00,1139.94,3521588,3521620
26849,69,44,1,7.42,41.78,3521619,3521688
26850,54,49,2,9.48,59.77,3521687,3521741
26851,50,32,2,10.24,45.14,3521741,3521791
26852,52,72,1,9.85,117.63,3521790,3521842
26853,40,69,1,12.80,200.76,3521841,3521881
26854,49,35,1,10.45,51.39,3521880,3521929
26855,25,55,2,20.48,240.01,3521928,3521953
26856,53,42,1,9.66,54.11,3521952,3522005
26857,43,89,1,11.91,177.15,3522004,3522047
26858,39,109,1,13.13,305.03,3522046,3522085
26859,52,45,2,9.85,77.32,3522084,3522136
26860,55,32,0,9.31,57.05,3522135,3522190
26861,41,54,3,12.49,133.52,3522189,3522230
26862,44,83,1,11.64,189.69,3522229,3522273
26863,46,55,1,11.13,92.37,3522272,3522318
26864,48,46,2,10.67,70.26,3522317,3522365
26865,47,33,1,10.89,47.97,3522364,3522411
26866,45,49,2,11.38,95.39,3522411,3522456
26867,40,51,1,12.80,148.46,3522455,3522495
26868,51,49,0,10.04,92.63,3522494,3522545
26869,45,49,1,11.38,63.97,3522544,3522589
26870,36,77,1,14.22,310.12,3522588,3522624
26871,48,34,2,10.67,64.60,3522623,3522671
26872,47,34,0,10.89,73.58,3522670,3522717
26873,37,47,1,13.84,118.14,3522716,3522753
26874,23,173,2,22.26,1211.58,3522752,3522775
26875,39,60,1,13.13,152.57,3522774,3522813
26876,36,81,1,14.22,408.78,3522812,3522848
26877,55,44,1,9.31,66.25,3522847,3522902
26878,47,36,2,10.89,68.05,3522901,3522948
26879,42,65,2,12.19,160.68,3522948,3522990
26880,63,61,0,8.13,87.98,3522989,3523052
26881,36,131,1,14.22,486.51,3523051,3523087
26882,35,120,2,14.63,531.26,3523087,3523122
26883,42,94,0,12.19,334.82,3523121,3523163
26884,49,58,1,10.45,97.27,3523162,3523211
26885,87,31,0,5.89,41.55,3523210,3523297
26886,67,43,0,7.64,49.72,3523296,3523363
26887,52,42,1,9.85,103.21,3523362,3523414
26888,63,74,0,8.13,132.97,3523413,3523476
26889,13,371,1,39.38,9337.01,3523475,3523488
26890,31,143,1,16.52,1038.70,3523487,3523518
26891,48,144,1,10.67,422.18,3523517,3523565
26892,63,26,1,8.13,36.81,3523564,3523627
26893,46,40,2,11.13,75.90,3523626,3523672
26894,58,54,1,8.83,67.11,3523671,3523729
26895,74,43,1,6.92,41.02,3523728,3523802
26896,59,74,0,8.68,104.46,3523802,3523861
26897,44,59,1,11.64,202.28,3523860,3523904
26898,59,43,1,8.68,63.30,3523903,3523962
26899,55,31,1,9.31,47.23,3523962,3524017
26900,54,47,1,9.48,88.51,3524016,3524070
26901,52,59,1,9.85,121.01,3524069,3524121
26902,79,31,1,6.48,27.31,3524120,3524199
26903,63,50,0,8.13,59.60,3524198,3524261
26904,59,41,1,8.68,50.35,3524260,3524319
26905,50,78,1,10.24,135.98,3524318,3524368
26906,55,43,1,9.31,61.52,3524367,3524422
26907,49,130,0,10.45,411.19,3524421,3524470
26908,52,48,1,9.85,98.63,3524469,3524521
26909,33,137,1,15.52,700.61,3524520,3524553
26910,45,76,1,11.38,173.79,3524553,3524598
26911,50,38,1,10.24,101.06,3524597,3524647
26912,21,161,3,24.38,1362.14,3524646,3524667
26913,41,135,1,12.49,428.59,3524666,3524707
26914,48,87,0,10.67,176.56,3524706,3524754
26915,35,123,1,14.63,400.63,3524753,3524788
26916,41,116,1,12.49,354.69,3524787,3524828
26917,53,42,0,9.66,62.41,3524827,3524880
26918,59,24,1,8.68,36.96,3524879,3524938
26919,50,41,0,10.24,69.78,3524937,3524987
26920,41,82,3,12.49,217.57,3524986,3525027
26921,42,88,2,12.19,184.15,3525026,3525068
26922,41,95,2,12.49,248.40,3525067,3525108
26923,42,84,1,12.19,184.87,3525107,3525149
26924,52,41,1,9.85,57.51,3525148,3525200
26925,47,91,0,10.89,193.20,3525199,3525246
26926,45,35,2,11.38,68.55,3525245,3525290
26927,51,30,1,10.04,50.78,3525289,3525340
26928,44,43,1,11.64,88.32,3525339,3525383
26929,51,30,2,10.04,50.51,3525382,3525433
26930,46,61,1,11.13,97.59,3525432,3525478
26931,54,30,1,9.48,38.77,3525478,3525532
26932,57,28,1,8.98,38.05,3525531,3525588
26933,42,94,2,12.19,225.20,3525587,3525629
26934,49,78,2,10.45,156.49,3525628,3525677
26935,37,76,1,13.84,217.11,3525676,3525713
26936,33,92,1,15.52,331.89,3525712,3525745
26937,23,74,1,22.26,431.24,3525744,3525767
26938,29,115,1,17.66,463.54,3525766,3525795
26939,39,176,2,13.13,759.91,3525794,3525833
26940,45,82,1,11.38,195.88,3525832,3525877
26941,42,50,1,12.19,120.39,3525876,3525918
26942,56,62,1,9.14,90.98,3525918,3525974
26943,37,99,1,13.84,447.16,3525973,3526010
26944,30,50,1,17.07,216.60,3526009,3526039
26945,61,38,1,8.39,49.03,3526038,3526099
26946,63,38,1,8.13,45.60,3526098,3526161
26947,69,56,0,7.42,86.13,3526160,3526229
26948,67,39,1,7.64,42.92,3526228,3526295
26949,78,41,0,6.56,55.50,3526294,3526372
26950,53,54,1,9.66,76.45,3526372,3526425
26951,61,55,1,8.39,99.98,3526424,3526485
26952,75,54,0,6.83,80.04,3526484,3526559
26953,98,67,0,5.22,57.79,3526558,3526656
26954,51,58,1,10.04,111.06,3526655,3526706
26955,41,76,2,12.49,202.79,3526705,3526746
26956,68,53,0,7.53,91.60,3526745,3526813
26957,57,36,1,8.98,48.58,3526812,3526869
26958,61,36,1,8.39,45.81,3526868,3526929
26959,64,33,1,8.00,39.12,3526928,3526992
26960,40,56,1,12.80,150.66,3526992,3527032
26961,47,60,1,10.89,115.07,3527031,3527078
26962,39,59,1,13.13,205.24,3527077,3527116
26963,56,55,1,9.14,71.98,3527115,3527171
26964,56,50,1,9.14,78.30,3527170,3527226
26965,53,43,1,9.66,72.68,3527225,3527278
26966,49,76,1,10.45,145.72,3527277,3527326
26967,43,40,1,11.91,96.32,3527325,3527368
26968,32,264,0,16.00,2059.75,3527368,3527400
26969,80,49,1,6.40,36.77,3527400,3527480
26970,57,126,0,8.98,309.35,3527479,3527536
26971,52,53,1,9.85,105.40,3527535,3527587
26972,53,71,1,9.66,110.19,3527586,3527639
26973,37,119,1,13.84,491.70,3527638,3527675
26974,40,81,1,12.80,198.06,3527674,3527714
26975,51,25,0,10.04,33.29,3527713,3527764
26976,50,81,1,10.24,146.78,3527763,3527813
26977,33,94,1,15.52,387.46,3527812,3527845
26978,62,20,1,8.26,16.09,3527844,3527906
26979,52,34,1,9.85,59.09,3527905,3527957
26980,35,76,1,14.63,232.98,3527956,3527991
26981,38,133,3,13.47,424.25,3527990,3528028
26982,29,125,3,17.66,659.33,3528027,3528056
26983,48,58,0,10.67,90.43,3528055,3528103
26984,37,87,0,13.84,251.54,3528102,3528139
26985,45,87,2,11.38,181.70,3528138,3528183
26986,50,37,2,10.24,67.42,3528182,3528232
26987,43,69,1,11.91,134.27,3528231,3528274
26988,52,39,1,9.85,51.98,3528273,3528325
26989,51,49,2,10.04,80.39,3528324,3528375
26990,36,107,2,14.22,330.78,3528375,3528411
26991,56,32,1,9.14,43.52,3528411,3528467
26992,56,49,2,9.14,65.62,3528466,3528522
26993,48,33,2,10.67,51.93,3528521,3528569
26994,54,49,1,9.48,77.99,3528568,3528622
26995,34,118,1,15.06,440.00,3528621,3528655
26996,31,70,2,16.52,318.12,3528654,3528685
26997,36,103,1,14.22,354.28,3528684,3528720
26998,39,50,1,13.13,122.98,3528719,3528758
26999,36,50,1,14.22,206.28,3528757,3528793
27000,51,50,1,10.04,77.25,3528792,3528843
27001,40,62,1,12.80,121.06,3528843,3528883
27002,35,153,1,14.63,685.89,3528882,3528917
27003,56,84,1,9.14,139.84,3528917,3528973
27004,46,106,1,11.13,238.11,3528972,3529018
27005,26,210,1,19.69,1906.75,3529017,3529043
27006,34,88,0,15.06,398.06,3529042,3529076
27007,54,93,1,9.48,290.03,3529075,3529129
27008,89,55,0,5.75,52.70,3529128,3529217
27009,45,70,0,11.38,135.17,3529217,3529262
27010,67,47,0,7.64,59.57,3529262,3529329
27011,79,33,0,6.48,32.68,3529328,3529407
27012,52,37,1,9.85,60.28,3529406,3529458
27013,34,116,2,15.06,455.82,3529457,3529491
27014,60,40,1,8.53,60.88,3529490,3529550
27015,53,69,0,9.66,108.79,3529549,3529602
27016,49,77,1,10.45,156.33,3529601,3529650
27017,43,95,0,11.91,343.01,3529649,3529692
27018,83,27,1,6.17,21.35,3529691,3529774
27019,58,35,0,8.83,49.21,3529773,3529831
27020,61,47,1,8.39,48.40,3529830,3529891
27021,69,43,1,7.42,44.62,3529890,3529959
27022,53,75,1,9.66,163.62,3529958,3530011
27023,58,48,1,8.83,52.83,3530010,3530068
27024,54,29,1,9.48,34.21,3530067,3530121
27025,79,54,0,6.48,44.20,3530121,3530200
27026,34,178,0,15.06,1094.47,3530200,3530234
27027,42,150,1,12.19,648.25,3530233,3530275
27028,38,34,1,13.47,70.20,3530274,3530312
27029,55,41,2,9.31,49.67,3530312,3530367
27030,57,45,1,8.98,56.79,3530366,3530423
27031,45,43,2,11.38,84.95,3530422,3530467
27032,51,28,1,10.04,41.06,3530466,3530517
27033,57,94,1,8.98,171.95,3530516,3530573
27034,48,37,2,10.67,76.68,3530572,3530620
27035,46,33,1,11.13,58.07,3530619,3530665
27036,44,45,2,11.64,73.10,3530665,3530709
27037,43,58,2,11.91,99.76,3530708,3530751
27038,43,55,1,11.91,104.78,3530750,3530793
27039,46,67,0,11.13,186.37,3530792,3530838
27040,31,96,1,16.52,462.51,3530837,3530868
27041,42,44,2,12.19,83.11,3530867,3530909
27042,30,105,4,17.07,425.46,3530909,3530939
27043,35,131,2,14.63,500.00,3530938,3530973
27044,30,68,5,17.07,178.06,3530972,3531002
27045,49,28,1,10.45,58.94,3531001,3531050
27046,55,37,1,9.31,47.96,3531050,3531105
27047,33,62,2,15.52,137.89,3531104,3531137
27048,59,31,1,8.68,31.24,3531136,3531195
27049,52,50,1,9.85,116.82,3531194,3531246
27050,46,42,1,11.13,71.50,3531245,3531291
27051,31,75,0,16.52,241.54,3531290,3531321
27052,26,174,1,19.69,1058.83,3531320,3531346
27053,33,92,1,15.52,384.86,3531346,3531379
27054,34,62,2,15.06,119.70,3531378,3531412
27055,30,41,1,17.07,160.00,3531411,3531441
27056,46,32,1,11.13,50.90,3531440,3531486
27057,48,76,0,10.67,140.68,3531485,3531533
27058,42,82,1,12.19,296.58,3531532,3531574
27059,28,198,1,18.29,1270.85,3531573,3531601
27060,53,71,0,9.66,111.32,3531600,3531653
27061,43,40,1,11.91,85.67,3531652,3531695
27062,49,62,1,10.45,127.47,3531694,3531743
27063,35,68,1,14.63,287.89,3531742,3531777
27064,52,47,1,9.85,89.86,3531776,3531828
27065,66,46,1,7.76,51.76,3531827,3531893
27066,77,28,0,6.65,47.37,3531892,3531969
27067,55,65,0,9.31,110.83,3531969,3532024
27068,65,28,0,7.88,53.58,3532023,3532088
27069,74,48,1,6.92,63.21,3532087,3532161
27070,14,356,1,36.57,8118.53,3532160,3532174
27071,56,49,1,9.14,106.37,3532173,3532229
27072,59,36,0,8.68,66.08,3532228,3532287
27073,89,58,1,5.75,68.46,3532286,3532375
27074,65,26,1,7.88,38.05,3532374,3532439
27075,56,37,1,9.14,36.87,3532439,3532495
27076,33,103,1,15.52,543.28,3532494,3532527
27077,76,26,0,6.74,33.09,3532526,3532602
27078,67,24,0,7.64,22.89,3532602,3532669
27079,64,45,1,8.00,67.16,3532668,3532732
27080,70,22,1,7.31,22.44,3532731,3532801
27081,44,65,1,11.64,155.69,3532800,3532844
27082,49,47,1,10.45,98.41,3532843,3532892
27083,54,33,1,9.48,49.14,3532891,3532945
27084,52,31,1,9.85,46.59,3532944,3532996
27085,64,39,0,8.00,47.53,3532995,3533059
27086,54,39,1,9.48,51.47,3533058,3533112
27087,62,33,1,8.26,40.90,3533111,3533173
27088,69,24,1,7.42,31.81,3533172,3533241
27089,68,38,0,7.53,48.90,3533240,3533308
27090,52,164,1,9.85,490.40,3533307,3533359
27091,47,181,1,10.89,657.67,3533358,3533405
27092,56,80,1,9.14,126.84,3533405,3533461
27093,61,28,1,8.39,37.09,3533460,3533521
27094,48,81,1,10.67,166.81,3533520,3533568
27095,44,35,1,11.64,69.60,3533567,3533611
27096,47,43,0,10.89,74.52,3533611,3533658
27097,45,40,1,11.38,56.72,3533657,3533702
27098,59,45,0,8.68,53.88,3533701,3533760
27099,42,109,1,12.19,289.30,3533760,3533802
27100,49,42,1,10.45,53.64,3533801,3533850
27101,51,66,1,10.04,83.76,3533849,3533900
27102,51,44,1,10.04,58.12,3533899,3533950
27103,36,87,1,14.22,217.62,3533949,3533985
27104,34,68,3,15.06,291.41,3533984,3534018
27105,50,42,1,10.24,56.14,3534017,3534067
27106,35,54,4,14.63,129.72,3534066,3534101
27107,53,88,1,9.66,160.83,3534101,3534154
27108,36,101,1,14.22,259.28,3534153,3534189
27109,40,52,1,12.80,122.46,3534188,3534228
27110,49,40,1,10.45,92.37,3534228,3534277
27111,37,38,3,13.84,92.68,3534276,3534313
27112,48,38,1,10.67,66.10,3534312,3534360
27113,56,30,1,9.14,34.84,3534359,3534415
27114,47,28,1,10.89,45.37,3534414,3534461
27115,57,25,3,8.98,29.84,3534460,3534517
27116,34,78,1,15.06,322.11,3534516,3534550
27117,60,58,0,8.53,75.55,3534549,3534609
27118,44,54,2,11.64,92.23,3534608,3534652
27119,36,51,2,14.22,104.51,3534651,3534687
27120,30,71,2,17.07,287.80,3534686,3534716
27121,43,60,1,11.91,163.11,3534715,3534758
27122,52,58,1,9.85,106.13,3534757,3534809
27123,48,52,1,10.67,117.68,3534808,3534856
27124,41,141,1,12.49,500.25,3534855,3534896
27125,63,40,0,8.13,65.67,3534895,3534958
27126,49,84,1,10.45,136.29,3534957,3535006
27127,51,56,1,10.04,117.21,3535005,3535056
27128,48,59,1,10.67,117.01,3535055,3535103
27129,36,92,0,14.22,388.95,3535102,3535138
27130,33,63,1,15.52,225.40,3535137,3535170
27131,62,61,0,8.26,84.77,3535169,3535231
27132,77,39,1,6.65,53.97,3535230,3535307
27133,67,37,1,7.64,44.05,3535307,3535374
27134,51,73,1,10.04,152.35,3535373,3535424
27135,54,62,0,9.48,87.88,3535423,3535477
27136,65,36,1,7.88,52.72,3535477,3535542
27137,34,94,0,15.06,485.53,3535541,3535575
27138,72,52,0,7.11,77.02,3535574,3535646
27139,65,84,0,7.88,164.97,3535645,3535710
27140,45,106,1,11.38,237.26,3535710,3535755
27141,40,80,3,12.80,192.21,3535754,3535794
27142,53,44,1,9.66,92.07,3535794,3535847
27143,62,30,0,8.26,48.45,3535846,3535908
27144,57,29,1,8.98,49.14,3535907,3535964
27145,47,62,2,10.89,107.67,3535964,3536011
27146,52,46,1,9.85,77.90,3536010,3536062
27147,58,43,1,8.83,43.11,3536061,3536119
27148,56,42,1,9.14,51.37,3536118,3536174
27149,59,47,1,8.68,57.17,3536174,3536233
27150,61,50,1,8.39,71.78,3536232,3536293
27151,67,22,1,7.64,20.08,3536292,3536359
27152,44,117,1,11.64,342.82,3536358,3536402
27153,56,60,1,9.14,84.09,3536401,3536457
27154,37,69,2,13.84,164.24,3536456,3536493
27155,79,54,1,6.48,54.53,3536492,3536571
27156,62,41,1,8.26,52.87,3536570,3536632
27157,61,73,1,8.39,102.27,3536631,3536692
27158,61,44,0,8.39,68.80,3536692,3536753
27159,51,79,1,10.04,135.92,3536752,3536803
27160,65,28,0,7.88,35.68,3536802,3536867
27161,44,110,1,11.64,273.00,3536866,3536910
27162,58,40,0,8.83,54.21,3536909,3536967
27163,57,28,1,8.98,35.81,3536966,3537023
27164,42,54,0,12.19,110.92,3537022,3537064
27165,29,121,1,17.66,951.05,3537063,3537092
27166,34,148,1,15.06,648.76,3537091,3537125
27167,52,50,1,9.85,71.13,3537124,3537176
27168,45,50,1,11.38,103.21,3537175,3537220
27169,41,71,2,12.49,125.37,3537219,3537260
27170,28,90,1,18.29,364.42,3537259,3537287
27171,41,45,1,12.49,139.71,3537286,3537327
27172,52,46,1,9.85,56.63,3537326,3537378
27173,47,54,1,10.89,131.97,3537377,3537424
27174,49,36,1,10.45,61.55,3537423,3537472
27175,35,85,1,14.63,277.89,3537471,3537506
27176,48,42,2,10.67,52.26,3537505,3537553
27177,51,31,2,10.04,40.47,3537552,3537603
27178,43,47,1,11.91,86.74,3537602,3537645
27179,46,36,1,11.13,64.50,3537644,3537690
27180,39,89,1,13.13,224.37,3537689,3537728
27181,52,48,0,9.85,74.28,3537727,3537779
27182,47,48,1,10.89,67.50,3537778,3537825
27183,51,50,1,10.04,67.49,3537824,3537875
27184,55,43,1,9.31,74.18,3537874,3537929
27185,44,53,1,11.64,120.55,3537928,3537972
27186,24,115,6,21.33,483.56,3537971,3537995
27187,28,59,1,18.29,296.28,3537994,3538022
27188,24,93,2,21.33,589.81,3538021,3538045
27189,58,58,0,8.83,118.49,3538044,3538102
27190,52,80,1,9.85,199.21,3538101,3538153
27191,43,60,1,11.91,143.29,3538152,3538195
27192,37,85,1,13.84,346.95,3538194,3538231
27193,34,163,1,15.06,731.70,3538230,3538264
27194,57,45,0,8.98,85.42,3538263,3538320
27195,61,31,0,8.39,45.91,3538319,3538380
27196,25,59,1,20.48,397.85,3538379,3538404
27197,45,51,1,11.38,139.26,3538403,3538448
27198,53,73,1,9.66,179.39,3538447,3538500
27199,95,59,0,5.39,54.07,3538499,3538594
27200,65,60,1,7.88,77.58,3538593,3538658
27201,47,161,1,10.89,544.31,3538657,3538704
27202,42,152,0,12.19,532.06,3538703,3538745
27203,66,85,0,7.76,123.64,3538744,3538810
27204,57,53,1,8.98,99.70,3538809,3538866
27205,60,68,0,8.53,147.92,3538866,3538926
27206,88,43,0,5.82,50.97,3538926,3539014
27207,49,116,0,10.45,325.80,3539013,3539062
27208,43,113,0,11.91,308.27,3539061,3539104
27209,44,65,1,11.64,174.91,3539103,3539147
27210,58,116,1,8.83,252.66,3539146,3539204
27211,59,74,1,8.68,110.73,3539203,3539262
27212,31,123,1,16.52,601.02,3539261,3539292
27213,61,42,1,8.39,48.93,3539291,3539352
27214,62,104,0,8.26,172.97,3539351,3539413
27215,61,91,1,8.39,142.57,3539412,3539473
27216,61,33,0,8.39,43.94,3539473,3539534
27217,60,36,1,8.53,49.25,3539533,3539593
27218,58,80,1,8.83,115.87,3539592,3539650
27219,66,50,1,7.76,53.24,3539649,3539715
27220,64,36,1,8.00,36.06,3539715,3539779
27221,64,75,1,8.00,96.38,3539778,3539842
27222,41,190,1,12.49,893.76,3539841,3539882
27223,55,128,1,9.31,277.30,3539881,3539936
27224,57,41,1,8.98,59.32,3539935,3539992
27225,48,54,0,10.67,117.68,3539991,3540039
27226,52,35,1,9.85,48.25,3540038,3540090
27227,47,121,1,10.89,304.73,3540089,3540136
27228,50,43,1,10.24,65.02,3540135,3540185
27229,47,35,1,10.89,78.86,3540184,3540231
27230,34,119,1,15.06,470.88,3540230,3540264
27231,33,118,1,15.52,450.98,3540263,3540296
27232,58,31,1,8.83,44.14,3540295,3540353
27233,37,106,2,13.84,328.78,3540352,3540389
27234,44,56,2,11.64,125.32,3540388,3540432
27235,56,31,1,9.14,37.19,3540431,3540487
27236,40,52,1,12.80,140.96,3540486,3540526
27237,39,113,2,13.13,314.32,3540525,3540564
27238,37,87,1,13.84,226.30,3540563,3540600
27239,54,75,1,9.48,122.36,3540599,3540653
27240,52,52,1,9.85,66.36,3540652,3540704
27241,43,58,2,11.91,140.97,3540703,3540746
27242,52,74,1,9.85,111.67,3540746,3540798
27243,23,262,1,22.26,2751.41,3540797,3540820
27244,43,58,2,11.91,79.43,3540820,3540863
27245,45,64,1,11.38,114.06,3540862,3540907
27246,40,75,1,12.80,212.26,3540906,3540946
27247,45,31,2,11.38,60.72,3540945,3540990
27248,48,55,1,10.67,89.10,3540989,3541037
27249,42,53,3,12.19,109.73,3541036,3541078
27250,43,63,2,11.91,131.62,3541077,3541120
27251,42,68,0,12.19,171.15,3541119,3541161
27252,39,49,1,13.13,135.86,3541160,3541199
27253,57,27,2,8.98,29.77,3541198,3541255
27254,56,45,1,9.14,77.34,3541255,3541311
27255,39,124,1,13.13,421.55,3541310,3541349
27256,32,74,1,16.00,299.19,3541348,3541380
27257,27,77,3,18.96,334.41,3541379,3541406
27258,36,62,2,14.22,144.40,3541405,3541441
27259,28,105,2,18.29,518.85,3541440,3541468
27260,37,112,1,13.84,334.57,3541467,3541504
27261,43,35,1,11.91,66.08,3541503,3541546
27262,59,63,1,8.68,106.96,3541545,3541604
27263,47,44,1,10.89,70.48,3541603,3541650
27264,41,55,2,12.49,102.69,3541649,3541690
27265,37,124,2,13.84,420.14,3541689,3541726
27266,21,216,1,24.38,2063.28,3541725,3541746
27267,46,81,1,11.13,166.72,3541745,3541791
27268,60,119,1,8.53,242.92,3541790,3541850
27269,50,83,0,10.24,148.10,3541849,3541899
27270,57,38,0,8.98,51.49,3541898,3541955
27271,56,51,0,9.14,109.94,3541954,3542010
27272,72,40,1,7.11,55.02,3542009,3542081
27273,64,46,0,8.00,58.00,3542080,3542144
27274,55,36,1,9.31,59.56,3542143,3542198
27275,36,131,1,14.22,478.17,3542197,3542233
27276,70,67,1,7.31,107.33,3542232,3542302
27277,58,68,1,8.83,130.32,3542301,3542359
27278,82,100,0,6.24,141.99,3542358,3542440
27279,66,106,0,7.76,181.94,3542439,3542505
27280,47,47,1,10.89,91.58,3542504,3542551
27281,42,48,1,12.19,116.73,3542550,3542592
27282,64,31,0,8.00,46.59,3542591,3542655
27283,43,171,1,11.91,633.85,3542654,3542697
27284,50,27,2,10.24,42.50,3542696,3542746
27285,57,49,0,8.98,73.32,3542745,3542802
27286,65,42,1,7.88,60.42,3542801,3542866
27287,55,46,1,9.31,61.70,3542865,3542920
27288,50,97,1,10.24,212.82,3542919,3542969
27289,54,103,0,9.48,221.36,3542968,3543022
27290,62,162,0,8.26,406.03,3543022,3543084
27291,48,39,2,10.67,59.47,3543084,3543132
27292,54,61,0,9.48,102.47,3543131,3543185
27293,31,225,1,16.52,1532.70,3543184,3543215
27294,64,43,1,8.00,57.56,3543214,3543278
27295,57,82,1,8.98,126.30,3543277,3543334
27296,34,193,0,15.06,1047.94,3543333,3543367
27297,67,33,0,7.64,40.83,3543366,3543433
27298,52,57,1,9.85,95.59,3543432,3543484
27299,53,174,1,9.66,553.43,3543483,3543536
27300,48,85,1,10.67,187.60,3543535,3543583
27301,41,83,1,12.49,192.59,3543582,3543623
27302,31,209,3,16.52,1290.12,3543622,3543653
27303,40,133,1,12.80,407.16,3543653,3543693
27304,53,77,1,9.66,119.24,3543692,3543745
27305,50,29,1,10.24,48.14,3543744,3543794
27306,48,34,2,10.67,54.64,3543793,3543841
27307,43,51,1,11.91,84.04,3543840,3543883
27308,37,77,0,13.84,202.24,3543883,3543920
27309,58,33,1,8.83,34.32,3543919,3543977
27310,52,31,1,9.85,38.75,3543976,3544028
27311,54,36,2,9.48,42.92,3544027,3544081
27312,52,28,1,9.85,29.86,3544080,3544132
27313,33,164,1,15.52,804.49,3544131,3544164
27314,48,56,1,10.67,124.01,3544163,3544211
27315,43,115,0,11.91,310.22,3544210,3544253
27316,47,31,2,10.89,41.84,3544252,3544299
27317,40,67,2,12.80,172.06,3544298,3544338
27318,55,34,1,9.31,42.07,3544337,3544392
27319,51,58,0,10.04,87.45,3544391,3544442
27320,56,44,0,9.14,63.34,3544441,3544497
27321,43,47,2,11.91,104.22,3544496,3544539
27322,47,65,1,10.89,164.82,3544538,3544585
27323,53,50,1,9.66,50.22,3544584,3544637
27324,56,41,0,9.14,79.77,3544636,3544692
27325,68,32,1,7.53,31.07,3544691,3544759
27326,45,68,1,11.38,149.92,3544759,3544804
27327,24,107,2,21.33,473.47,3544803,3544827
27328,21,225,2,24.38,2284.05,3544826,3544847
27329,27,87,2,18.96,408.41,3544846,3544873
27330,33,39,2,15.52,111.22,3544872,3544905
27331,42,38,1,12.19,67.15,3544904,3544946
27332,40,42,0,12.80,127.86,3544946,3544986
27333,50,57,1,10.24,82.66,3544986,3545036
27334,52,48,2,9.85,66.05,3545035,3545087
27335,35,71,1,14.63,231.26,3545086,3545121
27336,41,82,2,12.49,204.30,3545120,3545161
27337,37,85,0,13.84,207.38,3545160,3545197
27338,35,75,0,14.63,375.20,3545196,3545231
27339,35,102,2,14.63,490.98,3545230,3545265
27340,56,71,1,9.14,125.91,3545264,3545320
27341,68,31,0,7.53,53.25,3545319,3545387
27342,64,46,0,8.00,100.88,3545387,3545451
27343,58,49,1,8.83,71.18,3545450,3545508
27344,54,55,0,9.48,130.84,3545507,3545561
27345,42,162,1,12.19,734.87,3545561,3545603
27346,67,53,1,7.64,78.41,3545602,3545669
27347,68,46,0,7.53,58.07,3545669,3545737
27348,44,85,1,11.64,210.82,3545736,3545780
27349,47,62,1,10.89,184.52,3545779,3545826
27350,56,41,1,9.14,69.77,3545825,3545881
27351,64,31,1,8.00,32.03,3545880,3545944
27352,39,213,1,13.13,1078.06,3545943,3545982
27353,57,87,1,8.98,161.39,3545981,3546038
27354,40,102,1,12.80,409.71,3546037,3546077
27355,66,39,1,7.76,50.97,3546076,3546142
27356,64,31,1,8.00,44.78,3546141,3546205
27357,51,41,1,10.04,88.16,3546204,3546255
27358,49,42,1,10.45,84.90,3546254,3546303
27359,51,36,1,10.04,58.39,3546302,3546353
27360,32,183,1,16.00,955.50,3546352,3546384
27361,48,24,2,10.67,29.26,3546383,3546431
27362,45,29,1,11.38,56.50,3546430,3546475
27363,50,79,0,10.24,138.46,3546474,3546524
27364,34,57,3,15.06,146.70,3546523,3546557
27365,41,43,1,12.49,92.88,3546556,3546597
27366,59,25,1,8.68,33.51,3546596,3546655
27367,38,53,2,13.47,146.88,3546654,3546692
27368,59,37,1,8.68,49.20,3546691,3546750
27369,54,30,2,9.48,24.18,3546749,3546803
27370,43,47,1,11.91,99.48,3546802,3546845
27371,53,26,1,9.66,36.94,3546845,3546898
27372,50,34,2,10.24,47.26,3546897,3546947
27373,41,54,3,12.49,74.15,3546946,3546987
27374,40,84,1,12.80,246.21,3546986,3547026
27375,46,42,2,11.13,54.29,3547025,3547071
27376,39,49,1,13.13,103.29,3547070,3547109
27377,37,64,2,13.84,146.78,3547108,3547145
27378,48,50,2,10.67,94.18,3547144,3547192
27379,42,39,2,12.19,63.58,3547191,3547233
27380,38,67,2,13.47,163.78,3547232,3547270
27381,60,57,1,8.53,72.58,3547269,3547329
27382,56,44,0,9.14,69.52,3547328,3547384
27383,45,41,1,11.38,90.46,3547383,3547428
27384,37,116,1,13.84,415.70,3547427,3547464
27385,31,61,2,16.52,200.57,3547463,3547494
27386,23,156,3,22.26,1074.19,3547493,3547516
27387,39,63,2,13.13,178.01,3547515,3547554
27388,45,68,1,11.38,124.41,3547553,3547598
27389,49,40,1,10.45,80.00,3547597,3547646
27390,54,43,1,9.48,60.25,3547645,3547699
27391,49,46,0,10.45,77.10,3547698,3547747
27392,51,45,1,10.04,65.41,3547746,3547797
27393,55,39,1,9.31,67.12,3547797,3547852
27394,34,117,2,15.06,502.23,3547851,3547885
27395,29,118,3,17.66,588.71,3547885,3547914
27396,29,287,1,17.66,2624.23,3547913,3547942
27397,66,41,1,7.76,63.52,3547941,3548007
27398,7,463,1,73.14,25416.12,3548006,3548013
27399,71,133,1,7.21,244.56,3548012,3548083
27400,64,44,0,8.00,58.09,3548082,3548146
27401,45,53,1,11.38,134.55,3548146,3548191
27402,61,61,0,8.39,97.16,3548191,3548252
27403,55,61,1,9.31,106.69,3548251,3548306
27404,52,68,1,9.85,125.98,3548305,3548357
27405,95,37,0,5.39,31.75,3548356,3548451
27406,65,43,0,7.88,51.06,3548451,3548516
27407,57,68,1,8.98,91.77,3548515,3548572
27408,74,34,0,6.92,43.43,3548571,3548645
27409,64,33,1,8.00,45.34,3548644,3548708
27410,63,25,0,8.13,34.14,3548707,3548770
27411,68,25,1,7.53,21.25,3548769,3548837
27412,44,57,0,11.64,147.60,3548837,3548881
27413,59,33,1,8.68,52.42,3548880,3548939
27414,68,42,1,7.53,48.40,3548938,3549006
27415,65,30,1,7.88,37.18,3549005,3549070
27416,58,60,1,8.83,74.90,3549069,3549127
27417,63,56,1,8.13,98.08,3549126,3549189
27418,69,37,1,7.42,39.87,3549188,3549257
27419,57,31,1,8.98,45.70,3549256,3549313
27420,62,30,1,8.26,33.61,3549312,3549374
27421,54,35,0,9.48,46.25,3549373,3549427
27422,67,26,0,7.64,27.99,3549426,3549493
27423,51,110,1,10.04,222.59,3549492,3549543
27424,34,70,0,15.06,209.35,3549542,3549576
27425,44,43,0,11.64,69.73,3549575,3549619
27426,48,31,1,10.67,48.14,3549618,3549666
27427,51,22,0,10.04,28.86,3549665,3549716
27428,47,44,1,10.89,56.65,3549715,3549762
27429,42,61,1,12.19,120.34,3549761,3549803
27430,54,33,1,9.48,66.06,3549802,3549856
27431,50,76,1,10.24,149.10,3549855,3549905
27432,58,32,2,8.83,37.07,3549905,3549963
27433,66,45,1,7.76,44.97,3549963,3550029
27434,49,33,1,10.45,51.06,3550028,3550077
27435,33,54,1,15.52,166.43,3550076,3550109
27436,52,42,1,9.85,54.55,3550108,3550160
27437,46,59,1,11.13,102.33,3550160,3550206
27438,53,31,1,9.66,46.41,3550205,3550258
27439,34,53,1,15.06,161.64,3550257,3550291
27440,58,32,2,8.83,28.66,3550291,3550349
27441,44,60,1,11.64,144.46,3550348,3550392
27442,48,33,1,10.67,43.39,3550392,3550440
27443,45,32,1,11.38,59.70,3550440,3550485
27444,44,81,2,11.64,162.69,3550484,3550528
27445,49,34,1,10.45,79.02,3550527,3550576
27446,71,32,1,7.21,29.58,3550575,3550646
27447,49,67,1,10.45,146.33,3550645,3550694
27448,48,40,1,10.67,96.60,3550693,3550741
27449,30,65,2,17.07,168.33,3550741,3550771
27450,22,217,2,23.27,1913.38,3550770,3550792
27451,38,89,1,13.47,298.46,3550791,3550829
27452,31,52,2,16.52,153.80,3550828,3550859
27453,42,44,1,12.19,115.58,3550858,3550900
27454,48,56,1,10.67,125.64,3550899,3550947
27455,36,80,2,14.22,209.45,3550946,3550982
27456,44,141,1,11.64,430.05,3550981,3551025
27457,38,85,1,13.47,212.78,3551024,3551062
27458,45,155,1,11.38,520.86,3551061,3551106
27459,43,61,1,11.91,156.83,3551105,3551148
27460,54,36,0,9.48,51.36,3551147,3551201
27461,57,48,1,8.98,75.21,3551200,3551257
27462,101,26,0,5.07,26.28,3551256,3551357
27463,57,60,1,8.98,112.75,3551356,3551413
27464,42,161,0,12.19,573.49,3551412,3551454
27465,68,29,0,7.53,60.37,3551453,3551521
27466,59,34,0,8.68,66.15,3551521,3551580
27467,66,39,0,7.76,44.61,3551579,3551645
27468,77,47,0,6.65,57.60,3551644,3551721
27469,45,43,1,11.38,82.55,3551720,3551765
27470,54,63,0,9.48,80.10,3551764,3551818
27471,62,29,1,8.26,47.48,3551818,3551880
27472,65,35,1,7.88,44.82,3551879,3551944
27473,60,41,1,8.53,55.18,3551943,3552003
27474,62,50,0,8.26,77.35,3552002,3552064
27475,67,41,1,7.64,55.51,3552063,3552130
27476,46,68,1,11.13,203.33,3552129,3552175
27477,73,24,0,7.01,21.38,3552174,3552247
27478,65,57,1,7.88,68.91,3552246,3552311
27479,54,49,1,9.48,61.18,3552310,3552364
27480,75,35,1,6.83,34.52,3552363,3552438
27481,74,33,1,6.92,29.67,3552438,3552512
27482,55,78,0,9.31,132.32,3552511,3552566
27483,56,31,0,9.14,43.98,3552565,3552621
27484,34,106,1,15.06,405.35,3552620,3552654
27485,59,30,0,8.68,41.91,3552654,3552713
27486,47,39,1,10.89,53.50,3552712,3552759
27487,60,25,0,8.53,36.58,3552758,3552818
27488,45,34,0,11.38,49.75,3552817,3552862
27489,54,25,1,9.48,31.58,3552861,3552915
27490,44,50,1,11.64,110.14,3552914,3552958
27491,48,57,1,10.67,92.68,3552957,3553005
27492,49,46,1,10.45,52.12,3553004,3553053
27493,34,61,4,15.06,189.41,3553053,3553087
27494,53,44,1,9.66,63.39,3553086,3553139
27495,53,35,1,9.66,62.45,3553138,3553191
27496,51,24,1,10.04,45.41,3553190,3553241
27497,51,32,1,10.04,49.02,3553241,3553292
27498,49,61,1,10.45,153.15,3553291,3553340
27499,57,30,1,8.98,41.81,3553339,3553396
27500,58,32,1,8.83,33.04,3553396,3553454
27501,47,54,1,10.89,115.71,3553453,3553500
27502,42,45,2,12.19,61.15,3553499,3553541
27503,44,47,3,11.64,92.05,3553541,3553585
27504,47,86,0,10.89,157.80,3553584,3553631
27505,53,30,1,9.66,36.38,3553630,3553683
27506,41,39,1,12.49,80.05,3553682,3553723
27507,48,63,1,10.67,112.06,3553722,3553770
27508,45,39,1,11.38,88.15,3553769,3553814
27509,58,38,1,8.83,55.83,3553813,3553871
27510,61,32,1,8.39,41.81,3553871,3553932
27511,60,30,0,8.53,48.25,3553931,3553991
27512,45,55,1,11.38,140.28,3553990,3554035
27513,23,135,2,22.26,1033.58,3554034,3554057
27514,29,74,4,17.66,288.50,3554056,3554085
27515,29,102,1,17.66,457.05,3554084,3554113
27516,34,42,0,15.06,146.76,3554112,3554146
27517,46,86,1,11.13,190.55,3554145,3554191
27518,42,80,1,12.19,216.49,3554191,3554233
27519,45,36,1,11.38,76.01,3554232,3554277
27520,59,40,1,8.68,67.27,3554276,3554335
27521,51,53,1,10.04,80.74,3554334,3554385
27522,45,61,0,11.38,206.59,3554384,3554429
27523,44,68,1,11.64,188.23,3554428,3554472
27524,49,59,1,10.45,131.06,3554471,3554520
27525,58,43,1,8.83,66.76,3554519,3554577
27526,67,39,1,7.64,71.13,3554576,3554643
27527,55,127,1,9.31,288.25,3554642,3554697
27528,38,69,1,13.47,259.04,3554696,3554734
27529,56,45,1,9.14,72.30,3554733,3554789
27530,60,41,0,8.53,82.95,3554788,3554848
27531,61,41,0,8.39,68.89,3554847,3554908
27532,74,72,0,6.92,94.70,3554907,3554981
27533,48,48,0,10.67,100.93,3554980,3555028
27534,52,39,1,9.85,52.40,3555027,3555079
27535,73,31,1,7.01,39.79,3555078,3555151
27536,66,55,1,7.76,80.85,3555150,3555216
27537,63,27,0,8.13,38.14,3555216,3555279
27538,38,154,1,13.47,639.72,3555278,3555316
27539,62,35,0,8.26,52.71,3555315,3555377
27540,62,41,1,8.26,55.35,3555376,3555438
27541,55,58,0,9.31,86.43,3555438,3555493
27542,59,114,1,8.68,236.93,3555493,3555552
27543,69,26,1,7.42,29.06,3555552,3555621
27544,58,35,1,8.83,46.66,3555620,3555678
27545,52,48,1,9.85,84.48,3555677,3555729
27546,49,239,1,10.45,1103.15,3555728,3555777
27547,50,64,1,10.24,146.30,3555776,3555826
27548,53,54,1,9.66,104.60,3555826,3555879
27549,61,29,1,8.39,40.66,3555878,3555939
27550,48,36,1,10.67,60.06,3555938,3555986
27551,57,38,0,8.98,53.21,3555985,3556042
27552,65,44,0,7.88,44.08,3556041,3556106
27553,56,46,0,9.14,54.52,3556105,3556161
27554,44,42,0,11.64,76.82,3556160,3556204
27555,47,36,1,10.89,41.58,3556204,3556251
27556,22,113,2,23.27,811.65,3556250,3556272
27557,38,117,2,13.47,400.78,3556271,3556309
27558,50,63,1,10.24,135.70,3556309,3556359
27559,44,42,1,11.64,67.14,3556358,3556402
27560,50,29,1,10.24,39.02,3556401,3556451
27561,39,66,1,13.13,159.24,3556450,3556489
27562,58,23,2,8.83,25.69,3556488,3556546
27563,46,58,1,11.13,132.24,3556545,3556591
27564,47,107,1,10.89,244.86,3556590,3556637
27565,53,35,1,9.66,56.26,3556637,3556690
27566,38,89,1,13.47,248.62,3556689,3556727
27567,52,34,1,9.85,60.17,3556726,3556778
27568,54,57,1,9.48,80.99,3556777,3556831
27569,43,60,3,11.91,94.97,3556830,3556873
27570,48,72,1,10.67,113.72,3556872,3556920
27571,37,47,1,13.84,160.78,3556919,3556956
27572,39,41,1,13.13,75.29,3556955,3556994
27573,22,131,1,23.27,836.56,3556993,3557015
27574,28,116,2,18.29,555.20,3557014,3557042
27575,42,54,1,12.19,127.77,3557041,3557083
27576,29,71,0,17.66,270.29,3557082,3557111
27577,31,242,0,16.52,1720.96,3557110,3557141
27578,8,364,3,64.00,13490.00,3557140,3557148
27579,52,33,1,9.85,37.82,3557147,3557199
27580,50,51,1,10.24,102.18,3557198,3557248
27581,38,76,2,13.47,253.04,3557247,3557285
27582,28,174,1,18.29,986.42,3557284,3557312
27583,62,43,0,8.26,77.13,3557311,3557373
27584,57,34,1,8.98,56.40,3557372,3557429
27585,37,112,1,13.84,373.22,3557428,3557465
27586,58,38,1,8.83,78.94,3557464,3557522
27587,72,33,0,7.11,38.57,3557521,3557593
27588,42,55,1,12.19,123.54,3557592,3557634
27589,51,50,0,10.04,90.86,3557633,3557684
27590,75,34,1,6.83,39.56,3557683,3557758
27591,79,39,1,6.48,45.62,3557757,3557836
27592,52,35,0,9.85,68.21,3557836,3557888
27593,61,65,1,8.39,125.45,3557887,3557948
27594,54,41,1,9.48,60.81,3557947,3558001
27595,62,24,1,8.26,33.16,3558000,3558062
27596,55,120,1,9.31,253.63,3558061,3558116
27597,55,53,1,9.31,71.89,3558115,3558170
27598,72,38,1,7.11,33.35,3558169,3558241
27599,67,74,1,7.64,96.92,3558241,3558308
27600,50,42,1,10.24,84.70,3558307,3558357
27601,69,27,0,7.42,34.65,3558356,3558425
27602,45,55,1,11.38,123.88,3558424,3558469
27603,52,58,1,9.85,112.13,3558468,3558520
27604,60,50,1,8.53,82.82,3558519,3558579
27605,57,83,1,8.98,116.72,3558578,3558635
27606,57,49,0,8.98,71.74,3558634,3558691
27607,46,121,0,11.13,291.03,3558690,3558736
27608,51,35,0,10.04,54.70,3558735,3558786
27609,51,50,1,10.04,71.06,3558785,3558836
27610,45,27,1,11.38,36.55,3558835,3558880
27611,32,84,3,16.00,248.19,3558879,3558911
27612,49,66,0,10.45,118.45,3558910,3558959
27613,48,52,2,10.67,72.26,3558958,3559006
27614,69,29,1,7.42,24.13,3559005,3559074
27615,46,31,1,11.13,52.94,3559073,3559119
27616,42,49,1,12.19,122.87,3559118,3559160
27617,49,43,1,10.45,79.84,3559159,3559208
27618,43,48,1,11.91,75.29,3559208,3559251
27619,49,42,1,10.45,46.66,3559250,3559299
27620,52,24,1,9.85,33.51,3559298,3559350
27621,62,33,1,8.26,36.03,3559349,3559411
27622,47,52,1,10.89,121.33,3559410,3559457
27623,48,30,2,10.67,47.51,3559456,3559504
27624,51,36,0,10.04,45.76,3559503,3559554
27625,51,41,1,10.04,63.45,3559553,3559604
27626,43,44,1,11.91,103.15,3559603,3559646
27627,37,61,1,13.84,182.08,3559645,3559682
27628,35,71,2,14.63,168.29,3559681,3559716
27629,40,45,3,12.80,80.41,3559715,3559755
27630,48,59,1,10.67,132.39,3559754,3559802
27631,32,118,2,16.00,434.25,3559801,3559833
27632,57,52,0,8.98,74.23,3559832,3559889
27633,40,104,2,12.80,277.36,3559888,3559928
27634,39,57,1,13.13,169.09,3559927,3559966
27635,43,56,0,11.91,128.32,3559965,3560008
27636,55,41,1,9.31,64.07,3560007,3560062
27637,36,80,1,14.22,337.17,3560061,3560097
27638,36,218,1,14.22,1252.01,3560096,3560132
27639,23,393,2,22.26,6265.41,3560131,3560154
27640,68,32,0,7.53,48.98,3560153,3560221
27641,45,206,1,11.38,885.66,3560220,3560265
27642,56,49,0,9.14,93.94,3560264,3560320
27643,69,58,0,7.42,95.95,3560319,3560388
27644,80,37,0,6.40,50.89,3560387,3560467
27645,49,36,1,10.45,80.74,3560467,3560516
27646,50,44,1,10.24,89.62,3560515,3560565
27647,64,33,1,8.00,33.03,3560565,3560629
27648,66,35,1,7.76,47.21,3560628,3560694
27649,54,59,0,9.48,112.47,3560693,3560747
27650,57,37,1,8.98,40.58,3560746,3560803
27651,71,35,1,7.21,37.94,3560803,3560874
27652,54,89,1,9.48,166.81,3560873,3560927
27653,51,63,1,10.04,128.86,3560926,3560977
27654,32,194,1,16.00,1220.44,3560976,3561008
27655,62,50,0,8.26,62.09,3561007,3561069
27656,24,283,2,21.33,3070.97,3561068,3561092
27657,52,41,1,9.85,71.17,3561091,3561143
27658,53,83,1,9.66,164.75,3561142,3561195
27659,52,34,1,9.85,40.55,3561194,3561246
27660,45,53,2,11.38,91.35,3561245,3561290
27661,50,51,1,10.24,75.02,3561290,3561340
27662,55,27,2,9.31,34.65,3561339,3561394
27663,52,46,1,9.85,69.32,3561393,3561445
27664,47,48,1,10.89,83.24,3561444,3561491
27665,34,126,2,15.06,476.53,3561490,3561524
27666,40,82,2,12.80,194.36,3561523,3561563
27667,47,33,2,10.89,50.61,3561562,3561609
27668,50,43,1,10.24,68.42,3561608,3561658
27669,44,85,1,11.64,166.23,3561657,3561701
27670,58,25,1,8.83,30.35,3561700,3561758
27671,47,37,1,10.89,66.56,3561758,3561805
27672,42,57,1,12.19,117.73,3561804,3561846
27673,39,83,1,13.13,296.78,3561845,3561884
27674,68,29,1,7.53,28.48,3561883,3561951
27675,47,38,1,10.89,60.35,3561950,3561997
27676,50,36,1,10.24,49.26,3561996,3562046
27677,42,33,2,12.19,71.34,3562045,3562087
27678,46,51,1,11.13,76.55,3562087,3562133
27679,53,27,1,9.66,37.96,3562132,3562185
27680,46,111,2,11.13,267.50,3562184,3562230
27681,44,90,1,11.64,202.60,3562229,3562273
27682,40,37,2,12.80,46.06,3562272,3562312
27683,53,37,3,9.66,36.83,3562311,3562364
27684,34,95,1,15.06,329.35,3562363,3562397
27685,62,45,0,8.26,61.80,3562396,3562458
27686,44,105,1,11.64,245.60,3562457,3562501
27687,42,63,1,12.19,149.77,3562500,3562542
27688,28,53,4,18.29,175.70,3562541,3562569
27689,47,66,1,10.89,135.16,3562568,3562615
27690,53,39,0,9.66,69.73,3562614,3562667
27691,46,60,2,11.13,131.42,3562666,3562712
27692,45,51,1,11.38,99.57,3562711,3562756
27693,46,78,1,11.13,152.98,3562755,3562801
27694,68,44,0,7.53,61.43,3562800,3562868
27695,33,65,1,15.52,280.07,3562867,3562900
27696,54,83,1,9.48,157.51,3562899,3562953
27697,52,48,1,9.85,114.09,3562953,3563005
27698,98,26,0,5.22,24.60,3563004,3563102
27699,53,87,1,9.66,142.41,3563101,3563154
27700,41,58,0,12.49,151.71,3563153,3563194
27701,74,47,1,6.92,80.72,3563193,3563267
27702,52,48,1,9.85,94.82,3563266,3563318
27703,101,36,0,5.07,25.93,3563317,3563418
27704,50,74,1,10.24,195.34,3563417,3563467
27705,49,35,1,10.45,69.10,3563466,3563515
27706,65,68,0,7.88,98.57,3563514,3563579
27707,33,124,0,15.52,435.34,3563579,3563612
27708,51,52,1,10.04,94.16,3563611,3563662
27709,74,29,1,6.92,26.18,3563661,3563735
27710,68,43,1,7.53,65.69,3563734,3563802
27711,68,33,1,7.53,35.60,3563801,3563869
27712,49,44,1,10.45,83.23,3563868,3563917
27713,33,102,2,15.52,426.01,3563916,3563949
27714,65,43,1,7.88,58.08,3563948,3564013
27715,50,67,1,10.24,100.38,3564012,3564062
27716,66,32,1,7.76,36.21,3564061,3564127
27717,47,47,1,10.89,83.24,3564126,3564173
27718,54,44,1,9.48,87.21,3564172,3564226
27719,62,85,1,8.26,134.42,3564225,3564287
27720,47,171,0,10.89,586.14,3564286,3564333
27721,35,161,1,14.63,995.38,3564332,3564367
27722,67,27,0,7.64,41.51,3564366,3564433
27723,38,113,1,13.47,480.83,3564432,3564470
27724,51,51,1,10.04,75.76,3564469,3564520
27725,24,267,3,21.33,2657.81,3564519,3564543
27726,64,47,1,8.00,42.34,3564542,3564606
27727,55,58,2,9.31,73.30,3564605,3564660
27728,59,29,1,8.68,32.56,3564659,3564718
27729,47,53,1,10.89,85.37,3564717,3564764
27730,49,39,1,10.45,73.02,3564763,3564812
27731,44,60,1,11.64,87.55,3564811,3564855
27732,47,96,1,10.89,241.71,3564854,3564901
27733,48,42,1,10.67,56.51,3564900,3564948
27734,43,86,2,11.91,207.25,3564947,3564990
27735,47,72,0,10.89,127.88,3564989,3565036
27736,49,41,1,10.45,63.43,3565035,3565084
27737,50,30,2,10.24,42.22,3565083,3565133
27738,44,144,0,11.64,461.96,3565132,3565176
27739,46,32,1,11.13,59.07,3565175,3565221
27740,41,35,1,12.49,54.25,3565220,3565261
27741,48,82,0,10.67,146.10,3565260,3565308
27742,48,33,1,10.67,49.68,3565307,3565355
27743,47,29,1,10.89,50.10,3565354,3565401
27744,49,29,0,10.45,54.49,3565400,3565449
27745,58,25,0,8.83,34.14,3565448,3565506
27746,46,40,1,11.13,66.24,3565505,3565551
27747,54,36,2,9.48,38.10,3565550,3565604
27748,38,114,1,13.47,384.14,3565603,3565641
27749,58,30,1,8.83,44.42,3565640,3565698
27750,60,34,1,8.53,39.98,3565697,3565757
27751,40,48,1,12.80,123.26,3565756,3565796
27752,26,223,3,19.69,1713.75,3565795,3565821
27753,28,64,5,18.29,246.20,3565820,3565848
27754,29,74,3,17.66,253.47,3565847,3565876
27755,29,94,1,17.66,499.19,3565875,3565904
27756,37,64,2,13.84,192.41,3565903,3565940
27757,28,94,3,18.29,444.35,3565939,3565967
27758,54,51,0,9.48,96.69,3565966,3566020
27759,46,55,1,11.13,91.50,3566019,3566065
27760,43,83,1,11.91,198.41,3566064,3566107
27761,44,53,0,11.64,124.69,3566106,3566150
27762,32,132,1,16.00,569.31,3566149,3566181
27763,44,44,1,11.64,131.46,3566180,3566224
27764,24,288,1,21.33,3191.22,3566223,3566247
27765,50,60,0,10.24,138.02,3566246,3566296
27766,79,23,1,6.48,24.91,3566295,3566374
27767,60,31,1,8.53,36.48,3566374,3566434
27768,65,66,1,7.88,100.51,3566433,3566498
27769,63,90,1,8.13,185.00,3566498,3566561
27770,68,31,0,7.53,48.81,3566560,3566628
27771,42,46,2,12.19,82.96,3566627,3566669
27772,29,162,1,17.66,918.29,3566668,3566697
27773,60,46,1,8.53,74.78,3566696,3566756
27774,46,44,1,11.13,71.50,3566755,3566801
27775,44,92,2,11.64,196.78,3566801,3566845
27776,71,29,1,7.21,38.81,3566844,3566915
27777,34,79,1,15.06,301.82,3566914,3566948
27778,64,26,1,8.00,27.72,3566947,3567011
27779,54,32,0,9.48,67.25,3567010,3567064
27780,50,100,1,10.24,236.26,3567063,3567113
27781,72,23,1,7.11,27.57,3567112,3567184
27782,55,55,1,9.31,105.23,3567183,3567238
27783,61,35,1,8.39,43.78,3567237,3567298
27784,65,42,1,7.88,61.77,3567297,3567362
27785,66,71,1,7.76,97.21,3567361,3567427
27786,52,128,1,9.85,309.98,3567426,3567478
27787,48,121,2,10.67,295.06,3567477,3567525
27788,60,70,1,8.53,147.35,3567524,3567584
27789,38,113,0,13.47,357.14,3567583,3567621
27790,46,44,1,11.13,120.16,3567620,3567666
27791,53,125,1,9.66,288.94,3567665,3567718
27792,48,72,2,10.67,132.14,3567717,3567765
27793,57,26,0,8.98,29.56,3567765,3567822
27794,47,42,1,10.89,60.22,3567821,3567868
27795,30,81,2,17.07,352.66,3567867,3567897
27796,42,55,1,12.19,137.73,3567896,3567938
27797,34,56,1,15.06,176.82,3567937,3567971
27798,41,37,1,12.49,68.30,3567970,3568011
27799,28,110,1,18.29,581.06,3568010,3568038
27800,46,40,1,11.13,85.68,3568037,3568083
27801,56,37,1,9.14,46.23,3568082,3568138
27802,49,33,1,10.45,51.39,3568137,3568186
27803,52,37,1,9.85,50.55,3568185,3568237
27804,38,43,1,13.47,122.25,3568237,3568275
27805,43,47,2,11.91,80.22,3568274,3568317
27806,44,50,1,11.64,101.05,3568317,3568361
27807,42,58,2,12.19,167.01,3568360,3568402
27808,44,44,2,11.64,85.50,3568401,3568445
27809,52,41,0,9.85,58.17,3568445,3568497
27810,52,35,1,9.85,43.05,3568496,3568548
27811,43,81,1,11.91,175.06,3568547,3568590
27812,47,30,1,10.89,47.12,3568589,3568636
27813,52,34,1,9.85,59.51,3568635,3568687
27814,39,138,3,13.13,435.80,3568687,3568726
27815,50,94,1,10.24,222.18,3568725,3568775
27816,45,80,1,11.38,205.39,3568774,3568819
27817,43,45,1,11.91,109.48,3568818,3568861
27818,35,59,1,14.63,182.00,3568860,3568895
27819,24,80,1,21.33,535.47,3568894,3568918
27820,21,84,2,24.38,475.95,3568917,3568938
27821,49,50,1,10.45,79.35,3568937,3568986
27822,47,38,1,10.89,86.14,3568985,3569032
27823,36,46,1,14.22,146.12,3569031,3569067
27824,48,37,1,10.67,87.51,3569067,3569115
27825,52,76,0,9.85,133.21,3569114,3569166
27826,41,53,1,12.49,116.49,3569165,3569206
27827,58,48,1,8.83,86.28,3569205,3569263
27828,79,36,1,6.48,46.40,3569262,3569341
27829,2,508,4,256.00,63504.00,3569340,3569342
27830,32,262,1,16.00,1993.50,3569341,3569373
27831,57,64,1,8.98,118.47,3569372,3569429
27832,42,83,0,12.19,254.63,3569428,3569470
27833,69,39,0,7.42,49.92,3569469,3569538
27834,63,21,2,8.13,15.60,3569537,3569600
27835,33,78,1,15.52,329.58,3569599,3569632
27836,70,35,0,7.31,44.67,3569631,3569701
27837,47,50,2,10.89,96.22,3569700,3569747
27838,60,34,1,8.53,40.42,3569746,3569806
27839,69,46,0,7.42,49.69,3569805,3569874
27840,39,102,1,13.13,330.11,3569873,3569912
27841,73,26,1,7.01,27.25,3569911,3569984
27842,63,60,1,8.13,69.06,3569983,3570046
27843,49,33,2,10.45,45.92,3570045,3570094
27844,45,77,2,11.38,157.04,3570093,3570138
27845,75,35,1,6.83,44.76,3570137,3570212
27846,42,160,1,12.19,576.11,3570211,3570253
27847,42,162,0,12.19,615.73,3570252,3570294
27848,43,127,1,11.91,394.69,3570293,3570336
27849,49,81,0,10.45,161.19,3570335,3570384
27850,53,36,0,9.66,79.24,3570383,3570436
27851,44,78,1,11.64,157.91,3570436,3570480
27852,45,79,0,11.38,185.44,3570479,3570524
27853,33,77,0,15.52,250.92,3570523,3570556
27854,44,69,2,11.64,187.78,3570555,3570599
27855,52,29,0,9.85,34.90,3570598,3570650
27856,49,32,2,10.45,39.96,3570650,3570699
27857,45,31,2,11.38,51.21,3570698,3570743
27858,56,28,1,9.14,48.05,3570742,3570798
27859,53,32,1,9.66,52.07,3570797,3570850
27860,61,49,1,8.39,52.93,3570849,3570910
27861,59,35,0,8.68,48.63,3570910,3570969
27862,37,39,1,13.84,70.14,3570968,3571005
27863,42,53,3,12.19,95.49,3571005,3571047
27864,47,33,2,10.89,51.41,3571047,3571094
27865,53,41,1,9.66,61.43,3571093,3571146
27866,42,69,1,12.19,190.30,3571145,3571187
27867,40,94,1,12.80,271.56,3571186,3571226
27868,64,28,1,8.00,36.75,3571225,3571289
27869,41,49,1,12.49,109.76,3571288,3571329
27870,20,123,1,25.60,1091.64,3571328,3571348
27871,8,363,5,64.00,13002.75,3571347,3571355
27872,21,188,2,24.38,1637.85,3571354,3571375
27873,16,155,1,32.00,1809.25,3571374,3571390
27874,42,88,1,12.19,224.20,3571389,3571431
27875,21,88,1,24.38,552.33,3571430,3571451
27876,40,122,1,12.80,354.56,3571450,3571490
27877,24,285,1,21.33,3094.97,3571489,3571513
27878,40,75,1,12.80,217.76,3571512,3571552
27879,47,43,1,10.89,116.39,3571551,3571598
27880,37,148,0,13.84,572.78,3571597,3571634
27881,68,40,0,7.53,68.10,3571633,3571701
27882,48,50,0,10.67,118.72,3571700,3571748
27883,63,48,1,8.13,74.94,3571747,3571810
27884,50,68,0,10.24,132.94,3571809,3571859
27885,45,63,0,11.38,173.57,3571859,3571904
27886,45,43,0,11.38,82.55,3571904,3571949
27887,58,43,1,8.83,59.63,3571949,3572007
27888,41,113,0,12.49,350.20,3572006,3572047
27889,55,61,1,9.31,115.16,3572046,3572101
27890,42,83,2,12.19,212.92,3572100,3572142
27891,52,76,0,9.85,139.67,3572141,3572193
27892,56,90,1,9.14,142.30,3572192,3572248
27893,61,27,1,8.39,36.70,3572248,3572309
27894,51,47,1,10.04,64.98,3572308,3572359
27895,64,25,1,8.00,33.47,3572358,3572422
27896,62,47,1,8.26,76.58,3572421,3572483
27897,43,108,1,11.91,336.60,3572482,3572525
27898,51,42,1,10.04,84.31,3572524,3572575
27899,58,34,2,8.83,45.18,3572574,3572632
27900,52,80,1,9.85,130.98,3572631,3572683
27901,42,42,0,12.19,94.92,3572682,3572724
27902,49,42,1,10.45,77.64,3572724,3572773
27903,51,38,1,10.04,74.35,3572772,3572823
27904,48,43,2,10.67,65.97,3572822,3572870
27905,48,38,1,10.67,69.51,3572869,3572917
27906,55,37,1,9.31,64.58,3572916,3572971
27907,48,64,1,10.67,106.68,3572970,3573018
27908,49,43,2,10.45,74.12,3573017,3573066
27909,29,83,2,17.66,356.23,3573065,3573094
27910,46,52,1,11.13,67.81,3573093,3573139
27911,40,65,1,12.80,274.91,3573138,3573178
27912,41,62,1,12.49,128.35,3573177,3573218
27913,33,73,1,15.52,279.16,3573217,3573250
27914,44,37,2,11.64,66.05,3573249,3573293
27915,45,40,2,11.38,54.64,3573292,3573337
27916,47,30,2,10.89,47.75,3573336,3573383
27917,40,49,2,12.80,96.11,3573382,3573422
27918,51,46,1,10.04,71.84,3573421,3573472
27919,46,50,1,11.13,80.68,3573471,3573517
27920,62,36,1,8.26,33.35,3573517,3573579
27921,70,39,1,7.31,38.73,3573578,3573648
27922,60,31,1,8.53,41.08,3573647,3573707
27923,37,75,1,13.84,253.38,3573706,3573743
27924,24,239,1,21.33,2162.89,3573742,3573766
27925,11,167,4,46.55,1954.79,3573765,3573776
27926,16,88,4,32.00,743.25,3573775,3573791
27927,27,68,1,18.96,255.29,3573790,3573817
27928,41,38,1,12.49,89.62,3573816,3573857
27929,38,45,3,13.47,105.20,3573856,3573894
27930,20,70,1,25.60,365.84,3573893,3573913
27931,39,102,2,13.13,273.91,3573912,3573951
27932,35,94,1,14.63,277.03,3573950,3573985
27933,45,69,1,11.38,156.24,3573984,3574029
27934,13,287,1,39.38,5717.01,3574028,3574041
27935,47,44,1,10.89,81.97,3574040,3574087
27936,42,48,1,12.19,146.68,3574087,3574129
27937,20,219,3,25.60,2212.14,3574128,3574148
27938,36,60,2,14.22,155.45,3574147,3574183
27939,45,75,1,11.38,262.41,3574182,3574227
27940,38,49,2,13.47,130.46,3574226,3574264
27941,33,212,1,15.52,1283.95,3574263,3574296
27942,47,49,1,10.89,114.31,3574295,3574342
27943,78,47,0,6.56,50.68,3574341,3574419
27944,42,85,2,12.19,191.20,3574418,3574460
27945,57,46,0,8.98,74.16,3574460,3574517
27946,69,34,1,7.42,37.06,3574516,3574585
27947,65,53,1,7.88,111.52,3574584,3574649
27948,55,28,1,9.31,56.36,3574648,3574703
27949,65,61,1,7.88,82.82,3574702,3574767
27950,47,45,0,10.89,99.88,3574767,3574814
27951,64,31,1,8.00,38.59,3574813,3574877
27952,73,24,0,7.01,31.25,3574876,3574949
27953,66,39,1,7.76,44.97,3574948,3575014
27954,57,55,1,8.98,76.89,3575013,3575070
27955,58,24,1,8.83,27.73,3575069,3575127
27956,56,48,1,9.14,71.41,3575127,3575183
27957,54,52,1,9.48,99.21,3575182,3575236
27958,49,34,2,10.45,71.51,3575235,3575284
27959,52,140,1,9.85,379.98,3575283,3575335
27960,50,101,1,10.24,233.46,3575334,3575384
27961,77,29,1,6.65,34.70,3575383,3575460
27962,41,67,1,12.49,135.08,3575459,3575500
27963,56,47,0,9.14,77.98,3575499,3575555
27964,40,75,1,12.80,180.36,3575554,3575594
27965,54,39,0,9.48,64.95,3575593,3575647
27966,56,22,1,9.14,24.30,3575646,3575702
27967,54,44,1,9.48,68.43,3575701,3575755
27968,47,79,1,10.89,152.86,3575754,3575801
27969,53,31,0,9.66,58.45,3575800,3575853
27970,59,26,1,8.68,31.81,3575852,3575911
27971,41,55,2,12.49,119.37,3575910,3575951
27972,37,44,1,13.84,127.27,3575950,3575987
27973,33,119,0,15.52,473.64,3575986,3576019
27974,39,44,2,13.13,110.32,3576018,3576057
27975,44,47,1,11.64,98.14,3576056,3576100
27976,50,66,3,10.24,92.46,3576099,3576149
27977,58,36,1,8.83,54.28,3576148,3576206
27978,39,54,1,13.13,138.68,3576205,3576244
27979,39,59,1,13.13,133.45,3576243,3576282
27980,36,57,2,14.22,141.56,3576281,3576317
27981,49,57,2,10.45,74.57,3576317,3576366
27982,33,51,1,15.52,128.92,3576365,3576398
27983,46,77,1,11.13,146.37,3576397,3576443
27984,28,125,2,18.29,630.20,3576442,3576470
27985,42,59,1,12.19,116.82,3576469,3576511
27986,42,66,2,12.19,175.73,3576511,3576553
27987,50,28,2,10.24,39.82,3576552,3576602
27988,48,40,2,10.67,58.31,3576601,3576649
27989,46,45,1,11.13,70.98,3576648,3576694
27990,48,80,1,10.67,159.51,3576693,3576741
27991,40,46,2,12.80,113.71,3576740,3576780
27992,32,49,4,16.00,183.81,3576779,3576811
27993,49,54,1,10.45,74.33,3576810,3576859
27994,50,53,2,10.24,66.18,3576858,3576908
27995,47,37,1,10.89,56.39,3576907,3576954
27996,39,167,1,13.13,673.03,3576953,3576992
27997,35,209,1,14.63,1161.83,3576991,3577026
27998,49,53,1,10.45,89.64,3577025,3577074
27999,42,69,2,12.19,160.30,3577073,3577115
28000,59,34,0,8.68,54.79,3577114,3577173
28001,29,66,2,17.66,305.26,3577172,3577201
28002,34,152,0,15.06,624.70,3577200,3577234
28003,54,30,1,9.48,53.18,3577233,3577287
28004,44,50,1,11.64,141.46,3577286,3577330
28005,43,174,1,11.91,663.76,3577329,3577372
28006,53,52,1,9.66,76.45,3577371,3577424
28007,48,77,1,10.67,272.89,3577423,3577471
28008,33,139,1,15.52,563.10,3577470,3577503
28009,52,31,0,9.85,73.98,3577502,3577554
28010,52,69,0,9.85,135.67,3577553,3577605
28011,86,23,0,5.95,28.81,3577604,3577690
28012,59,57,1,8.68,81.85,3577689,3577748
28013,43,91,1,11.91,235.94,3577747,3577790
28014,56,62,1,9.14,110.23,3577789,3577845
28015,55,49,1,9.31,87.05,3577844,3577899
28016,36,148,1,14.22,552.73,3577899,3577935
28017,55,35,1,9.31,51.16,3577935,3577990
28018,78,23,1,6.56,20.07,3577990,3578068
28019,70,21,0,7.31,24.62,3578067,3578137
28020,40,172,1,12.80,730.61,3578136,3578176
28021,80,25,1,6.40,27.01,3578175,3578255
28022,57,44,1,8.98,50.61,3578254,3578311
28023,34,130,1,15.06,486.82,3578310,3578344
28024,57,42,1,8.98,64.96,3578343,3578400
28025,62,50,1,8.26,82.64,3578399,3578461
28026,43,121,1,11.91,349.29,3578460,3578503
28027,73,32,1,7.01,29.63,3578502,3578575
28028,52,72,1,9.85,124.67,3578574,3578626
28029,43,52,1,11.91,146.74,3578625,3578668
28030,67,84,0,7.64,111.90,3578667,3578734
28031,55,63,1,9.31,90.21,3578733,3578788
28032,56,57,1,9.14,121.37,3578787,3578843
28033,55,41,1,9.31,79.38,3578842,3578897
28034,56,80,1,9.14,153.87,3578896,3578952
28035,38,43,0,13.47,105.88,3578951,3578989
28036,44,45,1,11.64,75.96,3578989,3579033
28037,49,42,2,10.45,77.72,3579032,3579081
28038,22,193,2,23.27,1683.47,3579080,3579102
28039,49,44,2,10.45,80.25,3579101,3579150
28040,51,62,0,10.04,83.84,3579149,3579200
28041,55,63,0,9.31,106.21,3579199,3579254
28042,40,49,1,12.80,117.21,3579253,3579293
28043,44,53,2,11.64,102.00,3579292,3579336
28044,50,45,2,10.24,61.70,3579335,3579385
28045,31,104,2,16.52,423.28,3579384,3579415
28046,35,77,0,14.63,335.20,3579414,3579449
28047,43,46,3,11.91,92.22,3579448,3579491
28048,55,93,1,9.31,156.80,3579491,3579546
28049,43,56,1,11.91,104.69,3579545,3579588
28050,52,30,0,9.85,49.67,3579587,3579639
28051,52,40,2,9.85,48.78,3579639,3579691
28052,50,49,0,10.24,73.62,3579690,3579740
28053,38,99,1,13.47,307.57,3579739,3579777
28054,39,56,1,13.13,159.29,3579776,3579815
28055,48,43,1,10.67,91.14,3579814,3579862
28056,57,37,2,8.98,39.21,3579861,3579918
28057,50,42,3,10.24,51.10,3579917,3579967
28058,45,70,1,11.38,111.08,3579966,3580011
28059,51,47,1,10.04,56.55,3580010,3580061
28060,42,60,1,12.19,117.87,3580060,3580102
28061,33,62,1,15.52,177.40,3580101,3580134
28062,53,44,2,9.66,58.45,3580133,3580186
28063,43,40,3,11.91,37.39,3580185,3580228
28064,60,27,1,8.53,49.25,3580227,3580287
28065,56,51,1,9.14,77.52,3580286,3580342
28066,45,60,0,11.38,102.06,3580341,3580386
28067,39,113,1,13.13,305.50,3580385,3580424
28068,37,64,1,13.84,230.78,3580423,3580460
28069,27,86,2,18.96,461.29,3580460,3580487
28070,25,66,3,20.48,262.25,3580486,3580511
28071,15,219,3,34.13,3091.45,3580510,3580525
28072,25,81,2,20.48,471.61,3580524,3580549
28073,31,87,2,16.52,295.80,3580548,3580579
28074,40,92,1,12.80,269.71,3580578,3580618
28075,30,145,3,17.07,715.46,3580618,3580648
28076,47,55,1,10.89,95.84,3580647,3580694
28077,44,60,1,11.64,179.55,3580693,3580737
28078,45,26,0,11.38,60.46,3580737,3580782
28079,83,37,0,6.17,45.97,3580782,3580865
28080,57,76,1,8.98,111.84,3580864,3580921
28081,45,55,1,11.38,137.44,3580920,3580965
28082,63,42,1,8.13,57.83,3580964,3581027
28083,67,65,1,7.64,90.77,3581026,3581093
28084,63,39,0,8.13,90.27,3581093,3581156
28085,69,69,1,7.42,139.72,3581155,3581224
28086,58,41,0,8.83,69.21,3581224,3581282
28087,49,30,1,10.45,46.41,3581281,3581330
28088,22,191,2,23.27,1463.47,3581329,3581351
28089,61,133,1,8.39,281.06,3581350,3581411
28090,58,42,1,8.83,52.73,3581410,3581468
28091,61,48,1,8.39,66.96,3581467,3581528
28092,57,55,2,8.98,75.84,3581527,3581584
28093,48,61,1,10.67,112.72,3581583,3581631
28094,57,34,1,8.98,55.91,3581630,3581687
28095,56,62,0,9.14,96.16,3581686,3581742
28096,57,92,0,8.98,161.88,3581741,3581798
28097,50,48,1,10.24,143.18,3581797,3581847
28098,23,268,2,22.26,2821.50,3581846,3581869
28099,61,39,1,8.39,61.71,3581868,3581929
28100,39,105,1,13.13,372.06,3581928,3581967
28101,61,45,1,8.39,70.83,3581967,3582028
28102,60,100,1,8.53,175.52,3582027,3582087
28103,64,51,1,8.00,65.62,3582086,3582150
28104,55,30,1,9.31,62.69,3582150,3582205
28105,43,128,0,11.91,378.50,3582204,3582247
28106,44,41,2,11.64,70.60,3582246,3582290
28107,26,213,1,19.69,2005.83,3582289,3582315
28108,25,123,2,20.48,645.13,3582314,3582339
28109,46,49,1,11.13,120.42,3582338,3582384
28110,57,77,1,8.98,102.61,3582384,3582441
28111,45,59,1,11.38,101.84,3582441,3582486
28112,54,53,0,9.48,70.29,3582485,3582539
28113,38,42,1,13.47,80.62,3582538,3582576
28114,50,33,0,10.24,58.90,3582575,3582625
28115,52,70,1,9.85,102.63,3582624,3582676
28116,46,46,1,11.13,87.55,3582676,3582722
28117,30,85,1,17.07,284.80,3582721,3582751
28118,41,43,1,12.49,90.20,3582750,3582791
28119,45,39,0,11.38,86.15,3582791,3582836
28120,50,23,2,10.24,30.78,3582835,3582885
28121,51,30,3,10.04,48.31,3582884,3582935
28122,59,39,1,8.68,45.74,3582934,3582993
28123,33,129,2,15.52,642.80,3582992,3583025
28124,55,33,1,9.31,46.10,3583024,3583079
28125,29,239,1,17.66,1825.61,3583078,3583107
28126,54,34,1,9.48,49.77,3583106,3583160
28127,37,95,1,13.84,267.54,3583159,3583196
28128,41,50,1,12.49,100.84,3583195,3583236
28129,44,61,2,11.64,90.37,3583235,3583279
28130,41,58,1,12.49,113.13,3583278,3583319
28131,60,29,1,8.53,28.55,3583318,3583378
28132,33,79,1,15.52,237.76,3583377,3583410
28133,38,55,1,13.47,143.09,3583409,3583447
28134,40,64,1,12.80,136.51,3583446,3583486
28135,52,45,1,9.85,63.09,3583485,3583537
28136,38,87,1,13.47,247.04,3583536,3583574
28137,48,35,1,10.67,61.47,3583573,3583621
28138,60,42,1,8.53,41.18,3583620,3583680
28139,50,43,1,10.24,80.78,3583679,3583729
28140,22,93,1,23.27,623.11,3583728,3583750
28141,13,249,4,39.38,4170.08,3583749,3583762
28142,24,162,1,21.33,1139.39,3583761,3583785
28143,13,148,6,39.38,1610.08,3583784,3583797
28144,23,183,3,22.26,1328.98,3583796,3583819
28145,25,83,1,20.48,393.29,3583818,3583843
28146,28,107,1,18.29,579.70,3583842,3583870
28147,40,60,1,12.80,149.06,3583869,3583909
28148,35,148,1,14.63,601.66,3583908,3583943
28149,25,226,2,20.48,1940.49,3583942,3583967
28150,47,48,0,10.89,121.29,3583967,3584014
28151,43,42,1,11.91,101.01,3584014,3584057
28152,45,63,1,11.38,179.84,3584056,3584101
28153,23,190,0,22.26,2014.80,3584100,3584123
28154,31,74,1,16.52,349.09,3584122,3584153
28155,21,262,1,24.38,2944.33,3584152,3584173
28156,38,144,1,13.47,551.62,3584172,3584210
28157,63,48,0,8.13,79.13,3584209,3584272
28158,58,47,1,8.83,61.80,3584271,3584329
28159,52,60,1,9.85,151.09,3584328,3584380
28160,52,111,0,9.85,247.32,3584379,3584431
28161,93,36,0,5.51,34.98,3584430,3584523
28162,64,27,1,8.00,41.06,3584522,3584586
28163,50,31,1,10.24,54.10,3584585,3584635
28164,39,70,2,13.13,229.86,3584634,3584673
28165,41,68,1,12.49,214.79,3584672,3584713
28166,57,36,0,8.98,80.09,3584712,3584769
28167,52,39,1,9.85,76.59,3584768,3584820
28168,53,26,1,9.66,47.77,3584819,3584872
28169,67,51,1,7.64,71.72,3584871,3584938
28170,55,32,1,9.31,45.70,3584937,3584992
28171,49,52,0,10.45,94.90,3584991,3585040
28172,57,46,1,8.98,70.26,3585040,3585097
28173,60,39,1,8.53,56.28,3585096,3585156
28174,51,63,1,10.04,128.98,3585155,3585206
28175,54,49,1,9.48,86.43,3585205,3585259
28176,39,65,2,13.13,192.16,3585258,3585297
28177,40,96,2,12.80,267.51,3585296,3585336
28178,65,37,0,7.88,57.58,3585335,3585400
28179,34,162,1,15.06,756.76,3585399,3585433
28180,71,54,1,7.21,62.50,3585432,3585503
28181,32,53,2,16.00,196.25,3585502,3585534
28182,57,71,1,8.98,113.88,3585533,3585590
28183,48,78,1,10.67,136.81,3585589,3585637
28184,44,76,1,11.64,179.23,3585636,3585680
28185,51,47,1,10.04,84.86,3585679,3585730
28186,55,36,1,9.31,49.41,3585729,3585784
28187,35,73,0,14.63,258.00,3585783,3585818
28188,54,68,0,9.48,103.29,3585817,3585871
28189,46,38,1,11.13,71.55,3585871,3585917
28190,48,36,0,10.67,57.81,3585916,3585964
28191,43,50,1,11.91,80.78,3585963,3586006
28192,39,59,4,13.13,119.45,3586005,3586044
28193,41,96,1,12.49,250.98,3586043,3586084
28194,55,35,1,9.31,57.41,3586084,3586139
28195,45,45,1,11.38,109.61,3586138,3586183
28196,49,43,2,10.45,60.82,3586182,3586231
28197,46,82,1,11.13,150.33,3586230,3586276
28198,30,124,1,17.07,597.00,3586275,3586305
28199,42,40,1,12.19,78.11,3586304,3586346
28200,45,37,2,11.38,63.84,3586345,3586390
28201,48,45,1,10.67,85.76,3586389,3586437
28202,52,39,1,9.85,71.48,3586436,3586488
28203,42,67,1,12.19,142.01,3586487,3586529
28204,55,43,2,9.31,50.76,3586529,3586584
28205,50,41,1,10.24,50.58,3586583,3586633
28206,51,27,1,10.04,45.17,3586632,3586683
28207,42,131,0,12.19,413.49,3586682,3586724
28208,51,45,1,10.04,84.08,3586723,3586774
28209,41,57,2,12.49,134.35,3586773,3586814
28210,30,86,1,17.07,306.86,3586813,3586843
28211,28,111,1,18.29,490.99,3586842,3586870
28212,37,56,1,13.84,160.08,3586869,3586906
28213,33,79,1,15.52,248.73,3586905,3586938
28214,33,61,1,15.52,241.34,3586937,3586970
28215,21,218,1,24.38,2085.00,3586970,3586991
28216,37,73,2,13.84,256.73,3586990,3587027
28217,45,46,1,11.38,117.08,3587026,3587071
28218,42,76,1,12.19,183.49,3587071,3587113
28219,46,60,1,11.13,180.77,3587112,3587158
28220,35,139,2,14.63,542.69,3587157,3587192
28221,52,48,0,9.85,85.09,3587191,3587243
28222,83,32,0,6.17,37.66,3587242,3587325
28223,24,217,2,21.33,1842.56,3587324,3587348
28224,47,89,1,10.89,224.05,3587347,3587394
28225,73,35,0,7.01,49.25,3587393,3587466
28226,48,39,2,10.67,72.18,3587466,3587514
28227,37,61,1,13.84,147.22,3587513,3587550
28228,73,28,1,7.01,28.42,3587549,3587622
28229,60,47,0,8.53,71.95,3587621,3587681
28230,65,31,1,7.88,34.48,3587680,3587745
28231,52,67,1,9.85,140.13,3587744,3587796
28232,58,47,1,8.83,61.35,3587795,3587853
28233,58,60,1,8.83,87.59,3587853,3587911
28234,22,313,1,23.27,4049.29,3587910,3587932
28235,64,43,1,8.00,40.31,3587931,3587995
28236,56,36,1,9.14,62.02,3587994,3588050
28237,44,145,1,11.64,466.14,3588049,3588093
28238,43,122,2,11.91,323.48,3588092,3588135
28239,60,37,0,8.53,70.32,3588134,3588194
28240,40,191,1,12.80,924.41,3588193,3588233
28241,38,164,0,13.47,668.46,3588232,3588270
28242,31,165,0,16.52,858.44,3588269,3588300
28243,37,110,1,13.84,392.84,3588299,3588336
28244,34,121,1,15.06,520.76,3588335,3588369
28245,50,58,0,10.24,127.50,3588368,3588418
28246,47,120,1,10.89,306.01,3588417,3588464
28247,50,81,1,10.24,193.34,3588463,3588513
28248,49,40,1,10.45,60.78,3588512,3588561
28249,44,87,2,11.64,195.10,3588560,3588604
28250,41,56,2,12.49,125.66,3588603,3588644
28251,43,59,3,11.91,93.20,3588643,3588686
28252,37,50,2,13.84,119.97,3588685,3588722
28253,19,94,3,26.95,716.16,3588721,3588740
28254,53,32,1,9.66,66.90,3588739,3588792
28255,58,38,1,8.83,46.25,3588791,3588849
28256,55,55,1,9.31,74.76,3588848,3588903
28257,47,43,1,10.89,87.16,3588902,3588949
28258,37,88,1,13.84,203.87,3588948,3588985
28259,44,32,1,11.64,63.23,3588984,3589028
28260,48,60,1,10.67,146.81,3589027,3589075
28261,41,37,2,12.49,81.23,3589074,3589115
28262,35,49,1,14.63,122.75,3589115,3589150
28263,45,61,1,11.38,129.75,3589149,3589194
28264,45,103,1,11.38,230.77,3589193,3589238
28265,51,36,0,10.04,64.86,3589238,3589289
28266,46,57,1,11.13,116.20,3589288,3589334
28267,46,31,2,11.13,55.07,3589333,3589379
28268,41,43,2,12.49,75.52,3589378,3589419
28269,38,49,2,13.47,128.09,3589418,3589456
28270,56,59,0,9.14,111.77,3589455,3589511
28271,61,39,1,8.39,52.11,3589510,3589571
28272,53,63,1,9.66,106.11,3589570,3589623
28273,49,37,1,10.45,76.66,3589623,3589672
28274,33,56,1,15.52,190.25,3589671,3589704
28275,21,76,4,24.38,381.66,3589703,3589724
28276,21,120,1,24.38,632.43,3589723,3589744
28277,30,46,0,17.07,123.66,3589743,3589773
28278,25,107,2,20.48,702.09,3589772,3589797
28279,31,61,2,16.52,274.83,3589796,3589827
28280,49,65,0,10.45,165.80,3589826,3589875
28281,49,55,1,10.45,72.94,3589874,3589923
28282,32,82,1,16.00,259.44,3589922,3589954
28283,48,63,1,10.67,157.22,3589953,3590001
28284,48,47,1,10.67,80.51,3590001,3590049
28285,76,86,0,6.74,99.51,3590048,3590124
28286,66,35,0,7.76,57.91,3590123,3590189
28287,51,43,1,10.04,79.96,3590189,3590240
28288,49,66,1,10.45,184.17,3590239,3590288
28289,65,55,0,7.88,93.92,3590287,3590352
28290,8,458,1,64.00,22213.25,3590351,3590359
28291,79,32,0,6.48,40.58,3590358,3590437
28292,61,99,0,8.39,210.99,3590436,3590497
28293,56,116,1,9.14,230.27,3590496,3590552
28294,53,29,1,9.66,53.21,3590551,3590604
28295,46,70,1,11.13,195.24,3590603,3590649
28296,60,40,1,8.53,54.82,3590648,3590708
28297,52,97,0,9.85,191.75,3590707,3590759
28298,49,62,1,10.45,124.29,3590758,3590807
28299,62,68,1,8.26,75.22,3590806,3590868
28300,61,30,1,8.39,45.75,3590867,3590928
28301,63,37,1,8.13,55.16,3590927,3590990
28302,46,54,1,11.13,152.81,3590989,3591035
28303,40,59,2,12.80,171.11,3591034,3591074
28304,54,56,2,9.48,83.62,3591073,3591127
28305,55,46,0,9.31,81.67,3591126,3591181
28306,55,92,1,9.31,174.61,3591180,3591235
28307,55,66,1,9.31,103.16,3591234,3591289
28308,68,42,1,7.53,60.01,3591288,3591356
28309,27,201,1,18.96,1879.29,3591355,3591382
28310,56,116,1,9.14,246.30,3591381,3591437
28311,52,52,1,9.85,67.75,3591436,3591488
28312,45,128,1,11.38,364.32,3591487,3591532
28313,38,123,1,13.47,415.46,3591531,3591569
28314,49,37,1,10.45,42.04,3591568,3591617
28315,46,59,0,11.13,117.77,3591616,3591662
28316,62,36,1,8.26,36.32,3591661,3591723
28317,43,48,1,11.91,92.64,3591723,3591766
28318,53,31,1,9.66,40.98,3591765,3591818
28319,42,46,1,12.19,81.39,3591817,3591859
28320,35,46,2,14.63,152.58,3591858,3591893
28321,55,39,1,9.31,41.89,3591892,3591947
28322,56,29,1,9.14,31.73,3591946,3592002
28323,40,46,1,12.80,116.61,3592001,3592041
28324,51,49,1,10.04,66.23,3592040,3592091
28325,50,45,1,10.24,74.86,3592090,3592140
28326,43,50,1,11.91,80.64,3592139,3592182
28327,42,42,3,12.19,83.68,3592181,3592223
28328,50,49,1,10.24,65.34,3592223,3592273
28329,42,48,2,12.19,95.30,3592272,3592314
28330,55,35,1,9.31,58.87,3592313,3592368
28331,63,30,1,8.13,31.13,3592367,3592430
28332,45,67,2,11.38,146.28,3592429,3592474
28333,40,43,1,12.80,114.01,3592473,3592513
28334,25,226,1,20.48,1920.65,3592512,3592537
28335,37,127,2,13.84,534.89,3592536,3592573
28336,38,84,2,13.47,227.20,3592572,3592610
28337,54,37,3,9.48,36.21,3592609,3592663
28338,49,41,2,10.45,48.86,3592663,3592712
28339,52,34,0,9.85,53.90,3592712,3592764
28340,46,37,1,11.13,56.11,3592763,3592809
28341,52,45,2,9.85,65.44,3592808,3592860
28342,70,33,1,7.31,33.59,3592859,3592929
28343,39,126,1,13.13,390.78,3592928,3592967
28344,45,38,2,11.38,45.70,3592966,3593011
28345,49,46,1,10.45,70.90,3593010,3593059
28346,25,100,4,20.48,416.01,3593058,3593083
28347,25,80,1,20.48,300.41,3593082,3593107
28348,41,66,2,12.49,144.35,3593106,3593147
28349,42,41,1,12.19,109.96,3593146,3593188
28350,45,49,1,11.38,122.19,3593187,3593232
28351,39,107,1,13.13,304.42,3593231,3593270
28352,59,45,0,8.68,71.74,3593270,3593329
28353,40,113,1,12.80,370.76,3593328,3593368
28354,56,35,1,9.14,54.23,3593367,3593423
28355,44,125,1,11.64,368.91,3593422,3593466
28356,75,32,0,6.83,44.94,3593465,3593540
28357,67,76,0,7.64,110.50,3593539,3593606
28358,35,217,1,14.63,1261.20,3593605,3593640
28359,73,29,1,7.01,33.82,3593639,3593712
28360,57,46,1,8.98,104.12,3593712,3593769
28361,73,46,0,7.01,56.86,3593768,3593841
28362,48,60,1,10.67,126.68,3593841,3593889
28363,47,69,1,10.89,102.44,3593888,3593935
28364,52,60,1,9.85,132.51,3593934,3593986
28365,69,45,1,7.42,62.33,3593985,3594054
28366,31,102,1,16.52,430.44,3594053,3594084
28367,44,109,1,11.64,445.60,3594084,3594128
28368,58,53,1,8.83,57.69,3594127,3594185
28369,65,88,1,7.88,134.48,3594184,3594249
28370,42,51,1,12.19,111.77,3594248,3594290
28371,34,145,1,15.06,709.11,3594289,3594323
28372,50,75,1,10.24,175.10,3594322,3594372
28373,65,44,1,7.88,48.54,3594371,3594436
28374,69,28,1,7.42,27.69,3594435,3594504
28375,55,50,1,9.31,108.43,3594503,3594558
28376,60,30,0,8.53,30.85,3594558,3594618
28377,72,46,1,7.11,49.38,3594617,3594689
28378,60,40,1,8.53,66.38,3594688,3594748
28379,72,27,1,7.11,33.65,3594747,3594819
28380,25,236,2,20.48,2103.13,3594818,3594843
28381,57,36,1,8.98,43.67,3594842,3594899
28382,26,269,1,19.69,2574.44,3594898,3594924
28383,34,79,1,15.06,248.41,3594923,3594957
28384,43,119,0,11.91,332.92,3594956,3594999
28385,51,71,1,10.04,170.31,3594998,3595049
28386,54,38,1,9.48,41.81,3595048,3595102
28387,38,38,2,13.47,104.14,3595101,3595139
28388,36,59,2,14.22,186.40,3595138,3595174
28389,51,34,1,10.04,58.82,3595173,3595224
28390,38,59,1,13.47,166.46,3595223,3595261
28391,42,62,1,12.19,138.06,3595260,3595302
28392,44,68,1,11.64,130.41,3595301,3595345
28393,60,23,1,8.53,26.12,3595344,3595404
28394,51,41,1,10.04,57.72,3595403,3595454
28395,64,27,2,8.00,30.19,3595453,3595517
28396,40,52,1,12.80,107.11,3595516,3595556
28397,23,161,2,22.26,1038.80,3595555,3595578
28398,42,37,2,12.19,82.58,3595577,3595619
28399,43,51,2,11.91,101.39,3595618,3595661
28400,46,38,2,11.13,66.07,3595660,3595706
28401,43,90,0,11.91,170.46,3595705,3595748
28402,53,45,1,9.66,62.90,3595748,3595801
28403,40,40,1,12.80,84.21,3595800,3595840
28404,54,52,1,9.48,63.81,3595839,3595893
28405,41,33,2,12.49,65.23,3595892,3595933
28406,40,71,2,12.80,141.36,3595932,3595972
28407,48,36,2,10.67,65.64,3595972,3596020
28408,45,29,1,11.38,53.70,3596019,3596064
28409,45,48,1,11.38,104.32,3596063,3596108
28410,44,83,1,11.64,207.78,3596107,3596151
28411,56,36,1,9.14,50.87,3596150,3596206
28412,49,59,1,10.45,81.55,3596206,3596255
28413,28,73,1,18.29,373.35,3596254,3596282
28414,30,92,2,17.07,433.86,3596281,3596311
28415,34,108,2,15.06,332.35,3596310,3596344
28416,29,49,1,17.66,188.71,3596343,3596372
28417,17,126,2,30.12,872.10,3596371,3596388
28418,34,59,2,15.06,219.53,3596387,3596421
28419,56,34,2,9.14,39.77,3596420,3596476
28420,54,31,2,9.48,43.43,3596475,3596529
28421,40,158,1,12.80,600.16,3596528,3596568
28422,48,57,1,10.67,113.51,3596567,3596615
28423,36,144,1,14.22,647.40,3596614,3596650
28424,51,68,1,10.04,122.98,3596649,3596700
28425,69,31,1,7.42,41.37,3596699,3596768
28426,81,36,1,6.32,45.40,3596768,3596849
28427,60,27,2,8.53,33.02,3596848,3596908
28428,45,68,1,11.38,212.81,3596907,3596952
28429,62,36,1,8.26,62.74,3596951,3597013
28430,65,54,1,7.88,97.03,3597012,3597077
28431,48,79,1,10.67,203.22,3597076,3597124
28432,57,58,1,8.98,98.79,3597123,3597180
28433,45,46,1,11.38,100.50,3597179,3597224
28434,62,66,1,8.26,94.90,3597223,3597285
28435,48,90,1,10.67,178.26,3597284,3597332
28436,52,40,1,9.85,73.51,3597331,3597383
28437,47,52,1,10.89,121.88,3597382,3597429
28438,76,79,1,6.74,82.93,3597428,3597504
28439,44,65,1,11.64,129.00,3597503,3597547
28440,53,36,1,9.66,62.22,3597546,3597599
28441,55,79,1,9.31,151.01,3597598,3597653
28442,61,49,1,8.39,83.35,3597652,3597713
28443,53,71,0,9.66,173.51,3597712,3597765
28444,46,96,1,11.13,238.59,3597764,3597810
28445,50,62,2,10.24,82.22,3597810,3597860
28446,55,56,1,9.31,75.52,3597859,3597914
28447,63,33,1,8.13,46.49,3597913,3597976
28448,34,104,1,15.06,421.35,3597975,3598009
28449,53,43,1,9.66,69.70,3598008,3598061
28450,33,143,2,15.52,663.64,3598060,3598093
28451,35,79,1,14.63,334.23,3598092,3598127
28452,48,66,1,10.67,116.43,3598126,3598174
28453,49,31,2,10.45,54.04,3598173,3598222
28454,41,58,1,12.49,124.69,3598221,3598262
28455,40,85,1,12.80,309.11,3598261,3598301
28456,59,44,1,8.68,47.95,3598300,3598359
28457,45,88,1,11.38,184.46,3598359,3598404
28458,46,67,0,11.13,132.98,3598403,3598449
28459,40,130,1,12.80,407.76,3598448,3598488
28460,47,108,1,10.89,225.50,3598487,3598534
28461,40,43,2,12.80,74.56,3598534,3598574
28462,47,47,2,10.89,76.52,3598573,3598620
28463,50,42,1,10.24,59.18,3598619,3598669
28464,46,46,1,11.13,91.42,3598668,3598714
28465,38,105,1,13.47,360.14,3598713,3598751
28466,52,41,2,9.85,55.32,3598751,3598803
28467,29,130,1,17.66,644.85,3598802,3598831
28468,50,53,1,10.24,96.10,3598830,3598880
28469,43,45,1,11.91,74.46,3598879,3598922
28470,34,88,1,15.06,306.41,3598921,3598955
28471,53,36,0,9.66,50.53,3598954,3599007
28472,54,53,2,9.48,64.40,3599006,3599060
28473,48,31,2,10.67,47.22,3599059,3599107
28474,55,36,1,9.31,38.07,3599106,3599161
28475,41,177,1,12.49,697.86,3599160,3599201
28476,59,30,0,8.68,47.40,3599200,3599259
28477,44,61,1,11.64,142.14,3599258,3599302
28478,42,101,1,12.19,240.68,3599301,3599343
28479,29,62,2,17.66,324.64,3599342,3599371
28480,29,111,1,17.66,571.26,3599370,3599399
28481,30,114,1,17.07,420.73,3599398,3599428
28482,24,85,2,21.33,557.97,3599427,3599451
28483,25,58,1,20.48,296.97,3599450,3599475
28484,48,38,0,10.67,72.51,3599474,3599522
28485,43,75,1,11.91,183.25,3599521,3599564
28486,47,61,1,10.89,128.99,3599563,3599610
28487,48,85,1,10.67,189.51,3599609,3599657
28488,37,67,1,13.84,225.81,3599656,3599693
28489,45,77,0,11.38,210.59,3599692,3599737
28490,33,138,1,15.52,607.95,3599736,3599769
28491,70,50,1,7.31,71.02,3599768,3599838
28492,63,46,0,8.13,60.43,3599838,3599901
28493,55,30,1,9.31,75.89,3599900,3599955
28494,55,33,1,9.31,71.45,3599954,3600009
28495,50,53,1,10.24,81.34,3600008,3600058
28496,43,73,2,11.91,165.01,3600057,3600100
28497,39,185,1,13.13,807.60,3600099,3600138
28498,63,71,1,8.13,136.90,3600137,3600200
28499,63,33,1,8.13,46.90,3600199,3600262
28500,62,51,1,8.26,66.64,3600261,3600323
28501,59,61,1,8.68,104.22,3600322,3600381
28502,61,44,1,8.39,71.85,3600380,3600441
28503,62,41,0,8.26,56.55,3600440,3600502
28504,41,99,1,12.49,323.52,3600501,3600542
28505,50,43,1,10.24,61.50,3600541,3600591
28506,53,70,1,9.66,140.00,3600590,3600643
28507,60,54,1,8.53,72.65,3600642,3600702
28508,58,56,1,8.83,77.97,3600702,3600760
28509,58,41,1,8.83,65.14,3600759,3600817
28510,59,46,1,8.68,63.40,3600817,3600876
28511,40,42,2,12.80,109.31,3600875,3600915
28512,39,120,1,13.13,365.60,3600915,3600954
28513,34,167,2,15.06,752.06,3600953,3600987
28514,56,31,1,9.14,42.84,3600986,3601042
28515,34,152,1,15.06,687.88,3601041,3601075
28516,43,49,1,11.91,95.29,3601074,3601117
28517,39,126,1,13.13,394.47,3601116,3601155
28518,43,72,1,11.91,133.34,3601154,3601197
28519,37,78,1,13.84,223.81,3601196,3601233
28520,39,89,1,13.13,263.60,3601232,3601271
28521,60,29,2,8.53,37.45,3601270,3601330
28522,46,71,1,11.13,128.33,3601329,3601375
28523,54,36,0,9.48,73.32,3601374,3601428
28524,48,64,2,10.67,108.47,3601427,3601475
28525,32,92,2,16.00,390.56,3601474,3601506
28526,43,68,0,11.91,141.20,3601505,3601548
28527,46,43,2,11.13,48.24,3601547,3601593
28528,50,88,1,10.24,149.14,3601592,3601642
28529,44,38,2,11.64,69.41,3601641,3601685
28530,40,107,0,12.80,321.86,3601684,3601724
28531,39,74,2,13.13,242.73,3601723,3601762
28532,49,41,1,10.45,65.92,3601761,3601810
28533,47,38,1,10.89,54.18,3601809,3601856
28534,40,43,3,12.80,83.31,3601855,3601895
28535,46,78,1,11.13,152.33,3601894,3601940
28536,45,60,1,11.38,118.37,3601940,3601985
28537,53,41,1,9.66,83.43,3601984,3602037
28538,55,40,1,9.31,41.67,3602036,3602091
28539,35,159,1,14.63,693.55,3602090,3602125
28540,37,49,1,13.84,119.60,3602124,3602161
28541,33,38,1,15.52,113.83,3602160,3602193
28542,24,79,1,21.33,364.81,3602192,3602216
28543,32,82,2,16.00,299.62,3602215,3602247
28544,43,77,1,11.91,232.97,3602246,3602289
28545,21,323,1,24.38,4487.47,3602288,3602309
28546,40,44,2,12.80,112.91,3602308,3602348
28547,35,60,1,14.63,180.35,3602347,3602382
28548,40,94,1,12.80,267.16,3602381,3602421
28549,47,196,0,10.89,798.95,3602420,3602467
28550,48,50,1,10.67,92.31,3602466,3602514
28551,6,376,3,85.33,17231.22,3602513,3602519
28552,38,134,1,13.47,450.88,3602518,3602556
28553,60,64,1,8.53,112.85,3602555,3602615
28554,88,59,1,5.82,68.94,3602614,3602702
28555,35,197,1,14.63,1060.18,3602701,3602736
28556,67,42,0,7.64,70.17,3602736,3602803
28557,48,52,1,10.67,150.72,3602802,3602850
28558,51,60,1,10.04,193.25,3602849,3602900
28559,106,27,1,4.83,24.93,3602899,3603005
28560,52,34,1,9.85,53.09,3603004,3603056
28561,39,48,3,13.13,109.91,3603055,3603094
28562,45,38,1,11.38,90.46,3603093,3603138
28563,63,37,0,8.13,59.09,3603137,3603200
28564,45,75,1,11.38,152.37,3603199,3603244
28565,53,70,1,9.66,110.90,3603243,3603296
28566,57,118,1,8.98,241.74,3603296,3603353
28567,55,40,2,9.31,40.65,3603352,3603407
28568,67,43,1,7.64,70.08,3603407,3603474
28569,62,83,1,8.26,129.29,3603474,3603536
28570,50,52,1,10.24,114.22,3603535,3603585
28571,47,60,1,10.89,126.39,3603584,3603631
28572,45,43,0,11.38,121.35,3603630,3603675
28573,40,91,1,12.80,326.61,3603674,3603714
28574,65,58,1,7.88,89.74,3603713,3603778
28575,73,33,0,7.01,30.04,3603777,3603850
28576,51,151,1,10.04,467.92,3603849,3603900
28577,46,42,1,11.13,88.59,3603899,3603945
28578,28,220,1,18.29,1609.99,3603944,3603972
28579,41,76,1,12.49,252.20,3603971,3604012
28580,42,43,1,12.19,90.44,3604011,3604053
28581,51,63,0,10.04,103.84,3604052,3604103
28582,50,39,2,10.24,52.10,3604103,3604153
28583,68,29,1,7.53,28.25,3604152,3604220
28584,43,63,2,11.91,136.46,3604219,3604262
28585,31,125,3,16.52,454.89,3604261,3604292
28586,49,40,1,10.45,73.19,3604291,3604340
28587,56,29,1,9.14,43.62,3604339,3604395
28588,55,23,1,9.31,26.00,3604394,3604449
28589,26,146,3,19.69,801.21,3604448,3604474
28590,44,34,0,11.64,55.41,3604473,3604517
28591,54,47,1,9.48,67.51,3604516,3604570
28592,48,43,1,10.67,80.31,3604569,3604617
28593,47,46,1,10.89,60.56,3604616,3604663
28594,60,22,1,8.53,24.82,3604662,3604722
28595,50,29,1,10.24,41.30,3604721,3604771
28596,47,39,1,10.89,83.88,3604770,3604817
28597,23,149,2,22.26,1087.84,3604816,3604839
28598,48,31,2,10.67,47.56,3604838,3604886
28599,42,34,2,12.19,56.15,3604885,3604927
28600,55,31,1,9.31,38.36,3604926,3604981
28601,44,28,3,11.64,41.87,3604980,3605024
28602,44,70,2,11.64,109.64,3605024,3605068
28603,53,27,2,9.66,37.39,3605067,3605120
28604,53,27,1,9.66,36.53,3605119,3605172
28605,27,243,2,18.96,1994.78,3605171,3605198
28606,39,77,2,13.13,238.52,3605197,3605236
28607,39,60,2,13.13,157.24,3605235,3605274
28608,63,41,1,8.13,59.67,3605273,3605336
28609,51,37,1,10.04,56.86,3605335,3605386
28610,35,81,1,14.63,275.60,3605385,3605420
28611,27,124,2,18.96,797.07,3605419,3605446
28612,24,83,7,21.33,369.72,3605445,3605469
28613,27,67,1,18.96,279.74,3605468,3605495
28614,19,101,3,26.95,843.00,3605494,3605513
28615,47,49,1,10.89,94.78,3605512,3605559
28616,45,77,3,11.38,143.08,3605558,3605603
28617,50,41,1,10.24,84.58,3605603,3605653
28618,35,56,1,14.63,218.98,3605652,3605687
28619,32,96,1,16.00,381.44,3605686,3605718
28620,48,72,1,10.67,142.60,3605717,3605765
28621,59,41,1,8.68,68.63,3605764,3605823
28622,44,45,1,11.64,137.28,3605822,3605866
28623,57,34,0,8.98,53.46,3605865,3605922
28624,102,28,0,5.02,24.61,3605921,3606023
28625,53,105,1,9.66,231.47,3606022,3606075
28626,37,220,1,13.84,1224.03,3606075,3606112
28627,47,69,1,10.89,171.88,3606111,3606158
28628,82,35,0,6.24,40.92,3606157,3606239
28629,48,56,1,10.67,99.89,3606238,3606286
28630,66,56,1,7.76,82.61,3606285,3606351
28631,47,43,1,10.89,72.52,3606350,3606397
28632,54,66,1,9.48,91.95,3606396,3606450
28633,63,53,1,8.13,83.67,3606449,3606512
28634,42,183,0,12.19,758.73,3606511,3606553
28635,51,75,1,10.04,140.23,3606552,3606603
28636,49,74,2,10.45,201.76,3606602,3606651
28637,72,36,1,7.11,34.18,3606650,3606722
28638,61,37,1,8.39,62.04,3606721,3606782
28639,56,31,1,9.14,42.23,3606782,3606838
28640,54,62,1,9.48,107.73,3606837,3606891
28641,68,39,1,7.53,38.34,3606890,3606958
28642,46,107,1,11.13,260.33,3606957,3607003
28643,60,42,1,8.53,69.88,3607002,3607062
28644,49,75,2,10.45,147.31,3607061,3607110
28645,70,39,1,7.31,39.22,3607110,3607180
28646,57,57,1,8.98,82.72,3607179,3607236
28647,30,106,2,17.07,438.20,3607235,3607265
28648,50,49,1,10.24,92.02,3607264,3607314
28649,37,74,1,13.84,279.92,3607313,3607350
28650,21,137,4,24.38,939.85,3607349,3607370
28651,50,35,2,10.24,51.50,3607369,3607419
28652,38,192,1,13.47,896.93,3607418,3607456
28653,27,255,2,18.96,2199.52,3607456,3607483
28654,62,39,1,8.26,42.61,3607483,3607545
28655,48,33,1,10.67,45.72,3607544,3607592
28656,40,119,1,12.80,330.36,3607591,3607631
28657,39,57,1,13.13,141.45,3607630,3607669
28658,46,38,1,11.13,61.81,3607668,3607714
28659,55,40,1,9.31,45.56,3607713,3607768
28660,38,35,4,13.47,60.67,3607767,3607805
28661,51,32,2,10.04,48.94,3607804,3607855
28662,46,54,0,11.13,95.24,3607854,3607900
28663,53,35,1,9.66,66.45,3607900,3607953
28664,35,60,0,14.63,235.89,3607952,3607987
28665,36,99,1,14.22,250.73,3607986,3608022
28666,41,124,1,12.49,380.30,3608021,3608062
28667,39,113,1,13.13,371.91,3608061,3608100
28668,30,66,2,17.07,283.33,3608099,3608129
28669,43,63,1,11.91,146.83,3608128,3608171
28670,45,31,1,11.38,50.01,3608170,3608215
28671,47,100,1,10.89,205.58,3608214,3608261
28672,47,31,1,10.89,52.82,3608260,3608307
28673,46,38,1,11.13,71.68,3608306,3608352
28674,39,52,1,13.13,120.62,3608351,3608390
28675,33,99,2,15.52,457.52,3608389,3608422
28676,44,104,1,11.64,420.91,3608421,3608465
28677,37,150,1,13.84,657.65,3608464,3608501
28678,34,90,1,15.06,345.58,3608500,3608534
28679,34,86,2,15.06,260.58,3608533,3608567
28680,17,261,1,30.12,3455.87,3608566,3608583
28681,28,106,3,18.29,402.63,3608582,3608610
28682,39,86,1,13.13,264.88,3608609,3608648
28683,34,65,1,15.06,203.00,3608647,3608681
28684,39,81,1,13.13,237.50,3608680,3608719
28685,48,35,1,10.67,67.01,3608718,3608766
28686,34,124,3,15.06,451.53,3608765,3608799
28687,51,56,1,10.04,107.96,3608798,3608849
28688,53,87,0,9.66,172.26,3608848,3608901
28689,35,84,1,14.63,221.72,3608900,3608935
28690,55,42,1,9.31,69.38,3608934,3608989
28691,62,47,1,8.26,87.93,3608988,3609050
28692,1,512,512,512.00,0.00,3609049,3609050
28693,71,56,1,7.21,95.55,3609049,3609120
28694,42,109,1,12.19,463.87,3609119,3609161
28695,64,34,0,8.00,51.09,3609160,3609224
28696,34,72,1,15.06,250.53,3609223,3609257
28697,70,68,0,7.31,123.47,3609256,3609326
28698,68,58,1,7.53,104.13,3609325,3609393
28699,70,58,0,7.31,104.64,3609392,3609462
28700,45,46,1,11.38,66.24,3609461,3609506
28701,41,74,1,12.49,193.91,3609505,3609546
28702,57,46,1,8.98,83.07,3609545,3609602
28703,64,40,0,8.00,41.81,3609601,3609665
28704,52,86,0,9.85,173.67,3609664,3609716
28705,62,72,1,8.26,142.84,3609715,3609777
28706,47,62,1,10.89,145.12,3609776,3609823
28707,62,35,1,8.26,37.00,3609822,3609884
28708,53,48,2,9.66,79.21,3609883,3609936
28709,48,82,0,10.67,192.35,3609935,3609983
28710,68,30,0,7.53,45.31,3609982,3610050
28711,48,63,0,10.67,139.72,3610049,3610097
28712,37,66,1,13.84,172.57,3610096,3610133
28713,52,35,2,9.85,54.98,3610132,3610184
28714,87,18,1,5.89,13.09,3610183,3610270
28715,47,63,1,10.89,185.58,3610269,3610316
28716,35,72,1,14.63,264.18,3610315,3610350
28717,52,44,1,9.85,82.94,3610349,3610401
28718,49,31,1,10.45,61.43,3610400,3610449
28719,42,36,1,12.19,78.82,3610448,3610490
28720,58,38,1,8.83,69.28,3610489,3610547
28721,55,38,2,9.31,49.85,3610547,3610602
28722,37,119,2,13.84,385.97,3610601,3610638
28723,39,63,1,13.13,183.29,3610637,3610676
28724,52,48,1,9.85,101.40,3610675,3610727
28725,45,31,1,11.38,59.21,3610726,3610771
28726,53,73,2,9.66,122.94,3610770,3610823
28727,45,28,1,11.38,42.95,3610822,3610867
28728,42,39,1,12.19,95.34,3610866,3610908
28729,55,49,1,9.31,82.47,3610907,3610962
28730,35,54,2,14.63,168.12,3610961,3610996
28731,43,118,1,11.91,366.60,3610995,3611038
28732,35,88,1,14.63,301.43,3611037,3611072
28733,48,34,1,10.67,68.31,3611071,3611119
28734,30,122,1,17.07,499.26,3611118,3611148
28735,47,33,1,10.89,59.67,3611147,3611194
28736,48,31,1,10.67,34.60,3611193,3611241
28737,52,47,2,9.85,55.78,3611240,3611292
28738,45,46,1,11.38,104.15,3611291,3611336
28739,60,24,1,8.53,29.58,3611335,3611395
28740,53,96,0,9.66,176.90,3611394,3611447
28741,47,58,1,10.89,97.20,3611447,3611494
28742,33,73,2,15.52,294.07,3611493,3611526
28743,35,82,2,14.63,358.06,3611525,3611560
28744,27,102,3,18.96,505.22,3611559,3611586
28745,26,115,1,19.69,552.83,3611585,3611611
28746,49,55,1,10.45,93.23,3611610,3611659
28747,53,32,1,9.66,53.36,3611658,3611711
28748,38,144,1,13.47,509.93,3611710,3611748
28749,51,41,1,10.04,76.16,3611747,3611798
28750,43,64,0,11.91,220.83,3611797,3611840
28751,25,122,1,20.48,1150.73,3611839,3611864
28752,41,78,1,12.49,302.40,3611863,3611904
28753,44,67,0,11.64,182.82,3611903,3611947
28754,83,64,1,6.17,67.75,3611946,3612029
28755,53,58,1,9.66,113.32,3612028,3612081
28756,49,61,0,10.45,125.72,3612080,3612129
28757,61,47,1,8.39,83.94,3612128,3612189
28758,48,37,1,10.67,88.76,3612188,3612236
28759,58,65,1,8.83,121.97,3612235,3612293
28760,77,43,1,6.65,55.16,3612292,3612369
28761,64,86,1,8.00,138.22,3612368,3612432
28762,51,34,1,10.04,50.04,3612431,3612482
28763,28,111,3,18.29,450.06,3612481,3612509
28764,66,43,0,7.76,60.37,3612508,3612574
28765,65,52,1,7.88,61.28,3612573,3612638
28766,50,50,0,10.24,95.18,3612637,3612687
28767,55,71,1,9.31,130.61,3612686,3612741
28768,57,29,1,8.98,37.56,3612740,3612797
28769,61,39,1,8.39,52.89,3612796,3612857
28770,58,35,1,8.83,45.63,3612856,3612914
28771,63,47,1,8.13,59.98,3612913,3612976
28772,17,275,2,30.12,4278.81,3612975,3612992
28773,60,22,0,8.53,30.32,3612991,3613051
28774,60,44,1,8.53,49.65,3613050,3613110
28775,59,52,1,8.68,85.68,3613110,3613169
28776,53,96,0,9.66,205.58,3613168,3613221
28777,45,55,1,11.38,124.46,3613220,3613265
28778,31,210,1,16.52,1347.15,3613264,3613295
28779,52,42,1,9.85,69.17,3613294,3613346
28780,25,146,1,20.48,1423.45,3613345,3613370
28781,48,38,1,10.67,89.93,3613369,3613417
28782,32,121,1,16.00,563.31,3613416,3613448
28783,58,64,1,8.83,95.38,3613447,3613505
28784,48,73,1,10.67,127.76,3613504,3613552
28785,60,28,1,8.53,35.45,3613551,3613611
28786,44,94,1,11.64,317.23,3613611,3613655
28787,41,39,2,12.49,64.98,3613654,3613695
28788,46,33,1,11.13,52.29,3613694,3613740
28789,59,57,1,8.68,68.79,3613739,3613798
28790,52,38,1,9.85,58.32,3613797,3613849
28791,29,130,1,17.66,570.50,3613848,3613877
28792,46,27,2,11.13,49.94,3613876,3613922
28793,25,89,4,20.48,532.89,3613921,3613946
28794,41,43,2,12.49,63.23,3613945,3613986
28795,45,34,1,11.38,66.90,3613985,3614030
28796,31,57,3,16.52,106.19,3614029,3614060
28797,50,90,1,10.24,162.26,3614059,3614109
28798,59,42,1,8.68,43.17,3614108,3614167
28799,59,59,1,8.68,63.20,3614166,3614225
28800,54,66,1,9.48,105.03,3614224,3614278
28801,50,43,1,10.24,56.94,3614277,3614327
28802,38,56,3,13.47,139.67,3614326,3614364
28803,26,85,3,19.69,352.98,3614363,3614389
28804,25,77,1,20.48,510.65,3614388,3614413
28805,18,163,3,28.44,1289.80,3614412,3614430
28806,32,65,3,16.00,193.44,3614429,3614461
28807,23,102,4,22.26,486.80,3614460,3614483
28808,29,102,2,17.66,625.81,3614482,3614511
28809,17,127,3,30.12,905.04,3614510,3614527
28810,34,47,3,15.06,126.64,3614526,3614560
28811,51,51,1,10.04,94.82,3614560,3614611
28812,42,109,1,12.19,295.73,3614610,3614652
28813,34,99,2,15.06,280.76,3614652,3614686
28814,44,48,1,11.64,94.50,3614685,3614729
28815,58,55,1,8.83,84.11,3614728,3614786
28816,51,78,0,10.04,193.37,3614785,3614836
28817,39,87,0,13.13,366.98,3614835,3614874
28818,37,223,1,13.84,1281.27,3614873,3614910
28819,43,66,1,11.91,192.08,3614909,3614952
28820,62,123,0,8.26,264.03,3614951,3615013
28821,51,220,1,10.04,934.47,3615012,3615063
28822,48,115,1,10.67,339.14,3615062,3615110
28823,50,34,1,10.24,56.78,3615109,3615159
28824,50,85,1,10.24,220.70,3615158,3615208
28825,66,159,0,7.76,375.82,3615207,3615273
28826,36,65,1,14.22,293.12,3615272,3615308
28827,69,79,1,7.42,140.97,3615308,3615377
28828,45,65,1,11.38,131.12,3615377,3615422
28829,43,104,2,11.91,248.64,3615421,3615464
28830,67,71,1,7.64,100.80,3615463,3615530
28831,56,51,1,9.14,102.94,3615529,3615585
28832,41,76,1,12.49,288.10,3615584,3615625
28833,45,57,1,11.38,143.88,3615624,3615669
28834,61,33,1,8.39,46.01,3615668,3615729
28835,51,48,1,10.04,75.17,3615728,3615779
28836,58,29,0,8.83,57.94,3615778,3615836
28837,68,30,1,7.53,38.31,3615835,3615903
28838,61,44,1,8.39,52.47,3615902,3615963
28839,48,64,1,10.67,132.81,3615963,3616011
28840,58,78,1,8.83,128.28,3616010,3616068
28841,58,34,1,8.83,71.76,3616067,3616125
28842,62,46,1,8.26,69.58,3616125,3616187
28843,51,37,1,10.04,65.21,3616186,3616237
28844,44,124,1,11.64,366.87,3616236,3616280
28845,49,45,2,10.45,47.02,3616279,3616328
28846,64,26,1,8.00,28.72,3616327,3616391
28847,48,103,1,10.67,219.89,3616390,3616438
28848,42,43,0,12.19,86.49,3616437,3616479
28849,47,31,1,10.89,61.84,3616478,3616525
28850,54,28,1,9.48,36.51,3616524,3616578
28851,59,34,1,8.68,47.95,3616577,3616636
28852,47,35,1,10.89,52.14,3616635,3616682
28853,55,88,2,9.31,144.50,3616681,3616736
28854,36,54,1,14.22,169.01,3616735,3616771
28855,46,39,1,11.13,81.55,3616770,3616816
28856,50,47,0,10.24,65.66,3616816,3616866
28857,45,73,1,11.38,133.75,3616865,3616910
28858,53,61,1,9.66,79.17,3616909,3616962
28859,39,100,1,13.13,283.86,3616961,3617000
28860,47,44,2,10.89,93.63,3616999,3617046
28861,46,63,2,11.13,101.72,3617045,3617091
28862,47,35,1,10.89,63.33,3617090,3617137
28863,47,37,1,10.89,46.82,3617136,3617183
28864,47,67,2,10.89,96.95,3617182,3617229
28865,50,40,1,10.24,78.22,3617228,3617278
28866,51,71,1,10.04,127.92,3617277,3617328
28867,53,42,0,9.66,55.21,3617327,3617380
28868,49,51,1,10.45,66.12,3617380,3617429
28869,18,118,6,28.44,806.58,3617428,3617446
28870,26,160,3,19.69,847.29,3617445,3617471
28871,40,53,1,12.80,106.36,3617470,3617510
28872,53,34,1,9.66,62.22,3617509,3617562
28873,40,58,1,12.80,183.46,3617561,3617601
28874,38,47,1,13.47,165.09,3617600,3617638
28875,52,97,1,9.85,178.17,3617637,3617689
28876,29,176,3,17.66,945.61,3617688,3617717
28877,53,62,1,9.66,127.43,3617716,3617769
28878,38,88,2,13.47,311.04,3617768,3617806
28879,39,64,1,13.13,185.45,3617805,3617844
28880,67,30,1,7.64,42.29,3617843,3617910
28881,86,50,1,5.95,49.63,3617909,3617995
28882,40,123,0,12.80,386.31,3617994,3618034
28883,75,25,0,6.83,31.13,3618033,3618108
28884,43,124,1,11.91,429.11,3618108,3618151
28885,41,97,1,12.49,343.52,3618150,3618191
28886,79,50,1,6.48,50.00,3618191,3618270
28887,74,56,1,6.92,79.75,3618269,3618343
28888,59,44,1,8.68,57.27,3618342,3618401
28889,51,36,1,10.04,57.02,3618400,3618451
28890,28,191,1,18.29,1322.06,3618451,3618479
28891,60,47,0,8.53,80.75,3618478,3618538
28892,66,26,1,7.76,27.97,3618537,3618603
28893,36,77,2,14.22,288.51,3618602,3618638
28894,78,43,1,6.56,44.07,3618637,3618715
28895,63,49,1,8.13,76.94,3618714,3618777
28896,45,51,1,11.38,116.90,3618776,3618821
28897,22,308,2,23.27,3942.56,3618820,3618842
28898,71,42,0,7.21,45.12,3618841,3618912
28899,65,51,0,7.88,58.29,3618911,3618976
28900,38,119,1,13.47,374.57,3618975,3619013
28901,57,48,1,8.98,56.96,3619012,3619069
28902,74,47,1,6.92,52.78,3619068,3619142
28903,67,32,1,7.64,26.59,3619141,3619208
28904,37,169,1,13.84,738.62,3619207,3619244
28905,47,80,1,10.89,200.52,3619243,3619290
28906,31,208,2,16.52,1333.73,3619290,3619321
28907,40,129,2,12.80,386.16,3619320,3619360
28908,61,43,1,8.39,49.06,3619359,3619420
28909,50,57,1,10.24,96.30,3619419,3619469
28910,42,68,1,12.19,129.01,3619468,3619510
28911,44,53,1,11.64,105.32,3619510,3619554
28912,40,56,3,12.80,106.26,3619553,3619593
28913,46,128,1,11.13,354.85,3619593,3619639
28914,47,44,1,10.89,61.54,3619638,3619685
28915,47,36,1,10.89,43.46,3619684,3619731
28916,40,73,2,12.80,189.56,3619730,3619770
28917,39,94,1,13.13,253.03,3619769,3619808
28918,48,51,1,10.67,77.85,3619807,3619855
28919,43,87,1,11.91,177.85,3619854,3619897
28920,55,23,1,9.31,42.29,3619896,3619951
28921,58,39,1,8.83,54.07,3619950,3620008
28922,27,118,1,18.96,827.52,3620007,3620034
28923,32,78,2,16.00,259.12,3620033,3620065
28924,30,77,2,17.07,304.86,3620064,3620094
28925,54,30,1,9.48,51.25,3620093,3620147
28926,30,125,1,17.07,580.33,3620146,3620176
28927,26,138,1,19.69,1188.29,3620175,3620201
28928,29,224,2,17.66,1590.71,3620200,3620229
28929,46,67,1,11.13,141.07,3620228,3620274
28930,34,69,1,15.06,258.29,3620273,3620307
28931,44,72,1,11.64,353.91,3620307,3620351
28932,42,78,1,12.19,220.11,3620350,3620392
28933,40,79,2,12.80,207.31,3620391,3620431
28934,8,406,1,64.00,16945.75,3620430,3620438
28935,60,35,1,8.53,45.92,3620437,3620497
28936,85,41,0,6.02,62.09,3620496,3620581
28937,52,37,0,9.85,77.40,3620580,3620632
28938,55,51,0,9.31,94.32,3620631,3620686
28939,71,91,0,7.21,146.39,3620685,3620756
28940,35,83,0,14.63,424.46,3620755,3620790
28941,25,126,1,20.48,768.09,3620789,3620814
28942,59,64,0,8.68,129.40,3620813,3620872
28943,56,105,1,9.14,243.80,3620871,3620927
28944,76,27,1,6.74,32.72,3620926,3621002
28945,56,37,1,9.14,59.34,3621001,3621057
28946,55,33,1,9.31,51.81,3621057,3621112
28947,36,141,1,14.22,568.40,3621111,3621147
28948,56,31,1,9.14,40.48,3621147,3621203
28949,63,32,1,8.13,42.49,3621202,3621265
28950,42,60,1,12.19,157.68,3621264,3621306
28951,28,265,1,18.29,2354.92,3621305,3621333
28952,54,62,1,9.48,90.25,3621332,3621386
28953,33,182,0,15.52,912.86,3621385,3621418
28954,36,113,2,14.22,354.45,3621417,3621453
28955,53,39,2,9.66,60.49,3621453,3621506
28956,44,108,1,11.64,293.37,3621505,3621549
28957,41,123,2,12.49,346.84,3621549,3621590
28958,52,30,2,9.85,37.13,3621589,3621641
28959,53,40,1,9.66,52.11,3621640,3621693
28960,59,31,1,8.68,40.15,3621692,3621751
28961,35,58,1,14.63,183.43,3621750,3621785
28962,49,30,1,10.45,45.19,3621784,3621833
28963,26,114,4,19.69,533.06,3621832,3621858
28964,31,110,1,16.52,378.64,3621857,3621888
28965,52,42,1,9.85,60.82,3621887,3621939
28966,39,49,3,13.13,114.73,3621938,3621977
28967,29,89,2,17.66,383.33,3621976,3622005
28968,48,43,1,10.67,94.47,3622004,3622052
28969,33,69,0,15.52,261.95,3622051,3622084
28970,22,143,1,23.27,1363.29,3622083,3622105
28971,29,52,1,17.66,177.19,3622104,3622133
28972,39,58,0,13.13,169.39,3622132,3622171
28973,31,132,1,16.52,643.28,3622170,3622201
28974,51,48,1,10.04,99.17,3622200,3622251
28975,48,54,1,10.67,136.81,3622250,3622298
28976,56,36,0,9.14,58.05,3622297,3622353
28977,42,65,1,12.19,140.58,3622352,3622394
28978,49,116,1,10.45,317.35,3622393,3622442
28979,33,73,1,15.52,247.83,3622441,3622474
28980,39,81,1,13.13,291.86,3622473,3622512
28981,20,303,1,25.60,4142.54,3622511,3622531
28982,33,83,1,15.52,346.86,3622530,3622563
28983,53,106,1,9.66,252.79,3622562,3622615
28984,80,39,0,6.40,45.69,3622614,3622694
28985,67,34,1,7.64,35.01,3622693,3622760
28986,55,58,1,9.31,82.07,3622759,3622814
28987,35,109,1,14.63,354.23,3622813,3622848
28988,64,48,1,8.00,84.12,3622847,3622911
28989,32,102,1,16.00,514.00,3622910,3622942
28990,44,55,0,11.64,162.69,3622941,3622985
28991,75,61,1,6.83,67.42,3622984,3623059
28992,53,30,1,9.66,41.92,3623058,3623111
28993,58,55,1,8.83,91.49,3623110,3623168
28994,69,62,1,7.42,69.03,3623167,3623236
28995,48,58,1,10.67,130.85,3623235,3623283
28996,55,32,1,9.31,53.70,3623282,3623337
28997,74,54,1,6.92,49.78,3623336,3623410
28998,40,183,2,12.80,783.36,3623409,3623449
28999,54,54,1,9.48,108.36,3623448,3623502
29000,56,33,1,9.14,63.73,3623501,3623557
29001,49,110,1,10.45,272.45,3623557,3623606
29002,42,47,1,12.19,84.54,3623605,3623647
29003,44,43,2,11.64,89.00,3623646,3623690
29004,36,145,1,14.22,535.45,3623689,3623725
29005,45,57,1,11.38,122.01,3623724,3623769
29006,48,36,1,10.67,50.06,3623768,3623816
29007,34,100,3,15.06,313.23,3623815,3623849
29008,47,44,2,10.89,68.73,3623848,3623895
29009,35,86,3,14.63,307.32,3623894,3623929
29010,42,38,1,12.19,85.77,3623928,3623970
29011,50,28,2,10.24,48.46,3623970,3624020
29012,42,47,1,12.19,91.34,3624019,3624061
29013,58,27,1,8.83,51.66,3624060,3624118
29014,51,28,1,10.04,43.14,3624117,3624168
29015,36,124,1,14.22,445.51,3624167,3624203
29016,29,54,3,17.66,168.98,3624202,3624231
29017,55,35,1,9.31,44.14,3624230,3624285
29018,53,37,1,9.66,60.04,3624284,3624337
29019,41,72,1,12.49,200.10,3624336,3624377
29020,27,103,1,18.96,588.26,3624376,3624403
29021,44,81,1,11.64,224.23,3624402,3624446
29022,45,42,1,11.38,113.08,3624445,3624490
29023,58,77,1,8.83,159.35,3624489,3624547
29024,20,135,1,25.60,1499.74,3624546,3624566
29025,43,64,1,11.91,188.69,3624565,3624608
29026,45,45,1,11.38,144.68,3624607,3624652
29027,41,66,1,12.49,239.47,3624651,3624692
29028,71,42,1,7.21,43.12,3624691,3624762
29029,79,44,0,6.48,52.30,3624762,3624841
29030,77,34,0,6.65,30.18,3624840,3624917
29031,58,40,1,8.83,78.97,3624916,3624974
29032,83,42,0,6.17,53.44,3624973,3625056
29033,45,142,1,11.38,442.55,3625055,3625100
29034,68,36,1,7.53,55.51,3625099,3625167
29035,59,40,1,8.68,46.79,3625166,3625225
29036,46,126,2,11.13,330.07,3625225,3625271
29037,61,51,1,8.39,85.19,3625270,3625331
29038,47,107,1,10.89,243.67,3625330,3625377
29039,60,40,1,8.53,50.35,3625377,3625437
29040,67,40,1,7.64,47.01,3625436,3625503
29041,44,110,1,11.64,301.60,3625502,3625546
29042,48,55,1,10.67,108.72,3625545,3625593
29043,45,43,1,11.38,110.10,3625592,3625637
29044,46,54,1,11.13,134.50,3625636,3625682
29045,57,42,0,8.98,50.58,3625681,3625738
29046,37,77,3,13.84,205.33,3625737,3625774
29047,50,56,1,10.24,88.10,3625773,3625823
29048,49,45,1,10.45,86.86,3625822,3625871
29049,48,58,1,10.67,118.39,3625870,3625918
29050,48,47,1,10.67,77.81,3625917,3625965
29051,41,48,1,12.49,89.37,3625964,3626005
29052,50,50,0,10.24,63.86,3626004,3626054
29053,39,65,1,13.13,143.29,3626053,3626092
29054,54,44,2,9.48,54.69,3626091,3626145
29055,43,46,1,11.91,92.92,3626144,3626187
29056,48,41,2,10.67,72.10,3626186,3626234
29057,30,113,2,17.07,382.40,3626233,3626263
29058,25,77,3,20.48,414.57,3626262,3626287
29059,23,105,1,22.26,618.63,3626286,3626309
29060,34,48,1,15.06,133.06,3626309,3626343
29061,8,413,2,64.00,17601.00,3626342,3626350
29062,27,213,1,18.96,1515.96,3626349,3626376
29063,55,55,1,9.31,105.23,3626375,3626430
29064,40,70,1,12.80,203.86,3626429,3626469
29065,36,65,1,14.22,228.73,3626468,3626504
29066,40,46,1,12.80,161.01,3626503,3626543
29067,27,134,1,18.96,623.81,3626542,3626569
29068,56,66,1,9.14,104.87,3626568,3626624
29069,52,66,1,9.85,122.71,3626623,3626675
29070,36,179,1,14.22,852.56,3626674,3626710
29071,67,59,1,7.64,74.35,3626709,3626776
29072,74,39,1,6.92,63.40,3626775,3626849
29073,1,512,512,512.00,0.00,3626848,3626849
29074,40,186,1,12.80,863.66,3626848,3626888
29075,37,75,2,13.84,246.46,3626887,3626924
29076,63,41,1,8.13,56.08,3626923,3626986
29077,56,45,1,9.14,104.69,3626985,3627041
29078,68,45,1,7.53,86.28,3627040,3627108
29079,70,87,0,7.31,146.90,3627107,3627177
29080,70,33,1,7.31,41.07,3627176,3627246
29081,57,39,1,8.98,63.70,3627245,3627302
29082,62,30,1,8.26,50.32,3627301,3627363
29083,65,36,1,7.88,46.57,3627362,3627427
29084,38,77,1,13.47,305.72,3627426,3627464
29085,71,27,1,7.21,33.97,3627463,3627534
29086,61,63,2,8.39,111.91,3627533,3627594
29087,52,126,1,9.85,302.63,3627593,3627645
29088,46,43,2,11.13,82.81,3627644,3627690
29089,58,29,1,8.83,29.94,3627689,3627747
29090,48,38,1,10.67,61.31,3627746,3627794
29091,53,30,2,9.66,43.17,3627793,3627846
29092,51,51,1,10.04,78.70,3627845,3627896
29093,53,56,1,9.66,111.96,3627895,3627948
29094,50,32,1,10.24,56.22,3627947,3627997
29095,38,80,1,13.47,226.46,3627996,3628034
29096,43,55,1,11.91,115.11,3628033,3628076
29097,33,168,1,15.52,785.10,3628075,3628108
29098,58,26,1,8.83,45.69,3628107,3628165
29099,42,52,1,12.19,120.49,3628164,3628206
29100,50,33,1,10.24,51.90,3628205,3628255
29101,46,31,2,11.13,54.24,3628254,3628300
29102,53,42,1,9.66,70.19,3628299,3628352
29103,38,68,2,13.47,149.14,3628351,3628389
29104,51,38,1,10.04,53.92,3628388,3628439
29105,63,25,1,8.13,32.40,3628439,3628502
29106,37,45,1,13.84,115.92,3628501,3628538
29107,34,63,1,15.06,284.64,3628537,3628571
29108,28,118,2,18.29,452.92,3628570,3628598
29109,40,110,1,12.80,308.11,3628597,3628637
29110,37,80,1,13.84,288.24,3628636,3628673
29111,54,61,0,9.48,101.88,3628672,3628726
29112,39,70,1,13.13,157.50,3628725,3628764
29113,49,38,2,10.45,64.45,3628763,3628812
29114,45,34,1,11.38,80.15,3628812,3628857
29115,46,59,1,11.13,117.68,3628856,3628902
29116,61,50,0,8.39,93.55,3628901,3628962
29117,56,37,1,9.14,63.66,3628961,3629017
29118,42,48,1,12.19,108.01,3629016,3629058
29119,43,76,1,11.91,208.78,3629057,3629100
29120,37,197,1,13.84,1083.60,3629099,3629136
29121,15,426,1,34.13,10995.05,3629135,3629150
29122,58,31,0,8.83,72.07,3629149,3629207
29123,73,83,0,7.01,121.03,3629206,3629279
29124,56,70,1,9.14,121.19,3629278,3629334
29125,56,43,1,9.14,49.05,3629333,3629389
29126,55,37,1,9.31,64.32,3629388,3629443
29127,75,30,0,6.83,43.42,3629442,3629517
29128,45,160,0,11.38,624.41,3629516,3629561
29129,49,38,0,10.45,92.33,3629560,3629609
29130,53,49,1,9.66,84.30,3629609,3629662
29131,74,59,1,6.92,84.97,3629661,3629735
29132,72,69,1,7.11,107.13,3629734,3629806
29133,51,47,0,10.04,87.65,3629805,3629856
29134,55,53,1,9.31,105.30,3629856,3629911
29135,50,55,1,10.24,120.54,3629911,3629961
29136,52,72,1,9.85,138.90,3629960,3630012
29137,64,41,1,8.00,52.19,3630011,3630075
29138,60,39,1,8.53,44.52,3630074,3630134
29139,74,27,1,6.92,22.26,3630133,3630207
29140,61,65,0,8.39,92.73,3630206,3630267
29141,41,107,1,12.49,360.40,3630266,3630307
29142,41,105,0,12.49,281.96,3630306,3630347
29143,50,64,1,10.24,119.22,3630346,3630396
29144,53,35,2,9.66,52.04,3630395,3630448
29145,54,65,1,9.48,100.66,3630447,3630501
29146,51,56,1,10.04,86.86,3630500,3630551
29147,55,48,1,9.31,66.10,3630550,3630605
29148,49,39,2,10.45,74.94,3630604,3630653
29149,40,50,2,12.80,85.31,3630652,3630692
29150,42,85,1,12.19,186.44,3630692,3630734
29151,48,45,1,10.67,79.97,3630733,3630781
29152,48,39,1,10.67,71.18,3630780,3630828
29153,31,73,3,16.52,184.77,3630827,3630858
29154,51,39,1,10.04,49.17,3630857,3630908
29155,40,51,1,12.80,139.86,3630907,3630947
29156,29,64,2,17.66,198.92,3630946,3630975
29157,55,54,1,9.31,69.81,3630975,3631030
29158,42,76,1,12.19,203.77,3631029,3631071
29159,43,38,2,11.91,72.60,3631070,3631113
29160,40,47,1,12.80,152.26,3631112,3631152
29161,46,30,3,11.13,39.77,3631151,3631197
29162,64,27,1,8.00,33.56,3631196,3631260
29163,56,30,1,9.14,32.37,3631259,3631315
29164,41,51,1,12.49,122.30,3631314,3631355
29165,21,119,1,24.38,779.19,3631354,3631375
29166,25,77,1,20.48,404.49,3631374,3631399
29167,30,61,0,17.07,290.20,3631398,3631428
29168,31,102,1,16.52,356.19,3631427,3631458
29169,41,58,1,12.49,153.81,3631457,3631498
29170,42,32,2,12.19,60.25,3631497,3631539
29171,48,31,0,10.67,67.22,3631538,3631586
29172,33,61,1,15.52,272.55,3631586,3631619
29173,91,19,0,5.63,16.61,3631618,3631709
29174,46,72,1,11.13,161.50,3631709,3631755
29175,58,91,1,8.83,179.42,3631754,3631812
29176,79,39,1,6.48,52.55,3631811,3631890
29177,37,109,1,13.84,324.19,3631889,3631926
29178,64,28,1,8.00,39.56,3631925,3631989
29179,55,59,1,9.31,75.96,3631988,3632043
29180,22,170,1,23.27,1418.74,3632042,3632064
29181,67,28,1,7.64,30.41,3632063,3632130
29182,42,82,1,12.19,169.11,3632129,3632171
29183,51,90,1,10.04,182.86,3632170,3632221
29184,37,194,1,13.84,960.57,3632220,3632257
29185,71,35,1,7.21,34.84,3632256,3632327
29186,62,33,1,8.26,41.42,3632326,3632388
29187,61,60,1,8.39,93.22,3632387,3632448
29188,30,246,1,17.07,1855.13,3632447,3632477
29189,63,30,1,8.13,42.84,3632476,3632539
29190,41,95,1,12.49,276.01,3632538,3632579
29191,48,112,1,10.67,279.01,3632578,3632626
29192,31,88,2,16.52,356.96,3632625,3632656
29193,51,88,1,10.04,154.94,3632655,3632706
29194,54,35,1,9.48,50.14,3632705,3632759
29195,61,40,1,8.39,57.91,3632758,3632819
29196,28,180,1,18.29,1260.99,3632818,3632846
29197,50,28,1,10.24,50.38,3632845,3632895
29198,42,44,1,12.19,114.20,3632894,3632936
29199,49,48,1,10.45,77.31,3632935,3632984
29200,60,57,1,8.53,60.35,3632983,3633043
29201,46,46,2,11.13,70.03,3633042,3633088
29202,57,38,1,8.98,49.60,3633088,3633145
29203,35,147,1,14.63,595.49,3633144,3633179
29204,40,78,1,12.80,201.01,3633178,3633218
29205,39,107,1,13.13,332.21,3633217,3633256
29206,27,152,3,18.96,785.07,3633255,3633282
29207,39,78,1,13.13,236.52,3633281,3633320
29208,46,43,2,11.13,90.37,3633319,3633365
29209,36,59,2,14.22,172.17,3633364,3633400
29210,51,36,1,10.04,49.37,3633399,3633450
29211,40,96,1,12.80,248.16,3633449,3633489
29212,50,49,1,10.24,95.82,3633488,3633538
29213,49,36,0,10.45,74.74,3633538,3633587
29214,23,128,3,22.26,794.11,3633586,3633609
29215,27,178,1,18.96,1217.89,3633608,3633635
29216,46,75,1,11.13,159.68,3633634,3633680
29217,36,73,1,14.22,295.62,3633679,3633715
29218,31,88,2,16.52,380.44,3633714,3633745
29219,53,36,1,9.66,55.96,3633744,3633797
29220,56,50,0,9.14,93.44,3633796,3633852
29221,38,89,1,13.47,253.93,3633851,3633889
29222,63,26,1,8.13,35.25,3633888,3633951
29223,49,67,0,10.45,143.23,3633950,3633999
29224,61,31,1,8.39,59.39,3633998,3634059
29225,51,55,1,10.04,107.92,3634058,3634109
29226,42,44,1,12.19,155.77,3634108,3634150
29227,44,152,1,11.64,646.46,3634149,3634193
29228,43,59,1,11.91,170.50,3634192,3634235
29229,58,73,1,8.83,153.69,3634234,3634292
29230,64,22,1,8.00,27.75,3634291,3634355
29231,57,61,1,8.98,125.14,3634354,3634411
29232,51,41,0,10.04,103.49,3634410,3634461
29233,62,44,1,8.26,49.06,3634460,3634522
29234,43,137,2,11.91,425.76,3634521,3634564
29235,42,67,1,12.19,188.34,3634563,3634605
29236,56,51,1,9.14,71.66,3634605,3634661
29237,49,63,0,10.45,126.29,3634660,3634709
29238,68,55,1,7.53,60.28,3634708,3634776
29239,55,114,1,9.31,233.16,3634775,3634830
29240,43,55,1,11.91,136.69,3634829,3634872
29241,46,49,2,11.13,87.59,3634871,3634917
29242,56,58,1,9.14,79.44,3634916,3634972
29243,40,61,1,12.80,166.16,3634971,3635011
29244,45,48,1,11.38,127.61,3635010,3635055
29245,55,39,2,9.31,48.50,3635054,3635109
29246,49,49,1,10.45,88.33,3635108,3635157
29247,47,32,0,10.89,64.35,3635156,3635203
29248,38,91,1,13.47,255.04,3635202,3635240
29249,34,180,2,15.06,929.82,3635239,3635273
29250,42,46,1,12.19,91.39,3635273,3635315
29251,46,44,2,11.13,79.90,3635314,3635360
29252,31,87,1,16.52,387.28,3635359,3635390
29253,30,145,1,17.07,764.40,3635389,3635419
29254,38,91,1,13.47,255.30,3635418,3635456
29255,58,41,1,8.83,46.28,3635455,3635513
29256,36,57,3,14.22,153.01,3635512,3635548
29257,34,108,1,15.06,368.76,3635547,3635581
29258,50,40,1,10.24,57.62,3635580,3635630
29259,44,37,2,11.64,73.37,3635629,3635673
29260,1,512,512,512.00,0.00,3635672,3635673
29261,40,65,3,12.80,147.91,3635672,3635712
29262,51,39,1,10.04,67.21,3635711,3635762
29263,49,39,1,10.45,68.66,3635761,3635810
29264,45,110,1,11.38,267.88,3635809,3635854
29265,40,92,2,12.80,311.61,3635853,3635893
29266,38,69,2,13.47,182.46,3635892,3635930
29267,41,43,1,12.49,114.25,3635929,3635970
29268,17,168,2,30.12,1779.99,3635970,3635987
29269,29,68,1,17.66,248.02,3635986,3636015
29270,29,120,2,17.66,540.71,3636014,3636043
29271,41,53,1,12.49,122.64,3636042,3636083
29272,43,59,1,11.91,134.41,3636083,3636126
29273,53,28,1,9.66,42.53,3636125,3636178
29274,44,35,0,11.64,76.73,3636177,3636221
29275,51,99,1,10.04,202.16,3636220,3636271
29276,57,56,1,8.98,99.07,3636270,3636327
29277,46,48,1,11.13,91.29,3636326,3636372
29278,36,118,1,14.22,435.56,3636371,3636407
29279,36,118,1,14.22,470.56,3636406,3636442
29280,73,34,1,7.01,55.41,3636441,3636514
29281,71,38,1,7.21,58.39,3636513,3636584
29282,67,36,1,7.64,54.86,3636583,3636650
29283,44,141,1,11.64,453.78,3636649,3636693
29284,67,33,1,7.64,51.45,3636693,3636760
29285,67,48,1,7.64,73.78,3636759,3636826
29286,61,107,1,8.39,245.39,3636825,3636886
29287,45,122,1,11.38,321.75,3636885,3636930
29288,49,51,1,10.45,85.88,3636929,3636978
29289,46,48,1,11.13,146.55,3636977,3637023
29290,44,62,1,11.64,133.87,3637022,3637066
29291,30,119,0,17.07,743.93,3637065,3637095
29292,72,59,1,7.11,61.96,3637094,3637166
29293,30,106,1,17.07,505.33,3637165,3637195
29294,54,57,1,9.48,66.47,3637194,3637248
29295,62,29,1,8.26,35.87,3637247,3637309
29296,65,39,1,7.88,46.60,3637309,3637374
29297,43,70,1,11.91,188.64,3637374,3637417
29298,57,42,1,8.98,88.44,3637416,3637473
29299,54,76,1,9.48,147.21,3637472,3637526
29300,65,73,0,7.88,102.45,3637526,3637591
29301,50,38,2,10.24,86.66,3637591,3637641
29302,52,85,0,9.85,156.28,3637640,3637692
29303,44,77,1,11.64,160.37,3637691,3637735
29304,16,244,4,32.00,4073.12,3637734,3637750
29305,33,80,2,15.52,295.70,3637749,3637782
29306,50,65,1,10.24,110.70,3637781,3637831
29307,58,68,2,8.83,78.18,3637830,3637888
29308,30,129,2,17.07,566.20,3637887,3637917
29309,39,62,1,13.13,152.16,3637916,3637955
29310,49,33,1,10.45,69.06,3637955,3638004
29311,39,69,2,13.13,156.78,3638003,3638042
29312,55,50,1,9.31,85.67,3638041,3638096
29313,41,56,2,12.49,140.15,3638095,3638136
29314,54,30,1,9.48,44.95,3638135,3638189
29315,31,120,1,16.52,561.60,3638188,3638219
29316,27,93,2,18.96,579.44,3638218,3638245
29317,44,69,1,11.64,174.78,3638244,3638288
29318,41,45,3,12.49,90.10,3638287,3638328
29319,48,45,1,10.67,73.06,3638327,3638375
29320,38,60,1,13.47,129.57,3638374,3638412
29321,46,45,2,11.13,81.77,3638411,3638457
29322,43,79,2,11.91,156.78,3638456,3638499
29323,45,62,2,11.38,130.46,3638498,3638543
29324,47,26,1,10.89,44.10,3638542,3638589
29325,58,27,1,8.83,34.00,3638589,3638647
29326,47,154,1,10.89,484.61,3638646,3638693
29327,29,118,1,17.66,539.47,3638692,3638721
29328,21,72,3,24.38,214.24,3638720,3638741
29329,23,56,3,22.26,292.63,3638740,3638763
29330,27,69,2,18.96,341.67,3638762,3638789
29331,25,83,2,20.48,474.57,3638788,3638813
29332,46,48,1,11.13,81.94,3638812,3638858
29333,45,80,1,11.38,180.46,3638857,3638902
29334,46,30,1,11.13,54.68,3638901,3638947
29335,31,83,1,16.52,375.28,3638946,3638977
29336,49,56,1,10.45,103.15,3638976,3639025
29337,32,50,2,16.00,144.81,3639024,3639056
29338,65,35,0,7.88,63.03,3639055,3639120
29339,39,122,2,13.13,445.60,3639120,3639159
29340,32,117,1,16.00,534.75,3639158,3639190
29341,47,32,1,10.89,57.58,3639189,3639236
29342,83,45,0,6.17,54.00,3639235,3639318
29343,40,173,1,12.80,757.66,3639317,3639357
29344,52,66,1,9.85,134.40,3639356,3639408
29345,49,32,1,10.45,72.49,3639407,3639456
29346,62,75,0,8.26,139.45,3639455,3639517
29347,33,90,1,15.52,311.16,3639516,3639549
29348,75,34,1,6.83,45.58,3639548,3639623
29349,60,54,1,8.53,91.88,3639623,3639683
29350,46,58,1,11.13,127.46,3639683,3639729
29351,68,74,1,7.53,99.22,3639728,3639796
29352,80,41,0,6.40,38.64,3639795,3639875
29353,69,63,0,7.42,81.72,3639875,3639944
29354,49,76,1,10.45,151.80,3639943,3639992
29355,57,26,1,8.98,34.51,3639992,3640049
29356,51,92,1,10.04,180.86,3640048,3640099
29357,51,65,1,10.04,136.39,3640098,3640149
29358,47,66,1,10.89,147.37,3640148,3640195
29359,40,89,1,12.80,298.01,3640194,3640234
29360,61,55,1,8.39,79.12,3640233,3640294
29361,61,51,0,8.39,75.03,3640293,3640354
29362,44,37,1,11.64,69.32,3640353,3640397
29363,48,35,1,10.67,60.81,3640396,3640444
29364,28,235,1,18.29,1874.63,3640443,3640471
29365,45,44,1,11.38,90.86,3640470,3640515
29366,43,57,1,11.91,117.76,3640514,3640557
29367,55,32,1,9.31,42.50,3640556,3640611
29368,30,175,0,17.07,921.60,3640611,3640641
29369,49,32,2,10.45,54.21,3640640,3640689
29370,34,118,2,15.06,376.00,3640688,3640722
29371,42,39,2,12.19,58.82,3640721,3640763
29372,42,53,2,12.19,99.49,3640762,3640804
29373,37,46,1,13.84,151.38,3640803,3640840
29374,34,62,1,15.06,200.41,3640839,3640873
29375,53,43,1,9.66,64.87,3640872,3640925
29376,44,47,1,11.64,126.87,3640924,3640968
29377,36,58,1,14.22,133.28,3640967,3641003
29378,48,38,1,10.67,70.51,3641002,3641050
29379,51,50,1,10.04,71.21,3641049,3641100
29380,42,65,1,12.19,137.82,3641099,3641141
29381,47,57,2,10.89,89.20,3641140,3641187
29382,50,36,1,10.24,48.86,3641186,3641236
29383,53,39,1,9.66,79.77,3641235,3641288
29384,44,66,1,11.64,150.55,3641287,3641331
29385,19,174,3,26.95,1800.05,3641330,3641349
29386,27,109,1,18.96,434.33,3641348,3641375
29387,16,210,2,32.00,2284.38,3641374,3641390
29388,28,56,2,18.29,234.28,3641389,3641417
29389,33,83,1,15.52,252.31,3641416,3641449
29390,47,70,1,10.89,186.61,3641448,3641495
29391,34,87,1,15.06,331.53,3641494,3641528
29392,43,56,1,11.91,158.74,3641527,3641570
29393,48,32,1,10.67,77.68,3641569,3641617
29394,34,75,1,15.06,349.00,3641617,3641651
29395,32,73,1,16.00,371.50,3641650,3641682
29396,52,63,0,9.85,107.59,3641681,3641733
29397,79,37,0,6.48,45.54,3641732,3641811
29398,69,44,1,7.42,47.61,3641811,3641880
29399,35,98,0,14.63,296.63,3641880,3641915
29400,56,56,1,9.14,109.69,3641914,3641970
29401,44,92,1,11.64,299.64,3641969,3642013
29402,94,38,0,5.45,42.57,3642012,3642106
29403,33,184,2,15.52,939.52,3642106,3642139
29404,59,33,1,8.68,44.56,3642138,3642197
29405,46,46,1,11.13,106.64,3642196,3642242
29406,48,58,1,10.67,118.31,3642241,3642289
29407,65,25,1,7.88,26.23,3642288,3642353
29408,50,60,1,10.24,131.70,3642352,3642402
29409,59,25,1,8.68,34.79,3642401,3642460
29410,45,47,1,11.38,78.68,3642459,3642504
29411,29,89,1,17.66,494.43,3642503,3642532
29412,45,155,1,11.38,514.55,3642531,3642576
29413,57,31,1,8.98,44.33,3642576,3642633
29414,44,136,1,11.64,393.05,3642633,3642677
29415,41,99,2,12.49,299.52,3642676,3642717
29416,51,46,1,10.04,97.61,3642717,3642768
29417,55,26,1,9.31,29.78,3642767,3642822
29418,40,60,1,12.80,127.26,3642822,3642862
29419,45,72,2,11.38,126.95,3642861,3642906
29420,47,46,2,10.89,88.69,3642905,3642952
29421,46,29,2,11.13,53.81,3642951,3642997
29422,51,64,1,10.04,97.53,3642996,3643047
29423,50,27,1,10.24,34.94,3643046,3643096
29424,44,71,1,11.64,139.60,3643096,3643140
29425,53,33,2,9.66,46.90,3643139,3643192
29426,53,40,2,9.66,50.41,3643191,3643244
29427,47,50,2,10.89,76.14,3643243,3643290
29428,48,43,1,10.67,67.18,3643289,3643337
29429,53,41,2,9.66,56.34,3643336,3643389
29430,39,102,2,13.13,301.91,3643388,3643427
29431,51,40,0,10.04,51.84,3643427,3643478
29432,41,72,1,12.49,146.40,3643478,3643519
29433,60,40,1,8.53,55.65,3643518,3643578
29434,30,114,1,17.07,421.33,3643577,3643607
29435,26,92,2,19.69,373.21,3643606,3643632
29436,24,70,4,21.33,306.39,3643631,3643655
29437,28,123,2,18.29,632.56,3643654,3643682
29438,33,101,1,15.52,350.01,3643681,3643714
29439,51,44,1,10.04,91.37,3643713,3643764
29440,56,34,2,9.14,46.69,3643763,3643819
29441,30,164,1,17.07,835.06,3643818,3643848
29442,46,54,1,11.13,153.42,3643847,3643893
29443,30,86,1,17.07,288.60,3643893,3643923
29444,44,75,1,11.64,219.32,3643922,3643966
29445,22,292,1,23.27,3859.02,3643965,3643987
29446,62,66,1,8.26,88.19,3643986,3644048
29447,49,33,1,10.45,70.04,3644047,3644096
29448,61,41,1,8.39,71.32,3644095,3644156
29449,49,61,1,10.45,128.37,3644155,3644204
29450,48,114,0,10.67,336.81,3644203,3644251
29451,76,46,1,6.74,53.14,3644250,3644326
29452,46,143,1,11.13,529.29,3644325,3644371
29453,51,40,1,10.04,48.59,3644370,3644421
29454,61,37,1,8.39,50.66,3644420,3644481
29455,54,62,1,9.48,87.99,3644481,3644535
29456,64,31,1,8.00,45.91,3644534,3644598
29457,66,37,1,7.76,36.00,3644597,3644663
29458,46,88,1,11.13,174.64,3644662,3644708
29459,47,43,1,10.89,93.24,3644707,3644754
29460,35,233,1,14.63,1445.66,3644754,3644789
29461,49,121,1,10.45,323.76,3644788,3644837
29462,44,74,1,11.64,241.69,3644836,3644880
29463,56,61,1,9.14,124.66,3644879,3644935
29464,38,46,2,13.47,151.46,3644934,3644972
29465,57,29,1,8.98,54.44,3644971,3645028
29466,57,37,1,8.98,51.03,3645027,3645084
29467,62,26,1,8.26,30.16,3645083,3645145
29468,51,49,1,10.04,82.98,3645144,3645195
29469,61,30,1,8.39,28.11,3645194,3645255
29470,41,58,1,12.49,126.30,3645254,3645295
29471,61,25,1,8.39,34.27,3645294,3645355
29472,53,68,1,9.66,102.49,3645354,3645407
29473,53,37,1,9.66,58.94,3645406,3645459
29474,48,36,1,10.67,66.10,3645458,3645506
29475,40,42,2,12.80,100.71,3645505,3645545
29476,39,67,1,13.13,142.98,3645544,3645583
29477,44,35,1,11.64,73.14,3645582,3645626
29478,23,190,2,22.26,1589.24,3645625,3645648
29479,40,35,2,12.80,54.71,3645647,3645687
29480,42,64,1,12.19,144.82,3645686,3645728
29481,47,46,2,10.89,88.69,3645727,3645774
29482,38,149,2,13.47,534.20,3645774,3645812
29483,56,30,1,9.14,38.12,3645811,3645867
29484,35,141,1,14.63,544.12,3645866,3645901
29485,55,42,1,9.31,82.50,3645900,3645955
29486,41,41,1,12.49,84.25,3645954,3645995
29487,39,88,2,13.13,261.03,3645994,3646033
29488,27,97,1,18.96,413.22,3646032,3646059
29489,32,84,2,16.00,298.56,3646058,3646090
29490,26,110,1,19.69,550.75,3646089,3646115
29491,38,64,1,13.47,130.25,3646114,3646152
29492,37,87,1,13.84,357.11,3646151,3646188
29493,36,73,3,14.22,169.28,3646187,3646223
29494,40,121,1,12.80,339.66,3646222,3646262
29495,49,30,2,10.45,54.45,3646261,3646310
29496,41,87,2,12.49,189.66,3646309,3646350
29497,50,138,1,10.24,412.90,3646350,3646400
29498,42,78,1,12.19,203.25,3646399,3646441
29499,40,90,1,12.80,374.36,3646440,3646480
29500,53,56,1,9.66,140.87,3646479,3646532
29501,80,59,1,6.40,54.36,3646531,3646611
29502,26,281,1,19.69,3769.98,3646610,3646636
29503,33,203,3,15.52,1145.58,3646635,3646668
29504,43,131,1,11.91,413.76,3646667,3646710
29505,63,47,1,8.13,77.16,3646709,3646772
29506,57,49,0,8.98,104.75,3646771,3646828
29507,48,51,0,10.67,170.76,3646827,3646875
29508,59,60,1,8.68,143.61,3646874,3646933
29509,62,34,1,8.26,40.16,3646932,3646994
29510,45,46,2,11.38,85.48,3646993,3647038
29511,70,44,1,7.31,46.39,3647037,3647107
29512,65,40,1,7.88,43.68,3647106,3647171
29513,64,43,1,8.00,63.25,3647170,3647234
29514,61,54,1,8.39,53.42,3647233,3647294
29515,49,52,1,10.45,102.37,3647293,3647342
29516,51,76,1,10.04,125.45,3647341,3647392
29517,62,58,0,8.26,94.93,3647391,3647453
29518,53,60,1,9.66,88.79,3647452,3647505
29519,53,66,2,9.66,92.79,3647504,3647557
29520,42,213,1,12.19,1011.15,3647556,3647598
29521,78,26,1,6.56,31.89,3647598,3647676
29522,32,163,1,16.00,781.31,3647675,3647707
29523,57,33,0,8.98,43.88,3647706,3647763
29524,38,119,1,13.47,338.20,3647763,3647801
29525,28,204,2,18.29,1324.63,3647800,3647828
29526,60,61,1,8.53,95.28,3647827,3647887
29527,38,77,1,13.47,166.78,3647886,3647924
29528,49,62,2,10.45,88.78,3647923,3647972
29529,44,55,1,11.64,94.32,3647971,3648015
29530,38,55,1,13.47,176.20,3648014,3648052
29531,41,68,3,12.49,114.59,3648051,3648092
29532,44,42,1,11.64,99.55,3648091,3648135
29533,49,35,2,10.45,63.15,3648134,3648183
29534,57,29,1,8.98,38.79,3648182,3648239
29535,51,41,1,10.04,74.59,3648238,3648289
29536,26,98,2,19.69,548.75,3648288,3648314
29537,50,28,1,10.24,43.74,3648313,3648363
29538,56,41,1,9.14,46.66,3648362,3648418
29539,51,37,1,10.04,68.23,3648417,3648468
29540,48,45,2,10.67,73.43,3648468,3648516
29541,37,141,2,13.84,508.03,3648515,3648552
29542,33,163,1,15.52,775.46,3648551,3648584
29543,41,87,2,12.49,196.69,3648583,3648624
29544,38,67,3,13.47,156.09,3648624,3648662
29545,48,102,1,10.67,245.76,3648662,3648710
29546,59,31,1,8.68,41.91,3648709,3648768
29547,46,43,2,11.13,83.11,3648767,3648813
29548,44,57,1,11.64,119.19,3648812,3648856
29549,7,262,7,73.14,7066.12,3648855,3648862
29550,25,125,1,20.48,750.41,3648861,3648886
29551,24,104,1,21.33,502.47,3648885,3648909
29552,51,38,1,10.04,55.10,3648909,3648960
29553,48,37,1,10.67,91.01,3648959,3649007
29554,30,83,1,17.07,419.33,3649006,3649036
29555,45,42,1,11.38,69.66,3649035,3649080
29556,39,185,1,13.13,830.98,3649079,3649118
29557,38,69,1,13.47,209.41,3649117,3649155
29558,37,138,1,13.84,536.68,3649154,3649191
29559,39,103,1,13.13,382.98,3649191,3649230
29560,12,245,1,42.67,4358.39,3649229,3649241
29561,46,38,1,11.13,82.20,3649240,3649286
29562,44,103,1,11.64,291.96,3649285,3649329
29563,54,76,1,9.48,189.36,3649328,3649382
29564,52,205,0,9.85,798.44,3649381,3649433
29565,43,84,2,11.91,235.57,3649432,3649475
29566,64,33,1,8.00,39.53,3649475,3649539
29567,57,41,1,8.98,95.60,3649538,3649595
29568,64,36,0,8.00,58.94,3649594,3649658
29569,61,52,1,8.39,83.35,3649657,3649718
29570,75,63,1,6.83,89.72,3649717,3649792
29571,60,31,1,8.53,37.48,3649792,3649852
29572,35,112,2,14.63,417.43,3649851,3649886
29573,58,48,1,8.83,92.76,3649885,3649943
29574,66,47,1,7.76,48.97,3649942,3650008
29575,74,39,1,6.92,36.51,3650007,3650081
29576,39,61,1,13.13,243.96,3650081,3650120
29577,53,112,1,9.66,255.70,3650119,3650172
29578,48,56,1,10.67,93.22,3650172,3650220
29579,72,45,1,7.11,44.93,3650219,3650291
29580,52,43,1,9.85,95.75,3650290,3650342
29581,61,41,1,8.39,41.03,3650341,3650402
29582,65,27,1,7.88,40.14,3650401,3650466
29583,59,73,1,8.68,112.59,3650465,3650524
29584,40,183,1,12.80,795.96,3650523,3650563
29585,37,88,1,13.84,294.73,3650562,3650599
29586,42,58,1,12.19,163.39,3650598,3650640
29587,47,77,1,10.89,138.05,3650639,3650686
29588,38,202,1,13.47,1008.83,3650685,3650723
29589,59,39,1,8.68,55.27,3650722,3650781
29590,49,35,2,10.45,56.98,3650780,3650829
29591,28,103,2,18.29,467.70,3650828,3650856
29592,40,36,2,12.80,86.41,3650855,3650895
29593,40,53,2,12.80,126.56,3650894,3650934
29594,24,71,4,21.33,339.22,3650933,3650957
29595,50,42,1,10.24,52.86,3650956,3651006
29596,54,26,1,9.48,40.73,3651005,3651059
29597,60,23,2,8.53,26.78,3651058,3651118
29598,34,123,1,15.06,498.82,3651117,3651151
29599,46,43,1,11.13,94.90,3651150,3651196
29600,38,86,1,13.47,253.30,3651196,3651234
29601,43,78,1,11.91,181.67,3651233,3651276
29602,44,55,1,11.64,92.28,3651275,3651319
29603,36,75,2,14.22,228.45,3651318,3651354
29604,38,127,1,13.47,381.88,3651353,3651391
29605,46,62,1,11.13,105.24,3651390,3651436
29606,50,37,1,10.24,67.54,3651435,3651485
29607,58,31,1,8.83,42.63,3651484,3651542
29608,53,24,2,9.66,24.83,3651541,3651594
29609,36,98,2,14.22,399.78,3651593,3651629
29610,59,36,1,8.68,40.76,3651628,3651687
29611,36,62,2,14.22,240.06,3651686,3651722
29612,16,102,3,32.00,844.88,3651721,3651737
29613,38,56,2,13.47,145.04,3651736,3651774
29614,38,51,1,13.47,188.30,3651773,3651811
29615,53,43,1,9.66,74.49,3651810,3651863
29616,40,96,1,12.80,270.51,3651862,3651902
29617,48,59,1,10.67,116.76,3651901,3651949
29618,14,161,3,36.57,2064.96,3651948,3651962
29619,47,49,1,10.89,115.88,3651961,3652008
29620,65,43,0,7.88,57.62,3652007,3652072
29621,47,37,1,10.89,74.99,3652071,3652118
29622,30,110,0,17.07,623.06,3652117,3652147
29623,18,189,1,28.44,2733.47,3652146,3652164
29624,54,70,1,9.48,155.73,3652163,3652217
29625,84,27,0,6.10,34.59,3652217,3652301
29626,62,33,1,8.26,44.77,3652300,3652362
29627,34,81,0,15.06,287.29,3652361,3652395
29628,63,24,1,8.13,40.56,3652394,3652457
29629,33,164,1,15.52,1000.73,3652456,3652489
29630,45,98,1,11.38,280.64,3652488,3652533
29631,54,52,1,9.48,122.95,3652532,3652586
29632,67,46,1,7.64,56.38,3652585,3652652
29633,41,68,2,12.49,170.64,3652651,3652692
29634,67,50,1,7.64,65.63,3652691,3652758
29635,46,60,1,11.13,147.98,3652757,3652803
29636,46,72,1,11.13,173.20,3652802,3652848
29637,68,26,1,7.53,31.75,3652847,3652915
29638,57,38,1,8.98,64.26,3652914,3652971
29639,48,73,1,10.67,137.51,3652970,3653018
29640,63,27,1,8.13,39.60,3653017,3653080
29641,60,48,1,8.53,73.05,3653080,3653140
29642,49,66,1,10.45,165.55,3653139,3653188
29643,66,28,0,7.76,34.76,3653187,3653253
29644,29,66,1,17.66,367.88,3653252,3653281
29645,41,43,1,12.49,131.27,3653280,3653321
29646,41,66,1,12.49,143.37,3653320,3653361
29647,29,168,1,17.66,958.02,3653360,3653389
29648,55,101,1,9.31,188.50,3653388,3653443
29649,45,64,1,11.38,125.12,3653442,3653487
29650,35,62,1,14.63,248.35,3653486,3653521
29651,46,36,1,11.13,62.50,3653520,3653566
29652,44,38,1,11.64,81.78,3653565,3653609
29653,44,39,2,11.64,81.73,3653608,3653652
29654,51,34,1,10.04,49.49,3653651,3653702
29655,35,53,1,14.63,135.43,3653701,3653736
29656,43,86,3,11.91,196.27,3653735,3653778
29657,57,29,0,8.98,32.58,3653777,3653834
29658,48,39,1,10.67,77.93,3653833,3653881
29659,51,30,2,10.04,50.90,3653880,3653931
29660,47,48,1,10.89,89.54,3653930,3653977
29661,49,42,2,10.45,73.15,3653976,3654025
29662,51,29,3,10.04,32.94,3654024,3654075
29663,46,61,1,11.13,95.20,3654075,3654121
29664,49,49,1,10.45,69.47,3654120,3654169
29665,47,68,1,10.89,111.41,3654168,3654215
29666,40,60,2,12.80,107.71,3654214,3654254
29667,57,50,1,8.98,65.35,3654253,3654310
29668,54,37,1,9.48,51.06,3654309,3654363
29669,52,62,1,9.85,94.59,3654362,3654414
29670,52,44,1,9.85,59.09,3654413,3654465
29671,51,35,1,10.04,61.53,3654464,3654515
29672,15,226,4,34.13,2896.25,3654514,3654529
29673,37,57,2,13.84,145.05,3654528,3654565
29674,31,114,1,16.52,515.02,3654565,3654596
29675,19,185,2,26.95,1663.21,3654595,3654614
29676,12,436,2,42.67,14082.22,3654613,3654625
29677,55,87,1,9.31,150.90,3654624,3654679
29678,35,142,3,14.63,517.49,3654678,3654713
29679,40,46,2,12.80,115.96,3654712,3654752
29680,37,56,2,13.84,174.84,3654751,3654788
29681,28,96,2,18.29,398.56,3654788,3654816
29682,54,65,1,9.48,142.84,3654815,3654869
29683,42,64,2,12.19,153.49,3654868,3654910
29684,43,61,1,11.91,179.85,3654909,3654952
29685,58,63,1,8.83,94.69,3654952,3655010
29686,67,30,1,7.64,56.20,3655009,3655076
29687,49,44,1,10.45,74.86,3655075,3655124
29688,62,27,1,8.26,48.68,3655123,3655185
29689,60,39,1,8.53,81.38,3655184,3655244
29690,71,25,1,7.21,27.27,3655243,3655314
29691,92,32,1,5.57,31.66,3655313,3655405
29692,67,32,1,7.64,37.60,3655404,3655471
29693,40,55,1,12.80,142.01,3655470,3655510
29694,67,48,1,7.64,67.57,3655509,3655576
29695,59,29,1,8.68,34.56,3655575,3655634
29696,58,47,1,8.83,65.83,3655633,3655691
29697,55,49,1,9.31,94.94,3655690,3655745
29698,51,72,1,10.04,181.65,3655744,3655795
29699,54,35,1,9.48,56.62,3655794,3655848
29700,60,43,1,8.53,66.88,3655847,3655907
29701,55,51,1,9.31,94.72,3655906,3655961
29702,55,68,1,9.31,162.10,3655960,3656015
29703,58,52,1,8.83,81.07,3656014,3656072
29704,66,89,2,7.76,129.67,3656072,3656138
29705,44,99,1,11.64,364.87,3656137,3656181
29706,49,66,1,10.45,211.68,3656180,3656229
29707,50,72,1,10.24,146.62,3656228,3656278
29708,49,32,1,10.45,62.90,3656277,3656326
29709,49,48,1,10.45,90.04,3656326,3656375
29710,24,327,2,21.33,4089.47,3656374,3656398
29711,8,418,7,64.00,17944.25,3656397,3656405
29712,39,50,1,13.13,123.60,3656404,3656443
29713,54,29,2,9.48,34.14,3656443,3656497
29714,45,42,1,11.38,86.37,3656496,3656541
29715,31,63,2,16.52,205.09,3656540,3656571
29716,56,54,1,9.14,77.37,3656570,3656626
29717,55,42,2,9.31,62.90,3656625,3656680
29718,56,48,1,9.14,75.94,3656679,3656735
29719,49,39,1,10.45,78.04,3656734,3656783
29720,25,129,2,20.48,704.57,3656782,3656807
29721,48,78,1,10.67,139.43,3656806,3656854
29722,37,77,1,13.84,212.95,3656854,3656891
29723,49,45,1,10.45,64.53,3656890,3656939
29724,42,50,2,12.19,88.92,3656938,3656980
29725,65,31,2,7.88,28.60,3656979,3657044
29726,40,69,1,12.80,125.16,3657043,3657083
29727,40,50,1,12.80,158.86,3657082,3657122
29728,42,39,1,12.19,62.77,3657121,3657163
29729,48,52,2,10.67,98.60,3657162,3657210
29730,38,73,1,13.47,247.09,3657209,3657247
29731,53,68,1,9.66,106.79,3657246,3657299
29732,40,112,1,12.80,321.56,3657298,3657338
29733,45,44,2,11.38,91.21,3657337,3657382
29734,48,51,1,10.67,89.81,3657381,3657429
29735,33,112,1,15.52,570.07,3657428,3657461
29736,36,189,1,14.22,956.67,3657460,3657496
29737,43,78,1,11.91,163.90,3657495,3657538
29738,49,98,1,10.45,214.04,3657538,3657587
29739,63,37,1,8.13,73.86,3657586,3657649
29740,52,34,1,9.85,55.78,3657648,3657700
29741,38,91,1,13.47,285.41,3657699,3657737
29742,52,62,1,9.85,116.36,3657736,3657788
29743,74,37,1,6.92,44.78,3657787,3657861
29744,66,46,1,7.76,61.64,3657860,3657926
29745,52,45,1,9.85,77.98,3657925,3657977
29746,62,63,0,8.26,82.80,3657976,3658038
29747,41,115,1,12.49,386.44,3658037,3658078
29748,51,35,1,10.04,85.45,3658077,3658128
29749,42,45,1,12.19,142.73,3658127,3658169
29750,67,30,1,7.64,48.20,3658168,3658235
29751,41,125,2,12.49,461.62,3658234,3658275
29752,52,28,1,9.85,55.86,3658274,3658326
29753,50,85,0,10.24,263.10,3658325,3658375
29754,56,45,1,9.14,61.19,3658374,3658430
29755,58,57,1,8.83,90.63,3658429,3658487
29756,67,54,1,7.64,82.77,3658486,3658553
29757,62,57,1,8.26,82.71,3658552,3658614
29758,66,45,1,7.76,54.97,3658613,3658679
29759,54,80,2,9.48,134.14,3658679,3658733
29760,75,22,1,6.83,19.72,3658733,3658808
29761,65,27,1,7.88,24.45,3658807,3658872
29762,51,38,1,10.04,75.10,3658871,3658922
29763,44,100,1,11.64,317.19,3658921,3658965
29764,45,199,1,11.38,828.90,3658964,3659009
29765,55,101,1,9.31,181.85,3659008,3659063
29766,42,57,1,12.19,133.20,3659062,3659104
29767,54,50,1,9.48,82.55,3659103,3659157
29768,56,30,1,9.14,37.98,3659156,3659212
29769,44,70,2,11.64,117.55,3659211,3659255
29770,51,35,1,10.04,45.10,3659254,3659305
29771,40,80,3,12.80,231.36,3659304,3659344
29772,39,82,1,13.13,195.24,3659343,3659382
29773,52,27,4,9.85,30.48,3659381,3659433
29774,47,57,1,10.89,106.73,3659432,3659479
29775,46,57,1,11.13,87.90,3659479,3659525
29776,51,32,2,10.04,48.78,3659524,3659575
29777,46,105,1,11.13,252.46,3659574,3659620
29778,35,151,2,14.63,603.03,3659619,3659654
29779,50,37,1,10.24,46.22,3659653,3659703
29780,45,85,2,11.38,169.12,3659702,3659747
29781,50,57,2,10.24,64.02,3659746,3659796
29782,50,60,2,10.24,88.02,3659795,3659845
29783,45,44,1,11.38,110.50,3659844,3659889
29784,48,51,1,10.67,98.10,3659888,3659936
29785,53,65,1,9.66,102.79,3659935,3659988
29786,30,55,2,17.07,215.73,3659987,3660017
29787,28,166,2,18.29,943.49,3660016,3660044
29788,32,123,1,16.00,491.62,3660043,3660075
29789,21,117,2,24.38,1004.71,3660074,3660095
29790,17,127,4,30.12,1007.63,3660094,3660111
29791,34,80,1,15.06,237.41,3660110,3660144
29792,38,46,2,13.47,125.88,3660143,3660181
29793,32,83,3,16.00,267.50,3660180,3660212
29794,1,512,512,512.00,0.00,3660211,3660212
29795,48,42,2,10.67,89.39,3660211,3660259
29796,50,53,1,10.24,134.66,3660258,3660308
29797,49,40,1,10.45,122.70,3660307,3660356
29798,37,102,2,13.84,299.27,3660355,3660392
29799,44,73,1,11.64,192.91,3660391,3660435
29800,41,71,1,12.49,213.08,3660434,3660475
29801,44,66,1,11.64,143.14,3660475,3660519
29802,51,60,1,10.04,90.12,3660518,3660569
29803,73,90,0,7.01,162.45,3660568,3660641
29804,49,86,1,10.45,200.37,3660640,3660689
29805,51,60,1,10.04,104.78,3660688,3660739
29806,84,34,1,6.10,37.99,3660738,3660822
29807,55,72,1,9.31,136.47,3660821,3660876
29808,81,53,1,6.32,72.12,3660875,3660956
29809,69,107,1,7.42,174.01,3660956,3661025
29810,50,111,1,10.24,234.22,3661024,3661074
29811,41,56,1,12.49,162.59,3661073,3661114
29812,68,43,1,7.53,43.87,3661113,3661181
29813,55,45,1,9.31,74.61,3661180,3661235
29814,63,44,1,8.13,87.29,3661234,3661297
29815,66,31,1,7.76,40.97,3661296,3661362
29816,40,109,0,12.80,345.16,3661361,3661401
29817,53,38,1,9.66,70.00,3661400,3661453
29818,63,68,1,8.13,89.89,3661452,3661515
29819,47,110,1,10.89,374.86,3661515,3661562
29820,63,50,1,8.13,70.52,3661561,3661624
29821,51,43,1,10.04,64.55,3661623,3661674
29822,30,88,1,17.07,337.46,3661674,3661704
29823,47,123,1,10.89,311.07,3661703,3661750
29824,33,118,2,15.52,461.64,3661749,3661782
29825,53,49,1,9.66,60.83,3661781,3661834
29826,56,62,1,9.14,116.05,3661833,3661889
29827,61,26,1,8.39,24.63,3661888,3661949
29828,30,92,3,17.07,280.93,3661948,3661978
29829,43,69,1,11.91,155.81,3661977,3662020
29830,48,41,1,10.67,66.76,3662019,3662067
29831,49,30,1,10.45,43.02,3662066,3662115
29832,52,41,1,9.85,63.17,3662114,3662166
29833,50,43,1,10.24,59.58,3662165,3662215
29834,45,52,1,11.38,90.55,3662214,3662259
29835,58,34,1,8.83,39.14,3662258,3662316
29836,32,85,1,16.00,414.69,3662315,3662347
29837,38,43,1,13.47,112.20,3662346,3662384
29838,55,31,2,9.31,32.54,3662383,3662438
29839,46,43,1,11.13,79.94,3662437,3662483
29840,49,50,1,10.45,79.27,3662482,3662531
29841,64,28,1,8.00,30.59,3662530,3662594
29842,50,49,1,10.24,110.30,3662593,3662643
29843,46,50,1,11.13,101.90,3662642,3662688
29844,41,51,1,12.49,138.20,3662687,3662728
29845,49,43,1,10.45,62.86,3662727,3662776
29846,38,54,1,13.47,123.83,3662775,3662813
29847,50,34,1,10.24,52.98,3662812,3662862
29848,64,26,1,8.00,38.47,3662861,3662925
29849,67,53,1,7.64,57.04,3662924,3662991
29850,63,72,1,8.13,98.71,3662990,3663053
29851,47,101,1,10.89,268.65,3663052,3663099
29852,57,26,1,8.98,38.30,3663098,3663155
29853,73,61,1,7.01,65.27,3663154,3663227
29854,64,69,2,8.00,86.66,3663226,3663290
29855,46,76,1,11.13,237.55,3663289,3663335
29856,56,43,1,9.14,52.91,3663335,3663391
29857,51,44,2,10.04,63.10,3663390,3663441
29858,59,28,1,8.68,31.47,3663440,3663499
29859,41,36,1,12.49,65.08,3663498,3663539
29860,61,30,1,8.39,38.24,3663538,3663599
29861,67,27,1,7.64,33.13,3663598,3663665
29862,37,62,1,13.84,181.27,3663664,3663701
29863,58,50,1,8.83,60.94,3663700,3663758
29864,41,75,1,12.49,139.62,3663757,3663798
29865,43,76,1,11.91,166.60,3663797,3663840
29866,50,35,1,10.24,59.46,3663839,3663889
29867,45,57,1,11.38,98.28,3663888,3663933
29868,51,65,1,10.04,138.63,3663932,3663983
29869,60,39,1,8.53,45.68,3663982,3664042
29870,58,64,1,8.83,97.14,3664041,3664099
29871,56,49,1,9.14,76.91,3664098,3664154
29872,33,67,1,15.52,210.98,3664154,3664187
29873,13,146,4,39.38,1555.93,3664186,3664199
29874,20,232,2,25.60,2371.54,3664198,3664218
29875,27,84,3,18.96,291.81,3664217,3664244
29876,54,32,1,9.48,48.88,3664243,3664297
29877,53,43,1,9.66,72.79,3664296,3664349
29878,39,104,1,13.13,363.24,3664348,3664387
29879,42,53,1,12.19,140.30,3664386,3664428
29880,49,69,1,10.45,159.19,3664427,3664476
29881,43,52,1,11.91,193.76,3664475,3664518
29882,57,55,1,8.98,86.02,3664518,3664575
29883,68,49,1,7.53,65.90,3664575,3664643
29884,50,51,1,10.24,93.26,3664642,3664692
29885,66,35,1,7.76,45.61,3664691,3664757
29886,62,39,1,8.26,52.03,3664756,3664818
29887,58,94,1,8.83,163.04,3664817,3664875
29888,58,56,1,8.83,76.87,3664874,3664932
29889,59,42,1,8.68,61.71,3664931,3664990
29890,64,32,1,8.00,29.78,3664989,3665053
29891,58,28,1,8.83,42.32,3665052,3665110
29892,79,35,1,6.48,31.09,3665109,3665188
29893,72,48,1,7.11,51.04,3665187,3665259
29894,46,45,2,11.13,77.64,3665259,3665305
29895,25,223,1,20.48,1808.89,3665304,3665329
29896,45,85,1,11.38,158.59,3665328,3665373
29897,48,38,1,10.67,70.01,3665373,3665421
29898,50,37,1,10.24,64.30,3665420,3665470
29899,46,46,1,11.13,80.07,3665469,3665515
29900,51,43,2,10.04,65.57,3665515,3665566
29901,57,41,1,8.98,48.40,3665565,3665622
29902,55,99,1,9.31,169.45,3665621,3665676
29903,43,48,1,11.91,109.11,3665675,3665718
29904,52,60,1,9.85,118.40,3665717,3665769
29905,47,48,1,10.89,91.20,3665768,3665815
29906,53,73,1,9.66,119.17,3665814,3665867
29907,46,49,2,11.13,73.94,3665866,3665912
29908,56,23,1,9.14,30.91,3665911,3665967
29909,52,33,1,9.85,50.75,3665966,3666018
29910,62,35,1,8.26,29.26,3666017,3666079
29911,45,55,1,11.38,128.24,3666078,3666123
29912,53,55,1,9.66,90.41,3666122,3666175
29913,50,79,2,10.24,141.26,3666174,3666224
29914,47,70,1,10.89,172.39,3666223,3666270
29915,41,95,1,12.49,273.66,3666269,3666310
29916,43,48,2,11.91,75.67,3666309,3666352
29917,39,80,1,13.13,217.70,3666351,3666390
29918,43,102,1,11.91,248.55,3666389,3666432
29919,50,35,1,10.24,65.78,3666431,3666481
29920,50,35,1,10.24,73.90,3666480,3666530
29921,51,29,1,10.04,56.70,3666529,3666580
29922,44,72,1,11.64,170.46,3666580,3666624
29923,57,44,1,8.98,75.03,3666623,3666680
29924,34,78,2,15.06,201.53,3666679,3666713
29925,41,67,1,12.49,188.88,3666712,3666753
29926,75,47,0,6.83,60.30,3666752,3666827
29927,67,62,1,7.64,70.26,3666827,3666894
29928,47,109,1,10.89,259.20,3666893,3666940
29929,64,53,1,8.00,75.88,3666939,3667003
29930,68,27,1,7.53,29.28,3667002,3667070
29931,70,30,1,7.31,37.24,3667069,3667139
29932,53,41,1,9.66,74.56,3667138,3667191
29933,60,43,1,8.53,45.48,3667191,3667251
29934,65,32,1,7.88,40.02,3667250,3667315
29935,53,41,1,9.66,53.85,3667314,3667367
29936,59,173,1,8.68,494.69,3667366,3667425
29937,34,260,2,15.06,1847.06,3667424,3667458
29938,68,42,1,7.53,44.78,3667457,3667525
29939,28,269,2,18.29,2424.99,3667524,3667552
29940,56,37,2,9.14,46.52,3667552,3667608
29941,51,23,1,10.04,41.29,3667608,3667659
29942,61,27,2,8.39,30.21,3667658,3667719
29943,48,60,1,10.67,92.97,3667718,3667766
29944,41,64,1,12.49,124.84,3667766,3667807
29945,46,96,1,11.13,194.85,3667806,3667852
29946,54,39,1,9.48,48.25,3667852,3667906
29947,65,19,1,7.88,19.80,3667905,3667970
29948,42,47,2,12.19,75.68,3667969,3668011
29949,35,239,1,14.63,1506.40,3668010,3668045
29950,52,26,1,9.85,39.36,3668044,3668096
29951,43,57,1,11.91,139.57,3668095,3668138
29952,42,49,1,12.19,71.06,3668137,3668179
29953,34,42,2,15.06,137.41,3668178,3668212
29954,54,42,2,9.48,65.62,3668211,3668265
29955,53,38,1,9.66,61.88,3668264,3668317
29956,65,29,1,7.88,30.54,3668316,3668381
29957,45,37,1,11.38,81.39,3668380,3668425
29958,42,44,1,12.19,129.25,3668424,3668466
29959,61,31,1,8.39,46.04,3668465,3668526
29960,52,52,1,9.85,92.05,3668526,3668578
29961,40,61,1,12.80,153.86,3668578,3668618
29962,28,88,1,18.29,389.06,3668617,3668645
29963,30,88,1,17.07,331.26,3668644,3668674
29964,30,54,2,17.07,186.93,3668673,3668703
29965,40,45,1,12.80,103.81,3668702,3668742
29966,39,57,2,13.13,110.78,3668741,3668780
29967,45,75,1,11.38,156.81,3668779,3668824
29968,37,90,1,13.84,356.84,3668823,3668860
29969,51,60,1,10.04,87.84,3668859,3668910
29970,35,97,2,14.63,274.86,3668909,3668944
29971,37,115,1,13.84,407.65,3668943,3668980
29972,39,103,1,13.13,355.86,3668980,3669019
29973,41,49,1,12.49,100.25,3669018,3669059
29974,70,51,1,7.31,70.76,3669058,3669128
29975,61,80,1,8.39,132.60,3669127,3669188
29976,73,38,1,7.01,53.44,3669187,3669260
29977,58,37,1,8.83,48.94,3669259,3669317
29978,65,22,1,7.88,31.28,3669316,3669381
29979,59,34,1,8.68,45.88,3669380,3669439
29980,29,91,1,17.66,365.61,3669438,3669467
29981,73,44,1,7.01,48.67,3669466,3669539
29982,46,70,1,11.13,112.59,3669538,3669584
29983,35,171,1,14.63,762.86,3669583,3669618
29984,38,134,1,13.47,456.09,3669617,3669655
29985,47,63,1,10.89,180.69,3669654,3669701
29986,68,31,1,7.53,39.87,3669700,3669768
29987,65,31,1,7.88,36.66,3669768,3669833
29988,55,76,0,9.31,121.30,3669832,3669887
29989,51,93,1,10.04,193.49,3669886,3669937
29990,57,36,1,8.98,53.00,3669936,3669993
29991,53,36,1,9.66,49.92,3669992,3670045
29992,47,60,2,10.89,79.24,3670044,3670091
29993,51,36,2,10.04,55.53,3670090,3670141
29994,4,483,2,128.00,42036.50,3670140,3670144
29995,51,47,1,10.04,56.86,3670143,3670194
29996,40,43,2,12.80,91.91,3670193,3670233
29997,45,36,1,11.38,48.99,3670232,3670277
29998,61,25,1,8.39,36.11,3670276,3670337
29999,39,59,2,13.13,136.42,3670336,3670375
30000,60,31,1,8.53,38.82,3670374,3670434
30001,33,82,3,15.52,324.55,3670433,3670466
30002,43,67,1,11.91,139.39,3670465,3670508
30003,46,60,1,11.13,118.90,3670507,3670553
30004,47,38,2,10.89,55.75,3670552,3670599
30005,51,53,1,10.04,62.35,3670598,3670649
30006,44,53,1,11.64,90.64,3670648,3670692
30007,52,34,2,9.85,53.40,3670691,3670743
30008,39,54,2,13.13,106.32,3670742,3670781
30009,50,42,1,10.24,78.42,3670780,3670830
30010,57,48,1,8.98,72.75,3670829,3670886
30011,50,64,1,10.24,123.86,3670885,3670935
30012,33,77,1,15.52,272.55,3670934,3670967
30013,31,89,1,16.52,297.67,3670966,3670997
30014,35,49,2,14.63,150.40,3670996,3671031
30015,22,56,5,23.27,196.93,3671030,3671052
30016,54,49,1,9.48,78.55,3671051,3671105
30017,28,128,1,18.29,588.06,3671104,3671132
30018,44,42,1,11.64,102.78,3671131,3671175
30019,41,74,1,12.49,153.27,3671174,3671215
30020,37,107,1,13.84,322.84,3671214,3671251
30021,53,70,1,9.66,125.32,3671250,3671303
30022,42,64,1,12.19,124.54,3671302,3671344
30023,58,76,0,8.83,106.28,3671343,3671401
30024,55,54,1,9.31,92.14,3671400,3671455
30025,52,55,1,9.85,117.01,3671454,3671506
30026,66,41,1,7.76,55.09,3671506,3671572
30027,48,78,1,10.67,162.64,3671571,3671619
30028,59,56,1,8.68,79.51,3671618,3671677
30029,69,29,0,7.42,39.29,3671676,3671745
30030,40,93,1,12.80,291.76,3671744,3671784
30031,66,66,1,7.76,93.97,3671783,3671849
30032,44,65,2,11.64,141.14,3671848,3671892
30033,52,40,1,9.85,70.78,3671892,3671944
30034,59,48,1,8.68,82.63,3671943,3672002
30035,36,171,0,14.22,827.06,3672001,3672037
30036,51,126,1,10.04,308.43,3672036,3672087
30037,41,83,1,12.49,291.86,3672086,3672127
30038,75,40,1,6.83,34.89,3672126,3672201
30039,66,43,1,7.76,41.09,3672200,3672266
30040,40,66,1,12.80,182.71,3672265,3672305
30041,52,74,1,9.85,145.44,3672304,3672356
30042,47,63,3,10.89,112.14,3672355,3672402
30043,60,37,1,8.53,40.28,3672401,3672461
30044,43,36,1,11.91,77.01,3672460,3672503
30045,43,46,1,11.91,72.04,3672502,3672545
30046,48,96,1,10.67,211.51,3672544,3672592
30047,41,48,3,12.49,107.27,3672591,3672632
30048,44,69,2,11.64,151.14,3672631,3672675
30049,56,26,1,9.14,42.02,3672674,3672730
30050,48,42,1,10.67,66.93,3672729,3672777
30051,30,86,2,17.07,325.40,3672776,3672806
30052,43,48,1,11.91,105.43,3672805,3672848
30053,56,34,1,9.14,41.62,3672847,3672903
30054,41,85,2,12.49,177.03,3672902,3672943
30055,48,37,1,10.67,47.72,3672942,3672990
30056,58,27,1,8.83,28.80,3672989,3673047
30057,52,50,2,9.85,69.44,3673046,3673098
30058,52,46,1,9.85,86.82,3673097,3673149
30059,45,74,2,11.38,154.59,3673148,3673193
30060,61,54,1,8.39,102.07,3673192,3673253
30061,34,61,0,15.06,200.94,3673252,3673286
30062,18,97,4,28.44,941.36,3673285,3673303
30063,32,45,3,16.00,110.00,3673302,3673334
30064,22,64,1,23.27,335.93,3673333,3673355
30065,38,79,1,13.47,187.62,3673354,3673392
30066,42,61,2,12.19,184.15,3673391,3673433
30067,41,77,1,12.49,199.03,3673432,3673473
30068,46,35,0,11.13,83.42,3673472,3673518
30069,57,36,1,8.98,62.37,3673517,3673574
30070,62,56,1,8.26,76.16,3673573,3673635
30071,71,37,1,7.21,59.60,3673634,3673705
30072,77,35,1,6.65,43.63,3673704,3673781
30073,44,88,1,11.64,195.69,3673780,3673824
30074,47,41,1,10.89,101.80,3673823,3673870
30075,67,34,1,7.64,48.38,3673870,3673937
30076,58,60,1,8.83,97.97,3673937,3673995
30077,48,57,1,10.67,120.43,3673994,3674042
30078,47,76,2,10.89,170.65,3674041,3674088
30079,62,24,2,8.26,30.90,3674088,3674150
30080,61,50,1,8.39,69.75,3674149,3674210
30081,54,64,1,9.48,121.84,3674209,3674263
30082,60,65,1,8.53,98.15,3674262,3674322
30083,49,200,1,10.45,764.08,3674321,3674370
30084,34,82,1,15.06,302.35,3674369,3674403
30085,39,150,1,13.13,662.27,3674402,3674441
30086,49,62,1,10.45,103.92,3674441,3674490
30087,46,110,1,11.13,253.07,3674489,3674535
30088,47,57,2,10.89,92.65,3674534,3674581
30089,53,41,1,9.66,53.51,3674580,3674633
30090,18,196,1,28.44,2546.69,3674632,3674650
30091,27,87,2,18.96,462.78,3674649,3674676
30092,63,45,1,8.13,40.84,3674675,3674738
30093,55,28,1,9.31,40.98,3674737,3674792
30094,40,47,2,12.80,112.06,3674791,3674831
30095,42,60,2,12.19,135.39,3674830,3674872
30096,47,42,1,10.89,99.37,3674871,3674918
30097,39,49,1,13.13,110.42,3674917,3674956
30098,50,28,1,10.24,41.50,3674955,3675005
30099,44,47,1,11.64,122.05,3675004,3675048
30100,51,36,1,10.04,70.70,3675047,3675098
30101,57,42,1,8.98,50.44,3675097,3675154
30102,28,62,3,18.29,236.35,3675153,3675181
30103,32,64,1,16.00,219.88,3675180,3675212
30104,32,107,2,16.00,437.12,3675211,3675243
30105,40,97,1,12.80,275.01,3675242,3675282
30106,49,41,1,10.45,68.04,3675281,3675330
30107,43,108,0,11.91,260.50,3675329,3675372
30108,45,74,1,11.38,168.59,3675371,3675416
30109,43,34,1,11.91,89.76,3675415,3675458
30110,52,33,1,9.85,70.71,3675457,3675509
30111,62,48,1,8.26,75.77,3675508,3675570
30112,74,31,1,6.92,41.59,3675569,3675643
30113,57,47,1,8.98,67.10,3675642,3675699
30114,52,64,1,9.85,130.21,3675699,3675751
30115,44,87,1,11.64,215.46,3675750,3675794
30116,43,88,1,11.91,220.41,3675794,3675837
30117,55,55,1,9.31,75.81,3675836,3675891
30118,52,52,2,9.85,87.44,3675890,3675942
30119,77,23,1,6.65,26.88,3675941,3676018
30120,57,59,1,8.98,88.19,3676017,3676074
30121,63,56,1,8.13,60.59,3676073,3676136
30122,32,143,1,16.00,762.62,3676135,3676167
30123,62,29,1,8.26,35.22,3676166,3676228
30124,37,213,2,13.84,1133.05,3676227,3676264
30125,51,52,1,10.04,109.14,3676263,3676314
30126,48,44,1,10.67,71.06,3676313,3676361
30127,49,50,1,10.45,85.72,3676360,3676409
30128,41,80,1,12.49,159.76,3676408,3676449
30129,42,76,1,12.19,197.15,3676448,3676490
30130,41,65,1,12.49,155.96,3676489,3676530
30131,49,47,2,10.45,78.21,3676529,3676578
30132,40,85,1,12.80,215.11,3676577,3676617
30133,48,51,2,10.67,65.81,3676616,3676664
30134,41,55,1,12.49,116.59,3676663,3676704
30135,55,21,2,9.31,31.30,3676703,3676758
30136,46,56,1,11.13,105.85,3676757,3676803
30137,40,85,1,12.80,220.71,3676802,3676842
30138,61,37,2,8.39,52.37,3676841,3676902
30139,46,47,1,11.13,119.20,3676901,3676947
30140,22,109,2,23.27,673.38,3676947,3676969
30141,26,77,1,19.69,471.98,3676968,3676994
30142,39,62,3,13.13,154.88,3676993,3677032
30143,4,456,3,128.00,35968.50,3677031,3677035
30144,22,168,2,23.27,1283.93,3677034,3677056
30145,49,37,1,10.45,48.78,3677055,3677104
30146,43,58,2,11.91,158.97,3677103,3677146
30147,43,68,1,11.91,203.71,3677145,3677188
30148,51,41,1,10.04,81.92,3677187,3677238
30149,70,58,1,7.31,66.33,3677237,3677307
30150,62,31,1,8.26,50.13,3677306,3677368
30151,54,56,1,9.48,98.77,3677367,3677421
30152,80,39,0,6.40,52.49,3677420,3677500
30153,49,142,2,10.45,391.27,3677499,3677548
30154,49,40,1,10.45,60.29,3677547,3677596
30155,62,38,1,8.26,52.74,3677595,3677657
30156,62,32,1,8.26,40.71,3677656,3677718
30157,48,52,1,10.67,137.31,3677717,3677765
30158,60,56,1,8.53,88.25,3677764,3677824
30159,42,55,1,12.19,141.73,3677823,3677865
30160,55,81,1,9.31,170.50,3677864,3677919
30161,50,189,1,10.24,677.70,3677918,3677968
30162,28,116,1,18.29,723.78,3677967,3677995
30163,52,50,1,9.85,79.78,3677994,3678046
30164,49,37,2,10.45,61.76,3678045,3678094
30165,47,61,1,10.89,131.24,3678093,3678140
30166,46,92,1,11.13,227.42,3678139,3678185
30167,54,58,1,9.48,73.95,3678184,3678238
30168,38,96,1,13.47,370.78,3678237,3678275
30169,38,57,2,13.47,142.67,3678274,3678312
30170,52,39,2,9.85,39.94,3678311,3678363
30171,51,35,2,10.04,62.63,3678362,3678413
30172,66,23,1,7.76,26.40,3678413,3678479
30173,55,56,1,9.31,75.74,3678478,3678533
30174,26,97,1,19.69,533.29,3678532,3678558
30175,36,44,1,14.22,149.51,3678557,3678593
30176,36,103,1,14.22,439.45,3678592,3678628
30177,46,61,2,11.13,144.24,3678627,3678673
30178,55,67,1,9.31,95.85,3678672,3678727
30179,45,53,1,11.38,118.99,3678726,3678771
30180,53,34,1,9.66,52.60,3678770,3678823
30181,48,47,1,10.67,115.35,3678823,3678871
30182,63,42,1,8.13,59.03,3678870,3678933
30183,53,70,1,9.66,155.24,3678932,3678985
30184,60,57,1,8.53,97.68,3678984,3679044
30185,63,47,1,8.13,64.56,3679043,3679106
30186,64,27,1,8.00,37.56,3679105,3679169
30187,59,38,1,8.68,40.22,3679168,3679227
30188,64,76,1,8.00,142.09,3679226,3679290
30189,49,37,1,10.45,67.43,3679289,3679338
30190,51,54,1,10.04,150.55,3679337,3679388
30191,33,237,1,15.52,1581.70,3679387,3679420
30192,44,123,1,11.64,371.00,3679419,3679463
30193,55,36,1,9.31,52.43,3679462,3679517
30194,48,43,1,10.67,77.97,3679516,3679564
30195,38,114,1,13.47,364.99,3679563,3679601
30196,49,50,1,10.45,69.31,3679600,3679649
30197,31,84,1,16.52,254.96,3679648,3679679
30198,42,38,2,12.19,60.54,3679678,3679720
30199,50,43,1,10.24,69.30,3679719,3679769
30200,27,107,2,18.96,658.63,3679768,3679795
30201,47,27,1,10.89,46.99,3679795,3679842
30202,47,55,1,10.89,95.84,3679841,3679888
30203,47,53,2,10.89,84.99,3679887,3679934
30204,45,88,1,11.38,189.48,3679934,3679979
30205,31,111,2,16.52,540.44,3679978,3680009
30206,58,32,1,8.83,56.63,3680008,3680066
30207,50,33,1,10.24,66.74,3680066,3680116
30208,28,61,1,18.29,272.42,3680115,3680143
30209,38,41,1,13.47,133.20,3680142,3680180
30210,43,39,1,11.91,66.78,3680180,3680223
30211,44,53,1,11.64,136.91,3680222,3680266
30212,42,63,1,12.19,167.68,3680265,3680307
30213,47,50,1,10.89,115.37,3680306,3680353
30214,29,100,1,17.66,479.19,3680352,3680381
30215,44,47,0,11.64,148.23,3680380,3680424
30216,48,94,1,10.67,197.18,3680423,3680471
30217,53,99,1,9.66,202.71,3680470,3680523
30218,65,81,1,7.88,133.46,3680522,3680587
30219,71,27,1,7.21,38.25,3680587,3680658
30220,75,29,1,6.83,45.29,3680657,3680732
30221,57,94,1,8.98,180.65,3680731,3680788
30222,46,49,1,11.13,113.94,3680787,3680833
30223,67,35,1,7.64,56.14,3680832,3680899
30224,58,138,1,8.83,344.38,3680898,3680956
30225,44,44,1,11.64,119.41,3680955,3680999
30226,54,42,1,9.48,55.62,3680998,3681052
30227,52,100,1,9.85,209.21,3681051,3681103
30228,53,35,1,9.66,64.11,3681103,3681156
30229,68,68,1,7.53,91.69,3681155,3681223
30230,57,73,1,8.98,124.33,3681222,3681279
30231,40,86,2,12.80,302.31,3681278,3681318
30232,30,108,2,17.07,498.60,3681317,3681347
30233,57,46,1,8.98,72.68,3681346,3681403
30234,59,49,1,8.68,62.42,3681402,3681461
30235,47,66,1,10.89,166.22,3681460,3681507
30236,41,85,1,12.49,228.15,3681506,3681547
30237,54,35,1,9.48,43.58,3681546,3681600
30238,54,31,1,9.48,47.18,3681599,3681653
30239,33,96,1,15.52,354.67,3681652,3681685
30240,56,31,1,9.14,45.77,3681684,3681740
30241,50,49,1,10.24,65.78,3681739,3681789
30242,44,47,1,11.64,67.55,3681788,3681832
30243,52,31,1,9.85,59.86,3681831,3681883
30244,46,44,1,11.13,64.50,3681882,3681928
30245,44,70,1,11.64,156.14,3681927,3681971
30246,43,52,1,11.91,87.29,3681970,3682013
30247,45,43,1,11.38,95.88,3682013,3682058
30248,29,104,1,17.66,507.47,3682057,3682086
30249,47,57,1,10.89,86.69,3682085,3682132
30250,40,48,1,12.80,146.61,3682131,3682171
30251,23,147,1,22.26,1084.02,3682170,3682193
30252,13,242,4,39.38,4123.62,3682192,3682205
30253,34,103,2,15.06,380.88,3682204,3682238
30254,43,59,1,11.91,125.81,3682237,3682280
30255,44,75,1,11.64,179.37,3682279,3682323
30256,52,41,1,9.85,77.28,3682322,3682374
30257,47,54,1,10.89,100.10,3682373,3682420
30258,56,102,1,9.14,204.69,3682419,3682475
30259,45,74,1,11.38,157.35,3682474,3682519
30260,56,49,1,9.14,76.98,3682518,3682574
30261,46,54,1,11.13,150.50,3682573,3682619
30262,58,33,1,8.83,77.25,3682618,3682676
30263,68,41,1,7.53,46.66,3682675,3682743
30264,41,87,1,12.49,200.93,3682742,3682783
30265,53,61,1,9.66,140.56,3682782,3682835
30266,53,57,1,9.66,119.51,3682834,3682887
30267,63,32,1,8.13,55.32,3682887,3682950
30268,53,31,1,9.66,57.09,3682949,3683002
30269,61,39,1,8.39,58.24,3683001,3683062
30270,46,98,1,11.13,303.55,3683061,3683107
30271,41,60,1,12.49,154.59,3683106,3683147
30272,43,88,1,11.91,191.01,3683147,3683190
30273,78,39,2,6.56,31.04,3683189,3683267
30274,51,77,1,10.04,139.96,3683266,3683317
30275,29,233,1,17.66,1689.26,3683316,3683345
30276,43,102,1,11.91,285.06,3683344,3683387
30277,42,124,1,12.19,350.20,3683387,3683429
30278,46,63,1,11.13,179.16,3683428,3683474
30279,55,27,1,9.31,34.00,3683473,3683528
30280,36,54,0,14.22,175.51,3683527,3683563
30281,44,100,1,11.64,261.41,3683562,3683606
30282,62,46,1,8.26,62.84,3683605,3683667
30283,35,94,1,14.63,292.75,3683666,3683701
30284,29,75,3,17.66,299.19,3683700,3683729
30285,48,37,1,10.67,68.26,3683728,3683776
30286,40,61,1,12.80,152.26,3683775,3683815
30287,47,37,2,10.89,67.16,3683814,3683861
30288,35,75,1,14.63,208.80,3683860,3683895
30289,36,82,1,14.22,204.28,3683894,3683930
30290,54,36,1,9.48,44.14,3683929,3683983
30291,37,53,2,13.84,102.08,3683982,3684019
30292,41,54,2,12.49,145.66,3684018,3684059
30293,41,43,1,12.49,100.01,3684058,3684099
30294,51,49,1,10.04,72.82,3684098,3684149
30295,49,41,1,10.45,48.70,3684148,3684197
30296,53,49,1,9.66,59.39,3684196,3684249
30297,54,45,1,9.48,106.58,3684248,3684302
30298,42,83,1,12.19,235.49,3684301,3684343
30299,40,59,1,12.80,113.66,3684342,3684382
30300,41,87,2,12.49,184.44,3684381,3684422
30301,42,64,1,12.19,175.39,3684421,3684463
30302,21,172,2,24.38,1181.28,3684462,3684483
30303,14,283,2,36.57,4848.24,3684482,3684496
30304,25,120,2,20.48,567.85,3684495,3684520
30305,30,100,1,17.07,610.53,3684519,3684549
30306,42,82,1,12.19,169.20,3684548,3684590
30307,43,86,2,11.91,286.69,3684589,3684632
30308,46,61,1,11.13,144.90,3684632,3684678
30309,49,71,2,10.45,107.47,3684677,3684726
30310,35,99,1,14.63,416.86,3684725,3684760
30311,43,50,1,11.91,114.88,3684759,3684802
30312,55,45,1,9.31,72.72,3684801,3684856
30313,33,43,1,15.52,118.31,3684855,3684888
30314,43,79,1,11.91,244.83,3684887,3684930
30315,43,66,1,11.91,199.67,3684929,3684972
30316,66,35,1,7.76,58.03,3684971,3685037
30317,72,34,1,7.11,42.27,3685036,3685108
30318,59,44,1,8.68,64.18,3685107,3685166
30319,22,180,1,23.27,1952.56,3685165,3685187
30320,41,92,1,12.49,231.03,3685186,3685227
30321,71,90,1,7.21,131.35,3685227,3685298
30322,57,107,1,8.98,226.12,3685297,3685354
30323,55,41,1,9.31,72.07,3685353,3685408
30324,47,157,1,10.89,521.24,3685407,3685454
30325,50,31,1,10.24,56.90,3685453,3685503
30326,49,67,1,10.45,141.15,3685502,3685551
30327,75,22,1,6.83,29.02,3685550,3685625
30328,55,49,1,9.31,85.09,3685624,3685679
30329,68,40,1,7.53,53.63,3685678,3685746
30330,50,74,2,10.24,118.34,3685745,3685795
30331,72,48,0,7.11,56.74,3685795,3685867
30332,47,84,1,10.89,197.63,3685866,3685913
30333,66,50,1,7.76,59.52,3685913,3685979
30334,37,245,1,13.84,1546.89,3685978,3686015
30335,67,21,1,7.64,24.80,3686014,3686081
30336,20,288,1,25.60,3912.84,3686081,3686101
30337,25,236,2,20.48,2003.93,3686100,3686125
30338,45,61,1,11.38,118.95,3686124,3686169
30339,48,85,1,10.67,160.43,3686169,3686217
30340,50,74,1,10.24,141.18,3686216,3686266
30341,59,66,1,8.68,90.08,3686265,3686324
30342,58,34,2,8.83,40.56,3686323,3686381
30343,41,63,1,12.49,139.42,3686380,3686421
30344,45,49,1,11.38,98.32,3686420,3686465
30345,50,63,1,10.24,93.30,3686464,3686514
30346,39,130,3,13.13,398.93,3686513,3686552
30347,27,100,1,18.96,484.18,3686551,3686578
30348,28,118,1,18.29,599.13,3686577,3686605
30349,37,35,1,13.84,86.19,3686604,3686641
30350,62,27,1,8.26,29.16,3686640,3686702
30351,41,150,1,12.49,510.25,3686701,3686742
30352,50,33,1,10.24,41.26,3686741,3686791
30353,49,46,1,10.45,65.06,3686791,3686840
30354,59,23,1,8.68,35.68,3686839,3686898
30355,47,31,2,10.89,50.56,3686897,3686944
30356,24,83,2,21.33,501.97,3686944,3686968
30357,35,64,3,14.63,192.18,3686967,3687002
30358,55,21,1,9.31,26.98,3687001,3687056
30359,48,49,2,10.67,80.68,3687055,3687103
30360,44,50,2,11.64,90.87,3687102,3687146
30361,53,32,1,9.66,33.70,3687145,3687198
30362,56,34,1,9.14,38.98,3687197,3687253
30363,45,36,1,11.38,66.41,3687252,3687297
30364,42,44,1,12.19,98.15,3687296,3687338
30365,18,159,3,28.44,1718.02,3687337,3687355
30366,28,71,1,18.29,198.99,3687354,3687382
30367,33,143,1,15.52,655.10,3687381,3687414
30368,46,62,2,11.13,101.81,3687413,3687459
30369,48,65,1,10.67,118.64,3687458,3687506
30370,48,59,1,10.67,108.60,3687505,3687553
30371,39,72,2,13.13,208.42,3687552,3687591
30372,45,66,1,11.38,200.41,3687590,3687635
30373,42,68,1,12.19,195.82,3687634,3687676
30374,44,40,0,11.64,121.32,3687675,3687719
30375,47,67,1,10.89,140.48,3687718,3687765
30376,73,61,1,7.01,79.60,3687764,3687837
30377,64,40,1,8.00,53.72,3687837,3687901
30378,75,42,1,6.83,59.21,3687900,3687975
30379,22,178,1,23.27,1681.11,3687974,3687996
30380,65,43,1,7.88,75.40,3687995,3688060
30381,57,95,1,8.98,196.37,3688060,3688117
30382,34,84,1,15.06,260.29,3688116,3688150
30383,39,82,2,13.13,182.21,3688149,3688188
30384,47,100,1,10.89,241.29,3688187,3688234
30385,38,88,1,13.47,275.14,3688233,3688271
30386,57,59,1,8.98,91.25,3688270,3688327
30387,73,43,1,7.01,43.22,3688326,3688399
30388,34,130,1,15.06,592.00,3688398,3688432
30389,53,39,1,9.66,78.87,3688431,3688484
30390,65,36,1,7.88,39.77,3688483,3688548
30391,51,40,1,10.04,65.92,3688547,3688598
30392,51,107,1,10.04,281.41,3688597,3688648
30393,28,150,1,18.29,961.70,3688647,3688675
30394,64,40,1,8.00,63.41,3688674,3688738
30395,49,81,1,10.45,154.37,3688737,3688786
30396,39,47,2,13.13,99.96,3688785,3688824
30397,53,65,1,9.66,124.64,3688823,3688876
30398,48,69,1,10.67,125.39,3688876,3688924
30399,43,52,2,11.91,143.57,3688923,3688966
30400,34,237,2,15.06,1525.82,3688965,3688999
30401,48,69,1,10.67,107.85,3688998,3689046
30402,36,131,1,14.22,555.84,3689045,3689081
30403,37,61,2,13.84,129.05,3689080,3689117
30404,36,35,1,14.22,70.12,3689116,3689152
30405,21,139,2,24.38,851.57,3689151,3689172
30406,55,35,1,9.31,53.41,3689171,3689226
30407,57,54,1,8.98,64.12,3689225,3689282
30408,55,29,1,9.31,41.92,3689281,3689336
30409,36,46,2,14.22,125.06,3689336,3689372
30410,43,53,2,11.91,98.74,3689371,3689414
30411,54,41,1,9.48,70.81,3689413,3689467
30412,37,84,2,13.84,240.41,3689466,3689503
30413,43,37,3,11.91,56.92,3689502,3689545
30414,37,73,2,13.84,197.22,3689544,3689581
30415,54,25,1,9.48,33.73,3689580,3689634
30416,51,48,1,10.04,63.25,3689634,3689685
30417,42,28,3,12.19,44.96,3689684,3689726
30418,35,111,1,14.63,323.89,3689725,3689760
30419,50,34,1,10.24,56.34,3689759,3689809
30420,39,62,1,13.13,141.96,3689808,3689847
30421,53,30,1,9.66,47.21,3689846,3689899
30422,59,53,2,8.68,60.86,3689898,3689957
30423,39,77,2,13.13,224.16,3689956,3689995
30424,37,67,2,13.84,200.95,3689994,3690031
30425,25,96,1,20.48,601.53,3690030,3690055
30426,18,178,3,28.44,1836.91,3690054,3690072
30427,31,102,1,16.52,392.19,3690071,3690102
30428,34,52,3,15.06,171.29,3690101,3690135
30429,46,64,2,11.13,137.20,3690134,3690180
30430,47,45,1,10.89,83.67,3690179,3690226
30431,48,43,1,10.67,82.64,3690225,3690273
30432,52,46,1,9.85,59.82,3690272,3690324
30433,43,63,1,11.91,127.20,3690324,3690367
30434,36,188,1,14.22,920.67,3690366,3690402
30435,40,109,1,12.80,345.71,3690402,3690442
30436,44,44,1,11.64,93.96,3690441,3690485
30437,49,55,1,10.45,134.53,3690484,3690533
30438,47,55,1,10.89,120.99,3690532,3690579
30439,66,38,1,7.76,46.06,3690578,3690644
30440,76,28,1,6.74,28.93,3690643,3690719
30441,56,74,1,9.14,149.41,3690718,3690774
30442,54,104,1,9.48,313.21,3690773,3690827
30443,35,110,1,14.63,373.03,3690826,3690861
30444,72,33,1,7.11,45.10,3690860,3690932
30445,56,53,1,9.14,86.73,3690931,3690987
30446,51,33,1,10.04,63.10,3690987,3691038
30447,69,32,1,7.42,39.29,3691037,3691106
30448,51,34,1,10.04,53.76,3691105,3691156
30449,47,92,1,10.89,224.35,3691155,3691202
30450,81,26,1,6.32,19.97,3691201,3691282
30451,58,48,1,8.83,65.35,3691281,3691339
30452,61,29,1,8.39,36.50,3691338,3691399
30453,45,164,1,11.38,555.79,3691398,3691443
30454,64,46,1,8.00,52.59,3691442,3691506
30455,64,35,1,8.00,45.47,3691506,3691570
30456,49,49,1,10.45,112.49,3691569,3691618
30457,75,27,1,6.83,24.14,3691617,3691692
30458,66,31,1,7.76,45.43,3691692,3691758
30459,54,39,2,9.48,69.14,3691757,3691811
30460,55,31,1,9.31,37.67,3691810,3691865
30461,52,48,1,9.85,83.17,3691864,3691916
30462,57,30,1,8.98,43.07,3691915,3691972
30463,53,36,1,9.66,57.24,3691971,3692024
30464,32,215,2,16.00,1405.62,3692023,3692055
30465,46,48,1,11.13,99.59,3692054,3692100
30466,47,75,1,10.89,119.03,3692099,3692146
30467,46,53,1,11.13,82.85,3692145,3692191
30468,51,35,1,10.04,45.06,3692190,3692241
30469,30,72,4,17.07,230.46,3692240,3692270
30470,39,85,1,13.13,175.55,3692269,3692308
30471,50,86,1,10.24,170.54,3692308,3692358
30472,52,35,1,9.85,54.71,3692357,3692409
30473,55,39,1,9.31,58.76,3692408,3692463
30474,33,87,1,15.52,323.89,3692462,3692495
30475,36,87,2,14.22,287.62,3692494,3692530
30476,52,37,1,9.85,46.36,3692529,3692581
30477,33,88,1,15.52,263.40,3692580,3692613
30478,45,40,2,11.38,66.15,3692613,3692658
30479,41,51,2,12.49,90.88,3692658,3692699
30480,42,102,2,12.19,249.54,3692698,3692740
30481,51,29,2,10.04,40.63,3692739,3692790
30482,41,102,1,12.49,255.96,3692789,3692830
30483,49,32,1,10.45,51.68,3692829,3692878
30484,49,80,1,10.45,157.02,3692877,3692926
30485,44,89,2,11.64,192.82,3692925,3692969
30486,30,78,3,17.07,251.73,3692968,3692998
30487,37,73,1,13.84,195.92,3692997,3693034
30488,17,242,2,30.12,2890.93,3693033,3693050
30489,20,141,2,25.60,958.24,3693050,3693070
30490,37,52,2,13.84,187.60,3693069,3693106
30491,49,39,2,10.45,56.37,3693105,3693154
30492,49,32,1,10.45,62.94,3693153,3693202
30493,49,53,1,10.45,100.57,3693201,3693250
30494,39,85,1,13.13,232.37,3693249,3693288
30495,38,81,2,13.47,246.09,3693287,3693325
30496,57,116,1,8.98,252.82,3693324,3693381
30497,37,76,1,13.84,231.87,3693380,3693417
30498,49,56,1,10.45,140.61,3693416,3693465
30499,52,45,1,9.85,89.86,3693465,3693517
30500,65,52,1,7.88,83.49,3693516,3693581
30501,70,46,1,7.31,75.30,3693580,3693650
30502,49,61,1,10.45,122.61,3693649,3693698
30503,81,60,1,6.32,72.79,3693697,3693778
30504,48,80,1,10.67,143.68,3693777,3693825
30505,59,56,1,8.68,89.24,3693825,3693884
30506,44,84,1,11.64,214.87,3693883,3693927
30507,42,113,1,12.19,362.82,3693926,3693968
30508,57,100,1,8.98,174.65,3693967,3694024
30509,69,29,1,7.42,32.94,3694023,3694092
30510,75,35,1,6.83,30.20,3694091,3694166
30511,52,45,1,9.85,90.94,3694165,3694217
30512,62,57,1,8.26,104.03,3694216,3694278
30513,44,70,1,11.64,183.87,3694277,3694321
30514,67,40,1,7.64,40.80,3694320,3694387
30515,64,107,1,8.00,179.91,3694386,3694450
30516,49,61,1,10.45,120.78,3694449,3694498
30517,66,45,1,7.76,48.49,3694497,3694563
30518,49,71,1,10.45,181.31,3694562,3694611
30519,63,31,1,8.13,27.95,3694611,3694674
30520,53,31,1,9.66,45.28,3694673,3694726
30521,55,25,1,9.31,30.54,3694725,3694780
30522,51,40,1,10.04,51.41,3694779,3694830
30523,45,87,1,11.38,188.86,3694830,3694875
30524,48,54,1,10.67,107.81,3694874,3694922
30525,42,47,1,12.19,103.30,3694921,3694963
30526,32,91,1,16.00,278.38,3694962,3694994
30527,57,29,2,8.98,37.60,3694993,3695050
30528,66,24,1,7.76,23.94,3695049,3695115
30529,53,37,1,9.66,50.07,3695114,3695167
30530,56,39,1,9.14,50.37,3695166,3695222
30531,41,50,1,12.49,75.47,3695221,3695262
30532,34,58,2,15.06,163.17,3695261,3695295
30533,42,50,1,12.19,74.06,3695294,3695336
30534,49,33,1,10.45,49.39,3695335,3695384
30535,56,30,1,9.14,30.12,3695383,3695439
30536,35,50,1,14.63,107.78,3695438,3695473
30537,32,95,1,16.00,431.81,3695472,3695504
30538,51,37,2,10.04,53.17,3695503,3695554
30539,47,45,2,10.89,78.05,3695553,3695600
30540,51,31,1,10.04,45.96,3695599,3695650
30541,52,52,1,9.85,67.36,3695649,3695701
30542,39,59,2,13.13,83.50,3695700,3695739
30543,53,79,1,9.66,137.92,3695738,3695791
30544,53,32,2,9.66,49.62,3695790,3695843
30545,55,30,1,9.31,41.63,3695842,3695897
30546,23,122,3,22.26,969.76,3695896,3695919
30547,57,78,1,8.98,159.10,3695918,3695975
30548,52,36,1,9.85,47.40,3695974,3696026
30549,51,34,1,10.04,58.74,3696025,3696076
30550,27,79,1,18.96,467.22,3696075,3696102
30551,33,69,3,15.52,219.76,3696101,3696134
30552,25,103,1,20.48,726.57,3696133,3696158
30553,15,225,3,34.13,3386.38,3696157,3696172
30554,17,153,2,30.12,1633.75,3696171,3696188
30555,37,46,1,13.84,133.49,3696187,3696224
30556,49,117,1,10.45,310.66,3696223,3696272
30557,53,48,1,9.66,80.49,3696271,3696324
30558,45,31,1,11.38,60.64,3696323,3696368
30559,49,77,1,10.45,142.86,3696367,3696416
30560,39,51,1,13.13,110.98,3696415,3696454
30561,33,189,2,15.52,1000.07,3696453,3696486
30562,26,254,1,19.69,2233.83,3696485,3696511
30563,53,102,1,9.66,202.45,3696510,3696563
30564,48,66,1,10.67,130.72,3696562,3696610
30565,48,42,1,10.67,73.81,3696609,3696657
30566,12,311,2,42.67,7174.39,3696656,3696668
30567,46,45,1,11.13,89.11,3696667,3696713
30568,60,84,1,8.53,144.88,3696712,3696772
30569,61,55,1,8.39,120.01,3696771,3696832
30570,60,45,1,8.53,80.78,3696831,3696891
30571,79,30,1,6.48,42.83,3696890,3696969
30572,41,180,1,12.49,783.96,3696968,3697009
30573,62,50,1,8.26,88.22,3697008,3697070
30574,53,110,1,9.66,292.87,3697069,3697122
30575,77,36,1,6.65,47.66,3697121,3697198
30576,54,32,2,9.48,43.40,3697197,3697251
30577,73,27,1,7.01,31.90,3697250,3697323
30578,52,43,1,9.85,63.82,3697322,3697374
30579,53,68,2,9.66,136.34,3697373,3697426
30580,61,40,1,8.39,58.66,3697425,3697486
30581,76,42,1,6.74,38.80,3697486,3697562
30582,41,74,1,12.49,192.64,3697561,3697602
30583,65,39,1,7.88,48.91,3697602,3697667
30584,49,109,1,10.45,269.51,3697666,3697715
30585,64,56,1,8.00,86.34,3697714,3697778
30586,66,34,1,7.76,53.21,3697777,3697843
30587,53,29,1,9.66,41.62,3697842,3697895
30588,55,42,1,9.31,58.40,3697894,3697949
30589,62,71,1,8.26,102.22,3697948,3698010
30590,60,107,1,8.53,186.95,3698010,3698070
30591,71,29,1,7.21,33.21,3698069,3698140
30592,45,111,2,11.38,276.06,3698139,3698184
30593,47,160,1,10.89,501.54,3698183,3698230
30594,38,142,1,13.47,636.78,3698229,3698267
30595,48,47,1,10.67,91.47,3698266,3698314
30596,58,45,1,8.83,52.83,3698313,3698371
30597,76,23,1,6.74,21.27,3698370,3698446
30598,43,59,1,11.91,145.99,3698445,3698488
30599,49,34,1,10.45,47.59,3698487,3698536
30600,48,66,1,10.67,145.89,3698535,3698583
30601,50,36,2,10.24,58.30,3698582,3698632
30602,36,86,1,14.22,260.06,3698631,3698667
30603,48,45,2,10.67,73.56,3698667,3698715
30604,47,48,2,10.89,73.92,3698714,3698761
30605,29,97,2,17.66,542.85,3698760,3698789
30606,59,66,1,8.68,90.18,3698788,3698847
30607,47,54,1,10.89,101.50,3698846,3698893
30608,54,61,2,9.48,92.95,3698892,3698946
30609,47,38,2,10.89,63.41,3698945,3698992
30610,39,60,3,13.13,119.75,3698991,3699030
30611,44,41,3,11.64,65.64,3699029,3699073
30612,52,49,1,9.85,97.67,3699072,3699124
30613,40,61,2,12.80,149.71,3699123,3699163
30614,57,29,1,8.98,32.02,3699162,3699219
30615,53,37,1,9.66,64.98,3699218,3699271
30616,55,25,1,9.31,33.89,3699270,3699325
30617,43,45,1,11.91,67.34,3699325,3699368
30618,48,45,1,10.67,89.43,3699367,3699415
30619,31,83,2,16.52,345.60,3699414,3699445
30620,57,38,1,8.98,37.42,3699444,3699501
30621,45,78,1,11.38,140.32,3699500,3699545
30622,41,53,2,12.49,119.03,3699544,3699585
30623,22,79,4,23.27,447.56,3699584,3699606
30624,23,97,1,22.26,569.50,3699605,3699628
30625,32,60,2,16.00,233.94,3699627,3699659
30626,43,43,1,11.91,95.94,3699658,3699701
30627,58,46,1,8.83,57.11,3699700,3699758
30628,42,87,1,12.19,238.68,3699757,3699799
30629,48,70,1,10.67,178.18,3699798,3699846
30630,44,53,1,11.64,166.50,3699845,3699889
30631,33,80,1,15.52,308.80,3699888,3699921
30632,43,46,3,11.91,102.22,3699920,3699963
30633,50,39,1,10.24,78.30,3699962,3700012
30634,45,57,1,11.38,117.88,3700011,3700056
30635,35,53,1,14.63,167.83,3700055,3700090
30636,37,141,1,13.84,708.08,3700089,3700126
30637,67,24,1,7.64,35.57,3700125,3700192
30638,70,40,1,7.31,61.27,3700191,3700261
30639,52,83,1,9.85,188.63,3700260,3700312
30640,58,101,1,8.83,184.69,3700311,3700369
30641,27,183,1,18.96,1130.11,3700369,3700396
30642,81,38,1,6.32,51.95,3700395,3700476
30643,63,61,1,8.13,78.78,3700476,3700539
30644,39,41,1,13.13,86.52,3700538,3700577
30645,69,30,1,7.42,41.66,3700576,3700645
30646,62,47,2,8.26,54.13,3700644,3700706
30647,67,39,1,7.64,41.33,3700705,3700772
30648,51,54,1,10.04,95.29,3700771,3700822
30649,58,38,1,8.83,65.80,3700821,3700879
30650,53,64,1,9.66,133.28,3700878,3700931
30651,73,42,1,7.01,45.93,3700930,3701003
30652,59,31,1,8.68,56.25,3701002,3701061
30653,70,63,1,7.31,66.27,3701060,3701130
30654,34,245,1,15.06,1631.35,3701129,3701163
30655,46,96,1,11.13,249.20,3701162,3701208
30656,42,84,1,12.19,238.15,3701207,3701249
30657,54,58,0,9.48,85.81,3701248,3701302
30658,55,50,2,9.31,90.94,3701301,3701356
30659,56,43,1,9.14,81.91,3701355,3701411
30660,68,23,1,7.53,22.51,3701410,3701478
30661,47,51,1,10.89,88.90,3701477,3701524
30662,58,27,1,8.83,29.97,3701523,3701581
30663,46,63,1,11.13,83.98,3701580,3701626
30664,45,39,2,11.38,81.52,3701625,3701670
30665,35,72,2,14.63,235.43,3701670,3701705
30666,35,96,2,14.63,280.98,3701704,3701739
30667,42,62,2,12.19,197.54,3701738,3701780
30668,43,48,1,11.91,107.15,3701779,3701822
30669,51,36,1,10.04,53.14,3701821,3701872
30670,44,60,1,11.64,104.69,3701871,3701915
30671,50,38,1,10.24,69.22,3701914,3701964
30672,29,127,4,17.66,507.81,3701963,3701992
30673,38,75,2,13.47,184.57,3701991,3702029
30674,37,79,1,13.84,231.43,3702028,3702065
30675,48,74,1,10.67,139.47,3702064,3702112
30676,49,46,1,10.45,73.76,3702111,3702160
30677,40,46,2,12.80,63.01,3702159,3702199
30678,41,97,2,12.49,213.76,3702198,3702239
30679,52,26,1,9.85,37.05,3702238,3702290
30680,34,59,2,15.06,132.41,3702289,3702323
30681,56,27,1,9.14,34.69,3702322,3702378
30682,50,30,1,10.24,42.50,3702377,3702427
30683,47,62,2,10.89,124.52,3702426,3702473
30684,40,49,3,12.80,120.86,3702472,3702512
30685,44,34,3,11.64,44.32,3702512,3702556
30686,41,60,1,12.49,164.35,3702555,3702596
30687,62,56,1,8.26,68.19,3702595,3702657
30688,43,52,3,11.91,112.69,3702656,3702699
30689,34,134,2,15.06,630.94,3702698,3702732
30690,37,52,1,13.84,119.22,3702731,3702768
30691,18,209,1,28.44,2875.91,3702767,3702785
30692,22,68,1,23.27,483.11,3702784,3702806
30693,14,241,2,36.57,3453.53,3702805,3702819
30694,29,90,3,17.66,335.12,3702818,3702847
30695,39,67,2,13.13,135.09,3702846,3702885
30696,52,67,1,9.85,100.75,3702884,3702936
30697,43,45,1,11.91,111.06,3702935,3702978
30698,58,51,1,8.83,65.52,3702977,3703035
30699,37,84,1,13.84,279.70,3703034,3703071
30700,32,124,2,16.00,447.25,3703070,3703102
30701,46,47,1,11.13,80.29,3703101,3703147
30702,41,73,1,12.49,225.62,3703146,3703187
30703,39,120,2,13.13,403.80,3703186,3703225
30704,41,78,1,12.49,295.37,3703224,3703265
30705,46,78,2,11.13,220.94,3703264,3703310
30706,57,33,1,8.98,55.98,3703309,3703366
30707,56,49,1,9.14,104.48,3703365,3703421
30708,75,61,1,6.83,70.70,3703420,3703495
30709,34,191,1,15.06,996.64,3703494,3703528
30710,32,122,1,16.00,562.50,3703527,3703559
30711,82,36,1,6.24,42.33,3703558,3703640
30712,53,37,1,9.66,73.32,3703639,3703692
30713,76,41,1,6.74,63.98,3703691,3703767
30714,56,27,1,9.14,34.87,3703766,3703822
30715,58,37,1,8.83,71.80,3703821,3703879
30716,60,64,1,8.53,86.72,3703878,3703938
30717,76,27,1,6.74,26.30,3703937,3704013
30718,39,178,2,13.13,782.21,3704012,3704051
30719,77,24,1,6.65,26.25,3704050,3704127
30720,46,69,1,11.13,140.90,3704126,3704172
30721,62,41,1,8.26,42.93,3704171,3704233
30722,56,41,1,9.14,66.80,3704232,3704288
30723,72,40,1,7.11,48.35,3704287,3704359
30724,60,57,1,8.53,79.52,3704358,3704418
30725,61,31,1,8.39,41.06,3704417,3704478
30726,63,36,1,8.13,51.92,3704477,3704540
30727,47,75,1,10.89,207.84,3704539,3704586
30728,57,51,1,8.98,89.42,3704585,3704642
30729,36,103,2,14.22,277.73,3704641,3704677
30730,48,68,1,10.67,153.06,3704676,3704724
30731,57,26,1,8.98,34.61,3704723,3704780
30732,52,44,1,9.85,83.90,3704780,3704832
30733,53,41,1,9.66,52.75,3704831,3704884
30734,55,83,1,9.31,138.32,3704883,3704938
30735,53,33,1,9.66,43.47,3704937,3704990
30736,52,42,1,9.85,70.59,3704989,3705041
30737,53,37,1,9.66,59.62,3705040,3705093
30738,37,110,1,13.84,325.22,3705092,3705129
30739,46,40,1,11.13,68.20,3705128,3705174
30740,44,65,1,11.64,118.00,3705173,3705217
30741,52,65,2,9.85,112.75,3705216,3705268
30742,56,31,2,9.14,43.27,3705267,3705323
30743,50,32,1,10.24,45.38,3705322,3705372
30744,57,30,1,8.98,34.44,3705371,3705428
30745,43,47,2,11.91,123.94,3705427,3705470
30746,46,44,3,11.13,66.81,3705469,3705515
30747,41,81,2,12.49,214.69,3705514,3705555
30748,55,47,2,9.31,52.72,3705554,3705609
30749,42,70,1,12.19,153.73,3705609,3705651
30750,39,52,2,13.13,96.16,3705651,3705690
30751,32,76,1,16.00,218.44,3705689,3705721
30752,44,56,2,11.64,92.87,3705720,3705764
30753,45,53,1,11.38,78.90,3705764,3705809
30754,52,36,1,9.85,52.59,3705808,3705860
30755,54,36,1,9.48,38.73,3705859,3705913
30756,38,73,1,13.47,182.78,3705912,3705950
30757,44,63,1,11.64,108.19,3705949,3705993
30758,48,45,1,10.67,88.64,3705992,3706040
30759,54,50,1,9.48,116.51,3706039,3706093
30760,42,80,1,12.19,165.77,3706092,3706134
30761,52,35,1,9.85,63.21,3706133,3706185
30762,31,125,1,16.52,579.67,3706184,3706215
30763,33,86,1,15.52,354.37,3706214,3706247
30764,27,82,1,18.96,348.11,3706246,3706273
30765,19,80,1,26.95,716.58,3706272,3706291
30766,25,110,3,20.48,463.13,3706290,3706315
30767,38,94,1,13.47,240.62,3706314,3706352
30768,53,36,2,9.66,58.53,3706351,3706404
30769,45,42,1,11.38,108.64,3706403,3706448
30770,29,239,1,17.66,1815.81,3706447,3706476
30771,57,53,1,8.98,78.37,3706476,3706533
30772,50,73,1,10.24,129.82,3706532,3706582
30773,33,103,3,15.52,335.89,3706581,3706614
30774,33,72,1,15.52,272.80,3706613,3706646
30775,52,58,1,9.85,113.25,3706645,3706697
30776,53,83,0,9.66,162.49,3706696,3706749
30777,47,46,1,10.89,116.31,3706748,3706795
30778,37,124,1,13.84,521.05,3706794,3706831
30779,45,158,1,11.38,560.46,3706830,3706875
30780,38,84,1,13.47,232.35,3706874,3706912
30781,42,136,1,12.19,525.25,3706911,3706953
30782,62,107,1,8.26,223.51,3706952,3707014
30783,56,42,1,9.14,54.98,3707013,3707069
30784,76,59,1,6.74,80.88,3707068,3707144
30785,61,29,1,8.39,37.03,3707143,3707204
30786,60,28,1,8.53,42.48,3707203,3707263
30787,59,68,1,8.68,90.83,3707262,3707321
30788,57,44,1,8.98,58.68,3707320,3707377
30789,45,137,1,11.38,392.10,3707376,3707421
30790,76,24,1,6.74,21.56,3707420,3707496
30791,46,82,1,11.13,164.98,3707495,3707541
30792,58,46,1,8.83,83.66,3707540,3707598
30793,58,34,1,8.83,44.63,3707597,3707655
30794,55,42,1,9.31,92.36,3707654,3707709
30795,66,24,1,7.76,35.64,3707708,3707774
30796,57,55,1,8.98,101.67,3707773,3707830
30797,58,60,1,8.83,89.76,3707830,3707888
30798,51,114,1,10.04,252.27,3707887,3707938
30799,62,40,1,8.26,44.58,3707937,3707999
30800,55,31,1,9.31,52.65,3707998,3708053
30801,53,57,1,9.66,114.04,3708052,3708105
30802,31,108,1,16.52,506.38,3708104,3708135
30803,31,217,1,16.52,1389.80,3708134,3708165
30804,55,69,1,9.31,96.14,3708164,3708219
30805,55,45,2,9.31,55.01,3708219,3708274
30806,57,24,1,8.98,28.75,3708273,3708330
30807,43,47,1,11.91,91.11,3708329,3708372
30808,55,32,1,9.31,50.18,3708371,3708426
30809,55,35,1,9.31,45.60,3708425,3708480
30810,43,33,1,11.91,64.27,3708479,3708522
30811,31,89,1,16.52,313.80,3708521,3708552
30812,40,76,1,12.80,248.96,3708551,3708591
30813,60,40,1,8.53,55.02,3708590,3708650
30814,47,35,1,10.89,48.10,3708649,3708696
30815,41,36,2,12.49,78.74,3708695,3708736
30816,42,50,1,12.19,101.34,3708735,3708777
30817,49,59,1,10.45,93.15,3708776,3708825
30818,46,60,2,11.13,125.72,3708824,3708870
30819,41,36,2,12.49,72.05,3708869,3708910
30820,35,67,1,14.63,173.78,3708909,3708944
30821,42,41,1,12.19,67.06,3708944,3708986
30822,45,63,1,11.38,112.99,3708985,3709030
30823,38,68,2,13.47,148.09,3709029,3709067
30824,46,34,1,11.13,76.64,3709066,3709112
30825,39,59,2,13.13,140.01,3709111,3709150
30826,51,29,1,10.04,48.74,3709149,3709200
30827,67,41,1,7.64,37.93,3709199,3709266
30828,35,65,1,14.63,161.83,3709265,3709300
30829,43,71,1,11.91,149.53,3709299,3709342
30830,27,78,1,18.96,406.78,3709341,3709368
30831,20,106,1,25.60,697.44,3709367,3709387
30832,21,142,1,24.38,971.38,3709386,3709407
30833,29,76,2,17.66,289.61,3709406,3709435
30834,38,73,2,13.47,169.09,3709434,3709472
30835,52,44,1,9.85,77.05,3709471,3709523
30836,50,41,1,10.24,67.62,3709522,3709572
30837,39,54,1,13.13,131.09,3709571,3709610
30838,34,60,1,15.06,248.82,3709609,3709643
30839,38,86,2,13.47,221.09,3709642,3709680
30840,68,27,1,7.53,29.37,3709679,3709747
30841,33,99,1,15.52,386.67,3709746,3709779
30842,48,42,1,10.67,90.22,3709778,3709826
30843,62,29,1,8.26,38.45,3709826,3709888
30844,72,38,1,7.11,65.96,3709887,3709959
30845,21,194,1,24.38,1588.43,3709958,3709979
30846,58,45,1,8.83,100.63,3709978,3710036
30847,66,83,1,7.76,132.88,3710035,3710101
30848,75,34,1,6.83,45.18,3710100,3710175
30849,51,79,1,10.04,154.70,3710174,3710225
30850,84,25,1,6.10,18.71,3710224,3710308
30851,59,68,1,8.68,124.32,3710307,3710366
30852,69,22,1,7.42,24.42,3710365,3710434
30853,51,54,1,10.04,113.17,3710433,3710484
30854,58,26,1,8.83,29.28,3710484,3710542
30855,53,68,1,9.66,130.30,3710541,3710594
30856,56,63,1,9.14,86.23,3710593,3710649
30857,50,72,1,10.24,166.70,3710649,3710699
30858,77,33,1,6.65,36.88,3710698,3710775
30859,72,26,1,7.11,28.99,3710774,3710846
30860,25,229,3,20.48,1910.17,3710845,3710870
30861,64,34,1,8.00,40.91,3710869,3710933
30862,65,38,1,7.88,36.54,3710932,3710997
30863,76,24,1,6.74,19.96,3710996,3711072
30864,46,47,1,11.13,88.77,3711071,3711117
30865,53,57,1,9.66,71.17,3711116,3711169
30866,49,43,1,10.45,66.70,3711168,3711217
30867,37,53,2,13.84,126.08,3711216,3711253
30868,38,46,1,13.47,124.35,3711253,3711291
30869,53,33,1,9.66,54.26,3711290,3711343
30870,27,214,1,18.96,1532.55,3711342,3711369
30871,51,77,1,10.04,132.70,3711368,3711419
30872,43,50,3,11.91,89.39,3711419,3711462
30873,35,64,1,14.63,193.89,3711461,3711496
30874,46,30,2,11.13,44.42,3711495,3711541
30875,35,46,2,14.63,140.92,3711540,3711575
30876,50,71,1,10.24,110.62,3711574,3711624
30877,25,84,3,20.48,272.57,3711623,3711648
30878,50,44,2,10.24,58.38,3711647,3711697
30879,51,39,1,10.04,52.94,3711696,3711747
30880,50,34,1,10.24,55.54,3711747,3711797
30881,45,35,3,11.38,51.84,3711796,3711841
30882,43,44,1,11.91,90.08,3711840,3711883
30883,47,26,1,10.89,34.01,3711882,3711929
30884,33,147,1,15.52,681.34,3711928,3711961
30885,56,34,2,9.14,73.09,3711960,3712016
30886,36,48,3,14.22,115.45,3712015,3712051
30887,41,84,1,12.49,201.86,3712050,3712091
30888,34,67,1,15.06,242.00,3712090,3712124
30889,26,103,2,19.69,504.67,3712123,3712149
30890,14,250,1,36.57,3940.10,3712148,3712162
30891,30,54,2,17.07,144.46,3712161,3712191
30892,52,41,1,9.85,53.01,3712190,3712242
30893,51,45,2,10.04,70.90,3712241,3712292
30894,57,28,1,8.98,38.09,3712291,3712348
30895,37,87,1,13.84,268.08,3712347,3712384
30896,47,80,1,10.89,184.44,3712383,3712430
30897,59,30,1,8.68,46.42,3712429,3712488
30898,59,49,1,8.68,97.61,3712487,3712546
30899,39,56,1,13.13,201.96,3712545,3712584
30900,53,55,1,9.66,89.05,3712584,3712637
30901,45,88,1,11.38,198.72,3712636,3712681
30902,75,61,1,6.83,72.12,3712680,3712755
30903,62,61,1,8.26,86.55,3712754,3712816
30904,58,74,1,8.83,140.42,3712816,3712874
30905,76,34,1,6.74,44.69,3712873,3712949
30906,66,26,1,7.76,38.00,3712948,3713014
30907,54,59,1,9.48,131.95,3713013,3713067
30908,44,64,1,11.64,204.46,3713067,3713111
30909,51,52,1,10.04,98.51,3713110,3713161
30910,57,71,1,8.98,107.25,3713160,3713217
30911,62,53,1,8.26,72.06,3713216,3713278
30912,55,56,1,9.31,78.94,3713277,3713332
30913,49,42,1,10.45,88.82,3713331,3713380
30914,49,40,1,10.45,82.61,3713379,3713428
30915,67,32,1,7.64,48.23,3713427,3713494
30916,41,134,1,12.49,463.96,3713494,3713535
30917,52,127,1,9.85,298.40,3713534,3713586
30918,52,109,1,9.85,348.40,3713585,3713637
30919,69,25,1,7.42,24.24,3713636,3713705
30920,52,72,1,9.85,183.17,3713704,3713756
30921,48,104,1,10.67,223.22,3713755,3713803
30922,48,63,2,10.67,102.56,3713802,3713850
30923,66,22,1,7.76,25.61,3713849,3713915
30924,63,49,1,8.13,55.86,3713914,3713977
30925,47,27,1,10.89,37.12,3713976,3714023
30926,48,41,2,10.67,51.43,3714023,3714071
30927,49,42,1,10.45,63.51,3714070,3714119
30928,50,37,1,10.24,53.18,3714118,3714168
30929,48,37,2,10.67,46.68,3714167,3714215
30930,37,64,1,13.84,146.73,3714214,3714251
30931,54,34,2,9.48,49.32,3714250,3714304
30932,48,39,2,10.67,75.85,3714303,3714351
30933,35,86,1,14.63,238.06,3714350,3714385
30934,56,33,1,9.14,45.30,3714384,3714440
30935,47,61,1,10.89,129.97,3714439,3714486
30936,40,42,2,12.80,75.01,3714485,3714525
30937,48,49,2,10.67,78.35,3714524,3714572
30938,40,55,2,12.80,143.21,3714571,3714611
30939,47,34,2,10.89,76.65,3714610,3714657
30940,41,29,1,12.49,65.37,3714656,3714697
30941,37,80,1,13.84,211.00,3714697,3714734
30942,46,41,2,11.13,65.81,3714733,3714779
30943,47,49,2,10.89,81.63,3714778,3714825
30944,38,43,1,13.47,115.20,3714824,3714862
30945,41,60,3,12.49,93.23,3714861,3714902
30946,49,37,1,10.45,73.96,3714901,3714950
30947,51,47,1,10.04,105.84,3714949,3715000
30948,56,33,1,9.14,40.84,3714999,3715055
30949,46,62,1,11.13,110.50,3715054,3715100
30950,48,94,1,10.67,191.81,3715099,3715147
30951,48,32,1,10.67,46.72,3715146,3715194
30952,49,52,1,10.45,73.47,3715193,3715242
30953,29,70,2,17.66,344.29,3715241,3715270
30954,22,100,2,23.27,523.74,3715269,3715291
30955,29,96,2,17.66,524.57,3715290,3715319
30956,31,57,1,16.52,221.67,3715318,3715349
30957,21,155,2,24.38,1156.81,3715348,3715369
30958,33,146,1,15.52,629.04,3715368,3715401
30959,22,266,1,23.27,2947.65,3715400,3715422
30960,52,52,2,9.85,60.67,3715421,3715473
30961,39,88,1,13.13,203.91,3715472,3715511
30962,51,44,1,10.04,104.82,3715510,3715561
30963,50,31,1,10.24,48.30,3715560,3715610
30964,37,50,2,13.84,117.87,3715609,3715646
30965,36,57,1,14.22,161.23,3715645,3715681
30966,55,35,1,9.31,62.54,3715680,3715735
30967,48,49,1,10.67,98.51,3715734,3715782
30968,33,190,1,15.52,1043.70,3715781,3715814
30969,37,70,1,13.84,229.43,3715813,3715850
30970,31,144,1,16.52,768.38,3715849,3715880
30971,51,46,1,10.04,96.27,3715879,3715930
30972,66,57,1,7.76,86.55,3715929,3715995
30973,45,48,1,11.38,112.01,3715995,3716040
30974,66,45,1,7.76,76.79,3716039,3716105
30975,64,51,1,8.00,85.28,3716104,3716168
30976,78,37,1,6.56,49.55,3716168,3716246
30977,47,41,1,10.89,91.37,3716245,3716292
30978,45,57,1,11.38,116.59,3716291,3716336
30979,69,66,1,7.42,71.26,3716335,3716404
30980,51,48,1,10.04,77.17,3716403,3716454
30981,50,79,1,10.24,184.90,3716453,3716503
30982,68,74,1,7.53,94.04,3716502,3716570
30983,51,49,1,10.04,98.90,3716569,3716620
30984,59,51,1,8.68,71.20,3716619,3716678
30985,53,39,1,9.66,61.62,3716678,3716731
30986,47,38,1,10.89,93.29,3716730,3716777
30987,65,62,1,7.88,71.25,3716776,3716841
30988,38,172,1,13.47,833.41,3716840,3716878
30989,56,44,1,9.14,60.55,3716877,3716933
30990,61,34,1,8.39,39.35,3716932,3716993
30991,70,44,1,7.31,55.62,3716992,3717062
30992,50,79,1,10.24,167.10,3717061,3717111
30993,29,145,1,17.66,970.43,3717110,3717139
30994,52,36,1,9.85,77.55,3717138,3717190
30995,44,41,2,11.64,82.46,3717189,3717233
30996,42,52,1,12.19,104.11,3717232,3717274
30997,62,45,1,8.26,55.45,3717273,3717335
30998,52,56,1,9.85,104.51,3717334,3717386
30999,51,42,1,10.04,75.29,3717385,3717436
31000,38,66,2,13.47,175.93,3717435,3717473
31001,49,64,1,10.45,111.92,3717472,3717521
31002,40,55,2,12.80,152.41,3717521,3717561
31003,37,72,2,13.84,193.43,3717560,3717597
31004,41,35,1,12.49,66.59,3717596,3717637
31005,39,38,2,13.13,64.47,3717636,3717675
31006,52,44,1,9.85,69.51,3717674,3717726
31007,48,67,2,10.67,114.18,3717725,3717773
31008,54,28,1,9.48,37.40,3717772,3717826
31009,49,41,1,10.45,67.55,3717825,3717874
31010,33,78,1,15.52,225.16,3717873,3717906
31011,43,48,1,11.91,92.74,3717905,3717948
31012,41,115,1,12.49,311.62,3717947,3717988
31013,54,49,1,9.48,62.58,3717987,3718041
31014,42,55,2,12.19,138.73,3718040,3718082
31015,42,37,1,12.19,78.92,3718081,3718123
31016,40,72,2,12.80,214.91,3718122,3718162
31017,56,22,1,9.14,31.30,3718161,3718217
31018,52,31,1,9.85,45.40,3718216,3718268
31019,42,84,2,12.19,200.96,3718267,3718309
31020,42,50,2,12.19,89.73,3718308,3718350
31021,35,58,1,14.63,154.63,3718349,3718384
31022,44,76,1,11.64,160.05,3718383,3718427
31023,50,53,1,10.24,62.74,3718427,3718477
31024,32,143,3,16.00,594.31,3718476,3718508
31025,49,40,2,10.45,71.88,3718508,3718557
31026,56,94,1,9.14,200.55,3718556,3718612
31027,48,34,2,10.67,40.39,3718612,3718660
31028,43,82,1,11.91,178.50,3718659,3718702
31029,36,53,1,14.22,175.90,3718701,3718737
31030,26,75,3,19.69,304.52,3718736,3718762
31031,27,68,4,18.96,219.37,3718761,3718788
31032,26,174,2,19.69,1090.98,3718787,3718813
31033,32,60,2,16.00,216.44,3718812,3718844
31034,50,52,1,10.24,100.70,3718843,3718893
31035,47,73,2,10.89,161.41,3718892,3718939
31036,50,50,1,10.24,102.54,3718938,3718988
31037,49,54,1,10.45,111.59,3718987,3719036
31038,35,93,1,14.63,416.23,3719035,3719070
31039,45,68,1,11.38,152.90,3719069,3719114
31040,46,51,1,11.13,95.24,3719113,3719159
31041,25,126,2,20.48,758.73,3719158,3719183
31042,55,52,1,9.31,87.70,3719182,3719237
31043,41,58,1,12.49,198.30,3719236,3719277
31044,50,53,1,10.24,110.10,3719276,3719326
31045,37,52,1,13.84,168.46,3719325,3719362
31046,77,44,1,6.65,49.58,3719361,3719438
31047,53,56,1,9.66,105.02,3719438,3719491
31048,61,80,1,8.39,132.37,3719490,3719551
31049,58,47,1,8.83,117.38,3719550,3719608
31050,45,67,1,11.38,165.12,3719607,3719652
31051,84,43,1,6.10,53.30,3719651,3719735
31052,51,109,1,10.04,233.02,3719734,3719785
31053,65,33,1,7.88,42.60,3719785,3719850
31054,57,36,1,8.98,56.72,3719849,3719906
31055,67,20,1,7.64,26.89,3719905,3719972
31056,42,154,1,12.19,566.01,3719972,3720014
31057,70,39,1,7.31,48.59,3720013,3720083
31058,56,47,1,9.14,72.52,3720083,3720139
31059,71,34,1,7.21,41.04,3720138,3720209
31060,44,103,1,11.64,280.19,3720208,3720252
31061,52,133,1,9.85,329.09,3720251,3720303
31062,60,55,1,8.53,80.28,3720302,3720362
31063,62,46,1,8.26,56.29,3720361,3720423
31064,55,105,1,9.31,229.38,3720422,3720477
31065,56,37,1,9.14,66.87,3720476,3720532
31066,38,144,2,13.47,526.20,3720531,3720569
31067,34,109,2,15.06,394.76,3720569,3720603
31068,68,43,1,7.53,47.31,3720602,3720670
31069,51,50,1,10.04,74.90,3720669,3720720
31070,69,25,1,7.42,26.27,3720719,3720788
31071,64,27,1,8.00,28.38,3720787,3720851
31072,54,39,1,9.48,47.10,3720850,3720904
31073,45,85,1,11.38,166.99,3720903,3720948
31074,37,54,1,13.84,135.43,3720947,3720984
31075,36,52,1,14.22,149.40,3720983,3721019
31076,53,45,1,9.66,67.55,3721018,3721071
31077,45,73,1,11.38,152.32,3721070,3721115
31078,65,26,1,7.88,26.45,3721114,3721179
31079,31,97,1,16.52,419.86,3721178,3721209
31080,48,33,2,10.67,43.06,3721208,3721256
31081,44,53,2,11.64,111.87,3721255,3721299
31082,51,38,1,10.04,59.96,3721298,3721349
31083,41,51,2,12.49,97.13,3721348,3721389
31084,29,122,2,17.66,551.74,3721388,3721417
31085,44,97,1,11.64,239.05,3721416,3721460
31086,52,64,1,9.85,136.44,3721459,3721511
31087,45,49,2,11.38,97.66,3721510,3721555
31088,39,62,1,13.13,207.75,3721554,3721593
31089,41,37,2,12.49,77.32,3721592,3721633
31090,50,51,1,10.24,107.62,3721632,3721682
31091,49,40,1,10.45,76.66,3721681,3721730
31092,37,66,2,13.84,203.22,3721729,3721766
31093,32,54,2,16.00,179.50,3721765,3721797
31094,31,63,1,16.52,247.15,3721796,3721827
31095,15,107,3,34.13,653.72,3721826,3721841
31096,23,111,2,22.26,625.32,3721840,3721863
31097,22,105,1,23.27,841.29,3721862,3721884
31098,50,56,1,10.24,97.02,3721883,3721933
31099,35,41,2,14.63,86.40,3721932,3721967
31100,43,52,2,11.91,115.25,3721966,3722009
31101,42,80,1,12.19,205.06,3722008,3722050
31102,44,41,1,11.64,96.78,3722049,3722093
31103,41,42,2,12.49,87.32,3722092,3722133
31104,45,48,2,11.38,82.90,3722132,3722177
31105,44,120,1,11.64,375.14,3722176,3722220
31106,40,48,2,12.80,103.86,3722219,3722259
31107,37,84,1,13.84,288.73,3722258,3722295
31108,43,103,1,11.91,322.69,3722294,3722337
31109,61,47,1,8.39,79.52,3722336,3722397
31110,72,53,1,7.11,101.43,3722396,3722468
31111,37,56,2,13.84,143.54,3722467,3722504
31112,71,44,1,7.21,70.73,3722503,3722574
31113,25,106,1,20.48,899.29,3722573,3722598
31114,37,57,1,13.84,230.62,3722597,3722634
31115,57,70,1,8.98,138.26,3722633,3722690
31116,63,30,1,8.13,37.54,3722690,3722753
31117,48,38,1,10.67,108.18,3722752,3722800
31118,54,38,1,9.48,66.51,3722799,3722853
31119,35,81,1,14.63,256.06,3722852,3722887
31120,35,146,1,14.63,605.95,3722886,3722921
31121,34,78,1,15.06,437.82,3722921,3722955
31122,60,61,1,8.53,70.55,3722954,3723014
31123,53,43,2,9.66,61.58,3723013,3723066
31124,42,72,1,12.19,132.82,3723065,3723107
31125,43,49,1,11.91,108.64,3723106,3723149
31126,58,65,1,8.83,116.07,3723148,3723206
31127,50,55,2,10.24,89.78,3723205,3723255
31128,44,41,1,11.64,105.14,3723254,3723298
31129,43,43,1,11.91,117.81,3723297,3723340
31130,42,169,1,12.19,640.39,3723339,3723381
31131,52,74,1,9.85,153.36,3723380,3723432
31132,36,134,2,14.22,529.06,3723431,3723467
31133,44,114,1,11.64,340.37,3723466,3723510
31134,28,77,2,18.29,542.42,3723509,3723537
31135,22,168,1,23.27,1314.93,3723536,3723558
31136,57,34,1,8.98,52.23,3723557,3723614
31137,46,55,1,11.13,125.50,3723613,3723659
31138,40,55,1,12.80,180.96,3723658,3723698
31139,41,90,1,12.49,223.23,3723697,3723738
31140,39,116,1,13.13,326.01,3723737,3723776
31141,47,70,1,10.89,113.97,3723775,3723822
31142,53,32,1,9.66,53.85,3723821,3723874
31143,41,35,1,12.49,85.52,3723873,3723914
31144,32,96,2,16.00,283.81,3723913,3723945
31145,29,66,1,17.66,230.16,3723944,3723973
31146,55,44,1,9.31,63.27,3723972,3724027
31147,30,209,2,17.07,1348.13,3724026,3724056
31148,54,47,1,9.48,65.69,3724055,3724109
31149,46,43,1,11.13,79.16,3724108,3724154
31150,37,53,2,13.84,107.97,3724154,3724191
31151,36,54,1,14.22,167.17,3724190,3724226
31152,43,48,1,11.91,116.88,3724225,3724268
31153,50,55,1,10.24,99.82,3724267,3724317
31154,43,82,2,11.91,159.48,3724316,3724359
31155,44,43,1,11.64,88.28,3724358,3724402
31156,41,86,3,12.49,163.27,3724401,3724442
31157,43,49,2,11.91,95.76,3724441,3724484
31158,46,65,1,11.13,110.59,3724483,3724529
31159,43,60,1,11.91,144.46,3724528,3724571
31160,55,32,1,9.31,43.34,3724570,3724625
31161,44,42,2,11.64,71.37,3724625,3724669
31162,47,49,1,10.89,78.73,3724668,3724715
31163,40,110,1,12.80,350.41,3724714,3724754
31164,53,38,2,9.66,47.39,3724753,3724806
31165,51,35,1,10.04,56.67,3724805,3724856
31166,32,68,1,16.00,342.00,3724855,3724887
31167,32,61,2,16.00,162.88,3724886,3724918
31168,6,281,5,85.33,10947.56,3724917,3724923
31169,9,375,1,56.89,12824.32,3724923,3724932
31170,31,53,1,16.52,170.51,3724931,3724962
31171,19,99,2,26.95,801.84,3724961,3724980
31172,34,62,1,15.06,199.29,3724979,3725013
31173,53,29,1,9.66,50.07,3725012,3725065
31174,57,29,1,8.98,26.54,3725064,3725121
31175,39,82,1,13.13,257.50,3725120,3725159
31176,45,48,1,11.38,107.75,3725158,3725203
31177,39,57,2,13.13,149.75,3725202,3725241
31178,36,80,3,14.22,214.78,3725240,3725276
31179,44,166,1,11.64,619.55,3725275,3725319
31180,41,64,1,12.49,161.57,3725318,3725359
31181,57,42,1,8.98,56.44,3725358,3725415
31182,50,122,1,10.24,443.90,3725414,3725464
31183,29,127,1,17.66,641.81,3725463,3725492
31184,45,80,1,11.38,188.32,3725491,3725536
31185,53,52,1,9.66,101.55,3725535,3725588
31186,58,70,1,8.83,103.35,3725587,3725645
31187,64,60,1,8.00,69.47,3725644,3725708
31188,63,53,1,8.13,102.43,3725707,3725770
31189,58,100,1,8.83,191.38,3725769,3725827
31190,73,62,1,7.01,76.23,3725826,3725899
31191,49,116,1,10.45,314.49,3725898,3725947
31192,34,210,1,15.06,1243.88,3725946,3725980
31193,47,58,1,10.89,166.73,3725979,3726026
31194,65,77,1,7.88,169.12,3726025,3726090
31195,69,81,1,7.42,111.63,3726089,3726158
31196,56,30,1,9.14,40.12,3726158,3726214
31197,59,31,1,8.68,39.57,3726213,3726272
31198,54,47,1,9.48,64.21,3726272,3726326
31199,75,28,1,6.83,24.30,3726326,3726401
31200,46,136,1,11.13,583.64,3726400,3726446
31201,60,34,1,8.53,47.08,3726445,3726505
31202,50,55,2,10.24,107.86,3726504,3726554
31203,53,57,1,9.66,97.39,3726553,3726606
31204,56,42,1,9.14,70.80,3726605,3726661
31205,53,41,2,9.66,88.75,3726661,3726714
31206,48,82,1,10.67,173.72,3726713,3726761
31207,51,93,1,10.04,167.25,3726760,3726811
31208,61,38,1,8.39,82.50,3726810,3726871
31209,54,98,1,9.48,193.77,3726870,3726924
31210,58,58,1,8.83,76.73,3726923,3726981
31211,50,58,1,10.24,150.78,3726980,3727030
31212,34,145,2,15.06,773.17,3727029,3727063
31213,28,197,1,18.29,1885.85,3727063,3727091
31214,38,167,1,13.47,692.04,3727090,3727128
31215,54,78,1,9.48,111.40,3727127,3727181
31216,64,57,1,8.00,62.69,3727180,3727244
31217,54,34,1,9.48,63.06,3727243,3727297
31218,47,33,1,10.89,49.88,3727296,3727343
31219,44,70,2,11.64,141.41,3727342,3727386
31220,47,54,1,10.89,82.05,3727385,3727432
31221,35,74,1,14.63,167.26,3727431,3727466
31222,42,64,3,12.19,96.11,3727465,3727507
31223,35,29,3,14.63,65.20,3727506,3727541
31224,52,34,1,9.85,59.71,3727541,3727593
31225,52,45,2,9.85,86.44,3727592,3727644
31226,62,47,1,8.26,53.19,3727643,3727705
31227,30,53,4,17.07,161.20,3727705,3727735
31228,35,76,1,14.63,201.49,3727734,3727769
31229,36,87,1,14.22,207.34,3727768,3727804
31230,44,67,2,11.64,117.87,3727803,3727847
31231,48,30,1,10.67,45.22,3727846,3727894
31232,29,113,1,17.66,506.43,3727893,3727922
31233,42,34,1,12.19,74.68,3727921,3727963
31234,38,33,1,13.47,66.67,3727962,3728000
31235,36,118,1,14.22,368.67,3727999,3728035
31236,43,157,1,11.91,532.92,3728034,3728077
31237,40,54,3,12.80,125.86,3728076,3728116
31238,42,49,2,12.19,88.58,3728115,3728157
31239,59,25,2,8.68,25.00,3728156,3728215
31240,34,89,1,15.06,288.29,3728214,3728248
31241,44,97,2,11.64,235.73,3728247,3728291
31242,61,25,1,8.39,29.29,3728290,3728351
31243,38,61,2,13.47,178.93,3728350,3728388
31244,30,88,1,17.07,451.26,3728387,3728417
31245,24,92,4,21.33,365.39,3728417,3728441
31246,24,96,2,21.33,525.56,3728440,3728464
31247,42,92,2,12.19,221.77,3728463,3728505
31248,52,51,1,9.85,93.48,3728504,3728556
31249,47,52,2,10.89,73.97,3728555,3728602
31250,48,42,1,10.67,77.22,3728601,3728649
31251,51,89,2,10.04,168.00,3728648,3728699
31252,41,64,1,12.49,138.20,3728698,3728739
31253,39,53,1,13.13,93.65,3728738,3728777
31254,44,52,1,11.64,90.64,3728776,3728820
31255,41,110,3,12.49,302.79,3728819,3728860
31256,60,56,1,8.53,113.05,3728859,3728919
31257,43,35,1,11.91,97.43,3728918,3728961
31258,44,79,1,11.64,216.87,3728960,3729004
31259,38,109,1,13.47,380.09,3729003,3729041
31260,54,62,1,9.48,121.88,3729040,3729094
31261,66,68,1,7.76,97.24,3729093,3729159
31262,72,35,1,7.11,54.43,3729158,3729230
31263,49,44,1,10.45,99.47,3729229,3729278
31264,26,165,1,19.69,1415.14,3729277,3729303
31265,50,99,1,10.24,248.46,3729302,3729352
31266,60,61,1,8.53,110.75,3729351,3729411
31267,44,86,1,11.64,227.64,3729410,3729454
31268,63,61,1,8.13,87.41,3729453,3729516
31269,48,152,1,10.67,499.93,3729515,3729563
31270,52,120,1,9.85,275.28,3729562,3729614
31271,37,144,1,13.84,523.60,3729613,3729650
31272,53,47,1,9.66,81.85,3729649,3729702
31273,41,72,1,12.49,252.98,3729701,3729742
31274,31,107,2,16.52,536.25,3729741,3729772
31275,48,49,1,10.67,109.01,3729771,3729819
31276,51,35,1,10.04,55.84,3729818,3729869
31277,47,64,1,10.89,188.61,3729868,3729915
31278,57,53,1,8.98,106.16,3729914,3729971
31279,56,44,1,9.14,67.09,3729970,3730026
31280,48,59,1,10.67,114.01,3730025,3730073
31281,43,44,1,11.91,101.71,3730072,3730115
31282,59,57,1,8.68,78.05,3730114,3730173
31283,60,33,1,8.53,41.85,3730172,3730232
31284,52,89,1,9.85,174.25,3730231,3730283
31285,50,69,1,10.24,237.74,3730283,3730333
31286,58,61,1,8.83,90.21,3730332,3730390
31287,34,183,1,15.06,962.94,3730389,3730423
31288,50,103,1,10.24,219.58,3730422,3730472
31289,62,45,1,8.26,64.09,3730471,3730533
31290,34,120,1,15.06,634.58,3730533,3730567
31291,44,119,1,11.64,355.32,3730566,3730610
31292,48,42,1,10.67,84.06,3730609,3730657
31293,46,57,2,11.13,80.55,3730656,3730702
31294,43,58,1,11.91,111.11,3730701,3730744
31295,46,53,2,11.13,95.94,3730743,3730789
31296,37,62,2,13.84,134.78,3730788,3730825
31297,37,39,1,13.84,78.41,3730824,3730861
31298,41,44,2,12.49,89.76,3730861,3730902
31299,49,38,1,10.45,60.98,3730901,3730950
31300,38,71,1,13.47,172.46,3730949,3730987
31301,51,34,2,10.04,47.33,3730986,3731037
31302,35,63,1,14.63,143.72,3731036,3731071
31303,41,48,1,12.49,130.79,3731070,3731111
31304,62,35,1,8.26,36.45,3731110,3731172
31305,34,62,2,15.06,124.82,3731171,3731205
31306,35,61,2,14.63,205.89,3731205,3731240
31307,36,73,1,14.22,202.78,3731239,3731275
31308,32,116,2,16.00,496.56,3731274,3731306
31309,43,86,1,11.91,188.74,3731305,3731348
31310,33,131,2,15.52,497.10,3731347,3731380
31311,55,42,1,9.31,59.60,3731379,3731434
31312,45,36,1,11.38,71.44,3731433,3731478
31313,34,78,2,15.06,193.82,3731477,3731511
31314,26,70,3,19.69,307.29,3731510,3731536
31315,29,116,1,17.66,590.85,3731535,3731564
31316,19,211,1,26.95,2189.42,3731563,3731582
31317,31,68,2,16.52,240.96,3731581,3731612
31318,40,89,1,12.80,259.21,3731611,3731651
31319,52,44,1,9.85,65.36,3731650,3731702
31320,44,36,1,11.64,97.69,3731701,3731745
31321,37,75,1,13.84,247.11,3731744,3731781
31322,50,35,1,10.24,59.22,3731780,3731830
31323,51,46,1,10.04,74.35,3731829,3731880
31324,33,78,1,15.52,392.98,3731879,3731912
31325,44,141,1,11.64,461.82,3731911,3731955
31326,27,122,1,18.96,691.00,3731954,3731981
31327,42,98,1,12.19,234.44,3731980,3732022
31328,30,108,1,17.07,672.60,3732021,3732051
31329,44,145,1,11.64,484.37,3732050,3732094
31330,72,30,1,7.11,48.32,3732093,3732165
31331,66,53,1,7.76,97.94,3732165,3732231
31332,60,31,1,8.53,57.62,3732230,3732290
31333,83,32,1,6.17,49.90,3732289,3732372
31334,46,54,2,11.13,116.42,3732371,3732417
31335,65,37,1,7.88,74.78,3732416,3732481
31336,69,32,1,7.42,50.74,3732480,3732549
31337,29,92,1,17.66,374.85,3732548,3732577
31338,62,38,1,8.26,67.93,3732576,3732638
31339,57,70,1,8.98,103.91,3732637,3732694
31340,44,96,1,11.64,355.41,3732693,3732737
31341,55,46,1,9.31,80.40,3732736,3732791
31342,56,49,1,9.14,85.98,3732790,3732846
31343,42,82,1,12.19,233.44,3732845,3732887
31344,54,48,1,9.48,88.77,3732886,3732940
31345,51,51,1,10.04,121.92,3732939,3732990
31346,70,28,1,7.31,32.47,3732989,3733059
31347,61,71,1,8.39,105.32,3733058,3733119
31348,54,50,1,9.48,90.55,3733118,3733172
31349,38,112,2,13.47,434.46,3733171,3733209
31350,42,118,1,12.19,324.44,3733208,3733250
31351,42,105,1,12.19,249.58,3733249,3733291
31352,53,57,1,9.66,95.77,3733291,3733344
31353,55,51,1,9.31,64.98,3733344,3733399
31354,51,39,1,10.04,65.92,3733398,3733449
31355,44,47,1,11.64,82.37,3733448,3733492
31356,37,129,1,13.84,405.60,3733491,3733528
31357,41,41,2,12.49,105.62,3733527,3733568
31358,25,113,3,20.48,758.01,3733567,3733592
31359,35,88,2,14.63,194.58,3733591,3733626
31360,60,35,1,8.53,41.32,3733626,3733686
31361,55,31,1,9.31,42.18,3733685,3733740
31362,54,25,1,9.48,40.84,3733739,3733793
31363,36,177,1,14.22,865.84,3733792,3733828
31364,43,73,1,11.91,160.36,3733827,3733870
31365,44,33,1,11.64,60.32,3733869,3733913
31366,45,67,1,11.38,171.66,3733912,3733957
31367,40,41,1,12.80,100.46,3733956,3733996
31368,39,92,1,13.13,257.39,3733995,3734034
31369,36,41,1,14.22,108.51,3734033,3734069
31370,49,40,1,10.45,61.55,3734068,3734117
31371,46,65,2,11.13,94.11,3734116,3734162
31372,41,57,1,12.49,134.20,3734161,3734202
31373,41,64,1,12.49,240.84,3734202,3734243
31374,32,115,2,16.00,424.75,3734242,3734274
31375,40,44,3,12.80,77.11,3734273,3734313
31376,52,36,1,9.85,58.51,3734312,3734364
31377,42,64,1,12.19,147.87,3734363,3734405
31378,41,40,1,12.49,64.59,3734404,3734445
31379,45,34,1,11.38,54.01,3734444,3734489
31380,40,146,1,12.80,520.66,3734488,3734528
31381,55,39,1,9.31,60.18,3734528,3734583
31382,60,64,1,8.53,76.22,3734582,3734642
31383,34,69,2,15.06,241.23,3734642,3734676
31384,18,244,3,28.44,3204.69,3734676,3734694
31385,38,70,1,13.47,188.83,3734693,3734731
31386,28,95,2,18.29,385.70,3734730,3734758
31387,12,103,4,42.67,1152.56,3734757,3734769
31388,38,90,1,13.47,263.09,3734768,3734806
31389,46,79,1,11.13,184.81,3734805,3734851
31390,44,36,1,11.64,59.78,3734851,3734895
31391,41,55,1,12.49,139.96,3734894,3734935
31392,44,87,1,11.64,235.10,3734934,3734978
31393,44,57,2,11.64,117.82,3734977,3735021
31394,42,47,1,12.19,82.77,3735021,3735063
31395,35,60,4,14.63,147.49,3735062,3735097
31396,51,41,1,10.04,93.14,3735096,3735147
31397,62,64,1,8.26,102.58,3735146,3735208
31398,34,140,1,15.06,621.94,3735207,3735241
31399,29,85,2,17.66,337.61,3735240,3735269
31400,46,70,1,11.13,151.81,3735269,3735315
31401,36,108,1,14.22,312.17,3735314,3735350
31402,65,35,1,7.88,53.68,3735349,3735414
31403,84,63,1,6.10,70.42,3735413,3735497
31404,48,64,1,10.67,138.22,3735496,3735544
31405,79,46,1,6.48,52.68,3735543,3735622
31406,50,60,1,10.24,130.82,3735622,3735672
31407,37,146,1,13.84,617.33,3735671,3735708
31408,24,299,1,21.33,3522.14,3735707,3735731
31409,74,58,1,6.92,106.80,3735730,3735804
31410,54,105,1,9.48,252.43,3735803,3735857
31411,57,52,1,8.98,98.86,3735856,3735913
31412,57,50,1,8.98,70.65,3735912,3735969
31413,63,37,1,8.13,52.11,3735968,3736031
31414,42,68,2,12.19,148.15,3736030,3736072
31415,49,95,1,10.45,226.45,3736071,3736120
31416,76,22,1,6.74,28.25,3736119,3736195
31417,40,108,2,12.80,313.46,3736194,3736234
31418,70,34,1,7.31,39.27,3736233,3736303
31419,48,64,1,10.67,115.56,3736302,3736350
31420,60,33,1,8.53,43.02,3736349,3736409
31421,62,35,1,8.26,46.09,3736408,3736470
31422,59,40,1,8.68,73.95,3736469,3736528
31423,47,52,1,10.89,143.33,3736527,3736574
31424,65,33,1,7.88,46.94,3736573,3736638
31425,80,22,1,6.40,19.16,3736637,3736717
31426,27,160,2,18.96,925.81,3736716,3736743
31427,50,70,1,10.24,137.22,3736742,3736792
31428,28,188,1,18.29,1416.63,3736791,3736819
31429,20,169,3,25.60,1578.04,3736818,3736838
31430,49,87,1,10.45,200.33,3736837,3736886
31431,64,35,2,8.00,35.34,3736885,3736949
31432,49,66,1,10.45,140.00,3736949,3736998
31433,52,43,1,9.85,55.48,3736997,3737049
31434,25,126,2,20.48,973.93,3737048,3737073
31435,51,33,1,10.04,51.96,3737072,3737123
31436,58,45,1,8.83,61.14,3737122,3737180
31437,41,120,2,12.49,357.08,3737179,3737220
31438,32,60,4,16.00,172.75,3737219,3737251
31439,36,72,1,14.22,149.78,3737250,3737286
31440,52,80,1,9.85,125.09,3737285,3737337
31441,48,43,1,10.67,82.18,3737336,3737384
31442,49,34,2,10.45,54.90,3737383,3737432
31443,49,27,2,10.45,32.74,3737431,3737480
31444,52,48,2,9.85,66.21,3737479,3737531
31445,49,41,1,10.45,71.23,3737530,3737579
31446,48,38,1,10.67,89.47,3737579,3737627
31447,49,38,2,10.45,65.23,3737626,3737675
31448,45,37,1,11.38,72.06,3737674,3737719
31449,33,138,2,15.52,560.25,3737718,3737751
31450,28,67,2,18.29,212.35,3737750,3737778
31451,36,46,2,14.22,92.28,3737777,3737813
31452,41,58,1,12.49,134.59,3737812,3737853
31453,47,39,2,10.89,64.61,3737852,3737899
31454,43,33,2,11.91,48.08,3737898,3737941
31455,50,33,2,10.24,53.94,3737940,3737990
31456,52,27,2,9.85,33.59,3737989,3738041
31457,44,69,1,11.64,145.28,3738040,3738084
31458,43,81,1,11.91,156.69,3738083,3738126
31459,50,38,1,10.24,67.62,3738125,3738175
31460,38,86,2,13.47,288.20,3738174,3738212
31461,55,32,1,9.31,50.69,3738211,3738266
31462,48,74,1,10.67,124.64,3738266,3738314
31463,37,64,3,13.84,147.65,3738313,3738350
31464,57,86,1,8.98,129.03,3738349,3738406
31465,51,58,1,10.04,101.33,3738405,3738456
31466,57,37,1,8.98,61.67,3738455,3738512
31467,23,139,3,22.26,762.11,3738511,3738534
31468,23,106,2,22.26,560.37,3738533,3738556
31469,38,100,2,13.47,356.51,3738555,3738593
31470,27,135,2,18.96,644.78,3738592,3738619
31471,40,73,1,12.80,170.11,3738618,3738658
31472,43,78,1,11.91,229.48,3738657,3738700
31473,47,39,1,10.89,82.99,3738699,3738746
31474,42,45,1,12.19,93.96,3738745,3738787
31475,52,47,1,9.85,99.86,3738786,3738838
31476,63,27,1,8.13,40.97,3738837,3738900
31477,50,105,1,10.24,279.58,3738899,3738949
31478,49,37,1,10.45,71.27,3738948,3738997
31479,46,67,1,11.13,155.68,3738996,3739042
31480,38,93,1,13.47,404.51,3739041,3739079
31481,60,75,1,8.53,111.48,3739078,3739138
31482,66,35,1,7.76,71.55,3739137,3739203
31483,65,38,1,7.88,61.49,3739202,3739267
31484,60,30,1,8.53,48.62,3739267,3739327
31485,49,37,1,10.45,73.55,3739326,3739375
31486,69,39,1,7.42,60.53,3739374,3739443
31487,74,42,1,6.92,67.62,3739442,3739516
31488,45,46,1,11.38,122.41,3739515,3739560
31489,78,29,1,6.56,32.14,3739559,3739637
31490,80,40,1,6.40,57.19,3739636,3739716
31491,50,41,1,10.24,86.66,3739715,3739765
31492,50,69,1,10.24,192.02,3739764,3739814
31493,55,52,1,9.31,89.85,3739813,3739868
31494,53,27,2,9.66,39.47,3739867,3739920
31495,73,62,1,7.01,73.60,3739919,3739992
31496,69,46,1,7.42,42.36,3739991,3740060
31497,66,55,1,7.76,63.49,3740059,3740125
31498,38,80,2,13.47,186.93,3740124,3740162
31499,50,49,1,10.24,79.02,3740162,3740212
31500,62,60,1,8.26,85.71,3740211,3740273
31501,48,79,1,10.67,164.64,3740272,3740320
31502,47,63,1,10.89,136.10,3740319,3740366
31503,59,88,1,8.68,176.15,3740365,3740424
31504,45,219,1,11.38,1003.08,3740424,3740469
31505,45,132,1,11.38,416.99,3740468,3740513
31506,62,65,1,8.26,83.06,3740512,3740574
31507,40,82,1,12.80,194.56,3740573,3740613
31508,53,105,1,9.66,226.45,3740612,3740665
31509,59,52,2,8.68,72.86,3740664,3740723
31510,49,64,1,10.45,115.88,3740722,3740771
31511,50,51,1,10.24,83.98,3740770,3740820
31512,36,102,1,14.22,324.67,3740819,3740855
31513,50,32,2,10.24,48.50,3740855,3740905
31514,48,60,1,10.67,103.14,3740905,3740953
31515,43,75,1,11.91,182.64,3740952,3740995
31516,48,55,1,10.67,81.56,3740994,3741042
31517,32,88,3,16.00,285.38,3741041,3741073
31518,43,51,1,11.91,137.34,3741072,3741115
31519,40,58,1,12.80,119.36,3741114,3741154
31520,31,106,3,16.52,483.28,3741153,3741184
31521,38,95,1,13.47,294.99,3741183,3741221
31522,54,63,2,9.48,95.47,3741220,3741274
31523,45,47,1,11.38,76.10,3741273,3741318
31524,55,37,1,9.31,46.98,3741317,3741372
31525,46,43,2,11.13,66.29,3741371,3741417
31526,63,25,1,8.13,32.87,3741416,3741479
31527,52,42,2,9.85,65.75,3741478,3741530
31528,46,33,2,11.13,51.55,3741530,3741576
31529,39,78,2,13.13,198.68,3741575,3741614
31530,41,65,2,12.49,146.79,3741613,3741654
31531,63,26,1,8.13,31.51,3741653,3741716
31532,34,98,1,15.06,362.82,3741715,3741749
31533,36,79,1,14.22,187.23,3741748,3741784
31534,40,44,3,12.80,92.01,3741783,3741823
31535,46,47,2,11.13,116.03,3741822,3741868
31536,49,66,1,10.45,110.08,3741867,3741916
31537,45,60,1,11.38,103.08,3741915,3741960
31538,52,26,1,9.85,43.25,3741959,3742011
31539,46,35,2,11.13,60.94,3742010,3742056
31540,33,80,2,15.52,346.98,3742055,3742088
31541,45,68,1,11.38,140.01,3742087,3742132
31542,54,35,1,9.48,50.81,3742131,3742185
31543,51,43,1,10.04,60.86,3742184,3742235
31544,43,70,2,11.91,178.83,3742234,3742277
31545,36,94,1,14.22,332.95,3742276,3742312
31546,45,125,1,11.38,343.39,3742311,3742356
31547,62,46,1,8.26,69.74,3742355,3742417
31548,41,40,2,12.49,84.35,3742416,3742457
31549,48,69,1,10.67,119.85,3742456,3742504
31550,27,62,1,18.96,275.59,3742503,3742530
31551,23,108,1,22.26,755.06,3742529,3742552
31552,31,62,1,16.52,209.86,3742551,3742582
31553,32,103,1,16.00,456.75,3742581,3742613
31554,40,48,1,12.80,111.31,3742612,3742652
31555,33,198,1,15.52,1110.43,3742651,3742684
31556,37,67,1,13.84,209.22,3742683,3742720
31557,51,57,1,10.04,116.70,3742719,3742770
31558,43,42,1,11.91,111.20,3742769,3742812
31559,26,109,2,19.69,668.83,3742811,3742837
31560,9,177,6,56.89,3467.88,3742836,3742845
31561,49,38,1,10.45,63.31,3742844,3742893
31562,48,103,1,10.67,232.14,3742892,3742940
31563,46,147,1,11.13,468.16,3742940,3742986
31564,49,69,1,10.45,141.27,3742985,3743034
31565,37,114,1,13.84,349.81,3743033,3743070
31566,38,75,1,13.47,249.51,3743069,3743107
31567,62,39,1,8.26,50.97,3743106,3743168
31568,89,31,1,5.75,36.93,3743167,3743256
31569,70,33,1,7.31,38.39,3743255,3743325
31570,43,88,2,11.91,224.78,3743324,3743367
31571,44,61,1,11.64,150.73,3743367,3743411
31572,46,69,1,11.13,151.16,3743410,3743456
31573,49,102,1,10.45,279.72,3743456,3743505
31574,49,95,1,10.45,224.90,3743504,3743553
31575,41,77,1,12.49,191.23,3743552,3743593
31576,67,45,1,7.64,78.35,3743592,3743659
31577,99,25,1,5.17,20.97,3743658,3743757
31578,53,65,1,9.66,108.38,3743756,3743809
31579,58,54,1,8.83,85.21,3743808,3743866
31580,61,49,1,8.39,89.26,3743866,3743927
31581,46,74,1,11.13,137.20,3743926,3743972
31582,47,89,1,10.89,215.20,3743971,3744018
31583,67,59,1,7.64,60.95,3744017,3744084
31584,61,55,1,8.39,92.99,3744083,3744144
31585,56,44,2,9.14,76.30,3744144,3744200
31586,60,41,1,8.53,65.55,3744199,3744259
31587,56,40,1,9.14,67.30,3744258,3744314
31588,64,24,1,8.00,31.91,3744313,3744377
31589,44,141,1,11.64,455.82,3744376,3744420
31590,69,48,1,7.42,50.50,3744419,3744488
31591,56,52,1,9.14,87.09,3744487,3744543
31592,54,42,1,9.48,105.69,3744542,3744596
31593,34,145,1,15.06,784.35,3744595,3744629
31594,28,216,1,18.29,1606.78,3744628,3744656
31595,34,105,1,15.06,403.41,3744655,3744689
31596,69,35,1,7.42,32.10,3744688,3744757
31597,40,71,1,12.80,215.81,3744757,3744797
31598,64,66,1,8.00,82.88,3744796,3744860
31599,38,211,1,13.47,1166.20,3744859,3744897
31600,58,39,1,8.83,55.59,3744896,3744954
31601,44,65,1,11.64,144.96,3744953,3744997
31602,58,39,1,8.83,58.35,3744996,3745054
31603,45,46,1,11.38,98.10,3745053,3745098
31604,51,31,2,10.04,52.78,3745097,3745148
31605,47,50,1,10.89,76.31,3745147,3745194
31606,51,45,1,10.04,64.31,3745193,3745244
31607,46,95,2,11.13,228.20,3745243,3745289
31608,43,50,1,11.91,74.13,3745288,3745331
31609,46,47,1,11.13,89.20,3745330,3745376
31610,38,45,3,13.47,101.20,3745375,3745413
31611,35,106,1,14.63,415.09,3745412,3745447
31612,53,40,1,9.66,72.68,3745446,3745499
31613,44,53,2,11.64,123.41,3745498,3745542
31614,27,89,2,18.96,339.52,3745541,3745568
31615,49,36,1,10.45,65.10,3745567,3745616
31616,44,56,1,11.64,120.19,3745615,3745659
31617,56,70,1,9.14,89.87,3745658,3745714
31618,40,49,1,12.80,130.86,3745713,3745753
31619,41,55,1,12.49,110.35,3745752,3745793
31620,42,31,1,12.19,67.54,3745792,3745834
31621,40,61,1,12.80,135.96,3745833,3745873
31622,52,37,2,9.85,60.36,3745872,3745924
31623,48,35,3,10.67,46.35,3745923,3745971
31624,39,47,2,13.13,112.21,3745970,3746009
31625,40,57,1,12.80,122.36,3746008,3746048
31626,52,32,1,9.85,47.44,3746047,3746099
31627,43,51,1,11.91,67.62,3746098,3746141
31628,50,103,1,10.24,204.22,3746140,3746190
31629,49,50,1,10.45,69.31,3746189,3746238
31630,32,79,2,16.00,332.62,3746237,3746269
31631,44,108,1,11.64,261.19,3746268,3746312
31632,57,75,1,8.98,127.77,3746311,3746368
31633,47,73,2,10.89,172.73,3746367,3746414
31634,50,63,1,10.24,98.82,3746413,3746463
31635,47,43,1,10.89,77.92,3746462,3746509
31636,39,51,2,13.13,131.96,3746508,3746547
31637,72,67,1,7.11,71.65,3746546,3746618
31638,61,20,1,8.39,29.32,3746617,3746678
31639,36,76,1,14.22,228.28,3746677,3746713
31640,34,139,1,15.06,537.41,3746712,3746746
31641,33,78,2,15.52,233.04,3746745,3746778
31642,16,123,3,32.00,1422.00,3746778,3746794
31643,29,118,3,17.66,635.26,3746793,3746822
31644,25,88,2,20.48,466.33,3746821,3746846
31645,40,54,1,12.80,146.11,3746845,3746885
31646,36,59,2,14.22,134.34,3746884,3746920
31647,34,106,1,15.06,523.64,3746920,3746954
31648,46,90,1,11.13,236.11,3746953,3746999
31649,33,46,5,15.52,102.55,3746999,3747032
31650,40,85,1,12.80,239.41,3747031,3747071
31651,38,57,1,13.47,156.83,3747070,3747108
31652,59,55,1,8.68,90.15,3747107,3747166
31653,48,58,1,10.67,145.43,3747165,3747213
31654,32,132,2,16.00,617.88,3747212,3747244
31655,34,129,1,15.06,504.06,3747244,3747278
31656,47,84,1,10.89,196.86,3747277,3747324
31657,44,44,2,11.64,100.37,3747323,3747367
31658,67,48,1,7.64,66.38,3747366,3747433
31659,79,62,1,6.48,113.36,3747432,3747511
31660,51,66,1,10.04,121.61,3747510,3747561
31661,51,48,1,10.04,66.78,3747561,3747612
31662,65,46,1,7.88,67.40,3747612,3747677
31663,53,108,1,9.66,234.22,3747676,3747729
31664,57,137,1,8.98,355.63,3747728,3747785
31665,46,92,1,11.13,265.90,3747784,3747830
31666,39,92,1,13.13,374.32,3747829,3747868
31667,48,94,1,10.67,235.43,3747867,3747915
31668,26,344,1,19.69,4231.91,3747914,3747940
31669,71,92,1,7.21,156.05,3747939,3748010
31670,67,29,1,7.64,35.75,3748009,3748076
31671,50,58,1,10.24,144.74,3748075,3748125
31672,64,48,1,8.00,85.97,3748124,3748188
31673,51,77,1,10.04,142.94,3748187,3748238
31674,49,113,1,10.45,284.57,3748237,3748286
31675,54,82,1,9.48,139.55,3748285,3748339
31676,60,49,1,8.53,79.05,3748338,3748398
31677,68,29,1,7.53,35.10,3748397,3748465
31678,61,67,1,8.39,81.29,3748464,3748525
31679,69,33,1,7.42,29.46,3748524,3748593
31680,57,35,1,8.98,59.95,3748593,3748650
31681,55,43,2,9.31,70.87,3748649,3748704
31682,31,311,1,16.52,2917.09,3748703,3748734
31683,57,41,1,8.98,60.86,3748733,3748790
31684,62,58,1,8.26,74.35,3748789,3748851
31685,51,54,2,10.04,99.14,3748850,3748901
31686,24,251,2,21.33,2469.72,3748901,3748925
31687,33,186,1,15.52,1082.61,3748924,3748957
31688,56,40,1,9.14,57.37,3748956,3749012
31689,34,233,1,15.06,1470.94,3749011,3749045
31690,43,157,1,11.91,550.22,3749044,3749087
31691,53,40,2,9.66,70.68,3749086,3749139
31692,59,27,1,8.68,35.54,3749138,3749197
31693,44,37,1,11.64,85.19,3749196,3749240
31694,29,73,2,17.66,321.33,3749239,3749268
31695,36,95,1,14.22,393.12,3749267,3749303
31696,42,73,1,12.19,200.73,3749302,3749344
31697,48,45,1,10.67,103.22,3749343,3749391
31698,27,269,1,18.96,2428.18,3749390,3749417
31699,40,50,2,12.80,93.51,3749416,3749456
31700,30,75,1,17.07,277.80,3749455,3749485
31701,51,37,2,10.04,51.61,3749484,3749535
31702,34,179,2,15.06,847.58,3749534,3749568
31703,31,71,2,16.52,314.31,3749567,3749598
31704,35,126,1,14.63,540.23,3749597,3749632
31705,48,67,1,10.67,116.31,3749631,3749679
31706,38,36,1,13.47,97.25,3749678,3749716
31707,32,65,2,16.00,172.81,3749715,3749747
31708,51,61,2,10.04,107.84,3749746,3749797
31709,44,81,1,11.64,165.23,3749796,3749840
31710,54,40,1,9.48,59.40,3749839,3749893
31711,44,41,2,11.64,75.73,3749892,3749936
31712,28,200,1,18.29,1450.78,3749935,3749963
31713,49,78,1,10.45,171.31,3749962,3750011
31714,30,97,1,17.07,325.60,3750010,3750040
31715,42,75,2,12.19,148.82,3750039,3750081
31716,35,82,1,14.63,238.18,3750080,3750115
31717,35,98,1,14.63,294.29,3750114,3750149
31718,55,42,1,9.31,66.03,3750148,3750203
31719,39,57,1,13.13,161.80,3750202,3750241
31720,42,59,1,12.19,118.34,3750240,3750282
31721,40,38,4,12.80,47.21,3750281,3750321
31722,51,38,1,10.04,54.31,3750320,3750371
31723,46,45,1,11.13,72.59,3750370,3750416
31724,52,41,1,9.85,70.40,3750415,3750467
31725,40,47,2,12.80,105.86,3750466,3750506
31726,40,39,1,12.80,69.61,3750505,3750545
31727,46,85,1,11.13,175.50,3750544,3750590
31728,46,127,1,11.13,327.68,3750589,3750635
31729,49,43,1,10.45,100.61,3750634,3750683
31730,37,100,1,13.84,275.76,3750682,3750719
31731,55,26,3,9.31,21.20,3750718,3750773
31732,44,76,1,11.64,153.82,3750772,3750816
31733,78,35,1,6.56,29.86,3750815,3750893
31734,37,71,1,13.84,254.62,3750892,3750929
31735,46,78,1,11.13,144.11,3750928,3750974
31736,29,96,2,17.66,341.81,3750973,3751002
31737,25,72,1,20.48,455.61,3751001,3751026
31738,14,196,5,36.57,2414.10,3751025,3751039
31739,21,123,4,24.38,945.28,3751038,3751059
31740,22,77,6,23.27,379.47,3751058,3751080
31741,30,75,2,17.07,310.73,3751079,3751109
31742,52,50,1,9.85,76.25,3751108,3751160
31743,38,123,1,13.47,467.35,3751159,3751197
31744,34,102,1,15.06,425.00,3751196,3751230
31745,46,49,3,11.13,69.72,3751229,3751275
31746,34,63,1,15.06,268.06,3751274,3751308
31747,38,84,1,13.47,251.83,3751307,3751345
31748,16,214,1,32.00,2455.50,3751344,3751360
31749,56,86,1,9.14,216.34,3751359,3751415
31750,42,58,1,12.19,150.58,3751414,3751456
31751,42,85,1,12.19,285.87,3751455,3751497
31752,44,73,2,11.64,231.64,3751496,3751540
31753,41,45,1,12.49,111.86,3751539,3751580
31754,53,106,1,9.66,256.04,3751579,3751632
31755,98,34,1,5.22,33.26,3751631,3751729
31756,38,59,2,13.47,153.30,3751728,3751766
31757,39,89,1,13.13,280.57,3751765,3751804
31758,38,150,1,13.47,544.35,3751803,3751841
31759,47,50,1,10.89,148.73,3751840,3751887
31760,68,67,1,7.53,103.87,3751886,3751954
31761,68,47,1,7.53,67.13,3751953,3752021
31762,41,81,1,12.49,269.62,3752020,3752061
31763,61,155,1,8.39,380.07,3752060,3752121
31764,68,64,1,7.53,111.31,3752120,3752188
31765,48,40,1,10.67,113.89,3752187,3752235
31766,68,47,1,7.53,57.90,3752234,3752302
31767,57,52,1,8.98,113.98,3752301,3752358
31768,32,101,2,16.00,450.38,3752357,3752389
31769,50,55,1,10.24,134.98,3752388,3752438
31770,47,62,1,10.89,184.05,3752437,3752484
31771,72,54,1,7.11,58.99,3752483,3752555
31772,56,91,1,9.14,143.94,3752554,3752610
31773,60,35,1,8.53,38.88,3752609,3752669
31774,48,113,1,10.67,253.81,3752668,3752716
31775,60,67,1,8.53,90.68,3752715,3752775
31776,53,52,1,9.66,101.28,3752774,3752827
31777,46,130,1,11.13,366.94,3752826,3752872
31778,57,35,1,8.98,63.88,3752871,3752928
31779,73,41,1,7.01,37.00,3752927,3753000
31780,62,91,2,8.26,140.26,3752999,3753061
31781,48,101,1,10.67,231.18,3753060,3753108
31782,37,74,1,13.84,336.84,3753107,3753144
31783,60,41,1,8.53,61.78,3753143,3753203
31784,36,149,2,14.22,626.40,3753202,3753238
31785,45,192,1,11.38,766.77,3753237,3753282
31786,57,45,2,8.98,67.35,3753282,3753339
31787,31,75,2,16.52,328.57,3753338,3753369
31788,54,35,1,9.48,55.73,3753368,3753422
31789,34,93,1,15.06,294.64,3753421,3753455
31790,52,53,1,9.85,81.71,3753454,3753506
31791,38,86,2,13.47,212.83,3753505,3753543
31792,37,60,2,13.84,119.76,3753542,3753579
31793,48,66,1,10.67,127.22,3753578,3753626
31794,42,42,1,12.19,99.25,3753625,3753667
31795,42,49,2,12.19,88.06,3753666,3753708
31796,36,187,3,14.22,896.67,3753707,3753743
31797,30,129,2,17.07,639.46,3753742,3753772
31798,32,71,1,16.00,234.81,3753771,3753803
31799,31,77,3,16.52,273.67,3753802,3753833
31800,40,62,2,12.80,135.46,3753832,3753872
31801,52,34,2,9.85,45.78,3753871,3753923
31802,50,50,2,10.24,102.14,3753922,3753972
31803,53,29,2,9.66,41.43,3753971,3754024
31804,36,78,2,14.22,213.51,3754024,3754060
31805,58,40,1,8.83,43.73,3754059,3754117
31806,34,58,3,15.06,158.64,3754116,3754150
31807,36,81,2,14.22,194.17,3754149,3754185
31808,47,108,1,10.89,254.82,3754184,3754231
31809,50,28,1,10.24,52.50,3754230,3754280
31810,47,38,1,10.89,66.82,3754280,3754327
31811,24,141,1,21.33,839.39,3754326,3754350
31812,29,87,1,17.66,384.98,3754349,3754378
31813,38,52,1,13.47,132.04,3754377,3754415
31814,41,56,2,12.49,112.10,3754414,3754455
31815,36,93,1,14.22,240.34,3754454,3754490
31816,45,66,1,11.38,155.79,3754489,3754534
31817,46,30,2,11.13,36.37,3754533,3754579
31818,50,64,3,10.24,126.58,3754578,3754628
31819,41,73,1,12.49,159.37,3754627,3754668
31820,49,34,1,10.45,45.96,3754667,3754716
31821,46,32,2,11.13,65.64,3754715,3754761
31822,49,49,1,10.45,81.80,3754760,3754809
31823,55,46,1,9.31,72.72,3754808,3754863
31824,58,44,1,8.83,82.52,3754862,3754920
31825,32,83,3,16.00,264.62,3754919,3754951
31826,45,45,2,11.38,92.81,3754951,3754996
31827,50,89,1,10.24,198.78,3754995,3755045
31828,52,42,1,9.85,68.75,3755044,3755096
31829,55,27,2,9.31,39.38,3755095,3755150
31830,28,79,5,18.29,320.49,3755149,3755177
31831,24,68,2,21.33,327.22,3755176,3755200
31832,9,297,7,56.89,7464.77,3755199,3755208
31833,14,182,3,36.57,2274.67,3755207,3755221
31834,26,106,2,19.69,785.52,3755220,3755246
31835,33,47,1,15.52,151.95,3755245,3755278
31836,50,29,1,10.24,56.82,3755278,3755328
31837,49,29,1,10.45,49.80,3755327,3755376
31838,52,29,1,9.85,53.13,3755375,3755427
31839,41,68,1,12.49,239.37,3755426,3755467
31840,34,49,2,15.06,178.00,3755466,3755500
31841,54,154,1,9.48,439.81,3755499,3755553
31842,51,112,1,10.04,264.70,3755552,3755603
31843,47,72,1,10.89,141.54,3755602,3755649
31844,38,82,1,13.47,239.83,3755648,3755686
31845,57,47,1,8.98,81.03,3755685,3755742
31846,89,37,1,5.75,44.07,3755741,3755830
31847,55,101,1,9.31,207.01,3755829,3755884
31848,59,45,1,8.68,43.17,3755883,3755942
31849,46,38,1,11.13,77.77,3755941,3755987
31850,41,105,1,12.49,358.10,3755987,3756028
31851,59,154,1,8.68,421.07,3756027,3756086
31852,48,63,1,10.67,158.51,3756085,3756133
31853,58,65,1,8.83,108.32,3756132,3756190
31854,71,77,1,7.21,121.74,3756189,3756260
31855,58,70,1,8.83,114.66,3756259,3756317
31856,32,166,1,16.00,805.69,3756316,3756348
31857,72,30,1,7.11,46.24,3756347,3756419
31858,47,83,1,10.89,231.41,3756418,3756465
31859,68,41,1,7.53,47.87,3756464,3756532
31860,65,27,1,7.88,34.17,3756531,3756596
31861,63,43,1,8.13,66.78,3756596,3756659
31862,39,105,2,13.13,326.98,3756658,3756697
31863,48,64,2,10.67,98.47,3756696,3756744
31864,55,102,1,9.31,229.12,3756743,3756798
31865,53,38,1,9.66,56.15,3756797,3756850
31866,57,65,1,8.98,126.86,3756849,3756906
31867,45,105,1,11.38,409.79,3756905,3756950
31868,23,148,1,22.26,1519.93,3756949,3756972
31869,60,23,1,8.53,34.85,3756971,3757031
31870,67,68,1,7.64,101.81,3757030,3757097
31871,52,52,2,9.85,73.05,3757096,3757148
31872,16,275,3,32.00,4458.00,3757147,3757163
31873,32,85,1,16.00,424.94,3757162,3757194
31874,57,77,1,8.98,117.88,3757193,3757250
31875,49,44,1,10.45,53.80,3757249,3757298
31876,64,24,1,8.00,25.56,3757297,3757361
31877,47,38,1,10.89,68.22,3757360,3757407
31878,63,33,1,8.13,36.71,3757406,3757469
31879,42,114,2,12.19,283.06,3757469,3757511
31880,38,130,1,13.47,435.78,3757510,3757548
31881,45,73,1,11.38,171.57,3757547,3757592
31882,37,79,1,13.84,182.68,3757591,3757628
31883,50,68,1,10.24,121.98,3757627,3757677
31884,47,48,2,10.89,90.05,3757676,3757723
31885,53,29,1,9.66,42.38,3757722,3757775
31886,52,35,1,9.85,46.59,3757774,3757826
31887,51,45,1,10.04,75.33,3757825,3757876
31888,42,75,2,12.19,152.25,3757875,3757917
31889,47,39,2,10.89,58.22,3757916,3757963
31890,48,33,1,10.67,55.26,3757962,3758010
31891,51,49,2,10.04,88.27,3758009,3758060
31892,44,43,1,11.64,82.60,3758059,3758103
31893,44,53,2,11.64,99.87,3758102,3758146
31894,44,43,1,11.64,63.19,3758145,3758189
31895,61,62,1,8.39,79.03,3758188,3758249
31896,41,62,3,12.49,127.62,3758248,3758289
31897,54,27,2,9.48,44.58,3758289,3758343
31898,49,47,1,10.45,66.29,3758342,3758391
31899,42,36,2,12.19,85.87,3758390,3758432
31900,44,97,1,11.64,217.87,3758431,3758475
31901,38,34,2,13.47,52.93,3758474,3758512
31902,37,78,2,13.84,183.92,3758511,3758548
31903,48,34,2,10.67,53.97,3758547,3758595
31904,48,40,2,10.67,86.60,3758594,3758642
31905,36,53,2,14.22,142.12,3758642,3758678
31906,54,47,1,9.48,79.73,3758677,3758731
31907,39,52,3,13.13,114.16,3758730,3758769
31908,39,47,2,13.13,121.14,3758769,3758808
31909,49,58,2,10.45,72.66,3758807,3758856
31910,36,203,1,14.22,1090.34,3758855,3758891
31911,47,103,2,10.89,216.90,3758890,3758937
31912,38,59,1,13.47,110.41,3758937,3758975
31913,43,37,2,11.91,71.57,3758974,3759017
31914,41,43,2,12.49,102.10,3759016,3759057
31915,57,54,1,8.98,119.63,3759056,3759113
31916,36,85,1,14.22,241.28,3759112,3759148
31917,34,124,2,15.06,507.23,3759147,3759181
31918,36,124,1,14.22,425.62,3759180,3759216
31919,36,92,1,14.22,255.12,3759215,3759251
31920,21,130,4,24.38,887.76,3759250,3759271
31921,28,117,1,18.29,597.49,3759270,3759298
31922,14,106,2,36.57,1360.39,3759297,3759311
31923,34,62,1,15.06,252.17,3759310,3759344
31924,53,69,1,9.66,141.88,3759343,3759396
31925,43,71,1,11.91,247.20,3759395,3759438
31926,46,36,1,11.13,80.81,3759438,3759484
31927,49,41,1,10.45,56.74,3759483,3759532
31928,45,58,1,11.38,136.81,3759531,3759576
31929,40,62,1,12.80,192.51,3759575,3759615
31930,63,50,1,8.13,96.11,3759614,3759677
31931,44,72,1,11.64,177.00,3759676,3759720
31932,40,52,1,12.80,145.31,3759719,3759759
31933,50,48,1,10.24,102.02,3759758,3759808
31934,62,52,1,8.26,71.71,3759807,3759869
31935,76,25,1,6.74,35.09,3759868,3759944
31936,13,430,1,39.38,12746.24,3759943,3759956
31937,38,98,1,13.47,279.20,3759955,3759993
31938,46,91,1,11.13,173.42,3759992,3760038
31939,43,84,1,11.91,232.41,3760037,3760080
31940,55,96,1,9.31,221.20,3760080,3760135
31941,61,104,1,8.39,193.22,3760134,3760195
31942,60,48,1,8.53,76.92,3760194,3760254
31943,79,66,1,6.48,89.06,3760253,3760332
31944,53,126,1,9.66,333.32,3760331,3760384
31945,46,98,2,11.13,199.55,3760383,3760429
31946,61,72,1,8.39,118.34,3760428,3760489
31947,63,115,1,8.13,228.05,3760488,3760551
31948,65,73,1,7.88,92.63,3760550,3760615
31949,54,74,1,9.48,203.62,3760614,3760668
31950,87,26,1,5.89,15.71,3760667,3760754
31951,58,44,1,8.83,59.25,3760753,3760811
31952,56,88,1,9.14,137.73,3760810,3760866
31953,57,49,1,8.98,70.82,3760865,3760922
31954,76,25,1,6.74,22.25,3760921,3760997
31955,67,32,1,7.64,31.60,3760997,3761064
31956,61,34,1,8.39,50.57,3761063,3761124
31957,68,49,1,7.53,70.48,3761123,3761191
31958,50,72,1,10.24,199.94,3761190,3761240
31959,50,58,1,10.24,129.86,3761239,3761289
31960,53,69,1,9.66,104.79,3761289,3761342
31961,63,71,1,8.13,99.03,3761341,3761404
31962,61,55,1,8.39,86.37,3761403,3761464
31963,11,224,1,46.55,4245.70,3761463,3761474
31964,53,70,1,9.66,118.45,3761473,3761526
31965,46,38,2,11.13,68.33,3761525,3761571
31966,42,58,3,12.19,88.34,3761570,3761612
31967,28,106,2,18.29,592.99,3761611,3761639
31968,42,55,1,12.19,130.06,3761638,3761680
31969,57,27,1,8.98,27.98,3761679,3761736
31970,27,243,2,18.96,1977.96,3761735,3761762
31971,57,27,2,8.98,26.58,3761761,3761818
31972,39,81,2,13.13,180.01,3761817,3761856
31973,41,54,2,12.49,124.15,3761855,3761896
31974,49,44,1,10.45,64.66,3761895,3761944
31975,53,38,1,9.66,53.92,3761943,3761996
31976,40,43,1,12.80,106.91,3761995,3762035
31977,25,118,1,20.48,688.49,3762034,3762059
31978,61,33,1,8.39,47.94,3762058,3762119
31979,54,28,1,9.48,53.36,3762119,3762173
31980,34,54,1,15.06,206.94,3762172,3762206
31981,46,37,1,11.13,57.72,3762205,3762251
31982,57,38,1,8.98,40.37,3762250,3762307
31983,44,92,2,11.64,190.55,3762306,3762350
31984,46,52,2,11.13,120.29,3762349,3762395
31985,49,46,1,10.45,82.86,3762394,3762443
31986,44,47,2,11.64,96.78,3762442,3762486
31987,39,69,1,13.13,182.93,3762485,3762524
31988,34,58,1,15.06,152.94,3762523,3762557
31989,42,59,1,12.19,113.34,3762556,3762598
31990,36,54,3,14.22,128.28,3762597,3762633
31991,57,29,2,8.98,34.68,3762632,3762689
31992,52,52,1,9.85,86.90,3762688,3762740
31993,48,47,1,10.67,88.60,3762739,3762787
31994,57,32,1,8.98,30.58,3762786,3762843
31995,39,90,1,13.13,229.91,3762842,3762881
31996,48,37,1,10.67,81.06,3762880,3762928
31997,49,24,1,10.45,32.74,3762927,3762976
31998,46,36,1,11.13,58.24,3762975,3763021
31999,79,33,1,6.48,27.64,3763020,3763099
32000,45,91,2,11.38,213.30,3763098,3763143
32001,48,46,1,10.67,87.60,3763142,3763190
32002,35,49,1,14.63,163.89,3763189,3763224
32003,20,208,3,25.60,1967.54,3763223,3763243
32004,19,106,6,26.95,709.42,3763242,3763261
32005,40,49,1,12.80,141.46,3763260,3763300
32006,21,148,1,24.38,1131.95,3763299,3763320
32007,34,59,1,15.06,148.76,3763319,3763353
32008,53,44,1,9.66,77.36,3763352,3763405
32009,57,53,1,8.98,80.33,3763404,3763461
32010,42,48,1,12.19,121.25,3763460,3763502
32011,45,141,1,11.38,444.41,3763501,3763546
32012,31,130,1,16.52,704.06,3763545,3763576
32013,47,73,1,10.89,215.75,3763575,3763622
32014,34,148,1,15.06,621.88,3763621,3763655
32015,53,42,1,9.66,80.22,3763654,3763707
32016,40,137,1,12.80,572.01,3763706,3763746
32017,51,128,1,10.04,316.82,3763745,3763796
32018,69,50,1,7.42,55.61,3763795,3763864
32019,47,167,1,10.89,642.14,3763863,3763910
32020,29,214,1,17.66,1479.05,3763909,3763938
32021,50,51,1,10.24,72.74,3763937,3763987
32022,34,219,1,15.06,1352.35,3763986,3764020
32023,44,106,1,11.64,254.73,3764019,3764063
32024,65,112,1,7.88,202.94,3764062,3764127
32025,45,103,1,11.38,289.97,3764126,3764171
32026,24,116,1,21.33,690.47,3764170,3764194
32027,46,76,1,11.13,182.59,3764193,3764239
32028,67,62,1,7.64,123.19,3764238,3764305
32029,49,114,1,10.45,325.15,3764304,3764353
32030,60,29,1,8.53,45.55,3764352,3764412
32031,75,27,1,6.83,25.34,3764411,3764486
32032,49,45,1,10.45,75.15,3764485,3764534
32033,53,45,1,9.66,76.07,3764533,3764586
32034,69,39,1,7.42,47.87,3764586,3764655
32035,65,37,1,7.88,55.12,3764654,3764719
32036,58,59,1,8.83,76.00,3764718,3764776
32037,44,87,1,11.64,177.73,3764775,3764819
32038,46,48,1,11.13,99.81,3764818,3764864
32039,55,53,1,9.31,88.29,3764864,3764919
32040,56,58,1,9.14,79.87,3764918,3764974
32041,73,20,1,7.01,25.33,3764973,3765046
32042,60,78,1,8.53,114.95,3765045,3765105
32043,73,60,1,7.01,57.14,3765104,3765177
32044,28,93,1,18.29,575.20,3765176,3765204
32045,55,28,2,9.31,40.14,3765203,3765258
32046,52,86,1,9.85,148.09,3765257,3765309
32047,29,141,1,17.66,841.74,3765308,3765337
32048,55,49,1,9.31,74.90,3765336,3765391
32049,55,55,1,9.31,117.60,3765390,3765445
32050,48,63,1,10.67,97.39,3765444,3765492
32051,43,60,1,11.91,157.85,3765491,3765534
32052,39,48,1,13.13,136.83,3765533,3765572
32053,38,69,2,13.47,230.51,3765571,3765609
32054,19,285,2,26.95,3827.73,3765608,3765627
32055,42,57,1,12.19,116.06,3765626,3765668
32056,50,36,1,10.24,60.30,3765667,3765717
32057,47,66,1,10.89,121.03,3765716,3765763
32058,37,51,2,13.84,95.43,3765762,3765799
32059,36,50,2,14.22,94.73,3765798,3765834
32060,51,44,2,10.04,81.57,3765833,3765884
32061,21,174,1,24.38,2067.19,3765883,3765904
32062,48,46,1,10.67,76.81,3765903,3765951
32063,40,77,2,12.80,221.26,3765950,3765990
32064,40,52,1,12.80,116.41,3765989,3766029
32065,40,53,3,12.80,103.61,3766028,3766068
32066,47,64,1,10.89,158.61,3766067,3766114
32067,44,38,2,11.64,81.50,3766113,3766157
32068,42,111,1,12.19,394.39,3766156,3766198
32069,36,49,1,14.22,156.45,3766197,3766233
32070,33,49,2,15.52,186.13,3766232,3766265
32071,40,84,1,12.80,200.46,3766264,3766304
32072,46,50,1,11.13,67.59,3766303,3766349
32073,35,45,3,14.63,87.20,3766348,3766383
32074,36,80,1,14.22,209.84,3766382,3766418
32075,54,38,1,9.48,74.25,3766417,3766471
32076,45,82,1,11.38,170.01,3766470,3766515
32077,45,50,1,11.38,119.66,3766514,3766559
32078,36,130,1,14.22,566.73,3766558,3766594
32079,45,64,1,11.38,137.52,3766593,3766638
32080,35,114,1,14.63,505.15,3766637,3766672
32081,20,246,1,25.60,2792.24,3766671,3766691
32082,25,96,2,20.48,608.25,3766690,3766715
32083,26,104,3,19.69,521.98,3766714,3766740
32084,24,139,2,21.33,782.39,3766739,3766763
32085,57,38,1,8.98,55.03,3766762,3766819
32086,24,174,2,21.33,1110.89,3766818,3766842
32087,22,205,1,23.27,1701.11,3766841,3766863
32088,19,160,3,26.95,1225.10,3766862,3766881
32089,48,51,1,10.67,83.10,3766881,3766929
32090,36,212,1,14.22,1218.56,3766928,3766964
32091,48,131,1,10.67,414.76,3766963,3767011
32092,36,148,1,14.22,572.73,3767010,3767046
32093,45,84,1,11.38,188.06,3767045,3767090
32094,50,39,1,10.24,85.22,3767089,3767139
32095,84,35,1,6.10,41.73,3767138,3767222
32096,59,50,1,8.68,86.73,3767221,3767280
32097,55,45,1,9.31,68.21,3767279,3767334
32098,67,54,1,7.64,64.92,3767333,3767400
32099,68,54,1,7.53,86.93,3767399,3767467
32100,57,39,1,8.98,70.93,3767466,3767523
32101,74,52,1,6.92,70.16,3767522,3767596
32102,46,53,1,11.13,128.29,3767595,3767641
32103,51,71,1,10.04,168.90,3767640,3767691
32104,58,78,1,8.83,119.97,3767690,3767748
32105,49,64,1,10.45,113.59,3767747,3767796
32106,56,37,1,9.14,55.02,3767795,3767851
32107,38,74,1,13.47,207.51,3767850,3767888
32108,52,44,1,9.85,72.63,3767887,3767939
32109,45,41,1,11.38,104.99,3767938,3767983
32110,44,49,1,11.64,114.32,3767982,3768026
32111,47,69,1,10.89,185.41,3768026,3768073
32112,56,45,1,9.14,83.77,3768072,3768128
32113,43,118,1,11.91,441.15,3768127,3768170
32114,37,244,1,13.84,1501.22,3768169,3768206
32115,45,173,1,11.38,625.48,3768205,3768250
32116,47,111,1,10.89,275.46,3768249,3768296
32117,33,92,1,15.52,374.19,3768295,3768328
32118,42,153,1,12.19,586.82,3768327,3768369
32119,55,49,1,9.31,75.12,3768368,3768423
32120,52,44,1,9.85,47.01,3768422,3768474
32121,36,56,1,14.22,202.73,3768473,3768509
32122,53,43,1,9.66,55.55,3768509,3768562
32123,54,48,2,9.48,54.25,3768561,3768615
32124,42,77,1,12.19,176.77,3768614,3768656
32125,51,41,1,10.04,73.14,3768655,3768706
32126,27,92,1,18.96,511.44,3768705,3768732
32127,49,52,2,10.45,63.27,3768732,3768781
32128,21,185,1,24.38,1647.76,3768780,3768801
32129,40,71,2,12.80,138.26,3768800,3768840
32130,36,87,1,14.22,273.34,3768839,3768875
32131,52,52,1,9.85,68.01,3768875,3768927
32132,50,48,1,10.24,80.82,3768926,3768976
32133,47,50,2,10.89,90.48,3768976,3769023
32134,41,29,3,12.49,41.71,3769022,3769063
32135,40,71,1,12.80,233.71,3769062,3769102
32136,41,35,3,12.49,68.54,3769101,3769142
32137,48,46,1,10.67,90.72,3769141,3769189
32138,33,45,2,15.52,95.64,3769188,3769221
32139,42,90,1,12.19,220.15,3769220,3769262
32140,30,59,2,17.07,169.40,3769261,3769291
32141,39,55,2,13.13,101.86,3769290,3769329
32142,54,51,2,9.48,85.21,3769328,3769382
32143,44,39,1,11.64,76.78,3769381,3769425
32144,47,29,1,10.89,48.78,3769424,3769471
32145,47,45,1,10.89,88.31,3769470,3769517
32146,39,56,2,13.13,150.78,3769516,3769555
32147,42,56,2,12.19,102.44,3769554,3769596
32148,56,102,1,9.14,187.30,3769595,3769651
32149,52,42,1,9.85,72.05,3769650,3769702
32150,49,40,2,10.45,65.06,3769701,3769750
32151,27,91,3,18.96,389.81,3769749,3769776
32152,23,88,3,22.26,548.89,3769775,3769798
32153,11,218,5,46.55,3899.34,3769797,3769808
32154,19,110,1,26.95,902.79,3769807,3769826
32155,41,65,1,12.49,193.08,3769825,3769866
32156,48,69,1,10.67,155.01,3769865,3769913
32157,46,39,1,11.13,64.03,3769912,3769958
32158,41,49,1,12.49,103.81,3769957,3769998
32159,45,79,1,11.38,185.26,3769997,3770042
32160,45,58,1,11.38,99.88,3770041,3770086
32161,27,184,1,18.96,1206.63,3770085,3770112
32162,31,111,1,16.52,600.25,3770111,3770142
32163,71,28,1,7.21,44.45,3770141,3770212
32164,65,44,1,7.88,66.51,3770211,3770276
32165,54,34,1,9.48,62.25,3770275,3770329
32166,61,66,1,8.39,120.60,3770328,3770389
32167,56,54,1,9.14,106.73,3770388,3770444
32168,39,83,1,13.13,360.47,3770443,3770482
32169,67,31,1,7.64,55.10,3770481,3770548
32170,51,43,1,10.04,73.33,3770547,3770598
32171,57,52,1,8.98,103.35,3770597,3770654
32172,68,35,1,7.53,34.93,3770653,3770721
32173,51,58,1,10.04,97.65,3770720,3770771
32174,64,95,1,8.00,151.59,3770770,3770834
32175,55,45,1,9.31,55.49,3770833,3770888
32176,50,61,1,10.24,103.98,3770887,3770937
32177,48,69,1,10.67,122.60,3770937,3770985
32178,52,45,1,9.85,98.71,3770984,3771036
32179,31,95,2,16.52,480.44,3771035,3771066
32180,41,81,1,12.49,212.40,3771065,3771106
32181,54,64,1,9.48,140.66,3771105,3771159
32182,37,135,1,13.84,516.51,3771159,3771196
32183,44,48,2,11.64,89.73,3771195,3771239
32184,51,54,1,10.04,87.76,3771238,3771289
32185,57,37,1,8.98,54.23,3771288,3771345
32186,52,35,2,9.85,51.63,3771344,3771396
32187,54,33,2,9.48,37.92,3771396,3771450
32188,31,134,1,16.52,576.12,3771449,3771480
32189,48,40,1,10.67,65.68,3771479,3771527
32190,52,39,1,9.85,57.71,3771526,3771578
32191,50,49,1,10.24,73.34,3771577,3771627
32192,52,43,1,9.85,58.17,3771626,3771678
32193,23,137,2,22.26,852.54,3771677,3771700
32194,42,60,1,12.19,104.58,3771699,3771741
32195,40,48,2,12.80,76.21,3771740,3771780
32196,30,115,2,17.07,450.66,3771779,3771809
32197,44,80,1,11.64,243.78,3771808,3771852
32198,26,160,1,19.69,897.98,3771851,3771877
32199,39,86,2,13.13,357.03,3771876,3771915
32200,46,69,1,11.13,151.77,3771914,3771960
32201,51,38,1,10.04,60.04,3771959,3772010
32202,46,113,2,11.13,271.55,3772009,3772055
32203,31,164,2,16.52,811.09,3772054,3772085
32204,52,71,1,9.85,106.94,3772084,3772136
32205,41,66,1,12.49,218.05,3772135,3772176
32206,49,45,2,10.45,64.17,3772175,3772224
32207,45,50,1,11.38,119.97,3772223,3772268
32208,46,44,1,11.13,66.98,3772267,3772313
32209,51,43,2,10.04,48.55,3772312,3772363
32210,47,51,1,10.89,82.18,3772362,3772409
32211,45,44,2,11.38,81.79,3772408,3772453
32212,38,188,2,13.47,861.57,3772452,3772490
32213,35,140,1,14.63,663.38,3772489,3772524
32214,32,53,5,16.00,121.50,3772523,3772555
32215,28,144,1,18.29,977.13,3772554,3772582
32216,43,80,1,11.91,166.04,3772581,3772624
32217,43,68,1,11.91,150.27,3772623,3772666
32218,51,104,1,10.04,222.59,3772665,3772716
32219,37,62,1,13.84,194.35,3772715,3772752
32220,37,61,3,13.84,160.84,3772751,3772788
32221,26,69,1,19.69,322.91,3772787,3772813
32222,23,63,3,22.26,374.54,3772812,3772835
32223,23,119,2,22.26,893.24,3772834,3772857
32224,19,112,1,26.95,831.94,3772856,3772875
32225,38,106,1,13.47,409.35,3772874,3772912
32226,52,38,1,9.85,63.82,3772911,3772963
32227,34,115,1,15.06,517.88,3772962,3772996
32228,39,157,1,13.13,593.34,3772995,3773034
32229,46,84,1,11.13,183.64,3773033,3773079
32230,52,48,1,9.85,113.05,3773078,3773130
32231,40,82,1,12.80,243.76,3773129,3773169
32232,39,65,1,13.13,165.14,3773168,3773207
32233,69,77,1,7.42,99.81,3773206,3773275
32234,69,62,1,7.42,94.19,3773274,3773343
32235,62,26,1,8.26,34.13,3773342,3773404
32236,52,104,1,9.85,211.59,3773403,3773455
32237,67,121,1,7.64,228.77,3773454,3773521
32238,6,471,4,85.33,29765.22,3773520,3773526
32239,28,152,1,18.29,810.49,3773525,3773553
32240,81,37,1,6.32,38.98,3773552,3773633
32241,61,43,1,8.39,84.27,3773632,3773693
32242,67,68,1,7.64,96.65,3773692,3773759
32243,51,43,1,10.04,87.29,3773758,3773809
32244,66,52,1,7.76,61.12,3773808,3773874
32245,62,52,1,8.26,66.71,3773874,3773936
32246,63,27,1,8.13,30.40,3773935,3773998
32247,60,31,1,8.53,23.98,3773997,3774057
32248,54,48,1,9.48,62.18,3774056,3774110
32249,59,36,1,8.68,60.29,3774109,3774168
32250,55,49,1,9.31,66.98,3774167,3774222
32251,63,54,1,8.13,83.03,3774221,3774284
32252,42,161,1,12.19,630.73,3774283,3774325
32253,49,57,1,10.45,102.04,3774324,3774373
32254,45,76,1,11.38,139.35,3774372,3774417
32255,52,55,1,9.85,90.55,3774416,3774468
32256,38,118,1,13.47,349.20,3774467,3774505
32257,46,108,1,11.13,259.16,3774504,3774550
32258,30,96,1,17.07,414.66,3774549,3774579
32259,55,25,1,9.31,35.41,3774578,3774633
32260,45,68,1,11.38,139.88,3774632,3774677
32261,36,70,2,14.22,130.56,3774676,3774712
32262,42,52,1,12.19,110.73,3774711,3774753
32263,16,155,2,18.25,1275.94,3774752,3774768
