tile_id,n_reduce_rows_num,max_row_length,min_row_length,avg_row_length,variance,start_row,end_row
0,87,18,4,5.89,10.88,0,87
1,90,18,1,5.69,8.57,86,176
2,88,18,3,5.82,10.99,176,264
3,115,18,0,4.45,11.53,263,378
4,224,37,0,2.29,20.45,377,601
5,53,295,0,9.66,2051.96,600,653
6,18,296,0,28.44,5221.47,652,670
7,3,278,48,170.67,8934.22,669,672
8,7,284,0,73.14,13278.98,671,678
9,12,256,0,42.67,7847.39,677,689
10,3,283,40,170.67,10009.56,688,691
11,8,306,0,64.00,10092.25,690,698
12,3,264,123,170.67,4356.22,697,700
13,4,292,0,128.00,12334.00,699,703
14,5,273,0,102.40,13780.24,702,707
15,6,237,0,85.33,11358.56,706,712
16,4,277,0,128.00,13706.50,711,715
17,5,291,1,102.40,11591.44,714,719
18,80,233,0,6.40,696.34,718,798
19,58,38,0,8.83,180.83,797,855
20,137,35,0,3.74,56.31,854,991
21,200,22,0,2.56,14.58,990,1190
22,144,110,0,3.56,96.37,1189,1333
23,39,39,8,13.13,25.34,1332,1371
24,54,20,1,9.48,24.84,1371,1425
25,46,23,0,11.13,47.94,1424,1470
26,29,34,1,17.66,59.05,1469,1498
27,175,20,0,2.93,16.82,1497,1672
28,265,73,0,1.93,27.52,1672,1937
29,81,24,1,6.32,43.06,1936,2017
30,31,27,0,16.52,74.83,2016,2047
31,35,29,0,14.63,117.55,2046,2081
32,50,110,0,10.24,299.30,2080,2130
33,279,33,0,1.84,17.05,2129,2408
34,115,25,0,4.45,14.40,2407,2522
35,41,217,2,12.49,2026.05,2521,2562
36,244,26,0,2.10,2.87,2562,2806
37,147,216,0,3.48,309.71,2806,2953
38,173,33,0,2.96,27.07,2952,3125
39,201,35,0,2.55,19.91,3125,3326
40,83,26,0,6.17,33.83,3325,3408
41,82,21,0,6.24,31.23,3407,3489
42,29,21,1,17.66,11.05,3488,3517
43,25,44,3,20.48,61.13,3516,3541
44,26,46,8,19.69,46.44,3540,3566
45,60,22,0,8.53,69.45,3565,3625
46,62,344,0,8.26,1975.71,3624,3686
47,7,303,0,73.14,9746.98,3685,3692
48,12,63,12,42.67,155.22,3691,3703
49,14,62,1,36.57,311.53,3702,3716
50,20,53,1,25.60,101.74,3715,3735
51,23,43,0,22.26,113.67,3734,3757
52,30,33,1,17.07,144.46,3756,3786
53,23,37,1,22.26,90.54,3786,3809
54,19,41,9,26.95,32.26,3808,3827
55,21,30,3,24.38,44.81,3826,3847
56,140,50,0,3.66,83.67,3846,3986
57,108,55,0,4.74,117.49,3985,4093
58,212,54,0,2.42,42.30,4092,4304
59,142,24,0,3.61,19.99,4304,4446
60,127,30,0,4.03,35.20,4445,4572
61,95,18,0,5.39,12.89,4571,4666
62,80,18,1,6.40,7.34,4665,4745
63,121,24,0,4.23,17.91,4744,4865
64,200,40,0,2.56,27.05,4865,5065
65,231,42,0,2.22,33.75,5065,5296
66,215,42,0,2.38,24.38,5295,5510
67,252,28,0,2.03,13.68,5509,5761
68,105,27,0,4.88,16.18,5761,5866
69,161,27,0,3.18,12.89,5865,6026
70,191,19,0,2.68,11.32,6026,6217
71,173,20,0,2.96,11.51,6217,6390
72,87,56,0,5.89,64.52,6389,6476
73,74,56,1,6.92,67.80,6476,6550
74,65,56,2,7.88,102.69,6549,6614
75,64,56,4,8.00,80.94,6613,6677
76,65,56,4,7.88,93.77,6676,6741
77,96,56,0,5.33,57.91,6740,6836
78,18,34,8,28.44,32.69,6835,6853
79,104,40,0,4.92,91.26,6853,6957
80,215,26,0,2.38,13.96,6956,7171
81,55,23,0,9.31,28.61,7170,7225
82,55,30,0,9.31,77.89,7224,7279
83,58,26,0,8.83,109.21,7278,7336
84,85,12,0,6.02,23.74,7336,7421
85,50,12,1,10.24,8.78,7420,7470
86,47,12,6,10.89,0.90,7469,7516
87,48,12,2,10.67,2.93,7515,7563
88,30,156,8,17.07,680.00,7562,7592
89,35,141,5,14.63,470.80,7591,7626
90,45,13,6,11.38,0.99,7625,7670
91,45,12,6,11.38,0.90,7670,7715
92,47,17,2,10.89,3.92,7714,7761
93,45,102,1,11.38,200.46,7760,7805
94,50,16,0,10.24,11.86,7804,7854
95,51,16,0,10.04,12.86,7853,7904
96,48,18,1,10.67,13.14,7903,7951
97,58,30,1,8.83,30.59,7950,8008
98,82,52,0,6.24,68.45,8007,8089
99,148,35,0,3.46,41.75,8088,8236
100,94,64,1,5.45,78.12,8235,8329
101,88,64,1,5.82,80.10,8328,8416
102,185,29,0,2.77,13.08,8416,8601
103,120,17,1,4.27,11.85,8600,8720
104,60,18,0,8.53,39.25,8719,8779
105,61,23,0,8.39,25.45,8778,8839
106,42,49,2,12.19,51.11,8838,8880
107,152,38,0,3.37,16.38,8879,9031
108,163,39,0,3.14,16.78,9030,9193
109,179,35,0,2.86,17.08,9192,9371
110,76,108,1,6.74,148.59,9370,9446
111,108,28,0,4.74,66.77,9445,9553
112,114,39,0,4.49,115.04,9552,9666
113,59,238,0,8.68,994.96,9665,9724
114,1,512,512,512.00,0.00,9723,9724
115,2,412,100,256.00,24336.00,9723,9725
116,1,512,512,512.00,0.00,9724,9725
117,1,512,512,512.00,0.00,9724,9725
118,2,475,37,256.00,47961.00,9724,9726
119,1,512,512,512.00,0.00,9725,9726
120,2,338,174,256.00,6724.00,9725,9727
121,1,512,512,512.00,0.00,9726,9727
122,2,311,201,256.00,3025.00,9726,9728
123,1,512,512,512.00,0.00,9727,9728
124,2,448,64,256.00,36864.00,9727,9729
125,1,512,512,512.00,0.00,9728,9729
126,1,512,512,512.00,0.00,9728,9729
127,151,73,0,3.39,110.29,9728,9879
128,123,47,0,4.16,99.50,9878,10001
129,97,46,0,5.28,146.18,10000,10097
130,97,36,0,5.28,130.63,10096,10193
131,108,41,0,4.74,104.27,10192,10300
132,120,37,0,4.27,83.55,10299,10419
133,96,31,0,5.33,88.99,10418,10514
134,95,97,0,5.39,132.79,10513,10608
135,80,96,0,6.40,283.71,10607,10687
136,129,25,0,3.97,41.10,10686,10815
137,109,22,0,4.70,57.62,10814,10923
138,100,28,0,5.12,57.35,10922,11022
139,184,34,0,2.78,16.76,11022,11206
140,239,38,0,2.14,18.39,11205,11444
141,85,56,0,6.02,31.93,11443,11528
142,272,40,0,1.88,13.78,11527,11799
143,319,38,0,1.61,10.88,11798,12117
144,245,15,0,2.09,6.04,12116,12361
145,264,24,0,1.94,7.97,12361,12625
146,179,81,0,2.86,40.61,12625,12804
147,207,19,0,2.47,10.54,12803,13010
148,214,15,0,2.39,5.08,13009,13223
149,231,24,0,2.22,7.69,13222,13453
150,211,81,0,2.43,35.44,13452,13663
151,143,15,0,3.58,6.58,13662,13805
152,100,14,0,5.12,11.79,13804,13904
153,145,25,0,3.53,13.21,13903,14048
154,203,39,0,2.52,16.07,14048,14251
155,107,12,0,4.79,19.66,14251,14358
156,280,25,0,1.83,8.71,14357,14637
157,245,76,0,2.09,31.97,14636,14881
158,303,20,0,1.69,9.16,14880,15183
159,248,25,0,2.06,7.67,15182,15430
160,200,39,0,2.56,16.83,15429,15629
161,92,25,0,5.57,22.81,15628,15720
162,209,12,0,2.45,6.13,15720,15929
163,133,28,0,3.85,16.11,15928,16061
164,286,32,0,1.79,10.77,16060,16346
165,205,36,0,2.50,16.78,16345,16550
166,227,32,0,2.26,15.23,16550,16777
167,123,24,0,4.16,11.65,16776,16899
168,149,66,0,3.44,47.25,16898,17047
169,148,74,0,3.46,65.26,17046,17194
170,107,29,0,4.79,63.35,17193,17300
171,54,19,0,9.48,22.43,17300,17354
172,42,25,0,12.19,37.63,17353,17395
173,104,19,0,4.92,27.55,17394,17498
174,104,18,0,4.92,14.21,17497,17601
175,39,25,8,13.13,9.96,17600,17639
176,184,57,0,2.78,33.63,17638,17822
177,310,39,0,1.65,16.13,17821,18131
178,65,26,0,7.88,84.45,18130,18195
179,237,14,0,2.16,8.01,18194,18431
180,257,21,0,1.99,14.73,18431,18688
181,228,27,0,2.25,13.14,18687,18915
182,150,27,0,3.41,13.36,18915,19065
183,95,24,0,5.39,22.87,19064,19159
184,140,58,0,3.66,38.78,19158,19298
185,274,80,0,1.87,48.83,19298,19572
186,259,105,0,1.98,48.35,19571,19830
187,184,27,0,2.78,18.09,19829,20013
188,208,22,0,2.46,11.94,20012,20220
189,207,34,0,2.47,12.14,20219,20426
190,64,31,1,8.00,28.56,20425,20489
191,39,26,9,13.13,13.60,20488,20527
192,98,23,1,5.22,23.83,20527,20625
193,110,32,1,4.65,25.19,20624,20734
194,52,26,1,9.85,35.09,20733,20785
195,169,34,1,3.03,20.73,20785,20954
196,69,22,0,7.42,55.17,20954,21023
197,30,24,3,17.07,15.46,21022,21052
198,28,34,13,18.29,14.85,21051,21079
199,28,30,12,18.29,26.20,21078,21106
200,30,23,2,17.07,19.13,21105,21135
201,29,27,15,17.66,5.54,21134,21163
202,191,34,0,2.68,22.70,21162,21353
203,103,313,0,4.97,930.30,21352,21455
204,436,268,0,1.17,166.07,21454,21890
205,186,34,0,2.75,21.33,21889,22075
206,149,43,0,3.44,43.08,22074,22223
207,114,16,0,4.49,14.39,22222,22336
208,129,16,0,3.97,10.28,22335,22464
209,163,36,0,3.14,26.59,22463,22626
210,149,34,0,3.44,24.78,22625,22774
211,200,57,0,2.56,36.30,22773,22973
212,58,18,0,8.83,42.45,22972,23030
213,126,44,0,4.06,24.33,23029,23155
214,154,15,0,3.32,11.02,23154,23308
215,112,24,0,4.57,16.07,23308,23420
216,198,34,0,2.59,28.25,23419,23617
217,218,111,0,2.35,82.42,23617,23835
218,521,111,0,0.98,32.31,23834,24355
219,261,54,0,1.96,28.96,24354,24615
220,60,44,4,8.53,37.72,24614,24674
221,79,26,1,6.48,13.31,24673,24752
222,151,15,0,3.39,9.31,24751,24902
223,232,24,0,2.21,9.03,24902,25134
224,245,14,0,2.09,5.32,25134,25379
225,243,26,0,2.11,7.34,25378,25621
226,250,30,0,2.05,15.08,25620,25870
227,227,24,0,2.26,12.76,25869,26096
228,127,30,0,4.03,31.50,26095,26222
229,81,15,1,6.32,19.75,26221,26302
230,68,19,6,7.53,6.34,26302,26370
231,56,44,1,9.14,47.44,26369,26425
232,111,54,0,4.61,34.09,26424,26535
233,98,24,1,5.22,24.01,26534,26632
234,221,165,0,2.32,129.09,26631,26852
235,489,111,0,1.05,37.20,26852,27341
236,430,111,0,1.19,37.51,27341,27771
237,185,51,0,2.77,49.28,27770,27955
238,280,42,0,1.83,31.09,27955,28235
239,312,130,0,1.64,73.59,28234,28546
240,194,59,0,2.64,32.53,28546,28740
241,111,49,0,4.61,23.73,28739,28850
242,157,13,0,3.26,7.44,28849,29006
243,178,52,0,2.88,22.97,29005,29183
244,160,20,0,3.20,14.94,29182,29342
245,141,13,0,3.63,9.23,29341,29482
246,160,19,0,3.20,14.00,29482,29642
247,63,16,1,8.13,13.70,29641,29704
248,89,29,0,5.75,17.89,29703,29792
249,94,46,1,5.45,20.63,29791,29885
250,139,46,0,3.68,18.99,29884,30023
251,68,34,0,7.53,36.04,30022,30090
252,43,34,0,11.91,24.27,30089,30132
253,51,24,0,10.04,33.45,30131,30182
254,24,36,0,21.33,204.22,30181,30205
255,18,39,0,28.44,175.58,30204,30222
256,14,39,24,36.57,12.53,30222,30236
257,15,38,11,34.13,72.52,30235,30250
258,19,37,0,26.95,143.21,30249,30268
259,19,39,0,26.95,103.10,30267,30286
260,33,35,0,15.52,214.49,30285,30318
261,33,37,0,15.52,141.58,30317,30350
262,51,24,0,10.04,28.19,30349,30400
263,34,31,6,15.06,28.88,30399,30433
264,41,31,1,12.49,24.49,30432,30473
265,38,33,4,13.47,25.46,30472,30510
266,34,34,0,15.06,26.94,30509,30543
267,40,34,5,12.80,23.71,30542,30582
268,40,34,0,12.80,23.91,30581,30621
269,43,34,0,11.91,84.97,30620,30663
270,47,24,0,10.89,49.84,30662,30709
271,45,34,0,11.38,36.15,30708,30753
272,37,33,4,13.84,17.22,30752,30789
273,39,39,0,13.13,159.29,30788,30827
274,40,26,0,12.80,75.71,30826,30866
275,22,26,7,23.27,24.56,30865,30887
276,17,34,10,30.12,49.16,30886,30903
277,16,34,12,32.00,32.50,30902,30918
278,16,34,14,32.00,30.00,30917,30933
279,16,34,19,32.00,22.50,30932,30948
280,25,34,5,20.48,45.45,30947,30972
281,28,34,11,18.29,51.78,30971,30999
282,21,30,10,24.38,13.76,30998,31019
283,28,34,5,18.29,62.56,31018,31046
284,27,32,14,18.96,17.59,31045,31072
285,24,28,3,21.33,33.39,31071,31095
286,22,34,2,23.27,34.38,31094,31116
287,22,28,20,23.27,3.11,31115,31137
288,17,34,3,30.12,52.69,31136,31153
289,17,34,2,30.12,76.93,31152,31169
290,16,34,13,32.00,31.12,31168,31184
291,17,34,1,30.12,82.46,31183,31200
292,16,34,16,32.00,28.50,31199,31215
293,24,34,0,21.33,237.47,31214,31238
294,16,34,15,32.00,27.62,31237,31253
295,16,33,18,32.00,13.12,31252,31268
296,21,34,1,24.38,175.57,31267,31288
297,34,34,1,15.06,29.64,31287,31321
298,39,34,0,13.13,47.96,31320,31359
299,35,34,1,14.63,24.29,31358,31393
300,23,34,2,22.26,127.15,31392,31415
301,17,33,23,30.12,4.93,31414,31431
302,17,34,4,30.12,50.22,31430,31447
303,35,34,1,14.63,57.72,31446,31481
304,27,34,1,18.96,111.29,31480,31507
305,19,30,7,26.95,44.68,31506,31525
306,17,34,19,30.12,10.93,31524,31541
307,25,34,14,20.48,63.53,31540,31565
308,31,34,4,16.52,22.31,31564,31595
309,21,34,4,24.38,57.57,31594,31615
310,17,32,14,30.12,27.04,31614,31631
311,17,34,2,30.12,69.87,31630,31647
312,16,34,9,32.00,35.75,31646,31662
313,21,34,6,24.38,150.05,31661,31682
314,16,34,16,32.00,28.50,31681,31697
315,16,34,14,32.00,30.00,31696,31712
316,19,34,0,26.95,148.37,31711,31730
317,29,34,12,17.66,34.23,31730,31759
318,28,34,4,18.29,30.78,31758,31786
319,27,34,10,18.96,23.07,31785,31812
320,30,34,3,17.07,29.13,31811,31841
321,23,34,4,22.26,118.45,31840,31863
322,17,33,1,30.12,67.04,31862,31879
323,28,33,1,18.29,44.85,31878,31906
324,27,34,14,18.96,16.55,31905,31932
325,25,34,3,20.48,25.69,31931,31956
326,16,40,0,32.00,149.25,31956,31972
327,17,40,24,30.12,33.63,31971,31988
328,16,34,7,32.00,43.12,31987,32003
329,16,34,5,32.00,49.12,32002,32018
330,17,34,2,30.12,101.87,32017,32034
331,20,34,1,25.60,133.84,32033,32053
332,22,33,11,23.27,95.38,32052,32074
333,20,41,5,25.60,111.14,32073,32093
334,21,41,2,24.38,174.71,32092,32113
335,17,41,1,30.12,187.40,32112,32129
336,17,34,8,30.12,73.63,32128,32145
337,16,34,10,32.00,36.00,32144,32160
338,16,34,12,32.00,32.50,32159,32175
339,18,36,3,28.44,65.25,32174,32192
340,16,37,13,32.00,42.62,32191,32207
341,16,34,16,32.00,19.00,32206,32222
342,16,38,5,32.00,65.75,32221,32237
343,19,38,14,26.95,56.89,32236,32255
344,21,37,7,24.38,55.66,32254,32275
345,20,36,1,25.60,115.04,32274,32294
346,16,40,12,32.00,123.00,32293,32309
347,17,40,3,30.12,150.81,32308,32325
348,17,40,7,30.12,92.81,32324,32341
349,15,38,17,34.13,34.92,32340,32355
350,20,38,10,25.60,87.54,32354,32374
351,17,40,3,30.12,144.81,32373,32390
352,18,38,10,28.44,56.69,32389,32407
353,18,38,15,28.44,43.25,32406,32424
354,17,38,6,30.12,91.75,32423,32440
355,19,38,16,26.95,25.52,32439,32458
356,16,40,1,32.00,125.62,32457,32473
357,18,39,7,28.44,88.25,32472,32490
358,20,39,5,25.60,88.64,32489,32509
359,19,38,7,26.95,93.73,32508,32527
360,14,40,9,36.57,62.10,32526,32540
361,17,36,7,30.12,38.34,32539,32556
362,23,40,7,22.26,67.15,32555,32578
363,20,34,8,25.60,65.84,32577,32597
364,19,37,1,26.95,138.37,32596,32615
365,26,40,2,19.69,77.98,32614,32640
366,20,37,7,25.60,68.24,32639,32659
367,19,40,8,26.95,91.42,32658,32677
368,21,32,5,24.38,53.76,32676,32697
369,21,40,4,24.38,86.33,32696,32717
370,23,36,8,22.26,79.15,32716,32739
371,21,33,8,24.38,71.47,32738,32759
372,20,40,10,25.60,78.84,32758,32778
373,27,41,3,18.96,117.00,32777,32804
374,20,41,11,25.60,116.74,32803,32823
375,18,40,4,28.44,111.14,32822,32840
376,16,40,2,32.00,178.50,32839,32855
377,16,39,13,32.00,81.75,32854,32870
378,16,34,15,32.00,29.12,32869,32885
379,16,34,17,32.00,28.12,32884,32900
380,16,34,17,32.00,23.25,32899,32915
381,16,34,12,32.00,32.50,32914,32930
382,16,34,10,32.00,36.00,32929,32945
383,16,34,8,32.00,40.50,32944,32960
384,24,34,1,21.33,158.22,32959,32983
385,24,34,5,21.33,141.97,32982,33006
386,16,34,7,32.00,43.12,33005,33021
387,16,34,9,32.00,38.12,33020,33036
388,16,34,14,32.00,26.25,33035,33051
389,25,34,0,20.48,93.53,33050,33075
390,16,34,7,32.00,43.12,33074,33090
391,16,34,5,32.00,49.12,33089,33105
392,17,34,1,30.12,105.63,33104,33121
393,16,34,4,32.00,52.50,33120,33136
394,16,34,6,32.00,46.00,33135,33151
395,16,34,9,32.00,37.38,33150,33166
396,16,34,13,32.00,28.75,33165,33181
397,29,34,8,17.66,126.29,33180,33209
398,16,34,14,32.00,30.00,33208,33224
399,16,34,16,32.00,28.50,33223,33239
400,18,35,11,28.44,59.69,33238,33256
401,15,37,24,34.13,16.25,33255,33270
402,16,34,10,32.00,36.00,33269,33285
403,16,34,8,32.00,40.50,33284,33300
404,16,34,6,32.00,45.38,33299,33315
405,16,34,2,32.00,60.00,33314,33330
406,16,34,2,32.00,60.00,33330,33346
407,16,34,5,32.00,48.88,33345,33361
408,17,34,2,30.12,89.63,33360,33377
409,16,34,4,32.00,52.50,33376,33392
410,16,34,6,32.00,46.00,33391,33407
411,16,34,10,32.00,34.38,33406,33422
412,16,34,12,32.00,32.50,33421,33437
413,16,34,14,32.00,30.00,33436,33452
414,16,34,16,32.00,28.50,33451,33467
415,17,34,2,30.12,75.40,33466,33483
416,16,34,16,32.00,28.50,33482,33498
417,16,34,14,32.00,30.00,33497,33513
418,16,34,12,32.00,30.38,33512,33528
419,16,34,8,32.00,40.50,33527,33543
420,16,34,6,32.00,46.00,33542,33558
421,16,34,4,32.00,52.38,33557,33573
422,16,34,2,32.00,60.00,33573,33589
423,16,34,4,32.00,52.50,33588,33604
424,16,34,6,32.00,46.00,33603,33619
425,16,34,9,32.00,37.38,33618,33634
426,16,34,11,32.00,34.12,33633,33649
427,16,34,13,32.00,31.12,33648,33664
428,16,34,17,32.00,24.75,33663,33679
429,18,34,7,28.44,92.80,33678,33696
430,16,34,23,32.00,8.38,33695,33711
431,19,33,0,26.95,73.84,33710,33729
432,19,33,1,26.95,59.31,33728,33747
433,17,34,5,30.12,42.34,33746,33763
434,18,34,20,28.44,9.58,33762,33780
435,19,34,4,26.95,55.10,33779,33798
436,18,34,1,28.44,67.02,33797,33815
437,19,28,17,26.95,9.52,33814,33833
438,18,34,9,28.44,25.25,33832,33850
439,21,34,4,24.38,108.71,33850,33871
440,33,27,7,15.52,10.86,33870,33903
441,21,29,4,24.38,42.81,33902,33923
442,19,33,6,26.95,31.84,33922,33941
443,18,34,5,28.44,42.80,33940,33958
444,20,27,4,25.60,25.74,33957,33977
445,18,33,20,28.44,8.36,33976,33994
446,18,34,3,28.44,58.47,33993,34011
447,17,34,27,30.12,1.63,34010,34027
448,17,34,3,30.12,50.34,34026,34043
449,20,34,7,25.60,38.94,34042,34062
450,19,32,15,26.95,10.79,34061,34080
451,19,34,1,26.95,58.68,34080,34099
452,19,29,16,26.95,11.84,34098,34117
453,18,34,5,28.44,50.14,34116,34134
454,19,34,12,26.95,17.94,34133,34152
455,19,33,10,26.95,28.05,34151,34170
456,19,34,6,26.95,39.10,34169,34188
457,21,29,9,24.38,14.62,34187,34208
458,19,34,10,26.95,29.21,34207,34226
459,23,27,8,22.26,12.89,34225,34248
460,20,34,16,25.60,18.44,34247,34267
461,25,27,3,20.48,27.53,34266,34291
462,23,34,4,22.26,30.11,34290,34313
463,22,30,17,23.27,7.47,34312,34334
464,25,34,4,20.48,22.41,34333,34358
465,25,34,0,20.48,41.53,34357,34382
466,23,34,6,22.26,27.84,34381,34404
467,27,25,3,18.96,16.41,34403,34430
468,22,34,6,23.27,36.02,34429,34451
469,23,34,8,22.26,29.67,34450,34473
470,24,34,11,21.33,21.47,34472,34496
471,25,26,7,20.48,16.97,34495,34520
472,26,33,17,19.69,15.06,34519,34545
473,18,38,6,28.44,90.80,34544,34562
474,19,38,9,26.95,70.47,34561,34580
475,16,34,12,32.00,28.38,34579,34595
476,16,34,5,32.00,49.12,34594,34610
477,16,34,3,32.00,56.12,34609,34625
478,17,34,1,30.12,83.40,34624,34641
479,16,33,23,32.00,7.50,34640,34656
480,23,33,6,22.26,126.02,34655,34678
481,29,32,0,17.66,44.57,34677,34706
482,18,34,4,28.44,39.02,34706,34724
483,18,32,3,28.44,40.47,34723,34741
484,17,34,7,30.12,44.81,34740,34757
485,17,34,15,30.12,26.46,34756,34773
486,18,31,3,28.44,55.02,34772,34790
487,16,34,21,32.00,9.62,34789,34805
488,17,34,12,30.12,39.87,34804,34821
489,18,30,15,28.44,19.47,34820,34838
490,17,34,13,30.12,27.75,34837,34854
491,23,34,12,22.26,106.89,34853,34876
492,32,34,3,16.00,29.44,34875,34907
493,21,34,6,24.38,23.76,34906,34927
494,20,31,7,25.60,33.74,34926,34946
495,15,40,17,34.13,57.05,34945,34960
496,17,40,12,30.12,38.22,34959,34976
497,17,34,18,30.12,10.81,34975,34992
498,17,34,1,30.12,64.57,34992,35009
499,22,29,4,23.27,21.47,35008,35030
500,18,34,1,28.44,66.14,35029,35047
501,18,34,3,28.44,75.69,35046,35064
502,20,34,10,25.60,35.34,35063,35083
503,17,32,21,30.12,8.10,35082,35099
504,17,34,3,30.12,76.34,35098,35115
505,17,40,13,30.12,63.52,35114,35131
506,18,41,11,28.44,67.58,35130,35148
507,19,40,4,26.95,117.73,35147,35166
508,24,38,8,21.33,73.81,35165,35189
509,16,34,4,32.00,52.50,35188,35204
510,16,34,2,32.00,60.00,35203,35219
511,21,34,11,24.38,42.05,35219,35240
512,16,34,13,32.00,31.12,35239,35255
513,16,34,15,32.00,29.12,35254,35270
514,17,37,4,30.12,91.87,35269,35286
515,25,37,1,20.48,65.45,35285,35310
516,15,39,3,34.13,73.32,35309,35324
517,16,34,5,32.00,49.12,35323,35339
518,16,34,7,32.00,43.12,35338,35354
519,15,40,7,34.13,101.85,35353,35368
520,14,40,27,36.57,10.24,35367,35381
521,14,40,12,36.57,50.96,35380,35394
522,14,40,8,36.57,65.67,35393,35407
523,15,39,6,34.13,78.65,35406,35421
524,15,38,4,34.13,86.52,35420,35435
525,14,39,31,36.57,4.10,35434,35448
526,15,39,5,34.13,118.25,35447,35462
527,19,36,18,26.95,30.16,35461,35480
528,16,36,9,32.00,54.00,35479,35495
529,16,37,9,32.00,87.38,35494,35510
530,16,37,4,32.00,69.25,35509,35525
531,26,39,0,19.69,299.06,35524,35550
532,14,40,11,36.57,54.82,35549,35563
533,16,40,1,32.00,164.62,35562,35578
534,14,41,20,36.57,43.39,35577,35591
535,14,41,10,36.57,81.24,35590,35604
536,14,40,2,36.57,98.53,35603,35617
537,14,40,0,36.57,104.67,35616,35630
538,16,40,0,32.00,209.00,35629,35645
539,14,40,2,36.57,92.67,35644,35658
540,14,39,12,36.57,46.67,35658,35672
541,14,39,18,36.57,35.96,35671,35685
542,14,40,20,36.57,26.39,35684,35698
543,14,40,9,36.57,61.10,35697,35711
544,15,39,2,34.13,140.38,35710,35725
545,14,39,16,36.57,33.10,35724,35738
546,14,38,22,36.57,17.39,35737,35751
547,14,40,4,36.57,82.10,35750,35764
548,15,40,2,34.13,158.92,35763,35778
549,14,39,7,36.57,67.53,35777,35791
550,14,40,10,36.57,58.96,35790,35804
551,29,40,0,17.66,345.88,35803,35832
552,15,40,5,34.13,122.52,35831,35846
553,14,40,13,36.57,48.67,35845,35859
554,14,40,25,36.57,20.82,35858,35872
555,14,40,13,36.57,51.24,35871,35885
556,15,40,0,34.13,136.92,35884,35899
557,19,40,0,26.95,281.84,35898,35917
558,14,40,11,36.57,56.10,35916,35930
559,15,37,7,34.13,63.05,35929,35944
560,15,38,13,34.13,69.05,35943,35958
561,15,38,7,34.13,61.72,35957,35972
562,16,36,10,32.00,51.38,35971,35987
563,16,38,15,32.00,31.38,35986,36002
564,16,39,4,32.00,88.88,36001,36017
565,14,40,31,36.57,8.24,36016,36030
566,15,40,3,34.13,106.92,36029,36044
567,16,36,22,32.00,16.25,36043,36059
568,16,38,6,32.00,83.12,36058,36074
569,14,39,26,36.57,9.67,36073,36087
570,17,38,2,30.12,107.52,36086,36103
571,15,39,25,34.13,27.72,36102,36117
572,15,39,7,34.13,69.98,36116,36131
573,16,38,8,32.00,106.50,36130,36146
574,14,40,16,36.57,41.39,36145,36159
575,15,39,16,34.13,67.18,36158,36173
576,16,38,22,32.00,33.62,36172,36188
577,17,39,13,30.12,59.28,36187,36204
578,16,38,7,32.00,122.75,36203,36219
579,14,38,28,36.57,7.24,36218,36232
580,15,38,5,34.13,87.32,36231,36246
581,15,38,5,34.13,79.72,36245,36260
582,14,38,33,36.57,2.24,36259,36273
583,15,38,4,34.13,69.98,36272,36287
584,14,40,10,36.57,55.82,36286,36300
585,16,39,5,32.00,129.75,36299,36315
586,16,39,9,32.00,70.50,36314,36330
587,15,39,25,34.13,34.12,36329,36344
588,17,38,3,30.12,79.99,36343,36360
589,17,38,4,30.12,73.40,36359,36376
590,15,39,9,34.13,71.45,36375,36390
591,17,39,16,30.12,53.04,36389,36406
592,16,39,9,32.00,95.75,36405,36421
593,14,40,12,36.57,52.10,36420,36434
594,15,39,15,34.13,44.92,36433,36448
595,15,38,10,34.13,76.12,36447,36462
596,18,38,15,28.44,56.69,36461,36479
597,22,31,4,23.27,57.47,36478,36500
598,27,34,6,18.96,23.96,36499,36526
599,17,39,15,30.12,59.99,36525,36542
600,17,39,13,30.12,87.40,36541,36558
601,17,35,14,30.12,27.40,36557,36574
602,25,39,7,20.48,68.25,36573,36598
603,22,41,0,23.27,113.20,36597,36619
604,16,33,23,32.00,7.50,36618,36634
605,17,33,6,30.12,63.04,36633,36650
606,17,34,0,30.12,71.75,36649,36666
607,16,34,13,32.00,31.12,36665,36681
608,16,34,11,32.00,34.12,36680,36696
609,16,38,9,32.00,91.38,36695,36711
610,19,38,8,26.95,53.42,36710,36729
611,18,37,8,28.44,78.47,36728,36746
612,22,35,11,23.27,91.93,36745,36767
613,19,38,2,26.95,114.37,36766,36785
614,14,39,26,36.57,10.24,36784,36798
615,19,39,2,26.95,152.58,36797,36816
616,29,36,0,17.66,247.95,36815,36844
617,16,38,1,32.00,70.88,36843,36859
618,16,39,0,32.00,133.88,36858,36874
619,15,38,26,34.13,7.58,36874,36889
620,16,37,10,32.00,46.62,36888,36904
621,17,37,6,30.12,80.34,36903,36920
622,15,39,23,34.13,25.18,36919,36934
623,17,37,3,30.12,77.87,36933,36950
624,15,39,5,34.13,89.58,36949,36964
625,15,39,21,34.13,20.78,36963,36978
626,18,39,1,28.44,102.80,36977,36995
627,15,39,21,34.13,24.38,36994,37009
628,17,38,2,30.12,133.40,37008,37025
629,16,39,24,32.00,29.00,37024,37040
630,15,39,10,34.13,64.92,37040,37055
631,15,39,7,34.13,77.72,37054,37069
632,17,39,20,30.12,31.87,37068,37085
633,18,36,11,28.44,58.58,37084,37102
634,22,41,7,23.27,73.20,37101,37123
635,22,29,2,23.27,46.02,37122,37144
636,19,39,13,26.95,45.42,37143,37162
637,18,38,3,28.44,67.02,37161,37179
638,16,38,9,32.00,83.12,37178,37194
639,16,34,16,32.00,28.50,37193,37209
640,16,34,18,32.00,28.00,37208,37224
641,16,34,16,32.00,28.50,37223,37239
642,25,35,1,20.48,176.41,37238,37263
643,22,39,9,23.27,63.47,37262,37284
644,22,31,2,23.27,42.56,37283,37305
645,16,39,10,32.00,66.00,37304,37320
646,17,38,2,30.12,104.34,37319,37336
647,16,39,23,32.00,26.88,37335,37351
648,19,39,6,26.95,125.00,37350,37369
649,15,39,7,34.13,82.78,37368,37383
650,16,38,28,32.00,14.38,37382,37398
651,17,37,3,30.12,76.69,37397,37414
652,16,33,23,32.00,7.50,37413,37429
653,17,33,6,30.12,58.22,37428,37445
654,16,33,20,32.00,10.12,37444,37460
655,17,40,3,30.12,90.69,37459,37476
656,24,28,6,21.33,28.64,37475,37499
657,21,34,4,24.38,54.05,37498,37519
658,16,33,23,32.00,7.50,37518,37534
659,17,33,7,30.12,62.57,37533,37550
660,18,37,14,28.44,24.14,37549,37567
661,17,40,13,30.12,110.46,37566,37583
662,17,40,12,30.12,60.22,37582,37599
663,18,39,16,28.44,67.25,37598,37616
664,18,35,2,28.44,79.69,37615,37633
665,23,39,1,22.26,102.19,37632,37655
666,23,40,9,22.26,60.54,37654,37677
667,24,41,6,21.33,45.72,37676,37700
668,16,34,16,32.00,28.50,37699,37715
669,17,34,11,30.12,55.40,37714,37731
670,18,38,5,28.44,97.47,37730,37748
671,20,39,4,25.60,62.94,37747,37767
672,19,36,1,26.95,110.37,37766,37785
673,22,39,12,23.27,43.11,37784,37806
674,23,38,1,22.26,72.89,37805,37828
675,21,39,9,24.38,41.19,37827,37848
676,23,38,3,22.26,108.28,37847,37870
677,20,40,5,25.60,64.94,37869,37889
678,19,28,10,26.95,16.16,37888,37907
679,18,34,2,28.44,43.69,37906,37924
680,16,36,9,32.00,41.75,37924,37940
681,20,35,4,25.60,96.14,37939,37959
682,23,36,4,22.26,67.84,37958,37981
683,22,34,5,23.27,81.56,37980,38002
684,22,36,2,23.27,67.65,38001,38023
685,19,37,10,26.95,62.37,38022,38041
686,16,38,1,32.00,85.25,38040,38056
687,28,23,11,18.29,5.92,38055,38083
688,22,35,11,23.27,77.47,38082,38104
689,29,35,9,17.66,72.36,38104,38133
690,21,40,12,24.38,76.62,38132,38153
691,19,40,6,26.95,120.26,38152,38171
692,22,40,14,23.27,72.56,38170,38192
693,16,39,10,32.00,104.88,38191,38207
694,20,37,9,25.60,55.24,38206,38226
695,18,37,9,28.44,55.91,38225,38243
696,19,38,17,26.95,67.52,38242,38261
697,23,39,1,22.26,141.76,38260,38283
698,22,38,1,23.27,77.83,38282,38304
699,17,38,7,30.12,103.87,38303,38320
700,19,39,17,26.95,38.16,38319,38338
701,28,31,1,18.29,44.99,38337,38365
702,24,27,6,21.33,17.22,38364,38388
703,23,34,10,22.26,32.71,38387,38410
704,18,36,4,28.44,69.47,38409,38427
705,17,39,7,30.12,127.75,38426,38443
706,26,38,4,19.69,99.21,38442,38468
707,19,41,8,26.95,40.16,38467,38486
708,15,41,30,34.13,13.05,38485,38500
709,15,43,2,34.13,168.25,38499,38514
710,13,44,9,39.38,85.62,38513,38526
711,27,41,6,18.96,97.74,38525,38552
712,26,40,4,19.69,48.91,38551,38577
713,21,39,1,24.38,99.00,38576,38597
714,16,34,11,32.00,34.12,38596,38612
715,16,34,13,32.00,31.12,38611,38627
716,16,34,17,32.00,24.75,38626,38642
717,21,34,0,24.38,78.33,38641,38662
718,19,31,24,26.95,3.31,38661,38680
719,16,39,1,32.00,80.00,38679,38695
720,16,39,11,32.00,65.50,38694,38710
721,17,39,6,30.12,63.04,38709,38726
722,28,34,1,18.29,33.92,38725,38753
723,16,38,0,32.00,156.12,38753,38769
724,15,39,6,34.13,81.98,38768,38783
725,24,39,0,21.33,325.14,38782,38806
726,14,40,5,36.57,79.53,38805,38819
727,15,37,3,34.13,69.45,38818,38833
728,15,40,1,34.13,156.25,38832,38847
729,13,41,31,39.38,7.93,38846,38859
730,14,40,8,36.57,63.96,38858,38872
731,14,40,5,36.57,78.82,38871,38885
732,14,41,5,36.57,104.96,38884,38898
733,14,40,20,36.57,23.10,38897,38911
734,15,39,3,34.13,144.65,38911,38926
735,21,39,0,24.38,326.71,38925,38946
736,14,39,32,36.57,2.67,38945,38959
737,19,38,2,26.95,221.52,38958,38977
738,15,37,17,34.13,30.38,38976,38991
739,15,39,8,34.13,84.25,38990,39005
740,14,39,27,36.57,10.96,39004,39018
741,14,39,12,36.57,48.82,39017,39031
742,15,39,1,34.13,145.45,39030,39045
743,14,38,22,36.57,16.67,39044,39058
744,14,39,16,36.57,33.10,39057,39071
745,15,39,3,34.13,140.12,39070,39085
746,27,40,0,18.96,352.85,39084,39111
747,18,41,0,28.44,274.58,39110,39128
748,23,37,4,22.26,191.41,39127,39150
749,20,39,4,25.60,56.34,39149,39169
750,16,41,28,32.00,27.50,39168,39184
751,15,42,5,34.13,126.52,39183,39198
752,21,35,20,24.38,25.38,39197,39218
753,16,39,3,32.00,102.00,39217,39233
754,14,38,31,36.57,2.82,39232,39246
755,15,38,7,34.13,81.72,39245,39260
756,14,38,21,36.57,18.82,39259,39273
757,15,38,1,34.13,103.05,39272,39287
758,16,38,3,32.00,97.62,39286,39302
759,18,38,21,28.44,24.47,39301,39319
760,16,40,3,32.00,74.00,39318,39334
761,17,40,3,30.12,76.10,39333,39350
762,20,35,11,25.60,75.54,39349,39369
763,22,36,8,23.27,70.65,39368,39390
764,19,34,5,26.95,95.73,39389,39408
765,16,38,10,32.00,43.62,39407,39423
766,17,38,7,30.12,46.93,39422,39439
767,18,32,5,28.44,37.36,39438,39456
768,19,36,21,26.95,11.73,39455,39474
769,19,35,5,26.95,57.31,39473,39492
770,24,28,1,21.33,40.81,39491,39515
771,23,41,11,22.26,98.80,39514,39537
772,14,43,20,36.57,49.39,39536,39550
773,16,41,4,32.00,87.50,39549,39565
774,14,43,10,36.57,69.82,39564,39578
775,16,43,10,32.00,99.38,39577,39593
776,17,37,1,30.12,71.40,39592,39609
777,15,38,5,34.13,84.65,39608,39623
778,20,40,3,25.60,74.14,39622,39642
779,15,41,28,34.13,18.38,39641,39656
780,14,42,1,36.57,112.82,39655,39669
781,19,43,7,26.95,234.58,39668,39687
782,16,34,17,32.00,28.12,39686,39702
783,16,34,17,32.00,28.12,39701,39717
784,16,34,15,32.00,29.12,39716,39732
785,16,34,13,32.00,27.75,39731,39747
786,16,34,8,32.00,40.50,39746,39762
787,16,34,6,32.00,46.00,39761,39777
788,16,34,4,32.00,52.50,39776,39792
789,18,34,0,28.44,134.69,39791,39809
790,16,34,19,32.00,13.75,39808,39824
791,17,33,3,30.12,65.87,39823,39840
792,16,33,20,32.00,10.12,39839,39855
793,16,34,13,32.00,27.75,39854,39870
794,16,34,8,32.00,39.38,39869,39885
795,17,34,3,30.12,73.28,39884,39901
796,16,33,22,32.00,8.12,39900,39916
797,16,34,5,32.00,48.88,39915,39931
798,17,34,2,30.12,101.87,39930,39947
799,16,34,5,32.00,49.12,39946,39962
800,16,34,7,32.00,43.12,39961,39977
801,16,34,11,32.00,32.25,39976,39992
802,16,34,13,32.00,31.12,39991,40007
803,16,34,15,32.00,29.12,40006,40022
804,16,34,18,32.00,26.12,40021,40037
805,34,34,8,15.06,52.70,40036,40070
806,41,34,5,12.49,18.05,40069,40110
807,38,34,1,13.47,24.46,40109,40147
808,25,34,0,20.48,203.37,40146,40171
809,16,34,15,32.00,29.12,40170,40186
810,16,34,13,32.00,27.12,40185,40201
811,17,32,5,30.12,40.81,40200,40217
812,17,34,5,30.12,78.22,40216,40233
813,24,39,0,21.33,261.47,40232,40256
814,14,40,16,36.57,48.24,40255,40269
815,20,40,0,25.60,286.04,40268,40288
816,15,39,6,34.13,80.65,40287,40302
817,16,38,0,32.00,149.25,40301,40317
818,15,39,4,34.13,92.52,40316,40331
819,15,38,6,34.13,78.25,40330,40345
820,15,37,7,34.13,55.45,40344,40359
821,21,39,0,24.38,301.28,40358,40379
822,15,39,2,34.13,124.12,40378,40393
823,14,40,6,36.57,72.82,40392,40406
824,14,40,7,36.57,70.10,40405,40419
825,14,40,8,36.57,66.53,40418,40432
826,14,40,9,36.57,63.24,40431,40445
827,14,40,10,36.57,60.24,40444,40458
828,14,40,11,36.57,56.10,40457,40471
829,18,33,0,28.44,109.14,40470,40488
830,16,34,12,32.00,27.25,40487,40503
831,16,34,3,32.00,56.12,40502,40518
832,22,34,1,23.27,142.93,40517,40539
833,18,32,3,28.44,57.14,40538,40556
834,16,34,20,32.00,10.88,40555,40571
835,18,34,13,28.44,35.58,40570,40588
836,22,30,2,23.27,44.11,40587,40609
837,20,34,12,25.60,20.44,40608,40628
838,21,28,12,24.38,9.76,40627,40648
839,19,34,3,26.95,43.73,40647,40666
840,17,33,7,30.12,62.57,40665,40682
841,21,34,1,24.38,145.95,40681,40702
842,16,34,3,32.00,56.12,40701,40717
843,16,34,5,32.00,49.12,40716,40732
844,16,34,8,32.00,39.88,40731,40747
845,20,34,8,25.60,120.64,40746,40766
846,16,34,13,32.00,31.12,40765,40781
847,16,34,11,32.00,34.12,40780,40796
848,18,34,6,28.44,102.36,40795,40813
849,16,34,17,32.00,28.12,40812,40828
850,16,34,17,32.00,28.12,40827,40843
851,16,34,15,32.00,29.12,40842,40858
852,23,34,13,22.26,69.93,40857,40880
853,27,34,4,18.96,29.07,40879,40906
854,16,33,21,32.00,9.00,40905,40921
855,17,33,4,30.12,64.69,40920,40937
856,16,40,17,32.00,37.12,40936,40952
857,18,40,13,28.44,91.91,40951,40969
858,19,30,2,26.95,44.58,40968,40987
859,17,34,18,30.12,15.99,40986,41003
860,19,34,0,26.95,134.89,41002,41021
861,16,33,25,32.00,7.00,41020,41036
862,17,34,8,30.12,65.28,41035,41052
863,16,34,18,32.00,19.00,41051,41067
864,17,32,14,30.12,27.04,41066,41083
865,16,34,14,32.00,22.50,41082,41098
866,22,34,7,23.27,68.83,41098,41120
867,26,27,11,19.69,10.91,41119,41145
868,32,34,1,16.00,172.62,41144,41176
869,16,34,28,32.00,3.00,41175,41191
870,17,34,4,30.12,44.93,41190,41207
871,18,34,3,28.44,112.14,41206,41224
872,45,34,0,11.38,66.55,41223,41268
873,16,34,6,32.00,46.00,41267,41283
874,16,34,15,32.00,21.25,41282,41298
875,16,33,18,32.00,13.12,41297,41313
876,100,34,0,5.12,99.93,41312,41412
877,35,34,5,14.63,21.26,41411,41446
878,32,34,6,16.00,42.12,41445,41477
879,16,34,14,32.00,30.00,41476,41492
880,16,34,12,32.00,27.00,41491,41507
881,17,33,1,30.12,68.93,41506,41523
882,20,34,0,25.60,108.14,41522,41542
883,24,23,20,21.33,1.39,41542,41566
884,26,34,1,19.69,35.29,41565,41591
885,26,34,1,19.69,25.37,41590,41616
886,22,34,17,23.27,29.38,41615,41637
887,18,30,8,28.44,26.47,41636,41654
888,17,33,6,30.12,38.46,41653,41670
889,20,34,1,25.60,167.04,41669,41689
890,16,34,11,32.00,34.12,41688,41704
891,16,34,13,32.00,31.12,41703,41719
892,16,34,15,32.00,29.12,41718,41734
893,20,34,1,25.60,92.04,41733,41753
894,21,27,12,24.38,9.47,41752,41773
895,22,34,2,23.27,48.02,41772,41794
896,21,27,13,24.38,8.52,41793,41814
897,21,34,13,24.38,15.28,41813,41834
898,23,25,1,22.26,22.37,41833,41856
899,30,34,0,17.07,119.86,41855,41885
900,20,27,20,25.60,2.74,41884,41904
901,36,34,1,14.22,46.78,41904,41940
902,27,22,1,18.96,24.48,41939,41966
903,28,32,1,18.29,29.99,41965,41993
904,28,34,5,18.29,16.56,41992,42020
905,28,34,9,18.29,13.70,42019,42047
906,27,25,10,18.96,6.11,42046,42073
907,29,34,3,17.66,21.88,42072,42101
908,37,34,0,13.84,61.22,42100,42137
909,30,34,8,17.07,14.46,42136,42166
910,31,34,4,16.52,20.38,42165,42196
911,33,34,11,15.52,20.98,42195,42228
912,45,34,1,11.38,32.46,42227,42272
913,16,34,18,32.00,21.50,42271,42287
914,17,32,14,30.12,27.04,42286,42303
915,17,34,4,30.12,63.28,42302,42319
916,16,34,9,32.00,36.38,42318,42334
917,16,34,11,32.00,34.12,42333,42349
918,16,34,23,32.00,9.38,42348,42364
919,18,34,3,28.44,110.80,42363,42381
920,16,34,30,32.00,2.50,42380,42396
921,18,31,1,28.44,57.69,42395,42413
922,16,34,16,32.00,18.00,42412,42428
923,22,34,1,23.27,149.29,42427,42449
924,24,31,4,21.33,69.72,42448,42472
925,18,31,16,28.44,13.69,42471,42489
926,41,34,0,12.49,127.57,42488,42529
927,19,27,26,26.95,0.05,42528,42547
928,18,30,12,28.44,16.14,42547,42565
929,21,34,18,24.38,9.66,42564,42585
930,20,33,5,25.60,24.94,42584,42604
931,18,34,1,28.44,47.69,42603,42621
932,18,33,6,28.44,43.80,42620,42638
933,17,34,7,30.12,47.04,42637,42654
934,17,34,4,30.12,47.04,42653,42670
935,17,31,20,30.12,7.28,42669,42686
936,16,34,11,32.00,29.62,42685,42701
937,17,34,2,30.12,54.34,42701,42718
938,18,29,21,28.44,3.47,42717,42735
939,18,32,4,28.44,63.91,42734,42752
940,17,34,3,30.12,48.69,42751,42768
941,17,31,19,30.12,8.22,42767,42784
942,17,34,7,30.12,58.69,42783,42800
943,18,34,2,28.44,65.69,42799,42817
944,20,33,4,25.60,36.54,42816,42836
945,18,30,17,28.44,8.47,42835,42853
946,29,34,0,17.66,158.36,42852,42881
947,22,29,6,23.27,24.74,42880,42902
948,22,30,13,23.27,12.93,42901,42923
949,26,34,4,19.69,47.37,42922,42948
950,22,30,12,23.27,22.47,42947,42969
951,23,34,4,22.26,49.24,42968,42991
952,34,21,2,15.06,23.23,42991,43025
953,33,33,1,15.52,22.37,43024,43057
954,29,23,11,17.66,15.19,43056,43085
955,34,34,0,15.06,55.70,43084,43118
956,26,27,7,19.69,13.06,43118,43144
957,27,26,1,18.96,33.74,43143,43170
958,26,34,4,19.69,53.98,43169,43195
959,34,37,4,15.06,37.94,43194,43228
960,19,37,14,26.95,50.58,43228,43247
961,21,29,9,24.38,16.05,43246,43267
962,29,34,1,17.66,96.71,43266,43295
963,25,34,2,20.48,42.81,43294,43319
964,70,28,0,7.31,75.44,43318,43388
965,30,34,2,17.07,26.13,43387,43417
966,20,34,10,25.60,71.64,43416,43436
967,17,34,2,30.12,50.57,43435,43452
968,17,34,4,30.12,59.04,43451,43468
969,17,34,8,30.12,70.93,43467,43484
970,16,34,13,32.00,31.12,43483,43499
971,16,34,15,32.00,29.12,43498,43514
972,16,34,17,32.00,28.12,43513,43529
973,30,34,0,17.07,158.86,43528,43558
974,41,19,2,12.49,24.59,43557,43598
975,31,34,3,16.52,42.89,43597,43628
976,24,34,7,21.33,123.64,43627,43651
977,16,34,15,32.00,29.12,43650,43666
978,16,34,13,32.00,31.12,43665,43681
979,16,34,11,32.00,33.12,43680,43696
980,29,34,8,17.66,74.98,43695,43724
981,32,34,3,16.00,26.12,43723,43755
982,23,34,4,22.26,24.02,43754,43777
983,26,34,1,19.69,58.29,43776,43802
984,19,34,13,26.95,62.37,43801,43820
985,16,34,17,32.00,15.25,43819,43835
986,20,33,4,25.60,28.94,43835,43855
987,19,32,14,26.95,13.52,43854,43873
988,21,34,3,24.38,44.33,43872,43893
989,21,29,20,24.38,3.76,43892,43913
990,25,34,5,20.48,37.77,43912,43937
991,20,34,14,25.60,56.44,43936,43956
992,16,34,12,32.00,32.50,43955,43971
993,16,34,10,32.00,36.00,43970,43986
994,16,34,8,32.00,40.50,43985,44001
995,17,32,6,30.12,38.34,44000,44017
996,17,34,6,30.12,45.16,44016,44033
997,16,34,13,32.00,26.25,44032,44048
998,18,34,4,28.44,52.69,44047,44065
999,20,31,20,25.60,4.24,44065,44085
1000,30,34,0,17.07,136.93,44084,44114
1001,28,33,0,18.29,159.20,44113,44141
1002,17,33,12,30.12,22.46,44140,44157
1003,29,34,0,17.66,208.98,44156,44185
1004,20,29,14,25.60,8.14,44184,44204
1005,19,34,9,26.95,29.00,44203,44222
1006,21,28,16,24.38,6.24,44221,44242
1007,20,28,7,25.60,31.24,44241,44261
1008,19,34,17,26.95,8.37,44260,44279
1009,19,33,1,26.95,41.52,44278,44297
1010,18,34,7,28.44,38.14,44296,44314
1011,16,34,15,32.00,29.12,44313,44329
1012,16,34,13,32.00,31.12,44328,44344
1013,16,34,11,32.00,34.12,44343,44359
1014,26,34,6,19.69,92.83,44358,44384
1015,22,34,18,23.27,7.38,44383,44405
1016,25,34,4,20.48,69.85,44404,44429
1017,28,25,1,18.29,87.20,44428,44456
1018,19,32,13,26.95,12.05,44455,44474
1019,37,34,1,13.84,57.87,44473,44510
1020,18,29,19,28.44,5.25,44509,44527
1021,17,33,20,30.12,8.10,44527,44544
1022,22,34,6,23.27,66.47,44543,44565
1023,26,34,3,19.69,28.91,44564,44590
1024,45,34,0,11.38,91.57,44589,44634
1025,165,22,0,3.10,6.80,44633,44798
1026,270,52,0,1.90,19.81,44797,45067
1027,158,22,0,3.24,12.46,45067,45225
1028,148,18,0,3.46,7.95,45224,45372
1029,109,10,0,4.70,8.71,45371,45480
1030,102,10,0,5.02,6.43,45479,45581
1031,177,31,0,2.89,19.70,45580,45757
1032,247,35,0,2.07,17.06,45757,46004
1033,186,18,0,2.75,12.30,46003,46189
1034,208,33,0,2.46,20.17,46188,46396
1035,22,91,2,23.27,789.38,46395,46417
1036,29,79,1,17.66,464.57,46416,46445
1037,80,105,0,6.40,174.89,46444,46524
1038,46,173,0,11.13,1338.20,46523,46569
1039,46,35,0,11.13,139.68,46569,46615
1040,25,71,0,20.48,544.49,46614,46639
1041,95,22,0,5.39,28.83,46638,46733
1042,164,27,0,3.12,24.72,46732,46896
1043,87,93,0,5.89,235.80,46895,46982
1044,36,92,0,14.22,627.67,46981,47017
1045,59,25,0,8.68,28.08,47016,47075
1046,143,20,0,3.58,12.71,47074,47217
1047,245,26,0,2.09,6.86,47216,47461
1048,250,20,0,2.05,8.21,47460,47710
1049,193,26,0,2.65,13.68,47710,47903
1050,284,127,0,1.80,56.74,47903,48187
1051,1,512,512,512.00,0.00,48186,48187
1052,1,512,512,512.00,0.00,48186,48187
1053,221,71,1,2.32,21.46,48186,48407
1054,930,47,0,0.55,3.89,48406,49336
1055,330,53,0,1.55,17.40,49335,49665
1056,99,27,0,5.17,38.59,49664,49763
1057,63,27,0,8.13,63.09,49762,49825
1058,39,46,4,13.13,34.83,49824,49863
1059,39,21,8,13.13,9.86,49863,49902
1060,39,15,3,13.13,3.14,49901,49940
1061,39,20,4,13.13,4.32,49939,49978
1062,30,155,1,17.07,664.33,49977,50007
1063,38,40,6,13.47,30.41,50006,50044
1064,38,40,4,13.47,26.88,50043,50081
1065,40,23,7,12.80,6.36,50080,50120
1066,33,136,4,15.52,456.43,50120,50153
1067,38,70,7,13.47,88.14,50152,50190
1068,43,18,5,11.91,2.08,50189,50232
1069,38,25,11,13.47,8.62,50232,50270
1070,36,74,2,14.22,106.12,50269,50305
1071,40,73,2,12.80,95.86,50305,50345
1072,45,28,7,11.38,7.04,50344,50389
1073,41,22,2,12.49,12.05,50388,50429
1074,37,35,9,13.84,25.00,50428,50465
1075,39,23,4,13.13,13.09,50464,50503
1076,37,37,5,13.84,27.92,50502,50539
1077,37,23,6,13.84,20.51,50538,50575
1078,41,29,8,12.49,10.40,50574,50615
1079,29,36,4,17.66,79.67,50614,50643
1080,36,45,7,14.22,42.73,50642,50678
1081,37,32,3,13.84,24.57,50677,50714
1082,36,40,7,14.22,44.95,50713,50749
1083,38,19,6,13.47,6.09,50748,50786
1084,40,28,1,12.80,10.56,50785,50825
1085,33,35,7,15.52,32.92,50824,50857
1086,28,56,6,18.29,174.20,50856,50884
1087,35,55,1,14.63,55.60,50883,50918
1088,27,37,12,18.96,56.48,50917,50944
1089,41,15,5,12.49,2.49,50943,50984
1090,42,14,5,12.19,2.96,50983,51025
1091,43,49,1,11.91,40.41,51024,51067
1092,44,22,11,11.64,5.64,51066,51110
1093,43,23,10,11.91,5.85,51110,51153
1094,39,40,4,13.13,36.16,51152,51191
1095,43,34,4,11.91,17.76,51190,51233
1096,40,52,5,12.80,52.11,51232,51272
1097,37,105,5,13.84,233.60,51271,51308
1098,46,13,6,11.13,1.77,51307,51353
1099,41,76,3,12.49,103.76,51352,51393
1100,45,24,2,11.38,9.48,51392,51437
1101,39,22,2,13.13,12.57,51436,51475
1102,40,19,5,12.80,6.51,51474,51514
1103,37,40,7,13.84,55.65,51513,51550
1104,44,22,6,11.64,5.91,51550,51594
1105,48,11,1,10.67,2.72,51593,51641
1106,35,138,10,14.63,447.72,51640,51675
1107,43,32,11,11.91,11.06,51675,51718
1108,41,24,1,12.49,13.52,51717,51758
1109,44,13,10,11.64,0.91,51757,51801
1110,38,40,1,13.47,29.93,51800,51838
1111,39,21,7,13.13,9.19,51837,51876
1112,39,19,7,13.13,5.24,51875,51914
1113,41,14,2,12.49,3.47,51913,51954
1114,41,13,8,12.49,1.13,51954,51995
1115,43,14,5,11.91,2.50,51994,52037
1116,36,101,1,14.22,222.73,52036,52072
1117,37,40,2,13.84,26.03,52071,52108
1118,37,29,11,13.84,10.19,52107,52144
1119,38,25,2,13.47,14.30,52143,52181
1120,38,18,1,13.47,7.99,52181,52219
1121,42,20,7,12.19,3.58,52218,52260
1122,24,34,9,21.33,73.81,52259,52283
1123,39,45,2,13.13,58.42,52282,52321
1124,41,32,4,12.49,18.98,52320,52361
1125,34,42,11,15.06,43.41,52360,52394
1126,34,40,5,15.06,84.76,52393,52427
1127,38,19,7,13.47,5.78,52426,52464
1128,37,24,4,13.84,13.11,52463,52500
1129,38,28,3,13.47,19.09,52499,52537
1130,38,27,1,13.47,17.57,52536,52574
1131,39,33,10,13.13,25.24,52573,52612
1132,38,19,4,13.47,10.30,52611,52649
1133,38,40,2,13.47,30.99,52648,52686
1134,39,18,4,13.13,8.06,52685,52724
1135,36,40,12,14.22,21.34,52723,52759
1136,34,40,2,15.06,47.88,52758,52792
1137,40,92,3,12.80,164.26,52791,52831
1138,36,40,9,14.22,21.73,52830,52866
1139,40,18,3,12.80,8.56,52865,52905
1140,38,19,9,13.47,2.46,52904,52942
1141,39,19,1,13.13,11.86,52941,52980
1142,38,20,10,13.47,4.62,52979,53017
1143,38,101,3,13.47,209.51,53016,53054
1144,32,39,2,16.00,59.25,53053,53085
1145,35,38,7,14.63,18.80,53084,53119
1146,31,101,4,16.52,241.28,53118,53149
1147,24,113,2,21.33,764.14,53148,53172
1148,37,14,9,13.84,0.68,53171,53208
1149,38,28,1,13.47,20.04,53207,53245
1150,37,34,9,13.84,26.62,53244,53281
1151,44,27,2,11.64,9.00,53280,53324
1152,29,51,10,17.66,102.64,53324,53353
1153,29,51,10,17.66,184.36,53352,53381
1154,39,27,8,13.13,14.98,53381,53420
1155,39,25,5,13.13,20.32,53419,53458
1156,28,38,6,18.29,65.06,53457,53485
1157,37,40,3,13.84,44.51,53484,53521
1158,40,24,8,12.80,10.21,53520,53560
1159,44,28,4,11.64,10.23,53559,53603
1160,32,27,4,16.00,43.94,53602,53634
1161,24,56,9,21.33,224.06,53633,53657
1162,35,40,5,14.63,40.58,53656,53691
1163,35,40,1,14.63,45.43,53691,53726
1164,39,24,8,13.13,20.01,53725,53764
1165,38,44,3,13.47,42.72,53763,53801
1166,35,44,8,14.63,48.58,53800,53835
1167,38,51,2,13.47,51.51,53834,53872
1168,38,51,7,13.47,43.78,53871,53909
1169,34,40,2,15.06,81.41,53908,53942
1170,37,32,9,13.84,30.08,53941,53978
1171,39,41,7,13.13,50.78,53978,54017
1172,34,40,6,15.06,45.41,54016,54050
1173,40,16,2,12.80,7.56,54049,54089
1174,39,40,2,13.13,25.39,54088,54127
1175,47,11,8,10.89,0.27,54126,54173
1176,34,113,3,15.06,305.94,54172,54206
1177,30,40,5,17.07,64.33,54205,54235
1178,35,113,7,14.63,289.20,54234,54269
1179,48,11,2,10.67,2.60,54268,54316
1180,38,113,7,13.47,268.51,54315,54353
1181,48,11,2,10.67,2.60,54352,54400
1182,37,40,9,13.84,28.24,54399,54436
1183,35,21,9,14.63,11.15,54435,54470
1184,32,40,1,16.00,63.31,54469,54501
1185,36,29,10,14.22,18.34,54500,54536
1186,36,26,1,14.22,23.01,54535,54571
1187,34,40,7,15.06,36.64,54570,54604
1188,37,29,4,13.84,21.87,54603,54640
1189,43,38,4,11.91,20.50,54639,54682
1190,31,26,10,16.52,35.80,54681,54712
1191,42,38,1,12.19,29.68,54711,54753
1192,35,27,8,14.63,18.86,54752,54787
1193,37,43,7,13.84,39.38,54786,54823
1194,42,45,3,12.19,30.73,54822,54864
1195,44,28,1,11.64,14.00,54863,54907
1196,34,40,2,15.06,63.11,54906,54940
1197,41,28,6,12.49,14.35,54939,54980
1198,34,40,1,15.06,55.88,54979,55013
1199,35,24,6,14.63,10.75,55012,55047
1200,38,25,1,13.47,18.04,55046,55084
1201,41,40,2,12.49,29.13,55083,55124
1202,32,40,9,16.00,62.31,55123,55155
1203,26,32,1,19.69,79.60,55154,55180
1204,42,29,3,12.19,9.82,55180,55222
1205,39,36,1,13.13,23.96,55221,55260
1206,33,25,10,15.52,24.98,55259,55292
1207,31,40,2,16.52,61.54,55292,55323
1208,31,39,3,16.52,56.57,55322,55353
1209,36,58,11,14.22,61.67,55352,55388
1210,47,12,5,10.89,0.78,55388,55435
1211,47,11,6,10.89,0.52,55434,55481
1212,31,87,10,16.52,347.60,55481,55512
1213,48,13,1,10.67,4.22,55511,55559
1214,30,29,11,17.07,49.60,55558,55588
1215,40,26,2,12.80,8.91,55588,55628
1216,38,37,9,13.47,27.78,55627,55665
1217,34,40,6,15.06,57.82,55664,55698
1218,33,23,6,15.52,24.80,55697,55730
1219,40,64,5,12.80,69.86,55729,55769
1220,38,20,6,13.47,11.51,55768,55806
1221,16,82,11,32.00,703.25,55805,55821
1222,9,103,17,56.89,934.10,55820,55829
1223,32,17,5,16.00,7.25,55828,55860
1224,41,20,4,12.49,6.44,55859,55900
1225,45,13,2,11.38,2.81,55899,55944
1226,43,13,9,11.91,0.88,55943,55986
1227,43,17,2,11.91,3.71,55986,56029
1228,40,47,3,12.80,37.06,56028,56068
1229,45,13,8,11.38,0.86,56067,56112
1230,37,23,2,13.84,9.97,56111,56148
1231,37,23,2,13.84,13.49,56147,56184
1232,37,40,4,13.84,30.41,56184,56221
1233,34,24,8,15.06,16.06,56220,56254
1234,38,24,3,13.47,9.88,56253,56291
1235,36,20,10,14.22,8.06,56290,56326
1236,34,40,1,15.06,48.17,56325,56359
1237,36,24,4,14.22,12.06,56358,56394
1238,43,16,9,11.91,1.99,56393,56436
1239,35,51,1,14.63,88.23,56435,56470
1240,38,40,5,13.47,41.78,56469,56507
1241,37,40,7,13.84,41.81,56506,56543
1242,42,27,7,12.19,8.06,56542,56584
1243,35,26,7,14.63,22.69,56583,56618
1244,42,25,5,12.19,12.77,56617,56659
1245,46,24,2,11.13,5.50,56658,56704
1246,28,103,10,18.29,308.85,56703,56731
1247,36,127,4,14.22,365.62,56730,56766
1248,47,14,2,10.89,2.01,56765,56812
1249,26,41,10,19.69,103.83,56811,56837
1250,21,92,1,24.38,775.47,56836,56857
1251,42,30,5,12.19,18.82,56856,56898
1252,48,11,3,10.67,2.56,56897,56945
1253,47,12,8,10.89,0.39,56944,56991
1254,45,16,3,11.38,5.17,56990,57035
1255,32,51,6,16.00,64.44,57034,57066
1256,33,50,8,15.52,42.73,57065,57098
1257,6,104,19,85.33,968.56,57097,57103
1258,34,51,11,15.06,39.47,57102,57136
1259,37,15,4,13.84,5.81,57135,57172
1260,30,35,3,17.07,68.26,57171,57201
1261,32,42,3,16.00,35.06,57200,57232
1262,37,23,11,13.84,9.54,57231,57268
1263,26,38,3,19.69,108.75,57267,57293
1264,41,33,4,12.49,23.76,57292,57333
1265,40,26,6,12.80,7.71,57332,57372
1266,39,49,6,13.13,35.65,57371,57410
1267,37,15,2,13.84,7.00,57409,57446
1268,6,215,10,85.33,8521.56,57445,57451
1269,26,171,3,19.69,920.37,57450,57476
1270,20,132,11,25.60,1246.84,57475,57495
1271,29,132,2,17.66,474.02,57494,57523
1272,33,47,2,15.52,68.67,57522,57555
1273,40,16,5,12.80,2.96,57554,57594
1274,41,14,1,12.49,4.10,57593,57634
1275,26,189,12,19.69,1146.83,57633,57659
1276,2,430,82,256.00,30276.00,57658,57660
1277,1,512,512,512.00,0.00,57659,57660
1278,2,487,25,256.00,53361.00,57659,57661
1279,31,131,6,16.52,438.70,57660,57691
1280,39,15,7,13.13,1.70,57690,57729
1281,41,14,2,12.49,3.37,57728,57769
1282,39,14,5,13.13,2.16,57768,57807
1283,40,14,1,12.80,4.11,57806,57846
1284,40,15,1,12.80,6.21,57845,57885
1285,37,16,13,13.84,0.41,57884,57921
1286,32,51,12,16.00,41.88,57921,57953
1287,8,97,15,64.00,988.00,57952,57960
1288,26,67,9,19.69,186.29,57959,57985
1289,35,22,1,14.63,12.40,57984,58019
1290,37,40,6,13.84,40.84,58018,58055
1291,41,30,2,12.49,21.66,58054,58095
1292,23,63,12,22.26,256.54,58094,58117
1293,33,40,10,15.52,21.83,58116,58149
1294,33,123,4,15.52,363.52,58148,58181
1295,33,124,1,15.52,373.83,58180,58213
1296,29,38,1,17.66,106.71,58212,58241
1297,32,21,3,16.00,9.56,58240,58272
1298,37,18,1,13.84,6.46,58271,58308
1299,26,38,2,19.69,69.14,58307,58333
1300,29,49,2,17.66,55.54,58332,58361
1301,25,63,1,20.48,170.17,58360,58385
1302,21,84,11,24.38,341.57,58384,58405
1303,34,21,3,15.06,12.17,58404,58438
1304,38,15,12,13.47,0.41,58438,58476
1305,20,207,13,25.60,1736.34,58476,58496
1306,23,57,14,22.26,114.28,58496,58519
1307,32,20,1,16.00,18.75,58518,58550
1308,25,52,15,20.48,96.01,58549,58574
1309,34,51,5,15.06,79.58,58573,58607
1310,47,11,6,10.89,0.52,58606,58653
1311,47,11,6,10.89,0.52,58653,58700
1312,45,32,5,11.38,10.81,58699,58744
1313,87,20,0,5.89,23.23,58743,58830
1314,46,15,8,11.13,1.07,58829,58875
1315,24,71,4,21.33,285.89,58874,58898
1316,28,71,4,18.29,183.85,58897,58925
1317,35,26,10,14.63,10.92,58924,58959
1318,42,26,1,12.19,10.77,58958,59000
1319,32,101,1,16.00,337.88,58999,59031
1320,30,80,5,17.07,163.73,59030,59060
1321,37,39,10,13.84,23.76,59059,59096
1322,31,39,1,16.52,70.25,59095,59126
1323,25,76,2,20.48,408.01,59125,59150
1324,23,71,3,22.26,257.06,59149,59172
1325,29,21,1,17.66,14.02,59171,59200
1326,3,252,124,170.67,3331.56,59199,59202
1327,2,340,172,256.00,7056.00,59201,59203
1328,5,150,16,102.40,2510.64,59202,59207
1329,3,265,16,170.67,12153.56,59206,59209
1330,20,194,10,25.60,1497.54,59208,59228
1331,33,18,7,15.52,3.34,59227,59260
1332,36,20,4,14.22,7.34,59259,59295
1333,38,15,6,13.47,2.88,59295,59333
1334,32,19,6,16.00,13.44,59332,59364
1335,36,40,1,14.22,32.06,59363,59399
1336,48,11,1,10.67,2.72,59398,59446
1337,45,34,6,11.38,12.19,59445,59490
1338,12,71,1,42.67,858.56,59489,59501
1339,9,68,9,56.89,350.54,59500,59509
1340,14,69,10,36.57,718.10,59508,59522
1341,12,72,10,42.67,740.72,59521,59533
1342,13,74,10,39.38,782.08,59532,59545
1343,12,75,10,42.67,787.39,59544,59556
1344,17,71,7,30.12,758.46,59555,59572
1345,15,65,10,34.13,658.92,59571,59586
1346,14,72,5,36.57,789.67,59585,59599
1347,41,67,1,12.49,83.57,59598,59639
1348,48,11,2,10.67,2.60,59638,59686
1349,51,11,0,10.04,8.08,59685,59736
1350,45,33,8,11.38,10.90,59735,59780
1351,40,34,2,12.80,29.26,59779,59819
1352,23,38,5,22.26,76.45,59818,59841
1353,41,22,1,12.49,8.74,59840,59881
1354,44,22,10,11.64,3.19,59880,59924
1355,40,15,5,12.80,3.61,59924,59964
1356,34,71,5,15.06,98.70,59963,59997
1357,33,49,6,15.52,47.04,59996,60029
1358,30,49,10,17.07,39.20,60028,60058
1359,28,49,3,18.29,82.85,60057,60085
1360,37,25,1,13.84,13.38,60084,60121
1361,40,31,4,12.80,14.51,60120,60160
1362,39,19,4,13.13,5.29,60159,60198
1363,29,63,7,17.66,149.33,60197,60226
1364,41,77,2,12.49,108.84,60225,60266
1365,37,100,9,13.84,209.22,60265,60302
1366,31,40,1,16.52,56.06,60301,60332
1367,28,40,11,18.29,82.99,60331,60359
1368,38,40,11,13.47,28.25,60359,60397
1369,37,98,6,13.84,199.54,60396,60433
1370,38,87,5,13.47,153.25,60432,60470
1371,47,15,1,10.89,2.56,60469,60516
1372,30,36,6,17.07,56.80,60515,60545
1373,38,23,6,13.47,17.04,60545,60583
1374,31,107,2,16.52,324.38,60582,60613
1375,34,58,2,15.06,60.17,60612,60646
1376,5,140,11,102.40,2587.44,60645,60650
1377,25,140,1,20.48,692.01,60649,60674
1378,37,15,2,13.84,4.08,60673,60710
1379,37,15,1,13.84,4.95,60709,60746
1380,24,185,14,21.33,1164.89,60745,60769
1381,2,368,144,256.00,12544.00,60768,60770
1382,9,409,4,56.89,15507.88,60769,60778
1383,34,43,11,15.06,24.17,60777,60811
1384,4,181,12,128.00,4793.50,60810,60814
1385,14,181,6,36.57,3181.39,60813,60827
1386,28,144,6,18.29,588.92,60826,60854
1387,37,14,8,13.84,0.95,60853,60890
1388,25,136,8,20.48,586.17,60890,60915
1389,39,25,3,13.13,13.60,60914,60953
1390,32,28,8,16.00,26.81,60952,60984
1391,32,25,2,16.00,20.31,60983,61015
1392,33,55,1,15.52,97.46,61015,61048
1393,37,37,10,13.84,49.11,61047,61084
1394,38,49,4,13.47,56.20,61083,61121
1395,43,53,5,11.91,41.25,61120,61163
1396,43,35,4,11.91,16.22,61162,61205
1397,42,13,3,12.19,3.39,61204,61246
1398,40,13,8,12.80,0.81,61245,61285
1399,41,13,1,12.49,4.84,61284,61325
1400,40,13,6,12.80,1.21,61324,61364
1401,40,13,7,12.80,0.96,61363,61403
1402,41,13,2,12.49,5.13,61402,61443
1403,18,294,10,28.44,4148.69,61442,61460
1404,2,401,111,256.00,21025.00,61459,61461
1405,37,22,3,13.84,10.46,61460,61497
1406,34,31,1,15.06,25.41,61496,61530
1407,35,34,6,14.63,27.95,61529,61564
1408,42,34,2,12.19,20.92,61563,61605
1409,40,35,3,12.80,18.56,61604,61644
1410,34,33,1,15.06,45.82,61643,61677
1411,31,33,3,16.52,64.77,61676,61707
1412,41,33,2,12.49,15.18,61706,61747
1413,37,16,3,13.84,4.35,61746,61783
1414,22,55,11,23.27,225.74,61782,61804
1415,36,16,13,14.22,0.28,61803,61839
1416,36,17,11,14.22,0.95,61839,61875
1417,36,40,3,14.22,33.67,61874,61910
1418,32,76,3,16.00,244.56,61909,61941
1419,42,16,5,12.19,2.54,61940,61982
1420,25,40,2,20.48,101.93,61981,62006
1421,31,29,1,16.52,18.38,62005,62036
1422,27,65,11,18.96,188.41,62035,62062
1423,18,65,15,28.44,291.36,62061,62079
1424,29,47,3,17.66,38.16,62078,62107
1425,39,31,4,13.13,26.21,62106,62145
1426,34,29,6,15.06,33.88,62144,62178
1427,41,29,11,12.49,15.71,62177,62218
1428,30,60,4,17.07,113.26,62218,62248
1429,35,16,5,14.63,4.46,62247,62282
1430,35,40,5,14.63,43.49,62281,62316
1431,44,15,6,11.64,2.87,62315,62359
1432,34,89,2,15.06,172.64,62358,62392
1433,32,40,3,16.00,42.94,62391,62423
1434,35,26,10,14.63,10.23,62422,62457
1435,38,23,8,13.47,10.09,62456,62494
1436,39,28,5,13.13,15.34,62493,62532
1437,39,53,3,13.13,52.93,62531,62570
1438,38,40,8,13.47,25.67,62570,62608
1439,41,31,1,12.49,22.93,62607,62648
1440,19,155,10,26.95,1638.47,62647,62666
1441,27,154,12,18.96,704.04,62665,62692
1442,40,15,1,12.80,6.96,62691,62731
1443,38,23,6,13.47,6.62,62730,62768
1444,35,61,1,14.63,131.95,62767,62802
1445,34,36,11,15.06,29.88,62801,62835
1446,38,16,12,13.47,0.51,62834,62872
1447,34,65,11,15.06,87.17,62872,62906
1448,30,35,3,17.07,70.53,62905,62935
1449,30,36,9,17.07,63.93,62934,62964
1450,36,25,6,14.22,7.28,62963,62999
1451,32,38,1,16.00,46.25,62998,63030
1452,43,14,5,11.91,2.32,63029,63072
1453,36,116,10,14.22,296.56,63071,63107
1454,47,13,1,10.89,2.39,63106,63153
1455,48,11,1,10.67,2.72,63152,63200
1456,47,11,6,10.89,0.52,63199,63246
1457,47,11,6,10.89,0.52,63246,63293
1458,48,11,1,10.67,2.72,63292,63340
1459,37,23,1,13.84,23.54,63339,63376
1460,43,36,5,11.91,18.32,63375,63418
1461,47,12,6,10.89,0.56,63417,63464
1462,48,11,1,10.67,2.72,63463,63511
1463,47,11,6,10.89,0.52,63510,63557
1464,18,313,11,28.44,4764.58,63557,63575
1465,13,341,5,39.38,7603.01,63574,63587
1466,37,14,9,13.84,0.68,63586,63623
1467,32,67,1,16.00,190.19,63622,63654
1468,38,26,3,13.47,17.57,63653,63691
1469,40,33,5,12.80,33.41,63690,63730
1470,43,31,2,11.91,16.13,63729,63772
1471,42,29,8,12.19,14.30,63771,63813
1472,40,30,3,12.80,15.31,63812,63852
1473,38,22,2,13.47,12.78,63851,63889
1474,38,43,6,13.47,69.83,63888,63926
1475,36,43,5,14.22,66.78,63925,63961
1476,35,54,3,14.63,109.15,63960,63995
1477,42,24,7,12.19,5.44,63994,64036
1478,38,55,3,13.47,65.99,64035,64073
1479,45,13,2,11.38,3.88,64072,64117
1480,38,61,9,13.47,62.83,64116,64154
1481,41,48,5,12.49,34.69,64153,64194
1482,40,63,2,12.80,68.71,64193,64233
1483,39,63,4,13.13,68.21,64232,64271
1484,41,51,1,12.49,42.20,64270,64311
1485,39,51,4,13.13,48.42,64310,64349
1486,40,35,3,12.80,24.76,64348,64388
1487,43,36,4,11.91,28.46,64387,64430
1488,40,39,7,12.80,38.81,64429,64469
1489,40,26,1,12.80,22.66,64468,64508
1490,38,25,6,13.47,15.04,64507,64545
1491,38,40,2,13.47,29.93,64544,64582
1492,47,13,3,10.89,1.46,64581,64628
1493,42,73,1,12.19,92.73,64627,64669
1494,38,53,2,13.47,68.25,64668,64706
1495,39,29,11,13.13,17.80,64705,64744
1496,38,70,11,13.47,90.46,64744,64782
1497,47,14,5,10.89,1.58,64781,64828
1498,34,62,6,15.06,101.58,64827,64861
1499,38,44,1,13.47,45.62,64860,64898
1500,47,12,5,10.89,0.90,64897,64944
1501,47,12,6,10.89,0.78,64943,64990
1502,48,12,2,10.67,2.93,64989,65037
1503,46,13,7,11.13,0.72,65036,65082
1504,29,210,4,17.66,1322.98,65081,65110
1505,38,40,4,13.47,36.93,65109,65147
1506,38,21,7,13.47,7.88,65146,65184
1507,38,42,7,13.47,38.04,65183,65221
1508,40,18,8,12.80,3.71,65220,65260
1509,43,60,1,11.91,57.34,65259,65302
1510,35,29,10,14.63,18.46,65301,65336
1511,34,29,4,15.06,26.06,65335,65369
1512,39,18,1,13.13,10.83,65368,65407
1513,28,218,4,18.29,1479.35,65406,65434
1514,37,23,9,13.84,9.92,65433,65470
1515,41,27,2,12.49,18.49,65469,65510
1516,35,48,2,14.63,44.35,65509,65544
1517,27,40,3,18.96,94.26,65543,65570
1518,27,96,1,18.96,480.41,65569,65596
1519,40,14,4,12.80,2.06,65595,65635
1520,40,15,7,12.80,1.51,65634,65674
1521,34,40,5,15.06,42.58,65673,65707
1522,37,25,6,13.84,6.84,65706,65743
1523,34,68,9,15.06,86.00,65742,65776
1524,35,40,3,14.63,38.29,65775,65810
1525,36,22,4,14.22,13.95,65809,65845
1526,43,32,1,11.91,24.55,65844,65887
1527,37,95,5,13.84,191.00,65886,65923
1528,29,34,7,17.66,77.12,65922,65951
1529,39,34,2,13.13,25.70,65950,65989
1530,34,43,9,15.06,66.35,65988,66022
1531,38,26,4,13.47,10.30,66021,66059
1532,37,24,6,13.84,13.22,66058,66095
1533,35,40,1,14.63,50.58,66094,66129
1534,34,40,7,15.06,47.23,66128,66162
1535,37,33,1,13.84,27.70,66161,66198
1536,41,19,6,12.49,4.74,66197,66238
1537,40,29,8,12.80,9.31,66237,66277
1538,40,26,1,12.80,12.76,66276,66316
1539,35,28,7,14.63,26.52,66315,66350
1540,37,40,5,13.84,24.78,66349,66386
1541,47,14,4,10.89,1.97,66385,66432
1542,46,20,7,11.13,2.11,66431,66477
1543,35,70,6,14.63,102.98,66476,66511
1544,41,23,2,12.49,13.03,66510,66551
1545,38,23,11,13.47,7.83,66550,66588
1546,38,29,1,13.47,36.67,66587,66625
1547,39,29,9,13.13,17.86,66624,66663
1548,40,40,2,12.80,29.21,66662,66702
1549,39,40,1,13.13,37.75,66701,66740
1550,40,40,3,12.80,25.71,66739,66779
1551,37,40,7,13.84,40.89,66778,66815
1552,40,46,6,12.80,30.96,66814,66854
1553,35,40,10,14.63,40.86,66853,66888
1554,41,54,1,12.49,47.37,66888,66929
1555,41,16,5,12.49,3.76,66928,66969
1556,38,41,1,13.47,41.51,66968,67006
1557,36,28,11,14.22,25.01,67005,67041
1558,39,26,2,13.13,16.62,67041,67080
1559,39,39,4,13.13,41.34,67079,67118
1560,42,27,2,12.19,21.01,67117,67159
1561,44,22,1,11.64,6.32,67158,67202
1562,40,87,2,12.80,143.66,67201,67241
1563,40,87,4,12.80,142.61,67240,67280
1564,41,31,7,12.49,14.54,67279,67320
1565,37,44,1,13.84,48.24,67319,67356
1566,43,24,1,11.91,9.48,67355,67398
1567,47,13,3,10.89,1.50,67397,67444
1568,39,58,2,13.13,58.93,67443,67482
1569,31,67,9,16.52,144.83,67481,67512
1570,41,27,1,12.49,12.25,67511,67552
1571,33,66,10,15.52,90.43,67551,67584
1572,39,20,3,13.13,9.14,67583,67622
1573,37,21,5,13.84,10.30,67622,67659
1574,39,88,6,13.13,149.75,67658,67697
1575,42,17,1,12.19,5.25,67696,67738
1576,37,22,4,13.84,9.92,67737,67774
1577,37,40,4,13.84,30.73,67773,67810
1578,38,62,8,13.47,66.57,67809,67847
1579,66,11,1,7.76,21.30,67846,67912
1580,41,70,1,12.49,96.88,67911,67952
1581,40,49,4,12.80,65.61,67951,67991
1582,44,48,2,11.64,32.55,67991,68035
1583,38,60,9,13.47,70.93,68034,68072
1584,47,15,1,10.89,4.05,68071,68118
1585,69,31,0,7.42,95.32,68117,68186
1586,177,88,0,2.89,97.38,68186,68363
1587,1,512,512,512.00,0.00,68362,68363
1588,1,512,512,512.00,0.00,68362,68363
1589,314,199,1,1.63,124.46,68362,68676
1590,512,1,1,1.00,0.00,68676,69188
1591,445,12,0,1.15,1.00,69188,69633
1592,269,38,0,1.90,32.53,69633,69902
1593,337,142,0,1.52,84.85,69901,70238
1594,217,30,0,2.36,25.06,70237,70454
1595,199,52,0,2.57,38.09,70454,70653
1596,249,80,0,2.06,56.13,70652,70901
1597,274,59,0,1.87,32.24,70900,71174
1598,210,22,0,2.44,22.95,71174,71384
1599,189,65,0,2.71,42.03,71384,71573
1600,404,142,0,1.27,81.20,71572,71976
1601,236,25,0,2.17,22.04,71975,72211
1602,241,89,0,2.12,62.51,72210,72451
1603,291,46,0,1.76,30.69,72450,72741
1604,199,33,0,2.57,26.84,72741,72940
1605,214,33,0,2.39,26.11,72939,73153
1606,237,40,0,2.16,25.37,73152,73389
1607,197,38,0,2.60,31.81,73388,73585
1608,270,134,0,1.90,91.57,73584,73854
1609,306,41,0,1.67,32.21,73853,74159
1610,262,40,0,1.95,28.49,74158,74420
1611,257,72,0,1.99,39.08,74419,74676
1612,286,86,0,1.79,49.35,74675,74961
1613,270,29,0,1.90,31.07,74960,75230
1614,238,42,0,2.15,32.86,75229,75467
1615,252,52,0,2.03,31.88,75466,75718
1616,280,68,0,1.83,46.91,75717,75997
1617,231,59,0,2.22,51.46,75996,76227
1618,209,36,0,2.45,26.67,76227,76436
1619,327,50,0,1.57,44.58,76435,76762
1620,331,53,0,1.55,48.78,76761,77092
1621,289,71,0,1.77,49.59,77091,77380
1622,244,37,0,2.10,25.90,77379,77623
1623,156,14,0,3.28,14.34,77622,77778
1624,119,14,0,4.30,14.92,77778,77897
1625,139,17,0,3.68,15.51,77896,78035
1626,126,14,0,4.06,14.20,78034,78160
1627,123,26,0,4.16,16.69,78159,78282
1628,57,293,0,8.98,1454.93,78281,78338
1629,1,512,512,512.00,0.00,78337,78338
1630,4,498,2,128.00,45636.50,78337,78341
1631,111,17,0,4.61,14.33,78340,78451
1632,127,30,0,4.03,24.27,78450,78577
1633,126,19,0,4.06,18.28,78576,78702
1634,136,23,0,3.76,21.94,78701,78837
1635,143,24,0,3.58,19.40,78836,78979
1636,138,25,0,3.71,21.34,78978,79116
1637,128,35,0,4.00,23.17,79115,79243
1638,125,25,0,4.10,19.75,79242,79367
1639,109,38,0,4.70,25.57,79366,79475
1640,143,21,0,3.58,19.33,79474,79617
1641,129,13,0,3.97,14.94,79616,79745
1642,131,18,0,3.91,15.90,79744,79875
1643,145,25,0,3.53,20.50,79874,80019
1644,140,23,0,3.66,18.70,80018,80158
1645,132,22,0,3.88,17.02,80157,80289
1646,126,22,0,4.06,20.33,80288,80414
1647,120,23,0,4.27,19.95,80413,80533
1648,112,29,0,4.57,24.08,80532,80644
1649,125,30,0,4.10,20.13,80643,80768
1650,132,25,0,3.88,15.77,80767,80899
1651,63,271,0,8.13,1124.87,80898,80961
1652,73,150,0,7.01,292.78,80960,81033
1653,122,22,0,4.20,17.21,81032,81154
1654,125,14,0,4.10,12.53,81153,81278
1655,130,18,0,3.94,16.72,81277,81407
1656,137,28,0,3.74,29.22,81406,81543
1657,143,16,0,3.58,15.66,81542,81685
1658,130,18,0,3.94,17.90,81685,81815
1659,115,19,0,4.45,15.40,81814,81929
1660,136,24,0,3.76,17.67,81928,82064
1661,122,11,0,4.20,11.57,82063,82185
1662,93,51,0,5.51,55.91,82184,82277
1663,58,50,0,8.83,67.66,82276,82334
1664,59,51,1,8.68,66.22,82333,82392
1665,57,50,6,8.98,66.33,82391,82448
1666,55,51,0,9.31,79.92,82447,82502
1667,54,51,0,9.48,91.88,82501,82555
1668,61,51,1,8.39,63.03,82554,82615
1669,51,51,2,10.04,107.14,82614,82665
1670,58,50,0,8.83,66.52,82664,82722
1671,55,51,0,9.31,105.56,82721,82776
1672,68,51,0,7.53,66.81,82776,82844
1673,54,57,0,9.48,83.32,82843,82897
1674,55,51,1,9.31,38.18,82897,82952
1675,53,51,0,9.66,41.43,82951,83004
1676,53,51,1,9.66,109.02,83003,83056
1677,146,33,0,3.51,23.06,83055,83201
1678,81,29,0,6.32,26.32,83200,83281
1679,74,7,1,6.92,0.48,83281,83355
1680,76,7,0,6.74,1.35,83354,83430
1681,64,57,1,8.00,44.16,83429,83493
1682,76,8,0,6.74,1.46,83492,83568
1683,69,83,0,7.42,87.90,83567,83636
1684,82,34,0,6.24,18.26,83635,83717
1685,90,23,0,5.69,14.04,83717,83807
1686,105,36,0,4.88,40.60,83806,83911
1687,93,19,0,5.51,15.33,83910,84003
1688,102,26,0,5.02,19.04,84002,84104
1689,108,57,0,4.74,53.47,84104,84212
1690,109,30,0,4.70,25.33,84211,84320
1691,87,27,0,5.89,16.08,84319,84406
1692,116,22,0,4.41,19.66,84405,84521
1693,95,32,0,5.39,36.24,84520,84615
1694,96,44,0,5.33,28.95,84615,84711
1695,98,37,0,5.22,22.17,84710,84808
1696,122,22,0,4.20,21.14,84807,84929
1697,98,20,0,5.22,14.87,84928,85026
1698,98,14,0,5.22,11.85,85025,85123
1699,84,22,0,6.10,13.30,85122,85206
1700,100,18,0,5.12,13.67,85205,85305
1701,89,20,0,5.75,15.29,85304,85393
1702,96,14,0,5.33,11.14,85392,85488
1703,98,15,0,5.22,11.42,85487,85585
1704,77,36,0,6.65,28.95,85584,85661
1705,59,38,1,8.68,27.88,85660,85719
1706,50,67,0,10.24,163.86,85718,85768
1707,59,74,0,8.68,92.69,85767,85826
1708,52,41,0,9.85,53.13,85826,85878
1709,41,57,6,12.49,148.54,85877,85918
1710,62,47,0,8.26,39.03,85918,85980
1711,70,43,0,7.31,30.02,85979,86049
1712,61,66,0,8.39,70.70,86048,86109
1713,80,46,0,6.40,44.32,86108,86188
1714,175,80,0,2.93,69.68,86187,86362
1715,59,43,3,8.68,46.83,86361,86420
1716,67,32,0,7.64,24.50,86419,86486
1717,85,29,0,6.02,18.31,86485,86570
1718,67,74,0,7.64,119.01,86569,86636
1719,60,60,1,8.53,54.02,86635,86695
1720,66,59,0,7.76,54.12,86694,86760
1721,82,244,0,6.24,714.01,86759,86841
1722,131,19,0,3.91,16.46,86840,86971
1723,93,23,0,5.51,17.22,86970,87063
1724,37,57,4,13.84,165.60,87062,87099
1725,117,18,0,4.38,23.47,87098,87215
1726,128,17,0,4.00,16.72,87214,87342
1727,32,29,3,16.00,20.44,87341,87373
1728,38,21,5,13.47,10.99,87372,87410
1729,49,31,0,10.45,50.17,87409,87458
1730,303,43,0,1.69,16.40,87457,87760
1731,101,16,0,5.07,18.01,87759,87860
1732,111,41,0,4.61,92.63,87860,87971
1733,13,41,26,39.38,17.47,87970,87983
1734,14,41,5,36.57,121.24,87982,87996
1735,19,40,1,26.95,293.94,87995,88014
1736,13,40,33,39.38,3.47,88013,88026
1737,17,41,6,30.12,240.22,88025,88042
1738,14,41,6,36.57,119.96,88041,88055
1739,18,41,4,28.44,269.58,88054,88072
1740,14,41,2,36.57,126.82,88071,88085
1741,13,41,23,39.38,23.01,88084,88097
1742,19,41,3,26.95,275.94,88096,88115
1743,14,40,13,36.57,71.82,88114,88128
1744,18,40,6,28.44,227.69,88127,88145
1745,13,42,21,39.38,40.08,88144,88157
1746,13,42,13,39.38,59.78,88156,88169
1747,19,42,5,26.95,296.26,88168,88187
1748,13,41,27,39.38,16.24,88186,88199
1749,14,41,7,36.57,118.96,88198,88212
1750,18,40,6,28.44,233.14,88211,88229
1751,14,40,6,36.57,84.82,88228,88242
1752,12,248,6,42.67,4082.89,88241,88253
1753,9,185,33,56.89,2059.43,88252,88261
1754,13,42,9,39.38,77.01,88260,88273
1755,20,42,1,25.60,329.94,88272,88292
1756,13,40,33,39.38,3.47,88291,88304
1757,14,40,1,36.57,102.67,88303,88317
1758,17,41,6,30.12,235.04,88316,88333
1759,14,41,9,36.57,117.82,88332,88346
1760,18,41,2,28.44,273.91,88345,88363
1761,13,40,34,39.38,2.70,88362,88375
1762,14,40,6,36.57,84.82,88374,88388
1763,19,40,6,26.95,232.16,88387,88406
1764,14,38,24,36.57,14.53,88405,88419
1765,18,41,6,28.44,230.14,88418,88436
1766,14,41,9,36.57,117.82,88435,88449
1767,18,41,1,28.44,278.25,88448,88466
1768,15,38,6,34.13,95.05,88465,88480
1769,14,38,25,36.57,13.53,88479,88493
1770,17,41,6,30.12,240.34,88492,88509
1771,14,41,5,36.57,121.24,88508,88522
1772,18,41,6,28.44,263.25,88521,88539
1773,14,41,1,36.57,129.24,88538,88552
1774,13,41,22,39.38,25.47,88551,88564
1775,18,41,2,28.44,275.14,88563,88581
1776,14,41,8,36.57,118.24,88580,88594
1777,18,41,6,28.44,256.36,88593,88611
1778,14,40,5,36.57,87.82,88610,88624
1779,14,40,13,36.57,71.82,88623,88637
1780,18,41,6,28.44,254.91,88636,88654
1781,13,41,30,39.38,14.39,88653,88666
1782,20,41,6,25.60,290.84,88665,88685
1783,13,41,29,39.38,14.70,88684,88697
1784,14,41,8,36.57,118.24,88696,88710
1785,17,41,4,30.12,254.10,88709,88726
1786,13,41,24,39.38,20.85,88725,88738
1787,18,41,6,28.44,255.14,88737,88755
1788,13,41,27,39.38,16.24,88754,88767
1789,14,41,7,36.57,118.96,88766,88780
1790,18,41,3,28.44,272.25,88779,88797
1791,13,41,23,39.38,23.01,88796,88809
1792,18,48,6,28.44,282.80,88808,88826
1793,5,385,1,102.40,20217.84,88825,88830
1794,13,42,9,39.38,77.01,88829,88842
1795,13,42,17,39.38,47.47,88841,88854
1796,20,42,6,25.60,241.94,88853,88873
1797,14,38,23,36.57,15.82,88872,88886
1798,18,41,5,28.44,246.47,88885,88903
1799,13,41,29,39.38,14.70,88902,88915
1800,15,41,2,34.13,191.98,88914,88929
1801,17,41,4,30.12,254.10,88928,88945
1802,14,41,8,36.57,118.24,88944,88958
1803,18,41,6,28.44,251.47,88957,88975
1804,13,40,32,39.38,4.54,88974,88987
1805,18,41,1,28.44,272.14,88987,89005
1806,13,41,21,39.38,28.24,89004,89017
1807,13,41,20,39.38,31.31,89016,89029
1808,18,41,6,28.44,264.91,89029,89047
1809,14,41,4,36.57,122.82,89046,89060
1810,16,41,6,32.00,226.25,89059,89075
1811,14,42,6,36.57,156.82,89075,89089
1812,14,42,4,36.57,176.82,89088,89102
1813,18,42,6,28.44,264.25,89101,89119
1814,14,40,14,36.57,71.10,89118,89132
1815,15,40,4,34.13,150.65,89131,89146
1816,16,41,2,32.00,243.75,89145,89161
1817,13,41,26,39.38,17.47,89160,89173
1818,19,41,6,26.95,260.79,89172,89191
1819,14,40,7,36.57,82.10,89190,89204
1820,17,40,6,30.12,213.99,89203,89220
1821,14,40,7,36.57,82.10,89219,89233
1822,13,40,33,39.38,3.47,89232,89245
1823,17,41,1,30.12,264.22,89244,89261
1824,14,41,1,36.57,129.24,89260,89274
1825,19,41,3,26.95,284.37,89273,89292
1826,13,41,23,39.38,23.01,89291,89304
1827,14,41,2,36.57,126.82,89303,89317
1828,17,41,6,30.12,245.87,89316,89333
1829,14,41,8,36.57,118.24,89332,89346
1830,18,41,6,28.44,259.58,89345,89363
1831,14,41,4,36.57,122.82,89362,89376
1832,13,41,25,39.38,19.01,89375,89388
1833,19,41,5,26.95,269.73,89387,89406
1834,14,40,14,36.57,71.10,89405,89419
1835,18,40,6,28.44,227.80,89418,89436
1836,14,40,12,36.57,72.82,89435,89449
1837,14,40,4,36.57,91.10,89448,89462
1838,18,41,6,28.44,256.69,89461,89479
1839,14,41,9,36.57,117.82,89478,89492
1840,18,82,0,28.44,465.02,89491,89509
1841,6,351,6,85.33,14279.89,89508,89514
1842,13,42,13,39.38,59.78,89513,89526
1843,14,42,3,36.57,176.96,89525,89539
1844,18,42,6,28.44,255.02,89538,89556
1845,14,40,7,36.57,82.10,89555,89569
1846,18,40,1,28.44,243.47,89568,89586
1847,14,38,19,36.57,23.82,89585,89599
1848,19,42,2,26.95,235.42,89598,89617
1849,14,42,3,36.57,176.96,89616,89630
1850,13,42,13,39.38,59.78,89629,89642
1851,12,279,6,42.67,5342.39,89641,89653
1852,10,155,29,51.20,1209.96,89652,89662
1853,14,41,8,36.57,118.24,89661,89675
1854,21,48,1,24.38,333.66,89674,89695
1855,196,34,0,2.61,12.55,89694,89890
1856,120,34,1,4.27,18.78,89889,90009
1857,240,25,0,2.13,12.99,90008,90248
1858,41,37,3,12.49,17.62,90247,90288
1859,43,19,1,11.91,3.94,90288,90331
1860,41,37,1,12.49,18.84,90330,90371
1861,37,37,6,13.84,48.30,90370,90407
1862,40,37,2,12.80,31.61,90406,90446
1863,41,37,9,12.49,15.32,90445,90486
1864,41,37,3,12.49,34.69,90485,90526
1865,43,37,2,11.91,19.11,90525,90568
1866,84,16,0,6.10,30.99,90567,90651
1867,179,21,0,2.86,14.76,90650,90829
1868,123,16,0,4.16,10.01,90828,90951
1869,146,35,0,3.51,32.44,90950,91096
1870,145,35,0,3.53,33.44,91095,91240
1871,141,22,0,3.63,10.60,91239,91380
1872,49,85,1,10.45,239.76,91379,91428
1873,86,13,0,5.95,5.04,91427,91513
1874,122,16,0,4.20,13.75,91512,91634
1875,72,39,0,7.11,57.46,91633,91705
1876,162,35,0,3.16,19.43,91704,91866
1877,103,32,0,4.97,31.35,91866,91969
1878,24,39,1,21.33,310.39,91968,91992
1879,15,39,1,34.13,154.25,91991,92006
1880,17,39,4,30.12,187.16,92005,92022
1881,40,21,4,12.80,30.36,92021,92061
1882,34,27,5,15.06,60.53,92061,92095
1883,18,32,2,28.44,80.58,92094,92112
1884,16,33,30,32.00,0.38,92111,92127
1885,29,24,4,17.66,63.88,92126,92155
1886,54,31,0,9.48,33.95,92154,92208
1887,26,56,0,19.69,241.14,92207,92233
1888,23,32,1,22.26,178.45,92232,92255
1889,63,25,0,8.13,87.79,92254,92317
1890,67,27,0,7.64,60.23,92316,92383
1891,72,51,0,7.11,78.15,92383,92455
1892,88,46,0,5.82,46.74,92454,92542
1893,79,35,0,6.48,37.24,92541,92620
1894,104,27,0,4.92,23.97,92619,92723
1895,45,32,0,11.38,118.19,92722,92767
1896,37,27,1,13.84,98.57,92766,92803
1897,73,51,0,7.01,92.45,92803,92876
1898,73,23,0,7.01,22.40,92875,92948
1899,68,43,0,7.53,52.25,92947,93015
1900,59,39,0,8.68,39.98,93014,93073
1901,53,31,0,9.66,30.26,93072,93125
1902,63,39,0,8.13,32.49,93124,93187
1903,59,31,2,8.68,34.83,93186,93245
1904,51,30,0,10.04,38.63,93244,93295
1905,57,40,5,8.98,35.84,93294,93351
1906,63,58,0,8.13,78.75,93350,93413
1907,39,107,0,13.13,341.86,93412,93451
1908,54,45,1,9.48,63.55,93450,93504
1909,64,37,0,8.00,61.06,93503,93567
1910,67,37,0,7.64,37.63,93567,93634
1911,14,411,0,36.57,10792.82,93633,93647
1912,1,512,512,512.00,0.00,93646,93647
1913,4,501,0,128.00,46384.50,93646,93650
1914,69,38,0,7.42,64.39,93649,93718
1915,29,27,0,17.66,127.19,93718,93747
1916,32,27,1,16.00,79.62,93746,93778
1917,31,42,2,16.52,109.60,93777,93808
1918,18,29,21,28.44,3.47,93807,93825
1919,27,65,0,18.96,333.15,93824,93851
1920,13,43,21,39.38,30.54,93850,93863
1921,14,41,5,36.57,121.24,93862,93876
1922,39,51,1,13.13,220.78,93875,93914
1923,26,25,0,19.69,76.98,93913,93939
1924,46,49,0,11.13,124.68,93938,93984
1925,35,44,0,14.63,126.80,93983,94018
1926,20,43,1,25.60,80.94,94017,94037
1927,13,44,14,39.38,82.54,94036,94049
1928,13,43,19,39.38,71.93,94048,94061
1929,13,43,14,39.38,76.54,94060,94073
1930,48,45,1,10.67,108.68,94072,94120
1931,28,22,0,18.29,39.99,94119,94147
1932,49,74,0,10.45,131.88,94146,94195
1933,65,35,4,7.88,25.40,94195,94260
1934,9,439,4,56.89,18288.99,94259,94268
1935,3,465,2,170.67,43624.22,94267,94270
1936,2,412,100,256.00,24336.00,94269,94271
1937,8,86,5,64.00,1132.75,94270,94278
1938,7,86,17,73.14,577.84,94277,94284
1939,7,86,21,73.14,527.55,94283,94290
1940,7,86,25,73.14,486.41,94289,94296
1941,7,86,29,73.14,454.41,94295,94302
1942,7,86,33,73.14,431.55,94301,94308
1943,7,86,37,73.14,417.84,94307,94314
1944,7,86,41,73.14,413.27,94313,94320
1945,7,86,37,73.14,417.84,94319,94326
1946,7,86,33,73.14,431.55,94325,94332
1947,7,86,29,73.14,454.41,94331,94338
1948,7,86,25,73.14,486.41,94337,94344
1949,7,86,21,73.14,527.55,94343,94350
1950,28,86,1,18.29,684.06,94349,94377
1951,26,29,4,19.69,122.83,94376,94402
1952,26,29,4,19.69,60.75,94401,94427
1953,50,40,0,10.24,76.10,94426,94476
1954,61,34,1,8.39,30.86,94475,94536
1955,9,384,0,56.89,13652.32,94535,94544
1956,7,348,5,73.14,13162.41,94543,94550
1957,9,64,10,56.89,284.54,94549,94558
1958,9,64,10,56.89,284.54,94557,94566
1959,9,64,10,56.89,284.54,94565,94574
1960,9,64,10,56.89,284.54,94573,94582
1961,9,64,10,56.89,284.54,94581,94590
1962,9,64,10,56.89,284.54,94589,94598
1963,10,64,3,51.20,543.16,94597,94607
1964,35,52,3,14.63,153.49,94606,94641
1965,11,52,1,46.55,214.07,94640,94651
1966,11,52,9,46.55,164.61,94650,94661
1967,11,52,17,46.55,138.43,94660,94671
1968,11,52,19,46.55,135.52,94670,94681
1969,37,52,0,13.84,247.49,94680,94717
1970,17,31,19,30.12,8.22,94716,94733
1971,67,31,4,7.64,44.53,94732,94799
1972,60,116,0,8.53,236.85,94799,94859
1973,97,20,0,5.28,28.61,94858,94955
1974,34,23,0,15.06,36.64,94954,94988
1975,85,43,0,6.02,64.21,94987,95072
1976,87,37,0,5.89,35.89,95071,95158
1977,63,88,0,8.13,121.89,95157,95220
1978,97,30,0,5.28,29.62,95219,95316
1979,34,62,7,15.06,84.47,95315,95349
1980,38,29,2,13.47,30.35,95348,95386
1981,14,155,7,36.57,1526.39,95385,95399
1982,48,18,2,10.67,8.93,95398,95446
1983,88,24,0,5.82,57.33,95445,95533
1984,136,59,0,3.76,26.87,95532,95668
1985,107,12,0,4.79,3.12,95667,95774
1986,97,6,0,5.28,2.26,95773,95870
1987,98,68,0,5.22,50.58,95869,95967
1988,189,94,0,2.71,55.70,95966,96155
1989,174,118,0,2.94,143.99,96154,96328
1990,6,118,14,85.33,2146.22,96327,96333
1991,164,92,0,3.12,62.84,96332,96496
1992,41,140,1,12.49,614.98,96496,96537
1993,318,48,0,1.61,17.63,96536,96854
1994,25,24,2,20.48,41.85,96853,96878
1995,30,25,1,17.07,65.86,96877,96907
1996,23,24,1,22.26,27.76,96906,96929
1997,27,24,1,18.96,55.96,96928,96955
1998,25,25,4,20.48,44.81,96954,96979
1999,21,25,16,24.38,4.24,96978,96999
2000,28,25,9,18.29,36.63,96998,97026
2001,22,25,4,23.27,24.74,97025,97047
2002,29,25,5,17.66,40.16,97046,97075
2003,21,25,13,24.38,6.52,97074,97095
2004,22,25,1,23.27,29.93,97094,97116
2005,22,26,2,23.27,28.38,97115,97137
2006,22,26,5,23.27,33.47,97136,97158
2007,174,20,0,2.94,11.10,97157,97331
2008,39,18,0,13.13,15.80,97330,97369
2009,35,31,10,14.63,23.89,97368,97403
2010,85,25,0,6.02,35.72,97402,97487
2011,113,24,0,4.53,18.04,97486,97599
2012,49,42,1,10.45,49.39,97598,97647
2013,87,42,0,5.89,34.42,97646,97733
2014,79,40,0,6.48,30.73,97732,97811
2015,105,19,0,4.88,17.50,97810,97915
2016,110,18,1,4.65,17.81,97915,98025
2017,109,49,0,4.70,47.84,98024,98133
2018,104,22,0,4.92,33.78,98132,98236
2019,283,159,0,1.81,104.53,98235,98518
2020,389,151,0,1.32,109.01,98517,98906
2021,194,62,0,2.64,31.54,98905,99099
2022,99,188,0,5.17,584.63,99098,99197
2023,4,188,60,128.00,3632.00,99196,99200
2024,112,112,0,4.57,183.28,99199,99311
2025,79,22,0,6.48,42.27,99310,99389
2026,178,19,0,2.88,10.64,99389,99567
2027,45,49,1,11.38,91.44,99566,99611
2028,152,21,0,3.37,14.04,99610,99762
2029,78,19,1,6.56,25.55,99762,99840
2030,44,17,0,11.64,18.73,99839,99883
2031,188,27,0,2.72,14.19,99882,100070
2032,114,42,0,4.49,30.85,100069,100183
2033,202,39,0,2.53,19.63,100182,100384
2034,115,36,0,4.45,24.54,100383,100498
2035,125,75,0,4.10,59.97,100497,100622
2036,160,29,0,3.20,15.56,100621,100781
2037,79,15,0,6.48,7.46,100780,100859
2038,127,34,1,4.03,19.15,100859,100986
2039,93,36,1,5.51,30.16,100985,101078
2040,94,23,0,5.45,26.69,101077,101171
2041,174,43,0,2.94,29.96,101170,101344
2042,105,53,0,4.88,37.71,101343,101448
2043,201,32,0,2.55,21.79,101447,101648
2044,29,40,0,17.66,65.81,101647,101676
2045,22,28,14,23.27,7.83,101675,101697
2046,30,37,3,17.07,37.40,101696,101726
2047,146,30,0,3.51,31.80,101725,101871
2048,426,97,0,1.20,68.65,101870,102296
2049,447,59,0,1.15,34.15,102295,102742
2050,303,45,0,1.69,32.10,102741,103044
2051,116,17,0,4.41,34.71,103043,103159
2052,27,28,3,18.96,34.11,103158,103185
2053,24,28,13,21.33,13.06,103184,103208
2054,87,65,0,5.89,101.30,103207,103294
2055,146,26,0,3.51,19.96,103294,103440
2056,324,58,0,1.58,14.20,103439,103763
2057,172,32,0,2.98,11.34,103762,103934
2058,224,66,0,2.29,37.84,103933,104157
2059,386,45,0,1.33,24.09,104156,104542
2060,98,66,0,5.22,77.70,104541,104639
2061,189,30,0,2.71,23.17,104638,104827
2062,61,34,1,8.39,166.27,104827,104888
2063,19,34,7,26.95,106.68,104887,104906
2064,130,87,0,3.94,59.60,104905,105035
2065,163,96,1,3.14,53.53,105035,105198
2066,149,85,0,3.44,82.39,105197,105346
2067,171,57,0,2.99,45.98,105345,105516
2068,91,55,0,5.63,140.59,105515,105606
2069,77,41,0,6.65,130.62,105605,105682
2070,140,56,0,3.66,40.94,105681,105821
2071,119,21,0,4.30,17.45,105821,105940
2072,134,72,0,3.82,66.48,105940,106074
2073,115,65,0,4.45,46.11,106074,106189
2074,185,57,0,2.77,40.76,106188,106373
2075,126,43,0,4.06,50.36,106372,106498
2076,188,21,0,2.72,11.30,106498,106686
2077,138,26,0,3.71,14.52,106686,106824
2078,197,72,0,2.60,36.47,106823,107020
2079,197,34,0,2.60,20.45,107019,107216
2080,262,34,0,1.95,25.01,107216,107478
2081,298,34,0,1.72,16.47,107477,107775
2082,74,31,0,6.92,75.62,107774,107848
2083,26,27,13,19.69,5.37,107847,107873
2084,22,56,3,23.27,165.74,107872,107894
2085,25,25,9,20.48,9.77,107893,107918
2086,23,43,15,22.26,54.19,107917,107940
2087,26,26,1,19.69,25.98,107939,107965
2088,28,23,8,18.29,10.85,107964,107992
2089,25,30,5,20.48,20.73,107991,108016
2090,25,49,2,20.48,85.29,108015,108040
2091,24,60,16,21.33,68.22,108039,108063
2092,24,32,5,21.33,22.64,108062,108086
2093,25,29,3,20.48,15.61,108085,108110
2094,24,38,3,21.33,31.97,108109,108133
2095,26,22,15,19.69,2.21,108132,108158
2096,30,20,3,17.07,14.80,108157,108187
2097,26,25,4,19.69,14.60,108186,108212
2098,25,28,17,20.48,3.69,108211,108236
2099,26,28,3,19.69,18.91,108235,108261
2100,22,56,1,23.27,116.29,108260,108282
2101,27,32,15,18.96,8.48,108281,108308
2102,26,27,5,19.69,14.60,108307,108333
2103,26,44,10,19.69,30.14,108332,108358
2104,20,84,7,25.60,346.74,108357,108377
2105,21,79,15,24.38,151.38,108376,108397
2106,4,210,63,128.00,2809.50,108396,108400
2107,18,147,17,28.44,828.36,108399,108417
2108,23,30,5,22.26,24.54,108416,108439
2109,26,30,1,19.69,21.60,108438,108464
2110,26,23,4,19.69,11.21,108464,108490
2111,25,42,5,20.48,36.73,108489,108514
2112,27,22,8,18.96,7.67,108513,108540
2113,26,40,2,19.69,37.52,108539,108565
2114,26,30,5,19.69,15.60,108564,108590
2115,27,34,13,18.96,15.74,108589,108616
2116,21,97,2,24.38,374.81,108615,108636
2117,27,38,2,18.96,37.22,108635,108662
2118,26,30,17,19.69,5.60,108661,108687
2119,27,22,1,18.96,16.26,108686,108713
2120,16,93,4,32.00,746.50,108712,108728
2121,26,25,17,19.69,2.06,108727,108753
2122,18,82,1,28.44,504.91,108752,108770
2123,23,39,12,22.26,42.45,108769,108792
2124,23,43,2,22.26,56.11,108791,108814
2125,22,41,19,23.27,37.93,108813,108835
2126,11,123,14,46.55,1467.52,108834,108845
2127,23,41,7,22.26,50.89,108844,108867
2128,24,30,4,21.33,21.56,108866,108890
2129,26,24,7,19.69,13.37,108889,108915
2130,21,52,11,24.38,64.71,108914,108935
2131,18,59,8,28.44,159.69,108934,108952
2132,25,28,12,20.48,12.41,108951,108976
2133,26,40,8,19.69,23.91,108975,109001
2134,27,25,2,18.96,21.67,109000,109027
2135,26,24,9,19.69,7.06,109026,109052
2136,18,107,5,28.44,787.36,109051,109069
2137,14,232,15,36.57,2947.24,109068,109082
2138,2,472,40,256.00,46656.00,109081,109083
2139,24,47,8,21.33,43.22,109082,109106
2140,27,27,2,18.96,19.89,109105,109132
2141,26,26,12,19.69,7.44,109131,109157
2142,22,53,19,23.27,52.65,109156,109178
2143,16,95,7,32.00,627.00,109177,109193
2144,27,30,13,18.96,7.89,109192,109219
2145,23,30,11,22.26,15.67,109218,109241
2146,24,28,4,21.33,34.22,109240,109264
2147,24,30,15,21.33,9.14,109263,109287
2148,20,89,4,25.60,470.04,109286,109306
2149,27,20,16,18.96,2.18,109305,109332
2150,27,25,4,18.96,19.37,109331,109358
2151,27,33,11,18.96,11.89,109357,109384
2152,23,37,5,22.26,36.71,109383,109406
2153,19,72,4,26.95,309.42,109405,109424
2154,25,31,16,20.48,6.97,109423,109448
2155,18,112,3,28.44,719.69,109447,109465
2156,21,86,18,24.38,210.05,109464,109485
2157,28,27,2,18.29,14.20,109484,109512
2158,26,28,3,19.69,19.21,109511,109537
2159,26,21,4,19.69,18.21,109536,109562
2160,25,21,14,20.48,3.13,109561,109586
2161,21,64,7,24.38,174.05,109585,109606
2162,17,198,1,30.12,1783.52,109605,109622
2163,2,280,232,256.00,576.00,109621,109623
2164,24,68,2,21.33,109.72,109622,109646
2165,24,31,8,21.33,15.72,109645,109669
2166,27,29,5,18.96,14.78,109668,109695
2167,23,32,2,22.26,30.80,109694,109717
2168,4,246,22,128.00,11012.50,109716,109720
2169,7,284,18,73.14,7842.69,109719,109726
2170,21,49,7,24.38,53.57,109725,109746
2171,16,108,4,32.00,611.25,109745,109761
2172,21,60,15,24.38,75.66,109760,109781
2173,28,23,1,18.29,17.70,109780,109808
2174,25,35,16,20.48,13.53,109807,109832
2175,30,20,1,17.07,19.13,109831,109861
2176,19,149,18,26.95,828.47,109860,109879
2177,2,375,137,256.00,14161.00,109878,109880
2178,21,135,14,24.38,618.62,109879,109900
2179,23,34,4,22.26,39.32,109899,109922
2180,21,56,5,24.38,92.52,109921,109942
2181,26,23,3,19.69,15.83,109941,109967
2182,8,181,11,64.00,4255.75,109966,109974
2183,19,109,2,26.95,452.68,109973,109992
2184,26,21,12,19.69,3.52,109991,110017
2185,24,57,9,21.33,61.22,110016,110040
2186,25,56,4,20.48,63.61,110040,110065
2187,24,34,10,21.33,27.06,110064,110088
2188,21,59,13,24.38,169.76,110087,110108
2189,25,30,3,20.48,28.73,110107,110132
2190,26,25,16,19.69,4.21,110131,110157
2191,20,127,1,25.60,579.34,110156,110176
2192,20,68,14,25.60,158.94,110175,110195
2193,28,20,1,18.29,14.99,110194,110222
2194,25,33,10,20.48,12.65,110221,110246
2195,21,77,5,24.38,195.85,110245,110266
2196,10,133,11,51.20,2156.76,110265,110275
2197,25,29,10,20.48,7.85,110274,110299
2198,27,22,7,18.96,7.00,110299,110326
2199,26,24,7,19.69,10.52,110325,110351
2200,22,56,8,23.27,87.65,110350,110372
2201,20,45,3,25.60,101.64,110371,110391
2202,12,117,6,42.67,1491.89,110390,110402
2203,25,37,1,20.48,39.61,110401,110426
2204,22,43,11,23.27,69.38,110425,110447
2205,26,26,7,19.69,11.06,110446,110472
2206,21,53,4,24.38,184.43,110471,110492
2207,18,103,3,28.44,705.02,110491,110509
2208,23,68,1,22.26,131.93,110508,110531
2209,24,40,6,21.33,29.39,110530,110554
2210,21,43,18,24.38,58.71,110553,110574
2211,14,135,2,36.57,1552.82,110573,110587
2212,12,272,8,42.67,5141.22,110586,110598
2213,3,475,10,170.67,46357.56,110597,110600
2214,6,438,5,85.33,24896.89,110599,110605
2215,1,512,512,512.00,0.00,110604,110605
2216,4,388,27,128.00,22616.50,110604,110608
2217,8,260,7,64.00,7031.25,110607,110615
2218,22,32,7,23.27,33.83,110614,110636
2219,25,30,11,20.48,13.05,110635,110660
2220,26,24,7,19.69,10.44,110659,110685
2221,23,38,6,22.26,45.15,110684,110707
2222,17,110,15,30.12,547.04,110706,110723
2223,15,128,2,34.13,1134.38,110722,110737
2224,24,29,13,21.33,9.22,110736,110760
2225,25,53,1,20.48,78.33,110759,110784
2226,23,89,4,22.26,213.06,110783,110806
2227,17,98,16,30.12,612.34,110805,110822
2228,26,29,6,19.69,20.06,110821,110847
2229,26,22,13,19.69,3.67,110846,110872
2230,24,48,3,21.33,49.72,110871,110895
2231,16,82,8,32.00,525.25,110894,110910
2232,24,28,3,21.33,23.47,110909,110933
2233,29,40,10,17.66,22.71,110932,110961
2234,27,32,3,18.96,33.29,110960,110987
2235,17,79,6,30.12,451.75,110986,111003
2236,26,27,10,19.69,9.29,111002,111028
2237,28,23,8,18.29,8.85,111027,111055
2238,27,29,1,18.96,22.04,111054,111081
2239,25,24,14,20.48,8.01,111080,111105
2240,22,82,4,23.27,235.47,111104,111126
2241,22,78,18,23.27,146.38,111125,111147
2242,26,31,4,19.69,36.67,111146,111172
2243,24,39,14,21.33,33.89,111171,111195
2244,26,24,3,19.69,13.75,111194,111220
2245,26,34,10,19.69,22.60,111219,111245
2246,25,35,6,20.48,33.05,111244,111269
2247,22,78,5,23.27,192.02,111268,111290
2248,24,40,13,21.33,33.31,111289,111313
2249,27,38,3,18.96,33.74,111312,111339
2250,95,28,0,5.39,45.31,111338,111433
2251,110,40,1,4.65,26.48,111432,111542
2252,126,47,1,4.06,19.98,111541,111667
2253,99,44,1,5.17,38.59,111666,111765
2254,105,37,0,4.88,25.82,111764,111869
2255,143,35,0,3.58,16.03,111868,112011
2256,40,61,0,12.80,319.01,112010,112050
2257,53,60,3,9.66,171.73,112049,112102
2258,53,44,0,9.66,150.11,112101,112154
2259,48,39,2,10.67,119.97,112153,112201
2260,56,51,0,9.14,113.27,112200,112256
2261,59,50,0,8.68,145.57,112255,112314
2262,95,15,1,5.39,3.35,112313,112408
2263,54,202,2,9.48,705.36,112407,112461
2264,3,324,59,170.67,12572.22,112460,112463
2265,3,330,37,170.67,14637.56,112462,112465
2266,2,293,219,256.00,1369.00,112464,112466
2267,3,330,71,170.67,12960.22,112465,112468
2268,45,259,3,11.38,1400.72,112467,112512
2269,96,16,1,5.33,3.95,112511,112607
2270,126,39,0,4.06,26.14,112606,112732
2271,115,103,0,4.45,95.53,112732,112847
2272,8,275,1,64.00,8398.50,112846,112854
2273,3,186,162,170.67,118.22,112853,112856
2274,108,28,0,4.74,25.30,112855,112963
2275,145,23,0,3.53,11.28,112962,113107
2276,162,7,0,3.16,4.95,113107,113269
2277,161,12,0,3.18,6.84,113268,113429
2278,91,69,0,5.63,50.78,113428,113519
2279,38,45,1,13.47,213.83,113518,113556
2280,125,31,0,4.10,18.87,113555,113680
2281,115,53,0,4.45,32.58,113679,113794
2282,111,66,0,4.61,71.48,113793,113904
2283,105,16,0,4.88,4.13,113903,114008
2284,90,30,2,5.69,10.86,114008,114098
2285,25,253,4,20.48,2860.97,114097,114122
2286,3,248,116,170.67,3160.89,114121,114124
2287,4,252,4,128.00,15376.00,114123,114127
2288,5,252,2,102.40,14527.04,114126,114131
2289,90,59,0,5.69,39.46,114130,114220
2290,10,77,4,51.20,873.36,114219,114229
2291,94,60,0,5.45,34.25,114228,114322
2292,99,11,3,5.17,1.90,114321,114420
2293,64,146,1,8.00,313.53,114419,114483
2294,3,269,113,170.67,4882.89,114482,114485
2295,3,275,69,170.67,7076.22,114484,114487
2296,3,275,107,170.67,5530.89,114486,114489
2297,18,275,3,28.44,4595.58,114488,114506
2298,65,35,0,7.88,84.35,114505,114570
2299,70,19,3,7.31,14.47,114569,114639
2300,76,18,1,6.74,5.67,114638,114714
2301,79,13,5,6.48,3.06,114713,114792
2302,73,19,3,7.01,7.74,114792,114865
2303,81,18,2,6.32,4.74,114864,114945
2304,74,19,4,6.92,7.02,114944,115018
2305,17,391,5,30.12,8150.93,115018,115035
2306,4,331,3,128.00,18413.50,115034,115038
2307,75,19,4,6.83,7.58,115037,115112
2308,78,19,2,6.56,5.68,115111,115189
2309,78,17,1,6.56,4.43,115188,115266
2310,91,14,2,5.63,4.26,115266,115357
2311,43,45,3,11.91,206.88,115356,115399
2312,52,55,0,9.85,197.25,115398,115450
2313,93,54,0,5.51,106.42,115449,115542
2314,83,41,0,6.17,32.48,115541,115624
2315,191,29,0,2.68,15.79,115623,115814
2316,188,21,0,2.72,11.21,115814,116002
2317,76,74,2,6.74,127.90,116001,116077
2318,76,72,0,6.74,99.93,116076,116152
2319,30,88,2,17.07,607.60,116151,116181
2320,32,88,6,16.00,374.81,116180,116212
2321,62,57,0,8.26,59.55,116211,116273
2322,90,31,0,5.69,20.06,116272,116362
2323,27,179,1,18.96,1265.81,116361,116388
2324,83,51,0,6.17,43.71,116387,116470
2325,72,157,0,7.11,379.68,116469,116541
2326,68,119,0,7.53,353.51,116540,116608
2327,72,232,0,7.11,727.40,116607,116679
2328,87,117,0,5.89,242.63,116679,116766
2329,57,141,1,8.98,355.39,116765,116822
2330,28,74,5,18.29,495.06,116821,116849
2331,79,97,0,6.48,191.14,116849,116928
2332,75,50,1,6.83,46.46,116927,117002
2333,61,123,3,8.39,258.21,117001,117062
2334,75,128,0,6.83,224.97,117061,117136
2335,65,123,0,7.88,346.17,117135,117200
2336,107,82,0,4.79,73.20,117199,117306
2337,190,18,0,2.69,8.19,117306,117496
2338,169,54,0,3.03,25.59,117495,117664
2339,57,164,1,8.98,471.63,117664,117721
2340,76,34,0,6.74,56.17,117720,117796
2341,161,44,0,3.18,29.66,117795,117956
2342,211,56,0,2.43,28.97,117956,118167
2343,114,22,0,4.49,11.51,118167,118281
2344,204,14,0,2.51,10.33,118280,118484
2345,241,108,0,2.12,64.86,118483,118724
2346,232,187,0,2.21,179.08,118723,118955
2347,223,22,0,2.30,13.79,118955,119178
2348,333,26,0,1.54,6.18,119177,119510
2349,512,1,1,1.00,0.00,119510,120022
2350,449,7,1,1.14,0.33,120022,120471
2351,224,89,0,2.29,42.17,120470,120694
2352,185,72,2,2.77,50.94,120694,120879
2353,165,68,1,3.10,66.75,120879,121044
2354,184,61,1,2.78,38.95,121044,121228
2355,163,81,1,3.14,61.96,121227,121390
2356,190,47,2,2.69,23.89,121389,121579
2357,171,50,0,2.99,35.20,121578,121749
2358,172,81,2,2.98,60.16,121748,121920
2359,167,57,1,3.07,46.61,121919,122086
2360,129,47,1,3.97,38.93,122085,122214
2361,69,17,2,7.42,36.24,122213,122282
2362,131,12,2,3.91,8.65,122281,122412
2363,177,19,0,2.89,4.45,122412,122589
2364,196,14,1,2.61,3.37,122588,122784
2365,23,468,1,22.26,9031.15,122783,122806
2366,160,73,1,3.20,35.03,122805,122965
2367,179,16,1,2.86,6.10,122964,123143
2368,152,15,0,3.37,5.67,123143,123295
2369,434,17,1,1.18,0.84,123294,123728
2370,511,2,1,1.00,0.00,123728,124239
2371,82,431,1,6.24,2227.38,124239,124321
2372,1,512,512,512.00,0.00,124320,124321
2373,149,364,1,3.44,878.42,124320,124469
2374,310,11,1,1.65,1.19,124469,124779
2375,236,17,0,2.17,15.63,124778,125014
2376,512,1,1,1.00,0.00,125014,125526
2377,494,5,1,1.04,0.08,125526,126020
2378,23,490,1,22.26,9944.54,126020,126043
2379,1,512,512,512.00,0.00,126042,126043
2380,149,305,0,3.44,618.55,126042,126191
2381,322,91,0,1.59,32.22,126190,126512
2382,260,23,0,1.97,6.85,126511,126771
2383,180,81,0,2.84,39.70,126771,126951
2384,168,83,2,3.05,70.30,126950,127118
2385,179,50,1,2.86,36.19,127117,127296
2386,173,61,1,2.96,44.22,127295,127468
2387,166,70,1,3.08,52.47,127467,127633
2388,179,58,1,2.86,33.38,127632,127811
2389,163,68,0,3.14,71.90,127810,127973
2390,178,81,1,2.88,48.28,127972,128150
2391,192,52,1,2.67,26.03,128149,128341
2392,101,47,1,5.07,54.02,128340,128441
2393,118,16,1,4.34,18.33,128440,128558
2394,137,17,0,3.74,12.16,128557,128694
2395,182,19,0,2.81,4.21,128694,128876
2396,182,14,2,2.81,3.61,128876,129058
2397,179,15,2,2.86,6.06,129058,129237
2398,172,14,2,2.98,5.20,129236,129408
2399,153,17,0,3.35,5.15,129407,129560
2400,126,183,2,4.06,260.69,129559,129685
2401,11,358,1,46.55,9721.34,129684,129695
2402,74,17,1,6.92,31.18,129694,129768
2403,126,81,2,4.06,69.46,129767,129893
2404,185,61,0,2.77,31.34,129892,130077
2405,169,89,2,3.03,72.63,130077,130246
2406,176,65,1,2.91,48.61,130245,130421
2407,175,50,1,2.93,38.69,130420,130595
2408,165,68,1,3.10,54.23,130594,130759
2409,183,64,1,2.80,41.84,130758,130941
2410,172,57,2,2.98,32.52,130940,131112
2411,175,64,1,2.93,47.19,131111,131286
2412,143,96,1,3.58,79.10,131285,131428
2413,134,96,2,3.82,123.46,131427,131561
2414,175,19,1,2.93,4.61,131560,131735
2415,177,14,0,2.89,4.66,131734,131911
2416,153,134,1,3.35,113.73,131910,132063
2417,45,406,1,11.38,3541.61,132062,132107
2418,180,16,1,2.84,6.31,132106,132286
2419,168,15,0,3.05,4.93,132285,132453
2420,79,17,2,6.48,37.77,132452,132531
2421,140,17,0,3.66,18.04,132530,132670
2422,174,295,1,2.94,493.59,132669,132843
2423,1,512,512,512.00,0.00,132842,132843
2424,13,500,1,39.38,17680.54,132842,132855
2425,178,18,0,2.88,17.54,132855,133033
2426,197,31,0,2.60,19.07,133032,133229
2427,164,31,0,3.12,19.07,133229,133393
2428,114,17,0,4.49,19.97,133392,133506
2429,59,25,0,8.68,31.20,133506,133565
2430,37,39,6,13.84,43.43,133564,133601
2431,190,43,0,2.69,21.85,133600,133790
2432,170,43,0,3.01,15.11,133790,133960
2433,192,36,0,2.67,20.57,133959,134151
2434,151,48,0,3.39,33.09,134151,134302
2435,46,33,0,11.13,67.77,134301,134347
2436,40,23,2,12.80,60.66,134346,134386
2437,59,21,1,8.68,32.29,134385,134444
2438,129,34,0,3.97,22.08,134444,134573
2439,58,27,0,8.83,83.04,134572,134630
2440,28,25,15,18.29,10.85,134629,134657
2441,25,24,4,20.48,12.49,134656,134681
2442,25,35,4,20.48,66.01,134680,134705
2443,26,30,10,19.69,17.14,134704,134730
2444,26,30,7,19.69,22.91,134729,134755
2445,31,28,0,16.52,82.31,134754,134785
2446,28,32,4,18.29,31.35,134784,134812
2447,75,36,0,6.83,52.86,134811,134886
2448,132,79,1,3.88,51.20,134886,135018
2449,172,56,0,2.98,21.72,135017,135189
2450,125,97,1,4.10,79.27,135188,135313
2451,148,50,0,3.46,17.07,135312,135460
2452,117,90,1,4.38,112.25,135460,135577
2453,129,97,1,3.97,68.62,135577,135706
2454,112,50,0,4.57,51.14,135705,135817
2455,27,26,4,18.96,24.78,135816,135843
2456,24,25,7,21.33,9.97,135842,135866
2457,24,22,15,21.33,3.81,135865,135889
2458,23,31,2,22.26,26.71,135888,135911
2459,26,36,6,19.69,45.60,135910,135936
2460,29,27,8,17.66,17.95,135935,135964
2461,98,27,0,5.22,37.62,135963,136061
2462,22,27,9,23.27,10.83,136060,136082
2463,21,33,15,24.38,9.38,136081,136102
2464,20,38,1,25.60,62.24,136102,136122
2465,26,25,1,19.69,28.91,136121,136147
2466,22,24,9,23.27,9.74,136146,136168
2467,23,30,1,22.26,28.11,136167,136190
2468,31,26,6,16.52,7.86,136189,136220
2469,28,20,3,18.29,9.99,136219,136247
2470,220,47,0,2.33,34.01,136246,136466
2471,206,47,0,2.49,32.69,136465,136671
2472,106,31,0,4.83,74.10,136671,136777
2473,160,25,0,3.20,24.76,136776,136936
2474,159,35,0,3.22,17.82,136935,137094
2475,135,14,0,3.79,10.58,137093,137228
2476,79,71,4,6.48,58.71,137227,137306
2477,70,130,0,7.31,271.84,137305,137375
2478,47,50,3,10.89,204.39,137374,137421
2479,108,24,0,4.74,6.80,137421,137529
2480,79,56,3,6.48,31.72,137528,137607
2481,82,28,1,6.24,10.38,137606,137688
2482,85,24,4,6.02,4.12,137688,137773
2483,80,56,1,6.40,31.86,137772,137852
2484,118,22,0,4.34,25.51,137851,137969
2485,92,46,0,5.57,21.22,137968,138060
2486,93,50,3,5.51,23.13,138059,138152
2487,100,37,2,5.12,11.55,138152,138252
2488,81,83,2,6.32,74.61,138251,138332
2489,93,6,2,5.51,0.81,138331,138424
2490,76,107,3,6.74,134.88,138424,138500
2491,97,6,1,5.28,1.17,138499,138596
2492,76,124,3,6.74,184.43,138595,138671
2493,96,46,2,5.33,18.58,138670,138766
2494,112,6,1,4.57,1.08,138765,138877
2495,77,98,2,6.65,110.80,138876,138953
2496,91,33,2,5.63,13.38,138952,139043
2497,98,46,1,5.22,18.40,139042,139140
2498,91,61,2,5.63,35.31,139139,139230
2499,116,6,3,4.41,0.86,139229,139345
2500,77,97,1,6.65,108.36,139344,139421
2501,92,22,1,5.57,6.77,139420,139512
2502,94,36,3,5.45,17.76,139511,139605
2503,92,44,1,5.57,17.46,139605,139697
2504,101,44,3,5.07,17.43,139696,139797
2505,112,6,0,4.57,1.19,139796,139908
2506,83,33,2,6.17,43.15,139907,139990
2507,114,6,1,4.49,1.07,139989,140103
2508,73,113,1,7.01,157.03,140102,140175
2509,105,103,0,4.88,288.11,140174,140279
2510,79,102,0,6.48,336.65,140278,140357
2511,76,46,0,6.74,48.19,140356,140432
2512,76,124,3,6.74,184.40,140431,140507
2513,95,6,3,5.39,0.95,140506,140601
2514,109,12,2,4.70,1.59,140601,140710
2515,78,83,1,6.56,76.73,140709,140787
2516,100,37,3,5.12,11.37,140786,140886
2517,72,107,3,7.11,141.15,140886,140958
2518,99,6,3,5.17,1.05,140957,141056
2519,76,96,1,6.74,107.19,141055,141131
2520,100,44,1,5.12,16.47,141130,141230
2521,97,33,1,5.28,13.15,141229,141326
2522,109,6,1,4.70,1.15,141325,141434
2523,76,97,4,6.74,109.33,141433,141509
2524,98,46,1,5.22,18.42,141509,141607
2525,94,44,3,5.45,16.99,141606,141700
2526,87,33,1,5.89,38.98,141700,141787
2527,95,57,1,5.39,29.63,141786,141881
2528,97,30,1,5.28,8.86,141880,141977
2529,100,55,3,5.12,26.15,141976,142076
2530,104,6,3,4.92,1.03,142075,142179
2531,76,98,1,6.74,112.17,142178,142254
2532,107,26,3,4.79,5.16,142253,142360
2533,98,26,1,5.22,7.56,142359,142457
2534,80,87,3,6.40,83.14,142456,142536
2535,132,103,0,3.88,138.76,142535,142667
2536,61,102,0,8.39,620.66,142666,142727
2537,107,26,0,4.79,32.37,142726,142833
2538,91,48,0,5.63,39.33,142832,142923
2539,98,53,0,5.22,29.46,142922,143020
2540,272,95,0,1.88,76.48,143020,143292
2541,44,22,0,11.64,62.14,143291,143335
2542,200,17,0,2.56,11.21,143335,143535
2543,234,33,0,2.19,13.17,143535,143769
2544,216,52,0,2.37,33.64,143768,143984
2545,313,77,0,1.64,43.34,143983,144296
2546,320,111,0,1.60,53.70,144295,144615
2547,261,130,0,1.96,99.23,144614,144875
2548,363,43,0,1.41,34.29,144875,145238
2549,369,58,0,1.39,39.44,145238,145607
2550,354,130,0,1.45,63.43,145606,145960
2551,341,110,0,1.50,62.84,145959,146300
2552,339,43,0,1.51,36.27,146299,146638
2553,360,77,0,1.42,42.33,146638,146998
2554,458,111,0,1.12,46.17,146997,147455
2555,493,27,0,1.04,10.26,147455,147948
2556,130,120,0,3.94,181.01,147948,148078
2557,19,165,9,26.95,1134.79,148077,148096
2558,404,111,0,1.27,43.35,148095,148499
2559,406,66,0,1.26,24.86,148498,148904
2560,403,19,0,1.27,17.58,148904,149307
2561,435,19,0,1.18,14.67,149306,149741
2562,384,56,0,1.33,40.16,149740,150124
2563,392,61,0,1.31,43.83,150124,150516
2564,449,67,0,1.14,37.61,150516,150965
2565,357,73,0,1.43,60.50,150964,151321
2566,398,70,0,1.29,51.72,151320,151718
2567,377,67,0,1.36,45.98,151717,152094
2568,449,66,0,1.14,44.20,152094,152543
2569,379,73,0,1.35,52.90,152542,152921
2570,389,67,0,1.32,46.80,152920,153309
2571,413,38,0,1.24,21.74,153308,153721
2572,435,39,0,1.18,24.40,153720,154155
2573,156,27,0,3.28,11.63,154154,154310
2574,94,43,2,5.45,15.33,154309,154403
2575,41,55,0,12.49,386.74,154403,154444
2576,10,56,32,51.20,64.16,154443,154453
2577,30,56,0,17.07,423.66,154452,154482
2578,34,42,0,15.06,290.76,154481,154515
2579,126,24,0,4.06,41.81,154514,154640
2580,197,43,0,2.60,23.97,154639,154836
2581,113,43,0,4.53,94.67,154835,154948
2582,34,43,0,15.06,301.94,154947,154981
2583,26,57,0,19.69,687.29,154980,155006
2584,10,58,15,51.20,175.36,155005,155015
2585,40,58,0,12.80,386.71,155014,155054
2586,10,55,31,51.20,62.76,155053,155063
2587,12,56,0,42.67,413.72,155062,155074
2588,32,45,0,16.00,408.44,155073,155105
2589,23,45,0,22.26,361.58,155104,155127
2590,53,39,0,9.66,107.88,155126,155179
2591,45,47,0,11.38,184.37,155178,155223
2592,31,49,0,16.52,445.67,155222,155253
2593,12,49,8,42.67,202.06,155252,155264
2594,16,50,0,32.00,325.00,155263,155279
2595,36,57,0,14.22,424.51,155278,155314
2596,10,57,5,51.20,240.36,155313,155323
2597,18,58,0,28.44,539.14,155322,155340
2598,16,165,0,32.00,2738.00,155339,155355
2599,29,68,0,17.66,750.02,155354,155383
2600,8,67,49,64.00,36.00,155382,155390
2601,12,68,0,42.67,892.56,155389,155401
2602,29,69,0,17.66,659.26,155400,155429
2603,8,69,46,64.00,77.25,155428,155436
2604,10,70,13,51.20,521.96,155435,155445
2605,9,70,49,56.89,26.54,155444,155453
2606,47,57,0,10.89,369.12,155452,155499
2607,83,49,0,6.17,128.91,155498,155581
2608,43,50,0,11.91,340.83,155580,155623
2609,24,44,0,21.33,453.81,155622,155646
2610,26,45,0,19.69,257.06,155645,155671
2611,29,41,0,17.66,334.02,155670,155699
2612,56,51,0,9.14,276.27,155698,155754
2613,11,52,22,46.55,96.79,155753,155764
2614,12,54,0,42.67,335.39,155763,155775
2615,33,55,0,15.52,426.67,155774,155807
2616,34,53,0,15.06,425.58,155806,155840
2617,11,53,12,46.55,155.88,155839,155850
2618,22,53,0,23.27,592.38,155849,155871
2619,29,66,0,17.66,578.43,155870,155899
2620,9,66,16,56.89,308.54,155898,155907
2621,9,67,15,56.89,334.77,155906,155915
2622,42,25,0,12.19,71.77,155914,155956
2623,50,37,0,10.24,140.58,155956,156006
2624,30,37,0,17.07,238.00,156005,156035
2625,22,35,0,23.27,116.74,156034,156056
2626,44,61,0,11.64,140.46,156055,156099
2627,36,65,0,14.22,496.62,156098,156134
2628,9,65,27,56.89,230.77,156133,156142
2629,9,66,24,56.89,211.43,156141,156150
2630,29,67,0,17.66,769.54,156149,156178
2631,8,66,50,64.00,28.00,156177,156185
2632,20,67,0,25.60,649.74,156185,156205
2633,25,45,0,20.48,178.65,156204,156229
2634,41,55,0,12.49,294.69,156228,156269
2635,11,55,3,46.55,327.16,156268,156279
2636,10,56,16,51.20,138.96,156278,156288
2637,16,51,0,32.00,383.88,156287,156303
2638,19,52,0,26.95,353.00,156302,156321
2639,18,35,11,28.44,57.25,156320,156338
2640,20,37,0,25.60,105.84,156337,156357
2641,28,50,0,18.29,384.70,156356,156384
2642,12,51,4,42.67,219.22,156383,156395
2643,21,40,0,24.38,194.71,156394,156415
2644,14,77,8,36.57,271.53,156414,156428
2645,20,111,0,25.60,1035.74,156427,156447
2646,26,60,0,19.69,727.91,156446,156472
2647,10,59,10,51.20,263.36,156471,156481
2648,27,60,0,18.96,543.67,156480,156507
2649,11,50,27,46.55,41.34,156506,156517
2650,23,50,0,22.26,163.06,156516,156539
2651,37,42,0,13.84,161.70,156538,156575
2652,24,43,0,21.33,327.31,156574,156598
2653,34,111,0,15.06,728.82,156597,156631
2654,10,60,11,51.20,314.76,156630,156640
2655,25,61,0,20.48,336.97,156639,156664
2656,43,45,0,11.91,188.04,156663,156706
2657,11,52,7,46.55,174.79,156705,156716
2658,26,53,0,19.69,431.21,156715,156741
2659,28,47,0,18.29,213.56,156740,156768
2660,35,33,0,14.63,168.58,156767,156802
2661,30,39,0,17.07,275.80,156801,156831
2662,33,66,0,15.52,305.64,156830,156863
2663,27,65,0,18.96,783.52,156862,156889
2664,9,65,13,56.89,283.65,156888,156897
2665,45,66,0,11.38,405.26,156896,156941
2666,14,42,12,36.57,67.24,156940,156954
2667,35,40,0,14.63,259.89,156953,156988
2668,42,30,0,12.19,115.01,156987,157029
2669,30,130,0,17.07,517.53,157028,157058
2670,38,39,0,13.47,88.20,157058,157096
2671,34,40,0,15.06,216.88,157095,157129
2672,30,42,0,17.07,294.86,157128,157158
2673,27,61,0,18.96,546.85,157157,157184
2674,10,60,9,51.20,319.56,157183,157193
2675,16,62,0,32.00,641.25,157192,157208
2676,25,61,0,20.48,769.37,157207,157232
2677,10,62,10,51.20,394.56,157231,157241
2678,29,52,0,17.66,374.57,157240,157269
2679,13,45,15,39.38,89.62,157268,157281
2680,26,43,0,19.69,359.29,157280,157306
2681,29,59,0,17.66,529.88,157305,157334
2682,10,59,22,51.20,192.36,157333,157343
2683,93,59,0,5.51,155.56,157342,157435
2684,10,54,38,51.20,32.16,157434,157444
2685,45,55,0,11.38,247.08,157443,157488
2686,29,55,0,17.66,536.71,157487,157516
2687,16,55,0,32.00,567.62,157515,157531
2688,28,72,0,18.29,840.20,157530,157558
2689,8,72,13,64.00,374.25,157557,157565
2690,16,73,0,32.00,921.38,157564,157580
2691,25,70,0,20.48,896.73,157579,157604
2692,8,70,42,64.00,112.00,157603,157611
2693,12,71,0,42.67,643.72,157610,157622
2694,32,39,0,16.00,264.00,157621,157653
2695,34,31,0,15.06,129.23,157652,157686
2696,23,46,0,22.26,437.84,157685,157708
2697,31,54,0,16.52,234.57,157707,157738
2698,25,63,0,20.48,824.89,157737,157762
2699,9,62,21,56.89,163.43,157761,157770
2700,23,42,0,22.26,253.76,157769,157792
2701,52,39,0,9.85,151.09,157791,157843
2702,68,59,0,7.53,181.04,157842,157910
2703,29,41,0,17.66,299.40,157909,157938
2704,27,44,0,18.96,405.67,157937,157964
2705,58,45,0,8.83,95.35,157963,158021
2706,265,40,0,1.93,42.75,158020,158285
2707,268,111,0,1.91,87.08,158285,158553
2708,575,43,0,0.89,10.57,158552,159127
2709,239,165,0,2.14,185.13,159127,159366
2710,359,77,0,1.43,35.66,159366,159725
2711,397,41,0,1.29,29.49,159725,160122
2712,268,42,0,1.91,34.49,160121,160389
2713,115,22,1,4.45,13.69,160388,160503
2714,71,15,1,7.21,24.90,160502,160573
2715,137,12,0,3.74,5.35,160573,160710
2716,279,33,0,1.84,10.85,160709,160988
2717,243,16,0,2.11,5.96,160987,161230
2718,151,24,0,3.39,23.59,161229,161380
2719,77,47,0,6.65,84.10,161379,161456
2720,134,23,0,3.82,15.42,161455,161589
2721,186,16,0,2.75,17.11,161588,161774
2722,145,18,0,3.53,19.24,161773,161918
2723,38,30,4,13.47,14.62,161917,161955
2724,114,23,0,4.49,37.85,161954,162068
2725,109,36,0,4.70,50.28,162067,162176
2726,124,43,0,4.13,27.95,162175,162299
2727,103,29,0,4.97,31.39,162299,162402
2728,145,39,0,3.53,43.71,162401,162546
2729,102,26,0,5.02,33.47,162545,162647
2730,62,53,0,8.26,68.42,162646,162708
2731,68,53,1,7.53,65.87,162707,162775
2732,44,41,3,11.64,149.60,162774,162818
2733,58,34,1,8.83,63.42,162817,162875
2734,60,44,1,8.53,94.92,162874,162934
2735,60,29,1,8.53,39.85,162933,162993
2736,71,31,0,7.21,38.81,162992,163063
2737,51,30,3,10.04,64.00,163062,163113
2738,62,32,0,8.26,52.58,163112,163174
2739,64,32,1,8.00,36.75,163173,163237
2740,55,105,0,9.31,216.29,163236,163291
2741,144,36,0,3.56,39.34,163290,163434
2742,139,21,0,3.68,28.48,163433,163572
2743,54,23,0,9.48,72.51,163571,163625
2744,54,23,0,9.48,76.99,163624,163678
2745,62,23,0,8.26,55.87,163677,163739
2746,109,14,0,4.70,13.44,163738,163847
2747,248,16,0,2.06,5.59,163846,164094
2748,110,40,0,4.65,51.74,164093,164203
2749,36,19,0,14.22,12.28,164202,164238
2750,111,19,0,4.61,18.53,164237,164348
2751,78,13,0,6.56,19.84,164347,164425
2752,76,28,0,6.74,42.04,164424,164500
2753,40,20,1,12.80,5.81,164499,164539
2754,36,35,6,14.22,25.67,164538,164574
2755,37,42,3,13.84,37.49,164573,164610
2756,36,52,6,14.22,43.28,164609,164645
2757,44,19,1,11.64,9.41,164644,164688
2758,458,44,0,1.12,25.97,164687,165145
2759,153,28,0,3.35,34.06,165144,165297
2760,46,16,2,11.13,4.24,165296,165342
2761,49,12,1,10.45,2.70,165341,165390
2762,46,12,6,11.13,1.07,165389,165435
2763,43,68,2,11.91,95.67,165434,165477
2764,44,23,4,11.64,11.55,165476,165520
2765,194,28,0,2.64,21.66,165519,165713
2766,218,24,0,2.35,16.32,165712,165930
2767,108,50,0,4.74,23.97,165929,166037
2768,179,30,0,2.86,11.64,166036,166215
2769,152,27,1,3.37,16.57,166214,166366
2770,158,28,1,3.24,18.21,166365,166523
2771,162,24,1,3.16,13.59,166522,166684
2772,158,39,1,3.24,21.71,166684,166842
2773,159,40,1,3.22,24.84,166841,167000
2774,159,47,1,3.22,29.23,167000,167159
2775,99,27,0,5.17,41.29,167158,167257
2776,21,26,4,24.38,27.28,167256,167277
2777,393,44,0,1.30,35.08,167276,167669
2778,312,28,0,1.64,16.00,167668,167980
2779,226,28,0,2.27,18.04,167979,168205
2780,542,152,0,0.94,54.19,168204,168746
2781,384,265,0,1.33,236.94,168745,169129
2782,377,190,0,1.36,162.86,169128,169505
2783,348,357,0,1.47,408.58,169504,169852
2784,846,218,0,0.61,87.40,169851,170697
2785,205,19,0,2.50,14.05,170696,170901
2786,52,19,1,9.85,45.44,170900,170952
2787,104,22,0,4.92,32.67,170951,171055
2788,170,51,0,3.01,24.95,171054,171224
2789,193,105,0,2.65,80.93,171223,171416
2790,170,17,0,3.01,17.74,171416,171586
2791,30,19,5,17.07,6.93,171585,171615
2792,29,34,6,17.66,15.40,171614,171643
2793,28,32,2,18.29,26.85,171643,171671
2794,28,23,15,18.29,3.20,171670,171698
2795,93,27,0,5.51,56.66,171697,171790
2796,241,25,0,2.12,13.16,171790,172031
2797,165,30,0,3.10,17.47,172030,172195
2798,80,40,0,6.40,99.89,172194,172274
2799,116,31,0,4.41,10.71,172273,172389
2800,115,47,0,4.45,30.54,172388,172503
2801,174,40,0,2.94,31.18,172503,172677
2802,67,39,1,7.64,33.57,172676,172743
2803,145,47,0,3.53,21.64,172742,172887
2804,92,22,2,5.57,8.20,172886,172978
2805,27,129,2,18.96,1046.55,172977,173004
2806,22,38,8,23.27,37.83,173003,173025
2807,18,46,11,28.44,129.47,173024,173042
2808,26,40,10,19.69,41.83,173041,173067
2809,18,50,9,28.44,174.80,173066,173084
2810,35,21,10,14.63,12.23,173083,173118
2811,14,164,1,36.57,1663.39,173117,173131
2812,33,60,3,15.52,88.25,173130,173163
2813,24,60,4,21.33,113.64,173162,173186
2814,36,22,8,14.22,9.51,173185,173221
2815,37,28,3,13.84,18.46,173220,173257
2816,39,26,9,13.13,10.93,173257,173296
2817,27,65,9,18.96,107.00,173295,173322
2818,35,28,1,14.63,32.92,173321,173356
2819,77,18,0,6.65,41.84,173355,173432
2820,113,15,0,4.53,24.28,173431,173544
2821,117,32,0,4.38,26.06,173543,173660
2822,83,39,0,6.17,41.54,173659,173742
2823,103,20,2,4.97,11.31,173742,173845
2824,260,51,0,1.97,43.27,173844,174104
2825,255,57,0,2.01,53.32,174104,174359
2826,263,52,0,1.95,40.58,174358,174621
2827,263,58,0,1.95,24.60,174621,174884
2828,78,40,0,6.56,144.53,174883,174961
2829,13,40,32,39.38,4.54,174961,174974
2830,14,41,8,36.57,72.39,174973,174987
2831,14,41,10,36.57,101.82,174986,175000
2832,13,41,27,39.38,16.24,174999,175012
2833,14,41,7,36.57,72.96,175011,175025
2834,14,40,9,36.57,77.53,175024,175038
2835,14,40,17,36.57,64.10,175037,175051
2836,13,41,21,39.38,28.24,175050,175063
2837,14,41,1,36.57,129.24,175062,175076
2838,14,41,15,36.57,58.53,175075,175089
2839,14,38,23,36.57,15.82,175088,175102
2840,15,38,5,34.13,87.58,175101,175116
2841,14,38,20,36.57,21.39,175115,175129
2842,15,38,2,34.13,103.72,175128,175143
2843,14,41,10,36.57,79.96,175142,175156
2844,13,41,30,39.38,14.39,175155,175168
2845,14,41,11,36.57,105.10,175167,175181
2846,13,41,29,39.38,11.93,175180,175193
2847,14,41,6,36.57,119.96,175192,175206
2848,13,41,27,39.38,13.47,175205,175218
2849,14,41,1,36.57,129.24,175217,175231
2850,13,41,22,39.38,25.47,175230,175243
2851,14,41,2,36.57,95.10,175242,175256
2852,14,40,6,36.57,84.82,175255,175269
2853,14,40,14,36.57,65.39,175268,175282
2854,14,40,12,36.57,72.82,175281,175295
2855,14,40,4,36.57,91.10,175294,175308
2856,16,40,1,32.00,224.00,175307,175323
2857,14,40,5,36.57,87.82,175322,175336
2858,14,42,9,36.57,110.96,175335,175349
2859,13,42,17,39.38,47.47,175348,175361
2860,14,42,0,36.57,139.10,175360,175374
2861,14,45,1,36.57,183.24,175373,175387
2862,12,48,19,42.67,56.06,175386,175398
2863,13,49,1,39.38,132.70,175397,175410
2864,13,42,13,39.38,59.78,175410,175423
2865,13,42,21,39.38,40.08,175422,175435
2866,13,42,21,39.38,40.08,175434,175447
2867,13,42,12,39.38,63.62,175446,175459
2868,14,42,4,36.57,157.39,175458,175472
2869,13,42,17,39.38,46.24,175471,175484
2870,14,38,21,36.57,19.24,175483,175497
2871,15,38,3,34.13,101.98,175496,175511
2872,20,41,6,25.60,254.04,175510,175530
2873,14,41,4,36.57,122.82,175529,175543
2874,13,41,25,39.38,19.01,175542,175555
2875,14,41,5,36.57,99.67,175554,175568
2876,14,41,1,36.57,129.24,175567,175581
2877,13,41,25,39.38,17.78,175580,175593
2878,14,40,13,36.57,66.39,175592,175606
2879,14,40,13,36.57,71.82,175605,175619
2880,15,40,7,34.13,90.25,175618,175633
2881,14,38,22,36.57,17.39,175632,175646
2882,15,41,3,34.13,145.72,175645,175660
2883,13,41,23,39.38,23.01,175659,175672
2884,14,41,2,36.57,126.82,175671,175685
2885,13,41,28,39.38,11.47,175684,175697
2886,14,41,7,36.57,118.96,175696,175710
2887,13,41,29,39.38,12.54,175709,175722
2888,165,41,0,3.10,31.15,175721,175886
2889,31,31,1,16.52,81.60,175886,175917
2890,176,22,0,2.91,12.71,175916,176092
2891,233,23,0,2.20,14.05,176091,176324
2892,102,32,0,5.02,49.33,176323,176425
2893,33,36,0,15.52,92.43,176424,176457
2894,33,21,5,15.52,17.52,176456,176489
2895,37,29,0,13.84,28.78,176488,176525
2896,41,26,2,12.49,12.64,176524,176565
2897,38,26,6,13.47,15.67,176564,176602
2898,30,24,0,17.07,56.06,176601,176631
2899,51,30,0,10.04,48.94,176630,176681
2900,30,36,0,17.07,83.73,176680,176710
2901,46,36,0,11.13,107.77,176709,176755
2902,43,36,0,11.91,96.46,176754,176797
2903,45,23,0,11.38,91.70,176796,176841
2904,47,36,0,10.89,98.73,176840,176887
2905,46,19,0,11.13,41.94,176886,176932
2906,76,63,0,6.74,167.59,176931,177007
2907,9,62,38,56.89,45.65,177006,177015
2908,10,63,1,51.20,334.76,177014,177024
2909,10,59,16,51.20,246.56,177023,177033
2910,9,59,43,56.89,24.99,177032,177041
2911,10,60,3,51.20,305.76,177040,177050
2912,10,59,17,51.20,245.16,177049,177059
2913,9,59,42,56.89,28.10,177058,177067
2914,10,59,2,51.20,308.16,177066,177076
2915,10,70,8,51.20,355.76,177075,177085
2916,9,60,39,56.89,40.10,177084,177093
2917,9,70,20,56.89,191.88,177092,177101
2918,10,71,2,51.20,387.36,177100,177110
2919,10,59,7,51.20,277.16,177109,177119
2920,9,72,34,56.89,89.21,177118,177127
2921,10,59,15,51.20,248.36,177126,177136
2922,9,59,41,56.89,31.65,177135,177144
2923,10,59,18,51.20,244.16,177143,177153
2924,10,59,3,51.20,301.16,177152,177162
2925,9,69,20,56.89,181.43,177161,177170
2926,8,76,39,64.00,146.00,177169,177177
2927,10,76,1,51.20,441.36,177176,177186
2928,7,83,36,73.14,287.55,177185,177192
2929,7,83,38,73.14,274.41,177191,177198
2930,9,83,24,56.89,373.43,177197,177206
2931,10,60,7,51.20,282.56,177205,177215
2932,9,74,18,56.89,234.54,177214,177223
2933,9,71,20,56.89,199.88,177222,177231
2934,8,77,39,64.00,138.75,177230,177238
2935,8,91,12,64.00,500.00,177237,177245
2936,10,61,16,51.20,261.36,177244,177254
2937,9,60,37,56.89,49.65,177253,177262
2938,10,59,12,51.20,256.16,177262,177272
2939,9,59,47,56.89,16.99,177271,177280
2940,10,59,7,51.20,277.16,177279,177289
2941,9,76,26,56.89,286.54,177288,177297
2942,9,59,47,56.89,16.99,177296,177305
2943,10,71,7,51.20,368.36,177304,177314
2944,9,70,38,56.89,66.99,177313,177322
2945,10,70,9,51.20,353.36,177321,177331
2946,9,72,39,56.89,74.77,177330,177339
2947,10,72,4,51.20,491.56,177338,177348
2948,9,70,33,56.89,85.88,177347,177356
2949,9,73,26,56.89,156.32,177355,177364
2950,10,73,4,51.20,398.16,177363,177373
2951,9,68,31,56.89,91.65,177372,177381
2952,10,64,7,51.20,308.16,177380,177390
2953,9,70,32,56.89,97.21,177389,177398
2954,10,59,13,51.20,253.16,177397,177407
2955,9,72,34,56.89,106.54,177406,177415
2956,9,73,25,56.89,155.21,177414,177423
2957,10,59,6,51.20,282.56,177422,177432
2958,10,59,15,51.20,248.36,177431,177441
2959,9,59,44,56.89,22.32,177440,177449
2960,10,59,4,51.20,294.56,177448,177458
2961,10,59,17,51.20,245.16,177457,177467
2962,6,90,73,85.33,46.56,177466,177472
2963,7,90,11,73.14,824.69,177471,177478
2964,7,90,27,73.14,656.69,177477,177484
2965,7,90,30,73.14,471.55,177483,177490
2966,10,59,11,51.20,259.56,177489,177499
2967,9,59,48,56.89,16.10,177498,177507
2968,10,60,8,51.20,277.76,177506,177516
2969,10,59,12,51.20,256.16,177515,177525
2970,9,67,44,56.89,43.65,177524,177533
2971,10,70,14,51.20,347.36,177532,177542
2972,32,61,0,16.00,586.12,177541,177573
2973,201,33,0,2.55,18.06,177572,177773
2974,162,23,0,3.16,10.89,177772,177934
2975,55,40,1,9.31,26.76,177933,177988
2976,188,34,0,2.72,21.51,177987,178175
2977,81,23,0,6.32,59.18,178174,178255
2978,32,30,2,16.00,34.06,178254,178286
2979,29,21,2,17.66,21.81,178285,178314
2980,35,46,0,14.63,46.80,178313,178348
2981,31,23,1,16.52,37.48,178347,178378
2982,79,23,0,6.48,47.52,178377,178456
2983,45,32,4,11.38,42.59,178456,178501
2984,45,14,0,11.38,9.44,178500,178545
2985,190,26,0,2.69,13.65,178544,178734
2986,43,14,1,11.91,5.81,178733,178776
2987,37,50,3,13.84,47.33,178775,178812
2988,244,61,0,2.10,38.81,178811,179055
2989,418,131,0,1.22,93.02,179054,179472
2990,81,49,0,6.32,110.34,179472,179553
2991,42,28,0,12.19,143.96,179552,179594
2992,180,83,0,2.84,43.31,179593,179773
2993,67,24,0,7.64,46.92,179772,179839
2994,29,24,13,17.66,6.64,179838,179867
2995,115,28,0,4.45,40.68,179866,179981
2996,117,34,0,4.38,42.51,179980,180097
2997,223,61,0,2.30,42.24,180096,180319
2998,211,105,0,2.43,58.07,180319,180530
2999,106,19,0,4.83,8.22,180529,180635
3000,99,18,0,5.17,7.66,180634,180733
3001,99,37,0,5.17,43.70,180732,180831
3002,151,25,0,3.39,21.30,180830,180981
3003,148,24,0,3.46,16.94,180980,181128
3004,177,32,0,2.89,16.81,181127,181304
3005,138,31,0,3.71,13.34,181304,181442
3006,134,24,1,3.82,14.07,181442,181576
3007,115,15,1,4.45,13.13,181575,181690
3008,170,21,0,3.01,9.54,181690,181860
3009,137,31,2,3.74,15.76,181860,181997
3010,206,20,0,2.49,9.16,181996,182202
3011,130,31,1,3.94,18.92,182201,182331
3012,140,35,0,3.66,14.47,182330,182470
3013,297,25,0,1.72,9.92,182469,182766
3014,126,216,0,4.06,370.36,182765,182891
3015,200,73,0,2.56,26.93,182890,183090
3016,211,45,0,2.43,18.65,183090,183301
3017,193,42,0,2.65,27.30,183300,183493
3018,197,20,0,2.60,9.11,183493,183690
3019,167,13,0,3.07,7.55,183689,183856
3020,193,21,0,2.65,8.01,183856,184049
3021,131,13,0,3.91,9.98,184048,184179
3022,88,27,0,5.82,22.76,184179,184267
3023,221,23,0,2.32,9.59,184267,184488
3024,117,12,0,4.38,20.80,184487,184604
3025,86,119,0,5.95,384.21,184604,184690
3026,106,28,0,4.83,23.56,184689,184795
3027,135,18,0,3.79,16.09,184794,184929
3028,149,28,0,3.44,12.11,184928,185077
3029,191,22,0,2.68,10.87,185076,185267
3030,256,32,0,2.00,13.09,185266,185522
3031,215,36,0,2.38,17.69,185521,185736
3032,368,25,0,1.39,8.77,185736,186104
3033,163,45,0,3.14,31.53,186104,186267
3034,227,44,0,2.26,17.81,186266,186493
3035,67,27,2,7.64,14.08,186492,186559
3036,171,19,0,2.99,13.48,186558,186729
3037,112,14,0,4.57,23.44,186729,186841
3038,68,14,0,7.53,13.54,186841,186909
3039,85,11,0,6.02,15.86,186908,186993
3040,278,36,0,1.84,7.80,186992,187270
3041,127,28,0,4.03,13.12,187269,187396
3042,209,22,0,2.45,10.40,187395,187604
3043,264,18,0,1.94,9.41,187604,187868
3044,254,36,0,2.02,14.79,187867,188121
3045,256,26,0,2.00,12.09,188120,188376
3046,310,25,0,1.65,9.23,188375,188685
3047,107,267,2,4.79,658.73,188685,188792
3048,211,22,0,2.43,6.42,188791,189002
3049,211,45,0,2.43,18.41,189001,189212
3050,191,44,0,2.68,29.73,189211,189402
3051,204,29,0,2.51,12.40,189401,189605
3052,160,20,0,3.20,10.22,189604,189764
3053,191,10,0,2.68,5.12,189763,189954
3054,181,17,0,2.83,10.75,189953,190134
3055,79,27,0,6.48,20.30,190133,190212
3056,152,20,0,3.37,13.60,190211,190363
3057,146,28,0,3.51,21.54,190362,190508
3058,104,23,0,4.92,21.34,190507,190611
3059,116,58,1,4.41,38.69,190610,190726
3060,240,15,0,2.13,5.57,190725,190965
3061,200,26,0,2.56,10.69,190965,191165
3062,148,58,0,3.46,34.40,191165,191313
3063,144,58,0,3.56,38.44,191313,191457
3064,141,28,0,3.63,22.98,191456,191597
3065,28,26,1,18.29,59.42,191596,191624
3066,59,119,0,8.68,255.44,191623,191682
3067,140,32,0,3.66,12.98,191681,191821
3068,149,20,0,3.44,13.75,191821,191970
3069,217,21,1,2.36,6.05,191969,192186
3070,167,32,1,3.07,20.71,192186,192353
3071,165,34,0,3.10,15.70,192353,192518
3072,116,65,0,4.41,45.60,192517,192633
3073,159,85,0,3.22,67.62,192632,192791
3074,300,36,0,1.71,7.41,192790,193090
3075,235,22,0,2.18,8.88,193089,193324
3076,258,36,0,1.98,13.31,193323,193581
3077,217,32,0,2.36,13.24,193581,193798
3078,309,26,0,1.66,11.14,193798,194107
3079,303,19,0,1.69,6.29,194106,194409
3080,96,289,0,5.33,858.35,194408,194504
3081,197,23,0,2.60,8.65,194504,194701
3082,204,45,0,2.51,28.36,194700,194904
3083,228,43,0,2.25,18.76,194904,195132
3084,173,13,0,2.96,7.43,195131,195304
3085,165,11,0,3.10,6.72,195303,195468
3086,183,21,0,2.80,13.39,195467,195650
3087,113,27,0,4.53,15.17,195650,195763
3088,70,27,3,7.31,12.07,195762,195832
3089,218,28,0,2.35,11.98,195831,196049
3090,98,14,0,5.22,18.36,196048,196146
3091,181,33,0,2.83,6.45,196145,196326
3092,172,3,0,2.98,0.06,196326,196498
3093,215,144,0,2.38,109.03,196497,196712
3094,232,27,0,2.21,10.73,196712,196944
3095,211,15,0,2.43,4.87,196943,197154
3096,188,41,0,2.72,22.69,197153,197341
3097,107,43,0,4.79,24.67,197340,197447
3098,183,32,0,2.80,7.45,197447,197630
3099,179,35,0,2.86,13.33,197630,197809
3100,83,32,0,6.17,68.07,197808,197891
3101,51,25,0,10.04,142.27,197890,197941
3102,245,21,0,2.09,11.59,197940,198185
3103,198,37,0,2.59,32.22,198184,198382
3104,195,30,0,2.63,8.92,198381,198576
3105,112,6,1,4.57,0.66,198575,198687
3106,73,176,1,7.01,397.49,198686,198759
3107,2,334,178,256.00,6084.00,198758,198760
3108,108,20,2,4.74,2.73,198759,198867
3109,75,101,2,6.83,226.12,198866,198941
3110,118,7,3,4.34,0.48,198940,199058
3111,72,206,1,7.11,557.74,199057,199129
3112,54,202,3,9.48,753.36,199128,199182
3113,42,183,4,12.19,1040.39,199181,199223
3114,117,6,2,4.38,0.56,199223,199340
3115,117,6,2,4.38,0.56,199339,199456
3116,111,6,1,4.61,0.69,199455,199566
3117,110,6,2,4.65,0.55,199565,199675
3118,27,394,2,18.96,5410.41,199674,199701
3119,22,407,3,23.27,7015.38,199700,199722
3120,56,199,2,9.14,733.59,199721,199777
3121,78,128,1,6.56,192.25,199776,199854
3122,115,6,0,4.45,1.12,199853,199968
3123,115,17,0,4.45,2.72,199967,200082
3124,112,6,3,4.57,0.57,200082,200194
3125,40,333,1,12.80,2629.66,200193,200233
3126,9,407,2,56.89,15793.88,200232,200241
3127,110,6,1,4.65,0.72,200240,200350
3128,116,6,1,4.41,0.71,200349,200465
3129,107,6,3,4.79,0.64,200464,200571
3130,6,354,1,85.33,17116.56,200570,200576
3131,67,209,3,7.64,614.92,200575,200642
3132,113,6,1,4.53,0.73,200641,200754
3133,83,148,3,6.17,245.75,200753,200836
3134,3,328,4,170.67,17539.56,200835,200838
3135,114,6,2,4.49,0.69,200837,200951
3136,119,6,0,4.30,0.92,200950,201069
3137,121,18,0,4.23,2.95,201068,201189
3138,109,6,4,4.70,0.61,201188,201297
3139,110,6,3,4.65,0.52,201297,201407
3140,4,407,2,128.00,27436.50,201406,201410
3141,45,309,3,11.38,2013.66,201409,201454
3142,114,6,1,4.49,0.76,201453,201567
3143,112,6,1,4.57,0.64,201566,201678
3144,99,66,1,5.17,38.38,201677,201776
3145,2,288,224,256.00,1024.00,201775,201777
3146,82,130,4,6.24,189.75,201776,201858
3147,108,6,1,4.74,0.75,201857,201965
3148,26,199,2,19.69,2606.37,201964,201990
3149,116,6,3,4.41,0.45,201989,202105
3150,119,6,2,4.30,0.43,202105,202224
3151,51,289,3,10.04,1556.98,202223,202274
3152,19,362,1,26.95,6470.79,202273,202292
3153,123,6,3,4.16,0.23,202291,202414
3154,123,6,1,4.16,0.33,202413,202536
3155,119,6,1,4.30,0.53,202535,202654
3156,21,362,4,24.38,5914.43,202654,202675
3157,55,289,2,9.31,1448.98,202674,202729
3158,107,48,2,4.79,18.17,202728,202835
3159,88,101,1,5.82,131.29,202834,202922
3160,67,183,1,7.64,466.86,202921,202988
3161,79,182,2,6.48,395.39,202987,203066
3162,108,13,2,4.74,1.32,203065,203173
3163,2,315,197,256.00,3481.00,203172,203174
3164,84,131,3,6.10,188.49,203173,203257
3165,123,6,0,4.16,0.51,203256,203379
3166,85,137,2,6.02,204.80,203378,203463
3167,55,206,3,9.31,791.34,203462,203517
3168,120,6,2,4.27,0.48,203516,203636
3169,109,6,1,4.70,0.72,203635,203744
3170,66,213,2,7.76,648.70,203743,203809
3171,17,328,4,30.12,6218.46,203808,203825
3172,122,6,1,4.20,0.47,203824,203946
3173,124,6,3,4.13,0.21,203945,204069
3174,20,362,1,25.60,6230.94,204068,204088
3175,49,282,4,10.45,1536.74,204087,204136
3176,123,6,1,4.16,0.40,204135,204258
3177,80,147,3,6.40,250.86,204257,204337
3178,2,297,215,256.00,1681.00,204336,204338
3179,104,65,2,4.92,35.55,204337,204441
3180,126,6,1,4.06,0.27,204440,204566
3181,118,8,3,4.34,0.53,204565,204683
3182,79,101,1,6.48,213.59,204682,204761
3183,75,181,3,6.83,410.54,204760,204835
3184,64,206,3,8.00,629.31,204834,204898
3185,93,107,1,5.51,112.64,204897,204990
3186,57,183,2,8.98,629.42,204989,205046
3187,115,6,3,4.45,0.56,205045,205160
3188,27,199,1,18.96,2594.26,205159,205186
3189,106,6,2,4.83,0.67,205185,205291
3190,90,131,0,5.69,181.04,205290,205380
3191,2,281,231,256.00,625.00,205379,205381
3192,101,81,1,5.07,58.12,205380,205481
3193,121,6,1,4.23,0.44,205480,205601
3194,123,6,1,4.16,0.35,205600,205723
3195,123,6,3,4.16,0.30,205722,205845
3196,20,362,1,25.60,6180.64,205844,205864
3197,51,289,1,10.04,1557.17,205863,205914
3198,122,6,2,4.20,0.32,205913,206035
3199,86,76,1,5.95,120.30,206034,206120
3200,59,76,0,8.68,149.71,206119,206178
3201,35,24,0,14.63,67.89,206177,206212
3202,30,24,0,17.07,52.40,206211,206241
3203,40,34,0,12.80,108.71,206240,206280
3204,27,34,0,18.96,67.29,206279,206306
3205,28,24,0,18.29,57.56,206305,206333
3206,30,24,0,17.07,57.93,206332,206362
3207,29,48,2,17.66,60.98,206361,206390
3208,31,24,0,16.52,63.99,206389,206420
3209,28,24,0,18.29,37.92,206419,206447
3210,24,24,6,21.33,17.89,206446,206470
3211,21,31,1,24.38,55.95,206470,206491
3212,15,56,17,34.13,210.25,206490,206505
3213,21,68,16,24.38,133.19,206504,206525
3214,20,92,10,25.60,520.64,206524,206544
3215,26,28,0,19.69,39.91,206543,206569
3216,22,56,1,23.27,125.20,206568,206590
3217,13,56,11,39.38,282.54,206589,206602
3218,25,24,0,20.48,35.05,206601,206626
3219,28,24,0,18.29,29.13,206625,206653
3220,29,24,0,17.66,82.85,206652,206681
3221,25,24,0,20.48,26.65,206680,206705
3222,26,24,0,19.69,38.60,206704,206730
3223,30,48,0,17.07,65.46,206729,206759
3224,19,92,16,26.95,309.73,206758,206777
3225,22,54,10,23.27,61.93,206776,206798
3226,30,24,0,17.07,60.60,206797,206827
3227,31,28,0,16.52,96.96,206826,206857
3228,29,24,0,17.66,54.64,206856,206885
3229,55,31,0,9.31,71.67,206884,206939
3230,42,30,0,12.19,68.96,206938,206980
3231,112,24,0,4.57,34.28,206979,207091
3232,79,56,2,6.48,31.79,207090,207169
3233,292,18,0,1.75,11.94,207168,207460
3234,253,38,0,2.02,27.56,207459,207712
3235,299,38,0,1.71,26.57,207711,208010
3236,212,58,0,2.42,31.75,208009,208221
3237,161,25,0,3.18,32.99,208221,208382
3238,45,25,1,11.38,100.64,208381,208426
3239,23,24,2,22.26,32.11,208425,208448
3240,232,22,0,2.21,10.47,208447,208679
3241,64,16,0,8.00,12.38,208679,208743
3242,50,26,2,10.24,15.62,208742,208792
3243,241,17,0,2.12,10.15,208791,209032
3244,78,50,0,6.56,114.40,209032,209110
3245,192,33,0,2.67,22.92,209109,209301
3246,172,35,0,2.98,25.71,209300,209472
3247,186,32,0,2.75,10.33,209472,209658
3248,136,49,0,3.76,28.24,209657,209793
3249,61,23,0,8.39,59.12,209792,209853
3250,41,21,2,12.49,16.44,209852,209893
3251,23,34,6,22.26,100.02,209892,209915
3252,16,34,8,32.00,40.50,209914,209930
3253,16,34,6,32.00,45.62,209929,209945
3254,17,34,1,30.12,113.04,209944,209961
3255,16,34,4,32.00,52.38,209960,209976
3256,16,34,6,32.00,46.00,209975,209991
3257,16,34,13,32.00,26.12,209990,210006
3258,16,33,20,32.00,10.12,210005,210021
3259,17,34,3,30.12,81.75,210020,210037
3260,16,34,10,32.00,36.00,210036,210052
3261,16,34,13,32.00,29.88,210051,210067
3262,16,34,15,32.00,29.12,210066,210082
3263,16,34,19,32.00,24.25,210081,210097
3264,16,34,15,32.00,29.12,210096,210112
3265,17,34,1,30.12,83.40,210111,210128
3266,17,32,12,30.12,28.46,210127,210144
3267,18,32,1,28.44,68.69,210143,210161
3268,18,31,7,28.44,52.36,210160,210178
3269,17,31,23,30.12,5.87,210177,210194
3270,18,31,8,28.44,52.25,210193,210211
3271,18,34,2,28.44,117.02,210210,210228
3272,16,34,14,32.00,30.00,210227,210243
3273,16,34,20,32.00,11.25,210242,210258
3274,17,33,5,30.12,63.75,210257,210274
3275,16,34,16,32.00,26.88,210273,210289
3276,16,34,18,32.00,28.00,210288,210304
3277,16,34,16,32.00,17.25,210303,210319
3278,17,33,1,30.12,68.93,210318,210335
3279,16,34,17,32.00,28.12,210334,210350
3280,16,34,15,32.00,29.12,210349,210365
3281,16,34,13,32.00,29.88,210364,210380
3282,16,34,10,32.00,36.00,210379,210395
3283,17,34,6,30.12,71.52,210394,210411
3284,16,33,23,32.00,7.50,210410,210426
3285,16,34,10,32.00,33.75,210425,210441
3286,16,34,5,32.00,49.12,210440,210456
3287,17,34,3,30.12,78.81,210455,210472
3288,16,33,24,32.00,7.12,210471,210487
3289,17,33,7,30.12,62.57,210486,210503
3290,16,33,23,32.00,7.50,210502,210518
3291,16,34,6,32.00,46.00,210517,210533
3292,16,34,4,32.00,52.50,210532,210548
3293,17,33,2,30.12,67.28,210547,210564
3294,16,34,18,32.00,13.38,210563,210579
3295,16,34,3,32.00,56.12,210578,210594
3296,17,34,1,30.12,105.75,210593,210610
3297,16,34,5,32.00,49.12,210609,210625
3298,16,34,7,32.00,43.12,210624,210640
3299,16,33,24,32.00,7.12,210639,210655
3300,21,33,1,24.38,133.47,210654,210675
3301,40,19,2,12.80,11.61,210674,210714
3302,37,23,0,13.84,47.27,210713,210750
3303,23,33,0,22.26,212.11,210749,210772
3304,17,33,2,30.12,67.28,210771,210788
3305,16,33,18,32.00,13.12,210787,210803
3306,17,34,1,30.12,75.63,210802,210819
3307,16,34,15,32.00,29.12,210818,210834
3308,16,34,19,32.00,24.25,210833,210849
3309,16,34,15,32.00,29.12,210848,210864
3310,16,34,13,32.00,31.12,210863,210879
3311,16,34,11,32.00,33.12,210878,210894
3312,16,34,8,32.00,40.50,210893,210909
3313,16,34,6,32.00,45.50,210908,210924
3314,16,34,2,32.00,60.00,210923,210939
3315,18,34,1,28.44,89.02,210939,210957
3316,17,31,19,30.12,8.22,210956,210973
3317,16,34,15,32.00,29.12,210972,210988
3318,16,34,13,32.00,31.12,210987,211003
3319,16,34,11,32.00,33.12,211002,211018
3320,16,34,8,32.00,40.50,211017,211033
3321,18,34,1,28.44,111.47,211032,211050
3322,16,33,25,32.00,7.00,211049,211065
3323,18,33,6,28.44,57.80,211064,211082
3324,19,34,2,26.95,108.79,211081,211100
3325,16,34,8,32.00,40.50,211099,211115
3326,16,34,15,32.00,23.25,211114,211130
3327,16,33,18,32.00,13.12,211129,211145
3328,17,34,1,30.12,78.10,211144,211161
3329,16,34,14,32.00,30.00,211160,211176
3330,16,34,19,32.00,22.50,211175,211191
3331,17,33,3,30.12,65.87,211190,211207
3332,16,34,15,32.00,20.12,211206,211222
3333,16,34,17,32.00,28.12,211221,211237
3334,16,34,17,32.00,21.88,211236,211252
3335,17,33,7,30.12,62.57,211251,211268
3336,16,34,20,32.00,12.88,211267,211283
3337,16,34,14,32.00,30.00,211282,211298
3338,16,34,12,32.00,29.50,211297,211313
3339,17,33,6,30.12,63.04,211312,211329
3340,16,34,22,32.00,11.88,211328,211344
3341,16,34,10,32.00,36.00,211343,211359
3342,16,34,8,32.00,39.38,211358,211374
3343,17,33,3,30.12,65.87,211373,211390
3344,16,34,19,32.00,13.75,211389,211405
3345,16,34,7,32.00,43.12,211404,211420
3346,16,34,5,32.00,49.12,211419,211435
3347,16,34,3,32.00,56.12,211434,211450
3348,17,34,1,30.12,113.04,211449,211466
3349,16,34,3,32.00,56.12,211465,211481
3350,16,34,11,32.00,30.38,211480,211496
3351,17,32,11,30.12,29.52,211495,211512
3352,127,32,0,4.03,60.83,211511,211638
3353,83,28,0,6.17,54.43,211637,211720
3354,26,26,2,19.69,24.52,211719,211745
3355,25,21,13,20.48,2.57,211744,211769
3356,20,110,8,25.60,389.64,211768,211788
3357,23,59,2,22.26,99.15,211788,211811
3358,26,22,2,19.69,13.14,211810,211836
3359,27,25,2,18.96,17.37,211835,211862
3360,24,43,10,21.33,32.64,211861,211885
3361,76,36,0,6.74,51.38,211884,211960
3362,111,12,0,4.61,11.71,211959,212070
3363,80,14,0,6.40,25.81,212069,212149
3364,104,27,0,4.92,27.86,212149,212253
3365,50,45,0,10.24,112.34,212252,212302
3366,64,21,0,8.00,28.78,212301,212365
3367,61,50,0,8.39,123.81,212364,212425
3368,233,190,0,2.20,157.44,212425,212658
3369,233,42,0,2.20,19.79,212657,212890
3370,47,51,0,10.89,52.69,212889,212936
3371,52,20,3,9.85,7.82,212935,212987
3372,49,36,2,10.45,22.86,212986,213035
3373,37,215,2,13.84,1137.49,213034,213071
3374,51,67,1,10.04,70.19,213070,213121
3375,116,31,0,4.41,32.45,213121,213237
3376,68,62,1,7.53,129.84,213237,213305
3377,69,70,2,7.42,96.36,213304,213373
3378,62,65,2,8.26,174.97,213373,213435
3379,122,97,0,4.20,117.80,213434,213556
3380,121,19,1,4.23,3.25,213555,213676
3381,100,83,2,5.12,65.77,213675,213775
3382,58,276,1,8.83,1257.49,213774,213832
3383,84,142,3,6.10,246.87,213831,213915
3384,70,120,0,7.31,212.96,213914,213984
3385,230,188,0,2.23,164.84,213983,214213
3386,206,20,0,2.49,9.00,214212,214418
3387,179,40,0,2.86,23.60,214417,214596
3388,183,31,1,2.80,19.10,214595,214778
3389,178,60,0,2.88,33.80,214777,214955
3390,155,87,0,3.30,61.27,214955,215110
3391,142,152,0,3.61,168.44,215110,215252
3392,177,131,0,2.89,100.36,215251,215428
3393,191,72,0,2.68,29.65,215427,215618
3394,120,141,0,4.27,221.60,215617,215737
3395,173,58,0,2.96,31.40,215736,215909
3396,132,83,0,3.88,90.03,215908,216040
3397,181,95,0,2.83,53.80,216040,216221
3398,182,26,0,2.81,14.81,216220,216402
3399,195,29,0,2.63,16.72,216401,216596
3400,185,81,0,2.77,53.74,216595,216780
3401,165,6,0,3.10,1.96,216780,216945
3402,142,5,1,3.61,0.63,216944,217086
3403,123,27,1,4.16,5.23,217085,217208
3404,11,112,2,46.55,2482.25,217207,217218
3405,102,112,1,5.02,123.02,217217,217319
3406,142,6,1,3.61,0.83,217318,217460
3407,145,5,1,3.53,0.90,217459,217604
3408,41,127,2,12.49,1024.49,217603,217644
3409,45,126,1,11.38,918.99,217643,217688
3410,141,21,0,3.63,19.45,217688,217829
3411,22,419,0,23.27,7491.29,217828,217850
3412,1,512,512,512.00,0.00,217849,217850
3413,1,512,512,512.00,0.00,217849,217850
3414,1,512,512,512.00,0.00,217849,217850
3415,1,512,512,512.00,0.00,217849,217850
3416,2030,263,0,0.25,64.55,217849,219879
3417,879,276,0,0.58,149.69,219878,220757
3418,1,512,512,512.00,0.00,220756,220757
3419,1,512,512,512.00,0.00,220756,220757
3420,590,192,0,0.87,68.63,220756,221346
3421,74,17,0,6.92,15.18,221345,221419
3422,95,53,3,5.39,25.46,221418,221513
3423,45,40,1,11.38,49.26,221512,221557
3424,71,18,0,7.21,23.35,221557,221628
3425,46,27,1,11.13,25.98,221627,221673
3426,62,41,0,8.26,41.16,221672,221734
3427,82,29,1,6.24,29.04,221733,221815
3428,53,26,0,9.66,75.77,221814,221867
3429,24,54,3,21.33,116.22,221866,221890
3430,25,27,4,20.48,14.49,221889,221914
3431,138,35,0,3.71,30.92,221913,222051
3432,34,26,0,15.06,47.53,222050,222084
3433,28,32,1,18.29,27.35,222083,222111
3434,71,26,0,7.21,61.63,222110,222181
3435,49,18,4,10.45,4.94,222180,222229
3436,41,73,4,12.49,105.27,222228,222269
3437,57,19,0,8.98,16.44,222268,222325
3438,40,73,1,12.80,108.21,222324,222364
3439,71,105,0,7.21,177.32,222363,222434
3440,565,211,0,0.91,114.89,222433,222998
3441,233,51,0,2.20,30.17,222997,223230
3442,230,34,0,2.23,19.55,223229,223459
3443,232,28,0,2.21,9.71,223458,223690
3444,343,3,0,1.49,2.24,223689,224032
3445,343,3,0,1.49,2.23,224031,224374
3446,342,3,0,1.50,2.24,224373,224715
3447,340,3,0,1.51,2.24,224715,225055
3448,343,3,0,1.49,2.24,225054,225397
3449,342,3,0,1.50,2.24,225396,225738
3450,341,3,0,1.50,2.24,225738,226079
3451,343,3,0,1.49,2.24,226078,226421
3452,343,3,0,1.49,2.24,226420,226763
3453,342,3,0,1.50,2.24,226762,227104
3454,313,3,0,1.64,1.66,227104,227417
3455,335,4,0,1.53,2.08,227416,227751
3456,290,4,0,1.77,1.30,227750,228040
3457,99,77,0,5.17,215.31,228040,228139
3458,9,69,12,56.89,363.43,228138,228147
3459,8,77,45,64.00,93.75,228146,228154
3460,8,79,15,64.00,358.50,228153,228161
3461,8,84,3,64.00,576.25,228160,228168
3462,102,67,0,5.02,158.90,228167,228269
3463,10,63,17,51.20,139.36,228268,228278
3464,10,68,6,51.20,291.16,228277,228287
3465,201,136,0,2.55,91.46,228286,228487
3466,9,78,11,56.89,600.10,228486,228495
3467,9,67,17,56.89,218.54,228494,228503
3468,9,67,11,56.89,270.32,228502,228511
3469,12,74,2,42.67,1025.72,228510,228522
3470,8,77,42,64.00,88.25,228521,228529
3471,9,80,13,56.89,448.10,228528,228537
3472,9,69,11,56.89,331.88,228536,228545
3473,8,86,18,64.00,357.50,228544,228552
3474,9,197,2,56.89,4040.10,228551,228560
3475,8,78,34,64.00,154.50,228559,228567
3476,9,75,6,56.89,474.32,228566,228575
3477,8,88,45,64.00,120.75,228574,228582
3478,11,85,2,46.55,842.43,228581,228592
3479,9,99,24,56.89,332.32,228591,228600
3480,10,64,13,51.20,234.56,228599,228609
3481,15,75,2,34.13,924.65,228608,228623
3482,8,76,38,64.00,117.00,228622,228630
3483,9,80,9,56.89,417.43,228629,228638
3484,8,78,58,64.00,35.25,228637,228645
3485,13,164,2,39.38,2221.01,228644,228657
3486,9,79,26,56.89,296.32,228656,228665
3487,9,66,36,56.89,126.77,228664,228673
3488,9,87,25,56.89,348.10,228672,228681
3489,13,87,2,39.38,740.85,228680,228693
3490,11,111,9,46.55,544.25,228692,228703
3491,9,63,46,56.89,28.54,228702,228711
3492,10,64,8,51.20,223.96,228710,228720
3493,10,60,26,51.20,107.16,228719,228729
3494,11,59,4,46.55,247.52,228728,228739
3495,11,57,15,46.55,123.34,228738,228749
3496,12,48,27,42.67,25.39,228748,228760
3497,12,66,4,42.67,277.89,228759,228771
3498,11,51,40,46.55,6.98,228770,228781
3499,13,57,1,39.38,195.01,228780,228793
3500,10,60,27,51.20,79.16,228792,228802
3501,10,58,12,51.20,172.36,228801,228811
3502,12,62,2,42.67,381.56,228810,228822
3503,10,63,36,51.20,60.56,228821,228831
3504,12,63,3,42.67,331.06,228830,228842
3505,9,89,42,56.89,148.99,228841,228850
3506,10,67,14,51.20,174.76,228849,228859
3507,8,114,1,64.00,1014.50,228858,228866
3508,8,100,49,64.00,385.00,228865,228873
3509,10,76,7,51.20,335.56,228872,228882
3510,10,67,15,51.20,267.16,228881,228891
3511,10,66,2,51.20,303.56,228890,228900
3512,8,90,54,64.00,120.00,228899,228907
3513,12,54,8,42.67,117.72,228907,228919
3514,12,49,5,42.67,134.72,228918,228930
3515,12,51,39,42.67,10.22,228929,228941
3516,12,53,5,42.67,142.56,228940,228952
3517,13,50,6,39.38,127.78,228951,228964
3518,10,81,24,51.20,237.76,228963,228973
3519,11,57,11,46.55,221.34,228972,228983
3520,10,57,45,51.20,11.56,228982,228992
3521,11,52,7,46.55,157.16,228991,229002
3522,10,113,1,51.20,1204.96,229001,229011
3523,9,72,44,56.89,46.10,229010,229019
3524,10,75,12,51.20,333.36,229018,229028
3525,16,193,2,32.00,2473.62,229027,229043
3526,8,105,15,64.00,672.50,229042,229050
3527,9,79,30,56.89,145.43,229049,229058
3528,14,78,2,36.57,829.53,229057,229071
3529,9,67,24,56.89,141.88,229070,229079
3530,10,64,8,51.20,333.76,229078,229088
3531,9,71,35,56.89,100.54,229087,229096
3532,285,61,0,1.80,15.31,229095,229380
3533,176,118,0,2.91,120.86,229379,229555
3534,9,93,13,56.89,379.88,229554,229563
3535,10,61,11,51.20,190.16,229562,229572
3536,159,66,0,3.22,82.64,229571,229730
3537,298,3,0,1.72,1.32,229730,230028
3538,309,3,0,1.66,0.98,230028,230337
3539,320,4,0,1.60,1.71,230336,230656
3540,340,3,0,1.51,2.11,230655,230995
3541,339,4,0,1.51,2.23,230994,231333
3542,362,3,0,1.41,1.92,231332,231694
3543,327,82,1,1.57,40.74,231694,232021
3544,7,85,42,73.14,256.41,232020,232027
3545,7,90,41,73.14,300.12,232026,232033
3546,7,101,28,73.14,521.27,232032,232039
3547,7,81,30,73.14,311.27,232038,232045
3548,7,87,13,73.14,609.27,232044,232051
3549,256,94,1,2.00,83.43,232050,232306
3550,512,1,1,1.00,0.00,232306,232818
3551,271,59,1,1.89,44.64,232818,233089
3552,9,69,25,56.89,271.88,233088,233097
3553,8,71,42,64.00,72.50,233096,233104
3554,9,74,1,56.89,524.10,233103,233112
3555,10,61,31,51.20,102.56,233111,233121
3556,10,68,1,51.20,390.96,233120,233130
3557,8,85,33,64.00,179.25,233129,233137
3558,9,71,14,56.89,341.65,233136,233145
3559,9,74,17,56.89,281.65,233144,233153
3560,10,74,17,51.20,254.16,233152,233162
3561,8,78,10,64.00,455.00,233161,233169
3562,7,85,55,73.14,78.41,233168,233175
3563,8,78,22,64.00,394.50,233174,233182
3564,7,101,35,73.14,325.84,233181,233188
3565,9,80,4,56.89,800.54,233187,233196
3566,9,67,32,56.89,116.77,233195,233204
3567,10,74,19,51.20,201.16,233203,233213
3568,10,80,10,51.20,448.96,233212,233222
3569,8,75,27,64.00,242.00,233221,233229
3570,8,88,2,64.00,650.00,233228,233236
3571,8,74,12,64.00,387.50,233235,233243
3572,8,78,4,64.00,520.25,233242,233250
3573,7,80,57,73.14,50.12,233249,233256
3574,8,92,13,64.00,745.25,233255,233263
3575,7,77,63,73.14,18.12,233262,233269
3576,8,86,1,64.00,702.25,233268,233276
3577,9,77,31,56.89,163.21,233275,233284
3578,9,78,23,56.89,182.99,233283,233292
3579,8,84,12,64.00,414.50,233291,233299
3580,8,76,16,64.00,355.00,233298,233306
3581,9,87,7,56.89,678.99,233305,233314
3582,9,62,47,56.89,14.54,233313,233322
3583,10,66,4,51.20,459.36,233321,233331
3584,8,67,53,64.00,19.25,233330,233338
3585,9,78,13,56.89,471.21,233337,233346
3586,9,67,23,56.89,182.77,233345,233354
3587,9,62,38,56.89,66.99,233353,233362
3588,10,62,15,51.20,275.56,233361,233371
3589,10,61,28,51.20,106.96,233370,233380
3590,10,62,26,51.20,119.76,233379,233389
3591,9,66,27,56.89,152.99,233388,233397
3592,9,73,20,56.89,238.99,233396,233405
3593,10,62,4,51.20,382.56,233404,233414
3594,9,63,37,56.89,56.99,233413,233422
3595,10,65,17,51.20,142.76,233421,233431
3596,9,72,7,56.89,423.21,233430,233439
3597,8,77,35,64.00,134.25,233438,233446
3598,10,66,10,51.20,410.76,233445,233455
3599,9,62,46,56.89,21.65,233454,233463
3600,9,77,3,56.89,788.99,233462,233471
3601,8,73,16,64.00,330.75,233470,233478
3602,8,78,25,64.00,243.25,233477,233485
3603,8,79,27,64.00,284.50,233484,233492
3604,7,82,51,73.14,122.12,233491,233498
3605,8,81,19,64.00,632.75,233497,233505
3606,7,78,60,73.14,43.84,233504,233511
3607,8,81,12,64.00,675.50,233510,233518
3608,8,81,34,64.00,257.50,233517,233525
3609,10,58,20,51.20,110.96,233524,233534
3610,11,56,1,46.55,236.61,233533,233544
3611,9,77,14,56.89,396.10,233543,233552
3612,8,77,27,64.00,409.75,233551,233559
3613,7,82,53,73.14,81.55,233558,233565
3614,8,83,6,64.00,678.50,233564,233572
3615,8,81,1,64.00,700.75,233571,233579
3616,10,66,27,51.20,110.36,233578,233588
3617,8,70,40,64.00,87.75,233587,233595
3618,9,72,8,56.89,547.43,233594,233603
3619,8,78,45,64.00,124.25,233602,233610
3620,8,94,8,64.00,739.50,233609,233617
3621,7,78,61,73.14,27.27,233616,233623
3622,8,75,14,64.00,416.50,233622,233630
3623,8,83,25,64.00,442.00,233629,233637
3624,10,64,12,51.20,224.96,233636,233646
3625,9,66,17,56.89,218.99,233645,233654
3626,9,66,47,56.89,50.10,233653,233662
3627,7,77,63,73.14,18.12,233662,233669
3628,8,83,12,64.00,519.75,233668,233676
3629,8,78,29,64.00,376.75,233675,233683
3630,8,88,1,64.00,690.50,233682,233690
3631,9,75,31,56.89,187.43,233689,233698
3632,9,79,18,56.89,298.77,233697,233706
3633,9,79,1,56.89,822.77,233705,233714
3634,7,78,69,73.14,8.12,233713,233720
3635,8,88,1,64.00,617.25,233719,233727
3636,10,71,14,51.20,186.16,233726,233736
3637,8,82,1,64.00,876.00,233735,233743
3638,7,87,38,73.14,318.98,233742,233749
3639,6,125,63,85.33,422.22,233748,233754
3640,8,87,2,64.00,1043.50,233753,233761
3641,7,83,28,73.14,341.27,233760,233767
3642,6,119,59,85.33,331.22,233766,233772
3643,10,79,25,51.20,149.16,233771,233781
3644,125,57,1,4.10,145.80,233780,233905
3645,406,56,1,1.26,13.79,233905,234311
3646,505,3,0,1.01,0.03,234311,234816
3647,146,46,0,3.51,54.74,234816,234962
3648,175,103,0,2.93,99.09,234962,235137
3649,67,22,0,7.64,29.16,235136,235203
3650,52,19,0,9.85,14.90,235202,235254
3651,46,12,1,11.13,3.42,235253,235299
3652,52,16,0,9.85,14.17,235298,235350
3653,45,18,2,11.38,6.55,235349,235394
3654,39,77,4,13.13,120.73,235393,235432
3655,43,28,8,11.91,15.01,235431,235474
3656,23,270,2,22.26,2796.80,235473,235496
3657,45,28,5,11.38,7.21,235495,235540
3658,47,13,3,10.89,2.39,235539,235586
3659,45,12,9,11.38,0.50,235585,235630
3660,47,12,3,10.89,3.20,235629,235676
3661,47,12,1,10.89,2.86,235675,235722
3662,52,12,1,9.85,9.90,235721,235773
3663,212,88,0,2.42,54.79,235772,235984
3664,84,28,0,6.10,50.87,235983,236067
3665,73,24,0,7.01,70.86,236066,236139
3666,46,23,1,11.13,15.37,236138,236184
3667,56,23,1,9.14,28.30,236183,236239
3668,56,18,0,9.14,18.84,236238,236294
3669,90,23,0,5.69,29.84,236293,236383
3670,59,25,0,8.68,73.17,236382,236441
3671,34,46,3,15.06,47.17,236440,236474
3672,36,33,6,14.22,17.90,236473,236509
3673,27,33,0,18.96,150.70,236508,236535
3674,37,31,0,13.84,43.76,236534,236571
3675,24,29,0,21.33,85.89,236570,236594
3676,25,33,10,20.48,64.97,236593,236618
3677,16,61,4,32.00,114.62,236617,236633
3678,16,61,7,32.00,110.50,236632,236648
3679,16,33,24,32.00,7.12,236647,236663
3680,16,61,9,32.00,109.00,236662,236678
3681,16,61,2,32.00,118.62,236677,236693
3682,16,33,19,32.00,11.50,236692,236708
3683,16,61,8,32.00,109.62,236707,236723
3684,16,33,25,32.00,7.00,236722,236738
3685,16,61,8,32.00,109.62,236737,236753
3686,16,61,3,32.00,116.50,236752,236768
3687,16,33,20,32.00,10.12,236767,236783
3688,16,61,9,32.00,109.00,236782,236798
3689,16,33,24,32.00,7.12,236797,236813
3690,16,35,15,32.00,19.50,236812,236828
3691,16,61,4,32.00,114.62,236827,236843
3692,15,61,26,34.13,55.32,236842,236857
3693,17,33,7,30.12,62.57,236856,236873
3694,15,61,23,34.13,57.72,236872,236887
3695,16,61,1,32.00,121.00,236886,236902
3696,17,33,5,30.12,63.75,236901,236918
3697,15,61,27,34.13,55.05,236917,236932
3698,16,61,6,32.00,111.62,236931,236947
3699,16,33,17,32.00,15.00,236946,236962
3700,15,61,22,34.13,59.05,236962,236977
3701,17,33,6,30.12,63.04,236976,236993
3702,15,61,27,34.13,55.05,236992,237007
3703,17,33,5,30.12,63.75,237006,237023
3704,16,61,1,32.00,121.00,237022,237038
3705,14,61,28,36.57,97.10,237037,237051
3706,17,33,5,30.12,63.75,237050,237067
3707,16,61,1,32.00,121.00,237066,237082
3708,15,61,23,34.13,57.72,237081,237096
3709,17,33,7,30.12,62.57,237095,237112
3710,15,61,26,34.13,55.32,237111,237126
3711,16,61,4,32.00,114.62,237125,237141
3712,17,33,2,30.12,67.28,237140,237157
3713,14,61,1,36.57,228.67,237156,237170
3714,16,33,18,32.00,13.12,237169,237185
3715,16,61,7,32.00,110.50,237184,237200
3716,15,61,26,34.13,55.32,237199,237214
3717,17,33,4,30.12,64.69,237213,237230
3718,16,61,2,32.00,118.62,237229,237245
3719,16,33,19,32.00,11.50,237244,237260
3720,16,60,9,32.00,103.12,237259,237275
3721,16,33,24,32.00,7.12,237274,237290
3722,16,61,7,32.00,110.50,237289,237305
3723,16,61,4,32.00,114.62,237304,237320
3724,16,33,21,32.00,9.00,237319,237335
3725,16,40,10,32.00,35.12,237334,237350
3726,15,61,23,34.13,57.72,237349,237364
3727,17,33,1,30.12,68.93,237363,237380
3728,16,61,5,32.00,113.00,237379,237395
3729,15,61,27,34.13,55.05,237394,237409
3730,17,33,6,30.12,63.04,237408,237425
3731,15,61,22,34.13,59.05,237424,237439
3732,15,61,22,34.13,59.05,237439,237454
3733,17,33,6,30.12,63.04,237453,237470
3734,15,61,27,34.13,55.05,237469,237484
3735,16,61,5,32.00,113.00,237483,237499
3736,17,33,1,30.12,68.93,237498,237515
3737,15,61,23,34.13,57.72,237514,237529
3738,17,33,7,30.12,62.57,237528,237545
3739,15,61,26,34.13,55.32,237544,237559
3740,16,61,4,32.00,114.62,237558,237574
3741,17,33,2,30.12,67.28,237573,237590
3742,15,61,24,34.13,56.65,237589,237604
3743,16,61,9,32.00,109.00,237603,237619
3744,16,33,20,32.00,10.12,237618,237634
3745,16,61,3,32.00,116.50,237633,237649
3746,16,61,8,32.00,109.62,237648,237664
3747,16,33,25,32.00,7.00,237663,237679
3748,16,61,8,32.00,109.62,237678,237694
3749,16,33,19,32.00,11.50,237693,237709
3750,16,61,2,32.00,118.62,237708,237724
3751,16,61,9,32.00,109.00,237723,237739
3752,15,61,24,34.13,56.65,237738,237753
3753,16,61,2,32.00,118.62,237752,237768
3754,16,61,9,32.00,109.00,237767,237783
3755,16,33,24,32.00,7.12,237782,237798
3756,16,61,7,32.00,110.50,237797,237813
3757,16,33,18,32.00,13.12,237812,237828
3758,16,61,1,32.00,121.00,237827,237843
3759,16,61,10,32.00,108.62,237842,237858
3760,15,61,23,34.13,57.72,237857,237872
3761,17,33,1,30.12,68.93,237871,237888
3762,16,61,5,32.00,113.00,237887,237903
3763,15,61,27,34.13,55.05,237902,237917
3764,17,33,6,30.12,63.04,237916,237933
3765,15,61,22,34.13,59.05,237932,237947
3766,16,33,17,32.00,15.00,237947,237963
3767,16,61,6,32.00,111.62,237962,237978
3768,15,61,27,34.13,55.05,237977,237992
3769,16,61,5,32.00,113.00,237991,238007
3770,17,33,1,30.12,68.93,238006,238023
3771,15,61,23,34.13,57.72,238022,238037
3772,16,61,10,32.00,108.62,238036,238052
3773,16,33,21,32.00,9.00,238051,238067
3774,16,61,4,32.00,114.62,238066,238082
3775,16,61,7,32.00,110.50,238081,238097
3776,16,33,24,32.00,7.12,238096,238112
3777,16,61,9,32.00,109.00,238111,238127
3778,16,61,2,32.00,118.62,238126,238142
3779,16,33,19,32.00,11.50,238141,238157
3780,16,61,8,32.00,109.62,238156,238172
3781,15,61,25,34.13,55.85,238171,238186
3782,17,33,3,30.12,65.87,238185,238202
3783,16,61,3,32.00,116.50,238201,238217
3784,15,61,25,34.13,55.85,238216,238231
3785,17,33,8,30.12,62.34,238230,238247
3786,15,61,24,34.13,56.65,238246,238261
3787,17,33,2,30.12,67.28,238260,238277
3788,16,61,4,32.00,114.62,238276,238292
3789,15,61,26,34.13,55.32,238291,238306
3790,16,61,7,32.00,110.50,238305,238321
3791,16,33,18,32.00,13.12,238320,238336
3792,16,61,1,32.00,121.00,238335,238351
3793,17,33,5,30.12,63.75,238350,238367
3794,15,61,27,34.13,55.05,238366,238381
3795,16,61,6,32.00,111.62,238380,238396
3796,16,33,17,32.00,15.00,238395,238411
3797,15,61,22,34.13,59.05,238411,238426
3798,16,61,11,32.00,108.50,238425,238441
3799,15,61,22,34.13,59.05,238440,238455
3800,16,33,17,32.00,15.00,238455,238471
3801,16,61,6,32.00,111.62,238470,238486
3802,16,33,23,32.00,7.50,238485,238501
3803,17,33,7,30.12,62.57,238500,238517
3804,15,61,26,34.13,55.32,238516,238531
3805,16,61,4,32.00,114.62,238530,238546
3806,17,33,2,30.12,67.28,238545,238562
3807,15,61,24,34.13,56.65,238561,238576
3808,17,33,8,30.12,62.34,238575,238592
3809,15,53,30,34.13,25.98,238591,238606
3810,16,61,3,32.00,116.50,238605,238621
3811,16,61,8,32.00,109.62,238620,238636
3812,16,33,25,32.00,7.00,238635,238651
3813,16,61,8,32.00,109.62,238650,238666
3814,16,33,19,32.00,11.50,238665,238681
3815,16,61,2,32.00,118.62,238680,238696
3816,16,37,13,32.00,25.00,238695,238711
3817,16,33,24,32.00,7.12,238710,238726
3818,16,61,7,32.00,110.50,238725,238741
3819,16,61,4,32.00,114.62,238740,238756
3820,16,33,21,32.00,9.00,238755,238771
3821,16,61,10,32.00,108.62,238770,238786
3822,15,61,23,34.13,57.72,238785,238800
3823,17,33,1,30.12,68.93,238799,238816
3824,16,61,5,32.00,113.00,238815,238831
3825,16,33,22,32.00,8.12,238830,238846
3826,17,33,6,30.12,63.04,238845,238862
3827,15,61,27,34.13,55.05,238861,238876
3828,16,61,5,32.00,113.00,238875,238891
3829,17,33,1,30.12,68.93,238890,238907
3830,15,61,23,34.13,57.72,238906,238921
3831,17,33,7,30.12,62.57,238920,238937
3832,15,61,26,34.13,55.32,238936,238951
3833,16,61,4,32.00,114.62,238950,238966
3834,17,33,2,30.12,67.28,238965,238982
3835,15,59,24,34.13,49.18,238981,238996
3836,16,61,9,32.00,109.00,238995,239011
3837,16,33,20,32.00,10.12,239010,239026
3838,16,61,3,32.00,116.50,239025,239041
3839,16,61,8,32.00,109.62,239040,239056
3840,16,33,25,32.00,7.00,239055,239071
3841,16,61,8,32.00,109.62,239070,239086
3842,16,33,19,32.00,11.50,239085,239101
3843,16,61,2,32.00,118.62,239100,239116
3844,16,61,9,32.00,109.00,239115,239131
3845,15,59,24,34.13,49.18,239130,239145
3846,16,61,2,32.00,118.62,239144,239160
3847,17,33,4,30.12,64.69,239159,239176
3848,15,57,26,34.13,40.38,239175,239190
3849,16,61,7,32.00,110.50,239189,239205
3850,16,33,18,32.00,13.12,239204,239220
3851,16,61,1,32.00,121.00,239219,239235
3852,17,33,5,30.12,63.75,239234,239251
3853,15,60,28,34.13,50.65,239250,239265
3854,16,61,5,32.00,113.00,239264,239280
3855,17,33,1,30.12,68.93,239279,239296
3856,15,61,23,34.13,57.72,239295,239310
3857,16,61,10,32.00,108.62,239309,239325
3858,16,33,21,32.00,9.00,239324,239340
3859,16,61,4,32.00,114.62,239339,239355
3860,17,33,2,30.12,67.28,239354,239371
3861,16,33,19,32.00,11.50,239370,239386
3862,17,33,3,30.12,65.87,239385,239402
3863,15,61,25,34.13,55.85,239401,239416
3864,17,33,8,30.12,62.34,239415,239432
3865,15,52,31,34.13,23.05,239431,239446
3866,16,61,2,32.00,118.62,239445,239461
3867,17,33,4,30.12,64.69,239460,239477
3868,15,61,26,34.13,55.32,239476,239491
3869,16,43,7,32.00,47.50,239490,239506
3870,16,33,18,32.00,13.12,239505,239521
3871,16,61,1,32.00,121.00,239520,239536
3872,16,61,10,32.00,108.62,239535,239551
3873,16,33,23,32.00,7.50,239550,239566
3874,15,61,6,34.13,161.45,239565,239580
3875,17,33,5,30.12,63.75,239579,239596
3876,15,61,27,34.13,55.05,239595,239610
3877,17,33,6,30.12,63.04,239609,239626
3878,15,50,33,34.13,17.98,239625,239640
3879,15,61,22,34.13,59.05,239640,239655
3880,16,39,11,32.00,31.50,239654,239670
3881,16,33,22,32.00,8.12,239669,239685
3882,16,61,5,32.00,113.00,239684,239700
3883,16,34,16,32.00,17.12,239699,239715
3884,16,33,23,32.00,7.50,239714,239730
3885,16,61,10,32.00,108.62,239729,239745
3886,16,33,21,32.00,9.00,239744,239760
3887,16,61,4,32.00,114.62,239759,239775
3888,17,33,2,30.12,67.28,239774,239791
3889,15,61,24,34.13,56.65,239790,239805
3890,16,61,9,32.00,109.00,239804,239820
3891,16,33,20,32.00,10.12,239819,239835
3892,17,33,3,30.12,65.87,239834,239851
3893,16,33,19,32.00,11.50,239850,239866
3894,16,61,2,32.00,118.62,239865,239881
3895,16,61,9,32.00,109.00,239880,239896
3896,16,33,24,32.00,7.12,239895,239911
3897,15,61,7,34.13,159.58,239910,239925
3898,17,33,4,30.12,64.69,239924,239941
3899,16,33,21,32.00,9.00,239940,239956
3900,16,61,10,32.00,108.62,239955,239971
3901,16,33,23,32.00,7.50,239970,239986
3902,16,61,6,32.00,111.62,239985,240001
3903,16,33,17,32.00,15.00,240000,240016
3904,15,61,22,34.13,59.05,240016,240031
3905,16,61,11,32.00,108.50,240030,240046
3906,16,33,22,32.00,8.12,240045,240061
3907,16,61,5,32.00,113.00,240060,240076
3908,16,61,6,32.00,111.62,240075,240091
3909,16,33,23,32.00,7.50,240090,240106
3910,16,61,10,32.00,108.62,240105,240121
3911,16,33,21,32.00,9.00,240120,240136
3912,16,61,4,32.00,114.62,240135,240151
3913,16,61,7,32.00,110.50,240150,240166
3914,16,33,24,32.00,7.12,240165,240181
3915,16,61,9,32.00,109.00,240180,240196
3916,16,33,20,32.00,10.12,240195,240211
3917,16,33,19,32.00,11.50,240210,240226
3918,16,61,8,32.00,109.62,240225,240241
3919,15,61,25,34.13,55.85,240240,240255
3920,17,33,3,30.12,65.87,240254,240271
3921,16,61,3,32.00,116.50,240270,240286
3922,15,61,25,34.13,55.85,240285,240300
3923,17,33,8,30.12,62.34,240299,240316
3924,15,61,24,34.13,56.65,240315,240330
3925,16,61,2,32.00,118.62,240329,240345
3926,16,61,9,32.00,109.00,240344,240360
3927,15,61,24,34.13,56.65,240359,240374
3928,17,33,2,30.12,67.28,240373,240390
3929,16,33,18,32.00,13.12,240389,240405
3930,17,33,1,30.12,68.93,240404,240421
3931,16,33,17,32.00,15.00,240420,240436
3932,16,33,17,32.00,15.00,240436,240452
3933,17,33,1,30.12,68.93,240451,240468
3934,16,33,18,32.00,13.12,240467,240483
3935,16,61,7,32.00,110.50,240482,240498
3936,16,33,24,32.00,7.12,240497,240513
3937,17,33,8,30.12,62.34,240512,240529
3938,15,61,25,34.13,55.85,240528,240543
3939,17,33,3,30.12,65.87,240542,240559
3940,16,61,3,32.00,116.50,240558,240574
3941,15,61,25,34.13,55.85,240573,240588
3942,17,33,8,30.12,62.34,240587,240604
3943,15,61,24,34.13,56.65,240603,240618
3944,16,61,2,32.00,118.62,240617,240633
3945,16,61,9,32.00,109.00,240632,240648
3946,15,61,24,34.13,56.65,240647,240662
3947,17,33,2,30.12,67.28,240661,240678
3948,16,61,4,32.00,114.62,240677,240693
3949,16,33,21,32.00,9.00,240692,240708
3950,16,61,10,32.00,108.62,240707,240723
3951,15,61,23,34.13,57.72,240722,240737
3952,17,33,1,30.12,68.93,240736,240753
3953,16,61,5,32.00,113.00,240752,240768
3954,16,33,22,32.00,8.12,240767,240783
3955,16,61,11,32.00,108.50,240782,240798
3956,15,61,22,34.13,59.05,240797,240812
3957,16,33,17,32.00,15.00,240812,240828
3958,15,61,11,34.13,154.78,240827,240842
3959,16,33,22,32.00,8.12,240841,240857
3960,16,61,5,32.00,113.00,240856,240872
3961,17,33,1,30.12,68.93,240871,240888
3962,15,60,23,34.13,53.98,240887,240902
3963,16,61,10,32.00,108.62,240901,240917
3964,16,33,21,32.00,9.00,240916,240932
3965,16,61,4,32.00,114.62,240931,240947
3966,16,61,7,32.00,110.50,240946,240962
3967,16,33,24,32.00,7.12,240961,240977
3968,16,61,9,32.00,109.00,240976,240992
3969,16,61,2,32.00,118.62,240991,241007
3970,16,33,19,32.00,11.50,241006,241022
3971,16,61,8,32.00,109.62,241021,241037
3972,16,33,25,32.00,7.00,241036,241052
3973,16,61,8,32.00,109.62,241051,241067
3974,16,61,3,32.00,116.50,241066,241082
3975,16,33,20,32.00,10.12,241081,241097
3976,16,61,9,32.00,109.00,241096,241112
3977,15,61,24,34.13,56.65,241111,241126
3978,17,33,2,30.12,67.28,241125,241142
3979,16,61,4,32.00,114.62,241141,241157
3980,16,33,21,32.00,9.00,241156,241172
3981,16,61,10,32.00,108.62,241171,241187
3982,15,61,4,34.13,128.65,241186,241201
3983,15,61,26,34.13,55.32,241200,241215
3984,16,61,7,32.00,110.50,241214,241230
3985,16,33,18,32.00,13.12,241229,241245
3986,16,61,1,32.00,121.00,241244,241260
3987,16,61,10,32.00,108.62,241259,241275
3988,16,33,23,32.00,7.50,241274,241290
3989,17,33,6,30.12,63.04,241289,241306
3990,15,61,22,34.13,59.05,241305,241320
3991,15,61,22,34.13,59.05,241320,241335
3992,17,33,6,30.12,63.04,241334,241351
3993,15,61,27,34.13,55.05,241350,241365
3994,17,33,5,30.12,63.75,241364,241381
3995,16,33,21,32.00,9.00,241380,241396
3996,16,61,4,32.00,114.62,241395,241411
3997,17,33,2,30.12,67.28,241410,241427
3998,15,61,24,34.13,56.65,241426,241441
3999,16,37,13,32.00,25.00,241440,241456
4000,16,61,2,32.00,118.62,241455,241471
4001,16,33,19,32.00,11.50,241470,241486
4002,17,33,3,30.12,65.87,241485,241502
4003,16,33,20,32.00,10.12,241501,241517
4004,16,61,9,32.00,109.00,241516,241532
4005,15,61,24,34.13,56.65,241531,241546
4006,17,33,2,30.12,67.28,241545,241562
4007,16,33,18,32.00,13.12,241561,241577
4008,17,33,1,30.12,68.93,241576,241593
4009,16,61,5,32.00,113.00,241592,241608
4010,16,33,22,32.00,8.12,241607,241623
4011,16,61,11,32.00,108.50,241622,241638
4012,16,33,22,32.00,8.12,241637,241653
4013,16,61,5,32.00,113.00,241652,241668
4014,17,33,1,30.12,68.93,241667,241684
4015,15,61,23,34.13,57.72,241683,241698
4016,16,61,10,32.00,108.62,241697,241713
4017,16,33,21,32.00,9.00,241712,241728
4018,17,33,4,30.12,64.69,241727,241744
4019,16,33,20,32.00,10.12,241743,241759
4020,14,61,3,36.57,216.24,241758,241772
4021,17,33,3,30.12,65.87,241771,241788
4022,16,33,19,32.00,11.50,241787,241803
4023,17,33,2,30.12,67.28,241802,241819
4024,16,33,18,32.00,13.12,241818,241834
4025,17,33,1,30.12,68.93,241833,241850
4026,16,33,17,32.00,15.00,241849,241865
4027,16,33,17,32.00,15.00,241865,241881
4028,16,61,6,32.00,111.62,241880,241896
4029,16,33,23,32.00,7.50,241895,241911
4030,16,61,10,32.00,108.62,241910,241926
4031,16,33,21,32.00,9.00,241925,241941
4032,16,61,4,32.00,114.62,241940,241956
4033,16,61,7,32.00,110.50,241955,241971
4034,16,33,24,32.00,7.12,241970,241986
4035,16,37,13,32.00,25.00,241985,242001
4036,16,33,20,32.00,10.12,242000,242016
4037,16,61,3,32.00,116.50,242015,242031
4038,17,33,3,30.12,65.87,242030,242047
4039,15,61,25,34.13,55.85,242046,242061
4040,16,61,8,32.00,109.62,242060,242076
4041,16,33,19,32.00,11.50,242075,242091
4042,16,61,2,32.00,118.62,242090,242106
4043,17,33,4,30.12,64.69,242105,242122
4044,15,61,26,34.13,55.32,242121,242136
4045,17,33,7,30.12,62.57,242135,242152
4046,16,33,23,32.00,7.50,242151,242167
4047,16,61,6,32.00,111.62,242166,242182
4048,16,61,5,32.00,113.00,242181,242197
4049,15,61,27,34.13,55.05,242196,242211
4050,17,33,6,30.12,63.04,242210,242227
4051,15,61,22,34.13,59.05,242226,242241
4052,16,33,17,32.00,15.00,242241,242257
4053,16,61,6,32.00,111.62,242256,242272
4054,16,33,23,32.00,7.50,242271,242287
4055,16,61,10,32.00,108.62,242286,242302
4056,16,33,21,32.00,9.00,242301,242317
4057,16,61,4,32.00,114.62,242316,242332
4058,17,33,2,30.12,67.28,242331,242348
4059,16,33,19,32.00,11.50,242347,242363
4060,17,33,3,30.12,65.87,242362,242379
4061,16,33,20,32.00,10.12,242378,242394
4062,16,61,9,32.00,109.00,242393,242409
4063,15,61,24,34.13,56.65,242408,242423
4064,16,61,2,32.00,118.62,242422,242438
4065,17,33,4,30.12,64.69,242437,242454
4066,15,61,26,34.13,55.32,242453,242468
4067,17,33,7,30.12,62.57,242467,242484
4068,16,33,23,32.00,7.50,242483,242499
4069,16,61,6,32.00,111.62,242498,242514
4070,16,61,5,32.00,113.00,242513,242529
4071,16,33,22,32.00,8.12,242528,242544
4072,16,61,11,32.00,108.50,242543,242559
4073,15,61,22,34.13,59.05,242558,242573
4074,16,33,17,32.00,15.00,242573,242589
4075,16,61,6,32.00,111.62,242588,242604
4076,15,61,27,34.13,55.05,242603,242618
4077,17,33,5,30.12,63.75,242617,242634
4078,16,61,1,32.00,121.00,242633,242649
4079,15,61,23,34.13,57.72,242648,242663
4080,17,33,7,30.12,62.57,242662,242679
4081,15,61,26,34.13,55.32,242678,242693
4082,16,61,4,32.00,114.62,242692,242708
4083,17,33,2,30.12,67.28,242707,242724
4084,15,61,24,34.13,56.65,242723,242738
4085,16,61,9,32.00,109.00,242737,242753
4086,16,33,20,32.00,10.12,242752,242768
4087,17,33,3,30.12,65.87,242767,242784
4088,16,33,19,32.00,11.50,242783,242799
4089,17,33,2,30.12,67.28,242798,242815
4090,16,61,4,32.00,114.62,242814,242830
4091,16,33,21,32.00,9.00,242829,242845
4092,16,61,10,32.00,108.62,242844,242860
4093,16,33,23,32.00,7.50,242859,242875
4094,16,61,6,32.00,111.62,242874,242890
4095,16,61,5,32.00,113.00,242889,242905
4096,16,33,22,32.00,8.12,242904,242920
4097,17,33,6,30.12,63.04,242919,242936
4098,15,61,27,34.13,55.05,242935,242950
4099,16,61,5,32.00,113.00,242949,242965
4100,17,33,1,30.12,68.93,242964,242981
4101,15,61,23,34.13,57.72,242980,242995
4102,17,33,7,30.12,62.57,242994,243011
4103,16,33,24,32.00,7.12,243010,243026
4104,16,41,9,32.00,39.00,243025,243041
4105,15,61,7,34.13,159.58,243040,243055
4106,15,61,26,34.13,55.32,243054,243069
4107,17,33,4,30.12,64.69,243068,243085
4108,16,61,2,32.00,118.62,243084,243100
4109,16,33,19,32.00,11.50,243099,243115
4110,16,61,8,32.00,109.62,243114,243130
4111,15,61,25,34.13,55.85,243129,243144
4112,17,33,3,30.12,65.87,243143,243160
4113,16,61,3,32.00,116.50,243159,243175
4114,15,61,25,34.13,55.85,243174,243189
4115,17,33,8,30.12,62.34,243188,243205
4116,15,61,24,34.13,56.65,243204,243219
4117,16,61,2,32.00,118.62,243218,243234
4118,17,33,4,30.12,64.69,243233,243250
4119,15,61,26,34.13,55.32,243249,243264
4120,16,61,7,32.00,110.50,243263,243279
4121,16,61,4,32.00,114.62,243278,243294
4122,16,33,21,32.00,9.00,243293,243309
4123,17,33,5,30.12,63.75,243308,243325
4124,15,61,27,34.13,55.05,243324,243339
4125,17,33,6,30.12,63.04,243338,243355
4126,16,33,22,32.00,8.12,243354,243370
4127,17,33,5,30.12,63.75,243369,243386
4128,16,33,21,32.00,9.00,243385,243401
4129,17,33,4,30.12,64.69,243400,243417
4130,16,33,20,32.00,10.12,243416,243432
4131,17,33,3,30.12,65.87,243431,243448
4132,16,61,3,32.00,116.50,243447,243463
4133,16,33,20,32.00,10.12,243462,243478
4134,16,61,9,32.00,109.00,243477,243493
4135,15,61,24,34.13,56.65,243492,243507
4136,17,33,2,30.12,67.28,243506,243523
4137,16,61,4,32.00,114.62,243522,243538
4138,15,54,29,34.13,29.18,243537,243552
4139,17,33,7,30.12,62.57,243551,243568
4140,15,61,23,34.13,57.72,243567,243582
4141,17,33,1,30.12,68.93,243581,243598
4142,16,61,5,32.00,113.00,243597,243613
4143,16,33,22,32.00,8.12,243612,243628
4144,16,61,11,32.00,108.50,243627,243643
4145,16,33,22,32.00,8.12,243642,243658
4146,16,61,5,32.00,113.00,243657,243673
4147,16,61,6,32.00,111.62,243672,243688
4148,16,33,23,32.00,7.50,243687,243703
4149,16,61,10,32.00,108.62,243702,243718
4150,16,33,21,32.00,9.00,243717,243733
4151,16,61,4,32.00,114.62,243732,243748
4152,16,61,7,32.00,110.50,243747,243763
4153,16,33,24,32.00,7.12,243762,243778
4154,16,61,9,32.00,109.00,243777,243793
4155,16,33,20,32.00,10.12,243792,243808
4156,16,47,3,32.00,67.50,243807,243823
4157,16,61,8,32.00,109.62,243822,243838
4158,15,61,25,34.13,55.85,243837,243852
4159,17,33,3,30.12,65.87,243851,243868
4160,16,47,3,32.00,67.50,243867,243883
4161,15,61,25,34.13,55.85,243882,243897
4162,17,33,8,30.12,62.34,243896,243913
4163,15,61,24,34.13,56.65,243912,243927
4164,16,61,2,32.00,118.62,243926,243942
4165,17,33,4,30.12,64.69,243941,243958
4166,16,33,21,32.00,9.00,243957,243973
4167,16,61,10,32.00,108.62,243972,243988
4168,15,61,23,34.13,57.72,243987,244002
4169,16,61,1,32.00,121.00,244001,244017
4170,17,33,5,30.12,63.75,244016,244033
4171,15,61,27,34.13,55.05,244032,244047
4172,16,61,6,32.00,111.62,244046,244062
4173,16,61,5,32.00,113.00,244061,244077
4174,15,61,27,34.13,55.05,244076,244091
4175,17,33,6,30.12,63.04,244090,244107
4176,15,61,22,34.13,59.05,244106,244121
4177,15,50,33,34.13,17.98,244121,244136
4178,17,33,6,30.12,63.04,244135,244152
4179,15,61,27,34.13,55.05,244151,244166
4180,17,33,5,30.12,63.75,244165,244182
4181,16,61,1,32.00,121.00,244181,244197
4182,15,61,23,34.13,57.72,244196,244211
4183,17,33,7,30.12,62.57,244210,244227
4184,15,61,26,34.13,55.32,244226,244241
4185,17,33,4,30.12,64.69,244240,244257
4186,16,61,2,32.00,118.62,244256,244272
4187,15,61,24,34.13,56.65,244271,244286
4188,17,33,8,30.12,62.34,244285,244302
4189,15,61,25,34.13,55.85,244301,244316
4190,16,61,3,32.00,116.50,244315,244331
4191,17,33,3,30.12,65.87,244330,244347
4192,15,61,25,34.13,55.85,244346,244361
4193,16,61,8,32.00,109.62,244360,244376
4194,16,33,19,32.00,11.50,244375,244391
4195,17,33,2,30.12,67.28,244390,244407
4196,16,61,4,32.00,114.62,244406,244422
4197,15,61,26,34.13,55.32,244421,244436
4198,16,43,7,32.00,47.50,244435,244451
4199,16,33,18,32.00,13.12,244450,244466
4200,17,33,1,30.12,68.93,244465,244482
4201,16,33,17,32.00,15.00,244481,244497
4202,16,33,17,32.00,15.00,244497,244513
4203,16,34,16,32.00,17.12,244512,244528
4204,16,33,23,32.00,7.50,244527,244543
4205,16,40,10,32.00,35.12,244542,244558
4206,16,33,21,32.00,9.00,244557,244573
4207,16,61,4,32.00,114.62,244572,244588
4208,16,35,15,32.00,19.50,244587,244603
4209,16,33,24,32.00,7.12,244602,244618
4210,16,61,9,32.00,109.00,244617,244633
4211,16,33,20,32.00,10.12,244632,244648
4212,16,61,3,32.00,116.50,244647,244663
4213,16,61,8,32.00,109.62,244662,244678
4214,15,53,30,34.13,25.98,244677,244692
4215,16,61,3,32.00,116.50,244691,244707
4216,16,61,8,32.00,109.62,244706,244722
4217,16,33,25,32.00,7.00,244721,244737
4218,16,61,8,32.00,109.62,244736,244752
4219,16,61,3,32.00,116.50,244751,244767
4220,16,33,20,32.00,10.12,244766,244782
4221,16,61,9,32.00,109.00,244781,244797
4222,15,61,24,34.13,56.65,244796,244811
4223,16,61,2,32.00,118.62,244810,244826
4224,16,61,9,32.00,109.00,244825,244841
4225,16,33,24,32.00,7.12,244840,244856
4226,16,61,7,32.00,110.50,244855,244871
4227,16,61,4,32.00,114.62,244870,244886
4228,16,33,21,32.00,9.00,244885,244901
4229,16,61,10,32.00,108.62,244900,244916
4230,15,61,23,34.13,57.72,244915,244930
4231,17,33,1,30.12,68.93,244929,244946
4232,16,61,5,32.00,113.00,244945,244961
4233,15,61,27,34.13,55.05,244960,244975
4234,17,33,6,30.12,63.04,244974,244991
4235,15,61,22,34.13,59.05,244990,245005
4236,16,33,17,32.00,15.00,245005,245021
4237,16,61,6,32.00,111.62,245020,245036
4238,16,33,23,32.00,7.50,245035,245051
4239,17,33,7,30.12,62.57,245050,245067
4240,16,33,24,32.00,7.12,245066,245082
4241,17,33,8,30.12,62.34,245081,245098
4242,16,33,25,32.00,7.00,245097,245113
4243,16,61,8,32.00,109.62,245112,245128
4244,16,33,19,32.00,11.50,245127,245143
4245,16,61,2,32.00,118.62,245142,245158
4246,15,61,13,34.13,83.05,245157,245172
4247,16,33,19,32.00,11.50,245171,245187
4248,16,61,2,32.00,118.62,245186,245202
4249,16,61,9,32.00,109.00,245201,245217
4250,16,33,24,32.00,7.12,245216,245232
4251,16,61,7,32.00,110.50,245231,245247
4252,16,33,18,32.00,13.12,245246,245262
4253,16,61,1,32.00,121.00,245261,245277
4254,16,61,10,32.00,108.62,245276,245292
4255,16,33,23,32.00,7.50,245291,245307
4256,16,61,6,32.00,111.62,245306,245322
4257,16,33,17,32.00,15.00,245321,245337
4258,16,33,22,32.00,8.12,245336,245352
4259,16,61,11,32.00,108.50,245351,245367
4260,16,33,22,32.00,8.12,245366,245382
4261,16,33,17,32.00,15.00,245381,245397
4262,16,61,6,32.00,111.62,245396,245412
4263,15,61,27,34.13,55.05,245411,245426
4264,17,33,5,30.12,63.75,245425,245442
4265,16,61,1,32.00,121.00,245441,245457
4266,16,33,18,32.00,13.12,245456,245472
4267,16,61,7,32.00,110.50,245471,245487
4268,15,61,26,34.13,55.32,245486,245501
4269,17,33,4,30.12,64.69,245500,245517
4270,16,33,20,32.00,10.12,245516,245532
4271,16,61,3,32.00,116.50,245531,245547
4272,17,33,3,30.12,65.87,245546,245563
4273,15,61,25,34.13,55.85,245562,245577
4274,17,33,8,30.12,62.34,245576,245593
4275,15,61,24,34.13,56.65,245592,245607
4276,16,61,2,32.00,118.62,245606,245622
4277,17,33,4,30.12,64.69,245621,245638
4278,16,33,21,32.00,9.00,245637,245653
4279,17,33,5,30.12,63.75,245652,245669
4280,16,33,22,32.00,8.12,245668,245684
4281,17,33,6,30.12,63.04,245683,245700
4282,15,61,27,34.13,55.05,245699,245714
4283,17,33,5,30.12,63.75,245713,245730
4284,16,61,1,32.00,121.00,245729,245745
4285,16,33,18,32.00,13.12,245744,245760
4286,16,61,7,32.00,110.50,245759,245775
4287,16,33,24,32.00,7.12,245774,245790
4288,16,61,9,32.00,109.00,245789,245805
4289,16,33,20,32.00,10.12,245804,245820
4290,17,33,3,30.12,65.87,245819,245836
4291,16,33,19,32.00,11.50,245835,245851
4292,17,33,2,30.12,67.28,245850,245867
4293,16,33,18,32.00,13.12,245866,245882
4294,16,61,1,32.00,121.00,245881,245897
4295,17,33,5,30.12,63.75,245896,245913
4296,15,61,27,34.13,55.05,245912,245927
4297,16,61,6,32.00,111.62,245926,245942
4298,16,33,17,32.00,15.00,245941,245957
4299,16,33,17,32.00,15.00,245957,245973
4300,17,33,1,30.12,68.93,245972,245989
4301,13,61,32,39.38,140.24,245988,246001
4302,16,33,17,32.00,15.00,246001,246017
4303,17,33,1,30.12,68.93,246016,246033
4304,16,33,18,32.00,13.12,246032,246048
4305,17,33,2,30.12,67.28,246047,246064
4306,16,33,19,32.00,11.50,246063,246079
4307,16,61,8,32.00,109.62,246078,246094
4308,15,61,25,34.13,55.85,246093,246108
4309,17,33,3,30.12,65.87,246107,246124
4310,16,61,3,32.00,116.50,246123,246139
4311,15,61,25,34.13,55.85,246138,246153
4312,16,61,8,32.00,109.62,246152,246168
4313,16,33,19,32.00,11.50,246167,246183
4314,17,33,2,30.12,67.28,246182,246199
4315,16,61,4,32.00,114.62,246198,246214
4316,15,61,26,34.13,55.32,246213,246228
4317,17,33,7,30.12,62.57,246227,246244
4318,16,33,23,32.00,7.50,246243,246259
4319,17,33,6,30.12,63.04,246258,246275
4320,15,61,22,34.13,59.05,246274,246289
4321,16,33,17,32.00,15.00,246289,246305
4322,16,61,6,32.00,111.62,246304,246320
4323,16,33,23,32.00,7.50,246319,246335
4324,16,61,10,32.00,108.62,246334,246350
4325,16,33,21,32.00,9.00,246349,246365
4326,17,33,4,30.12,64.69,246364,246381
4327,16,33,20,32.00,10.12,246380,246396
4328,17,33,3,30.12,65.87,246395,246412
4329,16,33,19,32.00,11.50,246411,246427
4330,17,33,2,30.12,67.28,246426,246443
4331,16,33,18,32.00,13.12,246442,246458
4332,16,61,1,32.00,121.00,246457,246473
4333,16,38,12,32.00,28.12,246472,246488
4334,16,33,23,32.00,7.50,246487,246503
4335,16,44,6,32.00,52.12,246502,246518
4336,16,33,17,32.00,15.00,246517,246533
4337,15,61,22,34.13,59.05,246533,246548
4338,16,61,11,32.00,108.50,246547,246563
4339,16,33,22,32.00,8.12,246562,246578
4340,16,45,5,32.00,57.00,246577,246593
4341,17,33,1,30.12,68.93,246592,246609
4342,15,61,23,34.13,57.72,246608,246623
4343,17,33,10,30.12,54.46,246622,246639
4344,16,61,3,32.00,116.50,246638,246654
4345,17,33,3,30.12,65.87,246653,246670
4346,16,33,20,32.00,10.12,246669,246685
4347,17,33,4,30.12,64.69,246684,246701
4348,16,33,21,32.00,9.00,246700,246716
4349,17,33,5,30.12,63.75,246715,246732
4350,16,33,22,32.00,8.12,246731,246747
4351,17,33,6,30.12,63.04,246746,246763
4352,16,33,23,32.00,7.50,246762,246778
4353,17,33,7,30.12,62.57,246777,246794
4354,16,33,24,32.00,7.12,246793,246809
4355,17,33,8,30.12,62.34,246808,246825
4356,16,33,25,32.00,7.00,246824,246840
4357,17,33,8,30.12,62.34,246839,246856
4358,16,33,24,32.00,7.12,246855,246871
4359,17,33,7,30.12,62.57,246870,246887
4360,16,33,23,32.00,7.50,246886,246902
4361,17,33,6,30.12,63.04,246901,246918
4362,16,33,22,32.00,8.12,246917,246933
4363,17,33,5,30.12,63.75,246932,246949
4364,16,61,1,32.00,121.00,246948,246964
4365,16,33,18,32.00,13.12,246963,246979
4366,17,33,2,30.12,67.28,246978,246995
4367,16,33,19,32.00,11.50,246994,247010
4368,36,60,1,14.22,177.23,247009,247045
4369,16,33,22,32.00,8.12,247044,247060
4370,17,33,6,30.12,63.04,247059,247076
4371,16,33,23,32.00,7.50,247075,247091
4372,17,33,7,30.12,62.57,247090,247107
4373,16,33,24,32.00,7.12,247106,247122
4374,17,33,8,30.12,62.34,247121,247138
4375,16,33,25,32.00,7.00,247137,247153
4376,17,33,8,30.12,62.34,247152,247169
4377,16,33,24,32.00,7.12,247168,247184
4378,17,33,7,30.12,62.57,247183,247200
4379,16,33,23,32.00,7.50,247199,247215
4380,17,33,6,30.12,63.04,247214,247231
4381,16,33,22,32.00,8.12,247230,247246
4382,16,61,5,32.00,113.00,247245,247261
4383,17,33,1,30.12,68.93,247260,247277
4384,16,33,18,32.00,13.12,247276,247292
4385,17,33,2,30.12,67.28,247291,247308
4386,16,33,19,32.00,11.50,247307,247323
4387,17,33,3,30.12,65.87,247322,247339
4388,15,61,25,34.13,55.85,247338,247353
4389,17,33,8,30.12,62.34,247352,247369
4390,15,61,24,34.13,56.65,247368,247383
4391,17,33,2,30.12,67.28,247382,247399
4392,16,61,4,32.00,114.62,247398,247414
4393,14,61,29,36.57,100.67,247413,247427
4394,17,33,2,30.12,67.28,247426,247443
4395,16,33,18,32.00,13.12,247442,247458
4396,17,33,1,30.12,68.93,247457,247474
4397,16,61,5,32.00,113.00,247473,247489
4398,16,33,22,32.00,8.12,247488,247504
4399,16,61,11,32.00,108.50,247503,247519
4400,16,33,22,32.00,8.12,247518,247534
4401,16,61,5,32.00,113.00,247533,247549
4402,17,33,1,30.12,68.93,247548,247565
4403,15,61,23,34.13,57.72,247564,247579
4404,17,33,7,30.12,62.57,247578,247595
4405,16,33,24,32.00,7.12,247594,247610
4406,17,33,8,30.12,62.34,247609,247626
4407,15,61,25,34.13,55.85,247625,247640
4408,17,33,3,30.12,65.87,247639,247656
4409,16,61,3,32.00,116.50,247655,247671
4410,15,61,25,34.13,55.85,247670,247685
4411,17,33,8,30.12,62.34,247684,247701
4412,15,61,24,34.13,56.65,247700,247715
4413,16,48,2,32.00,73.12,247714,247730
4414,17,33,4,30.12,64.69,247729,247746
4415,15,61,26,34.13,55.32,247745,247760
4416,17,33,7,30.12,62.57,247759,247776
4417,15,61,23,34.13,57.72,247775,247790
4418,16,49,1,32.00,79.00,247789,247805
4419,17,33,5,30.12,63.75,247804,247821
4420,15,61,27,34.13,55.05,247820,247835
4421,17,33,6,30.12,63.04,247834,247851
4422,15,61,22,34.13,59.05,247850,247865
4423,15,61,22,34.13,59.05,247865,247880
4424,17,33,6,30.12,63.04,247879,247896
4425,15,61,27,34.13,55.05,247895,247910
4426,17,33,5,30.12,63.75,247909,247926
4427,15,61,6,34.13,161.45,247925,247940
4428,16,33,23,32.00,7.50,247939,247955
4429,16,38,12,32.00,28.12,247954,247970
4430,16,61,1,32.00,121.00,247969,247985
4431,15,61,23,34.13,57.72,247984,247999
4432,17,33,7,30.12,62.57,247998,248015
4433,15,61,26,34.13,55.32,248014,248029
4434,16,61,4,32.00,114.62,248028,248044
4435,17,33,2,30.12,67.28,248043,248060
4436,15,61,24,34.13,56.65,248059,248074
4437,17,33,8,30.12,62.34,248073,248090
4438,16,33,25,32.00,7.00,248089,248105
4439,17,33,8,30.12,62.34,248104,248121
4440,15,61,24,34.13,56.65,248120,248135
4441,16,61,2,32.00,118.62,248134,248150
4442,17,33,4,30.12,64.69,248149,248166
4443,15,61,26,34.13,55.32,248165,248180
4444,17,33,7,30.12,62.57,248179,248196
4445,15,51,32,34.13,20.38,248195,248210
4446,16,61,1,32.00,121.00,248209,248225
4447,16,38,12,32.00,28.12,248224,248240
4448,16,33,23,32.00,7.50,248239,248255
4449,16,61,6,32.00,111.62,248254,248270
4450,16,33,17,32.00,15.00,248269,248285
4451,15,61,22,34.13,59.05,248285,248300
4452,16,61,11,32.00,108.50,248299,248315
4453,16,33,22,32.00,8.12,248314,248330
4454,16,61,5,32.00,113.00,248329,248345
4455,15,61,16,34.13,72.65,248344,248359
4456,16,33,22,32.00,8.12,248358,248374
4457,16,61,5,32.00,113.00,248373,248389
4458,16,61,6,32.00,111.62,248388,248404
4459,16,33,23,32.00,7.50,248403,248419
4460,16,61,10,32.00,108.62,248418,248434
4461,16,61,1,32.00,121.00,248433,248449
4462,16,33,18,32.00,13.12,248448,248464
4463,16,61,7,32.00,110.50,248463,248479
4464,16,33,24,32.00,7.12,248478,248494
4465,17,33,8,30.12,62.34,248493,248510
4466,16,33,25,32.00,7.00,248509,248525
4467,16,61,8,32.00,109.62,248524,248540
4468,16,33,19,32.00,11.50,248539,248555
4469,17,33,2,30.12,67.28,248554,248571
4470,16,33,18,32.00,13.12,248570,248586
4471,17,33,1,30.12,68.93,248585,248602
4472,16,33,17,32.00,15.00,248601,248617
4473,15,61,22,34.13,59.05,248617,248632
4474,16,61,11,32.00,108.50,248631,248647
4475,16,36,22,32.00,11.12,248646,248662
4476,16,61,8,32.00,109.62,248661,248677
4477,16,33,19,32.00,11.50,248676,248692
4478,16,61,2,32.00,118.62,248691,248707
4479,16,61,9,32.00,109.00,248706,248722
4480,16,33,24,32.00,7.12,248721,248737
4481,16,35,15,32.00,19.50,248736,248752
4482,16,61,4,32.00,114.62,248751,248767
4483,15,61,26,34.13,55.32,248766,248781
4484,17,33,7,30.12,62.57,248780,248797
4485,15,61,23,34.13,57.72,248796,248811
4486,17,33,1,30.12,68.93,248810,248827
4487,16,45,5,32.00,57.00,248826,248842
4488,15,61,27,34.13,55.05,248841,248856
4489,17,33,6,30.12,63.04,248855,248872
4490,15,61,22,34.13,59.05,248871,248886
4491,15,61,22,34.13,59.05,248886,248901
4492,17,33,6,30.12,63.04,248900,248917
4493,15,61,27,34.13,55.05,248916,248931
4494,17,33,5,30.12,63.75,248930,248947
4495,16,49,1,32.00,79.00,248946,248962
4496,15,61,23,34.13,57.72,248961,248976
4497,17,33,7,30.12,62.57,248975,248992
4498,15,61,26,34.13,55.32,248991,249006
4499,16,61,4,32.00,114.62,249005,249021
4500,17,33,2,30.12,67.28,249020,249037
4501,15,61,24,34.13,56.65,249036,249051
4502,16,61,9,32.00,109.00,249050,249066
4503,16,33,20,32.00,10.12,249065,249081
4504,16,61,3,32.00,116.50,249080,249096
4505,16,36,14,32.00,22.12,249095,249111
4506,16,33,25,32.00,7.00,249110,249126
4507,16,61,8,32.00,109.62,249125,249141
4508,16,33,19,32.00,11.50,249140,249156
4509,16,61,2,32.00,118.62,249155,249171
4510,16,61,9,32.00,109.00,249170,249186
4511,16,33,24,32.00,7.12,249185,249201
4512,16,61,7,32.00,110.50,249200,249216
4513,16,33,18,32.00,13.12,249215,249231
4514,16,61,1,32.00,121.00,249230,249246
4515,16,61,10,32.00,108.62,249245,249261
4516,15,61,23,34.13,57.72,249260,249275
4517,17,33,1,30.12,68.93,249274,249291
4518,16,61,5,32.00,113.00,249290,249306
4519,16,33,22,32.00,8.12,249305,249321
4520,16,61,11,32.00,108.50,249320,249336
4521,16,33,22,32.00,8.12,249335,249351
4522,17,33,5,30.12,63.75,249350,249367
4523,16,33,21,32.00,9.00,249366,249382
4524,14,61,4,36.57,217.10,249381,249395
4525,17,33,5,30.12,63.75,249394,249411
4526,16,33,21,32.00,9.00,249410,249426
4527,17,33,4,30.12,64.69,249425,249442
4528,16,33,20,32.00,10.12,249441,249457
4529,16,61,3,32.00,116.50,249456,249472
4530,16,61,8,32.00,109.62,249471,249487
4531,16,33,25,32.00,7.00,249486,249502
4532,16,61,8,32.00,109.62,249501,249517
4533,16,33,19,32.00,11.50,249516,249532
4534,16,33,20,32.00,10.12,249531,249547
4535,16,61,9,32.00,109.00,249546,249562
4536,16,33,24,32.00,7.12,249561,249577
4537,16,61,7,32.00,110.50,249576,249592
4538,16,61,4,32.00,114.62,249591,249607
4539,16,33,21,32.00,9.00,249606,249622
4540,16,61,10,32.00,108.62,249621,249637
4541,16,33,23,32.00,7.50,249636,249652
4542,16,61,6,32.00,111.62,249651,249667
4543,16,33,17,32.00,15.00,249666,249682
4544,15,50,33,34.13,17.98,249682,249697
4545,17,33,6,30.12,63.04,249696,249713
4546,15,61,27,34.13,55.05,249712,249727
4547,16,61,5,32.00,113.00,249726,249742
4548,17,33,1,30.12,68.93,249741,249758
4549,16,33,18,32.00,13.12,249757,249773
4550,17,33,2,30.12,67.28,249772,249789
4551,15,61,24,34.13,56.65,249788,249803
4552,16,61,9,32.00,109.00,249802,249818
4553,16,33,20,32.00,10.12,249817,249833
4554,16,61,3,32.00,116.50,249832,249848
4555,16,61,8,32.00,109.62,249847,249863
4556,15,61,25,34.13,55.85,249862,249877
4557,16,61,3,32.00,116.50,249876,249892
4558,17,33,3,30.12,65.87,249891,249908
4559,15,61,25,34.13,55.85,249907,249922
4560,17,33,8,30.12,62.34,249921,249938
4561,15,61,24,34.13,56.65,249937,249952
4562,17,33,2,30.12,67.28,249951,249968
4563,16,61,4,32.00,114.62,249967,249983
4564,16,33,21,32.00,9.00,249982,249998
4565,16,61,10,32.00,108.62,249997,250013
4566,15,61,23,34.13,57.72,250012,250027
4567,17,33,1,30.12,68.93,250026,250043
4568,16,33,17,32.00,15.00,250042,250058
4569,16,33,17,32.00,15.00,250058,250074
4570,17,33,1,30.12,68.93,250073,250090
4571,15,61,23,34.13,57.72,250089,250104
4572,17,33,7,30.12,62.57,250103,250120
4573,15,61,26,34.13,55.32,250119,250134
4574,16,61,4,32.00,114.62,250133,250149
4575,16,35,15,32.00,19.50,250148,250164
4576,15,61,26,34.13,55.32,250163,250178
4577,17,33,4,30.12,64.69,250177,250194
4578,16,33,20,32.00,10.12,250193,250209
4579,16,61,3,32.00,116.50,250208,250224
4580,16,61,8,32.00,109.62,250223,250239
4581,16,33,25,32.00,7.00,250238,250254
4582,16,61,8,32.00,109.62,250253,250269
4583,16,33,19,32.00,11.50,250268,250284
4584,16,61,2,32.00,118.62,250283,250299
4585,16,61,9,32.00,109.00,250298,250314
4586,16,33,24,32.00,7.12,250313,250329
4587,17,33,7,30.12,62.57,250328,250345
4588,15,61,23,34.13,57.72,250344,250359
4589,16,61,1,32.00,121.00,250358,250374
4590,16,61,10,32.00,108.62,250373,250389
4591,16,33,23,32.00,7.50,250388,250404
4592,17,33,6,30.12,63.04,250403,250420
4593,15,61,22,34.13,59.05,250419,250434
4594,16,33,17,32.00,15.00,250434,250450
4595,16,61,6,32.00,111.62,250449,250465
4596,16,33,23,32.00,7.50,250464,250480
4597,17,33,7,30.12,62.57,250479,250496
4598,16,33,24,32.00,7.12,250495,250511
4599,14,61,9,36.57,203.53,250510,250524
4600,17,33,7,30.12,62.57,250523,250540
4601,16,33,24,32.00,7.12,250539,250555
4602,16,61,9,32.00,109.00,250554,250570
4603,16,61,2,32.00,118.62,250569,250585
4604,16,33,19,32.00,11.50,250584,250600
4605,16,61,8,32.00,109.62,250599,250615
4606,16,33,25,32.00,7.00,250614,250630
4607,16,61,8,32.00,109.62,250629,250645
4608,16,61,3,32.00,116.50,250644,250660
4609,16,33,20,32.00,10.12,250659,250675
4610,16,61,9,32.00,109.00,250674,250690
4611,15,59,24,34.13,49.18,250689,250704
4612,17,33,2,30.12,67.28,250703,250720
4613,16,61,4,32.00,114.62,250719,250735
4614,16,33,21,32.00,9.00,250734,250750
4615,16,40,10,32.00,35.12,250749,250765
4616,15,61,23,34.13,57.72,250764,250779
4617,17,33,1,30.12,68.93,250778,250795
4618,16,61,5,32.00,113.00,250794,250810
4619,15,61,27,34.13,55.05,250809,250824
4620,17,33,6,30.12,63.04,250823,250840
4621,15,61,22,34.13,59.05,250839,250854
4622,15,61,22,34.13,59.05,250854,250869
4623,17,33,6,30.12,63.04,250868,250885
4624,15,61,27,34.13,55.05,250884,250899
4625,17,33,5,30.12,63.75,250898,250915
4626,16,61,1,32.00,121.00,250914,250930
4627,15,61,23,34.13,57.72,250929,250944
4628,16,61,10,32.00,108.62,250943,250959
4629,16,61,1,32.00,121.00,250958,250974
4630,16,33,18,32.00,13.12,250973,250989
4631,16,61,7,32.00,110.50,250988,251004
4632,15,61,26,34.13,55.32,251003,251018
4633,17,33,4,30.12,64.69,251017,251034
4634,16,61,2,32.00,118.62,251033,251049
4635,15,52,31,34.13,23.05,251048,251063
4636,17,33,8,30.12,62.34,251062,251079
4637,15,61,25,34.13,55.85,251078,251093
4638,16,61,3,32.00,116.50,251092,251108
4639,17,33,3,30.12,65.87,251107,251124
4640,15,61,25,34.13,55.85,251123,251138
4641,16,42,8,32.00,43.12,251137,251153
4642,16,33,19,32.00,11.50,251152,251168
4643,16,61,2,32.00,118.62,251167,251183
4644,16,61,9,32.00,109.00,251182,251198
4645,16,33,24,32.00,7.12,251197,251213
4646,16,61,7,32.00,110.50,251212,251228
4647,16,61,4,32.00,114.62,251227,251243
4648,16,33,21,32.00,9.00,251242,251258
4649,16,61,10,32.00,108.62,251257,251273
4650,15,61,23,34.13,57.72,251272,251287
4651,17,33,1,30.12,68.93,251286,251303
4652,16,61,5,32.00,113.00,251302,251318
4653,15,61,27,34.13,55.05,251317,251332
4654,17,33,6,30.12,63.04,251331,251348
4655,15,61,22,34.13,59.05,251347,251362
4656,15,61,22,34.13,59.05,251362,251377
4657,17,33,6,30.12,63.04,251376,251393
4658,15,61,27,34.13,55.05,251392,251407
4659,17,33,5,30.12,63.75,251406,251423
4660,16,61,1,32.00,121.00,251422,251438
4661,15,61,23,34.13,57.72,251437,251452
4662,17,33,7,30.12,62.57,251451,251468
4663,15,61,26,34.13,55.32,251467,251482
4664,17,33,4,30.12,64.69,251481,251498
4665,16,61,2,32.00,118.62,251497,251513
4666,15,61,24,34.13,56.65,251512,251527
4667,17,33,8,30.12,62.34,251526,251543
4668,15,61,25,34.13,55.85,251542,251557
4669,16,61,3,32.00,116.50,251556,251572
4670,16,61,8,32.00,109.62,251571,251587
4671,15,61,25,34.13,55.85,251586,251601
4672,17,33,3,30.12,65.87,251600,251617
4673,16,61,3,32.00,116.50,251616,251632
4674,15,61,25,34.13,55.85,251631,251646
4675,16,61,8,32.00,109.62,251645,251661
4676,16,33,19,32.00,11.50,251660,251676
4677,16,61,2,32.00,118.62,251675,251691
4678,16,61,9,32.00,109.00,251690,251706
4679,15,61,24,34.13,56.65,251705,251720
4680,17,33,2,30.12,67.28,251719,251736
4681,16,61,4,32.00,114.62,251735,251751
4682,15,61,26,34.13,55.32,251750,251765
4683,17,33,7,30.12,62.57,251764,251781
4684,15,61,23,34.13,57.72,251780,251795
4685,16,61,1,32.00,121.00,251794,251810
4686,17,33,5,30.12,63.75,251809,251826
4687,15,61,27,34.13,55.05,251825,251840
4688,17,33,6,30.12,63.04,251839,251856
4689,15,61,22,34.13,59.05,251855,251870
4690,15,61,22,34.13,59.05,251870,251885
4691,17,33,6,30.12,63.04,251884,251901
4692,15,61,27,34.13,55.05,251900,251915
4693,16,61,5,32.00,113.00,251914,251930
4694,17,33,1,30.12,68.93,251929,251946
4695,15,61,23,34.13,57.72,251945,251960
4696,16,61,10,32.00,108.62,251959,251975
4697,16,33,21,32.00,9.00,251974,251990
4698,16,61,4,32.00,114.62,251989,252005
4699,16,61,7,32.00,110.50,252004,252020
4700,16,33,24,32.00,7.12,252019,252035
4701,16,61,9,32.00,109.00,252034,252050
4702,16,33,20,32.00,10.12,252049,252065
4703,16,61,3,32.00,116.50,252064,252080
4704,16,61,8,32.00,109.62,252079,252095
4705,16,33,25,32.00,7.00,252094,252110
4706,16,61,8,32.00,109.62,252109,252125
4707,16,33,19,32.00,11.50,252124,252140
4708,16,33,20,32.00,10.12,252139,252155
4709,16,61,9,32.00,109.00,252154,252170
4710,15,59,24,34.13,49.18,252169,252184
4711,17,33,2,30.12,67.28,252183,252200
4712,16,61,4,32.00,114.62,252199,252215
4713,16,33,21,32.00,9.00,252214,252230
4714,16,61,10,32.00,108.62,252229,252245
4715,15,61,23,34.13,57.72,252244,252259
4716,17,33,1,30.12,68.93,252258,252275
4717,16,61,5,32.00,113.00,252274,252290
4718,15,61,27,34.13,55.05,252289,252304
4719,17,33,6,30.12,63.04,252303,252320
4720,15,61,22,34.13,59.05,252319,252334
4721,16,33,17,32.00,15.00,252334,252350
4722,16,44,6,32.00,52.12,252349,252365
4723,15,61,27,34.13,55.05,252364,252379
4724,17,33,5,30.12,63.75,252378,252395
4725,15,49,33,34.13,15.85,252394,252409
4726,16,33,23,32.00,7.50,252408,252424
4727,17,33,7,30.12,62.57,252423,252440
4728,15,61,26,34.13,55.32,252439,252454
4729,16,61,4,32.00,114.62,252453,252469
4730,16,61,7,32.00,110.50,252468,252484
4731,16,33,24,32.00,7.12,252483,252499
4732,16,61,9,32.00,109.00,252498,252514
4733,16,61,2,32.00,118.62,252513,252529
4734,16,33,19,32.00,11.50,252528,252544
4735,16,61,8,32.00,109.62,252543,252559
4736,15,61,25,34.13,55.85,252558,252573
4737,17,33,3,30.12,65.87,252572,252589
4738,16,61,3,32.00,116.50,252588,252604
4739,15,61,25,34.13,55.85,252603,252618
4740,17,33,8,30.12,62.34,252617,252634
4741,15,61,24,34.13,56.65,252633,252648
4742,16,61,2,32.00,118.62,252647,252663
4743,17,33,4,30.12,64.69,252662,252679
4744,15,61,26,34.13,55.32,252678,252693
4745,17,33,7,30.12,62.57,252692,252709
4746,15,61,23,34.13,57.72,252708,252723
4747,16,61,1,32.00,121.00,252722,252738
4748,16,61,10,32.00,108.62,252737,252753
4749,16,33,23,32.00,7.50,252752,252768
4750,16,61,6,32.00,111.62,252767,252783
4751,16,33,17,32.00,15.00,252782,252798
4752,16,33,17,32.00,15.00,252798,252814
4753,17,33,1,30.12,68.93,252813,252830
4754,15,61,23,34.13,57.72,252829,252844
4755,17,33,7,30.12,62.57,252843,252860
4756,15,61,1,34.13,174.78,252859,252874
4757,16,33,18,32.00,13.12,252873,252889
4758,16,43,7,32.00,47.50,252888,252904
4759,15,61,26,34.13,55.32,252903,252918
4760,17,33,4,30.12,64.69,252917,252934
4761,16,61,2,32.00,118.62,252933,252949
4762,15,61,24,34.13,56.65,252948,252963
4763,17,33,8,30.12,62.34,252962,252979
4764,15,61,25,34.13,55.85,252978,252993
4765,16,61,3,32.00,116.50,252992,253008
4766,16,61,8,32.00,109.62,253007,253023
4767,15,61,25,34.13,55.85,253022,253037
4768,16,61,3,32.00,116.50,253036,253052
4769,17,33,3,30.12,65.87,253051,253068
4770,15,58,25,34.13,44.65,253067,253082
4771,16,61,8,32.00,109.62,253081,253097
4772,16,33,19,32.00,11.50,253096,253112
4773,16,61,2,32.00,118.62,253111,253127
4774,16,61,9,32.00,109.00,253126,253142
4775,16,33,24,32.00,7.12,253141,253157
4776,16,61,7,32.00,110.50,253156,253172
4777,16,61,4,32.00,114.62,253171,253187
4778,16,33,21,32.00,9.00,253186,253202
4779,16,61,10,32.00,108.62,253201,253217
4780,16,33,23,32.00,7.50,253216,253232
4781,16,61,6,32.00,111.62,253231,253247
4782,16,61,5,32.00,113.00,253246,253262
4783,15,61,27,34.13,55.05,253261,253276
4784,16,61,6,32.00,111.62,253275,253291
4785,16,33,17,32.00,15.00,253290,253306
4786,15,61,22,34.13,59.05,253306,253321
4787,16,61,11,32.00,108.50,253320,253336
4788,16,33,22,32.00,8.12,253335,253351
4789,16,61,5,32.00,113.00,253350,253366
4790,16,61,6,32.00,111.62,253365,253381
4791,16,33,23,32.00,7.50,253380,253396
4792,16,61,10,32.00,108.62,253395,253411
4793,16,61,1,32.00,121.00,253410,253426
4794,16,33,18,32.00,13.12,253425,253441
4795,16,61,7,32.00,110.50,253440,253456
4796,16,33,24,32.00,7.12,253455,253471
4797,16,61,9,32.00,109.00,253470,253486
4798,16,33,20,32.00,10.12,253485,253501
4799,16,33,19,32.00,11.50,253500,253516
4800,16,61,8,32.00,109.62,253515,253531
4801,16,33,25,32.00,7.00,253530,253546
4802,16,61,8,32.00,109.62,253545,253561
4803,16,61,3,32.00,116.50,253560,253576
4804,16,33,20,32.00,10.12,253575,253591
4805,16,61,9,32.00,109.00,253590,253606
4806,15,61,24,34.13,56.65,253605,253620
4807,17,33,2,30.12,67.28,253619,253636
4808,16,61,4,32.00,114.62,253635,253651
4809,15,54,29,34.13,29.18,253650,253665
4810,17,33,7,30.12,62.57,253664,253681
4811,15,61,23,34.13,57.72,253680,253695
4812,16,49,1,32.00,79.00,253694,253710
4813,17,33,5,30.12,63.75,253709,253726
4814,15,61,27,34.13,55.05,253725,253740
4815,17,33,6,30.12,63.04,253739,253756
4816,15,61,22,34.13,59.05,253755,253770
4817,15,61,22,34.13,59.05,253770,253785
4818,17,33,6,30.12,63.04,253784,253801
4819,15,61,27,34.13,55.05,253800,253815
4820,16,61,5,32.00,113.00,253814,253830
4821,17,33,1,30.12,68.93,253829,253846
4822,15,61,23,34.13,57.72,253845,253860
4823,16,61,10,32.00,108.62,253859,253875
4824,16,33,21,32.00,9.00,253874,253890
4825,16,61,4,32.00,114.62,253889,253905
4826,16,61,7,32.00,110.50,253904,253920
4827,16,33,24,32.00,7.12,253919,253935
4828,16,61,9,32.00,109.00,253934,253950
4829,16,61,2,32.00,118.62,253949,253965
4830,16,33,19,32.00,11.50,253964,253980
4831,16,61,8,32.00,109.62,253979,253995
4832,16,33,25,32.00,7.00,253994,254010
4833,16,36,14,32.00,22.12,254009,254025
4834,16,61,3,32.00,116.50,254024,254040
4835,15,61,25,34.13,55.85,254039,254054
4836,17,33,8,30.12,62.34,254053,254070
4837,15,61,24,34.13,56.65,254069,254084
4838,17,33,2,30.12,67.28,254083,254100
4839,16,61,4,32.00,114.62,254099,254115
4840,15,61,26,34.13,55.32,254114,254129
4841,17,33,7,30.12,62.57,254128,254145
4842,15,61,23,34.13,57.72,254144,254159
4843,16,61,1,32.00,121.00,254158,254174
4844,17,33,5,30.12,63.75,254173,254190
4845,15,61,27,34.13,55.05,254189,254204
4846,16,61,6,32.00,111.62,254203,254219
4847,16,33,17,32.00,15.00,254218,254234
4848,16,33,17,32.00,15.00,254234,254250
4849,144,17,0,3.56,16.84,254249,254393
4850,59,18,2,8.68,4.32,254392,254451
4851,45,55,7,11.38,62.24,254450,254495
4852,56,30,0,9.14,126.30,254494,254550
4853,25,51,14,20.48,50.09,254549,254574
4854,30,35,1,17.07,41.53,254573,254603
4855,29,26,4,17.66,27.33,254602,254631
4856,28,36,15,18.29,31.78,254630,254658
4857,33,46,6,15.52,32.07,254657,254690
4858,33,45,8,15.52,29.58,254689,254722
4859,35,15,7,14.63,2.40,254721,254756
4860,31,46,5,16.52,53.73,254755,254786
4861,33,45,5,15.52,30.31,254785,254818
4862,33,45,3,15.52,31.40,254817,254850
4863,33,46,1,15.52,34.80,254849,254882
4864,33,45,2,15.52,32.13,254882,254915
4865,30,55,13,17.07,55.00,254914,254944
4866,33,46,6,15.52,32.43,254943,254976
4867,33,46,6,15.52,32.07,254975,255008
4868,35,15,5,14.63,2.80,255007,255042
4869,23,46,0,22.26,59.50,255041,255064
4870,26,36,6,19.69,21.98,255063,255089
4871,25,27,1,20.48,45.37,255088,255113
4872,162,24,0,3.16,30.31,255112,255274
4873,212,52,0,2.42,34.82,255274,255486
4874,280,55,0,1.83,24.61,255486,255766
4875,353,71,0,1.45,41.99,255765,256118
4876,259,71,0,1.98,35.57,256118,256377
4877,92,16,0,5.57,20.27,256376,256468
4878,44,25,0,11.64,32.64,256467,256511
4879,37,25,4,13.84,13.33,256510,256547
4880,135,33,0,3.79,23.51,256546,256681
4881,224,77,0,2.29,31.98,256680,256904
4882,196,97,0,2.61,55.43,256903,257099
4883,47,21,3,10.89,9.29,257098,257145
4884,47,17,0,10.89,8.48,257144,257191
4885,51,17,0,10.04,10.47,257190,257241
4886,46,21,5,11.13,9.42,257240,257286
4887,87,21,0,5.89,27.18,257285,257372
4888,130,77,0,3.94,62.00,257371,257501
4889,274,157,0,1.87,99.26,257500,257774
4890,52,17,0,9.85,57.25,257774,257826
4891,188,31,0,2.72,20.79,257825,258013
4892,136,17,0,3.76,15.56,258012,258148
4893,49,118,7,10.45,246.98,258148,258197
4894,57,118,0,8.98,584.72,258196,258253
4895,93,35,0,5.51,22.62,258252,258345
4896,10,126,4,51.20,3001.56,258344,258354
4897,152,8,0,3.37,14.02,258353,258505
4898,48,75,0,10.67,186.22,258504,258552
4899,70,75,0,7.31,149.50,258551,258621
4900,114,9,0,4.49,13.58,258620,258734
4901,57,69,0,8.98,284.86,258733,258790
4902,155,33,0,3.30,34.66,258789,258944
4903,89,8,0,5.75,5.11,258943,259032
4904,80,9,6,6.40,0.34,259032,259112
4905,81,9,4,6.32,0.46,259112,259193
4906,78,9,2,6.56,0.71,259192,259270
4907,80,10,1,6.40,1.02,259269,259349
4908,78,8,2,6.56,0.66,259348,259426
4909,80,8,2,6.40,0.69,259425,259505
4910,45,229,5,11.38,1076.77,259504,259549
4911,2,466,46,256.00,44100.00,259548,259550
4912,1,512,512,512.00,0.00,259549,259550
4913,2,375,137,256.00,14161.00,259549,259551
4914,2,320,192,256.00,4096.00,259550,259552
4915,3,503,2,170.67,55226.89,259551,259554
4916,84,9,0,6.10,2.61,259553,259637
4917,101,13,0,5.07,13.25,259636,259737
4918,61,81,0,8.39,91.94,259736,259797
4919,2,267,245,256.00,121.00,259796,259798
4920,3,326,59,170.67,12834.89,259797,259800
4921,41,199,5,12.49,870.05,259799,259840
4922,71,10,0,7.21,4.84,259839,259910
4923,76,9,0,6.74,6.33,259909,259985
4924,82,10,0,6.24,9.18,259984,260066
4925,65,10,0,7.88,6.45,260065,260130
4926,63,10,0,8.13,5.22,260129,260192
4927,65,10,0,7.88,3.52,260191,260256
4928,63,11,0,8.13,3.83,260255,260318
4929,54,60,1,9.48,49.88,260317,260371
4930,2,282,230,256.00,676.00,260370,260372
4931,3,342,58,170.67,15163.56,260371,260374
4932,29,284,0,17.66,2538.29,260373,260402
4933,65,10,0,7.88,2.51,260401,260466
4934,63,11,0,8.13,3.70,260465,260528
4935,63,10,0,8.13,2.62,260527,260590
4936,16,383,4,32.00,8215.62,260589,260605
4937,1,512,512,512.00,0.00,260604,260605
4938,2,379,133,256.00,15129.00,260604,260606
4939,1,512,512,512.00,0.00,260605,260606
4940,1,512,512,512.00,0.00,260605,260606
4941,2,395,117,256.00,19321.00,260605,260607
4942,1,512,512,512.00,0.00,260606,260607
4943,2,367,145,256.00,12321.00,260606,260608
4944,1,512,512,512.00,0.00,260607,260608
4945,1,512,512,512.00,0.00,260607,260608
4946,46,105,3,11.13,196.81,260607,260653
4947,57,11,6,8.98,0.61,260652,260709
4948,59,10,4,8.68,1.71,260708,260767
4949,63,11,0,8.13,5.22,260766,260829
4950,58,12,1,8.83,1.80,260828,260886
4951,62,10,0,8.26,2.09,260885,260947
4952,61,10,0,8.39,3.91,260946,261007
4953,59,13,0,8.68,4.29,261006,261065
4954,66,11,0,7.76,3.34,261065,261131
4955,66,10,0,7.76,3.58,261131,261197
4956,65,10,0,7.88,6.35,261196,261261
4957,67,11,0,7.64,7.01,261260,261327
4958,64,12,0,8.00,4.44,261326,261390
4959,70,10,0,7.31,3.53,261390,261460
4960,70,10,0,7.31,4.56,261459,261529
4961,69,10,1,7.42,3.43,261528,261597
4962,65,11,2,7.88,0.97,261596,261661
4963,65,11,0,7.88,4.23,261661,261726
4964,73,10,0,7.01,2.62,261725,261798
4965,76,9,0,6.74,6.14,261797,261873
4966,73,9,0,7.01,6.10,261872,261945
4967,80,9,0,6.40,6.39,261944,262024
4968,71,10,0,7.21,3.10,262024,262095
4969,72,11,0,7.11,5.93,262094,262166
4970,75,10,0,6.83,6.94,262165,262240
4971,78,10,0,6.56,5.91,262239,262317
4972,73,10,0,7.01,3.19,262316,262389
4973,72,11,0,7.11,4.10,262388,262460
4974,67,10,0,7.64,3.24,262459,262526
4975,70,9,0,7.31,3.10,262525,262595
4976,73,9,3,7.01,0.73,262594,262667
4977,72,9,0,7.11,2.54,262666,262738
4978,17,396,6,30.12,8367.28,262737,262754
4979,1,512,512,512.00,0.00,262753,262754
4980,2,330,182,256.00,5476.00,262753,262755
4981,1,512,512,512.00,0.00,262754,262755
4982,1,512,512,512.00,0.00,262754,262755
4983,2,480,32,256.00,50176.00,262754,262756
4984,1,512,512,512.00,0.00,262755,262756
4985,2,266,246,256.00,100.00,262755,262757
4986,1,512,512,512.00,0.00,262756,262757
4987,7,460,7,73.14,24945.27,262756,262763
4988,67,10,0,7.64,2.05,262763,262830
4989,69,11,0,7.42,4.94,262829,262898
4990,78,12,0,6.56,10.73,262897,262975
4991,72,11,0,7.11,5.24,262974,263046
4992,71,34,0,7.21,13.01,263045,263116
4993,70,32,0,7.31,11.87,263115,263185
4994,77,9,1,6.65,3.42,263184,263261
4995,3,501,3,170.67,54564.22,263260,263263
4996,2,319,193,256.00,3969.00,263262,263264
4997,2,375,137,256.00,14161.00,263263,263265
4998,1,512,512,512.00,0.00,263264,263265
4999,2,467,45,256.00,44521.00,263264,263266
5000,39,227,7,13.13,1204.11,263265,263304
5001,69,9,6,7.42,0.30,263304,263373
5002,71,9,2,7.21,1.04,263373,263444
5003,70,10,0,7.31,2.53,263443,263513
5004,69,9,1,7.42,1.43,263512,263581
5005,68,10,2,7.53,0.96,263580,263648
5006,67,10,2,7.64,1.07,263647,263714
5007,87,15,0,5.89,9.94,263713,263800
5008,66,84,2,7.76,91.09,263799,263865
5009,42,157,4,12.19,614.44,263864,263906
5010,158,36,0,3.24,19.13,263905,264063
5011,61,24,0,8.39,41.48,264062,264123
5012,58,30,0,8.83,44.52,264122,264180
5013,53,25,0,9.66,69.70,264179,264232
5014,219,37,0,2.34,34.06,264231,264450
5015,152,16,0,3.37,14.30,264450,264602
5016,185,46,0,2.77,33.36,264602,264787
5017,152,28,0,3.37,27.05,264787,264939
5018,222,23,0,2.31,8.74,264938,265160
5019,73,56,3,7.01,68.56,265159,265232
5020,70,56,1,7.31,71.04,265231,265301
5021,79,56,4,6.48,64.63,265301,265380
5022,61,56,4,8.39,117.81,265380,265441
5023,62,56,2,8.26,116.77,265440,265502
5024,65,56,4,7.88,77.49,265502,265567
5025,67,56,2,7.64,90.11,265566,265633
5026,69,56,4,7.42,86.24,265632,265701
5027,55,56,4,9.31,171.05,265700,265755
5028,72,54,4,7.11,43.57,265755,265827
5029,73,56,0,7.01,71.47,265826,265899
5030,71,56,3,7.21,69.91,265898,265969
5031,64,56,4,8.00,97.75,265969,266033
5032,65,56,1,7.88,113.86,266032,266097
5033,71,56,1,7.21,91.74,266096,266167
5034,74,56,4,6.92,67.70,266166,266240
5035,75,56,1,6.83,64.49,266239,266314
5036,45,56,4,11.38,231.30,266313,266358
5037,70,56,3,7.31,70.59,266357,266427
5038,66,56,1,7.76,75.09,266426,266492
5039,66,56,4,7.76,73.73,266491,266557
5040,65,56,0,7.88,75.68,266556,266621
5041,62,56,3,8.26,116.68,266620,266682
5042,73,56,2,7.01,68.56,266681,266754
5043,67,56,1,7.64,110.44,266753,266820
5044,76,55,4,6.74,63.43,266819,266895
5045,63,56,5,8.13,115.16,266895,266958
5046,72,56,2,7.11,53.35,266957,267029
5047,67,56,1,7.64,111.10,267028,267095
5048,70,56,4,7.31,62.39,267094,267164
5049,57,56,3,8.98,123.53,267163,267220
5050,60,56,1,8.53,119.95,267219,267279
5051,58,56,5,8.83,118.59,267278,267336
5052,78,53,1,6.56,28.91,267335,267413
5053,62,54,2,8.26,86.74,267412,267474
5054,65,54,2,7.88,103.86,267473,267538
5055,72,54,3,7.11,36.99,267537,267609
5056,60,54,1,8.53,148.28,267608,267668
5057,145,68,0,3.53,37.81,267668,267813
5058,131,119,0,3.91,176.68,267812,267943
5059,174,16,0,2.94,10.44,267942,268116
5060,148,33,1,3.46,15.45,268116,268264
5061,178,19,0,2.88,8.93,268264,268442
5062,247,15,0,2.07,6.28,268442,268689
5063,280,36,0,1.83,12.62,268688,268968
5064,222,28,0,2.31,14.27,268967,269189
5065,168,17,0,3.05,6.38,269188,269356
5066,136,39,0,3.76,18.99,269356,269492
5067,213,28,0,2.40,11.69,269491,269704
5068,213,64,0,2.40,29.06,269703,269916
5069,207,81,0,2.47,34.70,269915,270122
5070,198,31,1,2.59,14.61,270121,270319
5071,203,18,0,2.52,7.88,270319,270522
5072,53,119,0,9.66,592.83,270521,270574
5073,163,37,0,3.14,15.07,270573,270736
5074,170,17,0,3.01,7.45,270736,270906
5075,133,39,0,3.85,18.73,270905,271038
5076,244,20,0,2.10,7.47,271037,271281
5077,106,23,0,4.83,15.14,271281,271387
5078,110,105,0,4.65,167.79,271386,271496
5079,225,35,0,2.28,12.84,271495,271720
5080,128,27,0,4.00,12.33,271719,271847
5081,143,11,0,3.58,13.22,271846,271989
5082,52,29,0,9.85,74.51,271988,272040
5083,37,30,0,13.84,198.57,272039,272076
5084,26,24,6,19.69,30.83,272075,272101
5085,26,27,7,19.69,49.98,272100,272126
5086,25,26,3,20.48,40.01,272125,272150
5087,237,22,0,2.16,10.75,272149,272386
5088,91,30,0,5.63,45.99,272386,272477
5089,21,30,12,24.38,47.57,272477,272498
5090,86,24,0,5.95,61.00,272497,272583
5091,157,32,0,3.26,17.98,272582,272739
5092,46,45,2,11.13,42.94,272738,272784
5093,32,19,12,16.00,1.31,272783,272815
5094,16,60,0,32.00,507.00,272814,272830
5095,10,59,18,51.20,223.16,272829,272839
5096,10,60,9,51.20,257.16,272838,272848
5097,9,59,50,56.89,7.88,272847,272856
5098,10,60,6,51.20,287.96,272855,272865
5099,10,59,18,51.20,223.16,272864,272874
5100,9,60,40,56.89,36.10,272873,272882
5101,10,59,1,51.20,301.56,272881,272891
5102,10,60,16,51.20,233.36,272890,272900
5103,10,59,12,51.20,228.16,272899,272909
5104,9,60,47,56.89,20.99,272908,272917
5105,10,59,9,51.20,247.16,272916,272926
5106,15,59,0,34.13,501.18,272925,272940
5107,25,60,1,20.48,359.69,272939,272964
5108,10,60,17,51.20,252.96,272963,272973
5109,10,60,2,51.20,308.36,272972,272982
5110,9,59,45,56.89,18.54,272981,272990
5111,10,60,14,51.20,244.56,272989,272999
5112,10,59,11,51.20,248.16,272998,273008
5113,9,60,47,56.89,23.21,273007,273016
5114,10,59,13,51.20,246.96,273015,273025
5115,10,59,10,51.20,257.76,273024,273034
5116,9,60,49,56.89,18.10,273033,273042
5117,10,60,10,51.20,257.96,273041,273051
5118,10,59,16,51.20,226.76,273050,273060
5119,9,59,44,56.89,20.99,273059,273068
5120,9,60,41,56.89,31.88,273068,273077
5121,10,60,19,51.20,229.16,273076,273086
5122,12,59,4,42.67,394.56,273085,273097
5123,22,53,2,23.27,75.83,273096,273118
5124,23,30,12,22.26,12.19,273117,273140
5125,26,35,14,19.69,17.21,273139,273165
5126,24,51,3,21.33,59.22,273164,273188
5127,111,21,0,4.61,22.51,273187,273298
5128,178,20,0,2.88,11.82,273297,273475
5129,104,34,0,4.92,41.97,273474,273578
5130,44,37,0,11.64,104.96,273577,273621
5131,38,33,0,13.47,53.62,273621,273659
5132,55,37,0,9.31,98.29,273658,273713
5133,29,37,1,17.66,50.64,273712,273741
5134,169,34,0,3.03,15.12,273740,273909
5135,57,30,0,8.98,60.68,273909,273966
5136,61,22,0,8.39,41.12,273965,274026
5137,34,29,6,15.06,16.88,274025,274059
5138,112,24,0,4.57,26.51,274058,274170
5139,78,23,0,6.56,29.53,274169,274247
5140,179,34,0,2.86,15.47,274247,274426
5141,127,38,0,4.03,35.89,274425,274552
5142,227,111,0,2.26,59.87,274551,274778
5143,134,20,0,3.82,13.73,274777,274911
5144,98,26,0,5.22,26.73,274910,275008
5145,211,27,0,2.43,8.14,275008,275219
5146,130,53,1,3.94,34.13,275219,275349
5147,129,41,0,3.97,27.18,275348,275477
5148,168,21,1,3.05,7.09,275476,275644
5149,143,43,1,3.58,32.96,275643,275786
5150,264,40,0,1.94,16.07,275786,276050
5151,179,37,0,2.86,22.15,276049,276228
5152,48,16,0,10.67,13.68,276228,276276
5153,39,76,1,13.13,114.32,276275,276314
5154,90,53,0,5.69,62.26,276314,276404
5155,110,52,0,4.65,95.39,276403,276513
5156,89,30,0,5.75,28.07,276512,276601
5157,151,12,0,3.39,11.52,276600,276751
5158,135,15,0,3.79,6.28,276750,276885
5159,144,20,0,3.56,34.07,276884,277028
5160,37,24,0,13.84,23.81,277027,277064
5161,49,33,0,10.45,35.76,277063,277112
5162,97,13,0,5.28,11.54,277111,277208
5163,116,22,0,4.41,10.74,277207,277323
5164,76,22,1,6.74,15.72,277322,277398
5165,23,136,3,22.26,1851.84,277397,277420
5166,76,21,2,6.74,10.85,277419,277495
5167,73,42,3,7.01,26.89,277495,277568
5168,63,62,3,8.13,56.11,277567,277630
5169,32,152,2,16.00,857.06,277629,277661
5170,14,181,3,36.57,3657.82,277660,277674
5171,18,255,3,28.44,3442.58,277673,277691
5172,86,29,3,5.95,11.07,277690,277776
5173,101,9,1,5.07,1.61,277775,277876
5174,53,71,2,9.66,88.68,277876,277929
5175,40,20,6,12.80,3.36,277928,277968
5176,36,18,11,14.22,2.28,277967,278003
5177,38,19,2,13.47,8.14,278002,278040
5178,33,59,7,15.52,79.16,278039,278072
5179,163,38,0,3.14,36.77,278071,278234
5180,180,38,0,2.84,16.64,278233,278413
5181,145,37,0,3.53,44.72,278412,278557
5182,126,34,0,4.06,46.84,278556,278682
5183,37,25,3,13.84,15.76,278681,278718
5184,158,136,0,3.24,157.71,278717,278875
5185,169,25,0,3.03,17.26,278874,279043
5186,129,27,0,3.97,43.41,279042,279171
5187,26,28,1,19.69,49.29,279170,279196
5188,52,65,0,9.85,109.01,279195,279247
5189,22,32,7,23.27,54.02,279246,279268
5190,24,64,2,21.33,129.31,279267,279291
5191,22,35,7,23.27,55.38,279290,279312
5192,35,35,1,14.63,115.66,279311,279346
5193,36,56,1,14.22,95.62,279345,279381
5194,43,17,3,11.91,4.64,279380,279423
5195,39,15,2,13.13,6.01,279422,279461
5196,36,33,12,14.22,11.95,279460,279496
5197,26,30,0,19.69,108.14,279495,279521
5198,20,34,8,25.60,31.34,279520,279540
5199,19,30,17,26.95,10.16,279539,279558
5200,19,28,11,26.95,14.37,279557,279576
5201,20,29,2,25.60,45.74,279575,279595
5202,19,61,5,26.95,96.68,279594,279613
5203,18,54,22,28.44,40.58,279612,279630
5204,20,27,2,25.60,29.74,279629,279649
5205,19,55,3,26.95,73.52,279648,279667
5206,19,64,4,26.95,123.63,279666,279685
5207,18,52,23,28.44,33.91,279684,279702
5208,20,29,2,25.60,38.34,279701,279721
5209,19,29,14,26.95,13.73,279720,279739
5210,19,30,8,26.95,25.21,279738,279757
5211,20,29,5,25.60,39.24,279756,279776
5212,18,75,4,28.44,156.80,279775,279793
5213,18,80,4,28.44,184.25,279792,279810
5214,19,30,14,26.95,11.42,279809,279828
5215,19,29,14,26.95,10.47,279827,279846
5216,20,30,3,25.60,54.84,279845,279865
5217,19,29,14,26.95,9.84,279864,279883
5218,19,30,14,26.95,16.16,279882,279901
5219,19,29,10,26.95,17.00,279900,279919
5220,20,29,4,25.60,52.14,279918,279938
5221,19,29,17,26.95,6.58,279937,279956
5222,20,29,10,25.60,27.34,279955,279975
5223,18,79,3,28.44,186.58,279974,279992
5224,19,28,24,26.95,0.58,279991,280010
5225,19,29,17,26.95,5.94,280010,280029
5226,19,30,11,26.95,14.89,280028,280047
5227,20,28,1,25.60,32.34,280046,280066
5228,20,29,3,25.60,34.54,280065,280085
5229,20,29,10,25.60,24.04,280084,280104
5230,12,104,7,42.67,999.22,280103,280115
5231,9,196,30,56.89,2615.21,280114,280123
5232,12,92,12,42.67,445.72,280122,280134
5233,20,28,5,25.60,25.84,280133,280153
5234,20,28,2,25.60,31.94,280152,280172
5235,20,28,7,25.60,28.14,280171,280191
5236,20,29,4,25.60,32.24,280190,280210
5237,17,84,21,30.12,184.93,280209,280226
5238,19,31,10,26.95,17.63,280225,280244
5239,19,47,2,26.95,54.26,280243,280262
5240,20,27,7,25.60,21.24,280261,280281
5241,19,45,3,26.95,51.00,280280,280299
5242,89,28,0,5.75,100.12,280298,280387
5243,268,51,1,1.91,39.89,280386,280654
5244,265,51,1,1.93,39.76,280653,280918
5245,237,92,0,2.16,55.86,280917,281154
5246,207,90,0,2.47,48.14,281153,281360
5247,233,31,0,2.20,19.10,281360,281593
5248,225,24,0,2.28,10.92,281592,281817
5249,204,14,0,2.51,4.37,281816,282020
5250,114,282,0,4.49,690.78,282019,282133
5251,177,24,0,2.89,12.99,282132,282309
5252,117,313,0,4.38,830.70,282308,282425
5253,1,512,512,512.00,0.00,282424,282425
5254,9,258,3,56.89,5270.54,282424,282433
5255,13,44,34,39.38,5.62,282432,282445
5256,172,92,0,2.98,71.66,282444,282616
5257,124,74,0,4.13,69.14,282615,282739
5258,119,11,0,4.30,5.19,282738,282857
5259,179,29,0,2.86,10.88,282856,283035
5260,216,67,0,2.37,33.29,283034,283250
5261,248,29,0,2.06,8.71,283250,283498
5262,36,21,1,14.22,48.23,283497,283533
5263,32,27,0,16.00,25.62,283532,283564
5264,75,21,0,6.83,50.97,283564,283639
5265,34,24,0,15.06,41.58,283638,283672
5266,121,70,0,4.23,126.18,283671,283792
5267,84,20,0,6.10,38.56,283791,283875
5268,55,36,1,9.31,20.50,283874,283929
5269,88,21,0,5.82,15.49,283928,284016
5270,100,21,0,5.12,28.63,284015,284115
5271,77,13,2,6.65,5.71,284114,284191
5272,75,15,1,6.83,5.21,284190,284265
5273,113,21,0,4.53,19.59,284264,284377
5274,89,21,0,5.75,16.05,284376,284465
5275,62,12,0,8.26,18.80,284464,284526
5276,65,17,0,7.88,19.49,284525,284590
5277,68,29,0,7.53,23.37,284589,284657
5278,53,35,0,9.66,85.47,284656,284709
5279,22,35,3,23.27,155.74,284708,284730
5280,17,35,12,30.12,77.16,284729,284746
5281,22,35,3,23.27,141.83,284745,284767
5282,20,35,1,25.60,140.94,284766,284786
5283,20,35,8,25.60,134.44,284785,284805
5284,59,35,0,8.68,57.81,284804,284863
5285,78,12,0,6.56,18.78,284862,284940
5286,69,12,0,7.42,22.68,284940,285009
5287,52,35,0,9.85,87.40,285008,285060
5288,17,35,12,30.12,77.16,285059,285076
5289,21,35,3,24.38,139.85,285075,285096
5290,24,35,3,21.33,162.31,285095,285119
5291,18,35,5,28.44,105.91,285118,285136
5292,24,35,1,21.33,169.14,285135,285159
5293,23,35,5,22.26,151.50,285158,285181
5294,19,35,9,26.95,113.84,285180,285199
5295,19,35,4,26.95,144.47,285198,285217
5296,19,35,4,26.95,125.94,285216,285235
5297,20,35,3,25.60,136.14,285234,285254
5298,25,35,2,20.48,173.85,285253,285278
5299,20,35,10,25.60,128.24,285277,285297
5300,25,35,2,20.48,204.57,285296,285321
5301,53,35,0,9.66,57.47,285320,285373
5302,20,35,3,25.60,137.74,285372,285392
5303,21,35,8,24.38,125.28,285391,285412
5304,20,35,9,25.60,132.94,285411,285431
5305,20,35,1,25.60,155.34,285430,285450
5306,19,35,5,26.95,135.63,285449,285468
5307,21,35,3,24.38,155.19,285467,285488
5308,74,30,0,6.92,22.13,285487,285561
5309,74,34,0,6.92,61.34,285560,285634
5310,28,34,3,18.29,107.06,285633,285661
5311,19,34,12,26.95,99.21,285660,285679
5312,21,35,3,24.38,156.05,285678,285699
5313,19,35,9,26.95,111.31,285698,285717
5314,20,35,12,25.60,105.24,285716,285736
5315,20,35,5,25.60,129.94,285735,285755
5316,90,35,0,5.69,28.04,285754,285844
5317,64,35,0,8.00,27.66,285843,285907
5318,71,15,0,7.21,22.56,285906,285977
5319,57,22,3,8.98,19.32,285976,286033
5320,63,35,0,8.13,55.44,286032,286095
5321,22,35,2,23.27,167.93,286094,286116
5322,18,35,11,28.44,106.80,286115,286133
5323,21,35,3,24.38,163.38,286132,286153
5324,21,35,1,24.38,153.38,286152,286173
5325,20,35,9,25.60,130.64,286172,286192
5326,48,35,0,10.67,90.76,286191,286239
5327,71,12,0,7.21,20.65,286238,286309
5328,70,24,0,7.31,18.56,286308,286378
5329,68,35,0,7.53,32.54,286377,286445
5330,22,35,12,23.27,123.02,286444,286466
5331,19,35,9,26.95,114.37,286465,286484
5332,22,35,9,23.27,138.02,286483,286505
5333,18,35,3,28.44,128.25,286504,286522
5334,38,35,0,13.47,153.41,286522,286560
5335,72,12,0,7.11,18.54,286559,286631
5336,74,12,0,6.92,22.78,286630,286704
5337,77,12,0,6.65,20.44,286703,286780
5338,27,35,3,18.96,164.55,286779,286806
5339,21,35,3,24.38,149.47,286805,286826
5340,21,35,3,24.38,155.19,286825,286846
5341,42,35,0,12.19,133.15,286845,286887
5342,25,35,1,20.48,143.37,286886,286911
5343,21,35,3,24.38,153.09,286910,286931
5344,37,35,0,13.84,145.81,286930,286967
5345,90,12,0,5.69,15.39,286967,287057
5346,77,12,0,6.65,16.54,287056,287133
5347,26,35,1,19.69,212.21,287132,287158
5348,21,35,4,24.38,153.19,287157,287178
5349,22,35,12,23.27,97.11,287177,287199
5350,19,35,12,26.95,108.16,287199,287218
5351,23,35,2,22.26,139.50,287217,287240
5352,28,31,2,18.29,145.49,287239,287267
5353,35,34,1,14.63,166.63,287266,287301
5354,95,12,0,5.39,15.71,287300,287395
5355,75,13,0,6.83,17.00,287395,287470
5356,84,19,0,6.10,24.35,287469,287553
5357,69,13,0,7.42,17.72,287552,287621
5358,71,12,0,7.21,18.90,287620,287691
5359,55,33,3,9.31,25.78,287690,287745
5360,57,18,3,8.98,22.12,287745,287802
5361,69,12,0,7.42,20.82,287802,287871
5362,65,12,0,7.88,20.78,287870,287935
5363,76,12,0,6.74,19.61,287934,288010
5364,88,12,0,5.82,13.51,288009,288097
5365,85,12,0,6.02,15.22,288096,288181
5366,100,17,0,5.12,18.75,288181,288281
5367,64,17,3,8.00,9.78,288281,288345
5368,77,13,1,6.65,4.85,288344,288421
5369,81,14,0,6.32,9.33,288420,288501
5370,61,10,0,8.39,4.17,288500,288561
5371,59,10,2,8.68,3.88,288560,288619
5372,59,10,3,8.68,3.95,288619,288678
5373,59,10,2,8.68,4.01,288677,288736
5374,85,10,0,6.02,13.67,288735,288820
5375,58,42,0,8.83,34.38,288819,288877
5376,76,15,0,6.74,24.56,288876,288952
5377,120,30,0,4.27,15.45,288951,289071
5378,80,15,0,6.40,6.62,289070,289150
5379,76,13,3,6.74,3.43,289149,289225
5380,59,112,1,8.68,188.59,289225,289284
5381,80,14,1,6.40,5.27,289283,289363
5382,79,12,1,6.48,2.63,289362,289441
5383,45,249,0,11.38,1290.86,289440,289485
5384,1,512,512,512.00,0.00,289484,289485
5385,1269,291,0,0.40,102.69,289484,290753
5386,1,512,512,512.00,0.00,290752,290753
5387,1,512,512,512.00,0.00,290752,290753
5388,1150,395,0,0.45,147.38,290752,291902
5389,519,390,0,0.99,320.77,291901,292420
5390,522,382,0,0.98,310.96,292419,292941
5391,737,278,0,0.69,143.91,292940,293677
5392,1,512,512,512.00,0.00,293676,293677
5393,1103,304,0,0.46,102.51,293676,294779
5394,583,495,0,0.88,420.01,294778,295361
5395,351,206,0,1.46,256.62,295360,295711
5396,1,512,512,512.00,0.00,295710,295711
5397,1125,406,0,0.46,152.91,295710,296835
5398,1,512,512,512.00,0.00,296834,296835
5399,726,383,0,0.71,224.48,296834,297560
5400,1,512,512,512.00,0.00,297559,297560
5401,1024,385,0,0.50,160.25,297559,298583
5402,890,223,0,0.58,88.00,298582,299472
5403,105,31,0,4.88,32.64,299471,299576
5404,47,19,0,10.89,13.07,299575,299622
5405,48,34,0,10.67,43.76,299621,299669
5406,131,29,0,3.91,15.85,299668,299799
5407,89,29,1,5.75,20.03,299798,299887
5408,165,14,0,3.10,9.12,299886,300051
5409,106,22,0,4.83,20.56,300050,300156
5410,103,19,0,4.97,24.07,300155,300258
5411,101,93,0,5.07,118.90,300258,300359
5412,66,22,3,7.76,9.37,300358,300424
5413,125,21,0,4.10,18.82,300423,300548
5414,226,43,0,2.27,18.24,300548,300774
5415,108,14,0,4.74,9.64,300773,300881
5416,90,21,0,5.69,12.86,300881,300971
5417,94,23,2,5.45,10.91,300970,301064
5418,107,27,0,4.79,21.53,301064,301171
5419,135,14,0,3.79,11.81,301170,301305
5420,123,13,0,4.16,11.47,301304,301427
5421,129,19,1,3.97,4.39,301426,301555
5422,93,58,3,5.51,71.80,301554,301647
5423,54,294,3,9.48,1528.92,301646,301700
5424,115,34,2,4.45,11.24,301699,301814
5425,99,37,2,5.17,35.72,301813,301912
5426,121,20,1,4.23,4.48,301911,302032
5427,115,34,1,4.45,10.73,302031,302146
5428,115,52,2,4.45,29.00,302146,302261
5429,111,23,2,4.61,11.57,302260,302371
5430,115,29,2,4.45,10.60,302370,302485
5431,103,68,1,4.97,43.74,302484,302587
5432,79,17,2,6.48,8.98,302586,302665
5433,101,37,1,5.07,31.57,302664,302765
5434,101,58,1,5.07,44.70,302764,302865
5435,97,43,0,5.28,102.80,302864,302961
5436,90,27,0,5.69,61.06,302960,303050
5437,105,26,0,4.88,22.07,303049,303154
5438,70,52,0,7.31,112.76,303153,303223
5439,70,51,0,7.31,70.33,303222,303292
5440,44,101,0,11.64,251.91,303291,303335
5441,4,192,1,128.00,5597.50,303334,303338
5442,4,175,78,128.00,1283.50,303337,303341
5443,20,142,7,25.60,1525.34,303340,303360
5444,105,55,0,4.88,82.03,303359,303464
5445,80,37,1,6.40,86.14,303463,303543
5446,186,37,0,2.75,22.41,303542,303728
5447,177,34,0,2.89,17.56,303728,303905
5448,137,27,0,3.74,28.84,303905,304042
5449,210,58,0,2.44,41.79,304041,304251
5450,71,23,0,7.21,53.74,304251,304322
5451,163,39,0,3.14,23.23,304321,304484
5452,59,39,0,8.68,58.52,304483,304542
5453,110,17,0,4.65,25.39,304541,304651
5454,66,39,0,7.76,70.82,304650,304716
5455,189,35,0,2.71,19.53,304715,304904
5456,159,30,0,3.22,11.45,304903,305062
5457,75,42,0,6.83,106.65,305061,305136
5458,18,39,6,28.44,42.36,305135,305153
5459,18,35,19,28.44,12.14,305152,305170
5460,26,30,0,19.69,143.60,305169,305195
5461,17,43,19,30.12,17.04,305194,305211
5462,18,47,2,28.44,63.69,305210,305228
5463,18,30,13,28.44,15.91,305227,305245
5464,18,30,17,28.44,15.47,305244,305262
5465,19,30,1,26.95,53.63,305261,305280
5466,18,30,3,28.44,38.14,305279,305297
5467,18,30,5,28.44,32.80,305296,305314
5468,15,94,25,34.13,258.25,305313,305328
5469,20,31,3,25.60,57.54,305327,305347
5470,28,42,1,18.29,198.99,305346,305374
5471,19,35,14,26.95,23.94,305373,305392
5472,44,45,0,11.64,191.73,305391,305435
5473,16,35,12,32.00,27.12,305434,305450
5474,16,33,21,32.00,9.00,305449,305465
5475,17,33,4,30.12,64.69,305464,305481
5476,16,34,20,32.00,10.62,305480,305496
5477,17,33,4,30.12,64.69,305495,305512
5478,16,33,20,32.00,10.12,305511,305527
5479,17,33,3,30.12,65.87,305526,305543
5480,16,33,19,32.00,11.50,305542,305558
5481,17,33,2,30.12,67.28,305557,305574
5482,13,56,18,39.38,103.62,305573,305586
5483,15,54,18,34.13,54.78,305585,305600
5484,17,34,1,30.12,71.04,305599,305616
5485,17,36,4,30.12,44.69,305615,305632
5486,17,31,20,30.12,7.28,305631,305648
5487,18,31,5,28.44,53.25,305647,305665
5488,17,31,21,30.12,6.57,305664,305681
5489,18,31,6,28.44,52.69,305680,305698
5490,17,31,22,30.12,6.10,305697,305714
5491,18,31,7,28.44,52.36,305713,305731
5492,17,31,23,30.12,5.87,305730,305747
5493,13,180,6,39.38,1745.78,305746,305759
5494,18,40,13,28.44,29.91,305758,305776
5495,17,31,18,30.12,9.40,305775,305792
5496,18,31,2,28.44,56.25,305791,305809
5497,23,31,0,22.26,118.98,305808,305831
5498,18,31,5,28.44,46.14,305830,305848
5499,17,31,16,30.12,12.46,305847,305864
5500,17,31,16,30.12,12.46,305864,305881
5501,18,31,1,28.44,57.69,305880,305898
5502,14,110,30,36.57,414.82,305897,305911
5503,16,78,1,32.00,302.00,305910,305926
5504,18,31,2,28.44,56.25,305925,305943
5505,17,31,17,30.12,10.81,305942,305959
5506,18,31,1,28.44,57.69,305958,305976
5507,17,31,16,30.12,12.46,305975,305992
5508,17,31,16,30.12,12.46,305992,306009
5509,19,31,12,26.95,27.31,306008,306027
5510,18,30,17,28.44,15.47,306026,306044
5511,16,99,13,32.00,340.12,306043,306059
5512,18,30,16,28.44,11.69,306058,306076
5513,18,30,5,28.44,32.80,306075,306093
5514,18,30,3,28.44,38.14,306092,306110
5515,24,30,1,21.33,104.72,306109,306133
5516,18,30,9,28.44,24.80,306132,306150
5517,17,80,7,30.12,190.93,306149,306166
5518,19,34,4,26.95,54.05,306165,306184
5519,18,30,11,28.44,19.25,306183,306201
5520,19,43,5,26.95,47.21,306200,306219
5521,19,30,23,26.95,2.47,306218,306237
5522,19,30,2,26.95,73.42,306236,306255
5523,18,43,7,28.44,40.69,306254,306272
5524,18,47,7,28.44,50.25,306271,306289
5525,16,34,23,32.00,9.38,306288,306304
5526,17,33,5,30.12,63.75,306303,306320
5527,16,33,21,32.00,9.00,306319,306335
5528,17,34,4,30.12,67.16,306334,306351
5529,16,33,21,32.00,9.00,306350,306366
5530,17,33,4,30.12,64.69,306365,306382
5531,16,33,20,32.00,10.12,306381,306397
5532,17,33,3,30.12,65.87,306396,306413
5533,16,33,19,32.00,11.50,306412,306428
5534,17,33,2,30.12,67.28,306427,306444
5535,12,67,2,42.67,387.22,306443,306455
5536,11,71,21,46.55,246.98,306454,306465
5537,17,33,5,30.12,63.75,306464,306481
5538,16,33,22,32.00,8.12,306480,306496
5539,17,33,6,30.12,63.04,306495,306512
5540,16,33,23,32.00,7.50,306511,306527
5541,17,33,7,30.12,62.57,306526,306543
5542,16,33,24,32.00,7.12,306542,306558
5543,17,33,8,30.12,62.34,306557,306574
5544,16,33,25,32.00,7.00,306573,306589
5545,17,33,8,30.12,62.34,306588,306605
5546,16,53,7,32.00,147.12,306604,306620
5547,11,197,12,46.55,3944.43,306619,306630
5548,16,33,23,32.00,7.50,306629,306645
5549,17,34,6,30.12,65.75,306644,306661
5550,16,33,23,32.00,7.50,306660,306676
5551,19,30,6,26.95,39.10,306675,306694
5552,18,30,14,28.44,19.80,306693,306711
5553,18,30,12,28.44,21.14,306710,306728
5554,16,98,10,32.00,341.50,306727,306743
5555,19,30,3,26.95,40.16,306742,306761
5556,18,30,8,28.44,25.47,306760,306778
5557,18,31,12,28.44,21.69,306777,306795
5558,17,31,19,30.12,8.22,306794,306811
5559,18,31,3,28.44,55.02,306810,306828
5560,17,31,18,30.12,9.40,306827,306844
5561,16,73,2,32.00,162.38,306843,306859
5562,17,43,22,30.12,26.93,306858,306875
5563,18,31,6,28.44,52.69,306874,306892
5564,18,31,7,28.44,33.69,306891,306909
5565,18,30,12,28.44,21.14,306908,306926
5566,18,30,14,28.44,19.80,306925,306943
5567,17,66,2,30.12,137.63,306942,306959
5568,18,36,26,28.44,7.91,306958,306976
5569,25,49,2,20.48,56.65,306975,307000
5570,17,55,5,30.12,131.40,306999,307016
5571,15,122,5,34.13,728.12,307015,307030
5572,13,74,10,39.38,308.70,307029,307042
5573,17,61,2,30.12,143.63,307041,307058
5574,15,81,1,34.13,382.78,307057,307072
5575,18,30,6,28.44,30.14,307071,307089
5576,18,30,8,28.44,26.47,307088,307106
5577,16,69,17,32.00,147.62,307105,307121
5578,18,30,9,28.44,23.25,307120,307138
5579,20,30,0,25.60,101.94,307137,307157
5580,25,28,1,20.48,23.53,307156,307181
5581,26,26,3,19.69,13.37,307180,307206
5582,26,23,17,19.69,1.29,307205,307231
5583,30,23,1,17.07,48.73,307230,307260
5584,27,21,1,18.96,12.92,307259,307286
5585,26,22,13,19.69,2.91,307285,307311
5586,26,23,6,19.69,9.06,307310,307336
5587,27,28,2,18.96,25.00,307335,307362
5588,26,24,17,19.69,1.44,307361,307387
5589,27,25,3,18.96,17.44,307386,307413
5590,27,24,4,18.96,10.41,307412,307439
5591,26,22,16,19.69,1.29,307438,307464
5592,27,22,4,18.96,11.44,307463,307490
5593,26,24,8,19.69,6.44,307489,307515
5594,27,24,1,18.96,22.55,307514,307541
5595,27,26,4,18.96,16.63,307540,307567
5596,28,23,0,18.29,32.92,307566,307594
5597,25,42,1,20.48,53.05,307593,307618
5598,22,46,2,23.27,53.38,307617,307639
5599,16,63,21,32.00,136.88,307638,307654
5600,18,60,10,28.44,109.36,307653,307671
5601,12,127,1,42.67,1065.22,307670,307682
5602,19,126,18,26.95,558.05,307681,307700
5603,27,22,2,18.96,15.22,307699,307726
5604,22,70,9,23.27,153.47,307725,307747
5605,28,23,0,18.29,27.85,307746,307774
5606,26,23,15,19.69,2.29,307773,307799
5607,27,22,6,18.96,10.70,307798,307825
5608,18,30,9,28.44,24.80,307824,307842
5609,18,30,7,28.44,28.36,307841,307859
5610,17,81,5,30.12,219.87,307858,307875
5611,18,33,16,28.44,12.47,307874,307892
5612,18,30,16,28.44,10.69,307892,307910
5613,19,29,11,26.95,19.42,307909,307928
5614,18,36,7,28.44,55.91,307927,307945
5615,16,39,27,32.00,9.12,307944,307960
5616,20,33,1,25.60,94.04,307959,307979
5617,16,33,25,32.00,7.00,307978,307994
5618,17,34,8,30.12,65.28,307993,308010
5619,16,33,25,32.00,7.00,308009,308025
5620,17,33,8,30.12,62.34,308024,308041
5621,16,33,24,32.00,7.12,308040,308056
5622,17,33,7,30.12,62.57,308055,308072
5623,16,33,23,32.00,7.50,308071,308087
5624,17,33,6,30.12,63.04,308086,308103
5625,16,33,22,32.00,8.12,308102,308118
5626,17,33,5,30.12,63.75,308117,308134
5627,16,33,21,32.00,9.00,308133,308149
5628,17,33,4,30.12,64.69,308148,308165
5629,12,61,20,42.67,180.72,308164,308176
5630,13,68,11,39.38,242.70,308175,308188
5631,17,33,7,30.12,62.57,308187,308204
5632,16,33,23,32.00,7.50,308203,308219
5633,21,34,0,24.38,143.85,308218,308239
5634,18,30,5,28.44,32.80,308238,308256
5635,18,30,7,28.44,28.36,308255,308273
5636,18,30,9,28.44,24.80,308272,308290
5637,12,187,21,42.67,1957.72,308289,308301
5638,19,40,1,26.95,80.37,308300,308319
5639,18,30,3,28.44,38.14,308318,308336
5640,18,30,5,28.44,32.80,308335,308353
5641,18,30,7,28.44,28.36,308352,308370
5642,18,30,9,28.44,24.80,308369,308387
5643,18,30,14,28.44,16.80,308386,308404
5644,18,30,16,28.44,19.36,308403,308421
5645,18,30,14,28.44,19.80,308420,308438
5646,21,34,1,24.38,156.71,308437,308458
5647,17,33,7,30.12,62.57,308457,308474
5648,16,34,22,32.00,9.75,308473,308489
5649,17,33,6,30.12,63.04,308488,308505
5650,16,33,23,32.00,7.50,308504,308520
5651,17,33,6,30.12,63.04,308519,308536
5652,16,33,23,32.00,7.50,308535,308551
5653,17,34,6,30.12,65.75,308550,308567
5654,16,33,23,32.00,7.50,308566,308582
5655,17,33,7,30.12,62.57,308581,308598
5656,16,33,24,32.00,7.12,308597,308613
5657,17,33,8,30.12,62.34,308612,308629
5658,13,65,25,39.38,141.01,308628,308641
5659,12,60,18,42.67,156.56,308640,308652
5660,17,34,1,30.12,71.04,308651,308668
5661,16,33,18,32.00,13.12,308667,308683
5662,17,33,2,30.12,67.28,308682,308699
5663,16,45,26,32.00,13.88,308698,308714
5664,18,37,5,28.44,61.69,308713,308731
5665,18,34,16,28.44,14.58,308730,308748
5666,20,31,3,25.60,64.04,308747,308767
5667,17,31,21,30.12,6.57,308766,308783
5668,18,31,5,28.44,53.25,308782,308800
5669,13,142,20,39.38,917.93,308799,308812
5670,19,33,10,26.95,35.31,308811,308830
5671,17,31,19,30.12,8.22,308829,308846
5672,18,31,3,28.44,55.02,308845,308863
5673,17,31,18,30.12,9.40,308862,308879
5674,18,31,2,28.44,56.25,308878,308896
5675,18,31,16,28.44,20.14,308895,308913
5676,18,30,14,28.44,17.58,308912,308930
5677,18,30,10,28.44,23.36,308929,308947
5678,16,98,8,32.00,327.50,308946,308962
5679,17,71,14,30.12,140.69,308961,308978
5680,18,30,8,28.44,26.47,308977,308995
5681,18,30,6,28.44,30.47,308994,309012
5682,18,30,4,28.44,35.36,309011,309029
5683,18,30,2,28.44,41.14,309028,309046
5684,18,30,14,28.44,13.80,309046,309064
5685,18,30,16,28.44,19.36,309063,309081
5686,18,30,14,28.44,19.80,309080,309098
5687,17,50,12,30.12,42.57,309097,309114
5688,17,54,24,30.12,45.28,309113,309130
5689,19,30,5,26.95,58.16,309129,309148
5690,18,31,20,28.44,9.80,309147,309165
5691,20,32,9,25.60,36.54,309164,309184
5692,19,54,5,26.95,83.42,309183,309202
5693,19,30,16,26.95,9.21,309201,309220
5694,19,37,10,26.95,38.26,309219,309238
5695,18,34,18,28.44,10.69,309237,309255
5696,24,31,0,21.33,147.47,309254,309278
5697,18,31,13,28.44,24.69,309277,309295
5698,18,30,14,28.44,19.80,309294,309312
5699,18,30,12,28.44,21.14,309311,309329
5700,18,30,10,28.44,23.36,309328,309346
5701,18,30,8,28.44,26.47,309345,309363
5702,12,60,6,42.67,199.39,309362,309374
5703,19,37,1,26.95,79.42,309373,309392
5704,18,30,9,28.44,24.80,309391,309409
5705,18,31,10,28.44,24.36,309408,309426
5706,18,31,11,28.44,23.25,309425,309443
5707,23,31,2,22.26,41.76,309442,309465
5708,22,44,17,23.27,22.29,309464,309486
5709,24,31,1,21.33,65.56,309485,309509
5710,17,51,4,30.12,69.40,309508,309525
5711,19,38,2,26.95,65.73,309524,309543
5712,40,31,0,12.80,166.36,309542,309582
5713,20,30,17,25.60,7.54,309581,309601
5714,20,29,10,25.60,22.84,309600,309620
5715,20,28,16,25.60,7.74,309619,309639
5716,18,99,6,28.44,331.25,309638,309656
5717,20,33,16,25.60,11.64,309655,309675
5718,20,37,10,25.60,22.14,309674,309694
5719,18,44,0,28.44,178.36,309693,309711
5720,12,44,36,42.67,8.89,309710,309722
5721,12,51,8,42.67,122.39,309721,309733
5722,24,50,0,21.33,232.81,309732,309756
5723,19,28,17,26.95,9.52,309755,309774
5724,19,28,11,26.95,14.58,309773,309792
5725,18,96,3,28.44,311.14,309791,309809
5726,19,28,18,26.95,8.47,309808,309827
5727,21,30,9,24.38,32.62,309826,309847
5728,18,37,13,28.44,20.14,309846,309864
5729,36,39,0,14.22,173.23,309864,309900
5730,18,62,11,28.44,84.58,309899,309917
5731,20,29,8,25.60,22.04,309916,309936
5732,27,29,0,18.96,129.81,309935,309962
5733,16,44,23,32.00,24.38,309961,309977
5734,16,38,5,32.00,86.00,309976,309992
5735,22,47,0,23.27,234.83,309991,310013
5736,39,30,0,13.13,166.37,310013,310052
5737,16,73,24,32.00,115.38,310051,310067
5738,19,33,5,26.95,36.79,310066,310085
5739,19,30,2,26.95,51.21,310084,310103
5740,20,44,2,25.60,138.34,310102,310122
5741,19,32,3,26.95,53.00,310121,310140
5742,22,31,6,23.27,66.74,310139,310161
5743,18,30,11,28.44,22.14,310160,310178
5744,18,30,13,28.44,20.36,310177,310195
5745,18,30,15,28.44,19.47,310194,310212
5746,15,136,15,34.13,771.18,310211,310226
5747,18,30,14,28.44,14.47,310225,310243
5748,18,30,4,28.44,35.36,310242,310260
5749,18,30,2,28.44,41.14,310259,310277
5750,18,30,20,28.44,9.91,310277,310295
5751,18,30,2,28.44,41.14,310294,310312
5752,18,30,2,28.44,41.14,310312,310330
5753,18,30,4,28.44,35.36,310329,310347
5754,18,30,6,28.44,30.47,310346,310364
5755,18,30,8,28.44,26.47,310363,310381
5756,14,157,2,36.57,1172.39,310380,310394
5757,19,31,3,26.95,35.94,310393,310412
5758,18,30,8,28.44,25.47,310411,310429
5759,18,31,12,28.44,19.69,310428,310446
5760,18,30,18,28.44,12.14,310445,310463
5761,18,30,10,28.44,23.36,310462,310480
5762,16,84,8,32.00,208.50,310479,310495
5763,19,39,5,26.95,53.94,310494,310513
5764,18,30,15,28.44,19.47,310512,310530
5765,19,30,13,26.95,23.21,310529,310548
5766,18,30,7,28.44,28.36,310547,310565
5767,17,70,5,30.12,221.16,310564,310581
5768,18,36,15,28.44,19.47,310580,310598
5769,18,30,15,28.44,19.47,310597,310615
5770,18,30,13,28.44,17.69,310614,310632
5771,21,30,1,24.38,91.00,310631,310652
5772,17,43,26,30.12,18.22,310651,310668
5773,18,31,10,28.44,21.69,310667,310685
5774,18,30,12,28.44,21.14,310684,310702
5775,20,30,3,25.60,43.54,310701,310721
5776,17,55,25,30.12,39.99,310720,310737
5777,19,46,4,26.95,62.79,310736,310755
5778,19,29,12,26.95,20.05,310754,310773
5779,26,35,0,19.69,167.44,310772,310798
5780,18,37,17,28.44,20.91,310797,310815
5781,57,31,0,8.98,122.51,310814,310871
5782,18,29,21,28.44,3.47,310870,310888
5783,18,29,19,28.44,5.25,310888,310906
5784,19,29,9,26.95,35.84,310905,310924
5785,16,101,20,32.00,326.25,310923,310939
5786,20,31,1,25.60,58.54,310938,310958
5787,18,31,7,28.44,52.36,310957,310975
5788,17,31,22,30.12,6.10,310974,310991
5789,18,31,6,28.44,52.69,310990,311008
5790,17,31,21,30.12,6.57,311007,311024
5791,16,75,5,32.00,263.00,311023,311039
5792,17,46,12,30.12,36.69,311038,311055
5793,17,31,19,30.12,8.22,311054,311071
5794,18,31,3,28.44,55.02,311070,311088
5795,29,31,0,17.66,196.16,311087,311116
5796,17,31,16,30.12,12.46,311116,311133
5797,18,31,1,28.44,57.69,311132,311150
5798,16,54,26,32.00,58.75,311149,311165
5799,17,50,16,30.12,38.69,311165,311182
5800,15,100,0,34.13,595.85,311181,311196
5801,18,36,11,28.44,29.02,311195,311213
5802,18,31,8,28.44,52.25,311212,311230
5803,17,31,23,30.12,5.87,311229,311246
5804,18,31,7,28.44,52.36,311245,311263
5805,18,31,14,28.44,22.47,311262,311280
5806,17,31,17,30.12,10.81,311279,311296
5807,18,31,1,28.44,57.69,311295,311313
5808,17,31,16,30.12,12.46,311312,311329
5809,19,31,2,26.95,52.26,311329,311348
5810,19,29,5,26.95,37.94,311347,311366
5811,18,29,24,28.44,2.47,311365,311383
5812,19,29,5,26.95,37.94,311382,311401
5813,16,91,15,32.00,243.50,311400,311416
5814,19,53,7,26.95,70.79,311415,311434
5815,19,29,2,26.95,41.73,311433,311452
5816,18,31,1,28.44,47.02,311451,311469
5817,17,31,17,30.12,10.81,311468,311485
5818,18,31,2,28.44,56.25,311484,311502
5819,17,31,18,30.12,9.40,311501,311518
5820,15,73,13,34.13,164.65,311517,311532
5821,17,54,26,30.12,42.46,311531,311548
5822,18,31,1,28.44,57.69,311547,311565
5823,17,31,16,30.12,12.46,311564,311581
5824,17,31,16,30.12,12.46,311581,311598
5825,20,31,1,25.60,90.54,311597,311617
5826,18,31,6,28.44,52.69,311616,311634
5827,17,31,22,30.12,6.10,311633,311650
5828,18,31,7,28.44,52.36,311649,311667
5829,15,95,8,34.13,370.92,311666,311681
5830,18,31,4,28.44,41.25,311680,311698
5831,17,31,20,30.12,7.28,311697,311714
5832,18,31,11,28.44,35.47,311713,311731
5833,26,30,0,19.69,135.60,311730,311756
5834,18,30,6,28.44,30.47,311755,311773
5835,17,63,4,30.12,129.28,311772,311789
5836,19,42,5,26.95,50.05,311788,311807
5837,18,30,18,28.44,9.36,311806,311824
5838,18,30,12,28.44,21.14,311823,311841
5839,18,30,10,28.44,23.36,311840,311858
5840,18,30,8,28.44,26.47,311857,311875
5841,18,30,6,28.44,30.47,311874,311892
5842,18,30,4,28.44,35.36,311891,311909
5843,15,150,2,34.13,1009.18,311908,311923
5844,18,30,14,28.44,14.14,311922,311940
5845,18,30,3,28.44,38.14,311939,311957
5846,19,31,1,26.95,56.26,311956,311975
5847,17,47,13,30.12,43.28,311974,311991
5848,18,45,9,28.44,46.80,311990,312008
5849,18,32,19,28.44,13.91,312007,312025
5850,18,46,2,28.44,101.14,312024,312042
5851,19,35,7,26.95,27.63,312041,312060
5852,18,30,20,28.44,9.91,312059,312077
5853,38,30,0,13.47,181.51,312076,312114
5854,18,30,13,28.44,20.36,312113,312131
5855,18,30,15,28.44,19.47,312130,312148
5856,16,77,15,32.00,148.12,312147,312163
5857,16,109,13,32.00,412.38,312162,312178
5858,18,30,15,28.44,19.47,312177,312195
5859,18,30,15,28.44,19.47,312194,312212
5860,18,30,13,28.44,20.36,312211,312229
5861,18,30,11,28.44,22.14,312228,312246
5862,18,30,9,28.44,24.80,312245,312263
5863,19,30,7,26.95,35.00,312262,312281
5864,17,47,25,30.12,21.87,312281,312298
5865,18,57,2,28.44,92.58,312297,312315
5866,18,30,12,28.44,21.14,312314,312332
5867,20,30,3,25.60,56.84,312331,312351
5868,26,21,7,19.69,7.21,312350,312376
5869,26,20,13,19.69,1.83,312375,312401
5870,13,199,1,39.38,2874.39,312400,312413
5871,18,199,6,28.44,1729.02,312412,312430
5872,26,21,13,19.69,1.98,312429,312455
5873,27,21,2,18.96,23.52,312454,312481
5874,26,21,2,19.69,13.14,312480,312506
5875,24,31,0,21.33,106.06,312505,312529
5876,17,31,16,30.12,12.46,312528,312545
5877,16,53,13,32.00,58.50,312545,312561
5878,18,49,16,28.44,42.69,312560,312578
5879,19,31,5,26.95,58.58,312577,312596
5880,26,21,5,19.69,10.60,312595,312621
5881,26,21,5,19.69,10.21,312620,312646
5882,26,21,1,19.69,15.06,312645,312671
5883,26,21,9,19.69,5.37,312670,312696
5884,28,21,5,18.29,8.92,312695,312723
5885,28,19,4,18.29,8.42,312722,312750
5886,16,196,15,32.00,1866.62,312749,312765
5887,16,196,4,32.00,1935.38,312764,312780
5888,27,22,1,18.96,18.04,312779,312806
5889,18,30,11,28.44,22.14,312805,312823
5890,17,69,9,30.12,130.46,312822,312839
5891,19,34,12,26.95,23.31,312838,312857
5892,19,31,13,26.95,26.89,312856,312875
5893,18,31,2,28.44,56.25,312874,312892
5894,17,31,18,30.12,9.40,312891,312908
5895,18,31,3,28.44,55.02,312907,312925
5896,16,70,2,32.00,218.75,312924,312940
5897,18,33,1,28.44,49.25,312939,312957
5898,23,31,1,22.26,145.84,312956,312979
5899,17,47,11,30.12,49.87,312978,312995
5900,18,35,14,28.44,19.02,312994,313012
5901,19,31,7,26.95,54.58,313011,313030
5902,17,31,24,30.12,3.99,313029,313046
5903,17,50,4,30.12,84.22,313045,313062
5904,18,47,13,28.44,47.47,313061,313079
5905,18,31,1,28.44,57.69,313078,313096
5906,17,53,14,30.12,49.52,313095,313112
5907,19,32,1,26.95,49.00,313111,313130
5908,18,31,4,28.44,37.58,313129,313147
5909,18,30,6,28.44,30.47,313146,313164
5910,18,30,8,28.44,26.47,313163,313181
5911,18,30,10,28.44,23.36,313180,313198
5912,18,30,12,28.44,21.14,313197,313215
5913,18,30,14,28.44,19.80,313214,313232
5914,14,169,4,36.57,1403.24,313231,313245
5915,18,40,19,28.44,17.58,313244,313262
5916,18,30,11,28.44,22.14,313261,313279
5917,18,30,9,28.44,24.80,313278,313296
5918,18,30,7,28.44,28.36,313295,313313
5919,19,30,5,26.95,48.68,313312,313331
5920,16,77,21,32.00,141.38,313330,313346
5921,19,35,6,26.95,35.94,313345,313364
5922,18,30,8,28.44,26.47,313363,313381
5923,19,43,6,26.95,61.84,313380,313399
5924,18,51,19,28.44,35.80,313398,313416
5925,19,29,4,26.95,31.63,313415,313434
5926,18,41,6,28.44,39.47,313433,313451
5927,19,43,6,26.95,56.05,313450,313469
5928,18,30,20,28.44,9.47,313468,313486
5929,18,38,9,28.44,39.58,313485,313503
5930,20,34,7,25.60,36.14,313502,313522
5931,18,41,2,28.44,89.36,313521,313539
5932,19,32,1,26.95,41.21,313538,313557
5933,18,30,3,28.44,38.14,313556,313574
5934,18,30,5,28.44,32.80,313573,313591
5935,18,30,7,28.44,28.36,313590,313608
5936,18,30,9,28.44,24.80,313607,313625
5937,14,141,20,36.57,849.82,313624,313638
5938,19,32,6,26.95,29.21,313637,313656
5939,18,30,7,28.44,28.36,313655,313673
5940,19,35,3,26.95,64.58,313672,313691
5941,19,29,20,26.95,4.37,313690,313709
5942,16,64,13,32.00,87.38,313709,313725
5943,19,32,10,26.95,26.79,313724,313743
5944,17,31,21,30.12,6.57,313742,313759
5945,18,41,1,28.44,63.80,313758,313776
5946,18,50,15,28.44,50.02,313775,313793
5947,18,31,11,28.44,31.02,313792,313810
5948,14,128,20,36.57,654.24,313809,313823
5949,18,31,8,28.44,52.25,313822,313840
5950,17,31,23,30.12,5.87,313839,313856
5951,18,31,7,28.44,52.36,313855,313873
5952,17,31,22,30.12,6.10,313872,313889
5953,18,31,6,28.44,52.69,313888,313906
5954,17,31,21,30.12,6.57,313905,313922
5955,18,31,5,28.44,53.25,313921,313939
5956,17,31,20,30.12,7.28,313938,313955
5957,18,31,4,28.44,54.02,313954,313972
5958,17,31,19,30.12,8.22,313971,313988
5959,18,31,3,28.44,55.02,313987,314005
5960,12,167,6,42.67,1683.22,314004,314016
5961,17,54,20,30.12,45.63,314015,314032
5962,18,31,2,28.44,46.47,314031,314049
5963,19,29,5,26.95,35.21,314048,314067
5964,19,29,6,26.95,37.10,314066,314085
5965,18,29,23,28.44,2.58,314084,314102
5966,19,29,4,26.95,39.00,314101,314120
5967,19,29,5,26.95,37.94,314119,314138
5968,18,29,24,28.44,2.47,314137,314155
5969,19,29,5,26.95,37.94,314154,314173
5970,19,29,4,26.95,39.00,314172,314191
5971,18,29,23,28.44,2.58,314190,314208
5972,12,209,6,42.67,2642.89,314207,314219
5973,19,33,12,26.95,19.31,314218,314237
5974,19,29,9,26.95,35.84,314236,314255
5975,18,29,20,28.44,4.25,314254,314272
5976,18,31,1,28.44,50.91,314271,314289
5977,17,60,3,30.12,109.87,314288,314305
5978,19,37,1,26.95,56.37,314304,314323
5979,18,31,13,28.44,21.80,314322,314340
5980,18,40,14,28.44,27.02,314339,314357
5981,20,32,10,25.60,30.94,314356,314376
5982,17,47,20,30.12,24.34,314375,314392
5983,21,30,5,24.38,40.43,314391,314412
5984,18,31,3,28.44,44.36,314411,314429
5985,17,31,19,30.12,8.22,314428,314445
5986,18,31,4,28.44,54.02,314444,314462
5987,17,31,20,30.12,7.28,314461,314478
5988,14,124,11,36.57,617.10,314477,314491
5989,19,42,1,26.95,78.37,314490,314509
5990,17,31,23,30.12,5.87,314508,314525
5991,18,31,7,28.44,52.36,314524,314542
5992,17,31,22,30.12,5.16,314541,314558
5993,18,31,2,28.44,56.25,314557,314575
5994,17,31,17,30.12,10.81,314574,314591
5995,18,31,1,28.44,57.69,314590,314608
5996,17,31,16,30.12,12.46,314607,314624
5997,14,111,9,36.57,489.24,314624,314638
5998,18,52,10,28.44,57.58,314637,314655
5999,17,31,21,30.12,6.10,314654,314671
6000,18,31,1,28.44,57.69,314670,314688
6001,19,31,16,26.95,23.73,314687,314706
6002,18,31,2,28.44,56.25,314705,314723
6003,17,31,18,30.12,9.40,314722,314739
6004,18,31,3,28.44,55.02,314738,314756
6005,17,31,19,30.12,8.22,314755,314772
6006,18,31,4,28.44,54.02,314771,314789
6007,17,31,20,30.12,7.28,314788,314805
6008,13,109,7,39.38,862.24,314804,314817
6009,18,31,3,28.44,43.36,314816,314834
6010,17,31,19,30.12,8.22,314833,314850
6011,18,31,4,28.44,54.02,314849,314867
6012,17,31,20,30.12,7.28,314866,314883
6013,18,31,5,28.44,53.25,314882,314900
6014,25,31,1,20.48,172.01,314899,314924
6015,17,54,13,30.12,52.34,314923,314940
6016,19,43,5,26.95,60.26,314939,314958
6017,18,30,17,28.44,9.58,314957,314975
6018,17,57,2,30.12,89.52,314974,314991
6019,19,31,13,26.95,15.84,314990,315009
6020,18,30,7,28.44,28.36,315008,315026
6021,19,30,5,26.95,36.68,315025,315044
6022,18,30,14,28.44,19.80,315043,315061
6023,17,51,12,30.12,81.04,315060,315077
6024,19,37,11,26.95,25.94,315076,315095
6025,25,38,1,20.48,159.69,315094,315119
6026,18,33,21,28.44,8.91,315118,315136
6027,18,31,18,28.44,18.80,315136,315154
6028,18,31,3,28.44,55.02,315153,315171
6029,17,31,19,30.12,8.22,315170,315187
6030,15,85,12,34.13,218.25,315186,315201
6031,19,37,6,26.95,44.68,315200,315219
6032,17,31,22,30.12,6.10,315218,315235
6033,18,34,9,28.44,32.69,315234,315252
6034,19,34,12,26.95,31.21,315251,315270
6035,18,31,19,28.44,12.02,315269,315287
6036,18,31,4,28.44,54.02,315286,315304
6037,17,31,20,30.12,7.28,315303,315320
6038,17,73,5,30.12,171.28,315319,315336
6039,19,35,12,26.95,27.73,315335,315354
6040,17,47,18,30.12,25.99,315353,315370
6041,19,37,5,26.95,60.16,315369,315388
6042,19,33,16,26.95,18.89,315387,315406
6043,17,52,12,30.12,63.40,315405,315422
6044,18,33,17,28.44,13.80,315421,315439
6045,37,32,0,13.84,182.78,315438,315475
6046,17,72,6,30.12,152.69,315474,315491
6047,18,32,24,28.44,5.91,315490,315508
6048,19,30,4,26.95,47.84,315507,315526
6049,24,30,0,21.33,127.39,315525,315549
6050,17,53,10,30.12,55.40,315548,315565
6051,18,50,14,28.44,40.69,315564,315582
6052,18,30,2,28.44,41.14,315582,315600
6053,18,30,4,28.44,35.36,315599,315617
6054,21,30,19,24.38,21.28,315616,315637
6055,18,31,1,28.44,57.69,315636,315654
6056,17,31,16,30.12,12.46,315653,315670
6057,15,86,24,34.13,199.72,315670,315685
6058,19,34,2,26.95,60.79,315684,315703
6059,18,31,4,28.44,40.47,315702,315720
6060,18,31,22,28.44,4.69,315719,315737
6061,18,30,8,28.44,26.47,315736,315754
6062,18,30,6,28.44,30.47,315753,315771
6063,18,30,4,28.44,35.36,315770,315788
6064,18,30,2,28.44,41.14,315787,315805
6065,16,106,5,32.00,401.50,315805,315821
6066,18,37,5,28.44,41.80,315820,315838
6067,16,77,6,32.00,171.88,315837,315853
6068,18,32,15,28.44,16.47,315852,315870
6069,18,33,13,28.44,26.80,315869,315887
6070,18,31,12,28.44,31.58,315886,315904
6071,17,39,19,30.12,22.34,315903,315920
6072,18,41,12,28.44,36.14,315919,315937
6073,19,31,11,26.95,38.16,315936,315955
6074,18,30,15,28.44,19.47,315954,315972
6075,18,30,13,28.44,20.36,315971,315989
6076,18,30,11,28.44,22.14,315988,316006
6077,16,112,9,32.00,464.12,316005,316021
6078,18,41,13,28.44,26.02,316020,316038
6079,18,30,7,28.44,28.36,316037,316055
6080,28,30,0,18.29,168.20,316054,316082
6081,18,52,2,28.44,100.25,316081,316099
6082,19,31,7,26.95,25.10,316098,316117
6083,21,31,0,24.38,109.19,316116,316137
6084,17,43,10,30.12,48.93,316136,316153
6085,18,38,21,28.44,16.02,316152,316170
6086,18,31,15,28.44,14.91,316169,316187
6087,18,30,6,28.44,30.14,316186,316204
6088,17,60,1,30.12,138.69,316203,316220
6089,19,34,8,26.95,35.21,316219,316238
6090,18,30,16,28.44,15.69,316237,316255
6091,19,30,9,26.95,39.31,316254,316273
6092,18,30,11,28.44,22.14,316272,316290
6093,18,30,13,28.44,20.36,316289,316307
6094,18,30,15,28.44,19.47,316306,316324
6095,16,71,15,32.00,215.88,316323,316339
6096,18,38,9,28.44,29.47,316338,316356
6097,30,31,0,17.07,197.06,316355,316385
6098,17,31,25,30.12,3.75,316384,316401
6099,18,31,5,28.44,53.25,316400,316418
6100,17,31,20,30.12,7.28,316417,316434
6101,15,91,4,34.13,301.45,316433,316448
6102,19,34,4,26.95,39.42,316447,316466
6103,18,31,11,28.44,22.14,316465,316483
6104,18,31,2,28.44,50.47,316482,316500
6105,17,44,13,30.12,34.10,316499,316516
6106,17,66,10,30.12,106.22,316515,316532
6107,18,41,2,28.44,62.80,316531,316549
6108,18,31,8,28.44,36.47,316548,316566
6109,17,46,19,30.12,27.40,316565,316582
6110,19,35,11,26.95,24.89,316581,316600
6111,29,41,0,17.66,201.88,316599,316628
6112,19,35,12,26.95,31.31,316627,316646
6113,19,37,4,26.95,44.58,316645,316664
6114,19,30,3,26.95,35.00,316663,316682
6115,19,48,6,26.95,53.42,316681,316700
6116,19,31,11,26.95,17.84,316699,316718
6117,18,33,15,28.44,16.91,316717,316735
6118,18,43,5,28.44,49.47,316734,316752
6119,17,42,22,30.12,15.63,316751,316768
6120,18,31,1,28.44,53.36,316767,316785
6121,21,47,0,24.38,169.19,316784,316805
6122,19,35,3,26.95,57.63,316804,316823
6123,21,31,1,24.38,92.43,316822,316843
6124,18,30,9,28.44,24.80,316842,316860
6125,18,30,7,28.44,28.36,316859,316877
6126,18,30,5,28.44,32.80,316876,316894
6127,18,30,3,28.44,38.14,316893,316911
6128,19,30,1,26.95,79.21,316910,316929
6129,15,127,9,34.13,648.65,316928,316943
6130,18,30,20,28.44,10.47,316942,316960
6131,18,31,10,28.44,28.14,316959,316977
6132,18,31,4,28.44,54.02,316976,316994
6133,17,31,20,30.12,7.28,316993,317010
6134,18,31,5,28.44,53.25,317009,317027
6135,17,31,21,30.12,6.57,317026,317043
6136,18,31,6,28.44,52.69,317042,317060
6137,17,31,22,30.12,6.10,317059,317076
6138,16,69,9,32.00,119.50,317075,317091
6139,16,98,2,32.00,351.12,317090,317106
6140,17,31,23,30.12,5.87,317105,317122
6141,18,31,8,28.44,49.80,317121,317139
6142,18,30,14,28.44,19.80,317138,317156
6143,17,78,8,30.12,177.99,317155,317172
6144,18,36,18,28.44,11.58,317171,317189
6145,18,30,3,28.44,38.14,317188,317206
6146,24,30,0,21.33,162.06,317205,317229
6147,18,30,3,28.44,38.14,317228,317246
6148,17,71,1,30.12,153.40,317245,317262
6149,19,31,1,26.95,44.89,317261,317280
6150,18,30,11,28.44,19.25,317279,317297
6151,18,57,4,28.44,99.69,317296,317314
6152,18,30,17,28.44,10.80,317313,317331
6153,18,31,6,28.44,31.02,317330,317348
6154,18,31,4,28.44,54.02,317347,317365
6155,16,71,7,32.00,150.50,317364,317380
6156,18,38,21,28.44,12.91,317379,317397
6157,18,31,5,28.44,53.25,317396,317414
6158,27,35,0,18.96,188.33,317413,317440
6159,19,42,6,26.95,59.10,317439,317458
6160,75,30,0,6.83,104.84,317457,317532
6161,30,31,7,17.07,64.46,317531,317561
6162,21,33,3,24.38,96.05,317560,317581
6163,64,13,0,8.00,24.03,317580,317644
6164,69,12,0,7.42,25.14,317643,317712
6165,81,12,0,6.32,16.22,317711,317792
6166,72,12,0,7.11,19.49,317791,317863
6167,24,35,3,21.33,163.06,317862,317886
6168,20,35,3,25.60,159.44,317885,317905
6169,22,35,7,23.27,138.56,317904,317926
6170,19,35,8,26.95,117.94,317925,317944
6171,20,35,2,25.60,138.14,317943,317963
6172,18,35,12,28.44,104.25,317962,317980
6173,21,35,1,24.38,148.81,317979,318000
6174,69,35,0,7.42,55.11,317999,318068
6175,86,12,0,5.95,20.77,318067,318153
6176,74,19,0,6.92,21.97,318152,318226
6177,66,35,0,7.76,37.30,318225,318291
6178,21,35,3,24.38,138.71,318290,318311
6179,18,34,11,28.44,84.80,318310,318328
6180,24,35,1,21.33,146.89,318327,318351
6181,17,35,9,30.12,85.28,318350,318367
6182,17,35,11,30.12,83.52,318366,318383
6183,22,35,7,23.27,138.56,318382,318404
6184,19,35,4,26.95,127.52,318403,318422
6185,53,35,0,9.66,87.39,318421,318474
6186,61,35,0,8.39,93.52,318473,318534
6187,22,35,12,23.27,121.11,318533,318555
6188,18,35,12,28.44,97.36,318554,318572
6189,23,35,2,22.26,149.24,318571,318594
6190,19,35,3,26.95,147.42,318593,318612
6191,19,35,10,26.95,110.89,318611,318630
6192,24,35,5,21.33,135.39,318629,318653
6193,19,35,3,26.95,123.21,318652,318671
6194,18,35,12,28.44,95.36,318670,318688
6195,20,35,3,25.60,154.64,318687,318707
6196,21,35,6,24.38,140.05,318706,318727
6197,45,35,0,11.38,120.32,318726,318771
6198,24,35,3,21.33,159.56,318770,318794
6199,19,35,8,26.95,119.10,318793,318812
6200,22,35,3,23.27,146.65,318811,318833
6201,22,35,6,23.27,139.65,318832,318854
6202,19,35,12,26.95,108.37,318853,318872
6203,19,35,2,26.95,139.52,318871,318890
6204,20,35,11,25.60,126.04,318889,318909
6205,48,35,0,10.67,102.93,318908,318956
6206,66,12,0,7.76,22.09,318955,319021
6207,44,12,3,11.64,2.55,319020,319064
6208,77,12,0,6.65,17.45,319063,319140
6209,78,12,0,6.56,21.81,319139,319217
6210,36,34,0,14.22,140.73,319216,319252
6211,25,34,2,20.48,125.77,319251,319276
6212,23,34,3,22.26,162.80,319275,319298
6213,91,34,0,5.63,19.97,319298,319389
6214,47,35,0,10.89,146.10,319388,319435
6215,21,35,4,24.38,144.81,319434,319455
6216,20,35,4,25.60,136.44,319454,319474
6217,25,34,4,20.48,159.69,319473,319498
6218,27,30,4,18.96,136.63,319497,319524
6219,24,30,1,21.33,130.89,319523,319547
6220,61,32,0,8.39,81.91,319546,319607
6221,70,12,0,7.31,22.16,319606,319676
6222,80,12,0,6.40,22.74,319675,319755
6223,73,12,0,7.01,19.25,319755,319828
6224,72,12,0,7.11,21.27,319827,319899
6225,74,12,0,6.92,25.62,319898,319972
6226,82,12,0,6.24,18.77,319972,320054
6227,41,35,0,12.49,146.44,320053,320094
6228,22,35,3,23.27,151.11,320093,320115
6229,20,35,6,25.60,134.44,320114,320134
6230,21,35,8,24.38,126.71,320133,320154
6231,22,35,6,23.27,140.83,320153,320175
6232,19,35,6,26.95,122.89,320174,320193
6233,25,35,0,20.48,205.53,320192,320217
6234,75,12,0,6.83,17.10,320216,320291
6235,70,12,0,7.31,23.16,320290,320360
6236,31,35,0,16.52,122.89,320359,320390
6237,20,35,3,25.60,171.04,320389,320409
6238,19,35,5,26.95,123.10,320408,320427
6239,20,35,3,25.60,165.04,320426,320446
6240,19,35,2,26.95,133.00,320445,320464
6241,22,35,5,23.27,141.20,320463,320485
6242,22,35,2,23.27,141.56,320484,320506
6243,65,35,0,7.88,81.55,320505,320570
6244,79,12,0,6.48,16.78,320569,320648
6245,80,12,0,6.40,21.96,320647,320727
6246,69,12,0,7.42,24.21,320726,320795
6247,83,12,0,6.17,21.75,320795,320878
6248,85,12,0,6.02,24.21,320877,320962
6249,75,12,0,6.83,16.68,320961,321036
6250,96,12,0,5.33,18.18,321035,321131
6251,105,30,0,4.88,22.83,321130,321235
6252,53,21,5,9.66,10.49,321234,321287
6253,32,208,1,16.00,1203.06,321286,321318
6254,67,34,0,7.64,17.07,321317,321384
6255,108,26,0,4.74,20.45,321383,321491
6256,456,55,0,1.12,28.69,321490,321946
6257,298,45,0,1.72,16.81,321945,322243
6258,231,31,0,2.22,15.05,322242,322473
6259,223,50,0,2.30,44.85,322472,322695
6260,14,44,6,36.57,99.39,322694,322708
6261,7,305,3,73.14,9149.55,322707,322714
6262,1,512,512,512.00,0.00,322713,322714
6263,178,267,0,2.88,398.61,322713,322891
6264,187,24,0,2.74,7.43,322891,323078
6265,212,33,0,2.42,14.63,323077,323289
6266,80,274,0,6.40,937.59,323288,323368
6267,262,31,0,1.95,10.32,323368,323630
6268,234,32,0,2.19,16.54,323630,323864
6269,39,44,0,13.13,292.27,323863,323902
6270,11,137,7,46.55,922.25,323901,323912
6271,1,512,512,512.00,0.00,323911,323912
6272,85,435,0,6.02,2197.65,323911,323996
6273,171,20,0,2.99,10.61,323995,324166
6274,210,32,0,2.44,8.98,324165,324375
6275,176,22,0,2.91,13.36,324374,324550
6276,220,98,0,2.33,55.98,324550,324770
6277,179,185,0,2.86,196.52,324769,324948
6278,234,92,0,2.19,76.27,324947,325181
6279,179,16,0,2.86,10.02,325180,325359
6280,151,46,0,3.39,28.56,325358,325509
6281,49,43,0,5.71,44.53,325508,325557
