tile_id,n_reduce_rows_num,max_row_length,min_row_length,avg_row_length,variance,start_row,end_row
0,6,109,13,85.33,1095.56,0,6
1,4,199,40,128.00,3277.50,5,9
2,15,168,24,34.13,1280.92,8,23
3,6,126,12,85.33,1651.56,22,28
4,4,196,70,128.00,2209.50,27,31
5,3,231,77,170.67,4508.22,30,33
6,14,167,24,36.57,1380.39,32,46
7,1,512,512,512.00,0.00,45,46
8,2,424,88,256.00,28224.00,45,47
9,1,512,512,512.00,0.00,46,47
10,2,354,158,256.00,9604.00,46,48
11,2,365,147,256.00,11881.00,47,49
12,1,512,512,512.00,0.00,48,49
13,1,512,512,512.00,0.00,48,49
14,2,381,131,256.00,15625.00,48,50
15,1,512,512,512.00,0.00,49,50
16,1,512,512,512.00,0.00,49,50
17,1,512,512,512.00,0.00,49,50
18,2,425,87,256.00,28561.00,49,51
19,1,512,512,512.00,0.00,50,51
20,2,342,170,256.00,7396.00,50,52
21,1,512,512,512.00,0.00,51,52
22,1,512,512,512.00,0.00,51,52
23,2,450,62,256.00,37636.00,51,53
24,1,512,512,512.00,0.00,52,53
25,2,412,100,256.00,24336.00,52,54
26,1,512,512,512.00,0.00,53,54
27,2,505,7,256.00,62001.00,53,55
28,1,512,512,512.00,0.00,54,55
29,2,307,205,256.00,2601.00,54,56
30,2,310,202,256.00,2916.00,55,57
31,6,196,12,85.33,5631.56,56,62
32,1,512,512,512.00,0.00,61,62
33,1,512,512,512.00,0.00,61,62
34,3,210,106,170.67,2123.56,61,64
35,2,288,224,256.00,1024.00,63,65
36,1,512,512,512.00,0.00,64,65
37,1,512,512,512.00,0.00,64,65
38,1,512,512,512.00,0.00,64,65
39,2,338,174,256.00,6724.00,64,66
40,1,512,512,512.00,0.00,65,66
41,1,512,512,512.00,0.00,65,66
42,2,473,39,256.00,47089.00,65,67
43,1,512,512,512.00,0.00,66,67
44,1,512,512,512.00,0.00,66,67
45,1,512,512,512.00,0.00,66,67
46,2,485,27,256.00,52441.00,66,68
47,1,512,512,512.00,0.00,67,68
48,2,308,204,256.00,2704.00,67,69
49,1,512,512,512.00,0.00,68,69
50,1,512,512,512.00,0.00,68,69
51,1,512,512,512.00,0.00,68,69
52,2,343,169,256.00,7569.00,68,70
53,1,512,512,512.00,0.00,69,70
54,1,512,512,512.00,0.00,69,70
55,2,401,111,256.00,21025.00,69,71
56,1,512,512,512.00,0.00,70,71
57,1,512,512,512.00,0.00,70,71
58,1,512,512,512.00,0.00,70,71
59,1,512,512,512.00,0.00,70,71
60,2,314,198,256.00,3364.00,70,72
61,2,276,236,256.00,400.00,71,73
62,2,311,201,256.00,3025.00,72,74
63,1,512,512,512.00,0.00,73,74
64,1,512,512,512.00,0.00,73,74
65,2,494,18,256.00,56644.00,73,75
66,1,512,512,512.00,0.00,74,75
67,1,512,512,512.00,0.00,74,75
68,2,356,156,256.00,10000.00,74,76
69,1,512,512,512.00,0.00,75,76
70,1,512,512,512.00,0.00,75,76
71,1,512,512,512.00,0.00,75,76
72,1,512,512,512.00,0.00,75,76
73,2,457,55,256.00,40401.00,75,77
74,1,512,512,512.00,0.00,76,77
75,2,312,200,256.00,3136.00,76,78
76,1,512,512,512.00,0.00,77,78
77,1,512,512,512.00,0.00,77,78
78,1,512,512,512.00,0.00,77,78
79,1,512,512,512.00,0.00,77,78
80,2,345,167,256.00,7921.00,77,79
81,1,512,512,512.00,0.00,78,79
82,2,300,212,256.00,1936.00,78,80
83,2,462,50,256.00,42436.00,79,81
84,1,512,512,512.00,0.00,80,81
85,1,512,512,512.00,0.00,80,81
86,2,330,182,256.00,5476.00,80,82
87,1,512,512,512.00,0.00,81,82
88,2,274,238,256.00,324.00,81,83
89,1,512,512,512.00,0.00,82,83
90,1,512,512,512.00,0.00,82,83
91,2,446,66,256.00,36100.00,82,84
92,2,480,32,256.00,50176.00,83,85
93,1,512,512,512.00,0.00,84,85
94,1,512,512,512.00,0.00,84,85
95,1,512,512,512.00,0.00,84,85
96,2,376,136,256.00,14400.00,84,86
97,1,512,512,512.00,0.00,85,86
98,1,512,512,512.00,0.00,85,86
99,2,267,245,256.00,121.00,85,87
100,1,512,512,512.00,0.00,86,87
101,2,369,143,256.00,12769.00,86,88
102,2,501,11,256.00,60025.00,87,89
103,2,380,132,256.00,15376.00,88,90
104,1,512,512,512.00,0.00,89,90
105,1,512,512,512.00,0.00,89,90
106,1,512,512,512.00,0.00,89,90
107,1,512,512,512.00,0.00,89,90
108,1,512,512,512.00,0.00,89,90
109,1,512,512,512.00,0.00,89,90
110,2,481,31,256.00,50625.00,89,91
111,2,502,10,256.00,60516.00,90,92
112,1,512,512,512.00,0.00,91,92
113,1,512,512,512.00,0.00,91,92
114,3,302,67,170.67,9586.89,91,94
115,1,512,512,512.00,0.00,93,94
116,1,512,512,512.00,0.00,93,94
117,1,512,512,512.00,0.00,93,94
118,1,512,512,512.00,0.00,93,94
119,2,290,222,256.00,1156.00,93,95
120,1,512,512,512.00,0.00,94,95
121,2,338,174,256.00,6724.00,94,96
122,1,512,512,512.00,0.00,95,96
123,2,344,168,256.00,7744.00,95,97
124,1,512,512,512.00,0.00,96,97
125,1,512,512,512.00,0.00,96,97
126,2,358,154,256.00,10404.00,96,98
127,1,512,512,512.00,0.00,97,98
128,1,512,512,512.00,0.00,97,98
129,2,416,96,256.00,25600.00,97,99
130,1,512,512,512.00,0.00,98,99
131,1,512,512,512.00,0.00,98,99
132,1,512,512,512.00,0.00,98,99
133,2,388,124,256.00,17424.00,98,100
134,2,399,113,256.00,20449.00,99,101
135,1,512,512,512.00,0.00,100,101
136,2,415,97,256.00,25281.00,100,102
137,1,512,512,512.00,0.00,101,102
138,1,512,512,512.00,0.00,101,102
139,1,512,512,512.00,0.00,101,102
140,2,508,4,256.00,63504.00,101,103
141,1,512,512,512.00,0.00,102,103
142,1,512,512,512.00,0.00,102,103
143,1,512,512,512.00,0.00,102,103
144,1,512,512,512.00,0.00,102,103
145,2,375,137,256.00,14161.00,102,104
146,2,473,39,256.00,47089.00,103,105
147,1,512,512,512.00,0.00,104,105
148,1,512,512,512.00,0.00,104,105
149,2,501,11,256.00,60025.00,104,106
150,1,512,512,512.00,0.00,105,106
151,2,353,159,256.00,9409.00,105,107
152,2,477,35,256.00,48841.00,106,108
153,1,512,512,512.00,0.00,107,108
154,1,512,512,512.00,0.00,107,108
155,2,350,162,256.00,8836.00,107,109
156,1,512,512,512.00,0.00,108,109
157,2,279,233,256.00,529.00,108,110
158,2,330,182,256.00,5476.00,109,111
159,1,512,512,512.00,0.00,110,111
160,2,314,198,256.00,3364.00,110,112
161,2,352,160,256.00,9216.00,111,113
162,1,512,512,512.00,0.00,112,113
163,2,302,210,256.00,2116.00,112,114
164,1,512,512,512.00,0.00,113,114
165,1,512,512,512.00,0.00,113,114
166,2,341,171,256.00,7225.00,113,115
167,2,281,231,256.00,625.00,114,116
168,1,512,512,512.00,0.00,115,116
169,2,502,10,256.00,60516.00,115,117
170,1,512,512,512.00,0.00,116,117
171,1,512,512,512.00,0.00,116,117
172,2,343,169,256.00,7569.00,116,118
173,1,512,512,512.00,0.00,117,118
174,2,377,135,256.00,14641.00,117,119
175,1,512,512,512.00,0.00,118,119
176,1,512,512,512.00,0.00,118,119
177,1,512,512,512.00,0.00,118,119
178,2,308,204,256.00,2704.00,118,120
179,1,512,512,512.00,0.00,119,120
180,1,512,512,512.00,0.00,119,120
181,1,512,512,512.00,0.00,119,120
182,2,421,91,256.00,27225.00,119,121
183,1,512,512,512.00,0.00,120,121
184,1,512,512,512.00,0.00,120,121
185,2,401,111,256.00,21025.00,120,122
186,1,512,512,512.00,0.00,121,122
187,1,512,512,512.00,0.00,121,122
188,1,512,512,512.00,0.00,121,122
189,2,496,16,256.00,57600.00,121,123
190,1,512,512,512.00,0.00,122,123
191,2,473,39,256.00,47089.00,122,124
192,1,512,512,512.00,0.00,123,124
193,2,367,145,256.00,12321.00,123,125
194,1,512,512,512.00,0.00,124,125
195,1,512,512,512.00,0.00,124,125
196,2,373,139,256.00,13689.00,124,126
197,2,504,8,256.00,61504.00,125,127
198,2,401,111,256.00,21025.00,126,128
199,1,512,512,512.00,0.00,127,128
200,1,512,512,512.00,0.00,127,128
201,1,512,512,512.00,0.00,127,128
202,2,263,249,256.00,49.00,127,129
203,1,512,512,512.00,0.00,128,129
204,2,499,13,256.00,59049.00,128,130
205,1,512,512,512.00,0.00,129,130
206,1,512,512,512.00,0.00,129,130
207,2,362,150,256.00,11236.00,129,131
208,1,512,512,512.00,0.00,130,131
209,2,407,105,256.00,22801.00,130,132
210,2,289,223,256.00,1089.00,131,133
211,1,512,512,512.00,0.00,132,133
212,2,293,219,256.00,1369.00,132,134
213,1,512,512,512.00,0.00,133,134
214,1,512,512,512.00,0.00,133,134
215,1,512,512,512.00,0.00,133,134
216,2,344,168,256.00,7744.00,133,135
217,1,512,512,512.00,0.00,134,135
218,1,512,512,512.00,0.00,134,135
219,1,512,512,512.00,0.00,134,135
220,1,512,512,512.00,0.00,134,135
221,2,500,12,256.00,59536.00,134,136
222,1,512,512,512.00,0.00,135,136
223,2,494,18,256.00,56644.00,135,137
224,1,512,512,512.00,0.00,136,137
225,2,282,230,256.00,676.00,136,138
226,1,512,512,512.00,0.00,137,138
227,2,313,199,256.00,3249.00,137,139
228,1,512,512,512.00,0.00,138,139
229,1,512,512,512.00,0.00,138,139
230,1,512,512,512.00,0.00,138,139
231,2,285,227,256.00,841.00,138,140
232,1,512,512,512.00,0.00,139,140
233,2,378,134,256.00,14884.00,139,141
234,2,460,52,256.00,41616.00,140,142
235,1,512,512,512.00,0.00,141,142
236,2,421,91,256.00,27225.00,141,143
237,1,512,512,512.00,0.00,142,143
238,1,512,512,512.00,0.00,142,143
239,1,512,512,512.00,0.00,142,143
240,2,403,109,256.00,21609.00,142,144
241,1,512,512,512.00,0.00,143,144
242,2,297,215,256.00,1681.00,143,145
243,1,512,512,512.00,0.00,144,145
244,1,512,512,512.00,0.00,144,145
245,1,512,512,512.00,0.00,144,145
246,2,257,255,256.00,1.00,144,146
247,1,512,512,512.00,0.00,145,146
248,1,512,512,512.00,0.00,145,146
249,2,422,90,256.00,27556.00,145,147
250,1,512,512,512.00,0.00,146,147
251,2,283,229,256.00,729.00,146,148
252,1,512,512,512.00,0.00,147,148
253,1,512,512,512.00,0.00,147,148
254,1,512,512,512.00,0.00,147,148
255,2,311,201,256.00,3025.00,147,149
256,1,512,512,512.00,0.00,148,149
257,1,512,512,512.00,0.00,148,149
258,1,512,512,512.00,0.00,148,149
259,1,512,512,512.00,0.00,148,149
260,2,297,215,256.00,1681.00,148,150
261,1,512,512,512.00,0.00,149,150
262,1,512,512,512.00,0.00,149,150
263,1,512,512,512.00,0.00,149,150
264,2,492,20,256.00,55696.00,149,151
265,1,512,512,512.00,0.00,150,151
266,2,423,89,256.00,27889.00,150,152
267,1,512,512,512.00,0.00,151,152
268,2,364,148,256.00,11664.00,151,153
269,1,512,512,512.00,0.00,152,153
270,2,334,178,256.00,6084.00,152,154
271,1,512,512,512.00,0.00,153,154
272,1,512,512,512.00,0.00,153,154
273,2,374,138,256.00,13924.00,153,155
274,1,512,512,512.00,0.00,154,155
275,1,512,512,512.00,0.00,154,155
276,2,270,242,256.00,196.00,154,156
277,1,512,512,512.00,0.00,155,156
278,1,512,512,512.00,0.00,155,156
279,1,512,512,512.00,0.00,155,156
280,2,474,38,256.00,47524.00,155,157
281,1,512,512,512.00,0.00,156,157
282,1,512,512,512.00,0.00,156,157
283,2,425,87,256.00,28561.00,156,158
284,1,512,512,512.00,0.00,157,158
285,2,343,169,256.00,7569.00,157,159
286,1,512,512,512.00,0.00,158,159
287,1,512,512,512.00,0.00,158,159
288,1,512,512,512.00,0.00,158,159
289,3,261,105,170.67,4360.22,158,161
290,1,512,512,512.00,0.00,160,161
291,2,295,217,256.00,1521.00,160,162
292,1,512,512,512.00,0.00,161,162
293,2,275,237,256.00,361.00,161,163
294,2,440,72,256.00,33856.00,162,164
295,2,428,84,256.00,29584.00,163,165
296,1,512,512,512.00,0.00,164,165
297,2,312,200,256.00,3136.00,164,166
298,1,512,512,512.00,0.00,165,166
299,1,512,512,512.00,0.00,165,166
300,1,512,512,512.00,0.00,165,166
301,1,512,512,512.00,0.00,165,166
302,1,512,512,512.00,0.00,165,166
303,2,294,218,256.00,1444.00,165,167
304,1,512,512,512.00,0.00,166,167
305,1,512,512,512.00,0.00,166,167
306,1,512,512,512.00,0.00,166,167
307,1,512,512,512.00,0.00,166,167
308,2,411,101,256.00,24025.00,166,168
309,1,512,512,512.00,0.00,167,168
310,1,512,512,512.00,0.00,167,168
311,1,512,512,512.00,0.00,167,168
312,1,512,512,512.00,0.00,167,168
313,1,512,512,512.00,0.00,167,168
314,2,500,12,256.00,59536.00,167,169
315,1,512,512,512.00,0.00,168,169
316,1,512,512,512.00,0.00,168,169
317,2,307,205,256.00,2601.00,168,170
318,1,512,512,512.00,0.00,169,170
319,1,512,512,512.00,0.00,169,170
320,1,512,512,512.00,0.00,169,170
321,1,512,512,512.00,0.00,169,170
322,2,415,97,256.00,25281.00,169,171
323,3,349,4,170.67,19905.56,170,173
324,1,512,512,512.00,0.00,172,173
325,1,512,512,512.00,0.00,172,173
326,1,512,512,512.00,0.00,172,173
327,2,441,71,256.00,34225.00,172,174
328,2,310,202,256.00,2916.00,173,175
329,2,321,191,256.00,4225.00,174,176
330,1,512,512,512.00,0.00,175,176
331,1,512,512,512.00,0.00,175,176
332,2,276,236,256.00,400.00,175,177
333,1,512,512,512.00,0.00,176,177
334,1,512,512,512.00,0.00,176,177
335,1,512,512,512.00,0.00,176,177
336,1,512,512,512.00,0.00,176,177
337,2,449,63,256.00,37249.00,176,178
338,1,512,512,512.00,0.00,177,178
339,1,512,512,512.00,0.00,177,178
340,1,512,512,512.00,0.00,177,178
341,1,512,512,512.00,0.00,177,178
342,2,479,33,256.00,49729.00,177,179
343,1,512,512,512.00,0.00,178,179
344,1,512,512,512.00,0.00,178,179
345,1,512,512,512.00,0.00,178,179
346,1,512,512,512.00,0.00,178,179
347,2,497,15,256.00,58081.00,178,180
348,1,512,512,512.00,0.00,179,180
349,1,512,512,512.00,0.00,179,180
350,1,512,512,512.00,0.00,179,180
351,1,512,512,512.00,0.00,179,180
352,1,512,512,512.00,0.00,179,180
353,3,329,38,170.67,14442.89,179,182
354,1,512,512,512.00,0.00,181,182
355,2,267,245,256.00,121.00,181,183
356,1,512,512,512.00,0.00,182,183
357,1,512,512,512.00,0.00,182,183
358,2,286,226,256.00,900.00,182,184
359,1,512,512,512.00,0.00,183,184
360,2,403,109,256.00,21609.00,183,185
361,2,452,60,256.00,38416.00,184,186
362,2,463,49,256.00,42849.00,185,187
363,1,512,512,512.00,0.00,186,187
364,1,512,512,512.00,0.00,186,187
365,3,188,138,170.67,534.22,186,189
366,1,512,512,512.00,0.00,188,189
367,1,512,512,512.00,0.00,188,189
368,1,512,512,512.00,0.00,188,189
369,2,406,106,256.00,22500.00,188,190
370,1,512,512,512.00,0.00,189,190
371,1,512,512,512.00,0.00,189,190
372,2,308,204,256.00,2704.00,189,191
373,1,512,512,512.00,0.00,190,191
374,4,240,41,128.00,5809.50,190,194
375,1,512,512,512.00,0.00,193,194
376,1,512,512,512.00,0.00,193,194
377,1,512,512,512.00,0.00,193,194
378,3,323,1,170.67,17430.89,193,196
379,1,512,512,512.00,0.00,195,196
380,2,447,65,256.00,36481.00,195,197
381,4,281,41,128.00,8489.00,196,200
382,1,512,512,512.00,0.00,199,200
383,3,329,46,170.67,13914.89,199,202
384,1,512,512,512.00,0.00,201,202
385,1,512,512,512.00,0.00,201,202
386,1,512,512,512.00,0.00,201,202
387,1,512,512,512.00,0.00,201,202
388,1,512,512,512.00,0.00,201,202
389,4,391,37,128.00,23068.50,201,205
390,1,512,512,512.00,0.00,204,205
391,1,512,512,512.00,0.00,204,205
392,2,447,65,256.00,36481.00,204,206
393,1,512,512,512.00,0.00,205,206
394,1,512,512,512.00,0.00,205,206
395,2,364,148,256.00,11664.00,205,207
396,2,423,89,256.00,27889.00,206,208
397,1,512,512,512.00,0.00,207,208
398,1,512,512,512.00,0.00,207,208
399,1,512,512,512.00,0.00,207,208
400,1,512,512,512.00,0.00,207,208
401,1,512,512,512.00,0.00,207,208
402,2,434,78,256.00,31684.00,207,209
403,3,388,1,170.67,26097.56,208,211
404,1,512,512,512.00,0.00,210,211
405,1,512,512,512.00,0.00,210,211
406,1,512,512,512.00,0.00,210,211
407,1,512,512,512.00,0.00,210,211
408,1,512,512,512.00,0.00,210,211
409,2,419,93,256.00,26569.00,210,212
410,1,512,512,512.00,0.00,211,212
411,1,512,512,512.00,0.00,211,212
412,1,512,512,512.00,0.00,211,212
413,1,512,512,512.00,0.00,211,212
414,1,512,512,512.00,0.00,211,212
415,2,475,37,256.00,47961.00,211,213
416,1,512,512,512.00,0.00,212,213
417,2,370,142,256.00,12996.00,212,214
418,1,512,512,512.00,0.00,213,214
419,1,512,512,512.00,0.00,213,214
420,1,512,512,512.00,0.00,213,214
421,1,512,512,512.00,0.00,213,214
422,2,502,10,256.00,60516.00,213,215
423,1,512,512,512.00,0.00,214,215
424,1,512,512,512.00,0.00,214,215
425,1,512,512,512.00,0.00,214,215
426,1,512,512,512.00,0.00,214,215
427,2,378,134,256.00,14884.00,214,216
428,1,512,512,512.00,0.00,215,216
429,1,512,512,512.00,0.00,215,216
430,3,240,73,170.67,5049.56,215,218
431,1,512,512,512.00,0.00,217,218
432,1,512,512,512.00,0.00,217,218
433,2,351,161,256.00,9025.00,217,219
434,1,512,512,512.00,0.00,218,219
435,2,272,240,256.00,256.00,218,220
436,1,512,512,512.00,0.00,219,220
437,1,512,512,512.00,0.00,219,220
438,2,367,145,256.00,12321.00,219,221
439,1,512,512,512.00,0.00,220,221
440,2,424,88,256.00,28224.00,220,222
441,1,512,512,512.00,0.00,221,222
442,2,286,226,256.00,900.00,221,223
443,1,512,512,512.00,0.00,222,223
444,2,397,115,256.00,19881.00,222,224
445,1,512,512,512.00,0.00,223,224
446,1,512,512,512.00,0.00,223,224
447,1,512,512,512.00,0.00,223,224
448,2,428,84,256.00,29584.00,223,225
449,1,512,512,512.00,0.00,224,225
450,1,512,512,512.00,0.00,224,225
451,1,512,512,512.00,0.00,224,225
452,2,267,245,256.00,121.00,224,226
453,1,512,512,512.00,0.00,225,226
454,1,512,512,512.00,0.00,225,226
455,1,512,512,512.00,0.00,225,226
456,1,512,512,512.00,0.00,225,226
457,3,310,1,170.67,16373.56,225,228
458,1,512,512,512.00,0.00,227,228
459,4,282,3,128.00,9941.50,227,231
460,1,512,512,512.00,0.00,230,231
461,3,328,4,170.67,17539.56,230,233
462,1,512,512,512.00,0.00,232,233
463,1,512,512,512.00,0.00,232,233
464,1,512,512,512.00,0.00,232,233
465,2,309,203,256.00,2809.00,232,234
466,1,512,512,512.00,0.00,233,234
467,1,512,512,512.00,0.00,233,234
468,1,512,512,512.00,0.00,233,234
469,1,512,512,512.00,0.00,233,234
470,1,512,512,512.00,0.00,233,234
471,3,191,130,170.67,826.89,233,236
472,1,512,512,512.00,0.00,235,236
473,1,512,512,512.00,0.00,235,236
474,1,512,512,512.00,0.00,235,236
475,3,286,3,170.67,14717.56,235,238
476,1,512,512,512.00,0.00,237,238
477,6,294,5,85.33,10315.56,237,243
478,2,417,95,256.00,25921.00,242,244
479,1,512,512,512.00,0.00,243,244
480,2,285,227,256.00,841.00,243,245
481,2,350,162,256.00,8836.00,244,246
482,1,512,512,512.00,0.00,245,246
483,1,512,512,512.00,0.00,245,246
484,2,432,80,256.00,30976.00,245,247
485,1,512,512,512.00,0.00,246,247
486,1,512,512,512.00,0.00,246,247
487,1,512,512,512.00,0.00,246,247
488,1,512,512,512.00,0.00,246,247
489,1,512,512,512.00,0.00,246,247
490,3,486,6,170.67,49750.22,246,249
491,5,271,12,102.40,9719.44,248,253
492,1,512,512,512.00,0.00,252,253
493,1,512,512,512.00,0.00,252,253
494,1,512,512,512.00,0.00,252,253
495,1,512,512,512.00,0.00,252,253
496,2,307,205,256.00,2601.00,252,254
497,1,512,512,512.00,0.00,253,254
498,2,401,111,256.00,21025.00,253,255
499,1,512,512,512.00,0.00,254,255
500,1,512,512,512.00,0.00,254,255
501,1,512,512,512.00,0.00,254,255
502,1,512,512,512.00,0.00,254,255
503,1,512,512,512.00,0.00,254,255
504,3,249,16,170.67,11961.56,254,257
505,1,512,512,512.00,0.00,256,257
506,1,512,512,512.00,0.00,256,257
507,1,512,512,512.00,0.00,256,257
508,1,512,512,512.00,0.00,256,257
509,2,299,213,256.00,1849.00,256,258
510,1,512,512,512.00,0.00,257,258
511,1,512,512,512.00,0.00,257,258
512,1,512,512,512.00,0.00,257,258
513,2,267,245,256.00,121.00,257,259
514,3,308,52,170.67,11096.89,258,261
515,2,356,156,256.00,10000.00,260,262
516,1,512,512,512.00,0.00,261,262
517,1,512,512,512.00,0.00,261,262
518,1,512,512,512.00,0.00,261,262
519,1,512,512,512.00,0.00,261,262
520,1,512,512,512.00,0.00,261,262
521,3,266,29,170.67,10434.89,261,264
522,1,512,512,512.00,0.00,263,264
523,1,512,512,512.00,0.00,263,264
524,1,512,512,512.00,0.00,263,264
525,1,512,512,512.00,0.00,263,264
526,1,512,512,512.00,0.00,263,264
527,2,494,18,256.00,56644.00,263,265
528,1,512,512,512.00,0.00,264,265
529,1,512,512,512.00,0.00,264,265
530,3,299,78,170.67,8776.22,264,267
531,1,512,512,512.00,0.00,266,267
532,1,512,512,512.00,0.00,266,267
533,1,512,512,512.00,0.00,266,267
534,1,512,512,512.00,0.00,266,267
535,1,512,512,512.00,0.00,266,267
536,2,398,114,256.00,20164.00,266,268
537,1,512,512,512.00,0.00,267,268
538,1,512,512,512.00,0.00,267,268
539,4,233,20,128.00,10723.50,267,271
540,1,512,512,512.00,0.00,270,271
541,1,512,512,512.00,0.00,270,271
542,3,221,86,170.67,3626.89,270,273
543,1,512,512,512.00,0.00,272,273
544,1,512,512,512.00,0.00,272,273
545,1,512,512,512.00,0.00,272,273
546,2,376,136,256.00,14400.00,272,274
547,1,512,512,512.00,0.00,273,274
548,1,512,512,512.00,0.00,273,274
549,2,379,133,256.00,15129.00,273,275
550,1,512,512,512.00,0.00,274,275
551,2,386,126,256.00,16900.00,274,276
552,1,512,512,512.00,0.00,275,276
553,2,332,180,256.00,5776.00,275,277
554,1,512,512,512.00,0.00,276,277
555,3,240,57,170.67,6564.22,276,279
556,1,512,512,512.00,0.00,278,279
557,1,512,512,512.00,0.00,278,279
558,1,512,512,512.00,0.00,278,279
559,1,512,512,512.00,0.00,278,279
560,5,307,27,102.40,10883.84,278,283
561,1,512,512,512.00,0.00,282,283
562,1,512,512,512.00,0.00,282,283
563,2,511,1,256.00,65025.00,282,284
564,1,512,512,512.00,0.00,283,284
565,2,291,221,256.00,1225.00,283,285
566,2,500,12,256.00,59536.00,284,286
567,1,512,512,512.00,0.00,285,286
568,1,512,512,512.00,0.00,285,286
569,1,512,512,512.00,0.00,285,286
570,2,492,20,256.00,55696.00,285,287
571,2,448,64,256.00,36864.00,286,288
572,1,512,512,512.00,0.00,287,288
573,3,504,2,170.67,55558.22,287,290
574,3,225,98,170.67,2856.22,289,292
575,5,270,3,102.40,8877.84,291,296
576,1,512,512,512.00,0.00,295,296
577,5,187,22,102.40,4051.84,295,300
578,2,377,135,256.00,14641.00,299,301
579,2,350,162,256.00,8836.00,300,302
580,2,461,51,256.00,42025.00,301,303
581,1,512,512,512.00,0.00,302,303
582,1,512,512,512.00,0.00,302,303
583,2,391,121,256.00,18225.00,302,304
584,1,512,512,512.00,0.00,303,304
585,1,512,512,512.00,0.00,303,304
586,1,512,512,512.00,0.00,303,304
587,2,259,253,256.00,9.00,303,305
588,1,512,512,512.00,0.00,304,305
589,2,285,227,256.00,841.00,304,306
590,2,300,212,256.00,1936.00,305,307
591,1,512,512,512.00,0.00,306,307
592,1,512,512,512.00,0.00,306,307
593,2,387,125,256.00,17161.00,306,308
594,2,373,139,256.00,13689.00,307,309
595,1,512,512,512.00,0.00,308,309
596,1,512,512,512.00,0.00,308,309
597,1,512,512,512.00,0.00,308,309
598,1,512,512,512.00,0.00,308,309
599,1,512,512,512.00,0.00,308,309
600,1,512,512,512.00,0.00,308,309
601,2,468,44,256.00,44944.00,308,310
602,1,512,512,512.00,0.00,309,310
603,1,512,512,512.00,0.00,309,310
604,1,512,512,512.00,0.00,309,310
605,1,512,512,512.00,0.00,309,310
606,2,491,21,256.00,55225.00,309,311
607,1,512,512,512.00,0.00,310,311
608,1,512,512,512.00,0.00,310,311
609,2,458,54,256.00,40804.00,310,312
610,1,512,512,512.00,0.00,311,312
611,1,512,512,512.00,0.00,311,312
612,1,512,512,512.00,0.00,311,312
613,2,508,4,256.00,63504.00,311,313
614,1,512,512,512.00,0.00,312,313
615,1,512,512,512.00,0.00,312,313
616,2,388,124,256.00,17424.00,312,314
617,1,512,512,512.00,0.00,313,314
618,2,441,71,256.00,34225.00,313,315
619,1,512,512,512.00,0.00,314,315
620,1,512,512,512.00,0.00,314,315
621,1,512,512,512.00,0.00,314,315
622,4,254,28,128.00,9441.50,314,318
623,3,251,83,170.67,4730.89,317,320
624,1,512,512,512.00,0.00,319,320
625,1,512,512,512.00,0.00,319,320
626,1,512,512,512.00,0.00,319,320
627,1,512,512,512.00,0.00,319,320
628,2,310,202,256.00,2916.00,319,321
629,1,512,512,512.00,0.00,320,321
630,1,512,512,512.00,0.00,320,321
631,1,512,512,512.00,0.00,320,321
632,1,512,512,512.00,0.00,320,321
633,3,430,33,170.67,33669.56,320,323
634,1,512,512,512.00,0.00,322,323
635,2,279,233,256.00,529.00,322,324
636,1,512,512,512.00,0.00,323,324
637,2,410,102,256.00,23716.00,323,325
638,1,512,512,512.00,0.00,324,325
639,3,341,20,170.67,17366.89,324,327
640,2,485,27,256.00,52441.00,326,328
641,1,512,512,512.00,0.00,327,328
642,2,275,237,256.00,361.00,327,329
643,1,512,512,512.00,0.00,328,329
644,1,512,512,512.00,0.00,328,329
645,1,512,512,512.00,0.00,328,329
646,4,399,4,128.00,25025.50,328,332
647,1,512,512,512.00,0.00,331,332
648,4,266,1,128.00,9336.50,331,335
649,3,286,43,170.67,9917.56,334,337
650,1,512,512,512.00,0.00,336,337
651,4,454,6,128.00,35510.00,336,340
652,1,512,512,512.00,0.00,339,340
653,1,512,512,512.00,0.00,339,340
654,1,512,512,512.00,0.00,339,340
655,1,512,512,512.00,0.00,339,340
656,2,297,215,256.00,1681.00,339,341
657,1,512,512,512.00,0.00,340,341
658,2,507,5,256.00,63001.00,340,342
659,2,492,20,256.00,55696.00,341,343
660,2,310,202,256.00,2916.00,342,344
661,2,423,89,256.00,27889.00,343,345
662,1,512,512,512.00,0.00,344,345
663,1,512,512,512.00,0.00,344,345
664,2,286,226,256.00,900.00,344,346
665,2,486,26,256.00,52900.00,345,347
666,2,362,150,256.00,11236.00,346,348
667,3,249,19,170.67,11505.56,347,350
668,2,442,70,256.00,34596.00,349,351
669,1,512,512,512.00,0.00,350,351
670,2,411,101,256.00,24025.00,350,352
671,1,512,512,512.00,0.00,351,352
672,1,512,512,512.00,0.00,351,352
673,1,512,512,512.00,0.00,351,352
674,1,512,512,512.00,0.00,351,352
675,5,187,16,102.40,5086.24,351,356
676,1,512,512,512.00,0.00,355,356
677,2,492,20,256.00,55696.00,355,357
678,1,512,512,512.00,0.00,356,357
679,1,512,512,512.00,0.00,356,357
680,1,512,512,512.00,0.00,356,357
681,1,512,512,512.00,0.00,356,357
682,2,411,101,256.00,24025.00,356,358
683,1,512,512,512.00,0.00,357,358
684,1,512,512,512.00,0.00,357,358
685,1,512,512,512.00,0.00,357,358
686,4,326,17,128.00,14233.50,357,361
687,1,512,512,512.00,0.00,360,361
688,1,512,512,512.00,0.00,360,361
689,2,481,31,256.00,50625.00,360,362
690,1,512,512,512.00,0.00,361,362
691,1,512,512,512.00,0.00,361,362
692,1,512,512,512.00,0.00,361,362
693,2,406,106,256.00,22500.00,361,363
694,1,512,512,512.00,0.00,362,363
695,3,489,11,170.67,50668.22,362,365
696,1,512,512,512.00,0.00,364,365
697,1,512,512,512.00,0.00,364,365
698,2,264,248,256.00,64.00,364,366
699,2,409,103,256.00,23409.00,365,367
700,2,370,142,256.00,12996.00,366,368
701,1,512,512,512.00,0.00,367,368
702,2,491,21,256.00,55225.00,367,369
703,1,512,512,512.00,0.00,368,369
704,1,512,512,512.00,0.00,368,369
705,3,443,1,170.67,37830.89,368,371
706,2,277,235,256.00,441.00,370,372
707,1,512,512,512.00,0.00,371,372
708,1,512,512,512.00,0.00,371,372
709,2,467,45,256.00,44521.00,372,374
710,1,512,512,512.00,0.00,373,374
711,2,373,139,256.00,13689.00,373,375
712,1,512,512,512.00,0.00,374,375
713,1,512,512,512.00,0.00,374,375
714,1,512,512,512.00,0.00,374,375
715,1,512,512,512.00,0.00,374,375
716,2,439,73,256.00,33489.00,374,376
717,1,512,512,512.00,0.00,375,376
718,1,512,512,512.00,0.00,375,376
719,2,278,234,256.00,484.00,375,377
720,1,512,512,512.00,0.00,376,377
721,3,285,13,170.67,13269.56,376,379
722,1,512,512,512.00,0.00,378,379
723,2,509,3,256.00,64009.00,378,380
724,1,512,512,512.00,0.00,379,380
725,1,512,512,512.00,0.00,379,380
726,1,512,512,512.00,0.00,379,380
727,1,512,512,512.00,0.00,379,380
728,2,343,169,256.00,7569.00,379,381
729,1,512,512,512.00,0.00,380,381
730,2,315,197,256.00,3481.00,380,382
731,1,512,512,512.00,0.00,381,382
732,2,343,169,256.00,7569.00,381,383
733,1,512,512,512.00,0.00,382,383
734,1,512,512,512.00,0.00,382,383
735,3,327,75,170.67,12424.22,382,385
736,1,512,512,512.00,0.00,384,385
737,1,512,512,512.00,0.00,384,385
738,1,512,512,512.00,0.00,384,385
739,1,512,512,512.00,0.00,384,385
740,2,441,71,256.00,34225.00,384,386
741,2,300,212,256.00,1936.00,385,387
742,2,379,133,256.00,15129.00,386,388
743,3,274,40,170.67,9499.56,387,390
744,3,177,161,170.67,48.22,389,392
745,2,489,23,256.00,54289.00,391,393
746,1,512,512,512.00,0.00,392,393
747,1,512,512,512.00,0.00,392,393
748,3,392,6,170.67,26438.22,392,395
749,1,512,512,512.00,0.00,394,395
750,1,512,512,512.00,0.00,394,395
751,5,392,2,102.40,21784.24,394,399
752,1,512,512,512.00,0.00,398,399
753,1,512,512,512.00,0.00,398,399
754,2,330,182,256.00,5476.00,398,400
755,1,512,512,512.00,0.00,399,400
756,1,512,512,512.00,0.00,399,400
757,1,512,512,512.00,0.00,399,400
758,1,512,512,512.00,0.00,399,400
759,5,166,30,102.40,3210.24,399,404
760,2,257,255,256.00,1.00,403,405
761,4,309,10,128.00,13707.50,404,408
762,1,512,512,512.00,0.00,407,408
763,2,372,140,256.00,13456.00,407,409
764,1,512,512,512.00,0.00,408,409
765,1,512,512,512.00,0.00,408,409
766,1,512,512,512.00,0.00,408,409
767,1,512,512,512.00,0.00,408,409
768,2,369,143,256.00,12769.00,408,410
769,1,512,512,512.00,0.00,409,410
770,1,512,512,512.00,0.00,409,410
771,1,512,512,512.00,0.00,409,410
772,1,512,512,512.00,0.00,409,410
773,1,512,512,512.00,0.00,409,410
774,1,512,512,512.00,0.00,409,410
775,2,386,126,256.00,16900.00,409,411
776,2,506,6,256.00,62500.00,410,412
777,2,415,97,256.00,25281.00,411,413
778,1,512,512,512.00,0.00,412,413
779,1,512,512,512.00,0.00,412,413
780,1,512,512,512.00,0.00,412,413
781,1,512,512,512.00,0.00,412,413
782,2,502,10,256.00,60516.00,412,414
783,1,512,512,512.00,0.00,413,414
784,1,512,512,512.00,0.00,413,414
785,2,451,61,256.00,38025.00,413,415
786,1,512,512,512.00,0.00,414,415
787,1,512,512,512.00,0.00,414,415
788,1,512,512,512.00,0.00,414,415
789,1,512,512,512.00,0.00,414,415
790,3,320,61,170.67,11966.89,414,417
791,3,243,54,170.67,6936.22,416,419
792,1,512,512,512.00,0.00,418,419
793,1,512,512,512.00,0.00,418,419
794,1,512,512,512.00,0.00,418,419
795,1,512,512,512.00,0.00,418,419
796,3,223,89,170.67,3422.89,418,421
797,1,512,512,512.00,0.00,420,421
798,1,512,512,512.00,0.00,420,421
799,2,434,78,256.00,31684.00,420,422
800,1,512,512,512.00,0.00,421,422
801,1,512,512,512.00,0.00,421,422
802,1,512,512,512.00,0.00,421,422
803,2,281,231,256.00,625.00,421,423
804,1,512,512,512.00,0.00,422,423
805,1,512,512,512.00,0.00,422,423
806,1,512,512,512.00,0.00,422,423
807,3,417,34,170.67,30461.56,422,425
808,1,512,512,512.00,0.00,424,425
809,1,512,512,512.00,0.00,424,425
810,1,512,512,512.00,0.00,424,425
811,1,512,512,512.00,0.00,424,425
812,2,445,67,256.00,35721.00,424,426
813,1,512,512,512.00,0.00,425,426
814,1,512,512,512.00,0.00,425,426
815,1,512,512,512.00,0.00,425,426
816,1,512,512,512.00,0.00,425,426
817,3,292,49,170.67,9841.56,425,428
818,3,411,41,170.67,28940.22,427,430
819,1,512,512,512.00,0.00,429,430
820,2,262,250,256.00,36.00,429,431
821,1,512,512,512.00,0.00,430,431
822,1,512,512,512.00,0.00,430,431
823,1,512,512,512.00,0.00,430,431
824,2,393,119,256.00,18769.00,430,432
825,1,512,512,512.00,0.00,431,432
826,1,512,512,512.00,0.00,431,432
827,1,512,512,512.00,0.00,431,432
828,1,512,512,512.00,0.00,431,432
829,1,512,512,512.00,0.00,431,432
830,2,376,136,256.00,14400.00,431,433
831,1,512,512,512.00,0.00,432,433
832,1,512,512,512.00,0.00,432,433
833,5,355,7,102.40,16351.84,432,437
834,1,512,512,512.00,0.00,436,437
835,1,512,512,512.00,0.00,436,437
836,1,512,512,512.00,0.00,436,437
837,1,512,512,512.00,0.00,436,437
838,1,512,512,512.00,0.00,436,437
839,3,311,92,170.67,9894.89,436,439
840,1,512,512,512.00,0.00,438,439
841,1,512,512,512.00,0.00,438,439
842,2,480,32,256.00,50176.00,438,440
843,1,512,512,512.00,0.00,439,440
844,1,512,512,512.00,0.00,439,440
845,1,512,512,512.00,0.00,439,440
846,1,512,512,512.00,0.00,439,440
847,2,402,110,256.00,21316.00,439,441
848,3,264,1,170.67,14441.56,440,443
849,1,512,512,512.00,0.00,442,443
850,1,512,512,512.00,0.00,442,443
851,5,272,1,102.40,11322.64,442,447
852,1,512,512,512.00,0.00,446,447
853,1,512,512,512.00,0.00,446,447
854,1,512,512,512.00,0.00,446,447
855,3,417,9,170.67,31328.22,446,449
856,1,512,512,512.00,0.00,448,449
857,1,512,512,512.00,0.00,448,449
858,3,471,7,170.67,45221.56,448,451
859,1,512,512,512.00,0.00,450,451
860,1,512,512,512.00,0.00,450,451
861,2,477,35,256.00,48841.00,450,452
862,1,512,512,512.00,0.00,451,452
863,1,512,512,512.00,0.00,451,452
864,2,290,222,256.00,1156.00,451,453
865,1,512,512,512.00,0.00,452,453
866,1,512,512,512.00,0.00,452,453
867,1,512,512,512.00,0.00,452,453
868,2,453,59,256.00,38809.00,452,454
869,1,512,512,512.00,0.00,453,454
870,1,512,512,512.00,0.00,453,454
871,2,484,28,256.00,51984.00,453,455
872,1,512,512,512.00,0.00,454,455
873,1,512,512,512.00,0.00,454,455
874,2,492,20,256.00,55696.00,454,456
875,1,512,512,512.00,0.00,455,456
876,1,512,512,512.00,0.00,455,456
877,2,446,66,256.00,36100.00,455,457
878,1,512,512,512.00,0.00,456,457
879,1,512,512,512.00,0.00,456,457
880,3,351,8,170.67,19764.22,456,459
881,2,272,240,256.00,256.00,458,460
882,1,512,512,512.00,0.00,459,460
883,1,512,512,512.00,0.00,459,460
884,1,512,512,512.00,0.00,459,460
885,2,478,34,256.00,49284.00,459,461
886,1,512,512,512.00,0.00,460,461
887,2,499,13,256.00,59049.00,460,462
888,2,376,136,256.00,14400.00,461,463
889,1,512,512,512.00,0.00,462,463
890,1,512,512,512.00,0.00,462,463
891,1,512,512,512.00,0.00,462,463
892,1,512,512,512.00,0.00,462,463
893,1,512,512,512.00,0.00,462,463
894,3,211,109,170.67,1961.56,462,465
895,1,512,512,512.00,0.00,464,465
896,1,512,512,512.00,0.00,464,465
897,1,512,512,512.00,0.00,464,465
898,1,512,512,512.00,0.00,464,465
899,2,453,59,256.00,38809.00,464,466
900,1,512,512,512.00,0.00,465,466
901,1,512,512,512.00,0.00,465,466
902,1,512,512,512.00,0.00,465,466
903,1,512,512,512.00,0.00,465,466
904,1,512,512,512.00,0.00,465,466
905,2,490,22,256.00,54756.00,465,467
906,2,406,106,256.00,22500.00,466,468
907,1,512,512,512.00,0.00,467,468
908,1,512,512,512.00,0.00,467,468
909,1,512,512,512.00,0.00,467,468
910,1,512,512,512.00,0.00,467,468
911,2,367,145,256.00,12321.00,467,469
912,1,512,512,512.00,0.00,468,469
913,1,512,512,512.00,0.00,468,469
914,2,404,108,256.00,21904.00,468,470
915,2,378,134,256.00,14884.00,469,471
916,1,512,512,512.00,0.00,470,471
917,1,512,512,512.00,0.00,470,471
918,3,403,6,170.67,28557.56,470,473
919,2,465,47,256.00,43681.00,472,474
920,1,512,512,512.00,0.00,473,474
921,1,512,512,512.00,0.00,473,474
922,1,512,512,512.00,0.00,473,474
923,4,326,2,128.00,17538.50,473,477
924,1,512,512,512.00,0.00,476,477
925,1,512,512,512.00,0.00,476,477
926,2,280,232,256.00,576.00,476,478
927,1,512,512,512.00,0.00,477,478
928,2,471,41,256.00,46225.00,477,479
929,1,512,512,512.00,0.00,478,479
930,2,384,128,256.00,16384.00,478,480
931,3,377,38,170.67,21866.89,479,482
932,1,512,512,512.00,0.00,481,482
933,1,512,512,512.00,0.00,481,482
934,2,469,43,256.00,45369.00,481,483
935,1,512,512,512.00,0.00,482,483
936,1,512,512,512.00,0.00,482,483
937,2,448,64,256.00,36864.00,482,484
938,1,512,512,512.00,0.00,483,484
939,2,459,53,256.00,41209.00,483,485
940,1,512,512,512.00,0.00,484,485
941,1,512,512,512.00,0.00,484,485
942,2,316,196,256.00,3600.00,484,486
943,1,512,512,512.00,0.00,485,486
944,2,341,171,256.00,7225.00,485,487
945,2,305,207,256.00,2401.00,486,488
946,1,512,512,512.00,0.00,487,488
947,1,512,512,512.00,0.00,487,488
948,2,401,111,256.00,21025.00,487,489
949,1,512,512,512.00,0.00,488,489
950,1,512,512,512.00,0.00,488,489
951,2,348,164,256.00,8464.00,488,490
952,1,512,512,512.00,0.00,489,490
953,1,512,512,512.00,0.00,489,490
954,1,512,512,512.00,0.00,489,490
955,1,512,512,512.00,0.00,489,490
956,1,512,512,512.00,0.00,489,490
957,2,399,113,256.00,20449.00,489,491
958,1,512,512,512.00,0.00,490,491
959,3,401,5,170.67,28226.89,490,493
960,2,376,136,256.00,14400.00,492,494
961,1,512,512,512.00,0.00,493,494
962,1,512,512,512.00,0.00,493,494
963,1,512,512,512.00,0.00,493,494
964,2,444,68,256.00,35344.00,493,495
965,1,512,512,512.00,0.00,494,495
966,1,512,512,512.00,0.00,494,495
967,1,512,512,512.00,0.00,494,495
968,1,512,512,512.00,0.00,494,495
969,1,512,512,512.00,0.00,494,495
970,2,347,165,256.00,8281.00,494,496
971,2,465,47,256.00,43681.00,495,497
972,1,512,512,512.00,0.00,496,497
973,1,512,512,512.00,0.00,496,497
974,3,323,80,170.67,11742.89,496,499
975,1,512,512,512.00,0.00,498,499
976,3,302,33,170.67,12080.22,498,501
977,1,512,512,512.00,0.00,500,501
978,1,512,512,512.00,0.00,500,501
979,1,512,512,512.00,0.00,500,501
980,1,512,512,512.00,0.00,500,501
981,3,242,73,170.67,5106.89,500,503
982,1,512,512,512.00,0.00,502,503
983,1,512,512,512.00,0.00,502,503
984,2,426,86,256.00,28900.00,502,504
985,1,512,512,512.00,0.00,503,504
986,2,359,153,256.00,10609.00,503,505
987,1,512,512,512.00,0.00,504,505
988,1,512,512,512.00,0.00,504,505
989,1,512,512,512.00,0.00,504,505
990,3,367,16,170.67,21401.56,504,507
991,1,512,512,512.00,0.00,506,507
992,2,277,235,256.00,441.00,506,508
993,1,512,512,512.00,0.00,507,508
994,3,335,19,170.67,16722.89,507,510
995,1,512,512,512.00,0.00,509,510
996,1,512,512,512.00,0.00,509,510
997,2,371,141,256.00,13225.00,509,511
998,3,490,2,170.67,51040.89,510,513
999,1,512,512,512.00,0.00,512,513
1000,1,512,512,512.00,0.00,512,513
1001,2,259,253,256.00,9.00,512,514
1002,1,512,512,512.00,0.00,513,514
1003,1,512,512,512.00,0.00,513,514
1004,2,476,36,256.00,48400.00,513,515
1005,1,512,512,512.00,0.00,514,515
1006,2,357,155,256.00,10201.00,514,516
1007,6,144,27,85.33,1718.22,515,521
1008,1,512,512,512.00,0.00,520,521
1009,2,478,34,256.00,49284.00,520,522
1010,1,512,512,512.00,0.00,521,522
1011,1,512,512,512.00,0.00,521,522
1012,1,512,512,512.00,0.00,521,522
1013,4,251,45,128.00,6809.00,521,525
1014,2,437,75,256.00,32761.00,524,526
1015,1,512,512,512.00,0.00,525,526
1016,1,512,512,512.00,0.00,525,526
1017,1,512,512,512.00,0.00,525,526
1018,2,321,191,256.00,4225.00,525,527
1019,1,512,512,512.00,0.00,526,527
1020,1,512,512,512.00,0.00,526,527
1021,2,264,248,256.00,64.00,526,528
1022,1,512,512,512.00,0.00,527,528
1023,3,303,31,170.67,12357.56,527,530
1024,1,512,512,512.00,0.00,529,530
1025,1,512,512,512.00,0.00,529,530
1026,1,512,512,512.00,0.00,529,530
1027,1,512,512,512.00,0.00,529,530
1028,1,512,512,512.00,0.00,529,530
1029,1,512,512,512.00,0.00,529,530
1030,2,330,182,256.00,5476.00,529,531
1031,3,481,10,170.67,48173.56,530,533
1032,2,445,67,256.00,35721.00,532,534
1033,1,512,512,512.00,0.00,533,534
1034,1,512,512,512.00,0.00,533,534
1035,2,379,133,256.00,15129.00,533,535
1036,1,512,512,512.00,0.00,534,535
1037,1,512,512,512.00,0.00,534,535
1038,1,512,512,512.00,0.00,534,535
1039,1,512,512,512.00,0.00,534,535
1040,2,371,141,256.00,13225.00,534,536
1041,1,512,512,512.00,0.00,535,536
1042,2,337,175,256.00,6561.00,535,537
1043,2,505,7,256.00,62001.00,536,538
1044,1,512,512,512.00,0.00,537,538
1045,1,512,512,512.00,0.00,537,538
1046,2,378,134,256.00,14884.00,537,539
1047,1,512,512,512.00,0.00,538,539
1048,1,512,512,512.00,0.00,538,539
1049,1,512,512,512.00,0.00,538,539
1050,1,512,512,512.00,0.00,538,539
1051,1,512,512,512.00,0.00,538,539
1052,2,401,111,256.00,21025.00,538,540
1053,1,512,512,512.00,0.00,539,540
1054,1,512,512,512.00,0.00,539,540
1055,1,512,512,512.00,0.00,539,540
1056,1,512,512,512.00,0.00,539,540
1057,1,512,512,512.00,0.00,539,540
1058,2,474,38,256.00,47524.00,539,541
1059,1,512,512,512.00,0.00,540,541
1060,1,512,512,512.00,0.00,540,541
1061,1,512,512,512.00,0.00,540,541
1062,1,512,512,512.00,0.00,540,541
1063,3,294,31,170.67,11661.56,540,543
1064,3,411,15,170.67,29720.22,542,545
1065,1,512,512,512.00,0.00,544,545
1066,1,512,512,512.00,0.00,544,545
1067,1,512,512,512.00,0.00,544,545
1068,1,512,512,512.00,0.00,544,545
1069,1,512,512,512.00,0.00,544,545
1070,2,442,70,256.00,34596.00,544,546
1071,1,512,512,512.00,0.00,545,546
1072,1,512,512,512.00,0.00,545,546
1073,1,512,512,512.00,0.00,545,546
1074,1,512,512,512.00,0.00,545,546
1075,1,512,512,512.00,0.00,545,546
1076,2,384,128,256.00,16384.00,545,547
1077,1,512,512,512.00,0.00,546,547
1078,1,512,512,512.00,0.00,546,547
1079,1,512,512,512.00,0.00,546,547
1080,1,512,512,512.00,0.00,546,547
1081,1,512,512,512.00,0.00,546,547
1082,2,303,209,256.00,2209.00,546,548
1083,1,512,512,512.00,0.00,547,548
1084,3,300,1,170.67,15713.56,547,550
1085,1,512,512,512.00,0.00,549,550
1086,1,512,512,512.00,0.00,549,550
1087,2,376,136,256.00,14400.00,549,551
1088,2,419,93,256.00,26569.00,550,552
1089,1,512,512,512.00,0.00,551,552
1090,1,512,512,512.00,0.00,551,552
1091,5,309,30,102.40,10982.64,551,556
1092,1,512,512,512.00,0.00,555,556
1093,1,512,512,512.00,0.00,555,556
1094,1,512,512,512.00,0.00,555,556
1095,1,512,512,512.00,0.00,555,556
1096,2,294,218,256.00,1444.00,555,557
1097,1,512,512,512.00,0.00,556,557
1098,1,512,512,512.00,0.00,556,557
1099,1,512,512,512.00,0.00,556,557
1100,1,512,512,512.00,0.00,556,557
1101,2,421,91,256.00,27225.00,556,558
1102,1,512,512,512.00,0.00,557,558
1103,1,512,512,512.00,0.00,557,558
1104,1,512,512,512.00,0.00,557,558
1105,1,512,512,512.00,0.00,557,558
1106,2,272,240,256.00,256.00,557,559
1107,2,343,169,256.00,7569.00,558,560
1108,2,448,64,256.00,36864.00,559,561
1109,2,459,53,256.00,41209.00,560,562
1110,1,512,512,512.00,0.00,561,562
1111,1,512,512,512.00,0.00,561,562
1112,4,341,37,128.00,15313.50,561,565
1113,1,512,512,512.00,0.00,564,565
1114,1,512,512,512.00,0.00,564,565
1115,1,512,512,512.00,0.00,564,565
1116,2,456,56,256.00,40000.00,564,566
1117,1,512,512,512.00,0.00,565,566
1118,1,512,512,512.00,0.00,565,566
1119,1,512,512,512.00,0.00,565,566
1120,2,385,127,256.00,16641.00,565,567
1121,1,512,512,512.00,0.00,566,567
1122,1,512,512,512.00,0.00,566,567
1123,1,512,512,512.00,0.00,566,567
1124,1,512,512,512.00,0.00,566,567
1125,1,512,512,512.00,0.00,566,567
1126,3,368,17,170.67,21486.89,566,569
1127,1,512,512,512.00,0.00,568,569
1128,1,512,512,512.00,0.00,568,569
1129,2,360,152,256.00,10816.00,568,570
1130,1,512,512,512.00,0.00,569,570
1131,1,512,512,512.00,0.00,569,570
1132,1,512,512,512.00,0.00,569,570
1133,2,310,202,256.00,2916.00,569,571
1134,1,512,512,512.00,0.00,570,571
1135,1,512,512,512.00,0.00,570,571
1136,1,512,512,512.00,0.00,570,571
1137,1,512,512,512.00,0.00,570,571
1138,2,322,190,256.00,4356.00,570,572
1139,1,512,512,512.00,0.00,571,572
1140,1,512,512,512.00,0.00,571,572
1141,1,512,512,512.00,0.00,571,572
1142,1,512,512,512.00,0.00,571,572
1143,1,512,512,512.00,0.00,571,572
1144,1,512,512,512.00,0.00,571,572
1145,3,291,25,170.67,12113.56,571,574
1146,1,512,512,512.00,0.00,573,574
1147,1,512,512,512.00,0.00,573,574
1148,1,512,512,512.00,0.00,573,574
1149,2,315,197,256.00,3481.00,573,575
1150,1,512,512,512.00,0.00,574,575
1151,2,380,132,256.00,15376.00,574,576
1152,1,512,512,512.00,0.00,575,576
1153,1,512,512,512.00,0.00,575,576
1154,1,512,512,512.00,0.00,575,576
1155,2,331,181,256.00,5625.00,575,577
1156,2,489,23,256.00,54289.00,576,578
1157,2,343,169,256.00,7569.00,577,579
1158,1,512,512,512.00,0.00,578,579
1159,2,349,163,256.00,8649.00,578,580
1160,1,512,512,512.00,0.00,579,580
1161,1,512,512,512.00,0.00,579,580
1162,1,512,512,512.00,0.00,579,580
1163,2,452,60,256.00,38416.00,579,581
1164,1,512,512,512.00,0.00,580,581
1165,1,512,512,512.00,0.00,580,581
1166,1,512,512,512.00,0.00,580,581
1167,2,400,112,256.00,20736.00,580,582
1168,1,512,512,512.00,0.00,581,582
1169,1,512,512,512.00,0.00,581,582
1170,2,263,249,256.00,49.00,581,583
1171,2,276,236,256.00,400.00,582,584
1172,1,512,512,512.00,0.00,583,584
1173,1,512,512,512.00,0.00,583,584
1174,2,471,41,256.00,46225.00,583,585
1175,1,512,512,512.00,0.00,584,585
1176,1,512,512,512.00,0.00,584,585
1177,2,300,212,256.00,1936.00,584,586
1178,1,512,512,512.00,0.00,585,586
1179,1,512,512,512.00,0.00,585,586
1180,1,512,512,512.00,0.00,585,586
1181,2,341,171,256.00,7225.00,585,587
1182,4,246,7,128.00,13697.50,586,590
1183,3,293,1,170.67,15330.89,589,592
1184,1,512,512,512.00,0.00,591,592
1185,1,512,512,512.00,0.00,591,592
1186,1,512,512,512.00,0.00,591,592
1187,1,512,512,512.00,0.00,591,592
1188,2,326,186,256.00,4900.00,591,593
1189,1,512,512,512.00,0.00,592,593
1190,1,512,512,512.00,0.00,592,593
1191,1,512,512,512.00,0.00,592,593
1192,4,248,19,128.00,7113.50,592,596
1193,1,512,512,512.00,0.00,595,596
1194,1,512,512,512.00,0.00,595,596
1195,1,512,512,512.00,0.00,595,596
1196,2,362,150,256.00,11236.00,595,597
1197,1,512,512,512.00,0.00,596,597
1198,1,512,512,512.00,0.00,596,597
1199,1,512,512,512.00,0.00,596,597
1200,1,512,512,512.00,0.00,596,597
1201,1,512,512,512.00,0.00,596,597
1202,4,310,30,128.00,11676.50,596,600
1203,1,512,512,512.00,0.00,599,600
1204,2,432,80,256.00,30976.00,599,601
1205,2,283,229,256.00,729.00,600,602
1206,2,503,9,256.00,61009.00,601,603
1207,1,512,512,512.00,0.00,602,603
1208,1,512,512,512.00,0.00,602,603
1209,1,512,512,512.00,0.00,602,603
1210,1,512,512,512.00,0.00,602,603
1211,1,512,512,512.00,0.00,602,603
1212,1,512,512,512.00,0.00,602,603
1213,2,295,217,256.00,1521.00,602,604
1214,1,512,512,512.00,0.00,603,604
1215,2,435,77,256.00,32041.00,603,605
1216,1,512,512,512.00,0.00,604,605
1217,1,512,512,512.00,0.00,604,605
1218,1,512,512,512.00,0.00,604,605
1219,3,242,95,170.67,3610.89,604,607
1220,1,512,512,512.00,0.00,606,607
1221,1,512,512,512.00,0.00,606,607
1222,1,512,512,512.00,0.00,606,607
1223,1,512,512,512.00,0.00,606,607
1224,1,512,512,512.00,0.00,606,607
1225,1,512,512,512.00,0.00,606,607
1226,2,371,141,256.00,13225.00,606,608
1227,1,512,512,512.00,0.00,607,608
1228,1,512,512,512.00,0.00,607,608
1229,2,468,44,256.00,44944.00,607,609
1230,1,512,512,512.00,0.00,608,609
1231,1,512,512,512.00,0.00,608,609
1232,1,512,512,512.00,0.00,608,609
1233,1,512,512,512.00,0.00,608,609
1234,2,299,213,256.00,1849.00,608,610
1235,2,346,166,256.00,8100.00,609,611
1236,2,481,31,256.00,50625.00,610,612
1237,1,512,512,512.00,0.00,611,612
1238,1,512,512,512.00,0.00,611,612
1239,2,291,221,256.00,1225.00,611,613
1240,2,316,196,256.00,3600.00,612,614
1241,1,512,512,512.00,0.00,613,614
1242,1,512,512,512.00,0.00,613,614
1243,2,265,247,256.00,81.00,613,615
1244,1,512,512,512.00,0.00,614,615
1245,1,512,512,512.00,0.00,614,615
1246,2,453,59,256.00,38809.00,614,616
1247,2,345,167,256.00,7921.00,615,617
1248,5,192,40,102.40,2966.64,616,621
1249,1,512,512,512.00,0.00,620,621
1250,3,342,16,170.67,17851.56,620,623
1251,1,512,512,512.00,0.00,622,623
1252,1,512,512,512.00,0.00,622,623
1253,1,512,512,512.00,0.00,622,623
1254,1,512,512,512.00,0.00,622,623
1255,1,512,512,512.00,0.00,622,623
1256,2,430,82,256.00,30276.00,622,624
1257,1,512,512,512.00,0.00,623,624
1258,2,510,2,256.00,64516.00,623,625
1259,1,512,512,512.00,0.00,624,625
1260,1,512,512,512.00,0.00,624,625
1261,2,292,220,256.00,1296.00,624,626
1262,1,512,512,512.00,0.00,625,626
1263,3,415,5,170.67,31110.89,625,628
1264,1,512,512,512.00,0.00,627,628
1265,1,512,512,512.00,0.00,627,628
1266,1,512,512,512.00,0.00,627,628
1267,1,512,512,512.00,0.00,627,628
1268,2,341,171,256.00,7225.00,627,629
1269,1,512,512,512.00,0.00,628,629
1270,1,512,512,512.00,0.00,628,629
1271,1,512,512,512.00,0.00,628,629
1272,1,512,512,512.00,0.00,628,629
1273,2,369,143,256.00,12769.00,628,630
1274,1,512,512,512.00,0.00,629,630
1275,1,512,512,512.00,0.00,629,630
1276,1,512,512,512.00,0.00,629,630
1277,1,512,512,512.00,0.00,629,630
1278,6,192,8,85.33,6420.56,629,635
1279,1,512,512,512.00,0.00,634,635
1280,1,512,512,512.00,0.00,634,635
1281,1,512,512,512.00,0.00,634,635
1282,1,512,512,512.00,0.00,634,635
1283,2,290,222,256.00,1156.00,634,636
1284,1,512,512,512.00,0.00,635,636
1285,1,512,512,512.00,0.00,635,636
1286,1,512,512,512.00,0.00,635,636
1287,1,512,512,512.00,0.00,635,636
1288,3,365,8,170.67,21742.89,635,638
1289,1,512,512,512.00,0.00,637,638
1290,1,512,512,512.00,0.00,637,638
1291,1,512,512,512.00,0.00,637,638
1292,2,445,67,256.00,35721.00,637,639
1293,1,512,512,512.00,0.00,638,639
1294,1,512,512,512.00,0.00,638,639
1295,1,512,512,512.00,0.00,638,639
1296,1,512,512,512.00,0.00,638,639
1297,2,334,178,256.00,6084.00,638,640
1298,1,512,512,512.00,0.00,639,640
1299,1,512,512,512.00,0.00,639,640
1300,1,512,512,512.00,0.00,639,640
1301,1,512,512,512.00,0.00,639,640
1302,2,394,118,256.00,19044.00,639,641
1303,2,496,16,256.00,57600.00,640,642
1304,1,512,512,512.00,0.00,641,642
1305,2,454,58,256.00,39204.00,641,643
1306,2,413,99,256.00,24649.00,642,644
1307,1,512,512,512.00,0.00,643,644
1308,1,512,512,512.00,0.00,643,644
1309,3,233,86,170.67,3850.89,643,646
1310,1,512,512,512.00,0.00,645,646
1311,1,512,512,512.00,0.00,645,646
1312,1,512,512,512.00,0.00,645,646
1313,1,512,512,512.00,0.00,645,646
1314,2,285,227,256.00,841.00,645,647
1315,1,512,512,512.00,0.00,646,647
1316,3,252,119,170.67,3388.22,646,649
1317,1,512,512,512.00,0.00,648,649
1318,1,512,512,512.00,0.00,648,649
1319,1,512,512,512.00,0.00,648,649
1320,3,250,24,170.67,10779.56,648,651
1321,1,512,512,512.00,0.00,650,651
1322,1,512,512,512.00,0.00,650,651
1323,1,512,512,512.00,0.00,650,651
1324,1,512,512,512.00,0.00,650,651
1325,2,458,54,256.00,40804.00,650,652
1326,2,447,65,256.00,36481.00,651,653
1327,1,512,512,512.00,0.00,652,653
1328,1,512,512,512.00,0.00,652,653
1329,2,277,235,256.00,441.00,652,654
1330,2,427,85,256.00,29241.00,653,655
1331,2,496,16,256.00,57600.00,654,656
1332,2,498,14,256.00,58564.00,655,657
1333,6,369,4,85.33,16625.56,656,662
1334,1,512,512,512.00,0.00,661,662
1335,1,512,512,512.00,0.00,661,662
1336,1,512,512,512.00,0.00,661,662
1337,2,470,42,256.00,45796.00,661,663
1338,2,301,211,256.00,2025.00,662,664
1339,1,512,512,512.00,0.00,663,664
1340,1,512,512,512.00,0.00,663,664
1341,2,435,77,256.00,32041.00,663,665
1342,1,512,512,512.00,0.00,664,665
1343,1,512,512,512.00,0.00,664,665
1344,1,512,512,512.00,0.00,664,665
1345,1,512,512,512.00,0.00,664,665
1346,3,315,11,170.67,15520.22,664,667
1347,1,512,512,512.00,0.00,666,667
1348,5,349,4,102.40,16048.24,666,671
1349,1,512,512,512.00,0.00,670,671
1350,2,355,157,256.00,9801.00,670,672
1351,1,512,512,512.00,0.00,671,672
1352,2,452,60,256.00,38416.00,671,673
1353,1,512,512,512.00,0.00,672,673
1354,1,512,512,512.00,0.00,672,673
1355,1,512,512,512.00,0.00,672,673
1356,2,331,181,256.00,5625.00,672,674
1357,1,512,512,512.00,0.00,673,674
1358,2,299,213,256.00,1849.00,673,675
1359,1,512,512,512.00,0.00,674,675
1360,1,512,512,512.00,0.00,674,675
1361,1,512,512,512.00,0.00,674,675
1362,1,512,512,512.00,0.00,674,675
1363,1,512,512,512.00,0.00,674,675
1364,1,512,512,512.00,0.00,674,675
1365,2,323,189,256.00,4489.00,674,676
1366,1,512,512,512.00,0.00,675,676
1367,2,494,18,256.00,56644.00,675,677
1368,1,512,512,512.00,0.00,676,677
1369,1,512,512,512.00,0.00,676,677
1370,1,512,512,512.00,0.00,676,677
1371,1,512,512,512.00,0.00,676,677
1372,2,442,70,256.00,34596.00,676,678
1373,1,512,512,512.00,0.00,677,678
1374,1,512,512,512.00,0.00,677,678
1375,1,512,512,512.00,0.00,677,678
1376,1,512,512,512.00,0.00,677,678
1377,1,512,512,512.00,0.00,677,678
1378,2,272,240,256.00,256.00,677,679
1379,1,512,512,512.00,0.00,678,679
1380,1,512,512,512.00,0.00,678,679
1381,1,512,512,512.00,0.00,678,679
1382,1,512,512,512.00,0.00,678,679
1383,2,454,58,256.00,39204.00,678,680
1384,1,512,512,512.00,0.00,679,680
1385,1,512,512,512.00,0.00,679,680
1386,4,247,22,128.00,7273.50,679,683
1387,1,512,512,512.00,0.00,682,683
1388,1,512,512,512.00,0.00,682,683
1389,2,378,134,256.00,14884.00,682,684
1390,2,484,28,256.00,51984.00,683,685
1391,1,512,512,512.00,0.00,684,685
1392,1,512,512,512.00,0.00,684,685
1393,2,303,209,256.00,2209.00,684,686
1394,1,512,512,512.00,0.00,685,686
1395,1,512,512,512.00,0.00,685,686
1396,1,512,512,512.00,0.00,685,686
1397,1,512,512,512.00,0.00,685,686
1398,1,512,512,512.00,0.00,685,686
1399,2,423,89,256.00,27889.00,685,687
1400,1,512,512,512.00,0.00,686,687
1401,1,512,512,512.00,0.00,686,687
1402,2,490,22,256.00,54756.00,686,688
1403,2,497,15,256.00,58081.00,687,689
1404,1,512,512,512.00,0.00,688,689
1405,3,328,25,170.67,15369.56,688,691
1406,2,276,236,256.00,400.00,690,692
1407,1,512,512,512.00,0.00,691,692
1408,1,512,512,512.00,0.00,691,692
1409,1,512,512,512.00,0.00,691,692
1410,3,410,9,170.67,29816.22,691,694
1411,1,512,512,512.00,0.00,693,694
1412,1,512,512,512.00,0.00,693,694
1413,1,512,512,512.00,0.00,693,694
1414,2,492,20,256.00,55696.00,693,695
1415,1,512,512,512.00,0.00,694,695
1416,4,300,32,128.00,10760.00,694,698
1417,2,476,36,256.00,48400.00,697,699
1418,4,343,5,128.00,19284.50,698,702
1419,1,512,512,512.00,0.00,701,702
1420,2,289,223,256.00,1089.00,701,703
1421,2,349,163,256.00,8649.00,702,704
1422,1,512,512,512.00,0.00,703,704
1423,3,297,81,170.67,8448.22,703,706
1424,1,512,512,512.00,0.00,705,706
1425,2,359,153,256.00,10609.00,705,707
1426,1,512,512,512.00,0.00,706,707
1427,1,512,512,512.00,0.00,706,707
1428,1,512,512,512.00,0.00,706,707
1429,1,512,512,512.00,0.00,706,707
1430,2,441,71,256.00,34225.00,706,708
1431,3,201,136,170.67,713.56,707,710
1432,1,512,512,512.00,0.00,709,710
1433,3,479,4,170.67,47638.89,709,712
1434,1,512,512,512.00,0.00,711,712
1435,3,318,11,170.67,15784.22,711,714
1436,1,512,512,512.00,0.00,713,714
1437,5,185,41,102.40,4133.04,713,718
1438,2,324,188,256.00,4624.00,717,719
1439,1,512,512,512.00,0.00,718,719
1440,3,282,107,170.67,6240.22,718,721
1441,2,268,244,256.00,144.00,720,722
1442,1,512,512,512.00,0.00,721,722
1443,1,512,512,512.00,0.00,721,722
1444,1,512,512,512.00,0.00,721,722
1445,2,403,109,256.00,21609.00,721,723
1446,1,512,512,512.00,0.00,722,723
1447,2,362,150,256.00,11236.00,722,724
1448,2,466,46,256.00,44100.00,723,725
1449,1,512,512,512.00,0.00,724,725
1450,2,425,87,256.00,28561.00,724,726
1451,5,260,23,102.40,6879.84,725,730
1452,1,512,512,512.00,0.00,729,730
1453,1,512,512,512.00,0.00,729,730
1454,1,512,512,512.00,0.00,729,730
1455,2,503,9,256.00,61009.00,729,731
1456,1,512,512,512.00,0.00,730,731
1457,1,512,512,512.00,0.00,730,731
1458,1,512,512,512.00,0.00,730,731
1459,1,512,512,512.00,0.00,730,731
1460,1,512,512,512.00,0.00,730,731
1461,1,512,512,512.00,0.00,730,731
1462,2,303,209,256.00,2209.00,730,732
1463,1,512,512,512.00,0.00,731,732
1464,1,512,512,512.00,0.00,731,732
1465,1,512,512,512.00,0.00,731,732
1466,2,428,84,256.00,29584.00,731,733
1467,2,267,245,256.00,121.00,732,734
1468,1,512,512,512.00,0.00,733,734
1469,1,512,512,512.00,0.00,733,734
1470,2,268,244,256.00,144.00,733,735
1471,1,512,512,512.00,0.00,734,735
1472,2,306,206,256.00,2500.00,734,736
1473,1,512,512,512.00,0.00,735,736
1474,1,512,512,512.00,0.00,735,736
1475,1,512,512,512.00,0.00,735,736
1476,1,512,512,512.00,0.00,735,736
1477,3,337,81,170.67,13861.56,735,738
1478,1,512,512,512.00,0.00,737,738
1479,2,425,87,256.00,28561.00,737,739
1480,1,512,512,512.00,0.00,738,739
1481,2,319,193,256.00,3969.00,738,740
1482,1,512,512,512.00,0.00,739,740
1483,1,512,512,512.00,0.00,739,740
1484,1,512,512,512.00,0.00,739,740
1485,1,512,512,512.00,0.00,739,740
1486,2,443,69,256.00,34969.00,739,741
1487,1,512,512,512.00,0.00,740,741
1488,1,512,512,512.00,0.00,740,741
1489,2,350,162,256.00,8836.00,740,742
1490,1,512,512,512.00,0.00,741,742
1491,2,462,50,256.00,42436.00,741,743
1492,1,512,512,512.00,0.00,742,743
1493,2,484,28,256.00,51984.00,742,744
1494,1,512,512,512.00,0.00,743,744
1495,1,512,512,512.00,0.00,743,744
1496,1,512,512,512.00,0.00,743,744
1497,2,317,195,256.00,3721.00,743,745
1498,2,395,117,256.00,19321.00,744,746
1499,2,300,212,256.00,1936.00,745,747
1500,1,512,512,512.00,0.00,746,747
1501,1,512,512,512.00,0.00,746,747
1502,2,424,88,256.00,28224.00,746,748
1503,1,512,512,512.00,0.00,747,748
1504,2,478,34,256.00,49284.00,747,749
1505,1,512,512,512.00,0.00,748,749
1506,2,408,104,256.00,23104.00,748,750
1507,2,370,142,256.00,12996.00,749,751
1508,1,512,512,512.00,0.00,750,751
1509,1,512,512,512.00,0.00,750,751
1510,1,512,512,512.00,0.00,750,751
1511,3,475,1,170.67,46513.56,750,753
1512,1,512,512,512.00,0.00,752,753
1513,2,378,134,256.00,14884.00,752,754
1514,4,302,30,128.00,11056.50,753,757
1515,1,512,512,512.00,0.00,756,757
1516,1,512,512,512.00,0.00,756,757
1517,1,512,512,512.00,0.00,756,757
1518,1,512,512,512.00,0.00,756,757
1519,2,268,244,256.00,144.00,756,758
1520,2,276,236,256.00,400.00,757,759
1521,1,512,512,512.00,0.00,758,759
1522,1,512,512,512.00,0.00,758,759
1523,1,512,512,512.00,0.00,758,759
1524,2,410,102,256.00,23716.00,758,760
1525,1,512,512,512.00,0.00,759,760
1526,1,512,512,512.00,0.00,759,760
1527,2,363,149,256.00,11449.00,759,761
1528,1,512,512,512.00,0.00,760,761
1529,1,512,512,512.00,0.00,760,761
1530,2,326,186,256.00,4900.00,760,762
1531,1,512,512,512.00,0.00,761,762
1532,2,448,64,256.00,36864.00,761,763
1533,2,495,17,256.00,57121.00,762,764
1534,1,512,512,512.00,0.00,763,764
1535,1,512,512,512.00,0.00,763,764
1536,2,388,124,256.00,17424.00,763,765
1537,3,390,18,170.67,25286.22,764,767
1538,1,512,512,512.00,0.00,766,767
1539,2,304,208,256.00,2304.00,766,768
1540,1,512,512,512.00,0.00,767,768
1541,2,293,219,256.00,1369.00,767,769
1542,1,512,512,512.00,0.00,768,769
1543,1,512,512,512.00,0.00,768,769
1544,1,512,512,512.00,0.00,768,769
1545,3,271,48,170.67,8537.56,768,771
1546,1,512,512,512.00,0.00,770,771
1547,1,512,512,512.00,0.00,770,771
1548,2,281,231,256.00,625.00,770,772
1549,1,512,512,512.00,0.00,771,772
1550,1,512,512,512.00,0.00,771,772
1551,2,510,2,256.00,64516.00,771,773
1552,4,256,29,128.00,9279.50,772,776
1553,1,512,512,512.00,0.00,775,776
1554,3,310,70,170.67,10347.56,775,778
1555,2,291,221,256.00,1225.00,777,779
1556,1,512,512,512.00,0.00,778,779
1557,1,512,512,512.00,0.00,778,779
1558,1,512,512,512.00,0.00,778,779
1559,2,473,39,256.00,47089.00,778,780
1560,1,512,512,512.00,0.00,779,780
1561,1,512,512,512.00,0.00,779,780
1562,2,504,8,256.00,61504.00,779,781
1563,1,512,512,512.00,0.00,780,781
1564,1,512,512,512.00,0.00,780,781
1565,1,512,512,512.00,0.00,780,781
1566,2,273,239,256.00,289.00,780,782
1567,1,512,512,512.00,0.00,781,782
1568,2,292,220,256.00,1296.00,781,783
1569,1,512,512,512.00,0.00,782,783
1570,2,506,6,256.00,62500.00,782,784
1571,2,346,166,256.00,8100.00,783,785
1572,1,512,512,512.00,0.00,784,785
1573,3,313,13,170.67,15117.56,784,787
1574,1,512,512,512.00,0.00,786,787
1575,2,421,91,256.00,27225.00,786,788
1576,1,512,512,512.00,0.00,787,788
1577,1,512,512,512.00,0.00,787,788
1578,1,512,512,512.00,0.00,787,788
1579,1,512,512,512.00,0.00,787,788
1580,1,512,512,512.00,0.00,787,788
1581,2,317,195,256.00,3721.00,787,789
1582,1,512,512,512.00,0.00,788,789
1583,2,336,176,256.00,6400.00,788,790
1584,1,512,512,512.00,0.00,789,790
1585,1,512,512,512.00,0.00,789,790
1586,2,392,120,256.00,18496.00,789,791
1587,1,512,512,512.00,0.00,790,791
1588,1,512,512,512.00,0.00,790,791
1589,1,512,512,512.00,0.00,790,791
1590,1,512,512,512.00,0.00,790,791
1591,4,272,22,128.00,11061.50,790,794
1592,1,512,512,512.00,0.00,793,794
1593,2,382,130,256.00,15876.00,793,795
1594,1,512,512,512.00,0.00,794,795
1595,1,512,512,512.00,0.00,794,795
1596,1,512,512,512.00,0.00,794,795
1597,2,343,169,256.00,7569.00,794,796
1598,4,255,8,128.00,9234.50,795,799
1599,1,512,512,512.00,0.00,798,799
1600,1,512,512,512.00,0.00,798,799
1601,2,290,222,256.00,1156.00,798,800
1602,2,280,232,256.00,576.00,799,801
1603,2,266,246,256.00,100.00,800,802
1604,1,512,512,512.00,0.00,801,802
1605,2,432,80,256.00,30976.00,801,803
1606,2,407,105,256.00,22801.00,802,804
1607,2,413,99,256.00,24649.00,803,805
1608,1,512,512,512.00,0.00,804,805
1609,1,512,512,512.00,0.00,804,805
1610,3,322,13,170.67,15933.56,804,807
1611,4,226,38,128.00,5838.50,806,810
1612,1,512,512,512.00,0.00,809,810
1613,1,512,512,512.00,0.00,809,810
1614,1,512,512,512.00,0.00,809,810
1615,1,512,512,512.00,0.00,809,810
1616,2,482,30,256.00,51076.00,809,811
1617,2,272,240,256.00,256.00,810,812
1618,1,512,512,512.00,0.00,811,812
1619,1,512,512,512.00,0.00,811,812
1620,2,396,116,256.00,19600.00,811,813
1621,1,512,512,512.00,0.00,812,813
1622,2,411,101,256.00,24025.00,812,814
1623,2,289,223,256.00,1089.00,813,815
1624,1,512,512,512.00,0.00,814,815
1625,2,320,192,256.00,4096.00,814,816
1626,1,512,512,512.00,0.00,815,816
1627,1,512,512,512.00,0.00,815,816
1628,1,512,512,512.00,0.00,815,816
1629,1,512,512,512.00,0.00,815,816
1630,2,478,34,256.00,49284.00,815,817
1631,1,512,512,512.00,0.00,816,817
1632,1,512,512,512.00,0.00,816,817
1633,1,512,512,512.00,0.00,816,817
1634,1,512,512,512.00,0.00,816,817
1635,1,512,512,512.00,0.00,816,817
1636,2,277,235,256.00,441.00,816,818
1637,1,512,512,512.00,0.00,817,818
1638,1,512,512,512.00,0.00,817,818
1639,1,512,512,512.00,0.00,817,818
1640,2,265,247,256.00,81.00,817,819
1641,2,403,109,256.00,21609.00,818,820
1642,2,267,245,256.00,121.00,819,821
1643,1,512,512,512.00,0.00,820,821
1644,1,512,512,512.00,0.00,820,821
1645,1,512,512,512.00,0.00,820,821
1646,2,485,27,256.00,52441.00,820,822
1647,1,512,512,512.00,0.00,821,822
1648,2,478,34,256.00,49284.00,821,823
1649,2,466,46,256.00,44100.00,822,824
1650,1,512,512,512.00,0.00,823,824
1651,2,313,199,256.00,3249.00,823,825
1652,2,344,168,256.00,7744.00,824,826
1653,3,410,15,170.67,29504.22,825,828
1654,1,512,512,512.00,0.00,827,828
1655,1,512,512,512.00,0.00,827,828
1656,1,512,512,512.00,0.00,827,828
1657,1,512,512,512.00,0.00,827,828
1658,3,265,40,170.67,9097.56,827,830
1659,1,512,512,512.00,0.00,829,830
1660,2,507,5,256.00,63001.00,829,831
1661,1,512,512,512.00,0.00,830,831
1662,1,512,512,512.00,0.00,830,831
1663,2,335,177,256.00,6241.00,830,832
1664,1,512,512,512.00,0.00,831,832
1665,2,446,66,256.00,36100.00,831,833
1666,1,512,512,512.00,0.00,832,833
1667,1,512,512,512.00,0.00,832,833
1668,1,512,512,512.00,0.00,832,833
1669,1,512,512,512.00,0.00,832,833
1670,2,366,146,256.00,12100.00,832,834
1671,1,512,512,512.00,0.00,833,834
1672,1,512,512,512.00,0.00,833,834
1673,1,512,512,512.00,0.00,833,834
1674,2,442,70,256.00,34596.00,833,835
1675,1,512,512,512.00,0.00,834,835
1676,1,512,512,512.00,0.00,834,835
1677,2,508,4,256.00,63504.00,834,836
1678,3,332,45,170.67,14364.22,835,838
1679,1,512,512,512.00,0.00,837,838
1680,1,512,512,512.00,0.00,837,838
1681,1,512,512,512.00,0.00,837,838
1682,1,512,512,512.00,0.00,837,838
1683,1,512,512,512.00,0.00,837,838
1684,1,512,512,512.00,0.00,837,838
1685,3,310,2,170.67,16240.89,837,840
1686,1,512,512,512.00,0.00,839,840
1687,1,512,512,512.00,0.00,839,840
1688,1,512,512,512.00,0.00,839,840
1689,1,512,512,512.00,0.00,839,840
1690,2,411,101,256.00,24025.00,839,841
1691,1,512,512,512.00,0.00,840,841
1692,1,512,512,512.00,0.00,840,841
1693,2,280,232,256.00,576.00,840,842
1694,1,512,512,512.00,0.00,841,842
1695,1,512,512,512.00,0.00,841,842
1696,1,512,512,512.00,0.00,841,842
1697,2,498,14,256.00,58564.00,841,843
1698,1,512,512,512.00,0.00,842,843
1699,1,512,512,512.00,0.00,842,843
1700,1,512,512,512.00,0.00,842,843
1701,2,467,45,256.00,44521.00,842,844
1702,4,321,2,128.00,14437.50,843,847
1703,2,268,244,256.00,144.00,846,848
1704,1,512,512,512.00,0.00,847,848
1705,1,512,512,512.00,0.00,847,848
1706,5,245,24,102.40,6035.44,847,852
1707,3,296,107,170.67,7854.89,851,854
1708,1,512,512,512.00,0.00,853,854
1709,1,512,512,512.00,0.00,853,854
1710,3,221,72,170.67,4868.22,853,856
1711,1,512,512,512.00,0.00,855,856
1712,1,512,512,512.00,0.00,855,856
1713,1,512,512,512.00,0.00,855,856
1714,1,512,512,512.00,0.00,855,856
1715,2,407,105,256.00,22801.00,855,857
1716,1,512,512,512.00,0.00,856,857
1717,1,512,512,512.00,0.00,856,857
1718,1,512,512,512.00,0.00,856,857
1719,1,512,512,512.00,0.00,856,857
1720,1,512,512,512.00,0.00,856,857
1721,2,352,160,256.00,9216.00,856,858
1722,1,512,512,512.00,0.00,857,858
1723,3,489,1,170.67,50741.56,857,860
1724,1,512,512,512.00,0.00,859,860
1725,2,420,92,256.00,26896.00,859,861
1726,1,512,512,512.00,0.00,860,861
1727,1,512,512,512.00,0.00,860,861
1728,2,381,131,256.00,15625.00,860,862
1729,1,512,512,512.00,0.00,861,862
1730,1,512,512,512.00,0.00,861,862
1731,1,512,512,512.00,0.00,861,862
1732,3,409,33,170.67,28629.56,861,864
1733,2,259,253,256.00,9.00,863,865
1734,1,512,512,512.00,0.00,864,865
1735,1,512,512,512.00,0.00,864,865
1736,1,512,512,512.00,0.00,864,865
1737,2,260,252,256.00,16.00,864,866
1738,2,344,168,256.00,7744.00,865,867
1739,1,512,512,512.00,0.00,866,867
1740,1,512,512,512.00,0.00,866,867
1741,4,192,39,128.00,3097.50,866,870
1742,1,512,512,512.00,0.00,869,870
1743,1,512,512,512.00,0.00,869,870
1744,2,333,179,256.00,5929.00,869,871
1745,1,512,512,512.00,0.00,870,871
1746,1,512,512,512.00,0.00,870,871
1747,1,512,512,512.00,0.00,870,871
1748,2,385,127,256.00,16641.00,870,872
1749,1,512,512,512.00,0.00,871,872
1750,1,512,512,512.00,0.00,871,872
1751,1,512,512,512.00,0.00,871,872
1752,2,402,110,256.00,21316.00,871,873
1753,1,512,512,512.00,0.00,872,873
1754,1,512,512,512.00,0.00,872,873
1755,1,512,512,512.00,0.00,872,873
1756,2,265,247,256.00,81.00,872,874
1757,1,512,512,512.00,0.00,873,874
1758,1,512,512,512.00,0.00,873,874
1759,2,313,199,256.00,3249.00,873,875
1760,1,512,512,512.00,0.00,874,875
1761,1,512,512,512.00,0.00,874,875
1762,2,470,42,256.00,45796.00,874,876
1763,3,409,35,170.67,28582.89,875,878
1764,1,512,512,512.00,0.00,877,878
1765,1,512,512,512.00,0.00,877,878
1766,2,294,218,256.00,1444.00,877,879
1767,1,512,512,512.00,0.00,878,879
1768,1,512,512,512.00,0.00,878,879
1769,2,392,120,256.00,18496.00,878,880
1770,1,512,512,512.00,0.00,879,880
1771,1,512,512,512.00,0.00,879,880
1772,1,512,512,512.00,0.00,879,880
1773,1,512,512,512.00,0.00,879,880
1774,2,469,43,256.00,45369.00,879,881
1775,1,512,512,512.00,0.00,880,881
1776,1,512,512,512.00,0.00,880,881
1777,1,512,512,512.00,0.00,880,881
1778,1,512,512,512.00,0.00,880,881
1779,2,363,149,256.00,11449.00,880,882
1780,2,393,119,256.00,18769.00,881,883
1781,4,386,1,128.00,23049.50,882,886
1782,2,486,26,256.00,52900.00,885,887
1783,1,512,512,512.00,0.00,886,887
1784,2,459,53,256.00,41209.00,886,888
1785,1,512,512,512.00,0.00,887,888
1786,1,512,512,512.00,0.00,887,888
1787,2,371,141,256.00,13225.00,887,889
1788,1,512,512,512.00,0.00,888,889
1789,2,390,122,256.00,17956.00,888,890
1790,1,512,512,512.00,0.00,889,890
1791,1,512,512,512.00,0.00,889,890
1792,2,404,108,256.00,21904.00,889,891
1793,1,512,512,512.00,0.00,890,891
1794,1,512,512,512.00,0.00,890,891
1795,3,220,142,170.67,1227.56,890,893
1796,2,342,170,256.00,7396.00,892,894
1797,1,512,512,512.00,0.00,893,894
1798,1,512,512,512.00,0.00,893,894
1799,2,390,122,256.00,17956.00,893,895
1800,1,512,512,512.00,0.00,894,895
1801,1,512,512,512.00,0.00,894,895
1802,1,512,512,512.00,0.00,894,895
1803,2,328,184,256.00,5184.00,894,896
1804,2,477,35,256.00,48841.00,895,897
1805,3,227,74,170.67,4714.89,896,899
1806,3,312,36,170.67,12718.22,898,901
1807,1,512,512,512.00,0.00,900,901
1808,1,512,512,512.00,0.00,900,901
1809,1,512,512,512.00,0.00,900,901
1810,1,512,512,512.00,0.00,900,901
1811,3,327,2,170.67,17680.22,900,903
1812,1,512,512,512.00,0.00,902,903
1813,1,512,512,512.00,0.00,902,903
1814,2,490,22,256.00,54756.00,902,904
1815,1,512,512,512.00,0.00,903,904
1816,1,512,512,512.00,0.00,903,904
1817,2,379,133,256.00,15129.00,903,905
1818,1,512,512,512.00,0.00,904,905
1819,1,512,512,512.00,0.00,904,905
1820,1,512,512,512.00,0.00,904,905
1821,1,512,512,512.00,0.00,904,905
1822,3,381,18,170.67,23624.22,904,907
1823,1,512,512,512.00,0.00,906,907
1824,1,512,512,512.00,0.00,906,907
1825,1,512,512,512.00,0.00,906,907
1826,1,512,512,512.00,0.00,906,907
1827,3,283,112,170.67,6313.56,906,909
1828,3,233,134,170.67,1962.89,908,911
1829,3,361,47,170.67,18654.89,910,913
1830,2,441,71,256.00,34225.00,912,914
1831,1,512,512,512.00,0.00,913,914
1832,1,512,512,512.00,0.00,913,914
1833,2,330,182,256.00,5476.00,913,915
1834,1,512,512,512.00,0.00,914,915
1835,1,512,512,512.00,0.00,914,915
1836,2,460,52,256.00,41616.00,914,916
1837,2,347,165,256.00,8281.00,915,917
1838,1,512,512,512.00,0.00,916,917
1839,1,512,512,512.00,0.00,916,917
1840,3,269,79,170.67,6038.89,916,919
1841,2,300,212,256.00,1936.00,918,920
1842,1,512,512,512.00,0.00,919,920
1843,1,512,512,512.00,0.00,919,920
1844,2,368,144,256.00,12544.00,919,921
1845,1,512,512,512.00,0.00,920,921
1846,1,512,512,512.00,0.00,920,921
1847,1,512,512,512.00,0.00,920,921
1848,1,512,512,512.00,0.00,920,921
1849,3,222,121,170.67,1701.56,920,923
1850,1,512,512,512.00,0.00,922,923
1851,1,512,512,512.00,0.00,922,923
1852,3,264,33,170.67,9876.22,922,925
1853,2,311,201,256.00,3025.00,924,926
1854,2,286,226,256.00,900.00,925,927
1855,1,512,512,512.00,0.00,926,927
1856,1,512,512,512.00,0.00,926,927
1857,2,476,36,256.00,48400.00,926,928
1858,2,460,52,256.00,41616.00,927,929
1859,1,512,512,512.00,0.00,928,929
1860,2,497,15,256.00,58081.00,928,930
1861,1,512,512,512.00,0.00,929,930
1862,2,347,165,256.00,8281.00,929,931
1863,1,512,512,512.00,0.00,930,931
1864,1,512,512,512.00,0.00,930,931
1865,2,359,153,256.00,10609.00,930,932
1866,4,234,48,128.00,5794.00,931,935
1867,1,512,512,512.00,0.00,934,935
1868,2,388,124,256.00,17424.00,934,936
1869,1,512,512,512.00,0.00,935,936
1870,2,262,250,256.00,36.00,935,937
1871,2,276,236,256.00,400.00,936,938
1872,2,357,155,256.00,10201.00,937,939
1873,1,512,512,512.00,0.00,938,939
1874,1,512,512,512.00,0.00,938,939
1875,1,512,512,512.00,0.00,938,939
1876,2,346,166,256.00,8100.00,938,940
1877,1,512,512,512.00,0.00,939,940
1878,2,350,162,256.00,8836.00,939,941
1879,1,512,512,512.00,0.00,940,941
1880,1,512,512,512.00,0.00,940,941
1881,1,512,512,512.00,0.00,940,941
1882,2,433,79,256.00,31329.00,940,942
1883,1,512,512,512.00,0.00,941,942
1884,1,512,512,512.00,0.00,941,942
1885,2,331,181,256.00,5625.00,941,943
1886,2,508,4,256.00,63504.00,942,944
1887,2,416,96,256.00,25600.00,943,945
1888,1,512,512,512.00,0.00,944,945
1889,1,512,512,512.00,0.00,944,945
1890,4,399,21,128.00,24784.50,944,948
1891,1,512,512,512.00,0.00,947,948
1892,1,512,512,512.00,0.00,947,948
1893,1,512,512,512.00,0.00,947,948
1894,3,257,78,170.67,5360.22,947,950
1895,2,307,205,256.00,2601.00,949,951
1896,1,512,512,512.00,0.00,950,951
1897,2,500,12,256.00,59536.00,950,952
1898,1,512,512,512.00,0.00,951,952
1899,1,512,512,512.00,0.00,951,952
1900,1,512,512,512.00,0.00,951,952
1901,1,512,512,512.00,0.00,951,952
1902,1,512,512,512.00,0.00,951,952
1903,2,325,187,256.00,4761.00,951,953
1904,1,512,512,512.00,0.00,952,953
1905,1,512,512,512.00,0.00,952,953
1906,2,438,74,256.00,33124.00,952,954
1907,1,512,512,512.00,0.00,953,954
1908,1,512,512,512.00,0.00,953,954
1909,1,512,512,512.00,0.00,953,954
1910,5,219,2,102.40,8043.44,953,958
1911,1,512,512,512.00,0.00,957,958
1912,1,512,512,512.00,0.00,957,958
1913,1,512,512,512.00,0.00,957,958
1914,1,512,512,512.00,0.00,957,958
1915,3,403,26,170.67,27530.89,957,960
1916,1,512,512,512.00,0.00,959,960
1917,1,512,512,512.00,0.00,959,960
1918,2,405,107,256.00,22201.00,959,961
1919,1,512,512,512.00,0.00,960,961
1920,1,512,512,512.00,0.00,960,961
1921,1,512,512,512.00,0.00,960,961
1922,1,512,512,512.00,0.00,960,961
1923,1,512,512,512.00,0.00,960,961
1924,2,457,55,256.00,40401.00,960,962
1925,1,512,512,512.00,0.00,961,962
1926,1,512,512,512.00,0.00,961,962
1927,2,384,128,256.00,16384.00,961,963
1928,1,512,512,512.00,0.00,962,963
1929,2,302,210,256.00,2116.00,962,964
1930,1,512,512,512.00,0.00,963,964
1931,1,512,512,512.00,0.00,963,964
1932,1,512,512,512.00,0.00,963,964
1933,1,512,512,512.00,0.00,963,964
1934,1,512,512,512.00,0.00,963,964
1935,2,325,187,256.00,4761.00,963,965
1936,1,512,512,512.00,0.00,964,965
1937,1,512,512,512.00,0.00,964,965
1938,3,448,2,170.67,39056.89,964,967
1939,2,394,118,256.00,19044.00,966,968
1940,1,512,512,512.00,0.00,967,968
1941,2,455,57,256.00,39601.00,967,969
1942,2,486,26,256.00,52900.00,968,970
1943,1,512,512,512.00,0.00,969,970
1944,1,512,512,512.00,0.00,969,970
1945,3,379,61,170.67,21721.56,969,972
1946,1,512,512,512.00,0.00,971,972
1947,2,469,43,256.00,45369.00,971,973
1948,1,512,512,512.00,0.00,972,973
1949,3,369,16,170.67,21721.56,972,975
1950,1,512,512,512.00,0.00,974,975
1951,1,512,512,512.00,0.00,974,975
1952,1,512,512,512.00,0.00,974,975
1953,1,512,512,512.00,0.00,974,975
1954,2,401,111,256.00,21025.00,974,976
1955,1,512,512,512.00,0.00,975,976
1956,1,512,512,512.00,0.00,975,976
1957,3,376,65,170.67,21086.89,975,978
1958,1,512,512,512.00,0.00,977,978
1959,3,395,13,170.67,26542.89,977,980
1960,1,512,512,512.00,0.00,979,980
1961,1,512,512,512.00,0.00,979,980
1962,1,512,512,512.00,0.00,979,980
1963,1,512,512,512.00,0.00,979,980
1964,1,512,512,512.00,0.00,979,980
1965,1,512,512,512.00,0.00,979,980
1966,3,294,11,170.67,14008.22,979,982
1967,1,512,512,512.00,0.00,981,982
1968,2,447,65,256.00,36481.00,981,983
1969,2,423,89,256.00,27889.00,982,984
1970,3,206,109,170.67,1914.89,983,986
1971,2,312,200,256.00,3136.00,985,987
1972,2,403,109,256.00,21609.00,986,988
1973,1,512,512,512.00,0.00,987,988
1974,3,445,9,170.67,38029.56,987,990
1975,1,512,512,512.00,0.00,989,990
1976,1,512,512,512.00,0.00,989,990
1977,1,512,512,512.00,0.00,989,990
1978,1,512,512,512.00,0.00,989,990
1979,3,365,6,170.67,21920.22,989,992
1980,1,512,512,512.00,0.00,991,992
1981,3,253,39,170.67,8849.56,991,994
1982,3,327,40,170.67,14057.56,993,996
1983,3,351,17,170.67,18948.22,995,998
1984,1,512,512,512.00,0.00,997,998
1985,1,512,512,512.00,0.00,997,998
1986,2,481,31,256.00,50625.00,997,999
1987,1,512,512,512.00,0.00,998,999
1988,1,512,512,512.00,0.00,998,999
1989,1,512,512,512.00,0.00,998,999
1990,2,289,223,256.00,1089.00,998,1000
1991,1,512,512,512.00,0.00,999,1000
1992,1,512,512,512.00,0.00,999,1000
1993,1,512,512,512.00,0.00,999,1000
1994,1,512,512,512.00,0.00,999,1000
1995,1,512,512,512.00,0.00,999,1000
1996,2,276,236,256.00,400.00,999,1001
1997,1,512,512,512.00,0.00,1000,1001
1998,1,512,512,512.00,0.00,1000,1001
1999,1,512,512,512.00,0.00,1000,1001
2000,1,512,512,512.00,0.00,1000,1001
2001,1,512,512,512.00,0.00,1000,1001
2002,2,329,183,256.00,5329.00,1000,1002
2003,2,292,220,256.00,1296.00,1001,1003
2004,1,512,512,512.00,0.00,1002,1003
2005,2,266,246,256.00,100.00,1002,1004
2006,1,512,512,512.00,0.00,1003,1004
2007,1,512,512,512.00,0.00,1003,1004
2008,2,445,67,256.00,35721.00,1003,1005
2009,2,272,240,256.00,256.00,1004,1006
2010,1,512,512,512.00,0.00,1005,1006
2011,4,295,35,128.00,10019.00,1005,1009
2012,1,512,512,512.00,0.00,1008,1009
2013,1,512,512,512.00,0.00,1008,1009
2014,2,287,225,256.00,961.00,1008,1010
2015,1,512,512,512.00,0.00,1009,1010
2016,1,512,512,512.00,0.00,1009,1010
2017,1,512,512,512.00,0.00,1009,1010
2018,1,512,512,512.00,0.00,1009,1010
2019,2,295,217,256.00,1521.00,1009,1011
2020,1,512,512,512.00,0.00,1010,1011
2021,1,512,512,512.00,0.00,1010,1011
2022,1,512,512,512.00,0.00,1010,1011
2023,1,512,512,512.00,0.00,1010,1011
2024,4,264,17,128.00,9862.50,1010,1014
2025,2,428,84,256.00,29584.00,1013,1015
2026,1,512,512,512.00,0.00,1014,1015
2027,2,273,239,256.00,289.00,1014,1016
2028,2,368,144,256.00,12544.00,1015,1017
2029,1,512,512,512.00,0.00,1016,1017
2030,1,512,512,512.00,0.00,1016,1017
2031,3,448,20,170.67,38552.89,1016,1019
2032,2,446,66,256.00,36100.00,1018,1020
2033,4,378,13,128.00,21674.50,1019,1023
2034,1,512,512,512.00,0.00,1022,1023
2035,1,512,512,512.00,0.00,1022,1023
2036,6,205,33,85.33,4893.89,1022,1028
2037,1,512,512,512.00,0.00,1027,1028
2038,1,512,512,512.00,0.00,1027,1028
2039,1,512,512,512.00,0.00,1027,1028
2040,2,284,228,256.00,784.00,1027,1029
2041,1,512,512,512.00,0.00,1028,1029
2042,1,512,512,512.00,0.00,1028,1029
2043,1,512,512,512.00,0.00,1028,1029
2044,1,512,512,512.00,0.00,1028,1029
2045,2,352,160,256.00,9216.00,1028,1030
2046,2,421,91,256.00,27225.00,1029,1031
2047,1,512,512,512.00,0.00,1030,1031
2048,1,512,512,512.00,0.00,1030,1031
2049,2,271,241,256.00,225.00,1030,1032
2050,1,512,512,512.00,0.00,1031,1032
2051,3,335,43,170.67,14882.89,1031,1034
2052,1,512,512,512.00,0.00,1033,1034
2053,1,512,512,512.00,0.00,1033,1034
2054,3,366,7,170.67,21981.56,1033,1036
2055,1,512,512,512.00,0.00,1035,1036
2056,1,512,512,512.00,0.00,1035,1036
2057,1,512,512,512.00,0.00,1035,1036
2058,2,297,215,256.00,1681.00,1035,1037
2059,2,272,240,256.00,256.00,1036,1038
2060,1,512,512,512.00,0.00,1037,1038
2061,5,483,3,102.40,36245.04,1037,1042
2062,1,512,512,512.00,0.00,1041,1042
2063,2,367,145,256.00,12321.00,1041,1043
2064,1,512,512,512.00,0.00,1042,1043
2065,1,512,512,512.00,0.00,1042,1043
2066,1,512,512,512.00,0.00,1042,1043
2067,4,387,8,128.00,22876.50,1042,1046
2068,1,512,512,512.00,0.00,1045,1046
2069,2,439,73,256.00,33489.00,1045,1047
2070,2,481,31,256.00,50625.00,1046,1048
2071,1,512,512,512.00,0.00,1047,1048
2072,1,512,512,512.00,0.00,1047,1048
2073,3,435,21,170.67,35140.22,1047,1050
2074,1,512,512,512.00,0.00,1049,1050
2075,2,329,183,256.00,5329.00,1049,1051
2076,1,512,512,512.00,0.00,1050,1051
2077,2,401,111,256.00,21025.00,1050,1052
2078,1,512,512,512.00,0.00,1051,1052
2079,1,512,512,512.00,0.00,1051,1052
2080,1,512,512,512.00,0.00,1051,1052
2081,3,371,3,170.67,23104.22,1051,1054
2082,1,512,512,512.00,0.00,1053,1054
2083,1,512,512,512.00,0.00,1053,1054
2084,1,512,512,512.00,0.00,1053,1054
2085,1,512,512,512.00,0.00,1053,1054
2086,2,340,172,256.00,7056.00,1053,1055
2087,1,512,512,512.00,0.00,1054,1055
2088,1,512,512,512.00,0.00,1054,1055
2089,1,512,512,512.00,0.00,1054,1055
2090,2,271,241,256.00,225.00,1054,1056
2091,1,512,512,512.00,0.00,1055,1056
2092,1,512,512,512.00,0.00,1055,1056
2093,3,271,20,170.67,11766.89,1055,1058
2094,1,512,512,512.00,0.00,1057,1058
2095,1,512,512,512.00,0.00,1057,1058
2096,1,512,512,512.00,0.00,1057,1058
2097,2,369,143,256.00,12769.00,1057,1059
2098,1,512,512,512.00,0.00,1058,1059
2099,1,512,512,512.00,0.00,1058,1059
2100,2,330,182,256.00,5476.00,1058,1060
2101,1,512,512,512.00,0.00,1059,1060
2102,1,512,512,512.00,0.00,1059,1060
2103,1,512,512,512.00,0.00,1059,1060
2104,3,341,83,170.67,14510.89,1059,1062
2105,1,512,512,512.00,0.00,1061,1062
2106,2,477,35,256.00,48841.00,1061,1063
2107,1,512,512,512.00,0.00,1062,1063
2108,1,512,512,512.00,0.00,1062,1063
2109,1,512,512,512.00,0.00,1062,1063
2110,2,409,103,256.00,23409.00,1062,1064
2111,1,512,512,512.00,0.00,1063,1064
2112,1,512,512,512.00,0.00,1063,1064
2113,2,449,63,256.00,37249.00,1063,1065
2114,1,512,512,512.00,0.00,1064,1065
2115,1,512,512,512.00,0.00,1064,1065
2116,2,295,217,256.00,1521.00,1064,1066
2117,2,275,237,256.00,361.00,1065,1067
2118,1,512,512,512.00,0.00,1066,1067
2119,7,162,1,73.14,4191.27,1066,1073
2120,1,512,512,512.00,0.00,1072,1073
2121,1,512,512,512.00,0.00,1072,1073
2122,1,512,512,512.00,0.00,1072,1073
2123,1,512,512,512.00,0.00,1072,1073
2124,1,512,512,512.00,0.00,1072,1073
2125,2,336,176,256.00,6400.00,1072,1074
2126,2,360,152,256.00,10816.00,1073,1075
2127,1,512,512,512.00,0.00,1074,1075
2128,1,512,512,512.00,0.00,1074,1075
2129,1,512,512,512.00,0.00,1074,1075
2130,1,512,512,512.00,0.00,1074,1075
2131,2,390,122,256.00,17956.00,1074,1076
2132,1,512,512,512.00,0.00,1075,1076
2133,1,512,512,512.00,0.00,1075,1076
2134,2,372,140,256.00,13456.00,1075,1077
2135,1,512,512,512.00,0.00,1076,1077
2136,2,384,128,256.00,16384.00,1076,1078
2137,2,489,23,256.00,54289.00,1077,1079
2138,1,512,512,512.00,0.00,1078,1079
2139,1,512,512,512.00,0.00,1078,1079
2140,1,512,512,512.00,0.00,1078,1079
2141,1,512,512,512.00,0.00,1078,1079
2142,1,512,512,512.00,0.00,1078,1079
2143,1,512,512,512.00,0.00,1078,1079
2144,2,406,106,256.00,22500.00,1078,1080
2145,1,512,512,512.00,0.00,1079,1080
2146,1,512,512,512.00,0.00,1079,1080
2147,1,512,512,512.00,0.00,1079,1080
2148,1,512,512,512.00,0.00,1079,1080
2149,1,512,512,512.00,0.00,1079,1080
2150,4,258,46,128.00,7076.00,1079,1083
2151,3,388,6,170.67,25707.56,1082,1085
2152,2,383,129,256.00,16129.00,1084,1086
2153,1,512,512,512.00,0.00,1085,1086
2154,1,512,512,512.00,0.00,1085,1086
2155,2,510,2,256.00,64516.00,1085,1087
2156,1,512,512,512.00,0.00,1086,1087
2157,1,512,512,512.00,0.00,1086,1087
2158,4,403,13,128.00,25574.50,1086,1090
2159,1,512,512,512.00,0.00,1089,1090
2160,2,429,83,256.00,29929.00,1089,1091
2161,1,512,512,512.00,0.00,1090,1091
2162,1,512,512,512.00,0.00,1090,1091
2163,3,491,5,170.67,51326.89,1090,1093
2164,1,512,512,512.00,0.00,1092,1093
2165,1,512,512,512.00,0.00,1092,1093
2166,1,512,512,512.00,0.00,1092,1093
2167,1,512,512,512.00,0.00,1092,1093
2168,2,339,173,256.00,6889.00,1092,1094
2169,1,512,512,512.00,0.00,1093,1094
2170,1,512,512,512.00,0.00,1093,1094
2171,3,253,96,170.67,4137.56,1093,1096
2172,3,458,16,170.67,41360.89,1095,1098
2173,1,512,512,512.00,0.00,1097,1098
2174,2,414,98,256.00,24964.00,1097,1099
2175,1,512,512,512.00,0.00,1098,1099
2176,1,512,512,512.00,0.00,1098,1099
2177,2,261,251,256.00,25.00,1098,1100
2178,1,512,512,512.00,0.00,1099,1100
2179,2,320,192,256.00,4096.00,1099,1101
2180,1,512,512,512.00,0.00,1100,1101
2181,1,512,512,512.00,0.00,1100,1101
2182,1,512,512,512.00,0.00,1100,1101
2183,2,284,228,256.00,784.00,1100,1102
2184,2,369,143,256.00,12769.00,1101,1103
2185,2,507,5,256.00,63001.00,1102,1104
2186,1,512,512,512.00,0.00,1103,1104
2187,1,512,512,512.00,0.00,1103,1104
2188,1,512,512,512.00,0.00,1103,1104
2189,4,454,7,128.00,35635.50,1103,1107
2190,8,307,2,64.00,9612.75,1106,1114
2191,1,512,512,512.00,0.00,1113,1114
2192,1,512,512,512.00,0.00,1113,1114
2193,1,512,512,512.00,0.00,1113,1114
2194,2,264,248,256.00,64.00,1113,1115
2195,2,380,132,256.00,15376.00,1114,1116
2196,1,512,512,512.00,0.00,1115,1116
2197,1,512,512,512.00,0.00,1115,1116
2198,2,385,127,256.00,16641.00,1115,1117
2199,1,512,512,512.00,0.00,1116,1117
2200,1,512,512,512.00,0.00,1116,1117
2201,1,512,512,512.00,0.00,1116,1117
2202,2,271,241,256.00,225.00,1116,1118
2203,1,512,512,512.00,0.00,1117,1118
2204,2,418,94,256.00,26244.00,1117,1119
2205,3,292,6,170.67,14571.56,1118,1121
2206,1,512,512,512.00,0.00,1120,1121
2207,1,512,512,512.00,0.00,1120,1121
2208,1,512,512,512.00,0.00,1120,1121
2209,2,278,234,256.00,484.00,1120,1122
2210,2,363,149,256.00,11449.00,1121,1123
2211,1,512,512,512.00,0.00,1122,1123
2212,1,512,512,512.00,0.00,1122,1123
2213,1,512,512,512.00,0.00,1122,1123
2214,1,512,512,512.00,0.00,1122,1123
2215,3,258,106,170.67,4107.56,1122,1125
2216,1,512,512,512.00,0.00,1124,1125
2217,2,269,243,256.00,169.00,1124,1126
2218,1,512,512,512.00,0.00,1125,1126
2219,1,512,512,512.00,0.00,1125,1126
2220,1,512,512,512.00,0.00,1125,1126
2221,1,512,512,512.00,0.00,1125,1126
2222,2,348,164,256.00,8464.00,1125,1127
2223,1,512,512,512.00,0.00,1126,1127
2224,1,512,512,512.00,0.00,1126,1127
2225,1,512,512,512.00,0.00,1126,1127
2226,2,332,180,256.00,5776.00,1126,1128
2227,2,260,252,256.00,16.00,1127,1129
2228,1,512,512,512.00,0.00,1128,1129
2229,1,512,512,512.00,0.00,1128,1129
2230,2,291,221,256.00,1225.00,1128,1130
2231,1,512,512,512.00,0.00,1129,1130
2232,2,386,126,256.00,16900.00,1129,1131
2233,1,512,512,512.00,0.00,1130,1131
2234,2,460,52,256.00,41616.00,1130,1132
2235,3,299,26,170.67,12554.89,1131,1134
2236,1,512,512,512.00,0.00,1133,1134
2237,3,259,44,170.67,8438.89,1133,1136
2238,2,433,79,256.00,31329.00,1135,1137
2239,1,512,512,512.00,0.00,1136,1137
2240,1,512,512,512.00,0.00,1136,1137
2241,1,512,512,512.00,0.00,1136,1137
2242,1,512,512,512.00,0.00,1136,1137
2243,2,298,214,256.00,1764.00,1136,1138
2244,4,336,2,128.00,19238.00,1137,1141
2245,1,512,512,512.00,0.00,1140,1141
2246,1,512,512,512.00,0.00,1140,1141
2247,1,512,512,512.00,0.00,1140,1141
2248,2,380,132,256.00,15376.00,1140,1142
2249,1,512,512,512.00,0.00,1141,1142
2250,1,512,512,512.00,0.00,1141,1142
2251,2,439,73,256.00,33489.00,1141,1143
2252,1,512,512,512.00,0.00,1142,1143
2253,1,512,512,512.00,0.00,1142,1143
2254,1,512,512,512.00,0.00,1142,1143
2255,1,512,512,512.00,0.00,1142,1143
2256,3,406,19,170.67,28461.56,1142,1145
2257,1,512,512,512.00,0.00,1144,1145
2258,2,398,114,256.00,20164.00,1144,1146
2259,1,512,512,512.00,0.00,1145,1146
2260,1,512,512,512.00,0.00,1145,1146
2261,1,512,512,512.00,0.00,1145,1146
2262,1,512,512,512.00,0.00,1145,1146
2263,3,290,66,170.67,8470.22,1145,1148
2264,3,265,113,170.67,4522.89,1147,1150
2265,2,450,62,256.00,37636.00,1149,1151
2266,1,512,512,512.00,0.00,1150,1151
2267,1,512,512,512.00,0.00,1150,1151
2268,2,398,114,256.00,20164.00,1150,1152
2269,1,512,512,512.00,0.00,1151,1152
2270,1,512,512,512.00,0.00,1151,1152
2271,1,512,512,512.00,0.00,1151,1152
2272,6,241,1,85.33,7209.56,1151,1157
2273,1,512,512,512.00,0.00,1156,1157
2274,2,392,120,256.00,18496.00,1156,1158
2275,1,512,512,512.00,0.00,1157,1158
2276,1,512,512,512.00,0.00,1157,1158
2277,1,512,512,512.00,0.00,1157,1158
2278,1,512,512,512.00,0.00,1157,1158
2279,2,344,168,256.00,7744.00,1157,1159
2280,1,512,512,512.00,0.00,1158,1159
2281,1,512,512,512.00,0.00,1158,1159
2282,2,323,189,256.00,4489.00,1158,1160
2283,1,512,512,512.00,0.00,1159,1160
2284,1,512,512,512.00,0.00,1159,1160
2285,2,417,95,256.00,25921.00,1159,1161
2286,1,512,512,512.00,0.00,1160,1161
2287,2,279,233,256.00,529.00,1160,1162
2288,1,512,512,512.00,0.00,1161,1162
2289,2,304,208,256.00,2304.00,1161,1163
2290,1,512,512,512.00,0.00,1162,1163
2291,2,374,138,256.00,13924.00,1162,1164
2292,1,512,512,512.00,0.00,1163,1164
2293,3,234,62,170.67,5958.22,1163,1166
2294,1,512,512,512.00,0.00,1165,1166
2295,2,442,70,256.00,34596.00,1165,1167
2296,2,343,169,256.00,7569.00,1166,1168
2297,2,478,34,256.00,49284.00,1167,1169
2298,2,300,212,256.00,1936.00,1168,1170
2299,1,512,512,512.00,0.00,1169,1170
2300,6,155,1,85.33,2652.56,1169,1175
2301,2,411,101,256.00,24025.00,1174,1176
2302,2,375,137,256.00,14161.00,1175,1177
2303,1,512,512,512.00,0.00,1176,1177
2304,5,217,8,102.40,6342.64,1176,1181
2305,2,371,141,256.00,13225.00,1180,1182
2306,1,512,512,512.00,0.00,1181,1182
2307,1,512,512,512.00,0.00,1181,1182
2308,1,512,512,512.00,0.00,1181,1182
2309,1,512,512,512.00,0.00,1181,1182
2310,1,512,512,512.00,0.00,1181,1182
2311,1,512,512,512.00,0.00,1181,1182
2312,1,512,512,512.00,0.00,1181,1182
2313,1,512,512,512.00,0.00,1181,1182
2314,1,512,512,512.00,0.00,1181,1182
2315,2,262,250,256.00,36.00,1181,1183
2316,1,512,512,512.00,0.00,1182,1183
2317,1,512,512,512.00,0.00,1182,1183
2318,1,512,512,512.00,0.00,1182,1183
2319,2,465,47,256.00,43681.00,1182,1184
2320,1,512,512,512.00,0.00,1183,1184
2321,1,512,512,512.00,0.00,1183,1184
2322,1,512,512,512.00,0.00,1183,1184
2323,2,510,2,256.00,64516.00,1183,1185
2324,2,374,138,256.00,13924.00,1184,1186
2325,1,512,512,512.00,0.00,1185,1186
2326,1,512,512,512.00,0.00,1185,1186
2327,2,375,137,256.00,14161.00,1185,1187
2328,1,512,512,512.00,0.00,1186,1187
2329,1,512,512,512.00,0.00,1186,1187
2330,1,512,512,512.00,0.00,1186,1187
2331,1,512,512,512.00,0.00,1186,1187
2332,1,512,512,512.00,0.00,1186,1187
2333,2,342,170,256.00,7396.00,1186,1188
2334,2,349,163,256.00,8649.00,1187,1189
2335,1,512,512,512.00,0.00,1188,1189
2336,1,512,512,512.00,0.00,1188,1189
2337,1,512,512,512.00,0.00,1188,1189
2338,4,375,2,128.00,21261.50,1188,1192
2339,3,234,115,170.67,2389.56,1191,1194
2340,1,512,512,512.00,0.00,1193,1194
2341,1,512,512,512.00,0.00,1193,1194
2342,1,512,512,512.00,0.00,1193,1194
2343,1,512,512,512.00,0.00,1193,1194
2344,1,512,512,512.00,0.00,1193,1194
2345,2,386,126,256.00,16900.00,1193,1195
2346,1,512,512,512.00,0.00,1194,1195
2347,1,512,512,512.00,0.00,1194,1195
2348,2,392,120,256.00,18496.00,1194,1196
2349,2,460,52,256.00,41616.00,1195,1197
2350,1,512,512,512.00,0.00,1196,1197
2351,1,512,512,512.00,0.00,1196,1197
2352,2,284,228,256.00,784.00,1196,1198
2353,5,176,14,102.40,4025.04,1197,1202
2354,1,512,512,512.00,0.00,1201,1202
2355,1,512,512,512.00,0.00,1201,1202
2356,2,310,202,256.00,2916.00,1201,1203
2357,2,470,42,256.00,45796.00,1202,1204
2358,2,274,238,256.00,324.00,1203,1205
2359,1,512,512,512.00,0.00,1204,1205
2360,3,408,24,170.67,28686.22,1204,1207
2361,1,512,512,512.00,0.00,1206,1207
2362,1,512,512,512.00,0.00,1206,1207
2363,1,512,512,512.00,0.00,1206,1207
2364,2,462,50,256.00,42436.00,1206,1208
2365,1,512,512,512.00,0.00,1207,1208
2366,1,512,512,512.00,0.00,1207,1208
2367,2,414,98,256.00,24964.00,1207,1209
2368,1,512,512,512.00,0.00,1208,1209
2369,1,512,512,512.00,0.00,1208,1209
2370,1,512,512,512.00,0.00,1208,1209
2371,1,512,512,512.00,0.00,1208,1209
2372,1,512,512,512.00,0.00,1208,1209
2373,2,405,107,256.00,22201.00,1208,1210
2374,1,512,512,512.00,0.00,1209,1210
2375,1,512,512,512.00,0.00,1209,1210
2376,1,512,512,512.00,0.00,1209,1210
2377,1,512,512,512.00,0.00,1209,1210
2378,2,495,17,256.00,57121.00,1209,1211
2379,1,512,512,512.00,0.00,1210,1211
2380,4,292,5,128.00,15087.50,1210,1214
2381,1,512,512,512.00,0.00,1213,1214
2382,1,512,512,512.00,0.00,1213,1214
2383,1,512,512,512.00,0.00,1213,1214
2384,1,512,512,512.00,0.00,1213,1214
2385,1,512,512,512.00,0.00,1213,1214
2386,3,385,29,170.67,23762.89,1213,1216
2387,4,254,16,128.00,7970.00,1215,1219
2388,1,512,512,512.00,0.00,1218,1219
2389,3,321,56,170.67,12340.22,1218,1221
2390,1,512,512,512.00,0.00,1220,1221
2391,1,512,512,512.00,0.00,1220,1221
2392,1,512,512,512.00,0.00,1220,1221
2393,4,238,58,128.00,4762.50,1220,1224
2394,1,512,512,512.00,0.00,1223,1224
2395,1,512,512,512.00,0.00,1223,1224
2396,1,512,512,512.00,0.00,1223,1224
2397,2,345,167,256.00,7921.00,1223,1225
2398,1,512,512,512.00,0.00,1224,1225
2399,1,512,512,512.00,0.00,1224,1225
2400,2,409,103,256.00,23409.00,1224,1226
2401,3,451,4,170.67,39761.56,1225,1228
2402,1,512,512,512.00,0.00,1227,1228
2403,1,512,512,512.00,0.00,1227,1228
2404,1,512,512,512.00,0.00,1227,1228
2405,1,512,512,512.00,0.00,1227,1228
2406,2,394,118,256.00,19044.00,1227,1229
2407,1,512,512,512.00,0.00,1228,1229
2408,1,512,512,512.00,0.00,1228,1229
2409,1,512,512,512.00,0.00,1228,1229
2410,2,460,52,256.00,41616.00,1228,1230
2411,1,512,512,512.00,0.00,1229,1230
2412,1,512,512,512.00,0.00,1229,1230
2413,1,512,512,512.00,0.00,1229,1230
2414,2,418,94,256.00,26244.00,1229,1231
2415,1,512,512,512.00,0.00,1230,1231
2416,2,271,241,256.00,225.00,1230,1232
2417,1,512,512,512.00,0.00,1231,1232
2418,1,512,512,512.00,0.00,1231,1232
2419,1,512,512,512.00,0.00,1231,1232
2420,2,375,137,256.00,14161.00,1231,1233
2421,4,228,1,128.00,6668.50,1232,1236
2422,1,512,512,512.00,0.00,1235,1236
2423,2,298,214,256.00,1764.00,1235,1237
2424,2,334,178,256.00,6084.00,1236,1238
2425,1,512,512,512.00,0.00,1237,1238
2426,2,470,42,256.00,45796.00,1237,1239
2427,2,289,223,256.00,1089.00,1238,1240
2428,4,211,3,128.00,5853.50,1239,1243
2429,2,426,86,256.00,28900.00,1242,1244
2430,1,512,512,512.00,0.00,1243,1244
2431,1,512,512,512.00,0.00,1243,1244
2432,2,292,220,256.00,1296.00,1243,1245
2433,1,512,512,512.00,0.00,1244,1245
2434,1,512,512,512.00,0.00,1244,1245
2435,3,358,75,170.67,17549.56,1244,1247
2436,2,470,42,256.00,45796.00,1246,1248
2437,1,512,512,512.00,0.00,1247,1248
2438,1,512,512,512.00,0.00,1247,1248
2439,3,263,123,170.67,4264.22,1247,1250
2440,2,448,64,256.00,36864.00,1249,1251
2441,2,293,219,256.00,1369.00,1250,1252
2442,1,512,512,512.00,0.00,1251,1252
2443,1,512,512,512.00,0.00,1251,1252
2444,2,419,93,256.00,26569.00,1251,1253
2445,1,512,512,512.00,0.00,1252,1253
2446,1,512,512,512.00,0.00,1252,1253
2447,1,512,512,512.00,0.00,1252,1253
2448,1,512,512,512.00,0.00,1252,1253
2449,2,419,93,256.00,26569.00,1252,1254
2450,1,512,512,512.00,0.00,1253,1254
2451,1,512,512,512.00,0.00,1253,1254
2452,1,512,512,512.00,0.00,1253,1254
2453,1,512,512,512.00,0.00,1253,1254
2454,2,257,255,256.00,1.00,1253,1255
2455,1,512,512,512.00,0.00,1254,1255
2456,1,512,512,512.00,0.00,1254,1255
2457,1,512,512,512.00,0.00,1254,1255
2458,2,439,73,256.00,33489.00,1254,1256
2459,1,512,512,512.00,0.00,1255,1256
2460,1,512,512,512.00,0.00,1255,1256
2461,2,293,219,256.00,1369.00,1255,1257
2462,2,485,27,256.00,52441.00,1256,1258
2463,1,512,512,512.00,0.00,1257,1258
2464,2,326,186,256.00,4900.00,1257,1259
2465,1,512,512,512.00,0.00,1258,1259
2466,1,512,512,512.00,0.00,1258,1259
2467,3,345,25,170.67,17477.56,1258,1261
2468,1,512,512,512.00,0.00,1260,1261
2469,1,512,512,512.00,0.00,1260,1261
2470,2,397,115,256.00,19881.00,1260,1262
2471,3,224,71,170.67,4974.89,1261,1264
2472,4,196,48,128.00,2936.00,1263,1267
2473,2,471,41,256.00,46225.00,1266,1268
2474,1,512,512,512.00,0.00,1267,1268
2475,2,290,222,256.00,1156.00,1267,1269
2476,4,204,69,128.00,2581.50,1268,1272
2477,1,512,512,512.00,0.00,1271,1272
2478,1,512,512,512.00,0.00,1271,1272
2479,1,512,512,512.00,0.00,1271,1272
2480,1,512,512,512.00,0.00,1271,1272
2481,4,267,1,128.00,16080.50,1271,1275
2482,2,430,82,256.00,30276.00,1274,1276
2483,1,512,512,512.00,0.00,1275,1276
2484,2,505,7,256.00,62001.00,1275,1277
2485,2,333,179,256.00,5929.00,1276,1278
2486,1,512,512,512.00,0.00,1277,1278
2487,2,334,178,256.00,6084.00,1277,1279
2488,1,512,512,512.00,0.00,1278,1279
2489,1,512,512,512.00,0.00,1278,1279
2490,2,387,125,256.00,17161.00,1278,1280
2491,1,512,512,512.00,0.00,1279,1280
2492,1,512,512,512.00,0.00,1279,1280
2493,2,315,197,256.00,3481.00,1279,1281
2494,1,512,512,512.00,0.00,1280,1281
2495,2,424,88,256.00,28224.00,1280,1282
2496,2,424,88,256.00,28224.00,1281,1283
2497,3,471,20,170.67,45100.22,1282,1285
2498,1,512,512,512.00,0.00,1284,1285
2499,1,512,512,512.00,0.00,1284,1285
2500,1,512,512,512.00,0.00,1284,1285
2501,2,502,10,256.00,60516.00,1284,1286
2502,1,512,512,512.00,0.00,1285,1286
2503,2,457,55,256.00,40401.00,1285,1287
2504,2,490,22,256.00,54756.00,1286,1288
2505,2,425,87,256.00,28561.00,1287,1289
2506,1,512,512,512.00,0.00,1288,1289
2507,1,512,512,512.00,0.00,1288,1289
2508,1,512,512,512.00,0.00,1288,1289
2509,4,222,6,128.00,6828.00,1288,1292
2510,3,253,76,170.67,5297.56,1291,1294
2511,2,503,9,256.00,61009.00,1293,1295
2512,2,394,118,256.00,19044.00,1294,1296
2513,1,512,512,512.00,0.00,1295,1296
2514,2,313,199,256.00,3249.00,1295,1297
2515,1,512,512,512.00,0.00,1296,1297
2516,1,512,512,512.00,0.00,1296,1297
2517,2,359,153,256.00,10609.00,1296,1298
2518,1,512,512,512.00,0.00,1297,1298
2519,1,512,512,512.00,0.00,1297,1298
2520,2,305,207,256.00,2401.00,1297,1299
2521,1,512,512,512.00,0.00,1298,1299
2522,3,223,103,170.67,2517.56,1298,1301
2523,1,512,512,512.00,0.00,1300,1301
2524,1,512,512,512.00,0.00,1300,1301
2525,2,349,163,256.00,8649.00,1300,1302
2526,1,512,512,512.00,0.00,1301,1302
2527,1,512,512,512.00,0.00,1301,1302
2528,1,512,512,512.00,0.00,1301,1302
2529,1,512,512,512.00,0.00,1301,1302
2530,2,489,23,256.00,54289.00,1301,1303
2531,1,512,512,512.00,0.00,1302,1303
2532,1,512,512,512.00,0.00,1302,1303
2533,1,512,512,512.00,0.00,1302,1303
2534,2,351,161,256.00,9025.00,1302,1304
2535,1,512,512,512.00,0.00,1303,1304
2536,2,349,163,256.00,8649.00,1303,1305
2537,1,512,512,512.00,0.00,1304,1305
2538,1,512,512,512.00,0.00,1304,1305
2539,2,372,140,256.00,13456.00,1304,1306
2540,1,512,512,512.00,0.00,1305,1306
2541,1,512,512,512.00,0.00,1305,1306
2542,1,512,512,512.00,0.00,1305,1306
2543,2,460,52,256.00,41616.00,1305,1307
2544,1,512,512,512.00,0.00,1306,1307
2545,3,358,55,170.67,17869.56,1306,1309
2546,1,512,512,512.00,0.00,1308,1309
2547,2,288,224,256.00,1024.00,1308,1310
2548,1,512,512,512.00,0.00,1309,1310
2549,1,512,512,512.00,0.00,1309,1310
2550,1,512,512,512.00,0.00,1309,1310
2551,1,512,512,512.00,0.00,1309,1310
2552,1,512,512,512.00,0.00,1309,1310
2553,2,270,242,256.00,196.00,1309,1311
2554,1,512,512,512.00,0.00,1310,1311
2555,2,281,231,256.00,625.00,1310,1312
2556,1,512,512,512.00,0.00,1311,1312
2557,1,512,512,512.00,0.00,1311,1312
2558,2,491,21,256.00,55225.00,1311,1313
2559,3,277,14,170.67,12794.89,1312,1315
2560,2,328,184,256.00,5184.00,1314,1316
2561,1,512,512,512.00,0.00,1315,1316
2562,3,370,55,170.67,20037.56,1315,1318
2563,1,512,512,512.00,0.00,1317,1318
2564,1,512,512,512.00,0.00,1317,1318
2565,2,416,96,256.00,25600.00,1317,1319
2566,1,512,512,512.00,0.00,1318,1319
2567,2,374,138,256.00,13924.00,1318,1320
2568,1,512,512,512.00,0.00,1319,1320
2569,1,512,512,512.00,0.00,1319,1320
2570,1,512,512,512.00,0.00,1319,1320
2571,1,512,512,512.00,0.00,1319,1320
2572,1,512,512,512.00,0.00,1319,1320
2573,2,362,150,256.00,11236.00,1319,1321
2574,2,477,35,256.00,48841.00,1320,1322
2575,2,266,246,256.00,100.00,1321,1323
2576,1,512,512,512.00,0.00,1322,1323
2577,1,512,512,512.00,0.00,1322,1323
2578,1,512,512,512.00,0.00,1322,1323
2579,1,512,512,512.00,0.00,1322,1323
2580,1,512,512,512.00,0.00,1322,1323
2581,2,409,103,256.00,23409.00,1322,1324
2582,1,512,512,512.00,0.00,1323,1324
2583,3,316,19,170.67,14721.56,1323,1326
2584,1,512,512,512.00,0.00,1325,1326
2585,1,512,512,512.00,0.00,1325,1326
2586,1,512,512,512.00,0.00,1325,1326
2587,3,263,46,170.67,8370.89,1325,1328
2588,2,259,253,256.00,9.00,1327,1329
2589,4,187,59,128.00,2553.50,1328,1332
2590,1,512,512,512.00,0.00,1331,1332
2591,1,512,512,512.00,0.00,1331,1332
2592,2,374,138,256.00,13924.00,1331,1333
2593,1,512,512,512.00,0.00,1332,1333
2594,1,512,512,512.00,0.00,1332,1333
2595,1,512,512,512.00,0.00,1332,1333
2596,1,512,512,512.00,0.00,1332,1333
2597,2,262,250,256.00,36.00,1332,1334
2598,1,512,512,512.00,0.00,1333,1334
2599,1,512,512,512.00,0.00,1333,1334
2600,2,256,256,256.00,0.00,1333,1335
2601,2,336,176,256.00,6400.00,1334,1336
2602,1,512,512,512.00,0.00,1335,1336
2603,1,512,512,512.00,0.00,1335,1336
2604,1,512,512,512.00,0.00,1335,1336
2605,3,238,64,170.67,5819.56,1335,1338
2606,1,512,512,512.00,0.00,1337,1338
2607,1,512,512,512.00,0.00,1337,1338
2608,1,512,512,512.00,0.00,1337,1338
2609,1,512,512,512.00,0.00,1337,1338
2610,1,512,512,512.00,0.00,1337,1338
2611,2,387,125,256.00,17161.00,1337,1339
2612,1,512,512,512.00,0.00,1338,1339
2613,1,512,512,512.00,0.00,1338,1339
2614,2,335,177,256.00,6241.00,1338,1340
2615,2,387,125,256.00,17161.00,1339,1341
2616,2,413,99,256.00,24649.00,1340,1342
2617,1,512,512,512.00,0.00,1341,1342
2618,2,283,229,256.00,729.00,1341,1343
2619,1,512,512,512.00,0.00,1342,1343
2620,1,512,512,512.00,0.00,1342,1343
2621,1,512,512,512.00,0.00,1342,1343
2622,2,384,128,256.00,16384.00,1342,1344
2623,1,512,512,512.00,0.00,1343,1344
2624,1,512,512,512.00,0.00,1343,1344
2625,2,347,165,256.00,8281.00,1343,1345
2626,2,489,23,256.00,54289.00,1344,1346
2627,2,275,237,256.00,361.00,1345,1347
2628,3,392,10,170.67,26160.89,1346,1349
2629,2,388,124,256.00,17424.00,1348,1350
2630,3,310,80,170.67,10000.89,1349,1352
2631,2,510,2,256.00,64516.00,1351,1353
2632,2,429,83,256.00,29929.00,1352,1354
2633,1,512,512,512.00,0.00,1353,1354
2634,2,372,140,256.00,13456.00,1353,1355
2635,1,512,512,512.00,0.00,1354,1355
2636,2,277,235,256.00,441.00,1354,1356
2637,1,512,512,512.00,0.00,1355,1356
2638,1,512,512,512.00,0.00,1355,1356
2639,2,429,83,256.00,29929.00,1355,1357
2640,1,512,512,512.00,0.00,1356,1357
2641,1,512,512,512.00,0.00,1356,1357
2642,1,512,512,512.00,0.00,1356,1357
2643,2,482,30,256.00,51076.00,1356,1358
2644,1,512,512,512.00,0.00,1357,1358
2645,2,467,45,256.00,44521.00,1357,1359
2646,1,512,512,512.00,0.00,1358,1359
2647,1,512,512,512.00,0.00,1358,1359
2648,5,166,7,102.40,3421.44,1358,1363
2649,2,296,216,256.00,1600.00,1362,1364
2650,1,512,512,512.00,0.00,1363,1364
2651,2,441,71,256.00,34225.00,1363,1365
2652,1,512,512,512.00,0.00,1364,1365
2653,2,507,5,256.00,63001.00,1364,1366
2654,1,512,512,512.00,0.00,1365,1366
2655,1,512,512,512.00,0.00,1365,1366
2656,2,460,52,256.00,41616.00,1365,1367
2657,1,512,512,512.00,0.00,1366,1367
2658,1,512,512,512.00,0.00,1366,1367
2659,1,512,512,512.00,0.00,1366,1367
2660,1,512,512,512.00,0.00,1366,1367
2661,1,512,512,512.00,0.00,1366,1367
2662,2,364,148,256.00,11664.00,1366,1368
2663,1,512,512,512.00,0.00,1367,1368
2664,1,512,512,512.00,0.00,1367,1368
2665,1,512,512,512.00,0.00,1367,1368
2666,1,512,512,512.00,0.00,1367,1368
2667,1,512,512,512.00,0.00,1367,1368
2668,2,363,149,256.00,11449.00,1367,1369
2669,2,323,189,256.00,4489.00,1368,1370
2670,1,512,512,512.00,0.00,1369,1370
2671,2,421,91,256.00,27225.00,1369,1371
2672,3,410,5,170.67,30050.89,1370,1373
2673,2,268,244,256.00,144.00,1372,1374
2674,1,512,512,512.00,0.00,1373,1374
2675,1,512,512,512.00,0.00,1373,1374
2676,1,512,512,512.00,0.00,1373,1374
2677,1,512,512,512.00,0.00,1373,1374
2678,4,256,29,128.00,6729.50,1373,1377
2679,3,242,35,170.67,9210.89,1376,1379
2680,1,512,512,512.00,0.00,1378,1379
2681,1,512,512,512.00,0.00,1378,1379
2682,1,512,512,512.00,0.00,1378,1379
2683,1,512,512,512.00,0.00,1378,1379
2684,3,245,94,170.67,3802.89,1378,1381
2685,1,512,512,512.00,0.00,1380,1381
2686,3,479,16,170.67,47534.89,1380,1383
2687,1,512,512,512.00,0.00,1382,1383
2688,1,512,512,512.00,0.00,1382,1383
2689,1,512,512,512.00,0.00,1382,1383
2690,2,405,107,256.00,22201.00,1382,1384
2691,2,344,168,256.00,7744.00,1383,1385
2692,2,403,109,256.00,21609.00,1384,1386
2693,1,512,512,512.00,0.00,1385,1386
2694,1,512,512,512.00,0.00,1385,1386
2695,3,235,44,170.67,8022.89,1385,1388
2696,1,512,512,512.00,0.00,1387,1388
2697,2,470,42,256.00,45796.00,1387,1389
2698,1,512,512,512.00,0.00,1388,1389
2699,1,512,512,512.00,0.00,1388,1389
2700,5,192,3,102.40,5778.64,1388,1393
2701,1,512,512,512.00,0.00,1392,1393
2702,1,512,512,512.00,0.00,1392,1393
2703,1,512,512,512.00,0.00,1392,1393
2704,1,512,512,512.00,0.00,1392,1393
2705,2,362,150,256.00,11236.00,1392,1394
2706,2,505,7,256.00,62001.00,1393,1395
2707,2,352,160,256.00,9216.00,1394,1396
2708,1,512,512,512.00,0.00,1395,1396
2709,2,304,208,256.00,2304.00,1395,1397
2710,1,512,512,512.00,0.00,1396,1397
2711,1,512,512,512.00,0.00,1396,1397
2712,1,512,512,512.00,0.00,1396,1397
2713,3,442,5,170.67,37410.89,1396,1399
2714,2,353,159,256.00,9409.00,1398,1400
2715,2,498,14,256.00,58564.00,1399,1401
2716,1,512,512,512.00,0.00,1400,1401
2717,1,512,512,512.00,0.00,1400,1401
2718,2,285,227,256.00,841.00,1400,1402
2719,1,512,512,512.00,0.00,1401,1402
2720,1,512,512,512.00,0.00,1401,1402
2721,1,512,512,512.00,0.00,1401,1402
2722,1,512,512,512.00,0.00,1401,1402
2723,3,415,33,170.67,30009.56,1401,1404
2724,2,266,246,256.00,100.00,1403,1405
2725,1,512,512,512.00,0.00,1404,1405
2726,2,437,75,256.00,32761.00,1404,1406
2727,4,252,10,128.00,11379.50,1405,1409
2728,2,350,162,256.00,8836.00,1408,1410
2729,2,458,54,256.00,40804.00,1409,1411
2730,3,249,75,170.67,5196.22,1410,1413
2731,1,512,512,512.00,0.00,1412,1413
2732,2,416,96,256.00,25600.00,1412,1414
2733,1,512,512,512.00,0.00,1413,1414
2734,1,512,512,512.00,0.00,1413,1414
2735,3,256,45,170.67,8233.56,1413,1416
2736,4,439,4,128.00,32531.50,1415,1419
2737,1,512,512,512.00,0.00,1418,1419
2738,1,512,512,512.00,0.00,1418,1419
2739,1,512,512,512.00,0.00,1418,1419
2740,3,313,17,170.67,14666.89,1418,1421
2741,1,512,512,512.00,0.00,1420,1421
2742,1,512,512,512.00,0.00,1420,1421
2743,2,301,211,256.00,2025.00,1420,1422
2744,3,188,143,170.67,390.89,1421,1424
2745,2,358,154,256.00,10404.00,1423,1425
2746,3,252,44,170.67,8238.22,1424,1427
2747,2,460,52,256.00,41616.00,1426,1428
2748,1,512,512,512.00,0.00,1427,1428
2749,1,512,512,512.00,0.00,1427,1428
2750,2,468,44,256.00,44944.00,1427,1429
2751,2,358,154,256.00,10404.00,1428,1430
2752,1,512,512,512.00,0.00,1429,1430
2753,1,512,512,512.00,0.00,1429,1430
2754,3,261,4,170.67,13921.56,1429,1432
2755,1,512,512,512.00,0.00,1431,1432
2756,1,512,512,512.00,0.00,1431,1432
2757,1,512,512,512.00,0.00,1431,1432
2758,1,512,512,512.00,0.00,1431,1432
2759,2,358,154,256.00,10404.00,1431,1433
2760,2,366,146,256.00,12100.00,1432,1434
2761,1,512,512,512.00,0.00,1433,1434
2762,3,432,3,170.67,35060.22,1433,1436
2763,1,512,512,512.00,0.00,1435,1436
2764,1,512,512,512.00,0.00,1435,1436
2765,1,512,512,512.00,0.00,1435,1436
2766,2,503,9,256.00,61009.00,1435,1437
2767,3,282,6,170.67,14118.22,1436,1439
2768,1,512,512,512.00,0.00,1438,1439
2769,1,512,512,512.00,0.00,1438,1439
2770,3,329,7,170.67,17294.89,1438,1441
2771,1,512,512,512.00,0.00,1440,1441
2772,1,512,512,512.00,0.00,1440,1441
2773,3,380,1,170.67,24726.89,1440,1443
2774,1,512,512,512.00,0.00,1442,1443
2775,1,512,512,512.00,0.00,1442,1443
2776,1,512,512,512.00,0.00,1442,1443
2777,1,512,512,512.00,0.00,1442,1443
2778,1,512,512,512.00,0.00,1442,1443
2779,1,512,512,512.00,0.00,1442,1443
2780,5,341,13,102.40,14964.64,1442,1447
2781,1,512,512,512.00,0.00,1446,1447
2782,1,512,512,512.00,0.00,1446,1447
2783,1,512,512,512.00,0.00,1446,1447
2784,1,512,512,512.00,0.00,1446,1447
2785,1,512,512,512.00,0.00,1446,1447
2786,2,463,49,256.00,42849.00,1446,1448
2787,1,512,512,512.00,0.00,1447,1448
2788,1,512,512,512.00,0.00,1447,1448
2789,1,512,512,512.00,0.00,1447,1448
2790,1,512,512,512.00,0.00,1447,1448
2791,2,378,134,256.00,14884.00,1447,1449
2792,1,512,512,512.00,0.00,1448,1449
2793,1,512,512,512.00,0.00,1448,1449
2794,1,512,512,512.00,0.00,1448,1449
2795,1,512,512,512.00,0.00,1448,1449
2796,2,385,127,256.00,16641.00,1448,1450
2797,1,512,512,512.00,0.00,1449,1450
2798,1,512,512,512.00,0.00,1449,1450
2799,1,512,512,512.00,0.00,1449,1450
2800,2,367,145,256.00,12321.00,1449,1451
2801,1,512,512,512.00,0.00,1450,1451
2802,2,406,106,256.00,22500.00,1450,1452
2803,1,512,512,512.00,0.00,1451,1452
2804,1,512,512,512.00,0.00,1451,1452
2805,1,512,512,512.00,0.00,1451,1452
2806,1,512,512,512.00,0.00,1451,1452
2807,1,512,512,512.00,0.00,1451,1452
2808,1,512,512,512.00,0.00,1451,1452
2809,2,433,79,256.00,31329.00,1451,1453
2810,1,512,512,512.00,0.00,1452,1453
2811,2,277,235,256.00,441.00,1452,1454
2812,1,512,512,512.00,0.00,1453,1454
2813,1,512,512,512.00,0.00,1453,1454
2814,1,512,512,512.00,0.00,1453,1454
2815,4,329,28,128.00,13941.50,1453,1457
2816,1,512,512,512.00,0.00,1456,1457
2817,1,512,512,512.00,0.00,1456,1457
2818,1,512,512,512.00,0.00,1456,1457
2819,3,279,51,170.67,8728.22,1456,1459
2820,1,512,512,512.00,0.00,1458,1459
2821,1,512,512,512.00,0.00,1458,1459
2822,1,512,512,512.00,0.00,1458,1459
2823,3,319,56,170.67,12094.89,1458,1461
2824,4,287,9,128.00,13932.50,1460,1464
2825,1,512,512,512.00,0.00,1463,1464
2826,1,512,512,512.00,0.00,1463,1464
2827,2,440,72,256.00,33856.00,1463,1465
2828,4,246,25,128.00,9087.50,1464,1468
2829,1,512,512,512.00,0.00,1467,1468
2830,1,512,512,512.00,0.00,1467,1468
2831,3,426,3,170.67,33664.22,1467,1470
2832,1,512,512,512.00,0.00,1469,1470
2833,1,512,512,512.00,0.00,1469,1470
2834,1,512,512,512.00,0.00,1469,1470
2835,3,290,108,170.67,7126.22,1469,1472
2836,1,512,512,512.00,0.00,1471,1472
2837,1,512,512,512.00,0.00,1471,1472
2838,3,312,57,170.67,11220.22,1471,1474
2839,2,409,103,256.00,23409.00,1473,1475
2840,1,512,512,512.00,0.00,1474,1475
2841,1,512,512,512.00,0.00,1474,1475
2842,2,450,62,256.00,37636.00,1474,1476
2843,2,272,240,256.00,256.00,1475,1477
2844,1,512,512,512.00,0.00,1476,1477
2845,1,512,512,512.00,0.00,1476,1477
2846,1,512,512,512.00,0.00,1476,1477
2847,1,512,512,512.00,0.00,1476,1477
2848,1,512,512,512.00,0.00,1476,1477
2849,2,370,142,256.00,12996.00,1476,1478
2850,1,512,512,512.00,0.00,1477,1478
2851,1,512,512,512.00,0.00,1477,1478
2852,2,290,222,256.00,1156.00,1477,1479
2853,2,381,131,256.00,15625.00,1478,1480
2854,1,512,512,512.00,0.00,1479,1480
2855,2,309,203,256.00,2809.00,1479,1481
2856,1,512,512,512.00,0.00,1480,1481
2857,2,290,222,256.00,1156.00,1480,1482
2858,1,512,512,512.00,0.00,1481,1482
2859,4,347,5,128.00,19169.00,1481,1485
2860,1,512,512,512.00,0.00,1484,1485
2861,2,497,15,256.00,58081.00,1484,1486
2862,1,512,512,512.00,0.00,1485,1486
2863,3,283,8,170.67,13870.89,1485,1488
2864,1,512,512,512.00,0.00,1487,1488
2865,1,512,512,512.00,0.00,1487,1488
2866,1,512,512,512.00,0.00,1487,1488
2867,2,474,38,256.00,47524.00,1487,1489
2868,1,512,512,512.00,0.00,1488,1489
2869,2,334,178,256.00,6084.00,1488,1490
2870,1,512,512,512.00,0.00,1489,1490
2871,1,512,512,512.00,0.00,1489,1490
2872,2,470,42,256.00,45796.00,1489,1491
2873,1,512,512,512.00,0.00,1490,1491
2874,1,512,512,512.00,0.00,1490,1491
2875,1,512,512,512.00,0.00,1490,1491
2876,1,512,512,512.00,0.00,1490,1491
2877,2,256,256,256.00,0.00,1490,1492
2878,1,512,512,512.00,0.00,1491,1492
2879,2,361,151,256.00,11025.00,1491,1493
2880,1,512,512,512.00,0.00,1492,1493
2881,2,430,82,256.00,30276.00,1492,1494
2882,1,512,512,512.00,0.00,1493,1494
2883,1,512,512,512.00,0.00,1493,1494
2884,2,468,44,256.00,44944.00,1493,1495
2885,3,285,4,170.67,14529.56,1494,1497
2886,1,512,512,512.00,0.00,1496,1497
2887,1,512,512,512.00,0.00,1496,1497
2888,2,491,21,256.00,55225.00,1496,1498
2889,1,512,512,512.00,0.00,1497,1498
2890,1,512,512,512.00,0.00,1497,1498
2891,2,314,198,256.00,3364.00,1497,1499
2892,2,381,131,256.00,15625.00,1498,1500
2893,1,512,512,512.00,0.00,1499,1500
2894,1,512,512,512.00,0.00,1499,1500
2895,2,271,241,256.00,225.00,1499,1501
2896,1,512,512,512.00,0.00,1500,1501
2897,1,512,512,512.00,0.00,1500,1501
2898,3,195,122,170.67,1184.22,1500,1503
2899,1,512,512,512.00,0.00,1502,1503
2900,5,230,2,102.40,10355.84,1502,1507
2901,2,424,88,256.00,28224.00,1506,1508
2902,1,512,512,512.00,0.00,1507,1508
2903,1,512,512,512.00,0.00,1507,1508
2904,2,503,9,256.00,61009.00,1507,1509
2905,1,512,512,512.00,0.00,1508,1509
2906,1,512,512,512.00,0.00,1508,1509
2907,3,311,46,170.67,11826.89,1508,1511
2908,3,255,52,170.67,7457.56,1510,1513
2909,1,512,512,512.00,0.00,1512,1513
2910,1,512,512,512.00,0.00,1512,1513
2911,1,512,512,512.00,0.00,1512,1513
2912,1,512,512,512.00,0.00,1512,1513
2913,2,354,158,256.00,9604.00,1512,1514
2914,3,349,52,170.67,16481.56,1513,1516
2915,4,273,3,128.00,11524.50,1515,1519
2916,2,452,60,256.00,38416.00,1518,1520
2917,1,512,512,512.00,0.00,1519,1520
2918,1,512,512,512.00,0.00,1519,1520
2919,1,512,512,512.00,0.00,1519,1520
2920,1,512,512,512.00,0.00,1519,1520
2921,2,376,136,256.00,14400.00,1519,1521
2922,1,512,512,512.00,0.00,1520,1521
2923,1,512,512,512.00,0.00,1520,1521
2924,4,164,95,128.00,603.50,1520,1524
2925,3,483,11,170.67,48784.22,1523,1526
2926,2,412,100,256.00,24336.00,1525,1527
2927,1,512,512,512.00,0.00,1526,1527
2928,1,512,512,512.00,0.00,1526,1527
2929,2,305,207,256.00,2401.00,1526,1528
2930,2,444,68,256.00,35344.00,1527,1529
2931,1,512,512,512.00,0.00,1528,1529
2932,2,485,27,256.00,52441.00,1528,1530
2933,1,512,512,512.00,0.00,1529,1530
2934,2,329,183,256.00,5329.00,1529,1531
2935,3,482,5,170.67,48530.89,1530,1533
2936,1,512,512,512.00,0.00,1532,1533
2937,1,512,512,512.00,0.00,1532,1533
2938,1,512,512,512.00,0.00,1532,1533
2939,1,512,512,512.00,0.00,1532,1533
2940,1,512,512,512.00,0.00,1532,1533
2941,2,278,234,256.00,484.00,1532,1534
2942,1,512,512,512.00,0.00,1533,1534
2943,2,489,23,256.00,54289.00,1533,1535
2944,1,512,512,512.00,0.00,1534,1535
2945,1,512,512,512.00,0.00,1534,1535
2946,1,512,512,512.00,0.00,1534,1535
2947,2,398,114,256.00,20164.00,1534,1536
2948,2,332,180,256.00,5776.00,1535,1537
2949,3,378,44,170.67,21846.22,1536,1539
2950,1,512,512,512.00,0.00,1538,1539
2951,1,512,512,512.00,0.00,1538,1539
2952,1,512,512,512.00,0.00,1538,1539
2953,2,490,22,256.00,54756.00,1538,1540
2954,1,512,512,512.00,0.00,1539,1540
2955,1,512,512,512.00,0.00,1539,1540
2956,2,281,231,256.00,625.00,1539,1541
2957,1,512,512,512.00,0.00,1540,1541
2958,3,381,54,170.67,22208.22,1540,1543
2959,9,161,1,56.89,3334.54,1542,1551
2960,2,505,7,256.00,62001.00,1550,1552
2961,1,512,512,512.00,0.00,1551,1552
2962,1,512,512,512.00,0.00,1551,1552
2963,3,228,74,170.67,4726.22,1551,1554
2964,3,454,8,170.67,40432.89,1553,1556
2965,1,512,512,512.00,0.00,1555,1556
2966,2,302,210,256.00,2116.00,1555,1557
2967,5,225,2,102.40,9162.64,1556,1561
2968,1,512,512,512.00,0.00,1560,1561
2969,1,512,512,512.00,0.00,1560,1561
2970,1,512,512,512.00,0.00,1560,1561
2971,1,512,512,512.00,0.00,1560,1561
2972,1,512,512,512.00,0.00,1560,1561
2973,2,263,249,256.00,49.00,1560,1562
2974,1,512,512,512.00,0.00,1561,1562
2975,1,512,512,512.00,0.00,1561,1562
2976,4,274,39,128.00,9146.50,1561,1565
2977,1,512,512,512.00,0.00,1564,1565
2978,4,227,15,128.00,5667.00,1564,1568
2979,1,512,512,512.00,0.00,1567,1568
2980,2,490,22,256.00,54756.00,1567,1569
2981,2,260,252,256.00,16.00,1568,1570
2982,3,417,47,170.67,30340.22,1569,1572
2983,1,512,512,512.00,0.00,1571,1572
2984,1,512,512,512.00,0.00,1571,1572
2985,1,512,512,512.00,0.00,1571,1572
2986,6,219,6,85.33,5932.89,1571,1577
2987,2,296,216,256.00,1600.00,1576,1578
2988,1,512,512,512.00,0.00,1577,1578
2989,1,512,512,512.00,0.00,1577,1578
2990,1,512,512,512.00,0.00,1577,1578
2991,1,512,512,512.00,0.00,1577,1578
2992,4,241,22,128.00,8218.50,1577,1581
2993,1,512,512,512.00,0.00,1580,1581
2994,1,512,512,512.00,0.00,1580,1581
2995,1,512,512,512.00,0.00,1580,1581
2996,1,512,512,512.00,0.00,1580,1581
2997,1,512,512,512.00,0.00,1580,1581
2998,3,361,30,170.67,19493.56,1580,1583
2999,2,293,219,256.00,1369.00,1582,1584
3000,1,512,512,512.00,0.00,1583,1584
3001,1,512,512,512.00,0.00,1583,1584
3002,3,355,14,170.67,19762.89,1583,1586
3003,1,512,512,512.00,0.00,1585,1586
3004,2,358,154,256.00,10404.00,1585,1587
3005,1,512,512,512.00,0.00,1586,1587
3006,1,512,512,512.00,0.00,1586,1587
3007,1,512,512,512.00,0.00,1586,1587
3008,1,512,512,512.00,0.00,1586,1587
3009,2,398,114,256.00,20164.00,1586,1588
3010,1,512,512,512.00,0.00,1587,1588
3011,4,238,31,128.00,6829.50,1587,1591
3012,1,512,512,512.00,0.00,1590,1591
3013,1,512,512,512.00,0.00,1590,1591
3014,5,320,7,102.40,13086.24,1590,1595
3015,1,512,512,512.00,0.00,1594,1595
3016,1,512,512,512.00,0.00,1594,1595
3017,3,448,28,170.67,38467.56,1594,1597
3018,1,512,512,512.00,0.00,1596,1597
3019,1,512,512,512.00,0.00,1596,1597
3020,1,512,512,512.00,0.00,1596,1597
3021,1,512,512,512.00,0.00,1596,1597
3022,1,512,512,512.00,0.00,1596,1597
3023,1,512,512,512.00,0.00,1596,1597
3024,2,312,200,256.00,3136.00,1596,1598
3025,2,291,221,256.00,1225.00,1597,1599
3026,2,478,34,256.00,49284.00,1598,1600
3027,1,512,512,512.00,0.00,1599,1600
3028,2,381,131,256.00,15625.00,1599,1601
3029,1,512,512,512.00,0.00,1600,1601
3030,2,385,127,256.00,16641.00,1600,1602
3031,2,335,177,256.00,6241.00,1601,1603
3032,4,281,14,128.00,9522.50,1602,1606
3033,2,454,58,256.00,39204.00,1605,1607
3034,1,512,512,512.00,0.00,1606,1607
3035,2,456,56,256.00,40000.00,1606,1608
3036,1,512,512,512.00,0.00,1607,1608
3037,1,512,512,512.00,0.00,1607,1608
3038,1,512,512,512.00,0.00,1607,1608
3039,1,512,512,512.00,0.00,1607,1608
3040,5,425,3,102.40,26285.84,1607,1612
3041,3,441,28,170.67,36577.56,1611,1614
3042,2,362,150,256.00,11236.00,1613,1615
3043,3,503,1,170.67,55230.89,1614,1617
3044,1,512,512,512.00,0.00,1616,1617
3045,1,512,512,512.00,0.00,1616,1617
3046,2,359,153,256.00,10609.00,1616,1618
3047,1,512,512,512.00,0.00,1617,1618
3048,1,512,512,512.00,0.00,1617,1618
3049,2,321,191,256.00,4225.00,1617,1619
3050,2,384,128,256.00,16384.00,1618,1620
3051,2,282,230,256.00,676.00,1619,1621
3052,3,255,34,170.67,9509.56,1620,1623
3053,2,351,161,256.00,9025.00,1622,1624
3054,4,429,3,128.00,31041.00,1623,1627
3055,2,382,130,256.00,15876.00,1626,1628
3056,1,512,512,512.00,0.00,1627,1628
3057,1,512,512,512.00,0.00,1627,1628
3058,1,512,512,512.00,0.00,1627,1628
3059,6,256,12,85.33,7121.22,1627,1633
3060,1,512,512,512.00,0.00,1632,1633
3061,1,512,512,512.00,0.00,1632,1633
3062,1,512,512,512.00,0.00,1632,1633
3063,1,512,512,512.00,0.00,1632,1633
3064,2,280,232,256.00,576.00,1632,1634
3065,1,512,512,512.00,0.00,1633,1634
3066,1,512,512,512.00,0.00,1633,1634
3067,1,512,512,512.00,0.00,1633,1634
3068,1,512,512,512.00,0.00,1633,1634
3069,1,512,512,512.00,0.00,1633,1634
3070,2,385,127,256.00,16641.00,1633,1635
3071,1,512,512,512.00,0.00,1634,1635
3072,2,347,165,256.00,8281.00,1634,1636
3073,1,512,512,512.00,0.00,1635,1636
3074,2,495,17,256.00,57121.00,1635,1637
3075,1,512,512,512.00,0.00,1636,1637
3076,1,512,512,512.00,0.00,1636,1637
3077,1,512,512,512.00,0.00,1636,1637
3078,1,512,512,512.00,0.00,1636,1637
3079,1,512,512,512.00,0.00,1636,1637
3080,2,372,140,256.00,13456.00,1636,1638
3081,1,512,512,512.00,0.00,1637,1638
3082,1,512,512,512.00,0.00,1637,1638
3083,1,512,512,512.00,0.00,1637,1638
3084,2,285,227,256.00,841.00,1637,1639
3085,3,386,62,170.67,23184.89,1638,1641
3086,2,433,79,256.00,31329.00,1640,1642
3087,1,512,512,512.00,0.00,1641,1642
3088,2,393,119,256.00,18769.00,1641,1643
3089,3,404,2,170.67,29024.89,1642,1645
3090,1,512,512,512.00,0.00,1644,1645
3091,1,512,512,512.00,0.00,1644,1645
3092,1,512,512,512.00,0.00,1644,1645
3093,3,300,3,170.67,15436.22,1644,1647
3094,1,512,512,512.00,0.00,1646,1647
3095,1,512,512,512.00,0.00,1646,1647
3096,1,512,512,512.00,0.00,1646,1647
3097,2,502,10,256.00,60516.00,1646,1648
3098,2,461,51,256.00,42025.00,1647,1649
3099,1,512,512,512.00,0.00,1648,1649
3100,1,512,512,512.00,0.00,1648,1649
3101,1,512,512,512.00,0.00,1648,1649
3102,2,342,170,256.00,7396.00,1648,1650
3103,3,279,17,170.67,12468.22,1649,1652
3104,1,512,512,512.00,0.00,1651,1652
3105,2,393,119,256.00,18769.00,1651,1653
3106,1,512,512,512.00,0.00,1652,1653
3107,1,512,512,512.00,0.00,1652,1653
3108,1,512,512,512.00,0.00,1652,1653
3109,1,512,512,512.00,0.00,1652,1653
3110,1,512,512,512.00,0.00,1652,1653
3111,1,512,512,512.00,0.00,1652,1653
3112,2,452,60,256.00,38416.00,1652,1654
3113,1,512,512,512.00,0.00,1653,1654
3114,1,512,512,512.00,0.00,1653,1654
3115,1,512,512,512.00,0.00,1653,1654
3116,2,393,119,256.00,18769.00,1653,1655
3117,1,512,512,512.00,0.00,1654,1655
3118,5,245,23,102.40,6251.04,1654,1659
3119,1,512,512,512.00,0.00,1658,1659
3120,2,421,91,256.00,27225.00,1658,1660
3121,1,512,512,512.00,0.00,1659,1660
3122,2,508,4,256.00,63504.00,1659,1661
3123,2,348,164,256.00,8464.00,1660,1662
3124,2,284,228,256.00,784.00,1662,1664
3125,1,512,512,512.00,0.00,1663,1664
3126,1,512,512,512.00,0.00,1663,1664
3127,2,366,146,256.00,12100.00,1663,1665
3128,3,200,121,170.67,1246.89,1664,1667
3129,3,280,14,170.67,12912.89,1666,1669
3130,1,512,512,512.00,0.00,1668,1669
3131,1,512,512,512.00,0.00,1668,1669
3132,1,512,512,512.00,0.00,1668,1669
3133,1,512,512,512.00,0.00,1668,1669
3134,6,277,1,85.33,10308.22,1668,1674
3135,5,171,23,102.40,3844.64,1673,1678
3136,3,253,56,170.67,6990.89,1677,1680
3137,1,512,512,512.00,0.00,1679,1680
3138,1,512,512,512.00,0.00,1679,1680
3139,2,276,236,256.00,400.00,1679,1681
3140,1,512,512,512.00,0.00,1680,1681
3141,1,512,512,512.00,0.00,1680,1681
3142,2,495,17,256.00,57121.00,1680,1682
3143,1,512,512,512.00,0.00,1681,1682
3144,3,297,75,170.67,8684.22,1681,1684
3145,3,375,22,170.67,22317.56,1683,1686
3146,2,328,184,256.00,5184.00,1685,1687
3147,3,208,125,170.67,1182.89,1686,1689
3148,1,512,512,512.00,0.00,1688,1689
3149,1,512,512,512.00,0.00,1688,1689
3150,2,496,16,256.00,57600.00,1688,1690
3151,2,321,191,256.00,4225.00,1689,1691
3152,1,512,512,512.00,0.00,1690,1691
3153,1,512,512,512.00,0.00,1690,1691
3154,1,512,512,512.00,0.00,1690,1691
3155,3,176,164,170.67,24.89,1690,1693
3156,1,512,512,512.00,0.00,1692,1693
3157,2,447,65,256.00,36481.00,1692,1694
3158,7,296,1,73.14,11612.41,1693,1700
3159,4,387,1,128.00,24385.00,1699,1703
3160,1,512,512,512.00,0.00,1702,1703
3161,1,512,512,512.00,0.00,1702,1703
3162,5,162,15,102.40,3558.64,1702,1707
3163,2,508,4,256.00,63504.00,1706,1708
3164,4,209,81,128.00,2341.50,1707,1711
3165,1,512,512,512.00,0.00,1710,1711
3166,2,469,43,256.00,45369.00,1710,1712
3167,1,512,512,512.00,0.00,1711,1712
3168,1,512,512,512.00,0.00,1711,1712
3169,4,304,11,128.00,15342.50,1711,1715
3170,1,512,512,512.00,0.00,1714,1715
3171,1,512,512,512.00,0.00,1714,1715
3172,1,512,512,512.00,0.00,1714,1715
3173,1,512,512,512.00,0.00,1714,1715
3174,2,329,183,256.00,5329.00,1714,1716
3175,1,512,512,512.00,0.00,1715,1716
3176,1,512,512,512.00,0.00,1715,1716
3177,1,512,512,512.00,0.00,1715,1716
3178,1,512,512,512.00,0.00,1715,1716
3179,2,481,31,256.00,50625.00,1715,1717
3180,1,512,512,512.00,0.00,1716,1717
3181,1,512,512,512.00,0.00,1716,1717
3182,3,355,78,170.67,16989.56,1716,1719
3183,3,483,4,170.67,48849.56,1718,1721
3184,1,512,512,512.00,0.00,1720,1721
3185,1,512,512,512.00,0.00,1720,1721
3186,1,512,512,512.00,0.00,1720,1721
3187,3,184,146,170.67,304.89,1720,1723
3188,1,512,512,512.00,0.00,1722,1723
3189,3,189,134,170.67,672.22,1722,1725
3190,1,512,512,512.00,0.00,1724,1725
3191,2,423,89,256.00,27889.00,1724,1726
3192,1,512,512,512.00,0.00,1725,1726
3193,4,468,1,128.00,38624.50,1725,1729
3194,5,415,2,102.40,25358.64,1728,1733
3195,2,430,82,256.00,30276.00,1732,1734
3196,1,512,512,512.00,0.00,1733,1734
3197,1,512,512,512.00,0.00,1733,1734
3198,2,385,127,256.00,16641.00,1733,1735
3199,1,512,512,512.00,0.00,1734,1735
3200,1,512,512,512.00,0.00,1734,1735
3201,1,512,512,512.00,0.00,1734,1735
3202,1,512,512,512.00,0.00,1734,1735
3203,2,271,241,256.00,225.00,1734,1736
3204,1,512,512,512.00,0.00,1735,1736
3205,1,512,512,512.00,0.00,1735,1736
3206,4,312,16,128.00,14426.00,1735,1739
3207,1,512,512,512.00,0.00,1738,1739
3208,1,512,512,512.00,0.00,1738,1739
3209,3,427,30,170.67,32957.56,1738,1741
3210,3,430,1,170.67,34693.56,1740,1743
3211,1,512,512,512.00,0.00,1742,1743
3212,3,375,68,170.67,20876.22,1742,1745
3213,1,512,512,512.00,0.00,1744,1745
3214,1,512,512,512.00,0.00,1744,1745
3215,2,318,194,256.00,3844.00,1744,1746
3216,1,512,512,512.00,0.00,1745,1746
3217,1,512,512,512.00,0.00,1745,1746
3218,1,512,512,512.00,0.00,1745,1746
3219,1,512,512,512.00,0.00,1745,1746
3220,1,512,512,512.00,0.00,1745,1746
3221,1,512,512,512.00,0.00,1745,1746
3222,2,362,150,256.00,11236.00,1745,1747
3223,1,512,512,512.00,0.00,1746,1747
3224,1,512,512,512.00,0.00,1746,1747
3225,1,512,512,512.00,0.00,1746,1747
3226,1,512,512,512.00,0.00,1746,1747
3227,1,512,512,512.00,0.00,1746,1747
3228,2,283,229,256.00,729.00,1746,1748
3229,1,512,512,512.00,0.00,1747,1748
3230,1,512,512,512.00,0.00,1747,1748
3231,1,512,512,512.00,0.00,1747,1748
3232,1,512,512,512.00,0.00,1747,1748
3233,1,512,512,512.00,0.00,1747,1748
3234,2,265,247,256.00,81.00,1747,1749
3235,3,281,40,170.67,9886.89,1748,1751
3236,3,463,9,170.67,42889.56,1750,1753
3237,3,239,78,170.67,4616.22,1752,1755
3238,1,512,512,512.00,0.00,1754,1755
3239,1,512,512,512.00,0.00,1754,1755
3240,2,379,133,256.00,15129.00,1754,1756
3241,1,512,512,512.00,0.00,1755,1756
3242,2,362,150,256.00,11236.00,1755,1757
3243,1,512,512,512.00,0.00,1756,1757
3244,1,512,512,512.00,0.00,1756,1757
3245,2,442,70,256.00,34596.00,1756,1758
3246,2,359,153,256.00,10609.00,1757,1759
3247,1,512,512,512.00,0.00,1758,1759
3248,1,512,512,512.00,0.00,1758,1759
3249,1,512,512,512.00,0.00,1758,1759
3250,1,512,512,512.00,0.00,1758,1759
3251,1,512,512,512.00,0.00,1758,1759
3252,2,464,48,256.00,43264.00,1758,1760
3253,2,467,45,256.00,44521.00,1759,1761
3254,2,472,40,256.00,46656.00,1760,1762
3255,1,512,512,512.00,0.00,1761,1762
3256,1,512,512,512.00,0.00,1761,1762
3257,2,394,118,256.00,19044.00,1761,1763
3258,1,512,512,512.00,0.00,1762,1763
3259,1,512,512,512.00,0.00,1762,1763
3260,2,284,228,256.00,784.00,1762,1764
3261,1,512,512,512.00,0.00,1763,1764
3262,3,231,99,170.67,2968.22,1763,1766
3263,1,512,512,512.00,0.00,1765,1766
3264,2,283,229,256.00,729.00,1765,1767
3265,1,512,512,512.00,0.00,1766,1767
3266,1,512,512,512.00,0.00,1766,1767
3267,1,512,512,512.00,0.00,1766,1767
3268,3,286,55,170.67,8893.56,1766,1769
3269,6,232,8,85.33,6611.89,1768,1774
3270,2,260,252,256.00,16.00,1773,1775
3271,3,262,66,170.67,6491.56,1774,1777
3272,4,232,19,128.00,7003.50,1776,1780
3273,1,512,512,512.00,0.00,1779,1780
3274,3,461,22,170.67,42154.89,1779,1782
3275,1,512,512,512.00,0.00,1781,1782
3276,1,512,512,512.00,0.00,1781,1782
3277,4,237,27,128.00,9313.00,1781,1785
3278,1,512,512,512.00,0.00,1784,1785
3279,1,512,512,512.00,0.00,1784,1785
3280,1,512,512,512.00,0.00,1784,1785
3281,1,512,512,512.00,0.00,1784,1785
3282,4,305,28,128.00,12613.50,1784,1788
3283,5,359,9,102.40,16748.24,1787,1792
3284,3,295,35,170.67,11330.89,1791,1794
3285,3,217,84,170.67,3761.56,1793,1796
3286,2,344,168,256.00,7744.00,1795,1797
3287,1,512,512,512.00,0.00,1796,1797
3288,4,267,62,128.00,6861.50,1796,1800
3289,3,271,48,170.67,8537.56,1799,1802
3290,2,507,5,256.00,63001.00,1801,1803
3291,3,392,43,170.67,24686.89,1802,1805
3292,1,512,512,512.00,0.00,1804,1805
3293,4,357,31,128.00,17953.00,1804,1808
3294,3,256,125,170.67,3646.89,1807,1810
3295,1,512,512,512.00,0.00,1809,1810
3296,2,490,22,256.00,54756.00,1809,1811
3297,2,478,34,256.00,49284.00,1810,1812
3298,1,512,512,512.00,0.00,1811,1812
3299,2,467,45,256.00,44521.00,1811,1813
3300,1,512,512,512.00,0.00,1812,1813
3301,1,512,512,512.00,0.00,1812,1813
3302,4,325,5,128.00,14589.50,1812,1816
3303,3,371,47,170.67,20434.89,1815,1818
3304,1,512,512,512.00,0.00,1817,1818
3305,2,352,160,256.00,9216.00,1817,1819
3306,1,512,512,512.00,0.00,1818,1819
3307,1,512,512,512.00,0.00,1818,1819
3308,1,512,512,512.00,0.00,1818,1819
3309,1,512,512,512.00,0.00,1818,1819
3310,2,472,40,256.00,46656.00,1818,1820
3311,1,512,512,512.00,0.00,1819,1820
3312,1,512,512,512.00,0.00,1819,1820
3313,2,416,96,256.00,25600.00,1819,1821
3314,2,282,230,256.00,676.00,1820,1822
3315,1,512,512,512.00,0.00,1821,1822
3316,1,512,512,512.00,0.00,1821,1822
3317,2,376,136,256.00,14400.00,1821,1823
3318,2,349,163,256.00,8649.00,1822,1824
3319,4,262,4,128.00,12395.50,1823,1827
3320,1,512,512,512.00,0.00,1826,1827
3321,2,361,151,256.00,11025.00,1826,1828
3322,3,250,112,170.67,3387.56,1827,1830
3323,3,293,2,170.67,15186.89,1829,1832
3324,1,512,512,512.00,0.00,1831,1832
3325,1,512,512,512.00,0.00,1831,1832
3326,1,512,512,512.00,0.00,1831,1832
3327,1,512,512,512.00,0.00,1831,1832
3328,2,490,22,256.00,54756.00,1831,1833
3329,2,495,17,256.00,57121.00,1832,1834
3330,2,296,216,256.00,1600.00,1833,1835
3331,1,512,512,512.00,0.00,1834,1835
3332,3,303,43,170.67,11277.56,1834,1837
3333,1,512,512,512.00,0.00,1836,1837
3334,3,309,24,170.67,13572.22,1836,1839
3335,1,512,512,512.00,0.00,1838,1839
3336,2,493,19,256.00,56169.00,1838,1840
3337,1,512,512,512.00,0.00,1839,1840
3338,2,481,31,256.00,50625.00,1839,1841
3339,3,274,5,170.67,14002.89,1840,1843
3340,1,512,512,512.00,0.00,1842,1843
3341,1,512,512,512.00,0.00,1842,1843
3342,2,388,124,256.00,17424.00,1842,1844
3343,2,459,53,256.00,41209.00,1843,1845
3344,1,512,512,512.00,0.00,1844,1845
3345,1,512,512,512.00,0.00,1844,1845
3346,2,269,243,256.00,169.00,1844,1846
3347,1,512,512,512.00,0.00,1845,1846
3348,1,512,512,512.00,0.00,1845,1846
3349,2,272,240,256.00,256.00,1845,1847
3350,1,512,512,512.00,0.00,1846,1847
3351,1,512,512,512.00,0.00,1846,1847
3352,2,473,39,256.00,47089.00,1846,1848
3353,1,512,512,512.00,0.00,1847,1848
3354,2,289,223,256.00,1089.00,1847,1849
3355,1,512,512,512.00,0.00,1848,1849
3356,1,512,512,512.00,0.00,1848,1849
3357,1,512,512,512.00,0.00,1848,1849
3358,1,512,512,512.00,0.00,1848,1849
3359,2,477,35,256.00,48841.00,1848,1850
3360,2,330,182,256.00,5476.00,1849,1851
3361,2,274,238,256.00,324.00,1850,1852
3362,1,512,512,512.00,0.00,1851,1852
3363,1,512,512,512.00,0.00,1851,1852
3364,1,512,512,512.00,0.00,1851,1852
3365,2,470,42,256.00,45796.00,1851,1853
3366,1,512,512,512.00,0.00,1852,1853
3367,1,512,512,512.00,0.00,1852,1853
3368,2,344,168,256.00,7744.00,1852,1854
3369,2,450,62,256.00,37636.00,1853,1855
3370,1,512,512,512.00,0.00,1854,1855
3371,3,289,27,170.67,11761.56,1854,1857
3372,1,512,512,512.00,0.00,1856,1857
3373,2,319,193,256.00,3969.00,1856,1858
3374,3,354,33,170.67,18216.22,1857,1860
3375,1,512,512,512.00,0.00,1859,1860
3376,1,512,512,512.00,0.00,1859,1860
3377,1,512,512,512.00,0.00,1859,1860
3378,3,249,44,170.67,8172.22,1859,1862
3379,1,512,512,512.00,0.00,1861,1862
3380,2,416,96,256.00,25600.00,1861,1863
3381,4,306,1,128.00,12713.50,1862,1866
3382,2,315,197,256.00,3481.00,1865,1867
3383,3,244,114,170.67,2955.56,1866,1869
3384,2,477,35,256.00,48841.00,1868,1870
3385,1,512,512,512.00,0.00,1869,1870
3386,1,512,512,512.00,0.00,1869,1870
3387,1,512,512,512.00,0.00,1869,1870
3388,2,464,48,256.00,43264.00,1869,1871
3389,2,362,150,256.00,11236.00,1870,1872
3390,2,298,214,256.00,1764.00,1871,1873
3391,1,512,512,512.00,0.00,1872,1873
3392,1,512,512,512.00,0.00,1872,1873
3393,3,258,2,170.67,14230.22,1872,1875
3394,3,243,55,170.67,6829.56,1874,1877
3395,4,304,1,128.00,12077.50,1876,1880
3396,1,512,512,512.00,0.00,1879,1880
3397,6,448,3,85.33,26350.89,1879,1885
3398,2,488,24,256.00,53824.00,1884,1886
3399,2,332,180,256.00,5776.00,1885,1887
3400,2,373,139,256.00,13689.00,1886,1888
3401,1,512,512,512.00,0.00,1887,1888
3402,1,512,512,512.00,0.00,1887,1888
3403,1,512,512,512.00,0.00,1887,1888
3404,2,414,98,256.00,24964.00,1887,1889
3405,5,242,11,102.40,6623.04,1888,1893
3406,2,340,172,256.00,7056.00,1892,1894
3407,1,512,512,512.00,0.00,1893,1894
3408,1,512,512,512.00,0.00,1893,1894
3409,1,512,512,512.00,0.00,1893,1894
3410,3,331,28,170.67,15457.56,1893,1896
3411,1,512,512,512.00,0.00,1895,1896
3412,2,400,112,256.00,20736.00,1895,1897
3413,2,289,223,256.00,1089.00,1896,1898
3414,1,512,512,512.00,0.00,1897,1898
3415,1,512,512,512.00,0.00,1897,1898
3416,1,512,512,512.00,0.00,1897,1898
3417,2,481,31,256.00,50625.00,1897,1899
3418,3,428,21,170.67,33404.22,1898,1901
3419,1,512,512,512.00,0.00,1900,1901
3420,1,512,512,512.00,0.00,1900,1901
3421,1,512,512,512.00,0.00,1900,1901
3422,3,326,14,170.67,16224.89,1900,1903
3423,1,512,512,512.00,0.00,1902,1903
3424,2,403,109,256.00,21609.00,1902,1904
3425,1,512,512,512.00,0.00,1903,1904
3426,2,277,235,256.00,441.00,1903,1905
3427,1,512,512,512.00,0.00,1904,1905
3428,1,512,512,512.00,0.00,1904,1905
3429,2,431,81,256.00,30625.00,1904,1906
3430,1,512,512,512.00,0.00,1905,1906
3431,1,512,512,512.00,0.00,1905,1906
3432,1,512,512,512.00,0.00,1905,1906
3433,1,512,512,512.00,0.00,1905,1906
3434,1,512,512,512.00,0.00,1905,1906
3435,2,403,109,256.00,21609.00,1905,1907
3436,1,512,512,512.00,0.00,1906,1907
3437,1,512,512,512.00,0.00,1906,1907
3438,2,402,110,256.00,21316.00,1906,1908
3439,2,308,204,256.00,2704.00,1907,1909
3440,2,370,142,256.00,12996.00,1908,1910
3441,1,512,512,512.00,0.00,1909,1910
3442,4,249,45,128.00,5725.00,1909,1913
3443,4,268,2,128.00,9506.00,1912,1916
3444,2,505,7,256.00,62001.00,1915,1917
3445,4,317,10,128.00,13537.50,1916,1920
3446,1,512,512,512.00,0.00,1919,1920
3447,1,512,512,512.00,0.00,1919,1920
3448,1,512,512,512.00,0.00,1919,1920
3449,1,512,512,512.00,0.00,1919,1920
3450,1,512,512,512.00,0.00,1919,1920
3451,1,512,512,512.00,0.00,1919,1920
3452,4,325,22,128.00,15316.50,1919,1923
3453,3,456,7,170.67,41001.56,1922,1925
3454,1,512,512,512.00,0.00,1924,1925
3455,1,512,512,512.00,0.00,1924,1925
3456,1,512,512,512.00,0.00,1924,1925
3457,2,430,82,256.00,30276.00,1924,1926
3458,3,230,140,170.67,1760.89,1925,1928
3459,2,427,85,256.00,29241.00,1927,1929
3460,2,336,176,256.00,6400.00,1928,1930
3461,1,512,512,512.00,0.00,1929,1930
3462,2,295,217,256.00,1521.00,1929,1931
3463,3,480,3,170.67,47956.22,1930,1933
3464,1,512,512,512.00,0.00,1932,1933
3465,2,420,92,256.00,26896.00,1932,1934
3466,1,512,512,512.00,0.00,1933,1934
3467,1,512,512,512.00,0.00,1933,1934
3468,2,374,138,256.00,13924.00,1933,1935
3469,1,512,512,512.00,0.00,1934,1935
3470,2,315,197,256.00,3481.00,1934,1936
3471,1,512,512,512.00,0.00,1935,1936
3472,1,512,512,512.00,0.00,1935,1936
3473,1,512,512,512.00,0.00,1935,1936
3474,1,512,512,512.00,0.00,1935,1936
3475,4,156,94,128.00,587.50,1935,1939
3476,1,512,512,512.00,0.00,1938,1939
3477,4,244,2,128.00,9523.50,1938,1942
3478,1,512,512,512.00,0.00,1941,1942
3479,1,512,512,512.00,0.00,1941,1942
3480,2,458,54,256.00,40804.00,1941,1943
3481,1,512,512,512.00,0.00,1942,1943
3482,1,512,512,512.00,0.00,1942,1943
3483,2,310,202,256.00,2916.00,1942,1944
3484,1,512,512,512.00,0.00,1943,1944
3485,3,244,69,170.67,5505.56,1943,1946
3486,3,388,58,170.67,23627.56,1945,1948
3487,1,512,512,512.00,0.00,1947,1948
3488,2,452,60,256.00,38416.00,1947,1949
3489,1,512,512,512.00,0.00,1948,1949
3490,4,331,51,128.00,13771.00,1948,1952
3491,1,512,512,512.00,0.00,1951,1952
3492,1,512,512,512.00,0.00,1951,1952
3493,3,214,137,170.67,1034.89,1951,1954
3494,2,263,249,256.00,49.00,1953,1955
3495,3,458,25,170.67,41282.89,1954,1957
3496,3,266,2,170.67,14304.89,1956,1959
3497,1,512,512,512.00,0.00,1958,1959
3498,1,512,512,512.00,0.00,1958,1959
3499,3,316,90,170.67,10603.56,1958,1961
3500,3,295,31,170.67,11733.56,1960,1963
3501,3,403,33,170.67,27297.56,1962,1965
3502,1,512,512,512.00,0.00,1964,1965
3503,1,512,512,512.00,0.00,1964,1965
3504,2,406,106,256.00,22500.00,1964,1966
3505,1,512,512,512.00,0.00,1965,1966
3506,3,474,2,170.67,46198.22,1965,1968
3507,1,512,512,512.00,0.00,1967,1968
3508,1,512,512,512.00,0.00,1967,1968
3509,4,435,13,128.00,31589.00,1967,1971
3510,3,351,3,170.67,20264.22,1970,1973
3511,2,504,8,256.00,61504.00,1972,1974
3512,1,512,512,512.00,0.00,1973,1974
3513,3,253,42,170.67,8493.56,1973,1976
3514,2,327,185,256.00,5041.00,1975,1977
3515,1,512,512,512.00,0.00,1976,1977
3516,1,512,512,512.00,0.00,1976,1977
3517,1,512,512,512.00,0.00,1976,1977
3518,2,325,187,256.00,4761.00,1976,1978
3519,1,512,512,512.00,0.00,1977,1978
3520,1,512,512,512.00,0.00,1977,1978
3521,1,512,512,512.00,0.00,1977,1978
3522,4,244,5,128.00,8098.50,1977,1981
3523,1,512,512,512.00,0.00,1980,1981
3524,1,512,512,512.00,0.00,1980,1981
3525,2,357,155,256.00,10201.00,1980,1982
3526,1,512,512,512.00,0.00,1981,1982
3527,4,432,1,128.00,31487.50,1981,1985
3528,2,498,14,256.00,58564.00,1984,1986
3529,1,512,512,512.00,0.00,1985,1986
3530,2,387,125,256.00,17161.00,1985,1987
3531,3,205,143,170.67,662.89,1986,1989
3532,3,406,12,170.67,28811.56,1988,1991
3533,3,395,31,170.67,25666.89,1990,1993
3534,1,512,512,512.00,0.00,1992,1993
3535,1,512,512,512.00,0.00,1992,1993
3536,7,387,3,73.14,16538.69,1992,1999
3537,2,257,255,256.00,1.00,1998,2000
3538,2,286,226,256.00,900.00,1999,2001
3539,3,265,49,170.67,8149.56,2000,2003
3540,1,512,512,512.00,0.00,2002,2003
3541,1,512,512,512.00,0.00,2002,2003
3542,2,309,203,256.00,2809.00,2002,2004
3543,1,512,512,512.00,0.00,2003,2004
3544,4,227,10,128.00,6166.50,2003,2007
3545,4,360,12,128.00,18922.50,2006,2010
3546,1,512,512,512.00,0.00,2009,2010
3547,1,512,512,512.00,0.00,2009,2010
3548,1,512,512,512.00,0.00,2009,2010
3549,5,307,1,102.40,15982.24,2009,2014
3550,1,512,512,512.00,0.00,2013,2014
3551,1,512,512,512.00,0.00,2013,2014
3552,1,512,512,512.00,0.00,2013,2014
3553,2,266,246,256.00,100.00,2013,2015
3554,3,302,7,170.67,15026.89,2014,2017
3555,2,398,114,256.00,20164.00,2016,2018
3556,4,357,29,128.00,18153.50,2017,2021
3557,3,451,1,170.67,39873.56,2020,2023
3558,1,512,512,512.00,0.00,2022,2023
3559,4,250,21,128.00,6716.50,2022,2026
3560,1,512,512,512.00,0.00,2025,2026
3561,2,500,12,256.00,59536.00,2025,2027
3562,6,243,16,85.33,5771.89,2026,2032
3563,7,291,1,73.14,10106.69,2031,2038
3564,4,275,4,128.00,14877.50,2037,2041
3565,1,512,512,512.00,0.00,2040,2041
3566,1,512,512,512.00,0.00,2040,2041
3567,1,512,512,512.00,0.00,2040,2041
3568,2,304,208,256.00,2304.00,2040,2042
3569,1,512,512,512.00,0.00,2041,2042
3570,1,512,512,512.00,0.00,2041,2042
3571,1,512,512,512.00,0.00,2041,2042
3572,2,282,230,256.00,676.00,2041,2043
3573,1,512,512,512.00,0.00,2042,2043
3574,1,512,512,512.00,0.00,2042,2043
3575,4,240,4,128.00,8798.00,2042,2046
3576,1,512,512,512.00,0.00,2045,2046
3577,1,512,512,512.00,0.00,2045,2046
3578,2,373,139,256.00,13689.00,2045,2047
3579,1,512,512,512.00,0.00,2046,2047
3580,1,512,512,512.00,0.00,2046,2047
3581,1,512,512,512.00,0.00,2046,2047
3582,4,215,20,128.00,5944.50,2046,2050
3583,1,512,512,512.00,0.00,2049,2050
3584,1,512,512,512.00,0.00,2049,2050
3585,1,512,512,512.00,0.00,2049,2050
3586,2,331,181,256.00,5625.00,2049,2051
3587,1,512,512,512.00,0.00,2050,2051
3588,2,341,171,256.00,7225.00,2050,2052
3589,1,512,512,512.00,0.00,2051,2052
3590,1,512,512,512.00,0.00,2051,2052
3591,1,512,512,512.00,0.00,2051,2052
3592,2,365,147,256.00,11881.00,2051,2053
3593,1,512,512,512.00,0.00,2052,2053
3594,2,323,189,256.00,4489.00,2052,2054
3595,1,512,512,512.00,0.00,2053,2054
3596,1,512,512,512.00,0.00,2053,2054
3597,1,512,512,512.00,0.00,2053,2054
3598,2,395,117,256.00,19321.00,2053,2055
3599,1,512,512,512.00,0.00,2054,2055
3600,1,512,512,512.00,0.00,2054,2055
3601,2,497,15,256.00,58081.00,2054,2056
3602,3,411,43,170.67,28917.56,2055,2058
3603,2,373,139,256.00,13689.00,2057,2059
3604,1,512,512,512.00,0.00,2058,2059
3605,2,400,112,256.00,20736.00,2058,2060
3606,1,512,512,512.00,0.00,2059,2060
3607,1,512,512,512.00,0.00,2059,2060
3608,1,512,512,512.00,0.00,2059,2060
3609,2,483,29,256.00,51529.00,2059,2061
3610,1,512,512,512.00,0.00,2060,2061
3611,1,512,512,512.00,0.00,2060,2061
3612,3,417,8,170.67,31380.22,2060,2063
3613,1,512,512,512.00,0.00,2063,2064
3614,2,478,34,256.00,49284.00,2063,2065
3615,1,512,512,512.00,0.00,2064,2065
3616,1,512,512,512.00,0.00,2064,2065
3617,1,512,512,512.00,0.00,2064,2065
3618,5,152,17,102.40,2329.04,2064,2069
3619,1,512,512,512.00,0.00,2068,2069
3620,1,512,512,512.00,0.00,2068,2069
3621,2,425,87,256.00,28561.00,2068,2070
3622,1,512,512,512.00,0.00,2069,2070
3623,1,512,512,512.00,0.00,2069,2070
3624,4,452,1,128.00,35142.50,2069,2073
3625,4,267,2,128.00,15841.50,2072,2076
3626,1,512,512,512.00,0.00,2075,2076
3627,1,512,512,512.00,0.00,2075,2076
3628,1,512,512,512.00,0.00,2075,2076
3629,1,512,512,512.00,0.00,2075,2076
3630,1,512,512,512.00,0.00,2075,2076
3631,2,330,182,256.00,5476.00,2075,2077
3632,1,512,512,512.00,0.00,2076,2077
3633,2,267,245,256.00,121.00,2076,2078
3634,1,512,512,512.00,0.00,2077,2078
3635,1,512,512,512.00,0.00,2077,2078
3636,2,382,130,256.00,15876.00,2077,2079
3637,1,512,512,512.00,0.00,2078,2079
3638,1,512,512,512.00,0.00,2078,2079
3639,1,512,512,512.00,0.00,2078,2079
3640,1,512,512,512.00,0.00,2078,2079
3641,2,414,98,256.00,24964.00,2078,2080
3642,1,512,512,512.00,0.00,2079,2080
3643,3,256,3,170.67,14057.56,2079,2082
3644,1,512,512,512.00,0.00,2081,2082
3645,1,512,512,512.00,0.00,2081,2082
3646,5,208,13,102.40,5442.64,2081,2086
3647,2,359,153,256.00,10609.00,2085,2087
3648,1,512,512,512.00,0.00,2086,2087
3649,1,512,512,512.00,0.00,2086,2087
3650,1,512,512,512.00,0.00,2086,2087
3651,4,235,47,128.00,5555.00,2086,2090
3652,3,245,132,170.67,2764.22,2089,2092
3653,2,474,38,256.00,47524.00,2091,2093
3654,1,512,512,512.00,0.00,2092,2093
3655,1,512,512,512.00,0.00,2092,2093
3656,1,512,512,512.00,0.00,2092,2093
3657,2,481,31,256.00,50625.00,2092,2094
3658,1,512,512,512.00,0.00,2093,2094
3659,1,512,512,512.00,0.00,2093,2094
3660,1,512,512,512.00,0.00,2093,2094
3661,7,162,3,73.14,2137.55,2093,2100
3662,1,512,512,512.00,0.00,2099,2100
3663,1,512,512,512.00,0.00,2099,2100
3664,2,361,151,256.00,11025.00,2099,2101
3665,2,277,235,256.00,441.00,2100,2102
3666,4,183,79,128.00,1505.50,2101,2105
3667,1,512,512,512.00,0.00,2104,2105
3668,3,225,119,170.67,1876.22,2104,2107
3669,1,512,512,512.00,0.00,2106,2107
3670,1,512,512,512.00,0.00,2106,2107
3671,1,512,512,512.00,0.00,2106,2107
3672,1,512,512,512.00,0.00,2106,2107
3673,2,478,34,256.00,49284.00,2106,2108
3674,1,512,512,512.00,0.00,2107,2108
3675,1,512,512,512.00,0.00,2107,2108
3676,3,282,24,170.67,11718.22,2107,2110
3677,1,512,512,512.00,0.00,2109,2110
3678,1,512,512,512.00,0.00,2109,2110
3679,2,355,157,256.00,9801.00,2109,2111
3680,1,512,512,512.00,0.00,2110,2111
3681,1,512,512,512.00,0.00,2110,2111
3682,2,458,54,256.00,40804.00,2110,2112
3683,1,512,512,512.00,0.00,2111,2112
3684,1,512,512,512.00,0.00,2111,2112
3685,2,499,13,256.00,59049.00,2111,2113
3686,1,512,512,512.00,0.00,2112,2113
3687,1,512,512,512.00,0.00,2112,2113
3688,1,512,512,512.00,0.00,2112,2113
3689,1,512,512,512.00,0.00,2112,2113
3690,1,512,512,512.00,0.00,2112,2113
3691,2,475,37,256.00,47961.00,2112,2114
3692,2,426,86,256.00,28900.00,2113,2115
3693,1,512,512,512.00,0.00,2114,2115
3694,1,512,512,512.00,0.00,2114,2115
3695,1,512,512,512.00,0.00,2114,2115
3696,1,512,512,512.00,0.00,2114,2115
3697,2,410,102,256.00,23716.00,2114,2116
3698,2,478,34,256.00,49284.00,2115,2117
3699,1,512,512,512.00,0.00,2116,2117
3700,1,512,512,512.00,0.00,2116,2117
3701,2,268,244,256.00,144.00,2116,2118
3702,2,300,212,256.00,1936.00,2117,2119
3703,1,512,512,512.00,0.00,2118,2119
3704,1,512,512,512.00,0.00,2118,2119
3705,1,512,512,512.00,0.00,2118,2119
3706,2,383,129,256.00,16129.00,2118,2120
3707,1,512,512,512.00,0.00,2119,2120
3708,1,512,512,512.00,0.00,2119,2120
3709,2,474,38,256.00,47524.00,2119,2121
3710,1,512,512,512.00,0.00,2120,2121
3711,1,512,512,512.00,0.00,2120,2121
3712,1,512,512,512.00,0.00,2120,2121
3713,1,512,512,512.00,0.00,2120,2121
3714,2,368,144,256.00,12544.00,2120,2122
3715,1,512,512,512.00,0.00,2121,2122
3716,1,512,512,512.00,0.00,2121,2122
3717,1,512,512,512.00,0.00,2121,2122
3718,1,512,512,512.00,0.00,2121,2122
3719,2,480,32,256.00,50176.00,2121,2123
3720,1,512,512,512.00,0.00,2122,2123
3721,1,512,512,512.00,0.00,2122,2123
3722,1,512,512,512.00,0.00,2122,2123
3723,4,295,11,128.00,11127.50,2122,2126
3724,1,512,512,512.00,0.00,2125,2126
3725,1,512,512,512.00,0.00,2125,2126
3726,3,430,4,170.67,34539.56,2125,2128
3727,1,512,512,512.00,0.00,2127,2128
3728,2,387,125,256.00,17161.00,2127,2129
3729,1,512,512,512.00,0.00,2128,2129
3730,2,376,136,256.00,14400.00,2128,2130
3731,2,509,3,256.00,64009.00,2129,2131
3732,1,512,512,512.00,0.00,2130,2131
3733,2,406,106,256.00,22500.00,2130,2132
3734,1,512,512,512.00,0.00,2131,2132
3735,1,512,512,512.00,0.00,2131,2132
3736,2,445,67,256.00,35721.00,2131,2133
3737,2,489,23,256.00,54289.00,2132,2134
3738,1,512,512,512.00,0.00,2133,2134
3739,4,244,46,128.00,5950.00,2133,2137
3740,1,512,512,512.00,0.00,2136,2137
3741,1,512,512,512.00,0.00,2136,2137
3742,1,512,512,512.00,0.00,2136,2137
3743,2,439,73,256.00,33489.00,2136,2138
3744,1,512,512,512.00,0.00,2137,2138
3745,1,512,512,512.00,0.00,2137,2138
3746,5,206,6,102.40,5693.44,2137,2142
3747,1,512,512,512.00,0.00,2141,2142
3748,2,497,15,256.00,58081.00,2141,2143
3749,1,512,512,512.00,0.00,2142,2143
3750,2,468,44,256.00,44944.00,2142,2144
3751,3,433,25,170.67,34549.56,2143,2146
3752,2,442,70,256.00,34596.00,2145,2147
3753,1,512,512,512.00,0.00,2146,2147
3754,1,512,512,512.00,0.00,2146,2147
3755,1,512,512,512.00,0.00,2146,2147
3756,2,368,144,256.00,12544.00,2146,2148
3757,1,512,512,512.00,0.00,2147,2148
3758,2,382,130,256.00,15876.00,2147,2149
3759,1,512,512,512.00,0.00,2148,2149
3760,2,383,129,256.00,16129.00,2148,2150
3761,1,512,512,512.00,0.00,2149,2150
3762,4,235,12,128.00,7139.50,2149,2153
3763,5,141,9,102.40,2583.04,2152,2157
3764,1,512,512,512.00,0.00,2156,2157
3765,1,512,512,512.00,0.00,2156,2157
3766,1,512,512,512.00,0.00,2156,2157
3767,1,512,512,512.00,0.00,2156,2157
3768,2,312,200,256.00,3136.00,2156,2158
3769,1,512,512,512.00,0.00,2157,2158
3770,1,512,512,512.00,0.00,2157,2158
3771,2,436,76,256.00,32400.00,2157,2159
3772,1,512,512,512.00,0.00,2158,2159
3773,1,512,512,512.00,0.00,2158,2159
3774,3,346,22,170.67,17851.56,2158,2161
3775,2,396,116,256.00,19600.00,2160,2162
3776,1,512,512,512.00,0.00,2161,2162
3777,1,512,512,512.00,0.00,2161,2162
3778,2,407,105,256.00,22801.00,2161,2163
3779,1,512,512,512.00,0.00,2162,2163
3780,1,512,512,512.00,0.00,2162,2163
3781,2,376,136,256.00,14400.00,2162,2164
3782,1,512,512,512.00,0.00,2163,2164
3783,1,512,512,512.00,0.00,2163,2164
3784,1,512,512,512.00,0.00,2163,2164
3785,2,401,111,256.00,21025.00,2163,2165
3786,1,512,512,512.00,0.00,2164,2165
3787,1,512,512,512.00,0.00,2164,2165
3788,1,512,512,512.00,0.00,2164,2165
3789,1,512,512,512.00,0.00,2164,2165
3790,2,447,65,256.00,36481.00,2164,2166
3791,1,512,512,512.00,0.00,2165,2166
3792,1,512,512,512.00,0.00,2165,2166
3793,1,512,512,512.00,0.00,2165,2166
3794,1,512,512,512.00,0.00,2165,2166
3795,1,512,512,512.00,0.00,2165,2166
3796,2,327,185,256.00,5041.00,2165,2167
3797,1,512,512,512.00,0.00,2166,2167
3798,2,264,248,256.00,64.00,2166,2168
3799,1,512,512,512.00,0.00,2167,2168
3800,1,512,512,512.00,0.00,2167,2168
3801,1,512,512,512.00,0.00,2167,2168
3802,1,512,512,512.00,0.00,2167,2168
3803,2,263,249,256.00,49.00,2167,2169
3804,1,512,512,512.00,0.00,2168,2169
3805,2,420,92,256.00,26896.00,2168,2170
3806,1,512,512,512.00,0.00,2169,2170
3807,1,512,512,512.00,0.00,2169,2170
3808,2,397,115,256.00,19881.00,2169,2171
3809,4,249,20,128.00,7377.50,2170,2174
3810,2,469,43,256.00,45369.00,2173,2175
3811,7,184,1,73.14,5031.27,2174,2181
3812,1,512,512,512.00,0.00,2180,2181
3813,6,312,1,85.33,12087.56,2180,2186
3814,1,512,512,512.00,0.00,2185,2186
3815,1,512,512,512.00,0.00,2185,2186
3816,1,512,512,512.00,0.00,2185,2186
3817,1,512,512,512.00,0.00,2185,2186
3818,2,379,133,256.00,15129.00,2185,2187
3819,1,512,512,512.00,0.00,2186,2187
3820,1,512,512,512.00,0.00,2186,2187
3821,2,336,176,256.00,6400.00,2186,2188
3822,2,362,150,256.00,11236.00,2187,2189
3823,3,425,2,170.67,33490.89,2188,2191
3824,5,262,25,102.40,7463.44,2190,2195
3825,1,512,512,512.00,0.00,2194,2195
3826,1,512,512,512.00,0.00,2194,2195
3827,1,512,512,512.00,0.00,2194,2195
3828,6,354,3,85.33,16184.22,2194,2200
3829,1,512,512,512.00,0.00,2199,2200
3830,3,354,51,170.67,17328.22,2199,2202
3831,2,459,53,256.00,41209.00,2201,2203
3832,3,487,11,170.67,50034.89,2202,2205
3833,6,185,1,85.33,5342.22,2204,2210
3834,1,512,512,512.00,0.00,2209,2210
3835,2,266,246,256.00,100.00,2209,2211
3836,4,373,5,128.00,21333.50,2210,2214
3837,1,512,512,512.00,0.00,2213,2214
3838,2,271,241,256.00,225.00,2213,2215
3839,2,403,109,256.00,21609.00,2214,2216
3840,1,512,512,512.00,0.00,2215,2216
3841,2,433,79,256.00,31329.00,2215,2217
3842,1,512,512,512.00,0.00,2216,2217
3843,2,391,121,256.00,18225.00,2216,2218
3844,3,354,33,170.67,18216.22,2217,2220
3845,1,512,512,512.00,0.00,2219,2220
3846,1,512,512,512.00,0.00,2219,2220
3847,3,203,153,170.67,524.22,2219,2222
3848,1,512,512,512.00,0.00,2221,2222
3849,1,512,512,512.00,0.00,2221,2222
3850,4,176,66,128.00,1782.00,2221,2225
3851,1,512,512,512.00,0.00,2224,2225
3852,1,512,512,512.00,0.00,2224,2225
3853,1,512,512,512.00,0.00,2224,2225
3854,1,512,512,512.00,0.00,2224,2225
3855,2,311,201,256.00,3025.00,2224,2226
3856,1,512,512,512.00,0.00,2225,2226
3857,2,484,28,256.00,51984.00,2225,2227
3858,1,512,512,512.00,0.00,2226,2227
3859,1,512,512,512.00,0.00,2226,2227
3860,2,447,65,256.00,36481.00,2226,2228
3861,2,456,56,256.00,40000.00,2227,2229
3862,5,211,1,102.40,6396.24,2228,2233
3863,1,512,512,512.00,0.00,2232,2233
3864,1,512,512,512.00,0.00,2232,2233
3865,1,512,512,512.00,0.00,2232,2233
3866,1,512,512,512.00,0.00,2232,2233
3867,1,512,512,512.00,0.00,2232,2233
3868,1,512,512,512.00,0.00,2232,2233
3869,3,247,59,170.67,6514.89,2232,2235
3870,3,266,123,170.67,4544.22,2234,2237
3871,1,512,512,512.00,0.00,2236,2237
3872,2,399,113,256.00,20449.00,2236,2238
3873,2,483,29,256.00,51529.00,2237,2239
3874,1,512,512,512.00,0.00,2238,2239
3875,1,512,512,512.00,0.00,2238,2239
3876,1,512,512,512.00,0.00,2238,2239
3877,1,512,512,512.00,0.00,2238,2239
3878,3,270,80,170.67,6054.22,2238,2241
3879,1,512,512,512.00,0.00,2240,2241
3880,2,319,193,256.00,3969.00,2240,2242
3881,1,512,512,512.00,0.00,2241,2242
3882,1,512,512,512.00,0.00,2241,2242
3883,2,396,116,256.00,19600.00,2241,2243
3884,1,512,512,512.00,0.00,2242,2243
3885,3,305,20,170.67,13670.89,2242,2245
3886,1,512,512,512.00,0.00,2244,2245
3887,5,280,3,102.40,14377.84,2244,2249
3888,1,512,512,512.00,0.00,2248,2249
3889,4,244,3,128.00,7470.50,2248,2252
3890,5,284,4,102.40,13181.44,2251,2256
3891,1,512,512,512.00,0.00,2255,2256
3892,4,217,29,128.00,5455.50,2255,2259
3893,1,512,512,512.00,0.00,2258,2259
3894,1,512,512,512.00,0.00,2258,2259
3895,3,363,65,170.67,18556.22,2258,2261
3896,1,512,512,512.00,0.00,2260,2261
3897,3,450,15,170.67,39184.22,2260,2263
3898,2,453,59,256.00,38809.00,2262,2264
3899,2,476,36,256.00,48400.00,2263,2265
3900,1,512,512,512.00,0.00,2264,2265
3901,1,512,512,512.00,0.00,2264,2265
3902,4,241,45,128.00,7271.50,2264,2268
3903,1,512,512,512.00,0.00,2267,2268
3904,1,512,512,512.00,0.00,2267,2268
3905,1,512,512,512.00,0.00,2267,2268
3906,1,512,512,512.00,0.00,2267,2268
3907,2,300,212,256.00,1936.00,2267,2269
3908,1,512,512,512.00,0.00,2268,2269
3909,1,512,512,512.00,0.00,2268,2269
3910,2,415,97,256.00,25281.00,2268,2270
3911,1,512,512,512.00,0.00,2269,2270
3912,2,322,190,256.00,4356.00,2269,2271
3913,3,454,2,170.67,40624.89,2270,2273
3914,2,483,29,256.00,51529.00,2272,2274
3915,1,512,512,512.00,0.00,2273,2274
3916,2,268,244,256.00,144.00,2273,2275
3917,4,389,1,128.00,24507.50,2274,2278
3918,4,316,1,128.00,16336.50,2277,2281
3919,1,512,512,512.00,0.00,2280,2281
3920,1,512,512,512.00,0.00,2280,2281
3921,1,512,512,512.00,0.00,2280,2281
3922,1,512,512,512.00,0.00,2280,2281
3923,2,390,122,256.00,17956.00,2280,2282
3924,4,463,1,128.00,37498.50,2281,2285
3925,2,347,165,256.00,8281.00,2284,2286
3926,2,456,56,256.00,40000.00,2285,2287
3927,2,448,64,256.00,36864.00,2286,2288
3928,5,284,11,102.40,10767.44,2287,2292
3929,1,512,512,512.00,0.00,2291,2292
3930,11,114,1,46.55,1445.70,2291,2302
3931,1,512,512,512.00,0.00,2301,2302
3932,1,512,512,512.00,0.00,2301,2302
3933,2,478,34,256.00,49284.00,2301,2303
3934,3,232,136,170.67,1891.56,2302,2305
3935,1,512,512,512.00,0.00,2304,2305
3936,1,512,512,512.00,0.00,2304,2305
3937,2,481,31,256.00,50625.00,2304,2306
3938,1,512,512,512.00,0.00,2305,2306
3939,2,353,159,256.00,9409.00,2305,2307
3940,1,512,512,512.00,0.00,2306,2307
3941,1,512,512,512.00,0.00,2306,2307
3942,1,512,512,512.00,0.00,2306,2307
3943,2,422,90,256.00,27556.00,2306,2308
3944,1,512,512,512.00,0.00,2307,2308
3945,1,512,512,512.00,0.00,2307,2308
3946,1,512,512,512.00,0.00,2307,2308
3947,1,512,512,512.00,0.00,2307,2308
3948,4,260,2,128.00,14054.00,2307,2311
3949,1,512,512,512.00,0.00,2310,2311
3950,1,512,512,512.00,0.00,2310,2311
3951,1,512,512,512.00,0.00,2310,2311
3952,3,395,31,170.67,25666.89,2310,2313
3953,1,512,512,512.00,0.00,2312,2313
3954,1,512,512,512.00,0.00,2312,2313
3955,1,512,512,512.00,0.00,2312,2313
3956,1,512,512,512.00,0.00,2312,2313
3957,2,385,127,256.00,16641.00,2312,2314
3958,1,512,512,512.00,0.00,2313,2314
3959,1,512,512,512.00,0.00,2313,2314
3960,1,512,512,512.00,0.00,2313,2314
3961,3,497,7,170.67,53246.89,2313,2316
3962,1,512,512,512.00,0.00,2315,2316
3963,1,512,512,512.00,0.00,2315,2316
3964,1,512,512,512.00,0.00,2315,2316
3965,1,512,512,512.00,0.00,2315,2316
3966,1,512,512,512.00,0.00,2315,2316
3967,6,415,1,85.33,22327.89,2315,2321
3968,1,512,512,512.00,0.00,2320,2321
3969,1,512,512,512.00,0.00,2320,2321
3970,2,397,115,256.00,19881.00,2320,2322
3971,1,512,512,512.00,0.00,2321,2322
3972,1,512,512,512.00,0.00,2321,2322
3973,5,236,2,102.40,5787.84,2321,2326
3974,4,221,17,128.00,5411.00,2325,2329
3975,3,231,69,170.67,5228.22,2328,2331
3976,3,271,81,170.67,6073.56,2330,2333
3977,1,512,512,512.00,0.00,2332,2333
3978,1,512,512,512.00,0.00,2332,2333
3979,2,481,31,256.00,50625.00,2332,2334
3980,1,512,512,512.00,0.00,2333,2334
3981,2,451,61,256.00,38025.00,2333,2335
3982,1,512,512,512.00,0.00,2334,2335
3983,2,271,241,256.00,225.00,2334,2336
3984,1,512,512,512.00,0.00,2335,2336
3985,1,512,512,512.00,0.00,2335,2336
3986,4,411,1,128.00,27361.00,2335,2339
3987,3,443,2,170.67,37786.89,2338,2341
3988,2,485,27,256.00,52441.00,2340,2342
3989,1,512,512,512.00,0.00,2341,2342
3990,1,512,512,512.00,0.00,2341,2342
3991,1,512,512,512.00,0.00,2341,2342
3992,1,512,512,512.00,0.00,2341,2342
3993,1,512,512,512.00,0.00,2341,2342
3994,2,301,211,256.00,2025.00,2341,2343
3995,1,512,512,512.00,0.00,2342,2343
3996,1,512,512,512.00,0.00,2342,2343
3997,1,512,512,512.00,0.00,2342,2343
3998,1,512,512,512.00,0.00,2342,2343
3999,1,512,512,512.00,0.00,2342,2343
4000,2,438,74,256.00,33124.00,2342,2344
4001,1,512,512,512.00,0.00,2343,2344
4002,1,512,512,512.00,0.00,2343,2344
4003,1,512,512,512.00,0.00,2343,2344
4004,5,360,9,102.40,17102.24,2343,2348
4005,7,269,3,73.14,7218.69,2347,2354
4006,3,284,22,170.67,12064.89,2353,2356
4007,3,251,112,170.67,3454.89,2355,2358
4008,2,399,113,256.00,20449.00,2357,2359
4009,1,512,512,512.00,0.00,2358,2359
4010,1,512,512,512.00,0.00,2358,2359
4011,2,385,127,256.00,16641.00,2358,2360
4012,1,512,512,512.00,0.00,2359,2360
4013,2,267,245,256.00,121.00,2359,2361
4014,1,512,512,512.00,0.00,2360,2361
4015,1,512,512,512.00,0.00,2360,2361
4016,1,512,512,512.00,0.00,2360,2361
4017,2,461,51,256.00,42025.00,2360,2362
4018,1,512,512,512.00,0.00,2361,2362
4019,3,350,68,170.67,16192.89,2361,2364
4020,3,341,55,170.67,15126.89,2363,2366
4021,2,471,41,256.00,46225.00,2365,2367
4022,1,512,512,512.00,0.00,2366,2367
4023,1,512,512,512.00,0.00,2366,2367
4024,1,512,512,512.00,0.00,2366,2367
4025,2,312,200,256.00,3136.00,2366,2368
4026,2,446,66,256.00,36100.00,2367,2369
4027,1,512,512,512.00,0.00,2368,2369
4028,1,512,512,512.00,0.00,2368,2369
4029,1,512,512,512.00,0.00,2368,2369
4030,2,390,122,256.00,17956.00,2368,2370
4031,4,264,2,128.00,10986.00,2369,2373
4032,3,480,3,170.67,47956.22,2372,2375
4033,1,512,512,512.00,0.00,2374,2375
4034,3,329,90,170.67,12536.22,2374,2377
4035,2,476,36,256.00,48400.00,2376,2378
4036,1,512,512,512.00,0.00,2377,2378
4037,1,512,512,512.00,0.00,2377,2378
4038,1,512,512,512.00,0.00,2377,2378
4039,1,512,512,512.00,0.00,2377,2378
4040,1,512,512,512.00,0.00,2377,2378
4041,1,512,512,512.00,0.00,2377,2378
4042,2,477,35,256.00,48841.00,2377,2379
4043,1,512,512,512.00,0.00,2378,2379
4044,4,483,2,128.00,42045.50,2378,2382
4045,3,270,31,170.67,10333.56,2381,2384
4046,1,512,512,512.00,0.00,2383,2384
4047,1,512,512,512.00,0.00,2383,2384
4048,4,376,30,128.00,20734.00,2383,2387
4049,2,474,38,256.00,47524.00,2386,2388
4050,5,189,44,102.40,2344.24,2387,2392
4051,2,426,86,256.00,28900.00,2391,2393
4052,1,512,512,512.00,0.00,2392,2393
4053,1,512,512,512.00,0.00,2392,2393
4054,1,512,512,512.00,0.00,2392,2393
4055,1,512,512,512.00,0.00,2392,2393
4056,2,449,63,256.00,37249.00,2392,2394
4057,1,512,512,512.00,0.00,2393,2394
4058,2,462,50,256.00,42436.00,2393,2395
4059,1,512,512,512.00,0.00,2394,2395
4060,3,291,1,170.67,15233.56,2394,2397
4061,1,512,512,512.00,0.00,2396,2397
4062,1,512,512,512.00,0.00,2396,2397
4063,3,286,3,170.67,14717.56,2396,2399
4064,2,315,197,256.00,3481.00,2398,2400
4065,1,512,512,512.00,0.00,2399,2400
4066,1,512,512,512.00,0.00,2399,2400
4067,2,471,41,256.00,46225.00,2399,2401
4068,1,512,512,512.00,0.00,2400,2401
4069,1,512,512,512.00,0.00,2400,2401
4070,2,429,83,256.00,29929.00,2400,2402
4071,1,512,512,512.00,0.00,2401,2402
4072,1,512,512,512.00,0.00,2401,2402
4073,1,512,512,512.00,0.00,2401,2402
4074,2,465,47,256.00,43681.00,2401,2403
4075,1,512,512,512.00,0.00,2402,2403
4076,1,512,512,512.00,0.00,2402,2403
4077,2,400,112,256.00,20736.00,2402,2404
4078,2,332,180,256.00,5776.00,2403,2405
4079,2,382,130,256.00,15876.00,2404,2406
4080,2,287,225,256.00,961.00,2405,2407
4081,1,512,512,512.00,0.00,2406,2407
4082,4,207,59,128.00,4811.00,2406,2410
4083,2,424,88,256.00,28224.00,2409,2411
4084,1,512,512,512.00,0.00,2410,2411
4085,1,512,512,512.00,0.00,2410,2411
4086,1,512,512,512.00,0.00,2410,2411
4087,1,512,512,512.00,0.00,2410,2411
4088,2,338,174,256.00,6724.00,2410,2412
4089,1,512,512,512.00,0.00,2411,2412
4090,1,512,512,512.00,0.00,2411,2412
4091,1,512,512,512.00,0.00,2411,2412
4092,1,512,512,512.00,0.00,2411,2412
4093,1,512,512,512.00,0.00,2411,2412
4094,2,449,63,256.00,37249.00,2411,2413
4095,2,299,213,256.00,1849.00,2412,2414
4096,1,512,512,512.00,0.00,2413,2414
4097,2,310,202,256.00,2916.00,2413,2415
4098,1,512,512,512.00,0.00,2414,2415
4099,3,316,90,170.67,10603.56,2414,2417
4100,1,512,512,512.00,0.00,2416,2417
4101,1,512,512,512.00,0.00,2416,2417
4102,1,512,512,512.00,0.00,2416,2417
4103,1,512,512,512.00,0.00,2416,2417
4104,1,512,512,512.00,0.00,2416,2417
4105,2,346,166,256.00,8100.00,2416,2418
4106,1,512,512,512.00,0.00,2417,2418
4107,1,512,512,512.00,0.00,2417,2418
4108,1,512,512,512.00,0.00,2417,2418
4109,1,512,512,512.00,0.00,2417,2418
4110,2,428,84,256.00,29584.00,2417,2419
4111,1,512,512,512.00,0.00,2418,2419
4112,1,512,512,512.00,0.00,2418,2419
4113,3,440,23,170.67,36382.89,2418,2421
4114,1,512,512,512.00,0.00,2420,2421
4115,1,512,512,512.00,0.00,2420,2421
4116,2,413,99,256.00,24649.00,2420,2422
4117,1,512,512,512.00,0.00,2421,2422
4118,2,297,215,256.00,1681.00,2421,2423
4119,2,508,4,256.00,63504.00,2422,2424
4120,1,512,512,512.00,0.00,2423,2424
4121,3,483,5,170.67,48836.22,2423,2426
4122,1,512,512,512.00,0.00,2425,2426
4123,4,245,13,128.00,6971.00,2425,2429
4124,1,512,512,512.00,0.00,2428,2429
4125,1,512,512,512.00,0.00,2428,2429
4126,2,285,227,256.00,841.00,2428,2430
4127,1,512,512,512.00,0.00,2429,2430
4128,1,512,512,512.00,0.00,2429,2430
4129,2,276,236,256.00,400.00,2429,2431
4130,1,512,512,512.00,0.00,2430,2431
4131,1,512,512,512.00,0.00,2430,2431
4132,1,512,512,512.00,0.00,2430,2431
4133,3,473,12,170.67,45740.22,2430,2433
4134,2,383,129,256.00,16129.00,2432,2434
4135,3,255,89,170.67,4596.22,2433,2436
4136,2,453,59,256.00,38809.00,2435,2437
4137,5,217,9,102.40,6353.84,2436,2441
4138,3,392,36,170.67,24878.22,2440,2443
4139,2,353,159,256.00,9409.00,2442,2444
4140,4,426,5,128.00,30162.50,2443,2447
4141,2,294,218,256.00,1444.00,2446,2448
4142,1,512,512,512.00,0.00,2447,2448
4143,2,495,17,256.00,57121.00,2447,2449
4144,3,231,53,170.67,6924.22,2448,2451
4145,6,145,35,85.33,1703.56,2450,2456
4146,4,382,28,128.00,21594.00,2455,2459
4147,2,382,130,256.00,15876.00,2458,2460
4148,2,483,29,256.00,51529.00,2459,2461
4149,1,512,512,512.00,0.00,2460,2461
4150,1,512,512,512.00,0.00,2460,2461
4151,2,405,107,256.00,22201.00,2460,2462
4152,4,331,10,128.00,16831.50,2461,2465
4153,1,512,512,512.00,0.00,2464,2465
4154,1,512,512,512.00,0.00,2464,2465
4155,2,288,224,256.00,1024.00,2464,2466
4156,1,512,512,512.00,0.00,2465,2466
4157,2,369,143,256.00,12769.00,2465,2467
4158,2,305,207,256.00,2401.00,2466,2468
4159,1,512,512,512.00,0.00,2467,2468
4160,5,179,3,102.40,5963.84,2467,2472
4161,2,373,139,256.00,13689.00,2471,2473
4162,2,276,236,256.00,400.00,2472,2474
4163,1,512,512,512.00,0.00,2473,2474
4164,1,512,512,512.00,0.00,2473,2474
4165,1,512,512,512.00,0.00,2473,2474
4166,3,295,64,170.67,9049.56,2473,2476
4167,1,512,512,512.00,0.00,2475,2476
4168,2,372,140,256.00,13456.00,2475,2477
4169,1,512,512,512.00,0.00,2476,2477
4170,2,351,161,256.00,9025.00,2476,2478
4171,1,512,512,512.00,0.00,2477,2478
4172,1,512,512,512.00,0.00,2477,2478
4173,5,351,10,102.40,15711.44,2477,2482
4174,2,431,81,256.00,30625.00,2481,2483
4175,2,354,158,256.00,9604.00,2482,2484
4176,1,512,512,512.00,0.00,2483,2484
4177,9,276,2,56.89,6660.54,2483,2492
4178,3,281,13,170.67,13090.89,2491,2494
4179,3,363,69,170.67,18516.22,2493,2496
4180,1,512,512,512.00,0.00,2495,2496
4181,3,377,8,170.67,23646.89,2495,2498
4182,3,252,54,170.67,7158.22,2497,2500
4183,8,213,2,64.00,4898.25,2499,2507
4184,1,512,512,512.00,0.00,2506,2507
4185,1,512,512,512.00,0.00,2506,2507
4186,1,512,512,512.00,0.00,2506,2507
4187,1,512,512,512.00,0.00,2506,2507
4188,3,314,24,170.67,14022.22,2506,2509
4189,2,503,9,256.00,61009.00,2508,2510
4190,1,512,512,512.00,0.00,2509,2510
4191,2,357,155,256.00,10201.00,2509,2511
4192,3,287,108,170.67,6780.22,2510,2513
4193,1,512,512,512.00,0.00,2512,2513
4194,2,431,81,256.00,30625.00,2512,2514
4195,1,512,512,512.00,0.00,2513,2514
4196,1,512,512,512.00,0.00,2513,2514
4197,1,512,512,512.00,0.00,2513,2514
4198,1,512,512,512.00,0.00,2513,2514
4199,1,512,512,512.00,0.00,2513,2514
4200,3,391,15,170.67,25653.56,2513,2516
4201,3,312,6,170.67,15878.22,2515,2518
4202,2,440,72,256.00,33856.00,2517,2519
4203,1,512,512,512.00,0.00,2518,2519
4204,1,512,512,512.00,0.00,2518,2519
4205,1,512,512,512.00,0.00,2518,2519
4206,2,511,1,256.00,65025.00,2518,2520
4207,3,315,87,170.67,10504.22,2519,2522
4208,1,512,512,512.00,0.00,2521,2522
4209,1,512,512,512.00,0.00,2521,2522
4210,1,512,512,512.00,0.00,2521,2522
4211,2,273,239,256.00,289.00,2521,2523
4212,4,249,21,128.00,9285.00,2522,2526
4213,2,460,52,256.00,41616.00,2525,2527
4214,3,331,22,170.67,15981.56,2526,2529
4215,1,512,512,512.00,0.00,2528,2529
4216,1,512,512,512.00,0.00,2528,2529
4217,1,512,512,512.00,0.00,2528,2529
4218,2,270,242,256.00,196.00,2528,2530
4219,3,246,87,170.67,4248.22,2529,2532
4220,1,512,512,512.00,0.00,2531,2532
4221,1,512,512,512.00,0.00,2531,2532
4222,1,512,512,512.00,0.00,2531,2532
4223,1,512,512,512.00,0.00,2531,2532
4224,4,282,7,128.00,14978.50,2531,2535
4225,1,512,512,512.00,0.00,2534,2535
4226,1,512,512,512.00,0.00,2534,2535
4227,2,447,65,256.00,36481.00,2534,2536
4228,3,345,24,170.67,17556.22,2535,2538
4229,3,429,27,170.67,33508.22,2537,2540
4230,1,512,512,512.00,0.00,2539,2540
4231,2,361,151,256.00,11025.00,2539,2541
4232,5,407,6,102.40,23689.04,2540,2545
4233,2,344,168,256.00,7744.00,2544,2546
4234,2,322,190,256.00,4356.00,2545,2547
4235,1,512,512,512.00,0.00,2546,2547
4236,3,279,1,170.67,14761.56,2546,2549
4237,8,215,1,64.00,4779.25,2548,2556
4238,5,181,37,102.40,3054.24,2555,2560
4239,5,187,8,102.40,4161.84,2559,2564
4240,2,316,196,256.00,3600.00,2563,2565
4241,2,427,85,256.00,29241.00,2564,2566
4242,1,512,512,512.00,0.00,2565,2566
4243,7,197,2,73.14,5218.12,2565,2572
4244,4,214,1,128.00,6469.50,2571,2575
4245,1,512,512,512.00,0.00,2574,2575
4246,1,512,512,512.00,0.00,2574,2575
4247,1,512,512,512.00,0.00,2574,2575
4248,2,334,178,256.00,6084.00,2574,2576
4249,2,425,87,256.00,28561.00,2575,2577
4250,1,512,512,512.00,0.00,2576,2577
4251,1,512,512,512.00,0.00,2576,2577
4252,3,321,52,170.67,12561.56,2576,2579
4253,1,512,512,512.00,0.00,2578,2579
4254,2,502,10,256.00,60516.00,2578,2580
4255,1,512,512,512.00,0.00,2579,2580
4256,2,414,98,256.00,24964.00,2579,2581
4257,3,287,41,170.67,10174.89,2580,2583
4258,1,512,512,512.00,0.00,2582,2583
4259,2,388,124,256.00,17424.00,2582,2584
4260,1,512,512,512.00,0.00,2583,2584
4261,4,271,11,128.00,9303.50,2583,2587
4262,6,217,6,85.33,5131.56,2586,2592
4263,2,481,31,256.00,50625.00,2591,2593
4264,4,289,22,128.00,9920.50,2592,2596
4265,4,387,6,128.00,23467.50,2595,2599
4266,3,362,17,170.67,20546.89,2598,2601
4267,2,497,15,256.00,58081.00,2600,2602
4268,1,512,512,512.00,0.00,2601,2602
4269,2,407,105,256.00,22801.00,2601,2603
4270,1,512,512,512.00,0.00,2602,2603
4271,1,512,512,512.00,0.00,2602,2603
4272,1,512,512,512.00,0.00,2602,2603
4273,1,512,512,512.00,0.00,2602,2603
4274,2,481,31,256.00,50625.00,2602,2604
4275,2,409,103,256.00,23409.00,2603,2605
4276,2,382,130,256.00,15876.00,2604,2606
4277,1,512,512,512.00,0.00,2605,2606
4278,1,512,512,512.00,0.00,2605,2606
4279,1,512,512,512.00,0.00,2605,2606
4280,5,189,2,102.40,6277.04,2605,2610
4281,3,434,8,170.67,35312.89,2609,2612
4282,1,512,512,512.00,0.00,2611,2612
4283,2,398,114,256.00,20164.00,2611,2613
4284,1,512,512,512.00,0.00,2612,2613
4285,1,512,512,512.00,0.00,2612,2613
4286,1,512,512,512.00,0.00,2612,2613
4287,2,509,3,256.00,64009.00,2612,2614
4288,3,491,1,170.67,51366.89,2613,2616
4289,2,461,51,256.00,42025.00,2615,2617
4290,1,512,512,512.00,0.00,2616,2617
4291,1,512,512,512.00,0.00,2616,2617
4292,1,512,512,512.00,0.00,2616,2617
4293,2,367,145,256.00,12321.00,2616,2618
4294,1,512,512,512.00,0.00,2617,2618
4295,1,512,512,512.00,0.00,2617,2618
4296,1,512,512,512.00,0.00,2617,2618
4297,2,474,38,256.00,47524.00,2617,2619
4298,2,485,27,256.00,52441.00,2618,2620
4299,1,512,512,512.00,0.00,2619,2620
4300,1,512,512,512.00,0.00,2619,2620
4301,2,324,188,256.00,4624.00,2619,2621
4302,1,512,512,512.00,0.00,2620,2621
4303,1,512,512,512.00,0.00,2620,2621
4304,1,512,512,512.00,0.00,2620,2621
4305,1,512,512,512.00,0.00,2620,2621
4306,2,484,28,256.00,51984.00,2620,2622
4307,1,512,512,512.00,0.00,2621,2622
4308,2,296,216,256.00,1600.00,2621,2623
4309,1,512,512,512.00,0.00,2622,2623
4310,1,512,512,512.00,0.00,2622,2623
4311,2,286,226,256.00,900.00,2622,2624
4312,1,512,512,512.00,0.00,2623,2624
4313,1,512,512,512.00,0.00,2623,2624
4314,2,267,245,256.00,121.00,2623,2625
4315,1,512,512,512.00,0.00,2624,2625
4316,2,491,21,256.00,55225.00,2624,2626
4317,1,512,512,512.00,0.00,2625,2626
4318,1,512,512,512.00,0.00,2625,2626
4319,2,476,36,256.00,48400.00,2625,2627
4320,2,464,48,256.00,43264.00,2626,2628
4321,1,512,512,512.00,0.00,2627,2628
4322,2,337,175,256.00,6561.00,2627,2629
4323,1,512,512,512.00,0.00,2628,2629
4324,1,512,512,512.00,0.00,2628,2629
4325,1,512,512,512.00,0.00,2628,2629
4326,1,512,512,512.00,0.00,2628,2629
4327,2,411,101,256.00,24025.00,2628,2630
4328,4,241,47,128.00,6161.00,2629,2633
4329,3,237,84,170.67,4108.22,2632,2635
4330,2,342,170,256.00,7396.00,2634,2636
4331,2,300,212,256.00,1936.00,2635,2637
4332,1,512,512,512.00,0.00,2636,2637
4333,1,512,512,512.00,0.00,2636,2637
4334,1,512,512,512.00,0.00,2636,2637
4335,3,437,29,170.67,35514.89,2636,2639
4336,1,512,512,512.00,0.00,2638,2639
4337,1,512,512,512.00,0.00,2638,2639
4338,1,512,512,512.00,0.00,2638,2639
4339,2,331,181,256.00,5625.00,2638,2640
4340,4,175,89,128.00,1332.50,2639,2643
4341,2,466,46,256.00,44100.00,2642,2644
4342,1,512,512,512.00,0.00,2643,2644
4343,5,381,1,102.40,20825.84,2643,2648
4344,2,475,37,256.00,47961.00,2647,2649
4345,1,512,512,512.00,0.00,2648,2649
4346,3,216,91,170.67,3193.56,2648,2651
4347,6,281,5,85.33,9344.22,2650,2656
4348,4,400,29,128.00,24742.50,2655,2659
4349,1,512,512,512.00,0.00,2658,2659
4350,1,512,512,512.00,0.00,2658,2659
4351,5,237,4,102.40,5926.24,2658,2663
4352,1,512,512,512.00,0.00,2662,2663
4353,1,512,512,512.00,0.00,2662,2663
4354,6,168,7,85.33,4100.56,2662,2668
4355,1,512,512,512.00,0.00,2667,2668
4356,1,512,512,512.00,0.00,2667,2668
4357,2,389,123,256.00,17689.00,2667,2669
4358,1,512,512,512.00,0.00,2668,2669
4359,1,512,512,512.00,0.00,2668,2669
4360,1,512,512,512.00,0.00,2668,2669
4361,1,512,512,512.00,0.00,2668,2669
4362,1,512,512,512.00,0.00,2668,2669
4363,1,512,512,512.00,0.00,2668,2669
4364,2,356,156,256.00,10000.00,2668,2670
4365,1,512,512,512.00,0.00,2669,2670
4366,1,512,512,512.00,0.00,2669,2670
4367,3,430,1,170.67,34693.56,2669,2672
4368,2,398,114,256.00,20164.00,2671,2673
4369,2,489,23,256.00,54289.00,2672,2674
4370,2,331,181,256.00,5625.00,2673,2675
4371,2,441,71,256.00,34225.00,2674,2676
4372,1,512,512,512.00,0.00,2675,2676
4373,1,512,512,512.00,0.00,2675,2676
4374,1,512,512,512.00,0.00,2675,2676
4375,4,269,59,128.00,6906.50,2675,2679
4376,1,512,512,512.00,0.00,2678,2679
4377,2,492,20,256.00,55696.00,2678,2680
4378,5,290,4,102.40,14017.84,2679,2684
4379,1,512,512,512.00,0.00,2683,2684
4380,1,512,512,512.00,0.00,2683,2684
4381,2,269,243,256.00,169.00,2683,2685
4382,1,512,512,512.00,0.00,2684,2685
4383,3,281,52,170.67,8774.89,2684,2687
4384,1,512,512,512.00,0.00,2686,2687
4385,1,512,512,512.00,0.00,2686,2687
4386,1,512,512,512.00,0.00,2686,2687
4387,2,504,8,256.00,61504.00,2686,2688
4388,3,260,11,170.67,12806.89,2687,2690
4389,2,387,125,256.00,17161.00,2689,2691
4390,5,211,20,102.40,4005.84,2690,2695
4391,6,257,1,85.33,6854.22,2694,2700
4392,1,512,512,512.00,0.00,2699,2700
4393,1,512,512,512.00,0.00,2699,2700
4394,1,512,512,512.00,0.00,2699,2700
4395,1,512,512,512.00,0.00,2699,2700
4396,1,512,512,512.00,0.00,2699,2700
4397,3,259,45,170.67,8329.56,2699,2702
4398,1,512,512,512.00,0.00,2701,2702
4399,2,491,21,256.00,55225.00,2701,2703
4400,1,512,512,512.00,0.00,2702,2703
4401,1,512,512,512.00,0.00,2702,2703
4402,1,512,512,512.00,0.00,2702,2703
4403,1,512,512,512.00,0.00,2702,2703
4404,8,160,1,64.00,4048.50,2702,2710
4405,1,512,512,512.00,0.00,2709,2710
4406,2,450,62,256.00,37636.00,2709,2711
4407,1,512,512,512.00,0.00,2710,2711
4408,4,292,1,128.00,14582.50,2710,2714
4409,1,512,512,512.00,0.00,2713,2714
4410,1,512,512,512.00,0.00,2713,2714
4411,3,363,57,170.67,18700.22,2713,2716
4412,1,512,512,512.00,0.00,2715,2716
4413,3,348,6,170.67,19574.22,2715,2718
4414,2,351,161,256.00,9025.00,2717,2719
4415,1,512,512,512.00,0.00,2718,2719
4416,1,512,512,512.00,0.00,2718,2719
4417,1,512,512,512.00,0.00,2718,2719
4418,3,462,23,170.67,42440.22,2718,2721
4419,2,286,226,256.00,900.00,2720,2722
4420,1,512,512,512.00,0.00,2721,2722
4421,1,512,512,512.00,0.00,2721,2722
4422,4,247,40,128.00,5641.50,2721,2725
4423,1,512,512,512.00,0.00,2724,2725
4424,1,512,512,512.00,0.00,2724,2725
4425,1,512,512,512.00,0.00,2724,2725
4426,1,512,512,512.00,0.00,2724,2725
4427,1,512,512,512.00,0.00,2724,2725
4428,1,512,512,512.00,0.00,2724,2725
4429,2,314,198,256.00,3364.00,2724,2726
4430,2,298,214,256.00,1764.00,2725,2727
4431,3,331,14,170.67,16754.89,2726,2729
4432,1,512,512,512.00,0.00,2728,2729
4433,1,512,512,512.00,0.00,2728,2729
4434,1,512,512,512.00,0.00,2728,2729
4435,2,325,187,256.00,4761.00,2728,2730
4436,1,512,512,512.00,0.00,2729,2730
4437,1,512,512,512.00,0.00,2729,2730
4438,1,512,512,512.00,0.00,2729,2730
4439,4,246,5,128.00,7294.50,2729,2733
4440,2,316,196,256.00,3600.00,2732,2734
4441,1,512,512,512.00,0.00,2733,2734
4442,1,512,512,512.00,0.00,2733,2734
4443,1,512,512,512.00,0.00,2733,2734
4444,3,379,38,170.67,22242.89,2733,2736
4445,2,273,239,256.00,289.00,2735,2737
4446,1,512,512,512.00,0.00,2736,2737
4447,1,512,512,512.00,0.00,2736,2737
4448,1,512,512,512.00,0.00,2736,2737
4449,1,512,512,512.00,0.00,2736,2737
4450,6,178,1,85.33,3782.89,2736,2742
4451,1,512,512,512.00,0.00,2741,2742
4452,1,512,512,512.00,0.00,2741,2742
4453,7,259,15,73.14,6332.12,2741,2748
4454,2,444,68,256.00,35344.00,2747,2749
4455,8,182,3,64.00,3220.50,2748,2756
4456,3,414,8,170.67,30726.22,2755,2758
4457,1,512,512,512.00,0.00,2757,2758
4458,1,512,512,512.00,0.00,2757,2758
4459,1,512,512,512.00,0.00,2757,2758
4460,2,404,108,256.00,21904.00,2757,2759
4461,1,512,512,512.00,0.00,2758,2759
4462,2,450,62,256.00,37636.00,2758,2760
4463,3,182,161,170.67,74.89,2759,2762
4464,2,461,51,256.00,42025.00,2761,2763
4465,2,470,42,256.00,45796.00,2762,2764
4466,1,512,512,512.00,0.00,2763,2764
4467,1,512,512,512.00,0.00,2763,2764
4468,1,512,512,512.00,0.00,2763,2764
4469,1,512,512,512.00,0.00,2763,2764
4470,3,493,3,170.67,51977.56,2763,2766
4471,1,512,512,512.00,0.00,2765,2766
4472,1,512,512,512.00,0.00,2765,2766
4473,2,283,229,256.00,729.00,2765,2767
4474,1,512,512,512.00,0.00,2766,2767
4475,1,512,512,512.00,0.00,2766,2767
4476,1,512,512,512.00,0.00,2766,2767
4477,1,512,512,512.00,0.00,2766,2767
4478,1,512,512,512.00,0.00,2766,2767
4479,5,284,15,102.40,9111.44,2766,2771
4480,2,446,66,256.00,36100.00,2770,2772
4481,1,512,512,512.00,0.00,2771,2772
4482,1,512,512,512.00,0.00,2771,2772
4483,1,512,512,512.00,0.00,2771,2772
4484,2,438,74,256.00,33124.00,2771,2773
4485,1,512,512,512.00,0.00,2772,2773
4486,1,512,512,512.00,0.00,2772,2773
4487,1,512,512,512.00,0.00,2772,2773
4488,1,512,512,512.00,0.00,2772,2773
4489,1,512,512,512.00,0.00,2772,2773
4490,1,512,512,512.00,0.00,2772,2773
4491,1,512,512,512.00,0.00,2772,2773
4492,3,274,15,170.67,12549.56,2772,2775
4493,1,512,512,512.00,0.00,2774,2775
4494,1,512,512,512.00,0.00,2774,2775
4495,1,512,512,512.00,0.00,2774,2775
4496,1,512,512,512.00,0.00,2774,2775
4497,2,280,232,256.00,576.00,2774,2776
4498,1,512,512,512.00,0.00,2775,2776
4499,1,512,512,512.00,0.00,2775,2776
4500,1,512,512,512.00,0.00,2775,2776
4501,1,512,512,512.00,0.00,2775,2776
4502,4,270,5,128.00,15084.50,2775,2779
4503,1,512,512,512.00,0.00,2778,2779
4504,2,272,240,256.00,256.00,2778,2780
4505,2,359,153,256.00,10609.00,2779,2781
4506,1,512,512,512.00,0.00,2780,2781
4507,1,512,512,512.00,0.00,2780,2781
4508,1,512,512,512.00,0.00,2780,2781
4509,2,449,63,256.00,37249.00,2780,2782
4510,1,512,512,512.00,0.00,2781,2782
4511,2,464,48,256.00,43264.00,2781,2783
4512,1,512,512,512.00,0.00,2782,2783
4513,1,512,512,512.00,0.00,2782,2783
4514,2,488,24,256.00,53824.00,2782,2784
4515,2,503,9,256.00,61009.00,2783,2785
4516,1,512,512,512.00,0.00,2784,2785
4517,2,471,41,256.00,46225.00,2784,2786
4518,1,512,512,512.00,0.00,2785,2786
4519,3,351,1,170.67,20473.56,2785,2788
4520,3,338,10,170.67,17952.89,2788,2791
4521,2,424,88,256.00,28224.00,2790,2792
4522,2,511,1,256.00,65025.00,2791,2793
4523,7,204,11,73.14,4450.12,2792,2799
4524,5,240,9,102.40,10315.04,2798,2803
4525,1,512,512,512.00,0.00,2802,2803
4526,1,512,512,512.00,0.00,2802,2803
4527,3,287,15,170.67,13104.22,2802,2805
4528,5,469,2,102.40,33676.24,2804,2809
4529,6,311,1,85.33,11335.56,2808,2814
4530,2,478,34,256.00,49284.00,2813,2815
4531,1,512,512,512.00,0.00,2814,2815
4532,3,428,10,170.67,33792.89,2814,2817
4533,2,345,167,256.00,7921.00,2816,2818
4534,1,512,512,512.00,0.00,2817,2818
4535,1,512,512,512.00,0.00,2817,2818
4536,3,351,13,170.67,19297.56,2817,2820
4537,1,512,512,512.00,0.00,2819,2820
4538,1,512,512,512.00,0.00,2819,2820
4539,1,512,512,512.00,0.00,2819,2820
4540,2,326,186,256.00,4900.00,2819,2821
4541,2,487,25,256.00,53361.00,2820,2822
4542,1,512,512,512.00,0.00,2821,2822
4543,2,434,78,256.00,31684.00,2821,2823
4544,1,512,512,512.00,0.00,2822,2823
4545,1,512,512,512.00,0.00,2822,2823
4546,1,512,512,512.00,0.00,2822,2823
4547,2,506,6,256.00,62500.00,2822,2824
4548,1,512,512,512.00,0.00,2823,2824
4549,2,411,101,256.00,24025.00,2823,2825
4550,1,512,512,512.00,0.00,2824,2825
4551,1,512,512,512.00,0.00,2824,2825
4552,2,479,33,256.00,49729.00,2824,2826
4553,1,512,512,512.00,0.00,2825,2826
4554,2,487,25,256.00,53361.00,2825,2827
4555,1,512,512,512.00,0.00,2826,2827
4556,2,345,167,256.00,7921.00,2826,2828
4557,1,512,512,512.00,0.00,2827,2828
4558,1,512,512,512.00,0.00,2827,2828
4559,1,512,512,512.00,0.00,2827,2828
4560,2,485,27,256.00,52441.00,2827,2829
4561,3,376,22,170.67,22491.56,2828,2831
4562,1,512,512,512.00,0.00,2830,2831
4563,2,263,249,256.00,49.00,2830,2832
4564,3,279,8,170.67,13716.22,2831,2834
4565,1,512,512,512.00,0.00,2833,2834
4566,1,512,512,512.00,0.00,2833,2834
4567,1,512,512,512.00,0.00,2833,2834
4568,4,413,3,128.00,27437.00,2833,2837
4569,1,512,512,512.00,0.00,2836,2837
4570,1,512,512,512.00,0.00,2836,2837
4571,1,512,512,512.00,0.00,2836,2837
4572,1,512,512,512.00,0.00,2836,2837
4573,1,512,512,512.00,0.00,2836,2837
4574,2,367,145,256.00,12321.00,2836,2838
4575,1,512,512,512.00,0.00,2837,2838
4576,1,512,512,512.00,0.00,2837,2838
4577,1,512,512,512.00,0.00,2837,2838
4578,1,512,512,512.00,0.00,2837,2838
4579,1,512,512,512.00,0.00,2837,2838
4580,1,512,512,512.00,0.00,2837,2838
4581,2,304,208,256.00,2304.00,2837,2839
4582,3,465,16,170.67,43353.56,2838,2841
4583,2,487,25,256.00,53361.00,2840,2842
4584,2,314,198,256.00,3364.00,2841,2843
4585,1,512,512,512.00,0.00,2842,2843
4586,4,424,18,128.00,29266.00,2842,2846
4587,3,378,40,170.67,21979.56,2845,2848
4588,6,258,3,85.33,8875.22,2847,2853
4589,1,512,512,512.00,0.00,2852,2853
4590,1,512,512,512.00,0.00,2852,2853
4591,1,512,512,512.00,0.00,2852,2853
4592,2,416,96,256.00,25600.00,2852,2854
4593,1,512,512,512.00,0.00,2853,2854
4594,4,460,4,128.00,36988.50,2853,2857
4595,1,512,512,512.00,0.00,2856,2857
4596,1,512,512,512.00,0.00,2856,2857
4597,2,487,25,256.00,53361.00,2856,2858
4598,1,512,512,512.00,0.00,2857,2858
4599,3,354,16,170.67,19451.56,2857,2860
4600,3,264,19,170.67,11705.56,2859,2862
4601,3,336,31,170.67,15833.56,2861,2864
4602,2,380,132,256.00,15376.00,2863,2865
4603,5,280,1,102.40,10097.44,2864,2869
4604,4,331,3,128.00,18331.00,2868,2872
4605,3,482,2,170.67,48576.89,2871,2874
4606,1,512,512,512.00,0.00,2873,2874
4607,3,309,23,170.67,13676.22,2873,2876
4608,1,512,512,512.00,0.00,2875,2876
4609,2,504,8,256.00,61504.00,2875,2877
4610,2,380,132,256.00,15376.00,2876,2878
4611,9,206,1,56.89,4063.21,2877,2886
4612,1,512,512,512.00,0.00,2885,2886
4613,5,375,4,102.40,19693.84,2885,2890
4614,6,331,1,85.33,13666.22,2889,2895
4615,2,380,132,256.00,15376.00,2894,2896
4616,1,512,512,512.00,0.00,2895,2896
4617,1,512,512,512.00,0.00,2895,2896
4618,2,459,53,256.00,41209.00,2895,2897
4619,1,512,512,512.00,0.00,2896,2897
4620,1,512,512,512.00,0.00,2896,2897
4621,1,512,512,512.00,0.00,2896,2897
4622,2,376,136,256.00,14400.00,2896,2898
4623,1,512,512,512.00,0.00,2897,2898
4624,1,512,512,512.00,0.00,2897,2898
4625,2,488,24,256.00,53824.00,2897,2899
4626,1,512,512,512.00,0.00,2898,2899
4627,1,512,512,512.00,0.00,2898,2899
4628,1,512,512,512.00,0.00,2898,2899
4629,1,512,512,512.00,0.00,2898,2899
4630,2,336,176,256.00,6400.00,2898,2900
4631,2,379,133,256.00,15129.00,2899,2901
4632,1,512,512,512.00,0.00,2900,2901
4633,1,512,512,512.00,0.00,2900,2901
4634,5,208,5,102.40,7268.24,2900,2905
4635,1,512,512,512.00,0.00,2904,2905
4636,3,326,89,170.67,12074.89,2904,2907
4637,1,512,512,512.00,0.00,2906,2907
4638,1,512,512,512.00,0.00,2906,2907
4639,2,490,22,256.00,54756.00,2906,2908
4640,1,512,512,512.00,0.00,2907,2908
4641,1,512,512,512.00,0.00,2907,2908
4642,1,512,512,512.00,0.00,2907,2908
4643,2,413,99,256.00,24649.00,2907,2909
4644,1,512,512,512.00,0.00,2908,2909
4645,2,423,89,256.00,27889.00,2908,2910
4646,1,512,512,512.00,0.00,2909,2910
4647,1,512,512,512.00,0.00,2909,2910
4648,1,512,512,512.00,0.00,2909,2910
4649,2,326,186,256.00,4900.00,2909,2911
4650,1,512,512,512.00,0.00,2910,2911
4651,1,512,512,512.00,0.00,2910,2911
4652,1,512,512,512.00,0.00,2910,2911
4653,5,312,4,102.40,12233.04,2910,2915
4654,1,512,512,512.00,0.00,2914,2915
4655,2,436,76,256.00,32400.00,2914,2916
4656,1,512,512,512.00,0.00,2915,2916
4657,1,512,512,512.00,0.00,2915,2916
4658,2,439,73,256.00,33489.00,2915,2917
4659,1,512,512,512.00,0.00,2916,2917
4660,1,512,512,512.00,0.00,2916,2917
4661,1,512,512,512.00,0.00,2916,2917
4662,2,404,108,256.00,21904.00,2916,2918
4663,2,414,98,256.00,24964.00,2917,2919
4664,1,512,512,512.00,0.00,2918,2919
4665,2,495,17,256.00,57121.00,2918,2920
4666,2,458,54,256.00,40804.00,2919,2921
4667,1,512,512,512.00,0.00,2920,2921
4668,1,512,512,512.00,0.00,2920,2921
4669,1,512,512,512.00,0.00,2920,2921
4670,1,512,512,512.00,0.00,2920,2921
4671,1,512,512,512.00,0.00,2920,2921
4672,2,304,208,256.00,2304.00,2920,2922
4673,1,512,512,512.00,0.00,2921,2922
4674,1,512,512,512.00,0.00,2921,2922
4675,1,512,512,512.00,0.00,2921,2922
4676,1,512,512,512.00,0.00,2921,2922
4677,1,512,512,512.00,0.00,2921,2922
4678,2,308,204,256.00,2704.00,2921,2923
4679,1,512,512,512.00,0.00,2922,2923
4680,1,512,512,512.00,0.00,2922,2923
4681,2,484,28,256.00,51984.00,2922,2924
4682,1,512,512,512.00,0.00,2923,2924
4683,1,512,512,512.00,0.00,2923,2924
4684,2,466,46,256.00,44100.00,2923,2925
4685,1,512,512,512.00,0.00,2924,2925
4686,1,512,512,512.00,0.00,2924,2925
4687,1,512,512,512.00,0.00,2924,2925
4688,1,512,512,512.00,0.00,2924,2925
4689,1,512,512,512.00,0.00,2924,2925
4690,1,512,512,512.00,0.00,2924,2925
4691,1,512,512,512.00,0.00,2924,2925
4692,2,482,30,256.00,51076.00,2924,2926
4693,1,512,512,512.00,0.00,2925,2926
4694,3,231,69,170.67,5228.22,2925,2928
4695,6,190,23,85.33,4776.56,2927,2933
4696,4,265,48,128.00,7023.50,2932,2936
4697,2,329,183,256.00,5329.00,2935,2937
4698,1,512,512,512.00,0.00,2936,2937
4699,2,418,94,256.00,26244.00,2936,2938
4700,1,512,512,512.00,0.00,2937,2938
4701,1,512,512,512.00,0.00,2937,2938
4702,1,512,512,512.00,0.00,2937,2938
4703,2,462,50,256.00,42436.00,2937,2939
4704,6,227,7,85.33,8655.56,2938,2944
4705,1,512,512,512.00,0.00,2943,2944
4706,2,345,167,256.00,7921.00,2943,2945
4707,1,512,512,512.00,0.00,2944,2945
4708,3,250,58,170.67,6699.56,2944,2947
4709,1,512,512,512.00,0.00,2946,2947
4710,2,285,227,256.00,841.00,2946,2948
4711,1,512,512,512.00,0.00,2947,2948
4712,4,333,2,128.00,18825.50,2947,2951
4713,4,400,23,128.00,24928.50,2950,2954
4714,1,512,512,512.00,0.00,2953,2954
4715,2,495,17,256.00,57121.00,2953,2955
4716,1,512,512,512.00,0.00,2954,2955
4717,2,436,76,256.00,32400.00,2954,2956
4718,1,512,512,512.00,0.00,2955,2956
4719,1,512,512,512.00,0.00,2955,2956
4720,1,512,512,512.00,0.00,2955,2956
4721,2,413,99,256.00,24649.00,2955,2957
4722,1,512,512,512.00,0.00,2956,2957
4723,1,512,512,512.00,0.00,2956,2957
4724,2,333,179,256.00,5929.00,2956,2958
4725,1,512,512,512.00,0.00,2957,2958
4726,1,512,512,512.00,0.00,2957,2958
4727,1,512,512,512.00,0.00,2957,2958
4728,2,428,84,256.00,29584.00,2957,2959
4729,1,512,512,512.00,0.00,2958,2959
4730,1,512,512,512.00,0.00,2958,2959
4731,1,512,512,512.00,0.00,2958,2959
4732,1,512,512,512.00,0.00,2958,2959
4733,1,512,512,512.00,0.00,2958,2959
4734,2,266,246,256.00,100.00,2958,2960
4735,1,512,512,512.00,0.00,2959,2960
4736,1,512,512,512.00,0.00,2959,2960
4737,2,414,98,256.00,24964.00,2959,2961
4738,1,512,512,512.00,0.00,2960,2961
4739,1,512,512,512.00,0.00,2960,2961
4740,1,512,512,512.00,0.00,2960,2961
4741,1,512,512,512.00,0.00,2960,2961
4742,2,482,30,256.00,51076.00,2960,2962
4743,1,512,512,512.00,0.00,2961,2962
4744,1,512,512,512.00,0.00,2961,2962
4745,1,512,512,512.00,0.00,2961,2962
4746,2,501,11,256.00,60025.00,2961,2963
4747,1,512,512,512.00,0.00,2962,2963
4748,1,512,512,512.00,0.00,2962,2963
4749,1,512,512,512.00,0.00,2962,2963
4750,3,454,9,170.67,40405.56,2962,2965
4751,1,512,512,512.00,0.00,2964,2965
4752,5,154,69,102.40,935.44,2964,2969
4753,1,512,512,512.00,0.00,2968,2969
4754,1,512,512,512.00,0.00,2968,2969
4755,2,499,13,256.00,59049.00,2968,2970
4756,1,512,512,512.00,0.00,2969,2970
4757,1,512,512,512.00,0.00,2969,2970
4758,1,512,512,512.00,0.00,2969,2970
4759,2,468,44,256.00,44944.00,2969,2971
4760,2,381,131,256.00,15625.00,2970,2972
4761,2,392,120,256.00,18496.00,2971,2973
4762,2,457,55,256.00,40401.00,2972,2974
4763,1,512,512,512.00,0.00,2973,2974
4764,1,512,512,512.00,0.00,2973,2974
4765,2,296,216,256.00,1600.00,2973,2975
4766,2,385,127,256.00,16641.00,2974,2976
4767,3,445,4,170.67,38209.56,2975,2978
4768,1,512,512,512.00,0.00,2977,2978
4769,2,277,235,256.00,441.00,2977,2979
4770,1,512,512,512.00,0.00,2978,2979
4771,1,512,512,512.00,0.00,2978,2979
4772,1,512,512,512.00,0.00,2978,2979
4773,1,512,512,512.00,0.00,2978,2979
4774,2,404,108,256.00,21904.00,2978,2980
4775,1,512,512,512.00,0.00,2979,2980
4776,1,512,512,512.00,0.00,2979,2980
4777,3,300,101,170.67,8380.22,2979,2982
4778,1,512,512,512.00,0.00,2981,2982
4779,7,201,6,73.14,4418.69,2981,2988
4780,2,435,77,256.00,32041.00,2987,2989
4781,1,512,512,512.00,0.00,2988,2989
4782,7,272,19,73.14,7066.98,2988,2995
4783,8,181,2,64.00,4554.25,2994,3002
4784,3,471,10,170.67,45173.56,3001,3004
4785,1,512,512,512.00,0.00,3003,3004
4786,1,512,512,512.00,0.00,3003,3004
4787,1,512,512,512.00,0.00,3003,3004
4788,1,512,512,512.00,0.00,3003,3004
4789,1,512,512,512.00,0.00,3003,3004
4790,1,512,512,512.00,0.00,3003,3004
4791,3,377,45,170.67,21624.22,3003,3006
4792,1,512,512,512.00,0.00,3005,3006
4793,2,341,171,256.00,7225.00,3005,3007
4794,3,337,2,170.67,18706.89,3006,3009
4795,1,512,512,512.00,0.00,3008,3009
4796,2,381,131,256.00,15625.00,3008,3010
4797,7,215,3,73.14,5712.41,3009,3016
4798,1,512,512,512.00,0.00,3015,3016
4799,1,512,512,512.00,0.00,3015,3016
4800,2,409,103,256.00,23409.00,3015,3017
4801,1,512,512,512.00,0.00,3016,3017
4802,1,512,512,512.00,0.00,3016,3017
4803,1,512,512,512.00,0.00,3016,3017
4804,3,364,65,170.67,18742.89,3016,3019
4805,1,512,512,512.00,0.00,3018,3019
4806,1,512,512,512.00,0.00,3018,3019
4807,2,376,136,256.00,14400.00,3018,3020
4808,1,512,512,512.00,0.00,3019,3020
4809,2,430,82,256.00,30276.00,3019,3021
4810,3,392,39,170.67,24788.22,3020,3023
4811,1,512,512,512.00,0.00,3022,3023
4812,2,383,129,256.00,16129.00,3022,3024
4813,1,512,512,512.00,0.00,3023,3024
4814,1,512,512,512.00,0.00,3023,3024
4815,1,512,512,512.00,0.00,3023,3024
4816,3,434,4,170.67,35488.89,3023,3026
4817,4,401,11,128.00,25546.50,3025,3029
4818,3,274,107,170.67,5434.89,3028,3031
4819,1,512,512,512.00,0.00,3030,3031
4820,1,512,512,512.00,0.00,3030,3031
4821,2,281,231,256.00,625.00,3030,3032
4822,1,512,512,512.00,0.00,3031,3032
4823,2,472,40,256.00,46656.00,3031,3033
4824,3,483,8,170.67,48804.22,3032,3035
4825,1,512,512,512.00,0.00,3034,3035
4826,1,512,512,512.00,0.00,3034,3035
4827,1,512,512,512.00,0.00,3034,3035
4828,2,374,138,256.00,13924.00,3034,3036
4829,4,288,36,128.00,9094.50,3035,3039
4830,1,512,512,512.00,0.00,3038,3039
4831,1,512,512,512.00,0.00,3038,3039
4832,3,336,3,170.67,18484.22,3038,3041
4833,2,398,114,256.00,20164.00,3040,3042
4834,10,148,2,51.20,1993.96,3041,3051
4835,1,512,512,512.00,0.00,3050,3051
4836,1,512,512,512.00,0.00,3050,3051
4837,1,512,512,512.00,0.00,3050,3051
4838,1,512,512,512.00,0.00,3050,3051
4839,1,512,512,512.00,0.00,3050,3051
4840,3,385,8,170.67,25022.89,3050,3053
4841,1,512,512,512.00,0.00,3052,3053
4842,2,501,11,256.00,60025.00,3052,3054
4843,1,512,512,512.00,0.00,3053,3054
4844,1,512,512,512.00,0.00,3053,3054
4845,2,357,155,256.00,10201.00,3053,3055
4846,4,446,4,128.00,34167.50,3054,3058
4847,2,364,148,256.00,11664.00,3057,3059
4848,4,227,24,128.00,6192.50,3058,3062
4849,1,512,512,512.00,0.00,3061,3062
4850,1,512,512,512.00,0.00,3061,3062
4851,2,405,107,256.00,22201.00,3061,3063
4852,2,424,88,256.00,28224.00,3062,3064
4853,6,168,24,85.33,3019.22,3063,3069
4854,3,373,67,170.67,20473.56,3068,3071
4855,1,512,512,512.00,0.00,3070,3071
4856,1,512,512,512.00,0.00,3070,3071
4857,6,304,15,85.33,11054.56,3070,3076
4858,1,512,512,512.00,0.00,3075,3076
4859,11,217,2,46.55,3774.79,3075,3086
4860,1,512,512,512.00,0.00,3085,3086
4861,1,512,512,512.00,0.00,3085,3086
4862,1,512,512,512.00,0.00,3085,3086
4863,1,512,512,512.00,0.00,3085,3086
4864,2,339,173,256.00,6889.00,3085,3087
4865,1,512,512,512.00,0.00,3086,3087
4866,1,512,512,512.00,0.00,3086,3087
4867,2,299,213,256.00,1849.00,3086,3088
4868,1,512,512,512.00,0.00,3087,3088
4869,1,512,512,512.00,0.00,3087,3088
4870,1,512,512,512.00,0.00,3087,3088
4871,3,272,106,170.67,5264.89,3087,3090
4872,4,344,21,128.00,16914.50,3089,3093
4873,1,512,512,512.00,0.00,3092,3093
4874,2,344,168,256.00,7744.00,3092,3094
4875,2,421,91,256.00,27225.00,3093,3095
4876,1,512,512,512.00,0.00,3094,3095
4877,1,512,512,512.00,0.00,3094,3095
4878,2,417,95,256.00,25921.00,3094,3096
4879,2,418,94,256.00,26244.00,3095,3097
4880,1,512,512,512.00,0.00,3096,3097
4881,1,512,512,512.00,0.00,3096,3097
4882,1,512,512,512.00,0.00,3096,3097
4883,3,314,34,170.67,13088.89,3096,3099
4884,4,252,6,128.00,9487.50,3098,3102
4885,2,447,65,256.00,36481.00,3101,3103
4886,5,167,51,102.40,2128.24,3102,3107
4887,5,302,6,102.40,14186.24,3106,3111
4888,1,512,512,512.00,0.00,3110,3111
4889,4,365,1,128.00,19599.50,3110,3114
4890,1,512,512,512.00,0.00,3113,3114
4891,2,284,228,256.00,784.00,3113,3115
4892,5,240,1,102.40,6747.04,3114,3119
4893,2,314,198,256.00,3364.00,3118,3120
4894,3,459,8,170.67,41796.22,3119,3122
4895,1,512,512,512.00,0.00,3121,3122
4896,1,512,512,512.00,0.00,3121,3122
4897,1,512,512,512.00,0.00,3121,3122
4898,3,301,3,170.67,15497.56,3121,3124
4899,3,229,108,170.67,2449.56,3123,3126
4900,1,512,512,512.00,0.00,3125,3126
4901,2,387,125,256.00,17161.00,3125,3127
4902,1,512,512,512.00,0.00,3126,3127
4903,5,286,1,102.40,10805.44,3126,3131
4904,2,439,73,256.00,33489.00,3130,3132
4905,1,512,512,512.00,0.00,3131,3132
4906,2,496,16,256.00,57600.00,3131,3133
4907,2,359,153,256.00,10609.00,3132,3134
4908,2,310,202,256.00,2916.00,3133,3135
4909,2,501,11,256.00,60025.00,3134,3136
4910,7,276,2,73.14,8445.27,3135,3142
4911,2,339,173,256.00,6889.00,3141,3143
4912,1,512,512,512.00,0.00,3142,3143
4913,2,499,13,256.00,59049.00,3142,3144
4914,10,188,1,51.20,2937.36,3143,3153
4915,6,255,2,85.33,9715.89,3152,3158
4916,1,512,512,512.00,0.00,3157,3158
4917,2,473,39,256.00,47089.00,3157,3159
4918,1,512,512,512.00,0.00,3158,3159
4919,4,200,78,128.00,1983.50,3158,3162
4920,2,507,5,256.00,63001.00,3161,3163
4921,1,512,512,512.00,0.00,3162,3163
4922,1,512,512,512.00,0.00,3162,3163
4923,5,235,37,102.40,6048.64,3162,3167
4924,1,512,512,512.00,0.00,3166,3167
4925,1,512,512,512.00,0.00,3166,3167
4926,1,512,512,512.00,0.00,3166,3167
4927,2,459,53,256.00,41209.00,3166,3168
4928,2,408,104,256.00,23104.00,3167,3169
4929,2,445,67,256.00,35721.00,3168,3170
4930,2,491,21,256.00,55225.00,3169,3171
4931,4,414,1,128.00,28019.50,3170,3174
4932,5,320,1,102.40,13614.64,3173,3178
4933,4,202,85,128.00,2087.50,3177,3181
4934,2,279,233,256.00,529.00,3180,3182
4935,8,153,1,64.00,3148.00,3181,3189
4936,1,512,512,512.00,0.00,3188,3189
4937,2,467,45,256.00,44521.00,3188,3190
4938,6,472,1,85.33,29933.22,3189,3195
4939,1,512,512,512.00,0.00,3194,3195
4940,1,512,512,512.00,0.00,3194,3195
4941,1,512,512,512.00,0.00,3194,3195
4942,1,512,512,512.00,0.00,3194,3195
4943,1,512,512,512.00,0.00,3194,3195
4944,2,449,63,256.00,37249.00,3194,3196
4945,3,463,3,170.67,43037.56,3195,3198
4946,3,462,3,170.67,42760.22,3197,3200
4947,8,255,1,64.00,6187.50,3199,3207
4948,3,261,43,170.67,8617.56,3206,3209
4949,1,512,512,512.00,0.00,3208,3209
4950,1,512,512,512.00,0.00,3208,3209
4951,2,413,99,256.00,24649.00,3208,3210
4952,2,414,98,256.00,24964.00,3209,3211
4953,1,512,512,512.00,0.00,3210,3211
4954,2,510,2,256.00,64516.00,3210,3212
4955,1,512,512,512.00,0.00,3211,3212
4956,1,512,512,512.00,0.00,3211,3212
4957,1,512,512,512.00,0.00,3211,3212
4958,3,373,1,170.67,23597.56,3211,3214
4959,1,512,512,512.00,0.00,3213,3214
4960,1,512,512,512.00,0.00,3213,3214
4961,1,512,512,512.00,0.00,3213,3214
4962,2,341,171,256.00,7225.00,3213,3215
4963,1,512,512,512.00,0.00,3214,3215
4964,1,512,512,512.00,0.00,3214,3215
4965,1,512,512,512.00,0.00,3214,3215
4966,2,257,255,256.00,1.00,3214,3216
4967,2,410,102,256.00,23716.00,3215,3217
4968,1,512,512,512.00,0.00,3216,3217
4969,1,512,512,512.00,0.00,3216,3217
4970,2,412,100,256.00,24336.00,3216,3218
4971,2,467,45,256.00,44521.00,3217,3219
4972,3,360,32,170.67,19214.22,3218,3221
4973,2,351,161,256.00,9025.00,3220,3222
4974,1,512,512,512.00,0.00,3221,3222
4975,1,512,512,512.00,0.00,3221,3222
4976,1,512,512,512.00,0.00,3221,3222
4977,2,449,63,256.00,37249.00,3221,3223
4978,1,512,512,512.00,0.00,3222,3223
4979,1,512,512,512.00,0.00,3222,3223
4980,1,512,512,512.00,0.00,3222,3223
4981,1,512,512,512.00,0.00,3222,3223
4982,7,159,12,73.14,2398.41,3222,3229
4983,5,301,3,102.40,14536.64,3228,3233
4984,2,483,29,256.00,51529.00,3232,3234
4985,1,512,512,512.00,0.00,3233,3234
4986,2,262,250,256.00,36.00,3233,3235
4987,2,295,217,256.00,1521.00,3234,3236
4988,1,512,512,512.00,0.00,3235,3236
4989,1,512,512,512.00,0.00,3235,3236
4990,3,257,67,170.67,6166.89,3235,3238
4991,2,353,159,256.00,9409.00,3237,3239
4992,7,288,2,73.14,10084.69,3238,3245
4993,1,512,512,512.00,0.00,3244,3245
4994,1,512,512,512.00,0.00,3244,3245
4995,2,365,147,256.00,11881.00,3244,3246
4996,1,512,512,512.00,0.00,3245,3246
4997,1,512,512,512.00,0.00,3245,3246
4998,3,241,35,170.67,9206.89,3245,3248
4999,1,512,512,512.00,0.00,3247,3248
5000,1,512,512,512.00,0.00,3247,3248
5001,2,409,103,256.00,23409.00,3247,3249
5002,1,512,512,512.00,0.00,3248,3249
5003,1,512,512,512.00,0.00,3248,3249
5004,3,468,7,170.67,44353.56,3248,3251
5005,1,512,512,512.00,0.00,3250,3251
5006,3,377,1,170.67,24234.89,3250,3253
5007,2,510,2,256.00,64516.00,3252,3254
5008,1,512,512,512.00,0.00,3253,3254
5009,3,223,66,170.67,5477.56,3253,3256
5010,5,262,2,102.40,8855.04,3255,3260
5011,5,328,22,102.40,13631.04,3259,3264
5012,1,512,512,512.00,0.00,3263,3264
5013,1,512,512,512.00,0.00,3263,3264
5014,1,512,512,512.00,0.00,3263,3264
5015,6,271,4,85.33,9802.89,3263,3269
5016,1,512,512,512.00,0.00,3268,3269
5017,1,512,512,512.00,0.00,3268,3269
5018,1,512,512,512.00,0.00,3268,3269
5019,2,341,171,256.00,7225.00,3268,3270
5020,1,512,512,512.00,0.00,3269,3270
5021,1,512,512,512.00,0.00,3269,3270
5022,1,512,512,512.00,0.00,3269,3270
5023,1,512,512,512.00,0.00,3269,3270
5024,4,319,1,128.00,17989.00,3269,3273
5025,1,512,512,512.00,0.00,3272,3273
5026,1,512,512,512.00,0.00,3272,3273
5027,1,512,512,512.00,0.00,3272,3273
5028,3,414,31,170.67,29821.56,3272,3275
5029,1,512,512,512.00,0.00,3274,3275
5030,2,343,169,256.00,7569.00,3274,3276
5031,1,512,512,512.00,0.00,3275,3276
5032,3,375,26,170.67,22080.22,3275,3278
5033,2,275,237,256.00,361.00,3277,3279
5034,2,328,184,256.00,5184.00,3278,3280
5035,1,512,512,512.00,0.00,3279,3280
5036,2,277,235,256.00,441.00,3279,3281
5037,1,512,512,512.00,0.00,3280,3281
5038,1,512,512,512.00,0.00,3280,3281
5039,2,432,80,256.00,30976.00,3280,3282
5040,1,512,512,512.00,0.00,3281,3282
5041,1,512,512,512.00,0.00,3281,3282
5042,2,510,2,256.00,64516.00,3281,3283
5043,2,309,203,256.00,2809.00,3282,3284
5044,1,512,512,512.00,0.00,3283,3284
5045,1,512,512,512.00,0.00,3283,3284
5046,2,428,84,256.00,29584.00,3283,3285
5047,4,300,16,128.00,12664.00,3284,3288
5048,1,512,512,512.00,0.00,3287,3288
5049,2,384,128,256.00,16384.00,3287,3289
5050,2,313,199,256.00,3249.00,3288,3290
5051,2,448,64,256.00,36864.00,3289,3291
5052,1,512,512,512.00,0.00,3290,3291
5053,1,512,512,512.00,0.00,3290,3291
5054,1,512,512,512.00,0.00,3290,3291
5055,2,429,83,256.00,29929.00,3290,3292
5056,2,349,163,256.00,8649.00,3291,3293
5057,1,512,512,512.00,0.00,3292,3293
5058,1,512,512,512.00,0.00,3292,3293
5059,1,512,512,512.00,0.00,3292,3293
5060,2,492,20,256.00,55696.00,3292,3294
5061,1,512,512,512.00,0.00,3293,3294
5062,1,512,512,512.00,0.00,3293,3294
5063,4,218,1,128.00,7356.50,3293,3297
5064,2,280,232,256.00,576.00,3296,3298
5065,1,512,512,512.00,0.00,3297,3298
5066,3,299,34,170.67,11738.89,3297,3300
5067,1,512,512,512.00,0.00,3299,3300
5068,1,512,512,512.00,0.00,3299,3300
5069,1,512,512,512.00,0.00,3299,3300
5070,1,512,512,512.00,0.00,3299,3300
5071,2,443,69,256.00,34969.00,3299,3301
5072,6,420,3,85.33,22768.56,3300,3306
5073,2,502,10,256.00,60516.00,3305,3307
5074,4,386,35,128.00,22212.50,3306,3310
5075,1,512,512,512.00,0.00,3309,3310
5076,1,512,512,512.00,0.00,3309,3310
5077,5,312,2,102.40,12585.04,3309,3314
5078,1,512,512,512.00,0.00,3313,3314
5079,1,512,512,512.00,0.00,3313,3314
5080,3,466,18,170.67,43627.56,3313,3316
5081,3,461,20,170.67,42166.89,3315,3318
5082,1,512,512,512.00,0.00,3317,3318
5083,5,386,1,102.40,21068.24,3317,3322
5084,2,483,29,256.00,51529.00,3321,3323
5085,4,206,76,128.00,2289.50,3322,3326
5086,6,189,7,85.33,5291.56,3325,3331
5087,3,492,3,170.67,51660.22,3330,3333
5088,1,512,512,512.00,0.00,3332,3333
5089,4,456,3,128.00,36184.50,3332,3336
5090,2,502,10,256.00,60516.00,3335,3337
5091,1,512,512,512.00,0.00,3336,3337
5092,9,317,4,56.89,8912.77,3336,3345
5093,1,512,512,512.00,0.00,3344,3345
5094,3,368,11,170.67,21950.89,3344,3347
5095,9,221,1,56.89,4483.43,3346,3355
5096,1,512,512,512.00,0.00,3354,3355
5097,1,512,512,512.00,0.00,3354,3355
5098,1,512,512,512.00,0.00,3354,3355
5099,1,512,512,512.00,0.00,3354,3355
5100,2,269,243,256.00,169.00,3354,3356
5101,1,512,512,512.00,0.00,3355,3356
5102,2,339,173,256.00,6889.00,3355,3357
5103,2,477,35,256.00,48841.00,3356,3358
5104,2,425,87,256.00,28561.00,3357,3359
5105,1,512,512,512.00,0.00,3358,3359
5106,2,371,141,256.00,13225.00,3358,3360
5107,4,434,4,128.00,31905.50,3359,3363
5108,1,512,512,512.00,0.00,3362,3363
5109,1,512,512,512.00,0.00,3362,3363
5110,1,512,512,512.00,0.00,3362,3363
5111,2,459,53,256.00,41209.00,3362,3364
5112,1,512,512,512.00,0.00,3363,3364
5113,1,512,512,512.00,0.00,3363,3364
5114,1,512,512,512.00,0.00,3363,3364
5115,2,305,207,256.00,2401.00,3363,3365
5116,1,512,512,512.00,0.00,3364,3365
5117,3,363,8,170.67,21444.22,3364,3367
5118,1,512,512,512.00,0.00,3366,3367
5119,1,512,512,512.00,0.00,3366,3367
5120,2,414,98,256.00,24964.00,3366,3368
5121,1,512,512,512.00,0.00,3367,3368
5122,2,467,45,256.00,44521.00,3367,3369
5123,1,512,512,512.00,0.00,3368,3369
5124,2,299,213,256.00,1849.00,3368,3370
5125,4,248,43,128.00,6990.50,3369,3373
5126,5,185,16,102.40,3910.64,3372,3377
5127,5,249,15,102.40,8512.64,3376,3381
5128,1,512,512,512.00,0.00,3380,3381
5129,1,512,512,512.00,0.00,3380,3381
5130,1,512,512,512.00,0.00,3380,3381
5131,2,431,81,256.00,30625.00,3380,3382
5132,2,349,163,256.00,8649.00,3381,3383
5133,4,438,3,128.00,32237.50,3382,3386
5134,4,353,20,128.00,17361.50,3385,3389
5135,2,505,7,256.00,62001.00,3388,3390
5136,1,512,512,512.00,0.00,3389,3390
5137,1,512,512,512.00,0.00,3389,3390
5138,2,283,229,256.00,729.00,3389,3391
5139,1,512,512,512.00,0.00,3390,3391
5140,2,313,199,256.00,3249.00,3390,3392
5141,5,389,2,102.40,21020.24,3391,3396
5142,7,252,3,73.14,8251.84,3395,3402
5143,2,371,141,256.00,13225.00,3401,3403
5144,2,405,107,256.00,22201.00,3402,3404
5145,1,512,512,512.00,0.00,3403,3404
5146,1,512,512,512.00,0.00,3403,3404
5147,1,512,512,512.00,0.00,3403,3404
5148,2,427,85,256.00,29241.00,3403,3405
5149,2,460,52,256.00,41616.00,3404,3406
5150,6,191,4,85.33,4140.56,3405,3411
5151,7,195,2,73.14,6156.41,3410,3417
5152,1,512,512,512.00,0.00,3416,3417
5153,1,512,512,512.00,0.00,3416,3417
5154,2,468,44,256.00,44944.00,3416,3418
5155,1,512,512,512.00,0.00,3417,3418
5156,1,512,512,512.00,0.00,3417,3418
5157,2,508,4,256.00,63504.00,3417,3419
5158,1,512,512,512.00,0.00,3418,3419
5159,3,402,3,170.67,28560.22,3418,3421
5160,4,221,32,128.00,6882.50,3420,3424
5161,1,512,512,512.00,0.00,3423,3424
5162,2,345,167,256.00,7921.00,3423,3425
5163,1,512,512,512.00,0.00,3424,3425
5164,1,512,512,512.00,0.00,3424,3425
5165,4,256,17,128.00,7212.50,3424,3428
5166,4,295,40,128.00,10354.50,3427,3431
5167,2,490,22,256.00,54756.00,3430,3432
5168,1,512,512,512.00,0.00,3431,3432
5169,2,383,129,256.00,16129.00,3431,3433
5170,1,512,512,512.00,0.00,3432,3433
5171,4,366,1,128.00,19943.50,3432,3436
5172,1,512,512,512.00,0.00,3435,3436
5173,2,472,40,256.00,46656.00,3435,3437
5174,3,258,63,170.67,6544.22,3436,3439
5175,2,423,89,256.00,27889.00,3438,3440
5176,2,406,106,256.00,22500.00,3439,3441
5177,2,416,96,256.00,25600.00,3440,3442
5178,3,196,148,170.67,387.56,3441,3444
5179,5,224,9,102.40,5945.84,3443,3448
5180,1,512,512,512.00,0.00,3447,3448
5181,6,171,37,85.33,1916.56,3447,3453
5182,1,512,512,512.00,0.00,3452,3453
5183,1,512,512,512.00,0.00,3452,3453
5184,1,512,512,512.00,0.00,3452,3453
5185,1,512,512,512.00,0.00,3452,3453
5186,3,267,2,170.67,14320.22,3452,3455
5187,7,208,10,73.14,4286.98,3454,3461
5188,2,473,39,256.00,47089.00,3460,3462
5189,5,331,9,102.40,14068.24,3461,3466
5190,4,368,6,128.00,20966.00,3465,3469
5191,3,289,35,170.67,10902.89,3468,3471
5192,1,512,512,512.00,0.00,3470,3471
5193,6,181,26,85.33,3059.22,3470,3476
5194,5,396,1,102.40,21937.04,3475,3480
5195,3,435,3,170.67,35776.22,3479,3482
5196,2,458,54,256.00,40804.00,3481,3483
5197,2,373,139,256.00,13689.00,3482,3484
5198,3,253,47,170.67,7926.89,3483,3486
5199,2,401,111,256.00,21025.00,3485,3487
5200,1,512,512,512.00,0.00,3486,3487
5201,7,183,11,73.14,2765.55,3486,3493
5202,1,512,512,512.00,0.00,3492,3493
5203,2,395,117,256.00,19321.00,3492,3494
5204,3,280,46,170.67,9243.56,3493,3496
5205,1,512,512,512.00,0.00,3495,3496
5206,2,393,119,256.00,18769.00,3495,3497
5207,1,512,512,512.00,0.00,3496,3497
5208,5,365,2,102.40,18675.84,3496,3501
5209,4,436,2,128.00,31987.50,3500,3504
5210,2,473,39,256.00,47089.00,3503,3505
5211,2,458,54,256.00,40804.00,3504,3506
5212,2,308,204,256.00,2704.00,3505,3507
5213,1,512,512,512.00,0.00,3506,3507
5214,3,353,55,170.67,17022.89,3506,3509
5215,2,432,80,256.00,30976.00,3508,3510
5216,2,387,125,256.00,17161.00,3509,3511
5217,1,512,512,512.00,0.00,3510,3511
5218,1,512,512,512.00,0.00,3510,3511
5219,1,512,512,512.00,0.00,3510,3511
5220,5,244,18,102.40,5657.04,3510,3515
5221,3,456,2,170.67,41158.22,3514,3517
5222,1,512,512,512.00,0.00,3516,3517
5223,2,399,113,256.00,20449.00,3516,3518
5224,6,293,9,85.33,9895.22,3517,3523
5225,2,443,69,256.00,34969.00,3522,3524
5226,1,512,512,512.00,0.00,3523,3524
5227,1,512,512,512.00,0.00,3523,3524
5228,1,512,512,512.00,0.00,3523,3524
5229,2,341,171,256.00,7225.00,3523,3525
5230,3,256,74,170.67,5584.89,3524,3527
5231,10,194,1,51.20,3792.56,3526,3536
5232,10,281,1,51.20,6415.36,3535,3545
5233,3,387,14,170.67,24968.22,3544,3547
5234,2,318,194,256.00,3844.00,3546,3548
5235,1,512,512,512.00,0.00,3547,3548
5236,1,512,512,512.00,0.00,3547,3548
5237,5,122,71,102.40,329.04,3547,3552
5238,2,328,184,256.00,5184.00,3551,3553
5239,1,512,512,512.00,0.00,3552,3553
5240,1,512,512,512.00,0.00,3552,3553
5241,3,383,15,170.67,24176.22,3552,3555
5242,3,323,2,170.67,17306.89,3554,3557
5243,2,324,188,256.00,4624.00,3556,3558
5244,2,419,93,256.00,26569.00,3557,3559
5245,1,512,512,512.00,0.00,3558,3559
5246,2,427,85,256.00,29241.00,3558,3560
5247,1,512,512,512.00,0.00,3559,3560
5248,1,512,512,512.00,0.00,3559,3560
5249,1,512,512,512.00,0.00,3559,3560
5250,1,512,512,512.00,0.00,3559,3560
5251,3,268,66,170.67,6827.56,3559,3562
5252,1,512,512,512.00,0.00,3561,3562
5253,2,474,38,256.00,47524.00,3561,3563
5254,1,512,512,512.00,0.00,3562,3563
5255,2,459,53,256.00,41209.00,3562,3564
5256,2,478,34,256.00,49284.00,3563,3565
5257,1,512,512,512.00,0.00,3564,3565
5258,2,505,7,256.00,62001.00,3564,3566
5259,2,424,88,256.00,28224.00,3565,3567
5260,1,512,512,512.00,0.00,3566,3567
5261,2,292,220,256.00,1296.00,3566,3568
5262,2,450,62,256.00,37636.00,3567,3569
5263,1,512,512,512.00,0.00,3568,3569
5264,1,512,512,512.00,0.00,3568,3569
5265,2,355,157,256.00,9801.00,3568,3570
5266,1,512,512,512.00,0.00,3569,3570
5267,1,512,512,512.00,0.00,3569,3570
5268,2,272,240,256.00,256.00,3569,3571
5269,1,512,512,512.00,0.00,3570,3571
5270,2,366,146,256.00,12100.00,3570,3572
5271,4,304,3,128.00,12641.50,3571,3575
5272,2,482,30,256.00,51076.00,3574,3576
5273,1,512,512,512.00,0.00,3575,3576
5274,1,512,512,512.00,0.00,3575,3576
5275,1,512,512,512.00,0.00,3575,3576
5276,1,512,512,512.00,0.00,3575,3576
5277,3,203,138,170.67,704.22,3575,3578
5278,2,508,4,256.00,63504.00,3577,3579
5279,7,225,10,73.14,5372.41,3578,3585
5280,2,307,205,256.00,2601.00,3584,3586
5281,1,512,512,512.00,0.00,3585,3586
5282,1,512,512,512.00,0.00,3585,3586
5283,5,173,9,102.40,2937.44,3585,3590
5284,1,512,512,512.00,0.00,3589,3590
5285,1,512,512,512.00,0.00,3589,3590
5286,1,512,512,512.00,0.00,3589,3590
5287,3,317,70,170.67,11210.89,3589,3592
5288,9,182,2,56.89,2924.77,3591,3600
5289,1,512,512,512.00,0.00,3599,3600
5290,2,423,89,256.00,27889.00,3599,3601
5291,2,376,136,256.00,14400.00,3600,3602
5292,5,330,5,102.40,13642.64,3601,3606
5293,1,512,512,512.00,0.00,3605,3606
5294,1,512,512,512.00,0.00,3605,3606
5295,1,512,512,512.00,0.00,3605,3606
5296,4,450,7,128.00,34632.50,3605,3609
5297,1,512,512,512.00,0.00,3608,3609
5298,4,371,1,128.00,21401.00,3608,3612
5299,6,181,26,85.33,3631.89,3611,3617
5300,1,512,512,512.00,0.00,3616,3617
5301,4,326,38,128.00,13284.50,3616,3620
5302,2,441,71,256.00,34225.00,3619,3621
5303,3,476,17,170.67,46614.89,3620,3623
5304,9,228,4,56.89,4601.43,3622,3631
5305,4,396,23,128.00,24036.50,3630,3634
5306,4,416,1,128.00,28749.50,3633,3637
5307,1,512,512,512.00,0.00,3636,3637
5308,2,290,222,256.00,1156.00,3636,3638
5309,1,512,512,512.00,0.00,3637,3638
5310,2,307,205,256.00,2601.00,3637,3639
5311,3,192,150,170.67,294.22,3638,3641
5312,1,512,512,512.00,0.00,3640,3641
5313,1,512,512,512.00,0.00,3640,3641
5314,1,512,512,512.00,0.00,3640,3641
5315,2,480,32,256.00,50176.00,3640,3642
5316,4,201,12,128.00,5707.50,3641,3645
5317,2,301,211,256.00,2025.00,3644,3646
5318,1,512,512,512.00,0.00,3645,3646
5319,2,502,10,256.00,60516.00,3645,3647
5320,1,512,512,512.00,0.00,3646,3647
5321,1,512,512,512.00,0.00,3646,3647
5322,1,512,512,512.00,0.00,3646,3647
5323,2,303,209,256.00,2209.00,3646,3648
5324,2,431,81,256.00,30625.00,3647,3649
5325,1,512,512,512.00,0.00,3648,3649
5326,2,419,93,256.00,26569.00,3648,3650
5327,1,512,512,512.00,0.00,3649,3650
5328,1,512,512,512.00,0.00,3649,3650
5329,2,466,46,256.00,44100.00,3649,3651
5330,2,380,132,256.00,15376.00,3650,3652
5331,1,512,512,512.00,0.00,3651,3652
5332,1,512,512,512.00,0.00,3651,3652
5333,1,512,512,512.00,0.00,3651,3652
5334,1,512,512,512.00,0.00,3651,3652
5335,2,267,245,256.00,121.00,3651,3653
5336,1,512,512,512.00,0.00,3652,3653
5337,1,512,512,512.00,0.00,3652,3653
5338,1,512,512,512.00,0.00,3652,3653
5339,2,422,90,256.00,27556.00,3652,3654
5340,2,306,206,256.00,2500.00,3653,3655
5341,1,512,512,512.00,0.00,3654,3655
5342,1,512,512,512.00,0.00,3654,3655
5343,1,512,512,512.00,0.00,3654,3655
5344,1,512,512,512.00,0.00,3654,3655
5345,1,512,512,512.00,0.00,3654,3655
5346,3,304,54,170.67,10555.56,3654,3657
5347,2,476,36,256.00,48400.00,3656,3658
5348,1,512,512,512.00,0.00,3657,3658
5349,1,512,512,512.00,0.00,3657,3658
5350,1,512,512,512.00,0.00,3657,3658
5351,3,342,4,170.67,19051.56,3657,3660
5352,1,512,512,512.00,0.00,3659,3660
5353,1,512,512,512.00,0.00,3659,3660
5354,2,501,11,256.00,60025.00,3659,3661
5355,2,396,116,256.00,19600.00,3660,3662
5356,1,512,512,512.00,0.00,3661,3662
5357,1,512,512,512.00,0.00,3661,3662
5358,4,268,3,128.00,9962.50,3661,3665
5359,1,512,512,512.00,0.00,3664,3665
5360,1,512,512,512.00,0.00,3664,3665
5361,1,512,512,512.00,0.00,3664,3665
5362,1,512,512,512.00,0.00,3664,3665
5363,3,469,17,170.67,44514.89,3664,3667
5364,2,333,179,256.00,5929.00,3666,3668
5365,1,512,512,512.00,0.00,3667,3668
5366,1,512,512,512.00,0.00,3667,3668
5367,2,277,235,256.00,441.00,3667,3669
5368,1,512,512,512.00,0.00,3668,3669
5369,2,314,198,256.00,3364.00,3668,3670
5370,1,512,512,512.00,0.00,3669,3670
5371,1,512,512,512.00,0.00,3669,3670
5372,3,249,20,170.67,11356.22,3669,3672
5373,1,512,512,512.00,0.00,3671,3672
5374,2,273,239,256.00,289.00,3671,3673
5375,1,512,512,512.00,0.00,3672,3673
5376,3,370,61,170.67,19933.56,3672,3675
5377,2,356,156,256.00,10000.00,3674,3676
5378,1,512,512,512.00,0.00,3675,3676
5379,1,512,512,512.00,0.00,3675,3676
5380,1,512,512,512.00,0.00,3675,3676
5381,1,512,512,512.00,0.00,3675,3676
5382,6,294,2,85.33,9781.56,3675,3681
5383,1,512,512,512.00,0.00,3680,3681
5384,2,275,237,256.00,361.00,3680,3682
5385,1,512,512,512.00,0.00,3681,3682
5386,1,512,512,512.00,0.00,3681,3682
5387,1,512,512,512.00,0.00,3681,3682
5388,2,328,184,256.00,5184.00,3681,3683
5389,3,451,29,170.67,39294.89,3682,3685
5390,2,328,184,256.00,5184.00,3684,3686
5391,1,512,512,512.00,0.00,3685,3686
5392,3,187,149,170.67,254.89,3685,3688
5393,4,405,1,128.00,26951.50,3687,3691
5394,4,185,96,128.00,1336.50,3690,3694
5395,7,187,3,73.14,3747.27,3693,3700
5396,4,463,4,128.00,37618.50,3699,3703
5397,5,301,3,102.40,10983.04,3702,3707
5398,5,328,2,102.40,13268.24,3706,3711
5399,1,512,512,512.00,0.00,3710,3711
5400,2,367,145,256.00,12321.00,3710,3712
5401,1,512,512,512.00,0.00,3711,3712
5402,1,512,512,512.00,0.00,3711,3712
5403,1,512,512,512.00,0.00,3711,3712
5404,1,512,512,512.00,0.00,3711,3712
5405,2,420,92,256.00,26896.00,3711,3713
5406,3,350,43,170.67,17042.89,3712,3715
5407,6,130,2,85.33,2119.56,3714,3720
5408,1,512,512,512.00,0.00,3719,3720
5409,6,273,2,85.33,8293.22,3719,3725
5410,1,512,512,512.00,0.00,3724,3725
5411,12,171,1,42.67,2743.72,3724,3736
5412,2,347,165,256.00,8281.00,3735,3737
5413,1,512,512,512.00,0.00,3736,3737
5414,3,263,6,170.67,13624.22,3736,3739
5415,4,231,38,128.00,6651.50,3738,3742
5416,2,500,12,256.00,59536.00,3741,3743
5417,1,512,512,512.00,0.00,3742,3743
5418,1,512,512,512.00,0.00,3742,3743
5419,1,512,512,512.00,0.00,3742,3743
5420,1,512,512,512.00,0.00,3742,3743
5421,1,512,512,512.00,0.00,3742,3743
5422,4,266,36,128.00,8066.00,3742,3746
5423,1,512,512,512.00,0.00,3745,3746
5424,1,512,512,512.00,0.00,3745,3746
5425,1,512,512,512.00,0.00,3745,3746
5426,2,339,173,256.00,6889.00,3745,3747
5427,1,512,512,512.00,0.00,3746,3747
5428,1,512,512,512.00,0.00,3746,3747
5429,1,512,512,512.00,0.00,3746,3747
5430,1,512,512,512.00,0.00,3746,3747
5431,5,288,20,102.40,10600.64,3746,3751
5432,1,512,512,512.00,0.00,3750,3751
5433,2,500,12,256.00,59536.00,3750,3752
5434,1,512,512,512.00,0.00,3751,3752
5435,1,512,512,512.00,0.00,3751,3752
5436,1,512,512,512.00,0.00,3751,3752
5437,4,230,32,128.00,6770.00,3751,3755
5438,1,512,512,512.00,0.00,3754,3755
5439,1,512,512,512.00,0.00,3754,3755
5440,1,512,512,512.00,0.00,3754,3755
5441,1,512,512,512.00,0.00,3754,3755
5442,2,294,218,256.00,1444.00,3754,3756
5443,1,512,512,512.00,0.00,3755,3756
5444,1,512,512,512.00,0.00,3755,3756
5445,1,512,512,512.00,0.00,3755,3756
5446,3,287,4,170.67,14614.89,3755,3758
5447,1,512,512,512.00,0.00,3757,3758
5448,1,512,512,512.00,0.00,3757,3758
5449,1,512,512,512.00,0.00,3757,3758
5450,1,512,512,512.00,0.00,3757,3758
5451,2,347,165,256.00,8281.00,3757,3759
5452,1,512,512,512.00,0.00,3758,3759
5453,3,382,54,170.67,22411.56,3758,3761
5454,1,512,512,512.00,0.00,3760,3761
5455,2,334,178,256.00,6084.00,3760,3762
5456,1,512,512,512.00,0.00,3761,3762
5457,2,341,171,256.00,7225.00,3761,3763
5458,2,307,205,256.00,2601.00,3762,3764
5459,1,512,512,512.00,0.00,3763,3764
5460,2,451,61,256.00,38025.00,3763,3765
5461,2,327,185,256.00,5041.00,3764,3766
5462,1,512,512,512.00,0.00,3765,3766
5463,2,452,60,256.00,38416.00,3765,3767
5464,1,512,512,512.00,0.00,3766,3767
5465,1,512,512,512.00,0.00,3766,3767
5466,3,266,5,170.67,13826.89,3766,3769
5467,2,393,119,256.00,18769.00,3768,3770
5468,1,512,512,512.00,0.00,3769,3770
5469,1,512,512,512.00,0.00,3769,3770
5470,7,285,3,73.14,8913.84,3769,3776
5471,1,512,512,512.00,0.00,3775,3776
5472,2,421,91,256.00,27225.00,3775,3777
5473,4,364,12,128.00,19106.00,3776,3780
5474,1,512,512,512.00,0.00,3779,3780
5475,1,512,512,512.00,0.00,3779,3780
5476,1,512,512,512.00,0.00,3779,3780
5477,1,512,512,512.00,0.00,3779,3780
5478,3,437,2,170.67,36306.89,3779,3782
5479,7,273,3,73.14,8046.69,3781,3788
5480,5,256,10,102.40,7627.44,3787,3792
5481,1,512,512,512.00,0.00,3791,3792
5482,1,512,512,512.00,0.00,3791,3792
5483,1,512,512,512.00,0.00,3791,3792
5484,2,323,189,256.00,4489.00,3791,3793
5485,1,512,512,512.00,0.00,3792,3793
5486,4,493,4,128.00,44413.50,3792,3796
5487,1,512,512,512.00,0.00,3795,3796
5488,2,436,76,256.00,32400.00,3795,3797
5489,1,512,512,512.00,0.00,3796,3797
5490,3,477,5,170.67,47024.22,3796,3799
5491,1,512,512,512.00,0.00,3798,3799
5492,1,512,512,512.00,0.00,3798,3799
5493,6,249,1,85.33,10427.56,3798,3804
5494,1,512,512,512.00,0.00,3803,3804
5495,1,512,512,512.00,0.00,3803,3804
5496,1,512,512,512.00,0.00,3803,3804
5497,1,512,512,512.00,0.00,3803,3804
5498,1,512,512,512.00,0.00,3803,3804
5499,13,222,1,39.38,3453.62,3803,3816
5500,4,378,2,128.00,21736.50,3815,3819
5501,1,512,512,512.00,0.00,3818,3819
5502,1,512,512,512.00,0.00,3818,3819
5503,3,434,6,170.67,35398.22,3818,3821
5504,2,325,187,256.00,4761.00,3821,3823
5505,1,512,512,512.00,0.00,3822,3823
5506,3,365,62,170.67,18970.89,3822,3825
5507,10,176,2,51.20,3840.56,3824,3834
5508,2,494,18,256.00,56644.00,3833,3835
5509,2,493,19,256.00,56169.00,3834,3836
5510,1,512,512,512.00,0.00,3835,3836
5511,1,512,512,512.00,0.00,3835,3836
5512,3,233,139,170.67,1942.89,3835,3838
5513,2,317,195,256.00,3721.00,3837,3839
5514,1,512,512,512.00,0.00,3838,3839
5515,1,512,512,512.00,0.00,3838,3839
5516,1,512,512,512.00,0.00,3838,3839
5517,2,382,130,256.00,15876.00,3838,3840
5518,1,512,512,512.00,0.00,3839,3840
5519,1,512,512,512.00,0.00,3839,3840
5520,1,512,512,512.00,0.00,3839,3840
5521,1,512,512,512.00,0.00,3839,3840
5522,2,378,134,256.00,14884.00,3839,3841
5523,3,435,2,170.67,35824.22,3841,3844
5524,1,512,512,512.00,0.00,3843,3844
5525,2,450,62,256.00,37636.00,3843,3845
5526,2,487,25,256.00,53361.00,3844,3846
5527,1,512,512,512.00,0.00,3845,3846
5528,1,512,512,512.00,0.00,3845,3846
5529,1,512,512,512.00,0.00,3845,3846
5530,2,261,251,256.00,25.00,3845,3847
5531,1,512,512,512.00,0.00,3846,3847
5532,1,512,512,512.00,0.00,3846,3847
5533,1,512,512,512.00,0.00,3846,3847
5534,1,512,512,512.00,0.00,3846,3847
5535,1,512,512,512.00,0.00,3846,3847
5536,2,366,146,256.00,12100.00,3846,3848
5537,2,443,69,256.00,34969.00,3847,3849
5538,1,512,512,512.00,0.00,3848,3849
5539,1,512,512,512.00,0.00,3848,3849
5540,2,267,245,256.00,121.00,3848,3850
5541,2,315,197,256.00,3481.00,3849,3851
5542,4,479,3,128.00,41141.00,3850,3854
5543,1,512,512,512.00,0.00,3853,3854
5544,2,269,243,256.00,169.00,3853,3855
5545,1,512,512,512.00,0.00,3854,3855
5546,1,512,512,512.00,0.00,3854,3855
5547,1,512,512,512.00,0.00,3854,3855
5548,2,393,119,256.00,18769.00,3854,3856
5549,1,512,512,512.00,0.00,3855,3856
5550,1,512,512,512.00,0.00,3855,3856
5551,2,382,130,256.00,15876.00,3855,3857
5552,1,512,512,512.00,0.00,3856,3857
5553,2,510,2,256.00,64516.00,3856,3858
5554,8,314,2,64.00,9696.25,3858,3866
5555,1,512,512,512.00,0.00,3865,3866
5556,1,512,512,512.00,0.00,3865,3866
5557,1,512,512,512.00,0.00,3865,3866
5558,2,367,145,256.00,12321.00,3865,3867
5559,1,512,512,512.00,0.00,3866,3867
5560,1,512,512,512.00,0.00,3866,3867
5561,1,512,512,512.00,0.00,3866,3867
5562,1,512,512,512.00,0.00,3866,3867
5563,1,512,512,512.00,0.00,3866,3867
5564,8,437,5,64.00,19913.75,3866,3874
5565,1,512,512,512.00,0.00,3873,3874
5566,1,512,512,512.00,0.00,3873,3874
5567,1,512,512,512.00,0.00,3873,3874
5568,4,245,14,128.00,7302.50,3873,3877
5569,5,192,12,102.40,5504.24,3876,3881
5570,9,176,2,56.89,4851.43,3880,3889
5571,4,226,8,128.00,8653.50,3888,3892
5572,4,289,2,128.00,11592.50,3891,3895
5573,1,512,512,512.00,0.00,3894,3895
5574,6,252,4,85.33,7553.22,3894,3900
5575,1,512,512,512.00,0.00,3899,3900
5576,2,298,214,256.00,1764.00,3899,3901
5577,1,512,512,512.00,0.00,3900,3901
5578,1,512,512,512.00,0.00,3900,3901
5579,2,328,184,256.00,5184.00,3900,3902
5580,2,436,76,256.00,32400.00,3901,3903
5581,2,327,185,256.00,5041.00,3902,3904
5582,1,512,512,512.00,0.00,3903,3904
5583,4,374,14,128.00,21438.00,3903,3907
5584,2,395,117,256.00,19321.00,3906,3908
5585,1,512,512,512.00,0.00,3907,3908
5586,1,512,512,512.00,0.00,3907,3908
5587,4,346,39,128.00,15942.50,3907,3911
5588,1,512,512,512.00,0.00,3910,3911
5589,1,512,512,512.00,0.00,3910,3911
5590,7,190,4,73.14,4513.27,3910,3917
5591,1,512,512,512.00,0.00,3916,3917
5592,1,512,512,512.00,0.00,3916,3917
5593,1,512,512,512.00,0.00,3916,3917
5594,1,512,512,512.00,0.00,3916,3917
5595,5,411,9,102.40,24195.04,3916,3921
5596,8,342,1,64.00,12026.00,3920,3928
5597,1,512,512,512.00,0.00,3927,3928
5598,1,512,512,512.00,0.00,3927,3928
5599,1,512,512,512.00,0.00,3927,3928
5600,1,512,512,512.00,0.00,3927,3928
5601,1,512,512,512.00,0.00,3927,3928
5602,1,512,512,512.00,0.00,3927,3928
5603,4,325,4,128.00,14278.50,3927,3931
5604,1,512,512,512.00,0.00,3930,3931
5605,5,383,3,102.40,19924.64,3930,3935
5606,4,417,2,128.00,28225.50,3934,3938
5607,1,512,512,512.00,0.00,3937,3938
5608,1,512,512,512.00,0.00,3937,3938
5609,1,512,512,512.00,0.00,3937,3938
5610,1,512,512,512.00,0.00,3937,3938
5611,1,512,512,512.00,0.00,3937,3938
5612,2,373,139,256.00,13689.00,3937,3939
5613,1,512,512,512.00,0.00,3938,3939
5614,1,512,512,512.00,0.00,3938,3939
5615,2,379,133,256.00,15129.00,3938,3940
5616,1,512,512,512.00,0.00,3939,3940
5617,2,471,41,256.00,46225.00,3939,3941
5618,1,512,512,512.00,0.00,3940,3941
5619,1,512,512,512.00,0.00,3940,3941
5620,3,319,7,170.67,16341.56,3940,3943
5621,1,512,512,512.00,0.00,3942,3943
5622,1,512,512,512.00,0.00,3942,3943
5623,1,512,512,512.00,0.00,3942,3943
5624,1,512,512,512.00,0.00,3942,3943
5625,5,362,3,102.40,18214.64,3942,3947
5626,2,403,109,256.00,21609.00,3946,3948
5627,1,512,512,512.00,0.00,3947,3948
5628,1,512,512,512.00,0.00,3947,3948
5629,1,512,512,512.00,0.00,3947,3948
5630,1,512,512,512.00,0.00,3947,3948
5631,2,319,193,256.00,3969.00,3947,3949
5632,4,481,1,128.00,41593.50,3948,3952
5633,2,372,140,256.00,13456.00,3951,3953
5634,5,352,16,102.40,15755.44,3952,3957
5635,1,512,512,512.00,0.00,3956,3957
5636,4,264,31,128.00,7211.50,3956,3960
5637,1,512,512,512.00,0.00,3959,3960
5638,1,512,512,512.00,0.00,3959,3960
5639,1,512,512,512.00,0.00,3959,3960
5640,2,353,159,256.00,9409.00,3959,3961
5641,1,512,512,512.00,0.00,3960,3961
5642,5,286,2,102.40,9953.84,3960,3965
5643,1,512,512,512.00,0.00,3964,3965
5644,4,468,3,128.00,38639.50,3964,3968
5645,1,512,512,512.00,0.00,3967,3968
5646,2,362,150,256.00,11236.00,3967,3969
5647,1,512,512,512.00,0.00,3968,3969
5648,1,512,512,512.00,0.00,3968,3969
5649,1,512,512,512.00,0.00,3968,3969
5650,1,512,512,512.00,0.00,3968,3969
5651,2,472,40,256.00,46656.00,3968,3970
5652,1,512,512,512.00,0.00,3969,3970
5653,1,512,512,512.00,0.00,3969,3970
5654,3,224,110,170.67,2192.89,3969,3972
5655,3,411,24,170.67,29348.22,3971,3974
5656,1,512,512,512.00,0.00,3973,3974
5657,1,512,512,512.00,0.00,3973,3974
5658,1,512,512,512.00,0.00,3973,3974
5659,1,512,512,512.00,0.00,3973,3974
5660,3,371,57,170.67,20188.22,3973,3976
5661,4,270,32,128.00,8121.50,3975,3979
5662,2,404,108,256.00,21904.00,3978,3980
5663,1,512,512,512.00,0.00,3979,3980
5664,2,371,141,256.00,13225.00,3979,3981
5665,1,512,512,512.00,0.00,3980,3981
5666,1,512,512,512.00,0.00,3980,3981
5667,2,484,28,256.00,51984.00,3980,3982
5668,1,512,512,512.00,0.00,3981,3982
5669,4,322,19,128.00,13660.50,3981,3985
5670,6,349,2,85.33,15006.22,3984,3990
5671,3,353,23,170.67,18750.89,3989,3992
5672,3,285,106,170.67,6573.56,3991,3994
5673,6,173,2,85.33,5854.22,3993,3999
5674,9,169,2,56.89,4675.21,3998,4007
5675,5,177,14,102.40,3917.84,4006,4011
5676,8,261,3,64.00,7492.25,4010,4018
5677,6,268,3,85.33,11123.89,4017,4023
5678,1,512,512,512.00,0.00,4022,4023
5679,1,512,512,512.00,0.00,4022,4023
5680,1,512,512,512.00,0.00,4022,4023
5681,1,512,512,512.00,0.00,4022,4023
5682,1,512,512,512.00,0.00,4022,4023
5683,1,512,512,512.00,0.00,4022,4023
5684,1,512,512,512.00,0.00,4022,4023
5685,1,512,512,512.00,0.00,4022,4023
5686,3,318,40,170.67,13019.56,4022,4025
5687,6,188,4,85.33,5166.56,4024,4030
5688,2,489,23,256.00,54289.00,4029,4031
5689,1,512,512,512.00,0.00,4030,4031
5690,1,512,512,512.00,0.00,4030,4031
5691,2,371,141,256.00,13225.00,4030,4032
5692,2,485,27,256.00,52441.00,4031,4033
5693,3,382,62,170.67,22336.89,4032,4035
5694,3,352,15,170.67,19257.56,4034,4037
5695,1,512,512,512.00,0.00,4036,4037
5696,1,512,512,512.00,0.00,4036,4037
5697,2,392,120,256.00,18496.00,4036,4038
5698,1,512,512,512.00,0.00,4037,4038
5699,2,294,218,256.00,1444.00,4037,4039
5700,1,512,512,512.00,0.00,4038,4039
5701,1,512,512,512.00,0.00,4038,4039
5702,2,414,98,256.00,24964.00,4038,4040
5703,1,512,512,512.00,0.00,4039,4040
5704,1,512,512,512.00,0.00,4039,4040
5705,1,512,512,512.00,0.00,4039,4040
5706,1,512,512,512.00,0.00,4039,4040
5707,1,512,512,512.00,0.00,4039,4040
5708,4,207,23,128.00,5369.00,4039,4043
5709,2,487,25,256.00,53361.00,4042,4044
5710,2,323,189,256.00,4489.00,4043,4045
5711,1,512,512,512.00,0.00,4044,4045
5712,4,354,7,128.00,18510.50,4044,4048
5713,1,512,512,512.00,0.00,4047,4048
5714,1,512,512,512.00,0.00,4047,4048
5715,1,512,512,512.00,0.00,4047,4048
5716,4,310,7,128.00,13441.50,4047,4051
5717,1,512,512,512.00,0.00,4050,4051
5718,2,407,105,256.00,22801.00,4050,4052
5719,1,512,512,512.00,0.00,4051,4052
5720,1,512,512,512.00,0.00,4051,4052
5721,1,512,512,512.00,0.00,4051,4052
5722,1,512,512,512.00,0.00,4051,4052
5723,3,386,1,170.67,25746.89,4051,4054
5724,2,426,86,256.00,28900.00,4053,4055
5725,1,512,512,512.00,0.00,4054,4055
5726,4,253,15,128.00,8574.50,4054,4058
5727,3,303,19,170.67,13629.56,4057,4060
5728,4,218,35,128.00,7929.50,4059,4063
5729,6,236,7,85.33,5426.56,4062,4068
5730,5,292,1,102.40,10859.04,4067,4072
5731,2,495,17,256.00,57121.00,4071,4073
5732,3,261,107,170.67,4308.22,4072,4075
5733,1,512,512,512.00,0.00,4074,4075
5734,1,512,512,512.00,0.00,4074,4075
5735,3,259,3,170.67,14069.56,4074,4077
5736,1,512,512,512.00,0.00,4076,4077
5737,1,512,512,512.00,0.00,4076,4077
5738,4,278,1,128.00,12069.50,4076,4080
5739,3,478,2,170.67,47376.89,4079,4082
5740,4,431,5,128.00,31176.50,4081,4085
5741,7,248,2,73.14,10678.69,4084,4091
5742,4,394,5,128.00,24433.50,4090,4094
5743,3,411,1,170.67,30513.56,4093,4096
5744,2,375,137,256.00,14161.00,4095,4097
5745,6,301,2,85.33,10447.89,4096,4102
5746,1,512,512,512.00,0.00,4101,4102
5747,1,512,512,512.00,0.00,4101,4102
5748,2,305,207,256.00,2401.00,4101,4103
5749,1,512,512,512.00,0.00,4102,4103
5750,3,372,3,170.67,23260.22,4102,4105
5751,1,512,512,512.00,0.00,4104,4105
5752,1,512,512,512.00,0.00,4104,4105
5753,1,512,512,512.00,0.00,4104,4105
5754,4,487,2,128.00,42975.50,4104,4108
5755,3,248,132,170.67,2990.22,4107,4110
5756,1,512,512,512.00,0.00,4109,4110
5757,1,512,512,512.00,0.00,4109,4110
5758,1,512,512,512.00,0.00,4109,4110
5759,4,380,4,128.00,21800.00,4109,4113
5760,3,462,11,170.67,42568.22,4112,4115
5761,5,371,4,102.40,18313.04,4114,4119
5762,7,265,2,73.14,9626.98,4118,4125
5763,1,512,512,512.00,0.00,4124,4125
5764,2,325,187,256.00,4761.00,4124,4126
5765,1,512,512,512.00,0.00,4125,4126
5766,1,512,512,512.00,0.00,4125,4126
5767,1,512,512,512.00,0.00,4125,4126
5768,2,295,217,256.00,1521.00,4125,4127
5769,4,275,13,128.00,10821.00,4126,4130
5770,2,259,253,256.00,9.00,4129,4131
5771,1,512,512,512.00,0.00,4130,4131
5772,1,512,512,512.00,0.00,4130,4131
5773,1,512,512,512.00,0.00,4130,4131
5774,1,512,512,512.00,0.00,4130,4131
5775,1,512,512,512.00,0.00,4130,4131
5776,2,497,15,256.00,58081.00,4130,4132
5777,1,512,512,512.00,0.00,4131,4132
5778,4,291,3,128.00,11697.00,4131,4135
5779,2,417,95,256.00,25921.00,4134,4136
5780,1,512,512,512.00,0.00,4135,4136
5781,2,349,163,256.00,8649.00,4135,4137
5782,2,410,102,256.00,23716.00,4136,4138
5783,1,512,512,512.00,0.00,4137,4138
5784,4,209,70,128.00,2700.50,4137,4141
5785,4,231,35,128.00,5219.00,4140,4144
5786,1,512,512,512.00,0.00,4143,4144
5787,5,248,1,102.40,11399.44,4143,4148
5788,2,294,218,256.00,1444.00,4147,4149
5789,2,373,139,256.00,13689.00,4148,4150
5790,7,193,6,73.14,5456.12,4149,4156
5791,1,512,512,512.00,0.00,4155,4156
5792,1,512,512,512.00,0.00,4155,4156
5793,3,205,115,170.67,1577.56,4155,4158
5794,1,512,512,512.00,0.00,4157,4158
5795,3,290,28,170.67,11712.89,4157,4160
5796,3,429,1,170.67,34461.56,4159,4162
5797,2,391,121,256.00,18225.00,4161,4163
5798,4,399,2,128.00,25188.50,4162,4166
5799,4,259,1,128.00,16137.00,4165,4169
5800,2,408,104,256.00,23104.00,4168,4170
5801,1,512,512,512.00,0.00,4169,4170
5802,2,298,214,256.00,1764.00,4169,4171
5803,1,512,512,512.00,0.00,4170,4171
5804,1,512,512,512.00,0.00,4170,4171
5805,2,349,163,256.00,8649.00,4170,4172
5806,1,512,512,512.00,0.00,4171,4172
5807,1,512,512,512.00,0.00,4171,4172
5808,1,512,512,512.00,0.00,4171,4172
5809,1,512,512,512.00,0.00,4171,4172
5810,2,312,200,256.00,3136.00,4171,4173
5811,1,512,512,512.00,0.00,4172,4173
5812,1,512,512,512.00,0.00,4172,4173
5813,1,512,512,512.00,0.00,4172,4173
5814,2,509,3,256.00,64009.00,4172,4174
5815,1,512,512,512.00,0.00,4173,4174
5816,2,310,202,256.00,2916.00,4173,4175
5817,1,512,512,512.00,0.00,4174,4175
5818,1,512,512,512.00,0.00,4174,4175
5819,1,512,512,512.00,0.00,4174,4175
5820,1,512,512,512.00,0.00,4174,4175
5821,2,375,137,256.00,14161.00,4174,4176
5822,1,512,512,512.00,0.00,4175,4176
5823,2,431,81,256.00,30625.00,4175,4177
5824,5,327,3,102.40,13391.84,4176,4181
5825,1,512,512,512.00,0.00,4180,4181
5826,4,362,11,128.00,18825.50,4180,4184
5827,4,416,1,128.00,28359.50,4183,4187
5828,1,512,512,512.00,0.00,4186,4187
5829,1,512,512,512.00,0.00,4186,4187
5830,1,512,512,512.00,0.00,4186,4187
5831,1,512,512,512.00,0.00,4186,4187
5832,1,512,512,512.00,0.00,4186,4187
5833,1,512,512,512.00,0.00,4186,4187
5834,1,512,512,512.00,0.00,4186,4187
5835,1,512,512,512.00,0.00,4186,4187
5836,1,512,512,512.00,0.00,4186,4187
5837,1,512,512,512.00,0.00,4186,4187
5838,1,512,512,512.00,0.00,4186,4187
5839,1,512,512,512.00,0.00,4186,4187
5840,2,278,234,256.00,484.00,4186,4188
5841,1,512,512,512.00,0.00,4187,4188
5842,1,512,512,512.00,0.00,4187,4188
5843,2,468,44,256.00,44944.00,4187,4189
5844,1,512,512,512.00,0.00,4188,4189
5845,3,305,50,170.67,10930.89,4188,4191
5846,1,512,512,512.00,0.00,4190,4191
5847,2,498,14,256.00,58564.00,4190,4192
5848,1,512,512,512.00,0.00,4191,4192
5849,1,512,512,512.00,0.00,4191,4192
5850,2,466,46,256.00,44100.00,4191,4193
5851,3,272,62,170.67,7376.89,4192,4195
5852,2,394,118,256.00,19044.00,4194,4196
5853,1,512,512,512.00,0.00,4195,4196
5854,1,512,512,512.00,0.00,4195,4196
5855,1,512,512,512.00,0.00,4195,4196
5856,2,344,168,256.00,7744.00,4195,4197
5857,1,512,512,512.00,0.00,4196,4197
5858,4,302,44,128.00,10346.00,4196,4200
5859,3,283,102,170.67,6413.56,4199,4202
5860,3,386,4,170.67,25504.89,4201,4204
5861,3,468,21,170.67,44204.22,4203,4206
5862,3,453,11,170.67,40084.22,4205,4208
5863,2,398,114,256.00,20164.00,4207,4209
5864,1,512,512,512.00,0.00,4208,4209
5865,1,512,512,512.00,0.00,4208,4209
5866,2,425,87,256.00,28561.00,4208,4210
5867,4,242,10,128.00,8472.50,4209,4213
5868,2,434,78,256.00,31684.00,4212,4214
5869,2,470,42,256.00,45796.00,4213,4215
5870,2,311,201,256.00,3025.00,4214,4216
5871,1,512,512,512.00,0.00,4215,4216
5872,1,512,512,512.00,0.00,4215,4216
5873,1,512,512,512.00,0.00,4215,4216
5874,2,393,119,256.00,18769.00,4215,4217
5875,1,512,512,512.00,0.00,4216,4217
5876,1,512,512,512.00,0.00,4216,4217
5877,1,512,512,512.00,0.00,4216,4217
5878,2,363,149,256.00,11449.00,4216,4218
5879,1,512,512,512.00,0.00,4217,4218
5880,2,274,238,256.00,324.00,4217,4219
5881,4,282,2,128.00,14228.00,4218,4222
5882,2,339,173,256.00,6889.00,4221,4223
5883,3,283,3,170.67,14597.56,4222,4225
5884,3,397,1,170.67,27741.56,4224,4227
5885,5,341,8,102.40,15435.04,4226,4231
5886,1,512,512,512.00,0.00,4230,4231
5887,3,356,4,170.67,20824.89,4230,4233
5888,2,458,54,256.00,40804.00,4232,4234
5889,1,512,512,512.00,0.00,4233,4234
5890,1,512,512,512.00,0.00,4233,4234
5891,1,512,512,512.00,0.00,4233,4234
5892,2,456,56,256.00,40000.00,4233,4235
5893,1,512,512,512.00,0.00,4234,4235
5894,3,232,136,170.67,1891.56,4234,4237
5895,5,268,24,102.40,8089.84,4236,4241
5896,2,395,117,256.00,19321.00,4240,4242
5897,2,373,139,256.00,13689.00,4241,4243
5898,1,512,512,512.00,0.00,4242,4243
5899,1,512,512,512.00,0.00,4242,4243
5900,1,512,512,512.00,0.00,4242,4243
5901,1,512,512,512.00,0.00,4242,4243
5902,3,249,90,170.67,4216.22,4242,4245
5903,2,451,61,256.00,38025.00,4244,4246
5904,1,512,512,512.00,0.00,4245,4246
5905,4,346,2,128.00,17486.00,4245,4249
5906,1,512,512,512.00,0.00,4248,4249
5907,1,512,512,512.00,0.00,4248,4249
5908,1,512,512,512.00,0.00,4248,4249
5909,3,358,22,170.67,19563.56,4248,4251
5910,1,512,512,512.00,0.00,4250,4251
5911,1,512,512,512.00,0.00,4250,4251
5912,5,378,2,102.40,19457.84,4250,4255
5913,3,262,50,170.67,7920.89,4254,4257
5914,4,415,1,128.00,28066.50,4256,4260
5915,1,512,512,512.00,0.00,4259,4260
5916,1,512,512,512.00,0.00,4259,4260
5917,8,343,2,64.00,11533.00,4259,4267
5918,4,346,1,128.00,17138.50,4266,4270
5919,1,512,512,512.00,0.00,4269,4270
5920,1,512,512,512.00,0.00,4269,4270
5921,1,512,512,512.00,0.00,4269,4270
5922,1,512,512,512.00,0.00,4269,4270
5923,2,408,104,256.00,23104.00,4269,4271
5924,1,512,512,512.00,0.00,4270,4271
5925,2,460,52,256.00,41616.00,4270,4272
5926,1,512,512,512.00,0.00,4271,4272
5927,1,512,512,512.00,0.00,4271,4272
5928,3,319,52,170.67,12321.56,4271,4274
5929,2,485,27,256.00,52441.00,4273,4275
5930,1,512,512,512.00,0.00,4274,4275
5931,1,512,512,512.00,0.00,4274,4275
5932,2,503,9,256.00,61009.00,4274,4276
5933,1,512,512,512.00,0.00,4275,4276
5934,2,507,5,256.00,63001.00,4275,4277
5935,1,512,512,512.00,0.00,4276,4277
5936,1,512,512,512.00,0.00,4276,4277
5937,1,512,512,512.00,0.00,4276,4277
5938,2,467,45,256.00,44521.00,4276,4278
5939,1,512,512,512.00,0.00,4277,4278
5940,1,512,512,512.00,0.00,4277,4278
5941,1,512,512,512.00,0.00,4277,4278
5942,3,199,146,170.67,474.89,4277,4280
5943,1,512,512,512.00,0.00,4279,4280
5944,1,512,512,512.00,0.00,4279,4280
5945,1,512,512,512.00,0.00,4279,4280
5946,1,512,512,512.00,0.00,4279,4280
5947,2,405,107,256.00,22201.00,4279,4281
5948,1,512,512,512.00,0.00,4280,4281
5949,1,512,512,512.00,0.00,4280,4281
5950,1,512,512,512.00,0.00,4280,4281
5951,1,512,512,512.00,0.00,4280,4281
5952,1,512,512,512.00,0.00,4280,4281
5953,1,512,512,512.00,0.00,4280,4281
5954,8,238,1,64.00,5951.00,4280,4288
5955,5,375,3,102.40,19791.04,4287,4292
5956,3,294,102,170.67,7638.22,4291,4294
5957,1,512,512,512.00,0.00,4293,4294
5958,1,512,512,512.00,0.00,4293,4294
5959,3,332,29,170.67,15494.89,4293,4296
5960,1,512,512,512.00,0.00,4295,4296
5961,1,512,512,512.00,0.00,4295,4296
5962,1,512,512,512.00,0.00,4295,4296
5963,2,393,119,256.00,18769.00,4295,4297
5964,2,491,21,256.00,55225.00,4296,4298
5965,1,512,512,512.00,0.00,4297,4298
5966,1,512,512,512.00,0.00,4297,4298
5967,1,512,512,512.00,0.00,4297,4298
5968,1,512,512,512.00,0.00,4297,4298
5969,1,512,512,512.00,0.00,4297,4298
5970,1,512,512,512.00,0.00,4297,4298
5971,1,512,512,512.00,0.00,4297,4298
5972,2,421,91,256.00,27225.00,4297,4299
5973,1,512,512,512.00,0.00,4298,4299
5974,1,512,512,512.00,0.00,4298,4299
5975,2,469,43,256.00,45369.00,4298,4300
5976,1,512,512,512.00,0.00,4299,4300
5977,1,512,512,512.00,0.00,4299,4300
5978,2,267,245,256.00,121.00,4299,4301
5979,1,512,512,512.00,0.00,4300,4301
5980,2,476,36,256.00,48400.00,4300,4302
5981,3,413,36,170.67,29484.22,4301,4304
5982,2,317,195,256.00,3721.00,4303,4305
5983,1,512,512,512.00,0.00,4304,4305
5984,4,300,1,128.00,12461.50,4304,4308
5985,1,512,512,512.00,0.00,4307,4308
5986,1,512,512,512.00,0.00,4307,4308
5987,2,382,130,256.00,15876.00,4307,4309
5988,3,344,1,170.67,19614.89,4308,4311
5989,1,512,512,512.00,0.00,4310,4311
5990,5,188,9,102.40,6076.64,4310,4315
5991,1,512,512,512.00,0.00,4314,4315
5992,1,512,512,512.00,0.00,4314,4315
5993,2,504,8,256.00,61504.00,4314,4316
5994,1,512,512,512.00,0.00,4315,4316
5995,1,512,512,512.00,0.00,4315,4316
5996,6,360,1,85.33,16264.89,4315,4321
5997,1,512,512,512.00,0.00,4320,4321
5998,1,512,512,512.00,0.00,4320,4321
5999,2,474,38,256.00,47524.00,4320,4322
6000,1,512,512,512.00,0.00,4321,4322
6001,1,512,512,512.00,0.00,4321,4322
6002,2,505,7,256.00,62001.00,4321,4323
6003,3,309,19,170.67,14105.56,4322,4325
6004,2,290,222,256.00,1156.00,4324,4326
6005,2,329,183,256.00,5329.00,4325,4327
6006,1,512,512,512.00,0.00,4326,4327
6007,1,512,512,512.00,0.00,4326,4327
6008,3,234,55,170.67,6709.56,4326,4329
6009,4,234,15,128.00,9577.50,4328,4332
6010,2,465,47,256.00,43681.00,4331,4333
6011,1,512,512,512.00,0.00,4332,4333
6012,1,512,512,512.00,0.00,4332,4333
6013,1,512,512,512.00,0.00,4332,4333
6014,1,512,512,512.00,0.00,4332,4333
6015,1,512,512,512.00,0.00,4332,4333
6016,3,290,11,170.67,13786.89,4332,4335
6017,1,512,512,512.00,0.00,4334,4335
6018,1,512,512,512.00,0.00,4334,4335
6019,1,512,512,512.00,0.00,4334,4335
6020,1,512,512,512.00,0.00,4334,4335
6021,1,512,512,512.00,0.00,4334,4335
6022,3,413,3,170.67,30804.22,4334,4337
6023,3,362,50,170.67,18720.89,4336,4339
6024,2,263,249,256.00,49.00,4338,4340
6025,3,306,61,170.67,10333.56,4339,4342
6026,1,512,512,512.00,0.00,4341,4342
6027,2,275,237,256.00,361.00,4341,4343
6028,1,512,512,512.00,0.00,4342,4343
6029,1,512,512,512.00,0.00,4342,4343
6030,3,428,41,170.67,33110.89,4342,4345
6031,2,385,127,256.00,16641.00,4344,4346
6032,1,512,512,512.00,0.00,4345,4346
6033,1,512,512,512.00,0.00,4345,4346
6034,2,363,149,256.00,11449.00,4345,4347
6035,1,512,512,512.00,0.00,4346,4347
6036,1,512,512,512.00,0.00,4346,4347
6037,5,224,15,102.40,9251.44,4346,4351
6038,1,512,512,512.00,0.00,4350,4351
6039,1,512,512,512.00,0.00,4350,4351
6040,6,230,1,85.33,9146.56,4350,4356
6041,5,207,6,102.40,4103.04,4355,4360
6042,5,253,1,102.40,14822.64,4359,4364
6043,1,512,512,512.00,0.00,4363,4364
6044,1,512,512,512.00,0.00,4363,4364
6045,1,512,512,512.00,0.00,4363,4364
6046,1,512,512,512.00,0.00,4363,4364
6047,3,366,71,170.67,19080.22,4363,4366
6048,1,512,512,512.00,0.00,4365,4366
6049,2,427,85,256.00,29241.00,4365,4367
6050,2,300,212,256.00,1936.00,4366,4368
6051,3,397,14,170.67,26874.89,4367,4370
6052,1,512,512,512.00,0.00,4369,4370
6053,1,512,512,512.00,0.00,4369,4370
6054,2,398,114,256.00,20164.00,4369,4371
6055,1,512,512,512.00,0.00,4370,4371
6056,1,512,512,512.00,0.00,4370,4371
6057,1,512,512,512.00,0.00,4370,4371
6058,2,432,80,256.00,30976.00,4370,4372
6059,5,274,1,102.40,12989.44,4371,4376
6060,7,257,1,73.14,6495.84,4375,4382
6061,1,512,512,512.00,0.00,4381,4382
6062,1,512,512,512.00,0.00,4381,4382
6063,1,512,512,512.00,0.00,4381,4382
6064,2,353,159,256.00,9409.00,4381,4383
6065,4,340,17,128.00,15669.50,4382,4386
6066,1,512,512,512.00,0.00,4385,4386
6067,1,512,512,512.00,0.00,4385,4386
6068,1,512,512,512.00,0.00,4385,4386
6069,1,512,512,512.00,0.00,4385,4386
6070,1,512,512,512.00,0.00,4385,4386
6071,2,428,84,256.00,29584.00,4385,4387
6072,1,512,512,512.00,0.00,4386,4387
6073,3,331,13,170.67,16857.56,4386,4389
6074,3,396,11,170.67,26860.22,4388,4391
6075,4,303,40,128.00,11003.50,4390,4394
6076,2,387,125,256.00,17161.00,4393,4395
6077,2,326,186,256.00,4900.00,4394,4396
6078,1,512,512,512.00,0.00,4395,4396
6079,2,389,123,256.00,17689.00,4395,4397
6080,3,235,64,170.67,5769.56,4396,4399
6081,1,512,512,512.00,0.00,4398,4399
6082,5,221,1,102.40,8967.84,4398,4403
6083,1,512,512,512.00,0.00,4402,4403
6084,1,512,512,512.00,0.00,4402,4403
6085,1,512,512,512.00,0.00,4402,4403
6086,1,512,512,512.00,0.00,4402,4403
6087,1,512,512,512.00,0.00,4402,4403
6088,1,512,512,512.00,0.00,4402,4403
6089,2,340,172,256.00,7056.00,4402,4404
6090,7,458,1,73.14,24714.69,4403,4410
6091,2,344,168,256.00,7744.00,4409,4411
6092,3,456,7,170.67,41001.56,4410,4413
6093,2,442,70,256.00,34596.00,4412,4414
6094,3,362,53,170.67,18626.89,4413,4416
6095,2,349,163,256.00,8649.00,4415,4417
6096,3,221,73,170.67,4770.89,4416,4419
6097,1,512,512,512.00,0.00,4418,4419
6098,1,512,512,512.00,0.00,4418,4419
6099,1,512,512,512.00,0.00,4418,4419
6100,1,512,512,512.00,0.00,4418,4419
6101,1,512,512,512.00,0.00,4418,4419
6102,3,459,6,170.67,41848.22,4418,4421
6103,6,213,7,85.33,3874.56,4420,4426
6104,1,512,512,512.00,0.00,4425,4426
6105,1,512,512,512.00,0.00,4425,4426
6106,1,512,512,512.00,0.00,4425,4426
6107,1,512,512,512.00,0.00,4425,4426
6108,1,512,512,512.00,0.00,4425,4426
6109,2,442,70,256.00,34596.00,4425,4427
6110,2,491,21,256.00,55225.00,4426,4428
6111,1,512,512,512.00,0.00,4427,4428
6112,1,512,512,512.00,0.00,4427,4428
6113,1,512,512,512.00,0.00,4427,4428
6114,3,288,36,170.67,10734.22,4427,4430
6115,1,512,512,512.00,0.00,4429,4430
6116,5,233,1,102.40,5883.04,4429,4434
6117,1,512,512,512.00,0.00,4433,4434
6118,2,377,135,256.00,14641.00,4433,4435
6119,1,512,512,512.00,0.00,4434,4435
6120,1,512,512,512.00,0.00,4434,4435
6121,1,512,512,512.00,0.00,4434,4435
6122,1,512,512,512.00,0.00,4434,4435
6123,1,512,512,512.00,0.00,4434,4435
6124,1,512,512,512.00,0.00,4434,4435
6125,1,512,512,512.00,0.00,4434,4435
6126,2,273,239,256.00,289.00,4434,4436
6127,5,390,2,102.40,21039.44,4435,4440
6128,3,310,16,170.67,14523.56,4439,4442
6129,1,512,512,512.00,0.00,4441,4442
6130,3,254,17,170.67,11834.89,4441,4444
6131,1,512,512,512.00,0.00,4443,4444
6132,2,352,160,256.00,9216.00,4443,4445
6133,1,512,512,512.00,0.00,4444,4445
6134,1,512,512,512.00,0.00,4444,4445
6135,6,310,2,85.33,11989.56,4444,4450
6136,1,512,512,512.00,0.00,4449,4450
6137,2,348,164,256.00,8464.00,4449,4451
6138,3,436,2,170.67,36064.89,4450,4453
6139,2,283,229,256.00,729.00,4452,4454
6140,1,512,512,512.00,0.00,4453,4454
6141,1,512,512,512.00,0.00,4453,4454
6142,1,512,512,512.00,0.00,4453,4454
6143,1,512,512,512.00,0.00,4453,4454
6144,3,303,84,170.67,9036.22,4453,4456
6145,1,512,512,512.00,0.00,4455,4456
6146,3,262,87,170.67,5133.56,4455,4458
6147,2,336,176,256.00,6400.00,4457,4459
6148,3,293,2,170.67,15186.89,4458,4461
6149,1,512,512,512.00,0.00,4460,4461
6150,1,512,512,512.00,0.00,4460,4461
6151,1,512,512,512.00,0.00,4460,4461
6152,4,487,1,128.00,43030.50,4460,4464
6153,4,383,2,128.00,22935.50,4463,4467
6154,1,512,512,512.00,0.00,4466,4467
6155,1,512,512,512.00,0.00,4466,4467
6156,2,356,156,256.00,10000.00,4466,4468
6157,1,512,512,512.00,0.00,4467,4468
6158,1,512,512,512.00,0.00,4467,4468
6159,1,512,512,512.00,0.00,4467,4468
6160,2,394,118,256.00,19044.00,4467,4469
6161,1,512,512,512.00,0.00,4468,4469
6162,1,512,512,512.00,0.00,4468,4469
6163,5,266,4,102.40,13099.84,4468,4473
6164,3,455,3,170.67,40856.22,4472,4475
6165,6,294,4,85.33,13117.22,4474,4480
6166,3,214,115,170.67,1709.56,4479,4482
6167,3,306,81,170.67,9480.22,4481,4484
6168,1,512,512,512.00,0.00,4483,4484
6169,2,500,12,256.00,59536.00,4483,4485
6170,1,512,512,512.00,0.00,4484,4485
6171,2,417,95,256.00,25921.00,4484,4486
6172,5,196,62,102.40,2405.44,4485,4490
6173,1,512,512,512.00,0.00,4489,4490
6174,4,287,30,128.00,10782.50,4489,4493
6175,4,239,48,128.00,6691.50,4492,4496
6176,1,512,512,512.00,0.00,4495,4496
6177,6,230,1,85.33,6519.56,4495,4501
6178,2,269,243,256.00,169.00,4500,4502
6179,1,512,512,512.00,0.00,4501,4502
6180,1,512,512,512.00,0.00,4501,4502
6181,3,365,73,170.67,18882.89,4501,4504
6182,7,305,1,73.14,10767.27,4503,4510
6183,1,512,512,512.00,0.00,4509,4510
6184,3,339,21,170.67,17028.22,4509,4512
6185,1,512,512,512.00,0.00,4511,4512
6186,1,512,512,512.00,0.00,4511,4512
6187,1,512,512,512.00,0.00,4511,4512
6188,1,512,512,512.00,0.00,4511,4512
6189,1,512,512,512.00,0.00,4511,4512
6190,9,241,2,56.89,6788.77,4511,4520
6191,1,512,512,512.00,0.00,4519,4520
6192,1,512,512,512.00,0.00,4519,4520
6193,1,512,512,512.00,0.00,4519,4520
6194,2,288,224,256.00,1024.00,4519,4521
6195,1,512,512,512.00,0.00,4520,4521
6196,1,512,512,512.00,0.00,4520,4521
6197,1,512,512,512.00,0.00,4520,4521
6198,3,467,2,170.67,44186.89,4520,4523
6199,3,261,40,170.67,8953.56,4522,4525
6200,4,455,9,128.00,35752.50,4524,4528
6201,2,477,35,256.00,48841.00,4527,4529
6202,1,512,512,512.00,0.00,4528,4529
6203,1,512,512,512.00,0.00,4528,4529
6204,3,488,4,170.67,50392.89,4528,4531
6205,1,512,512,512.00,0.00,4530,4531
6206,3,272,6,170.67,13798.22,4530,4533
6207,2,409,103,256.00,23409.00,4532,4534
6208,1,512,512,512.00,0.00,4533,4534
6209,3,375,33,170.67,21716.22,4533,4536
6210,5,326,4,102.40,14917.04,4535,4540
6211,2,477,35,256.00,48841.00,4539,4541
6212,4,251,8,128.00,8979.50,4540,4544
6213,4,494,2,128.00,44658.50,4543,4547
6214,3,421,4,170.67,32481.56,4546,4549
6215,2,326,186,256.00,4900.00,4548,4550
6216,1,512,512,512.00,0.00,4549,4550
6217,1,512,512,512.00,0.00,4549,4550
6218,1,512,512,512.00,0.00,4549,4550
6219,2,372,140,256.00,13456.00,4549,4551
6220,1,512,512,512.00,0.00,4550,4551
6221,1,512,512,512.00,0.00,4550,4551
6222,2,431,81,256.00,30625.00,4550,4552
6223,2,332,180,256.00,5776.00,4551,4553
6224,2,299,213,256.00,1849.00,4552,4554
6225,2,307,205,256.00,2601.00,4553,4555
6226,1,512,512,512.00,0.00,4554,4555
6227,1,512,512,512.00,0.00,4554,4555
6228,1,512,512,512.00,0.00,4554,4555
6229,1,512,512,512.00,0.00,4554,4555
6230,1,512,512,512.00,0.00,4554,4555
6231,1,512,512,512.00,0.00,4554,4555
6232,1,512,512,512.00,0.00,4554,4555
6233,3,280,92,170.67,6360.89,4554,4557
6234,2,276,236,256.00,400.00,4556,4558
6235,1,512,512,512.00,0.00,4557,4558
6236,2,510,2,256.00,64516.00,4557,4559
6237,1,512,512,512.00,0.00,4558,4559
6238,1,512,512,512.00,0.00,4558,4559
6239,1,512,512,512.00,0.00,4558,4559
6240,1,512,512,512.00,0.00,4558,4559
6241,1,512,512,512.00,0.00,4558,4559
6242,1,512,512,512.00,0.00,4558,4559
6243,1,512,512,512.00,0.00,4558,4559
6244,1,512,512,512.00,0.00,4558,4559
6245,2,279,233,256.00,529.00,4558,4560
6246,2,354,158,256.00,9604.00,4559,4561
6247,4,409,2,128.00,26943.50,4560,4564
6248,1,512,512,512.00,0.00,4563,4564
6249,2,320,192,256.00,4096.00,4563,4565
6250,1,512,512,512.00,0.00,4564,4565
6251,1,512,512,512.00,0.00,4564,4565
6252,1,512,512,512.00,0.00,4564,4565
6253,5,220,1,102.40,5250.64,4564,4569
6254,4,229,12,128.00,6407.50,4568,4572
6255,5,402,5,102.40,22720.64,4571,4576
6256,5,196,1,102.40,6289.44,4575,4580
6257,2,377,135,256.00,14641.00,4579,4581
6258,1,512,512,512.00,0.00,4580,4581
6259,1,512,512,512.00,0.00,4580,4581
6260,3,323,8,170.67,16590.89,4580,4583
6261,1,512,512,512.00,0.00,4582,4583
6262,1,512,512,512.00,0.00,4582,4583
6263,4,405,20,128.00,25671.50,4582,4586
6264,1,512,512,512.00,0.00,4585,4586
6265,1,512,512,512.00,0.00,4585,4586
6266,3,483,13,170.67,48777.56,4585,4588
6267,5,258,14,102.40,6963.44,4587,4592
6268,1,512,512,512.00,0.00,4591,4592
6269,1,512,512,512.00,0.00,4591,4592
6270,1,512,512,512.00,0.00,4591,4592
6271,7,446,1,73.14,23265.55,4591,4598
6272,3,253,43,170.67,8377.56,4597,4600
6273,1,512,512,512.00,0.00,4599,4600
6274,1,512,512,512.00,0.00,4599,4600
6275,1,512,512,512.00,0.00,4599,4600
6276,1,512,512,512.00,0.00,4599,4600
6277,1,512,512,512.00,0.00,4599,4600
6278,2,466,46,256.00,44100.00,4599,4601
6279,1,512,512,512.00,0.00,4600,4601
6280,1,512,512,512.00,0.00,4600,4601
6281,4,427,8,128.00,30208.50,4600,4604
6282,6,399,1,85.33,20743.89,4603,4609
6283,1,512,512,512.00,0.00,4608,4609
6284,1,512,512,512.00,0.00,4608,4609
6285,1,512,512,512.00,0.00,4608,4609
6286,2,499,13,256.00,59049.00,4608,4610
6287,2,313,199,256.00,3249.00,4609,4611
6288,3,468,18,170.67,44214.22,4610,4613
6289,5,200,1,102.40,7411.44,4612,4617
6290,1,512,512,512.00,0.00,4616,4617
6291,4,251,18,128.00,11293.50,4616,4620
6292,4,425,3,128.00,30417.00,4619,4623
6293,2,470,42,256.00,45796.00,4622,4624
6294,1,512,512,512.00,0.00,4623,4624
6295,1,512,512,512.00,0.00,4623,4624
6296,1,512,512,512.00,0.00,4623,4624
6297,1,512,512,512.00,0.00,4623,4624
6298,3,389,32,170.67,24414.89,4623,4626
6299,1,512,512,512.00,0.00,4625,4626
6300,1,512,512,512.00,0.00,4625,4626
6301,2,361,151,256.00,11025.00,4625,4627
6302,1,512,512,512.00,0.00,4626,4627
6303,1,512,512,512.00,0.00,4626,4627
6304,1,512,512,512.00,0.00,4626,4627
6305,1,512,512,512.00,0.00,4626,4627
6306,3,320,34,170.67,13712.89,4626,4629
6307,1,512,512,512.00,0.00,4628,4629
6308,5,251,6,102.40,11765.84,4628,4633
6309,2,496,16,256.00,57600.00,4632,4634
6310,2,389,123,256.00,17689.00,4633,4635
6311,1,512,512,512.00,0.00,4634,4635
6312,1,512,512,512.00,0.00,4634,4635
6313,3,324,70,170.67,12139.56,4634,4637
6314,2,376,136,256.00,14400.00,4636,4638
6315,1,512,512,512.00,0.00,4637,4638
6316,3,417,47,170.67,30340.22,4637,4640
6317,1,512,512,512.00,0.00,4639,4640
6318,4,258,12,128.00,9295.50,4639,4643
6319,1,512,512,512.00,0.00,4642,4643
6320,6,182,5,85.33,3689.56,4642,4648
6321,4,288,1,128.00,16454.50,4647,4651
6322,1,512,512,512.00,0.00,4650,4651
6323,1,512,512,512.00,0.00,4650,4651
6324,2,325,187,256.00,4761.00,4650,4652
6325,1,512,512,512.00,0.00,4651,4652
6326,2,403,109,256.00,21609.00,4651,4653
6327,3,283,12,170.67,13313.56,4652,4655
6328,1,512,512,512.00,0.00,4654,4655
6329,2,335,177,256.00,6241.00,4654,4656
6330,6,285,2,85.33,10347.22,4655,4661
6331,4,163,101,128.00,528.50,4660,4664
6332,5,352,1,102.40,18012.24,4663,4668
6333,6,331,4,85.33,13303.56,4667,4673
6334,2,363,149,256.00,11449.00,4672,4674
6335,5,247,3,102.40,12847.84,4673,4678
6336,1,512,512,512.00,0.00,4677,4678
6337,1,512,512,512.00,0.00,4677,4678
6338,1,512,512,512.00,0.00,4677,4678
6339,1,512,512,512.00,0.00,4677,4678
6340,1,512,512,512.00,0.00,4677,4678
6341,2,481,31,256.00,50625.00,4677,4679
6342,4,355,29,128.00,17441.00,4678,4682
6343,1,512,512,512.00,0.00,4681,4682
6344,2,262,250,256.00,36.00,4681,4683
6345,4,345,11,128.00,17549.00,4682,4686
6346,6,253,1,85.33,10861.56,4685,4691
6347,1,512,512,512.00,0.00,4690,4691
6348,1,512,512,512.00,0.00,4690,4691
6349,9,160,1,56.89,4190.99,4690,4699
6350,2,306,206,256.00,2500.00,4698,4700
6351,1,512,512,512.00,0.00,4699,4700
6352,1,512,512,512.00,0.00,4699,4700
6353,1,512,512,512.00,0.00,4699,4700
6354,1,512,512,512.00,0.00,4699,4700
6355,5,460,1,102.40,32131.44,4699,4704
6356,2,507,5,256.00,63001.00,4703,4705
6357,1,512,512,512.00,0.00,4704,4705
6358,1,512,512,512.00,0.00,4704,4705
6359,6,385,1,85.33,18351.56,4704,4710
6360,2,463,49,256.00,42849.00,4709,4711
6361,1,512,512,512.00,0.00,4710,4711
6362,1,512,512,512.00,0.00,4710,4711
6363,1,512,512,512.00,0.00,4710,4711
6364,1,512,512,512.00,0.00,4710,4711
6365,4,293,1,128.00,12423.50,4710,4714
6366,1,512,512,512.00,0.00,4713,4714
6367,2,372,140,256.00,13456.00,4713,4715
6368,2,448,64,256.00,36864.00,4714,4716
6369,2,413,99,256.00,24649.00,4715,4717
6370,1,512,512,512.00,0.00,4716,4717
6371,1,512,512,512.00,0.00,4716,4717
6372,1,512,512,512.00,0.00,4716,4717
6373,1,512,512,512.00,0.00,4716,4717
6374,1,512,512,512.00,0.00,4716,4717
6375,3,438,2,170.67,36550.22,4716,4719
6376,1,512,512,512.00,0.00,4718,4719
6377,1,512,512,512.00,0.00,4718,4719
6378,4,308,2,128.00,13446.00,4718,4722
6379,1,512,512,512.00,0.00,4721,4722
6380,5,178,19,102.40,2873.04,4721,4726
6381,1,512,512,512.00,0.00,4725,4726
6382,1,512,512,512.00,0.00,4725,4726
6383,1,512,512,512.00,0.00,4725,4726
6384,3,357,11,170.67,20308.22,4725,4728
6385,1,512,512,512.00,0.00,4727,4728
6386,1,512,512,512.00,0.00,4727,4728
6387,2,414,98,256.00,24964.00,4727,4729
6388,1,512,512,512.00,0.00,4728,4729
6389,2,302,210,256.00,2116.00,4728,4730
6390,1,512,512,512.00,0.00,4729,4730
6391,2,471,41,256.00,46225.00,4729,4731
6392,1,512,512,512.00,0.00,4730,4731
6393,1,512,512,512.00,0.00,4730,4731
6394,1,512,512,512.00,0.00,4730,4731
6395,2,341,171,256.00,7225.00,4730,4732
6396,1,512,512,512.00,0.00,4731,4732
6397,1,512,512,512.00,0.00,4731,4732
6398,2,502,10,256.00,60516.00,4731,4733
6399,1,512,512,512.00,0.00,4732,4733
6400,1,512,512,512.00,0.00,4732,4733
6401,2,321,191,256.00,4225.00,4732,4734
6402,1,512,512,512.00,0.00,4733,4734
6403,1,512,512,512.00,0.00,4733,4734
6404,1,512,512,512.00,0.00,4733,4734
6405,2,442,70,256.00,34596.00,4733,4735
6406,1,512,512,512.00,0.00,4734,4735
6407,1,512,512,512.00,0.00,4734,4735
6408,1,512,512,512.00,0.00,4734,4735
6409,2,425,87,256.00,28561.00,4734,4736
6410,1,512,512,512.00,0.00,4735,4736
6411,1,512,512,512.00,0.00,4735,4736
6412,1,512,512,512.00,0.00,4735,4736
6413,1,512,512,512.00,0.00,4735,4736
6414,2,386,126,256.00,16900.00,4735,4737
6415,1,512,512,512.00,0.00,4736,4737
6416,1,512,512,512.00,0.00,4736,4737
6417,1,512,512,512.00,0.00,4736,4737
6418,1,512,512,512.00,0.00,4736,4737
6419,1,512,512,512.00,0.00,4736,4737
6420,2,308,204,256.00,2704.00,4736,4738
6421,1,512,512,512.00,0.00,4737,4738
6422,1,512,512,512.00,0.00,4737,4738
6423,1,512,512,512.00,0.00,4737,4738
6424,2,415,97,256.00,25281.00,4737,4739
6425,1,512,512,512.00,0.00,4738,4739
6426,2,413,99,256.00,24649.00,4738,4740
6427,2,437,75,256.00,32761.00,4739,4741
6428,2,357,155,256.00,10201.00,4740,4742
6429,4,305,19,128.00,13493.00,4741,4745
6430,1,512,512,512.00,0.00,4744,4745
6431,1,512,512,512.00,0.00,4744,4745
6432,1,512,512,512.00,0.00,4744,4745
6433,1,512,512,512.00,0.00,4744,4745
6434,1,512,512,512.00,0.00,4744,4745
6435,3,278,106,170.67,5840.89,4744,4747
6436,2,452,60,256.00,38416.00,4746,4748
6437,1,512,512,512.00,0.00,4747,4748
6438,1,512,512,512.00,0.00,4747,4748
6439,1,512,512,512.00,0.00,4747,4748
6440,1,512,512,512.00,0.00,4747,4748
6441,4,218,5,128.00,6538.50,4747,4751
6442,1,512,512,512.00,0.00,4750,4751
6443,1,512,512,512.00,0.00,4750,4751
6444,2,266,246,256.00,100.00,4750,4752
6445,2,402,110,256.00,21316.00,4751,4753
6446,2,276,236,256.00,400.00,4752,4754
6447,1,512,512,512.00,0.00,4753,4754
6448,2,359,153,256.00,10609.00,4753,4755
6449,2,261,251,256.00,25.00,4754,4756
6450,1,512,512,512.00,0.00,4755,4756
6451,1,512,512,512.00,0.00,4755,4756
6452,1,512,512,512.00,0.00,4755,4756
6453,4,229,35,128.00,4962.50,4755,4759
6454,1,512,512,512.00,0.00,4758,4759
6455,3,456,6,170.67,41030.22,4758,4761
6456,4,387,2,128.00,24661.50,4760,4764
6457,2,435,77,256.00,32041.00,4763,4765
6458,1,512,512,512.00,0.00,4765,4766
6459,3,255,3,170.67,14056.22,4765,4768
6460,1,512,512,512.00,0.00,4767,4768
6461,1,512,512,512.00,0.00,4767,4768
6462,3,347,39,170.67,16808.22,4767,4770
6463,4,255,1,128.00,15385.00,4769,4773
6464,3,400,24,170.67,26979.56,4772,4775
6465,1,512,512,512.00,0.00,4774,4775
6466,1,512,512,512.00,0.00,4774,4775
6467,1,512,512,512.00,0.00,4774,4775
6468,4,295,2,128.00,16611.50,4774,4778
6469,2,297,215,256.00,1681.00,4777,4779
6470,3,365,4,170.67,22102.89,4778,4781
6471,2,357,155,256.00,10201.00,4780,4782
6472,1,512,512,512.00,0.00,4781,4782
6473,2,431,81,256.00,30625.00,4781,4783
6474,1,512,512,512.00,0.00,4782,4783
6475,4,337,6,128.00,15840.50,4782,4786
6476,5,171,2,102.40,6525.44,4785,4790
6477,5,239,13,102.40,5993.04,4789,4794
6478,4,324,1,128.00,18326.50,4793,4797
6479,1,512,512,512.00,0.00,4797,4798
6480,2,402,110,256.00,21316.00,4797,4799
6481,5,172,43,102.40,2850.64,4798,4803
6482,3,402,16,170.67,27771.56,4802,4805
6483,3,352,19,170.67,18921.56,4804,4807
6484,1,512,512,512.00,0.00,4806,4807
6485,1,512,512,512.00,0.00,4806,4807
6486,3,367,39,170.67,20021.56,4806,4809
6487,7,222,8,73.14,4902.69,4808,4815
6488,1,512,512,512.00,0.00,4814,4815
6489,1,512,512,512.00,0.00,4814,4815
6490,1,512,512,512.00,0.00,4814,4815
6491,1,512,512,512.00,0.00,4814,4815
6492,1,512,512,512.00,0.00,4814,4815
6493,1,512,512,512.00,0.00,4814,4815
6494,1,512,512,512.00,0.00,4814,4815
6495,1,512,512,512.00,0.00,4814,4815
6496,1,512,512,512.00,0.00,4814,4815
6497,2,309,203,256.00,2809.00,4814,4816
6498,3,483,14,170.67,48776.22,4815,4818
6499,8,134,2,64.00,2751.00,4818,4826
6500,1,512,512,512.00,0.00,4825,4826
6501,2,397,115,256.00,19881.00,4825,4827
6502,3,362,17,170.67,20546.89,4826,4829
6503,1,512,512,512.00,0.00,4828,4829
6504,2,376,136,256.00,14400.00,4828,4830
6505,2,498,14,256.00,58564.00,4829,4831
6506,1,512,512,512.00,0.00,4830,4831
6507,1,512,512,512.00,0.00,4830,4831
6508,1,512,512,512.00,0.00,4830,4831
6509,1,512,512,512.00,0.00,4830,4831
6510,9,206,1,56.89,4500.77,4830,4839
6511,1,512,512,512.00,0.00,4838,4839
6512,2,427,85,256.00,29241.00,4838,4840
6513,1,512,512,512.00,0.00,4839,4840
6514,2,259,253,256.00,9.00,4839,4841
6515,3,221,135,170.67,1340.22,4840,4843
6516,1,512,512,512.00,0.00,4842,4843
6517,1,512,512,512.00,0.00,4842,4843
6518,1,512,512,512.00,0.00,4842,4843
6519,2,421,91,256.00,27225.00,4842,4844
6520,2,490,22,256.00,54756.00,4843,4845
6521,1,512,512,512.00,0.00,4844,4845
6522,1,512,512,512.00,0.00,4844,4845
6523,1,512,512,512.00,0.00,4844,4845
6524,2,442,70,256.00,34596.00,4844,4846
6525,1,512,512,512.00,0.00,4845,4846
6526,1,512,512,512.00,0.00,4845,4846
6527,2,270,242,256.00,196.00,4845,4847
6528,1,512,512,512.00,0.00,4846,4847
6529,5,190,15,102.40,5529.04,4846,4851
6530,1,512,512,512.00,0.00,4850,4851
6531,1,512,512,512.00,0.00,4850,4851
6532,1,512,512,512.00,0.00,4850,4851
6533,1,512,512,512.00,0.00,4850,4851
6534,2,407,105,256.00,22801.00,4850,4852
6535,3,270,102,170.67,5174.22,4851,4854
6536,1,512,512,512.00,0.00,4853,4854
6537,1,512,512,512.00,0.00,4853,4854
6538,1,512,512,512.00,0.00,4853,4854
6539,1,512,512,512.00,0.00,4853,4854
6540,1,512,512,512.00,0.00,4853,4854
6541,3,315,81,170.67,10620.22,4853,4856
6542,2,406,106,256.00,22500.00,4855,4857
6543,1,512,512,512.00,0.00,4856,4857
6544,1,512,512,512.00,0.00,4856,4857
6545,2,297,215,256.00,1681.00,4856,4858
6546,2,460,52,256.00,41616.00,4857,4859
6547,2,266,246,256.00,100.00,4858,4860
6548,7,141,1,73.14,3531.27,4859,4866
6549,1,512,512,512.00,0.00,4865,4866
6550,1,512,512,512.00,0.00,4865,4866
6551,2,397,115,256.00,19881.00,4865,4867
6552,1,512,512,512.00,0.00,4866,4867
6553,1,512,512,512.00,0.00,4866,4867
6554,1,512,512,512.00,0.00,4866,4867
6555,2,501,11,256.00,60025.00,4866,4868
6556,1,512,512,512.00,0.00,4867,4868
6557,1,512,512,512.00,0.00,4867,4868
6558,1,512,512,512.00,0.00,4867,4868
6559,1,512,512,512.00,0.00,4867,4868
6560,2,333,179,256.00,5929.00,4867,4869
6561,1,512,512,512.00,0.00,4868,4869
6562,1,512,512,512.00,0.00,4868,4869
6563,2,431,81,256.00,30625.00,4868,4870
6564,1,512,512,512.00,0.00,4869,4870
6565,1,512,512,512.00,0.00,4869,4870
6566,2,313,199,256.00,3249.00,4869,4871
6567,1,512,512,512.00,0.00,4870,4871
6568,2,339,173,256.00,6889.00,4870,4872
6569,2,412,100,256.00,24336.00,4871,4873
6570,3,318,3,170.67,16744.22,4872,4875
6571,1,512,512,512.00,0.00,4874,4875
6572,1,512,512,512.00,0.00,4874,4875
6573,1,512,512,512.00,0.00,4874,4875
6574,1,512,512,512.00,0.00,4874,4875
6575,1,512,512,512.00,0.00,4874,4875
6576,2,364,148,256.00,11664.00,4874,4876
6577,2,309,203,256.00,2809.00,4875,4877
6578,1,512,512,512.00,0.00,4876,4877
6579,1,512,512,512.00,0.00,4876,4877
6580,2,488,24,256.00,53824.00,4876,4878
6581,1,512,512,512.00,0.00,4877,4878
6582,2,321,191,256.00,4225.00,4877,4879
6583,1,512,512,512.00,0.00,4878,4879
6584,1,512,512,512.00,0.00,4878,4879
6585,2,340,172,256.00,7056.00,4878,4880
6586,1,512,512,512.00,0.00,4879,4880
6587,2,426,86,256.00,28900.00,4879,4881
6588,1,512,512,512.00,0.00,4880,4881
6589,2,320,192,256.00,4096.00,4880,4882
6590,1,512,512,512.00,0.00,4881,4882
6591,1,512,512,512.00,0.00,4881,4882
6592,2,428,84,256.00,29584.00,4881,4883
6593,2,479,33,256.00,49729.00,4882,4884
6594,2,495,17,256.00,57121.00,4883,4885
6595,1,512,512,512.00,0.00,4884,4885
6596,1,512,512,512.00,0.00,4884,4885
6597,2,350,162,256.00,8836.00,4884,4886
6598,1,512,512,512.00,0.00,4885,4886
6599,1,512,512,512.00,0.00,4885,4886
6600,2,380,132,256.00,15376.00,4885,4887
6601,1,512,512,512.00,0.00,4886,4887
6602,1,512,512,512.00,0.00,4886,4887
6603,1,512,512,512.00,0.00,4886,4887
6604,2,338,174,256.00,6724.00,4886,4888
6605,1,512,512,512.00,0.00,4887,4888
6606,1,512,512,512.00,0.00,4887,4888
6607,2,487,25,256.00,53361.00,4887,4889
6608,3,373,22,170.67,21973.56,4888,4891
6609,1,512,512,512.00,0.00,4890,4891
6610,3,301,56,170.67,10126.89,4890,4893
6611,1,512,512,512.00,0.00,4892,4893
6612,1,512,512,512.00,0.00,4892,4893
6613,1,512,512,512.00,0.00,4892,4893
6614,2,392,120,256.00,18496.00,4892,4894
6615,2,292,220,256.00,1296.00,4893,4895
6616,2,403,109,256.00,21609.00,4894,4896
6617,1,512,512,512.00,0.00,4895,4896
6618,2,469,43,256.00,45369.00,4895,4897
6619,1,512,512,512.00,0.00,4896,4897
6620,5,210,15,102.40,7929.04,4896,4901
6621,1,512,512,512.00,0.00,4900,4901
6622,1,512,512,512.00,0.00,4900,4901
6623,1,512,512,512.00,0.00,4900,4901
6624,3,394,35,170.67,25322.89,4900,4903
6625,1,512,512,512.00,0.00,4902,4903
6626,3,369,21,170.67,21368.22,4902,4905
6627,1,512,512,512.00,0.00,4904,4905
6628,1,512,512,512.00,0.00,4904,4905
6629,4,318,5,128.00,14403.50,4904,4908
6630,3,440,35,170.67,36270.89,4907,4910
6631,1,512,512,512.00,0.00,4909,4910
6632,1,512,512,512.00,0.00,4909,4910
6633,2,468,44,256.00,44944.00,4909,4911
6634,1,512,512,512.00,0.00,4910,4911
6635,2,364,148,256.00,11664.00,4910,4912
6636,2,354,158,256.00,9604.00,4911,4913
6637,3,250,50,170.67,7520.89,4912,4915
6638,1,512,512,512.00,0.00,4914,4915
6639,1,512,512,512.00,0.00,4914,4915
6640,2,422,90,256.00,27556.00,4914,4916
6641,3,401,38,170.67,26730.89,4915,4918
6642,4,320,2,128.00,14930.00,4917,4921
6643,1,512,512,512.00,0.00,4920,4921
6644,1,512,512,512.00,0.00,4920,4921
6645,5,228,2,102.40,10397.84,4920,4925
6646,8,288,11,64.00,7429.00,4924,4932
6647,5,142,1,102.40,2731.84,4931,4936
6648,1,512,512,512.00,0.00,4935,4936
6649,1,512,512,512.00,0.00,4935,4936
6650,5,345,2,102.40,15785.84,4935,4940
6651,1,512,512,512.00,0.00,4939,4940
6652,1,512,512,512.00,0.00,4939,4940
6653,1,512,512,512.00,0.00,4939,4940
6654,1,512,512,512.00,0.00,4939,4940
6655,1,512,512,512.00,0.00,4939,4940
6656,1,512,512,512.00,0.00,4939,4940
6657,7,453,1,73.14,24129.27,4939,4946
6658,1,512,512,512.00,0.00,4945,4946
6659,1,512,512,512.00,0.00,4945,4946
6660,1,512,512,512.00,0.00,4945,4946
6661,1,512,512,512.00,0.00,4945,4946
6662,1,512,512,512.00,0.00,4945,4946
6663,3,297,8,170.67,14580.22,4945,4948
6664,2,275,237,256.00,361.00,4947,4949
6665,1,512,512,512.00,0.00,4948,4949
6666,8,210,1,64.00,4856.25,4948,4956
6667,2,395,117,256.00,19321.00,4955,4957
6668,4,269,27,128.00,8778.50,4956,4960
6669,1,512,512,512.00,0.00,4959,4960
6670,1,512,512,512.00,0.00,4959,4960
6671,1,512,512,512.00,0.00,4959,4960
6672,5,366,2,102.40,19018.64,4959,4964
6673,1,512,512,512.00,0.00,4963,4964
6674,1,512,512,512.00,0.00,4963,4964
6675,3,275,32,170.67,10430.89,4963,4966
6676,1,512,512,512.00,0.00,4965,4966
6677,2,337,175,256.00,6561.00,4965,4967
6678,4,364,11,128.00,19857.50,4966,4970
6679,1,512,512,512.00,0.00,4969,4970
6680,1,512,512,512.00,0.00,4969,4970
6681,6,252,1,85.33,13000.89,4969,4975
6682,2,505,7,256.00,62001.00,4974,4976
6683,6,202,1,85.33,6365.89,4975,4981
6684,1,512,512,512.00,0.00,4980,4981
6685,3,271,72,170.67,6601.56,4980,4983
6686,2,376,136,256.00,14400.00,4982,4984
6687,1,512,512,512.00,0.00,4983,4984
6688,2,453,59,256.00,38809.00,4983,4985
6689,3,281,68,170.67,7590.89,4984,4987
6690,1,512,512,512.00,0.00,4986,4987
6691,1,512,512,512.00,0.00,4986,4987
6692,1,512,512,512.00,0.00,4986,4987
6693,1,512,512,512.00,0.00,4986,4987
6694,1,512,512,512.00,0.00,4986,4987
6695,1,512,512,512.00,0.00,4986,4987
6696,3,396,26,170.67,26070.22,4986,4989
6697,7,141,3,73.14,2745.55,4988,4995
6698,1,512,512,512.00,0.00,4994,4995
6699,1,512,512,512.00,0.00,4994,4995
6700,1,512,512,512.00,0.00,4994,4995
6701,1,512,512,512.00,0.00,4994,4995
6702,1,512,512,512.00,0.00,4994,4995
6703,2,263,249,256.00,49.00,4994,4996
6704,1,512,512,512.00,0.00,4995,4996
6705,4,262,3,128.00,13865.50,4995,4999
6706,2,280,232,256.00,576.00,4998,5000
6707,1,512,512,512.00,0.00,4999,5000
6708,1,512,512,512.00,0.00,4999,5000
6709,1,512,512,512.00,0.00,4999,5000
6710,1,512,512,512.00,0.00,4999,5000
6711,1,512,512,512.00,0.00,4999,5000
6712,1,512,512,512.00,0.00,4999,5000
6713,1,512,512,512.00,0.00,4999,5000
6714,4,382,4,128.00,23335.50,4999,5003
6715,1,512,512,512.00,0.00,5002,5003
6716,1,512,512,512.00,0.00,5002,5003
6717,1,512,512,512.00,0.00,5002,5003
6718,1,512,512,512.00,0.00,5002,5003
6719,2,504,8,256.00,61504.00,5002,5004
6720,1,512,512,512.00,0.00,5003,5004
6721,2,311,201,256.00,3025.00,5003,5005
6722,1,512,512,512.00,0.00,5004,5005
6723,1,512,512,512.00,0.00,5004,5005
6724,1,512,512,512.00,0.00,5004,5005
6725,2,444,68,256.00,35344.00,5004,5006
6726,1,512,512,512.00,0.00,5005,5006
6727,5,310,1,102.40,13581.04,5005,5010
6728,2,359,153,256.00,10609.00,5009,5011
6729,10,220,1,51.20,3704.56,5010,5020
6730,1,512,512,512.00,0.00,5019,5020
6731,3,417,9,170.67,31328.22,5019,5022
6732,1,512,512,512.00,0.00,5021,5022
6733,1,512,512,512.00,0.00,5021,5022
6734,4,400,1,128.00,25684.50,5021,5025
6735,1,512,512,512.00,0.00,5024,5025
6736,1,512,512,512.00,0.00,5024,5025
6737,2,446,66,256.00,36100.00,5024,5026
6738,1,512,512,512.00,0.00,5025,5026
6739,1,512,512,512.00,0.00,5025,5026
6740,3,422,36,170.67,31638.22,5025,5028
6741,1,512,512,512.00,0.00,5027,5028
6742,1,512,512,512.00,0.00,5027,5028
6743,1,512,512,512.00,0.00,5027,5028
6744,1,512,512,512.00,0.00,5027,5028
6745,1,512,512,512.00,0.00,5027,5028
6746,2,276,236,256.00,400.00,5027,5029
6747,1,512,512,512.00,0.00,5028,5029
6748,1,512,512,512.00,0.00,5028,5029
6749,1,512,512,512.00,0.00,5028,5029
6750,2,452,60,256.00,38416.00,5028,5030
6751,3,232,93,170.67,3353.56,5029,5032
6752,1,512,512,512.00,0.00,5031,5032
6753,1,512,512,512.00,0.00,5031,5032
6754,6,352,1,85.33,15130.56,5031,5037
6755,3,301,69,170.67,9381.56,5036,5039
6756,1,512,512,512.00,0.00,5038,5039
6757,1,512,512,512.00,0.00,5038,5039
6758,1,512,512,512.00,0.00,5038,5039
6759,1,512,512,512.00,0.00,5038,5039
6760,1,512,512,512.00,0.00,5038,5039
6761,4,290,10,128.00,12948.50,5038,5042
6762,1,512,512,512.00,0.00,5041,5042
6763,1,512,512,512.00,0.00,5041,5042
6764,1,512,512,512.00,0.00,5041,5042
6765,1,512,512,512.00,0.00,5041,5042
6766,4,340,9,128.00,17937.50,5041,5045
6767,3,471,11,170.67,45160.22,5044,5047
6768,1,512,512,512.00,0.00,5046,5047
6769,2,472,40,256.00,46656.00,5046,5048
6770,3,391,2,170.67,26554.89,5047,5050
6771,7,241,1,73.14,7216.41,5049,5056
6772,1,512,512,512.00,0.00,5055,5056
6773,4,246,11,128.00,8733.50,5055,5059
6774,7,184,3,73.14,3860.69,5058,5065
6775,1,512,512,512.00,0.00,5064,5065
6776,2,492,20,256.00,55696.00,5064,5066
6777,2,362,150,256.00,11236.00,5065,5067
6778,2,474,38,256.00,47524.00,5066,5068
6779,1,512,512,512.00,0.00,5067,5068
6780,2,404,108,256.00,21904.00,5067,5069
6781,2,332,180,256.00,5776.00,5068,5070
6782,1,512,512,512.00,0.00,5069,5070
6783,2,380,132,256.00,15376.00,5069,5071
6784,3,278,92,170.67,6176.89,5070,5073
6785,1,512,512,512.00,0.00,5072,5073
6786,1,512,512,512.00,0.00,5072,5073
6787,1,512,512,512.00,0.00,5072,5073
6788,1,512,512,512.00,0.00,5072,5073
6789,2,391,121,256.00,18225.00,5072,5074
6790,1,512,512,512.00,0.00,5073,5074
6791,1,512,512,512.00,0.00,5073,5074
6792,1,512,512,512.00,0.00,5073,5074
6793,2,334,178,256.00,6084.00,5073,5075
6794,1,512,512,512.00,0.00,5074,5075
6795,1,512,512,512.00,0.00,5074,5075
6796,2,289,223,256.00,1089.00,5074,5076
6797,1,512,512,512.00,0.00,5075,5076
6798,1,512,512,512.00,0.00,5075,5076
6799,4,226,71,128.00,3676.50,5075,5079
6800,1,512,512,512.00,0.00,5078,5079
6801,2,259,253,256.00,9.00,5078,5080
6802,1,512,512,512.00,0.00,5079,5080
6803,2,483,29,256.00,51529.00,5079,5081
6804,1,512,512,512.00,0.00,5080,5081
6805,1,512,512,512.00,0.00,5080,5081
6806,5,247,26,102.40,5940.24,5080,5085
6807,1,512,512,512.00,0.00,5084,5085
6808,1,512,512,512.00,0.00,5084,5085
6809,2,503,9,256.00,61009.00,5084,5086
6810,1,512,512,512.00,0.00,5085,5086
6811,2,495,17,256.00,57121.00,5085,5087
6812,1,512,512,512.00,0.00,5086,5087
6813,1,512,512,512.00,0.00,5086,5087
6814,1,512,512,512.00,0.00,5086,5087
6815,1,512,512,512.00,0.00,5086,5087
6816,1,512,512,512.00,0.00,5086,5087
6817,2,409,103,256.00,23409.00,5086,5088
6818,1,512,512,512.00,0.00,5087,5088
6819,1,512,512,512.00,0.00,5087,5088
6820,1,512,512,512.00,0.00,5087,5088
6821,2,356,156,256.00,10000.00,5087,5089
6822,1,512,512,512.00,0.00,5088,5089
6823,1,512,512,512.00,0.00,5088,5089
6824,2,290,222,256.00,1156.00,5088,5090
6825,3,383,20,170.67,23862.89,5089,5092
6826,2,376,136,256.00,14400.00,5091,5093
6827,1,512,512,512.00,0.00,5092,5093
6828,2,329,183,256.00,5329.00,5092,5094
6829,4,265,35,128.00,7128.50,5093,5097
6830,2,494,18,256.00,56644.00,5096,5098
6831,1,512,512,512.00,0.00,5097,5098
6832,2,348,164,256.00,8464.00,5097,5099
6833,1,512,512,512.00,0.00,5098,5099
6834,1,512,512,512.00,0.00,5098,5099
6835,1,512,512,512.00,0.00,5098,5099
6836,6,183,17,85.33,4849.22,5098,5104
6837,1,512,512,512.00,0.00,5103,5104
6838,1,512,512,512.00,0.00,5103,5104
6839,2,381,131,256.00,15625.00,5103,5105
6840,1,512,512,512.00,0.00,5104,5105
6841,1,512,512,512.00,0.00,5104,5105
6842,1,512,512,512.00,0.00,5104,5105
6843,1,512,512,512.00,0.00,5104,5105
6844,3,273,12,170.67,12940.22,5104,5107
6845,3,356,29,170.67,18774.89,5106,5109
6846,1,512,512,512.00,0.00,5108,5109
6847,1,512,512,512.00,0.00,5108,5109
6848,1,512,512,512.00,0.00,5108,5109
6849,1,512,512,512.00,0.00,5108,5109
6850,3,234,81,170.67,4248.22,5108,5111
6851,2,443,69,256.00,34969.00,5110,5112
6852,1,512,512,512.00,0.00,5111,5112
6853,1,512,512,512.00,0.00,5111,5112
6854,4,196,30,128.00,4774.00,5111,5115
6855,1,512,512,512.00,0.00,5114,5115
6856,1,512,512,512.00,0.00,5114,5115
6857,2,443,69,256.00,34969.00,5114,5116
6858,1,512,512,512.00,0.00,5115,5116
6859,1,512,512,512.00,0.00,5115,5116
6860,2,324,188,256.00,4624.00,5115,5117
6861,4,453,2,128.00,35676.50,5116,5120
6862,2,369,143,256.00,12769.00,5119,5121
6863,1,512,512,512.00,0.00,5120,5121
6864,2,382,130,256.00,15876.00,5120,5122
6865,1,512,512,512.00,0.00,5121,5122
6866,2,442,70,256.00,34596.00,5121,5123
6867,1,512,512,512.00,0.00,5122,5123
6868,2,497,15,256.00,58081.00,5122,5124
6869,1,512,512,512.00,0.00,5123,5124
6870,1,512,512,512.00,0.00,5123,5124
6871,1,512,512,512.00,0.00,5123,5124
6872,2,315,197,256.00,3481.00,5123,5125
6873,1,512,512,512.00,0.00,5124,5125
6874,1,512,512,512.00,0.00,5124,5125
6875,2,409,103,256.00,23409.00,5124,5126
6876,1,512,512,512.00,0.00,5125,5126
6877,1,512,512,512.00,0.00,5125,5126
6878,1,512,512,512.00,0.00,5125,5126
6879,2,357,155,256.00,10201.00,5125,5127
6880,1,512,512,512.00,0.00,5126,5127
6881,1,512,512,512.00,0.00,5126,5127
6882,1,512,512,512.00,0.00,5126,5127
6883,2,450,62,256.00,37636.00,5126,5128
6884,2,380,132,256.00,15376.00,5127,5129
6885,1,512,512,512.00,0.00,5128,5129
6886,1,512,512,512.00,0.00,5128,5129
6887,1,512,512,512.00,0.00,5128,5129
6888,2,294,218,256.00,1444.00,5128,5130
6889,3,312,93,170.67,10020.22,5129,5132
6890,1,512,512,512.00,0.00,5131,5132
6891,1,512,512,512.00,0.00,5131,5132
6892,2,402,110,256.00,21316.00,5131,5133
6893,1,512,512,512.00,0.00,5132,5133
6894,2,322,190,256.00,4356.00,5132,5134
6895,1,512,512,512.00,0.00,5133,5134
6896,4,319,22,128.00,12968.50,5133,5137
6897,1,512,512,512.00,0.00,5136,5137
6898,1,512,512,512.00,0.00,5136,5137
6899,2,330,182,256.00,5476.00,5136,5138
6900,2,344,168,256.00,7744.00,5137,5139
6901,1,512,512,512.00,0.00,5138,5139
6902,2,334,178,256.00,6084.00,5138,5140
6903,2,407,105,256.00,22801.00,5139,5141
6904,1,512,512,512.00,0.00,5140,5141
6905,2,299,213,256.00,1849.00,5140,5142
6906,4,248,3,128.00,9589.50,5141,5145
6907,2,316,196,256.00,3600.00,5144,5146
6908,3,264,124,170.67,4355.56,5145,5148
6909,1,512,512,512.00,0.00,5147,5148
6910,1,512,512,512.00,0.00,5147,5148
6911,1,512,512,512.00,0.00,5147,5148
6912,2,454,58,256.00,39204.00,5147,5149
6913,1,512,512,512.00,0.00,5148,5149
6914,3,302,9,170.67,14768.22,5148,5151
6915,2,291,221,256.00,1225.00,5150,5152
6916,1,512,512,512.00,0.00,5151,5152
6917,2,369,143,256.00,12769.00,5151,5153
6918,1,512,512,512.00,0.00,5152,5153
6919,2,448,64,256.00,36864.00,5152,5154
6920,1,512,512,512.00,0.00,5153,5154
6921,1,512,512,512.00,0.00,5153,5154
6922,1,512,512,512.00,0.00,5153,5154
6923,2,458,54,256.00,40804.00,5153,5155
6924,1,512,512,512.00,0.00,5154,5155
6925,2,376,136,256.00,14400.00,5154,5156
6926,1,512,512,512.00,0.00,5155,5156
6927,1,512,512,512.00,0.00,5155,5156
6928,3,314,6,170.67,16038.22,5155,5158
6929,1,512,512,512.00,0.00,5157,5158
6930,1,512,512,512.00,0.00,5157,5158
6931,1,512,512,512.00,0.00,5157,5158
6932,2,436,76,256.00,32400.00,5157,5159
6933,1,512,512,512.00,0.00,5158,5159
6934,1,512,512,512.00,0.00,5158,5159
6935,1,512,512,512.00,0.00,5158,5159
6936,2,275,237,256.00,361.00,5158,5160
6937,1,512,512,512.00,0.00,5159,5160
6938,5,215,1,102.40,5304.64,5159,5164
6939,2,466,46,256.00,44100.00,5163,5165
6940,2,381,131,256.00,15625.00,5164,5166
6941,1,512,512,512.00,0.00,5165,5166
6942,2,350,162,256.00,8836.00,5165,5167
6943,1,512,512,512.00,0.00,5166,5167
6944,1,512,512,512.00,0.00,5166,5167
6945,5,361,7,102.40,17115.84,5166,5171
6946,1,512,512,512.00,0.00,5170,5171
6947,1,512,512,512.00,0.00,5170,5171
6948,4,294,4,128.00,14914.00,5170,5174
6949,2,493,19,256.00,56169.00,5173,5175
6950,1,512,512,512.00,0.00,5174,5175
6951,1,512,512,512.00,0.00,5174,5175
6952,1,512,512,512.00,0.00,5174,5175
6953,1,512,512,512.00,0.00,5174,5175
6954,2,375,137,256.00,14161.00,5174,5176
6955,1,512,512,512.00,0.00,5175,5176
6956,2,322,190,256.00,4356.00,5175,5177
6957,3,382,60,170.67,22347.56,5176,5179
6958,1,512,512,512.00,0.00,5178,5179
6959,1,512,512,512.00,0.00,5178,5179
6960,1,512,512,512.00,0.00,5178,5179
6961,1,512,512,512.00,0.00,5178,5179
6962,3,317,14,170.67,15354.89,5178,5181
6963,1,512,512,512.00,0.00,5180,5181
6964,1,512,512,512.00,0.00,5180,5181
6965,1,512,512,512.00,0.00,5180,5181
6966,2,441,71,256.00,34225.00,5180,5182
6967,1,512,512,512.00,0.00,5181,5182
6968,2,375,137,256.00,14161.00,5181,5183
6969,1,512,512,512.00,0.00,5182,5183
6970,2,498,14,256.00,58564.00,5182,5184
6971,3,372,13,170.67,22433.56,5183,5186
6972,6,154,26,85.33,1538.56,5185,5191
6973,2,300,212,256.00,1936.00,5190,5192
6974,2,495,17,256.00,57121.00,5191,5193
6975,2,321,191,256.00,4225.00,5192,5194
6976,2,298,214,256.00,1764.00,5193,5195
6977,2,447,65,256.00,36481.00,5194,5196
6978,1,512,512,512.00,0.00,5195,5196
6979,1,512,512,512.00,0.00,5195,5196
6980,1,512,512,512.00,0.00,5195,5196
6981,7,215,1,73.14,7518.41,5195,5202
6982,3,361,3,170.67,21617.56,5201,5204
6983,1,512,512,512.00,0.00,5203,5204
6984,1,512,512,512.00,0.00,5203,5204
6985,2,377,135,256.00,14641.00,5203,5205
6986,1,512,512,512.00,0.00,5204,5205
6987,2,324,188,256.00,4624.00,5204,5206
6988,1,512,512,512.00,0.00,5205,5206
6989,2,444,68,256.00,35344.00,5205,5207
6990,1,512,512,512.00,0.00,5206,5207
6991,1,512,512,512.00,0.00,5206,5207
6992,1,512,512,512.00,0.00,5206,5207
6993,2,308,204,256.00,2704.00,5206,5208
6994,2,447,65,256.00,36481.00,5207,5209
6995,2,500,12,256.00,59536.00,5208,5210
6996,1,512,512,512.00,0.00,5209,5210
6997,1,512,512,512.00,0.00,5209,5210
6998,2,505,7,256.00,62001.00,5209,5211
6999,1,512,512,512.00,0.00,5210,5211
7000,1,512,512,512.00,0.00,5210,5211
7001,1,512,512,512.00,0.00,5210,5211
7002,1,512,512,512.00,0.00,5210,5211
7003,2,430,82,256.00,30276.00,5210,5212
7004,1,512,512,512.00,0.00,5211,5212
7005,1,512,512,512.00,0.00,5211,5212
7006,2,340,172,256.00,7056.00,5211,5213
7007,1,512,512,512.00,0.00,5212,5213
7008,1,512,512,512.00,0.00,5212,5213
7009,3,314,62,170.67,11184.89,5212,5215
7010,1,512,512,512.00,0.00,5214,5215
7011,1,512,512,512.00,0.00,5214,5215
7012,1,512,512,512.00,0.00,5214,5215
7013,2,409,103,256.00,23409.00,5214,5216
7014,3,234,68,170.67,5366.22,5215,5218
7015,3,430,10,170.67,34267.56,5217,5220
7016,6,263,7,85.33,7639.56,5219,5225
7017,2,377,135,256.00,14641.00,5224,5226
7018,2,390,122,256.00,17956.00,5225,5227
7019,4,335,26,128.00,14736.50,5226,5230
7020,1,512,512,512.00,0.00,5229,5230
7021,1,512,512,512.00,0.00,5229,5230
7022,1,512,512,512.00,0.00,5229,5230
7023,2,507,5,256.00,63001.00,5229,5231
7024,2,282,230,256.00,676.00,5230,5232
7025,2,387,125,256.00,17161.00,5231,5233
7026,1,512,512,512.00,0.00,5232,5233
7027,1,512,512,512.00,0.00,5232,5233
7028,1,512,512,512.00,0.00,5232,5233
7029,2,271,241,256.00,225.00,5232,5234
7030,1,512,512,512.00,0.00,5233,5234
7031,1,512,512,512.00,0.00,5233,5234
7032,1,512,512,512.00,0.00,5233,5234
7033,2,354,158,256.00,9604.00,5233,5235
7034,1,512,512,512.00,0.00,5234,5235
7035,1,512,512,512.00,0.00,5234,5235
7036,2,357,155,256.00,10201.00,5234,5236
7037,7,125,22,73.14,1314.41,5235,5242
7038,3,465,6,170.67,43520.22,5241,5244
7039,1,512,512,512.00,0.00,5243,5244
7040,1,512,512,512.00,0.00,5243,5244
7041,1,512,512,512.00,0.00,5243,5244
7042,2,421,91,256.00,27225.00,5243,5245
7043,4,204,54,128.00,3654.00,5244,5248
7044,1,512,512,512.00,0.00,5247,5248
7045,2,314,198,256.00,3364.00,5247,5249
7046,1,512,512,512.00,0.00,5248,5249
7047,1,512,512,512.00,0.00,5248,5249
7048,8,312,1,64.00,11084.00,5248,5256
7049,1,512,512,512.00,0.00,5255,5256
7050,1,512,512,512.00,0.00,5255,5256
7051,2,268,244,256.00,144.00,5255,5257
7052,2,279,233,256.00,529.00,5256,5258
7053,1,512,512,512.00,0.00,5257,5258
7054,2,340,172,256.00,7056.00,5257,5259
7055,1,512,512,512.00,0.00,5258,5259
7056,1,512,512,512.00,0.00,5258,5259
7057,1,512,512,512.00,0.00,5258,5259
7058,5,280,12,102.40,9507.44,5258,5263
7059,3,389,1,170.67,26274.89,5262,5265
7060,8,180,3,64.00,4262.25,5264,5272
7061,1,512,512,512.00,0.00,5271,5272
7062,1,512,512,512.00,0.00,5271,5272
7063,1,512,512,512.00,0.00,5271,5272
7064,1,512,512,512.00,0.00,5271,5272
7065,2,327,185,256.00,5041.00,5271,5273
7066,2,469,43,256.00,45369.00,5272,5274
7067,1,512,512,512.00,0.00,5273,5274
7068,1,512,512,512.00,0.00,5273,5274
7069,1,512,512,512.00,0.00,5273,5274
7070,1,512,512,512.00,0.00,5273,5274
7071,4,247,22,128.00,8386.50,5273,5277
7072,2,380,132,256.00,15376.00,5276,5278
7073,1,512,512,512.00,0.00,5277,5278
7074,4,495,1,128.00,44922.50,5277,5281
7075,1,512,512,512.00,0.00,5280,5281
7076,2,284,228,256.00,784.00,5280,5282
7077,1,512,512,512.00,0.00,5281,5282
7078,2,327,185,256.00,5041.00,5281,5283
7079,3,303,78,170.67,9224.22,5282,5285
7080,1,512,512,512.00,0.00,5284,5285
7081,1,512,512,512.00,0.00,5284,5285
7082,4,209,48,128.00,4101.50,5284,5288
7083,1,512,512,512.00,0.00,5287,5288
7084,2,463,49,256.00,42849.00,5287,5289
7085,1,512,512,512.00,0.00,5288,5289
7086,4,254,20,128.00,7893.50,5288,5292
7087,1,512,512,512.00,0.00,5291,5292
7088,1,512,512,512.00,0.00,5291,5292
7089,1,512,512,512.00,0.00,5291,5292
7090,1,512,512,512.00,0.00,5291,5292
7091,1,512,512,512.00,0.00,5291,5292
7092,3,357,36,170.67,18508.22,5291,5294
7093,8,356,4,64.00,12607.00,5293,5301
7094,1,512,512,512.00,0.00,5300,5301
7095,4,375,17,128.00,21569.00,5300,5304
7096,2,306,206,256.00,2500.00,5303,5305
7097,1,512,512,512.00,0.00,5304,5305
7098,2,338,174,256.00,6724.00,5304,5306
7099,1,512,512,512.00,0.00,5305,5306
7100,3,464,16,170.67,43064.89,5305,5308
7101,1,512,512,512.00,0.00,5307,5308
7102,3,325,89,170.67,11922.89,5307,5310
7103,1,512,512,512.00,0.00,5309,5310
7104,1,512,512,512.00,0.00,5309,5310
7105,1,512,512,512.00,0.00,5309,5310
7106,2,319,193,256.00,3969.00,5309,5311
7107,1,512,512,512.00,0.00,5310,5311
7108,1,512,512,512.00,0.00,5310,5311
7109,1,512,512,512.00,0.00,5310,5311
7110,3,261,81,170.67,5400.22,5310,5313
7111,1,512,512,512.00,0.00,5312,5313
7112,1,512,512,512.00,0.00,5312,5313
7113,2,365,147,256.00,11881.00,5312,5314
7114,1,512,512,512.00,0.00,5313,5314
7115,5,403,2,102.40,23522.64,5313,5318
7116,2,372,140,256.00,13456.00,5317,5319
7117,3,270,1,170.67,14533.56,5318,5321
7118,1,512,512,512.00,0.00,5320,5321
7119,2,327,185,256.00,5041.00,5320,5322
7120,2,322,190,256.00,4356.00,5321,5323
7121,1,512,512,512.00,0.00,5322,5323
7122,2,465,47,256.00,43681.00,5322,5324
7123,2,269,243,256.00,169.00,5323,5325
7124,1,512,512,512.00,0.00,5324,5325
7125,5,277,4,102.40,10441.44,5324,5329
7126,1,512,512,512.00,0.00,5328,5329
7127,2,287,225,256.00,961.00,5328,5330
7128,1,512,512,512.00,0.00,5329,5330
7129,6,305,3,85.33,13544.22,5329,5335
7130,5,276,1,102.40,12763.44,5334,5339
7131,1,512,512,512.00,0.00,5338,5339
7132,1,512,512,512.00,0.00,5338,5339
7133,1,512,512,512.00,0.00,5338,5339
7134,2,444,68,256.00,35344.00,5338,5340
7135,1,512,512,512.00,0.00,5339,5340
7136,1,512,512,512.00,0.00,5339,5340
7137,1,512,512,512.00,0.00,5339,5340
7138,1,512,512,512.00,0.00,5339,5340
7139,1,512,512,512.00,0.00,5339,5340
7140,2,465,47,256.00,43681.00,5339,5341
7141,1,512,512,512.00,0.00,5340,5341
7142,1,512,512,512.00,0.00,5340,5341
7143,1,512,512,512.00,0.00,5340,5341
7144,1,512,512,512.00,0.00,5340,5341
7145,1,512,512,512.00,0.00,5340,5341
7146,2,306,206,256.00,2500.00,5340,5342
7147,1,512,512,512.00,0.00,5341,5342
7148,1,512,512,512.00,0.00,5341,5342
7149,1,512,512,512.00,0.00,5341,5342
7150,1,512,512,512.00,0.00,5341,5342
7151,3,445,17,170.67,37810.89,5341,5344
7152,1,512,512,512.00,0.00,5343,5344
7153,1,512,512,512.00,0.00,5343,5344
7154,1,512,512,512.00,0.00,5343,5344
7155,1,512,512,512.00,0.00,5343,5344
7156,5,273,3,102.40,8220.64,5343,5348
7157,1,512,512,512.00,0.00,5347,5348
7158,6,187,18,85.33,3903.22,5347,5353
7159,4,374,35,128.00,20253.50,5352,5356
7160,6,276,4,85.33,9237.89,5355,5361
7161,1,512,512,512.00,0.00,5360,5361
7162,1,512,512,512.00,0.00,5360,5361
7163,1,512,512,512.00,0.00,5360,5361
7164,6,231,1,85.33,8801.89,5360,5366
7165,3,291,100,170.67,7313.56,5365,5368
7166,1,512,512,512.00,0.00,5367,5368
7167,1,512,512,512.00,0.00,5367,5368
7168,3,424,1,170.67,33321.56,5367,5370
7169,3,388,61,170.67,23617.56,5369,5372
7170,1,512,512,512.00,0.00,5371,5372
7171,1,512,512,512.00,0.00,5371,5372
7172,1,512,512,512.00,0.00,5371,5372
7173,3,320,55,170.67,12270.89,5371,5374
7174,1,512,512,512.00,0.00,5373,5374
7175,1,512,512,512.00,0.00,5373,5374
7176,2,282,230,256.00,676.00,5373,5375
7177,1,512,512,512.00,0.00,5374,5375
7178,1,512,512,512.00,0.00,5374,5375
7179,5,330,4,102.40,14354.64,5375,5380
7180,1,512,512,512.00,0.00,5379,5380
7181,2,375,137,256.00,14161.00,5379,5381
7182,3,246,100,170.67,3563.56,5380,5383
7183,2,295,217,256.00,1521.00,5382,5384
7184,3,492,2,170.67,51670.22,5383,5386
7185,9,201,1,56.89,4141.88,5385,5394
7186,1,512,512,512.00,0.00,5393,5394
7187,1,512,512,512.00,0.00,5393,5394
7188,1,512,512,512.00,0.00,5393,5394
7189,5,270,2,102.40,13008.64,5393,5398
7190,1,512,512,512.00,0.00,5397,5398
7191,2,336,176,256.00,6400.00,5397,5399
7192,4,316,17,128.00,13122.50,5398,5402
7193,2,275,237,256.00,361.00,5401,5403
7194,3,423,26,170.67,32064.22,5402,5405
7195,1,512,512,512.00,0.00,5404,5405
7196,2,408,104,256.00,23104.00,5404,5406
7197,1,512,512,512.00,0.00,5405,5406
7198,1,512,512,512.00,0.00,5405,5406
7199,2,500,12,256.00,59536.00,5405,5407
7200,1,512,512,512.00,0.00,5406,5407
7201,1,512,512,512.00,0.00,5406,5407
7202,2,278,234,256.00,484.00,5406,5408
7203,6,249,4,85.33,8126.56,5407,5413
7204,7,402,1,73.14,18371.84,5412,5419
7205,5,411,4,102.40,24243.04,5418,5423
7206,1,512,512,512.00,0.00,5422,5423
7207,3,279,34,170.67,10405.56,5422,5425
7208,1,512,512,512.00,0.00,5424,5425
7209,10,193,1,51.20,2749.36,5424,5434
7210,7,206,6,73.14,4321.55,5433,5440
7211,1,512,512,512.00,0.00,5439,5440
7212,4,339,6,128.00,18469.50,5439,5443
7213,6,237,14,85.33,5491.89,5442,5448
7214,3,253,126,170.67,3397.56,5447,5450
7215,1,512,512,512.00,0.00,5449,5450
7216,1,512,512,512.00,0.00,5449,5450
7217,6,418,1,85.33,22377.56,5449,5455
7218,2,492,20,256.00,55696.00,5454,5456
7219,1,512,512,512.00,0.00,5455,5456
7220,1,512,512,512.00,0.00,5455,5456
7221,2,508,4,256.00,63504.00,5455,5457
7222,1,512,512,512.00,0.00,5456,5457
7223,4,349,8,128.00,17275.50,5456,5460
7224,2,486,26,256.00,52900.00,5459,5461
7225,2,275,237,256.00,361.00,5460,5462
7226,1,512,512,512.00,0.00,5461,5462
7227,3,403,5,170.67,28622.89,5461,5464
7228,1,512,512,512.00,0.00,5463,5464
7229,2,390,122,256.00,17956.00,5463,5465
7230,1,512,512,512.00,0.00,5464,5465
7231,1,512,512,512.00,0.00,5464,5465
7232,4,252,4,128.00,15130.00,5464,5468
7233,4,326,16,128.00,14966.00,5467,5471
7234,4,344,4,128.00,18488.00,5470,5474
7235,1,512,512,512.00,0.00,5473,5474
7236,1,512,512,512.00,0.00,5473,5474
7237,2,477,35,256.00,48841.00,5473,5475
7238,4,486,2,128.00,42750.50,5474,5478
7239,1,512,512,512.00,0.00,5477,5478
7240,5,340,1,102.40,17769.04,5477,5482
7241,9,164,2,56.89,3518.99,5481,5490
7242,3,294,47,170.67,10168.22,5489,5492
7243,1,512,512,512.00,0.00,5491,5492
7244,1,512,512,512.00,0.00,5491,5492
7245,5,171,4,102.40,4393.44,5491,5496
7246,2,452,60,256.00,38416.00,5495,5497
7247,2,350,162,256.00,8836.00,5496,5498
7248,1,512,512,512.00,0.00,5497,5498
7249,3,332,22,170.67,16096.89,5497,5500
7250,2,419,93,256.00,26569.00,5499,5501
7251,1,512,512,512.00,0.00,5500,5501
7252,5,205,2,102.40,6604.24,5500,5505
7253,2,319,193,256.00,3969.00,5504,5506
7254,1,512,512,512.00,0.00,5505,5506
7255,1,512,512,512.00,0.00,5505,5506
7256,4,286,21,128.00,10023.50,5505,5509
7257,1,512,512,512.00,0.00,5508,5509
7258,3,225,116,170.67,1980.22,5508,5511
7259,2,418,94,256.00,26244.00,5510,5512
7260,6,306,1,85.33,11777.56,5511,5517
7261,2,260,252,256.00,16.00,5516,5518
7262,2,327,185,256.00,5041.00,5517,5519
7263,1,512,512,512.00,0.00,5518,5519
7264,1,512,512,512.00,0.00,5518,5519
7265,1,512,512,512.00,0.00,5518,5519
7266,1,512,512,512.00,0.00,5518,5519
7267,6,245,5,85.33,6302.89,5518,5524
7268,2,319,193,256.00,3969.00,5523,5525
7269,3,238,78,170.67,4587.56,5524,5527
7270,1,512,512,512.00,0.00,5526,5527
7271,2,288,224,256.00,1024.00,5526,5528
7272,3,502,2,170.67,54896.89,5527,5530
7273,10,155,1,51.20,2433.56,5529,5539
7274,1,512,512,512.00,0.00,5538,5539
7275,1,512,512,512.00,0.00,5538,5539
7276,5,270,3,102.40,12765.04,5538,5543
7277,1,512,512,512.00,0.00,5542,5543
7278,7,243,1,73.14,5856.41,5542,5549
7279,3,240,124,170.67,2499.56,5548,5551
7280,1,512,512,512.00,0.00,5550,5551
7281,1,512,512,512.00,0.00,5550,5551
7282,3,283,57,170.67,8513.56,5550,5553
7283,1,512,512,512.00,0.00,5552,5553
7284,1,512,512,512.00,0.00,5552,5553
7285,1,512,512,512.00,0.00,5552,5553
7286,1,512,512,512.00,0.00,5552,5553
7287,1,512,512,512.00,0.00,5552,5553
7288,5,331,2,102.40,16241.04,5552,5557
7289,3,261,4,170.67,13921.56,5556,5559
7290,6,353,11,85.33,14567.22,5558,5564
7291,1,512,512,512.00,0.00,5563,5564
7292,6,464,4,85.33,28705.22,5563,5569
7293,1,512,512,512.00,0.00,5568,5569
7294,1,512,512,512.00,0.00,5568,5569
7295,1,512,512,512.00,0.00,5568,5569
7296,4,289,40,128.00,9160.50,5568,5572
7297,1,512,512,512.00,0.00,5571,5572
7298,1,512,512,512.00,0.00,5571,5572
7299,3,330,8,170.67,17286.22,5571,5574
7300,1,512,512,512.00,0.00,5573,5574
7301,2,321,191,256.00,4225.00,5573,5575
7302,1,512,512,512.00,0.00,5574,5575
7303,1,512,512,512.00,0.00,5574,5575
7304,1,512,512,512.00,0.00,5574,5575
7305,1,512,512,512.00,0.00,5574,5575
7306,1,512,512,512.00,0.00,5574,5575
7307,3,437,33,170.67,35480.22,5574,5577
7308,1,512,512,512.00,0.00,5576,5577
7309,2,372,140,256.00,13456.00,5576,5578
7310,2,406,106,256.00,22500.00,5577,5579
7311,3,451,20,170.67,39366.89,5578,5581
7312,2,323,189,256.00,4489.00,5580,5582
7313,1,512,512,512.00,0.00,5581,5582
7314,2,409,103,256.00,23409.00,5581,5583
7315,1,512,512,512.00,0.00,5582,5583
7316,4,218,15,128.00,5844.50,5582,5586
7317,5,299,5,102.40,15022.24,5585,5590
7318,2,424,88,256.00,28224.00,5589,5591
7319,1,512,512,512.00,0.00,5590,5591
7320,1,512,512,512.00,0.00,5590,5591
7321,2,312,200,256.00,3136.00,5590,5592
7322,1,512,512,512.00,0.00,5591,5592
7323,1,512,512,512.00,0.00,5591,5592
7324,1,512,512,512.00,0.00,5591,5592
7325,2,497,15,256.00,58081.00,5591,5593
7326,1,512,512,512.00,0.00,5592,5593
7327,4,247,15,128.00,8981.50,5592,5596
7328,2,429,83,256.00,29929.00,5595,5597
7329,2,471,41,256.00,46225.00,5596,5598
7330,1,512,512,512.00,0.00,5597,5598
7331,8,185,1,64.00,5189.50,5597,5605
7332,2,455,57,256.00,39601.00,5604,5606
7333,1,512,512,512.00,0.00,5605,5606
7334,5,267,12,102.40,11482.64,5605,5610
7335,1,512,512,512.00,0.00,5609,5610
7336,3,250,46,170.67,7963.56,5609,5612
7337,1,512,512,512.00,0.00,5611,5612
7338,3,342,4,170.67,19051.56,5611,5614
7339,1,512,512,512.00,0.00,5613,5614
7340,1,512,512,512.00,0.00,5613,5614
7341,4,319,1,128.00,13689.00,5613,5617
7342,4,201,53,128.00,2901.00,5616,5620
7343,1,512,512,512.00,0.00,5619,5620
7344,1,512,512,512.00,0.00,5619,5620
7345,1,512,512,512.00,0.00,5619,5620
7346,3,385,4,170.67,25329.56,5619,5622
7347,2,346,166,256.00,8100.00,5621,5623
7348,1,512,512,512.00,0.00,5622,5623
7349,1,512,512,512.00,0.00,5622,5623
7350,1,512,512,512.00,0.00,5622,5623
7351,1,512,512,512.00,0.00,5622,5623
7352,4,327,2,128.00,15861.50,5622,5626
7353,1,512,512,512.00,0.00,5625,5626
7354,1,512,512,512.00,0.00,5625,5626
7355,1,512,512,512.00,0.00,5625,5626
7356,1,512,512,512.00,0.00,5625,5626
7357,2,353,159,256.00,9409.00,5625,5627
7358,3,508,1,170.67,56897.56,5626,5629
7359,1,512,512,512.00,0.00,5628,5629
7360,1,512,512,512.00,0.00,5628,5629
7361,4,298,2,128.00,14716.50,5628,5632
7362,1,512,512,512.00,0.00,5631,5632
7363,1,512,512,512.00,0.00,5631,5632
7364,3,295,15,170.67,13557.56,5631,5634
7365,2,363,149,256.00,11449.00,5633,5635
7366,3,302,35,170.67,11890.89,5634,5637
7367,1,512,512,512.00,0.00,5636,5637
7368,4,343,2,128.00,19365.50,5636,5640
7369,1,512,512,512.00,0.00,5639,5640
7370,1,512,512,512.00,0.00,5639,5640
7371,2,270,242,256.00,196.00,5639,5641
7372,1,512,512,512.00,0.00,5640,5641
7373,3,203,149,170.67,542.89,5640,5643
7374,4,358,21,128.00,17999.50,5642,5646
7375,2,483,29,256.00,51529.00,5645,5647
7376,2,267,245,256.00,121.00,5646,5648
7377,1,512,512,512.00,0.00,5647,5648
7378,1,512,512,512.00,0.00,5647,5648
7379,4,197,67,128.00,3053.00,5647,5651
7380,2,296,216,256.00,1600.00,5650,5652
7381,1,512,512,512.00,0.00,5651,5652
7382,2,392,120,256.00,18496.00,5651,5653
7383,7,164,1,73.14,3078.41,5652,5659
7384,7,286,2,73.14,9118.98,5658,5665
7385,2,384,128,256.00,16384.00,5664,5666
7386,1,512,512,512.00,0.00,5665,5666
7387,1,512,512,512.00,0.00,5665,5666
7388,1,512,512,512.00,0.00,5665,5666
7389,1,512,512,512.00,0.00,5665,5666
7390,2,287,225,256.00,961.00,5665,5667
7391,2,495,17,256.00,57121.00,5666,5668
7392,1,512,512,512.00,0.00,5667,5668
7393,5,288,3,102.40,14541.84,5667,5672
7394,1,512,512,512.00,0.00,5671,5672
7395,3,350,5,170.67,19930.89,5671,5674
7396,2,331,181,256.00,5625.00,5673,5675
7397,1,512,512,512.00,0.00,5674,5675
7398,1,512,512,512.00,0.00,5674,5675
7399,1,512,512,512.00,0.00,5674,5675
7400,1,512,512,512.00,0.00,5674,5675
7401,1,512,512,512.00,0.00,5674,5675
7402,1,512,512,512.00,0.00,5674,5675
7403,4,250,14,128.00,7316.00,5674,5678
7404,5,305,1,102.40,15025.44,5677,5682
7405,1,512,512,512.00,0.00,5681,5682
7406,1,512,512,512.00,0.00,5681,5682
7407,5,304,4,102.40,11046.64,5681,5686
7408,1,512,512,512.00,0.00,5685,5686
7409,1,512,512,512.00,0.00,5685,5686
7410,3,407,24,170.67,28468.22,5685,5688
7411,6,254,2,85.33,7023.89,5687,5693
7412,2,296,216,256.00,1600.00,5692,5694
7413,1,512,512,512.00,0.00,5693,5694
7414,1,512,512,512.00,0.00,5693,5694
7415,5,287,1,102.40,11372.24,5693,5698
7416,2,314,198,256.00,3364.00,5697,5699
7417,1,512,512,512.00,0.00,5698,5699
7418,5,327,7,102.40,14360.64,5698,5703
7419,5,404,2,102.40,23001.04,5702,5707
7420,1,512,512,512.00,0.00,5706,5707
7421,1,512,512,512.00,0.00,5706,5707
7422,1,512,512,512.00,0.00,5706,5707
7423,3,455,16,170.67,40526.89,5706,5709
7424,2,478,34,256.00,49284.00,5708,5710
7425,1,512,512,512.00,0.00,5709,5710
7426,1,512,512,512.00,0.00,5709,5710
7427,3,314,4,170.67,16288.89,5709,5712
7428,5,202,1,102.40,7306.24,5711,5716
7429,5,209,1,102.40,7753.44,5715,5720
7430,3,185,156,170.67,140.22,5719,5722
7431,3,276,58,170.67,7947.56,5721,5724
7432,1,512,512,512.00,0.00,5723,5724
7433,4,188,15,128.00,4563.50,5723,5727
7434,1,512,512,512.00,0.00,5726,5727
7435,1,512,512,512.00,0.00,5726,5727
7436,5,452,1,102.40,30777.04,5726,5731
7437,1,512,512,512.00,0.00,5730,5731
7438,1,512,512,512.00,0.00,5730,5731
7439,1,512,512,512.00,0.00,5730,5731
7440,3,448,6,170.67,38907.56,5730,5733
7441,2,355,157,256.00,9801.00,5732,5734
7442,2,496,16,256.00,57600.00,5733,5735
7443,1,512,512,512.00,0.00,5734,5735
7444,5,453,13,102.40,30733.04,5734,5739
7445,2,343,169,256.00,7569.00,5738,5740
7446,1,512,512,512.00,0.00,5739,5740
7447,1,512,512,512.00,0.00,5739,5740
7448,1,512,512,512.00,0.00,5739,5740
7449,1,512,512,512.00,0.00,5739,5740
7450,3,263,54,170.67,7576.22,5739,5742
7451,1,512,512,512.00,0.00,5741,5742
7452,1,512,512,512.00,0.00,5741,5742
7453,4,218,51,128.00,3759.50,5741,5745
7454,1,512,512,512.00,0.00,5744,5745
7455,1,512,512,512.00,0.00,5744,5745
7456,2,453,59,256.00,38809.00,5744,5746
7457,2,296,216,256.00,1600.00,5745,5747
7458,3,415,7,170.67,30997.56,5746,5749
7459,2,510,2,256.00,64516.00,5748,5750
7460,1,512,512,512.00,0.00,5749,5750
7461,1,512,512,512.00,0.00,5749,5750
7462,4,289,2,128.00,16062.50,5749,5753
7463,2,438,74,256.00,33124.00,5752,5754
7464,1,512,512,512.00,0.00,5753,5754
7465,3,367,13,170.67,21633.56,5753,5756
7466,5,257,2,102.40,9926.64,5755,5760
7467,1,512,512,512.00,0.00,5759,5760
7468,1,512,512,512.00,0.00,5759,5760
7469,1,512,512,512.00,0.00,5759,5760
7470,1,512,512,512.00,0.00,5759,5760
7471,1,512,512,512.00,0.00,5759,5760
7472,1,512,512,512.00,0.00,5759,5760
7473,1,512,512,512.00,0.00,5759,5760
7474,3,354,38,170.67,17926.22,5759,5762
7475,4,254,30,128.00,6918.00,5761,5765
7476,1,512,512,512.00,0.00,5764,5765
7477,1,512,512,512.00,0.00,5764,5765
7478,1,512,512,512.00,0.00,5764,5765
7479,1,512,512,512.00,0.00,5764,5765
7480,1,512,512,512.00,0.00,5764,5765
7481,1,512,512,512.00,0.00,5764,5765
7482,1,512,512,512.00,0.00,5764,5765
7483,5,367,3,102.40,18215.84,5764,5769
7484,4,306,2,128.00,16278.00,5768,5772
7485,4,200,43,128.00,4608.50,5771,5775
7486,1,512,512,512.00,0.00,5774,5775
7487,1,512,512,512.00,0.00,5774,5775
7488,4,424,10,128.00,29633.50,5774,5778
7489,1,512,512,512.00,0.00,5777,5778
7490,3,271,55,170.67,7893.56,5777,5780
7491,4,322,9,128.00,13662.50,5779,5783
7492,1,512,512,512.00,0.00,5782,5783
7493,1,512,512,512.00,0.00,5782,5783
7494,1,512,512,512.00,0.00,5782,5783
7495,1,512,512,512.00,0.00,5782,5783
7496,1,512,512,512.00,0.00,5782,5783
7497,3,408,29,170.67,28516.22,5782,5785
7498,2,295,217,256.00,1521.00,5784,5786
7499,1,512,512,512.00,0.00,5785,5786
7500,2,451,61,256.00,38025.00,5785,5787
7501,2,385,127,256.00,16641.00,5786,5788
7502,1,512,512,512.00,0.00,5787,5788
7503,3,450,3,170.67,39536.22,5787,5790
7504,1,512,512,512.00,0.00,5789,5790
7505,1,512,512,512.00,0.00,5789,5790
7506,2,454,58,256.00,39204.00,5789,5791
7507,1,512,512,512.00,0.00,5790,5791
7508,3,286,6,170.67,14283.56,5790,5793
7509,1,512,512,512.00,0.00,5792,5793
7510,5,199,24,102.40,4286.24,5792,5797
7511,1,512,512,512.00,0.00,5796,5797
7512,1,512,512,512.00,0.00,5796,5797
7513,3,406,49,170.67,27701.56,5796,5799
7514,1,512,512,512.00,0.00,5798,5799
7515,2,301,211,256.00,2025.00,5798,5800
7516,2,317,195,256.00,3721.00,5799,5801
7517,5,271,1,102.40,10751.44,5800,5805
7518,1,512,512,512.00,0.00,5804,5805
7519,1,512,512,512.00,0.00,5804,5805
7520,2,465,47,256.00,43681.00,5804,5806
7521,1,512,512,512.00,0.00,5805,5806
7522,2,316,196,256.00,3600.00,5805,5807
7523,1,512,512,512.00,0.00,5806,5807
7524,5,243,8,102.40,10366.64,5806,5811
7525,1,512,512,512.00,0.00,5810,5811
7526,2,457,55,256.00,40401.00,5810,5812
7527,1,512,512,512.00,0.00,5811,5812
7528,1,512,512,512.00,0.00,5811,5812
7529,2,419,93,256.00,26569.00,5811,5813
7530,1,512,512,512.00,0.00,5812,5813
7531,1,512,512,512.00,0.00,5812,5813
7532,1,512,512,512.00,0.00,5812,5813
7533,1,512,512,512.00,0.00,5812,5813
7534,4,263,10,128.00,10558.50,5812,5816
7535,1,512,512,512.00,0.00,5815,5816
7536,2,449,63,256.00,37249.00,5815,5817
7537,2,508,4,256.00,63504.00,5816,5818
7538,2,413,99,256.00,24649.00,5817,5819
7539,1,512,512,512.00,0.00,5818,5819
7540,1,512,512,512.00,0.00,5818,5819
7541,2,493,19,256.00,56169.00,5818,5820
7542,2,423,89,256.00,27889.00,5819,5821
7543,1,512,512,512.00,0.00,5820,5821
7544,2,443,69,256.00,34969.00,5820,5822
7545,1,512,512,512.00,0.00,5821,5822
7546,1,512,512,512.00,0.00,5821,5822
7547,1,512,512,512.00,0.00,5821,5822
7548,1,512,512,512.00,0.00,5821,5822
7549,1,512,512,512.00,0.00,5821,5822
7550,1,512,512,512.00,0.00,5821,5822
7551,4,382,3,128.00,23390.50,5821,5825
7552,1,512,512,512.00,0.00,5824,5825
7553,2,362,150,256.00,11236.00,5824,5826
7554,2,431,81,256.00,30625.00,5825,5827
7555,1,512,512,512.00,0.00,5826,5827
7556,1,512,512,512.00,0.00,5826,5827
7557,3,233,109,170.67,2562.89,5826,5829
7558,1,512,512,512.00,0.00,5828,5829
7559,1,512,512,512.00,0.00,5828,5829
7560,1,512,512,512.00,0.00,5828,5829
7561,3,284,92,170.67,6744.89,5828,5831
7562,1,512,512,512.00,0.00,5830,5831
7563,1,512,512,512.00,0.00,5830,5831
7564,2,421,91,256.00,27225.00,5830,5832
7565,1,512,512,512.00,0.00,5831,5832
7566,1,512,512,512.00,0.00,5831,5832
7567,1,512,512,512.00,0.00,5831,5832
7568,5,315,7,102.40,13123.44,5831,5836
7569,1,512,512,512.00,0.00,5835,5836
7570,1,512,512,512.00,0.00,5835,5836
7571,1,512,512,512.00,0.00,5835,5836
7572,1,512,512,512.00,0.00,5835,5836
7573,3,385,58,170.67,22989.56,5835,5838
7574,1,512,512,512.00,0.00,5837,5838
7575,3,430,23,170.67,33842.89,5837,5840
7576,1,512,512,512.00,0.00,5839,5840
7577,1,512,512,512.00,0.00,5839,5840
7578,2,332,180,256.00,5776.00,5839,5841
7579,2,454,58,256.00,39204.00,5840,5842
7580,1,512,512,512.00,0.00,5841,5842
7581,2,280,232,256.00,576.00,5841,5843
7582,1,512,512,512.00,0.00,5842,5843
7583,1,512,512,512.00,0.00,5842,5843
7584,1,512,512,512.00,0.00,5842,5843
7585,1,512,512,512.00,0.00,5842,5843
7586,1,512,512,512.00,0.00,5842,5843
7587,2,309,203,256.00,2809.00,5842,5844
7588,1,512,512,512.00,0.00,5843,5844
7589,1,512,512,512.00,0.00,5843,5844
7590,1,512,512,512.00,0.00,5843,5844
7591,1,512,512,512.00,0.00,5843,5844
7592,1,512,512,512.00,0.00,5843,5844
7593,1,512,512,512.00,0.00,5843,5844
7594,2,378,134,256.00,14884.00,5843,5845
7595,1,512,512,512.00,0.00,5844,5845
7596,4,174,57,128.00,2273.50,5844,5848
7597,2,467,45,256.00,44521.00,5847,5849
7598,2,483,29,256.00,51529.00,5848,5850
7599,2,506,6,256.00,62500.00,5850,5852
7600,5,426,1,102.40,26613.04,5851,5856
7601,2,265,247,256.00,81.00,5855,5857
7602,1,512,512,512.00,0.00,5856,5857
7603,2,461,51,256.00,42025.00,5856,5858
7604,1,512,512,512.00,0.00,5857,5858
7605,1,512,512,512.00,0.00,5857,5858
7606,4,317,7,128.00,15281.00,5857,5861
7607,1,512,512,512.00,0.00,5860,5861
7608,2,427,85,256.00,29241.00,5860,5862
7609,2,331,181,256.00,5625.00,5861,5863
7610,4,209,46,128.00,3987.50,5862,5866
7611,2,447,65,256.00,36481.00,5865,5867
7612,1,512,512,512.00,0.00,5866,5867
7613,1,512,512,512.00,0.00,5866,5867
7614,1,512,512,512.00,0.00,5866,5867
7615,1,512,512,512.00,0.00,5866,5867
7616,1,512,512,512.00,0.00,5866,5867
7617,1,512,512,512.00,0.00,5866,5867
7618,2,478,34,256.00,49284.00,5866,5868
7619,3,478,16,170.67,47227.56,5867,5870
7620,1,512,512,512.00,0.00,5869,5870
7621,1,512,512,512.00,0.00,5869,5870
7622,1,512,512,512.00,0.00,5869,5870
7623,1,512,512,512.00,0.00,5869,5870
7624,2,487,25,256.00,53361.00,5869,5871
7625,2,353,159,256.00,9409.00,5870,5872
7626,1,512,512,512.00,0.00,5871,5872
7627,2,408,104,256.00,23104.00,5871,5873
7628,1,512,512,512.00,0.00,5872,5873
7629,1,512,512,512.00,0.00,5872,5873
7630,1,512,512,512.00,0.00,5872,5873
7631,1,512,512,512.00,0.00,5872,5873
7632,1,512,512,512.00,0.00,5872,5873
7633,1,512,512,512.00,0.00,5872,5873
7634,1,512,512,512.00,0.00,5872,5873
7635,1,512,512,512.00,0.00,5872,5873
7636,1,512,512,512.00,0.00,5872,5873
7637,2,387,125,256.00,17161.00,5872,5874
7638,1,512,512,512.00,0.00,5873,5874
7639,1,512,512,512.00,0.00,5873,5874
7640,2,409,103,256.00,23409.00,5873,5875
7641,2,461,51,256.00,42025.00,5874,5876
7642,3,292,72,170.67,8323.56,5875,5878
7643,1,512,512,512.00,0.00,5877,5878
7644,1,512,512,512.00,0.00,5877,5878
7645,5,391,7,102.40,21006.64,5877,5882
7646,4,398,5,128.00,24786.50,5881,5885
7647,1,512,512,512.00,0.00,5884,5885
7648,1,512,512,512.00,0.00,5884,5885
7649,4,400,7,128.00,25502.50,5884,5888
7650,1,512,512,512.00,0.00,5887,5888
7651,1,512,512,512.00,0.00,5887,5888
7652,3,267,54,170.67,7768.22,5887,5890
7653,1,512,512,512.00,0.00,5889,5890
7654,1,512,512,512.00,0.00,5889,5890
7655,2,287,225,256.00,961.00,5889,5891
7656,3,360,4,170.67,21379.56,5890,5893
7657,2,270,242,256.00,196.00,5892,5894
7658,1,512,512,512.00,0.00,5893,5894
7659,3,265,12,170.67,12737.56,5893,5896
7660,1,512,512,512.00,0.00,5895,5896
7661,1,512,512,512.00,0.00,5895,5896
7662,1,512,512,512.00,0.00,5895,5896
7663,2,322,190,256.00,4356.00,5895,5897
7664,2,481,31,256.00,50625.00,5896,5898
7665,1,512,512,512.00,0.00,5897,5898
7666,2,473,39,256.00,47089.00,5897,5899
7667,1,512,512,512.00,0.00,5898,5899
7668,1,512,512,512.00,0.00,5898,5899
7669,2,394,118,256.00,19044.00,5898,5900
7670,1,512,512,512.00,0.00,5899,5900
7671,1,512,512,512.00,0.00,5899,5900
7672,1,512,512,512.00,0.00,5899,5900
7673,2,502,10,256.00,60516.00,5899,5901
7674,1,512,512,512.00,0.00,5900,5901
7675,4,218,2,128.00,6156.00,5900,5904
7676,4,236,1,128.00,10821.50,5903,5907
7677,2,383,129,256.00,16129.00,5906,5908
7678,1,512,512,512.00,0.00,5907,5908
7679,1,512,512,512.00,0.00,5907,5908
7680,1,512,512,512.00,0.00,5907,5908
7681,1,512,512,512.00,0.00,5907,5908
7682,4,200,48,128.00,2912.00,5907,5911
7683,1,512,512,512.00,0.00,5910,5911
7684,3,437,24,170.67,35588.22,5910,5913
7685,2,261,251,256.00,25.00,5912,5914
7686,1,512,512,512.00,0.00,5913,5914
7687,7,243,3,73.14,5409.27,5913,5920
7688,1,512,512,512.00,0.00,5919,5920
7689,2,316,196,256.00,3600.00,5919,5921
7690,1,512,512,512.00,0.00,5920,5921
7691,2,425,87,256.00,28561.00,5920,5922
7692,1,512,512,512.00,0.00,5921,5922
7693,1,512,512,512.00,0.00,5921,5922
7694,1,512,512,512.00,0.00,5921,5922
7695,1,512,512,512.00,0.00,5921,5922
7696,1,512,512,512.00,0.00,5921,5922
7697,1,512,512,512.00,0.00,5921,5922
7698,2,406,106,256.00,22500.00,5921,5923
7699,2,414,98,256.00,24964.00,5922,5924
7700,3,377,37,170.67,21906.89,5923,5926
7701,1,512,512,512.00,0.00,5925,5926
7702,1,512,512,512.00,0.00,5925,5926
7703,1,512,512,512.00,0.00,5925,5926
7704,1,512,512,512.00,0.00,5925,5926
7705,1,512,512,512.00,0.00,5925,5926
7706,1,512,512,512.00,0.00,5925,5926
7707,2,274,238,256.00,324.00,5925,5927
7708,4,319,8,128.00,15303.50,5926,5930
7709,1,512,512,512.00,0.00,5929,5930
7710,1,512,512,512.00,0.00,5929,5930
7711,1,512,512,512.00,0.00,5929,5930
7712,2,415,97,256.00,25281.00,5929,5931
7713,1,512,512,512.00,0.00,5930,5931
7714,1,512,512,512.00,0.00,5930,5931
7715,1,512,512,512.00,0.00,5930,5931
7716,1,512,512,512.00,0.00,5930,5931
7717,1,512,512,512.00,0.00,5930,5931
7718,3,373,66,170.67,20477.56,5930,5933
7719,1,512,512,512.00,0.00,5932,5933
7720,2,390,122,256.00,17956.00,5932,5934
7721,2,424,88,256.00,28224.00,5933,5935
7722,6,382,3,85.33,18024.22,5934,5940
7723,6,335,2,85.33,14112.22,5939,5945
7724,1,512,512,512.00,0.00,5944,5945
7725,1,512,512,512.00,0.00,5944,5945
7726,1,512,512,512.00,0.00,5944,5945
7727,1,512,512,512.00,0.00,5944,5945
7728,1,512,512,512.00,0.00,5944,5945
7729,1,512,512,512.00,0.00,5944,5945
7730,2,319,193,256.00,3969.00,5944,5946
7731,1,512,512,512.00,0.00,5945,5946
7732,2,504,8,256.00,61504.00,5945,5947
7733,4,253,1,128.00,9861.00,5946,5950
7734,5,355,18,102.40,16621.84,5949,5954
7735,3,298,13,170.67,13997.56,5953,5956
7736,1,512,512,512.00,0.00,5955,5956
7737,1,512,512,512.00,0.00,5955,5956
7738,1,512,512,512.00,0.00,5955,5956
7739,1,512,512,512.00,0.00,5955,5956
7740,1,512,512,512.00,0.00,5955,5956
7741,1,512,512,512.00,0.00,5955,5956
7742,1,512,512,512.00,0.00,5955,5956
7743,1,512,512,512.00,0.00,5955,5956
7744,3,256,12,170.67,12611.56,5955,5958
7745,1,512,512,512.00,0.00,5957,5958
7746,3,377,7,170.67,23726.89,5957,5960
7747,1,512,512,512.00,0.00,5959,5960
7748,6,262,10,85.33,9510.56,5959,5965
7749,2,494,18,256.00,56644.00,5964,5966
7750,1,512,512,512.00,0.00,5965,5966
7751,1,512,512,512.00,0.00,5965,5966
7752,2,449,63,256.00,37249.00,5965,5967
7753,3,416,10,170.67,31056.89,5966,5969
7754,1,512,512,512.00,0.00,5968,5969
7755,1,512,512,512.00,0.00,5968,5969
7756,2,400,112,256.00,20736.00,5968,5970
7757,3,297,5,170.67,14984.22,5969,5972
7758,2,303,209,256.00,2209.00,5971,5973
7759,2,268,244,256.00,144.00,5972,5974
7760,1,512,512,512.00,0.00,5973,5974
7761,1,512,512,512.00,0.00,5973,5974
7762,1,512,512,512.00,0.00,5973,5974
7763,1,512,512,512.00,0.00,5973,5974
7764,1,512,512,512.00,0.00,5973,5974
7765,1,512,512,512.00,0.00,5973,5974
7766,2,445,67,256.00,35721.00,5973,5975
7767,2,297,215,256.00,1681.00,5974,5976
7768,2,315,197,256.00,3481.00,5975,5977
7769,1,512,512,512.00,0.00,5976,5977
7770,1,512,512,512.00,0.00,5976,5977
7771,2,437,75,256.00,32761.00,5976,5978
7772,1,512,512,512.00,0.00,5977,5978
7773,3,382,8,170.67,24496.89,5977,5980
7774,1,512,512,512.00,0.00,5979,5980
7775,1,512,512,512.00,0.00,5979,5980
7776,4,285,3,128.00,13238.50,5979,5983
7777,2,399,113,256.00,20449.00,5982,5984
7778,2,511,1,256.00,65025.00,5983,5985
7779,1,512,512,512.00,0.00,5984,5985
7780,1,512,512,512.00,0.00,5984,5985
7781,1,512,512,512.00,0.00,5984,5985
7782,1,512,512,512.00,0.00,5984,5985
7783,1,512,512,512.00,0.00,5984,5985
7784,1,512,512,512.00,0.00,5984,5985
7785,1,512,512,512.00,0.00,5984,5985
7786,1,512,512,512.00,0.00,5984,5985
7787,1,512,512,512.00,0.00,5984,5985
7788,3,476,2,170.67,46784.89,5984,5987
7789,1,512,512,512.00,0.00,5986,5987
7790,1,512,512,512.00,0.00,5986,5987
7791,4,186,21,128.00,4013.50,5986,5990
7792,1,512,512,512.00,0.00,5989,5990
7793,1,512,512,512.00,0.00,5989,5990
7794,1,512,512,512.00,0.00,5989,5990
7795,1,512,512,512.00,0.00,5989,5990
7796,1,512,512,512.00,0.00,5989,5990
7797,2,281,231,256.00,625.00,5989,5991
7798,4,257,48,128.00,6213.50,5990,5994
7799,1,512,512,512.00,0.00,5993,5994
7800,1,512,512,512.00,0.00,5993,5994
7801,2,281,231,256.00,625.00,5993,5995
7802,1,512,512,512.00,0.00,5994,5995
7803,2,411,101,256.00,24025.00,5994,5996
7804,7,366,9,73.14,14624.69,5995,6002
7805,1,512,512,512.00,0.00,6001,6002
7806,2,343,169,256.00,7569.00,6001,6003
7807,1,512,512,512.00,0.00,6002,6003
7808,1,512,512,512.00,0.00,6002,6003
7809,2,272,240,256.00,256.00,6002,6004
7810,1,512,512,512.00,0.00,6003,6004
7811,1,512,512,512.00,0.00,6003,6004
7812,1,512,512,512.00,0.00,6003,6004
7813,1,512,512,512.00,0.00,6003,6004
7814,3,288,1,170.67,15097.56,6003,6006
7815,1,512,512,512.00,0.00,6005,6006
7816,1,512,512,512.00,0.00,6005,6006
7817,1,512,512,512.00,0.00,6005,6006
7818,1,512,512,512.00,0.00,6005,6006
7819,1,512,512,512.00,0.00,6005,6006
7820,1,512,512,512.00,0.00,6005,6006
7821,1,512,512,512.00,0.00,6005,6006
7822,1,512,512,512.00,0.00,6005,6006
7823,4,253,7,128.00,7629.00,6005,6009
7824,1,512,512,512.00,0.00,6008,6009
7825,1,512,512,512.00,0.00,6008,6009
7826,1,512,512,512.00,0.00,6008,6009
7827,1,512,512,512.00,0.00,6008,6009
7828,2,488,24,256.00,53824.00,6008,6010
7829,1,512,512,512.00,0.00,6009,6010
7830,1,512,512,512.00,0.00,6009,6010
7831,1,512,512,512.00,0.00,6009,6010
7832,1,512,512,512.00,0.00,6009,6010
7833,1,512,512,512.00,0.00,6009,6010
7834,3,292,49,170.67,9841.56,6009,6012
7835,1,512,512,512.00,0.00,6011,6012
7836,3,349,37,170.67,17221.56,6011,6014
7837,1,512,512,512.00,0.00,6013,6014
7838,1,512,512,512.00,0.00,6013,6014
7839,3,421,3,170.67,32537.56,6013,6016
7840,1,512,512,512.00,0.00,6015,6016
7841,1,512,512,512.00,0.00,6015,6016
7842,1,512,512,512.00,0.00,6015,6016
7843,4,255,12,128.00,8272.50,6015,6019
7844,1,512,512,512.00,0.00,6018,6019
7845,2,286,226,256.00,900.00,6018,6020
7846,2,359,153,256.00,10609.00,6019,6021
7847,3,272,74,170.67,6544.89,6020,6023
7848,2,439,73,256.00,33489.00,6022,6024
7849,4,303,4,128.00,16011.50,6023,6027
7850,3,348,26,170.67,17814.22,6026,6029
7851,1,512,512,512.00,0.00,6028,6029
7852,1,512,512,512.00,0.00,6028,6029
7853,1,512,512,512.00,0.00,6028,6029
7854,1,512,512,512.00,0.00,6028,6029
7855,1,512,512,512.00,0.00,6028,6029
7856,1,512,512,512.00,0.00,6028,6029
7857,1,512,512,512.00,0.00,6028,6029
7858,3,230,73,170.67,4842.89,6028,6031
7859,1,512,512,512.00,0.00,6030,6031
7860,2,301,211,256.00,2025.00,6030,6032
7861,2,366,146,256.00,12100.00,6031,6033
7862,3,187,152,170.67,206.89,6032,6035
7863,1,512,512,512.00,0.00,6034,6035
7864,2,365,147,256.00,11881.00,6034,6036
7865,3,280,36,170.67,10243.56,6035,6038
7866,1,512,512,512.00,0.00,6037,6038
7867,1,512,512,512.00,0.00,6037,6038
7868,1,512,512,512.00,0.00,6037,6038
7869,1,512,512,512.00,0.00,6037,6038
7870,1,512,512,512.00,0.00,6037,6038
7871,3,273,84,170.67,6076.22,6037,6040
7872,1,512,512,512.00,0.00,6039,6040
7873,2,374,138,256.00,13924.00,6039,6041
7874,1,512,512,512.00,0.00,6040,6041
7875,1,512,512,512.00,0.00,6040,6041
7876,1,512,512,512.00,0.00,6040,6041
7877,2,367,145,256.00,12321.00,6040,6042
7878,1,512,512,512.00,0.00,6041,6042
7879,3,262,87,170.67,5133.56,6041,6044
7880,1,512,512,512.00,0.00,6043,6044
7881,2,364,148,256.00,11664.00,6043,6045
7882,1,512,512,512.00,0.00,6044,6045
7883,1,512,512,512.00,0.00,6044,6045
7884,1,512,512,512.00,0.00,6044,6045
7885,3,266,10,170.67,13056.89,6044,6047
7886,2,393,119,256.00,18769.00,6046,6048
7887,1,512,512,512.00,0.00,6047,6048
7888,2,485,27,256.00,52441.00,6047,6049
7889,6,261,7,85.33,7169.22,6048,6054
7890,3,458,2,170.67,41696.89,6053,6056
7891,1,512,512,512.00,0.00,6055,6056
7892,1,512,512,512.00,0.00,6055,6056
7893,1,512,512,512.00,0.00,6055,6056
7894,2,297,215,256.00,1681.00,6055,6057
7895,1,512,512,512.00,0.00,6056,6057
7896,1,512,512,512.00,0.00,6056,6057
7897,3,379,24,170.67,22905.56,6056,6059
7898,1,512,512,512.00,0.00,6058,6059
7899,2,318,194,256.00,3844.00,6058,6060
7900,1,512,512,512.00,0.00,6059,6060
7901,1,512,512,512.00,0.00,6059,6060
7902,1,512,512,512.00,0.00,6059,6060
7903,1,512,512,512.00,0.00,6059,6060
7904,1,512,512,512.00,0.00,6059,6060
7905,1,512,512,512.00,0.00,6059,6060
7906,1,512,512,512.00,0.00,6059,6060
7907,4,248,1,128.00,8341.50,6059,6063
7908,6,428,3,85.33,23612.89,6062,6068
7909,1,512,512,512.00,0.00,6067,6068
7910,2,292,220,256.00,1296.00,6067,6069
7911,1,512,512,512.00,0.00,6068,6069
7912,1,512,512,512.00,0.00,6068,6069
7913,3,210,144,170.67,806.22,6068,6071
7914,2,493,19,256.00,56169.00,6070,6072
7915,1,512,512,512.00,0.00,6071,6072
7916,1,512,512,512.00,0.00,6071,6072
7917,2,318,194,256.00,3844.00,6071,6073
7918,3,339,17,170.67,17388.22,6072,6075
7919,1,512,512,512.00,0.00,6074,6075
7920,2,479,33,256.00,49729.00,6074,6076
7921,3,382,27,170.67,23293.56,6075,6078
7922,1,512,512,512.00,0.00,6077,6078
7923,1,512,512,512.00,0.00,6077,6078
7924,1,512,512,512.00,0.00,6077,6078
7925,1,512,512,512.00,0.00,6077,6078
7926,1,512,512,512.00,0.00,6077,6078
7927,2,411,101,256.00,24025.00,6077,6079
7928,4,299,19,128.00,10905.50,6078,6082
7929,1,512,512,512.00,0.00,6081,6082
7930,1,512,512,512.00,0.00,6081,6082
7931,1,512,512,512.00,0.00,6081,6082
7932,5,238,12,102.40,6808.24,6081,6086
7933,2,280,232,256.00,576.00,6085,6087
7934,1,512,512,512.00,0.00,6086,6087
7935,1,512,512,512.00,0.00,6086,6087
7936,1,512,512,512.00,0.00,6086,6087
7937,1,512,512,512.00,0.00,6086,6087
7938,4,415,17,128.00,27557.00,6086,6090
7939,2,273,239,256.00,289.00,6089,6091
7940,1,512,512,512.00,0.00,6090,6091
7941,1,512,512,512.00,0.00,6090,6091
7942,8,227,1,64.00,6317.75,6090,6098
7943,2,381,131,256.00,15625.00,6097,6099
7944,3,341,10,170.67,18306.89,6098,6101
7945,1,512,512,512.00,0.00,6100,6101
7946,1,512,512,512.00,0.00,6100,6101
7947,1,512,512,512.00,0.00,6100,6101
7948,4,324,5,128.00,15822.50,6100,6104
7949,1,512,512,512.00,0.00,6103,6104
7950,1,512,512,512.00,0.00,6103,6104
7951,1,512,512,512.00,0.00,6103,6104
7952,2,491,21,256.00,55225.00,6103,6105
7953,1,512,512,512.00,0.00,6104,6105
7954,2,496,16,256.00,57600.00,6104,6106
7955,2,491,21,256.00,55225.00,6105,6107
7956,2,370,142,256.00,12996.00,6106,6108
7957,1,512,512,512.00,0.00,6107,6108
7958,1,512,512,512.00,0.00,6107,6108
7959,1,512,512,512.00,0.00,6107,6108
7960,1,512,512,512.00,0.00,6107,6108
7961,5,212,2,102.40,5489.04,6107,6112
7962,1,512,512,512.00,0.00,6111,6112
7963,2,469,43,256.00,45369.00,6111,6113
7964,4,281,22,128.00,12018.50,6112,6116
7965,1,512,512,512.00,0.00,6115,6116
7966,1,512,512,512.00,0.00,6115,6116
7967,2,299,213,256.00,1849.00,6115,6117
7968,2,294,218,256.00,1444.00,6116,6118
7969,2,375,137,256.00,14161.00,6117,6119
7970,2,336,176,256.00,6400.00,6118,6120
7971,2,477,35,256.00,48841.00,6119,6121
7972,3,406,50,170.67,27696.89,6120,6123
7973,3,259,119,170.67,3938.89,6122,6125
7974,1,512,512,512.00,0.00,6124,6125
7975,1,512,512,512.00,0.00,6124,6125
7976,2,320,192,256.00,4096.00,6124,6126
7977,2,492,20,256.00,55696.00,6125,6127
7978,2,411,101,256.00,24025.00,6126,6128
7979,1,512,512,512.00,0.00,6127,6128
7980,2,354,158,256.00,9604.00,6127,6129
7981,1,512,512,512.00,0.00,6128,6129
7982,1,512,512,512.00,0.00,6128,6129
7983,2,396,116,256.00,19600.00,6128,6130
7984,1,512,512,512.00,0.00,6129,6130
7985,1,512,512,512.00,0.00,6129,6130
7986,2,318,194,256.00,3844.00,6129,6131
7987,1,512,512,512.00,0.00,6130,6131
7988,2,282,230,256.00,676.00,6130,6132
7989,1,512,512,512.00,0.00,6131,6132
7990,2,379,133,256.00,15129.00,6131,6133
7991,1,512,512,512.00,0.00,6132,6133
7992,1,512,512,512.00,0.00,6132,6133
7993,1,512,512,512.00,0.00,6132,6133
7994,1,512,512,512.00,0.00,6132,6133
7995,1,512,512,512.00,0.00,6132,6133
7996,2,366,146,256.00,12100.00,6132,6134
7997,1,512,512,512.00,0.00,6133,6134
7998,1,512,512,512.00,0.00,6133,6134
7999,2,437,75,256.00,32761.00,6133,6135
8000,1,512,512,512.00,0.00,6134,6135
8001,1,512,512,512.00,0.00,6134,6135
8002,1,512,512,512.00,0.00,6134,6135
8003,2,446,66,256.00,36100.00,6134,6136
8004,3,250,34,170.67,9419.56,6135,6138
8005,1,512,512,512.00,0.00,6137,6138
8006,2,426,86,256.00,28900.00,6137,6139
8007,1,512,512,512.00,0.00,6138,6139
8008,5,163,50,102.40,2331.44,6138,6143
8009,4,216,21,128.00,7258.50,6142,6146
8010,3,242,28,170.67,10176.89,6145,6148
8011,1,512,512,512.00,0.00,6147,6148
8012,1,512,512,512.00,0.00,6147,6148
8013,2,434,78,256.00,31684.00,6147,6149
8014,1,512,512,512.00,0.00,6148,6149
8015,2,406,106,256.00,22500.00,6148,6150
8016,3,249,24,170.67,10772.22,6149,6152
8017,1,512,512,512.00,0.00,6151,6152
8018,1,512,512,512.00,0.00,6151,6152
8019,1,512,512,512.00,0.00,6151,6152
8020,2,402,110,256.00,21316.00,6151,6153
8021,1,512,512,512.00,0.00,6152,6153
8022,1,512,512,512.00,0.00,6152,6153
8023,2,480,32,256.00,50176.00,6152,6154
8024,1,512,512,512.00,0.00,6153,6154
8025,1,512,512,512.00,0.00,6153,6154
8026,1,512,512,512.00,0.00,6153,6154
8027,2,427,85,256.00,29241.00,6153,6155
8028,5,201,3,102.40,5982.24,6154,6159
8029,1,512,512,512.00,0.00,6158,6159
8030,1,512,512,512.00,0.00,6158,6159
8031,4,341,1,128.00,18611.00,6158,6162
8032,1,512,512,512.00,0.00,6161,6162
8033,1,512,512,512.00,0.00,6161,6162
8034,1,512,512,512.00,0.00,6161,6162
8035,2,393,119,256.00,18769.00,6161,6163
8036,1,512,512,512.00,0.00,6162,6163
8037,1,512,512,512.00,0.00,6162,6163
8038,1,512,512,512.00,0.00,6162,6163
8039,2,314,198,256.00,3364.00,6162,6164
8040,3,372,23,170.67,21740.22,6163,6166
8041,1,512,512,512.00,0.00,6165,6166
8042,2,316,196,256.00,3600.00,6165,6167
8043,1,512,512,512.00,0.00,6166,6167
8044,1,512,512,512.00,0.00,6166,6167
8045,1,512,512,512.00,0.00,6166,6167
8046,3,398,45,170.67,25936.22,6166,6169
8047,3,195,146,170.67,400.22,6168,6171
8048,3,395,48,170.67,25236.22,6170,6173
8049,1,512,512,512.00,0.00,6172,6173
8050,1,512,512,512.00,0.00,6172,6173
8051,1,512,512,512.00,0.00,6172,6173
8052,1,512,512,512.00,0.00,6172,6173
8053,1,512,512,512.00,0.00,6172,6173
8054,4,361,28,128.00,18388.50,6172,6176
8055,2,344,168,256.00,7744.00,6175,6177
8056,8,211,4,64.00,4243.50,6176,6184
8057,8,163,3,64.00,3279.00,6183,6191
8058,1,512,512,512.00,0.00,6190,6191
8059,2,316,196,256.00,3600.00,6190,6192
8060,2,277,235,256.00,441.00,6191,6193
8061,5,274,49,102.40,7450.24,6192,6197
8062,2,261,251,256.00,25.00,6196,6198
8063,1,512,512,512.00,0.00,6197,6198
8064,1,512,512,512.00,0.00,6197,6198
8065,2,490,22,256.00,54756.00,6197,6199
8066,1,512,512,512.00,0.00,6198,6199
8067,1,512,512,512.00,0.00,6198,6199
8068,1,512,512,512.00,0.00,6198,6199
8069,3,374,16,170.67,22544.89,6198,6201
8070,1,512,512,512.00,0.00,6200,6201
8071,1,512,512,512.00,0.00,6200,6201
8072,4,255,1,128.00,15506.50,6200,6204
8073,1,512,512,512.00,0.00,6203,6204
8074,1,512,512,512.00,0.00,6203,6204
8075,1,512,512,512.00,0.00,6203,6204
8076,2,493,19,256.00,56169.00,6203,6205
8077,1,512,512,512.00,0.00,6204,6205
8078,1,512,512,512.00,0.00,6204,6205
8079,1,512,512,512.00,0.00,6204,6205
8080,2,420,92,256.00,26896.00,6204,6206
8081,3,264,116,170.67,4398.22,6205,6208
8082,2,301,211,256.00,2025.00,6207,6209
8083,1,512,512,512.00,0.00,6208,6209
8084,1,512,512,512.00,0.00,6208,6209
8085,4,297,2,128.00,13420.50,6208,6212
8086,1,512,512,512.00,0.00,6211,6212
8087,1,512,512,512.00,0.00,6211,6212
8088,2,261,251,256.00,25.00,6211,6213
8089,1,512,512,512.00,0.00,6212,6213
8090,1,512,512,512.00,0.00,6212,6213
8091,2,321,191,256.00,4225.00,6212,6214
8092,1,512,512,512.00,0.00,6213,6214
8093,2,365,147,256.00,11881.00,6213,6215
8094,1,512,512,512.00,0.00,6214,6215
8095,2,368,144,256.00,12544.00,6214,6216
8096,7,216,11,73.14,4096.98,6215,6222
8097,3,396,5,170.67,27260.22,6221,6224
8098,2,476,36,256.00,48400.00,6223,6225
8099,1,512,512,512.00,0.00,6224,6225
8100,1,512,512,512.00,0.00,6224,6225
8101,3,447,23,170.67,38240.22,6224,6227
8102,1,512,512,512.00,0.00,6226,6227
8103,1,512,512,512.00,0.00,6226,6227
8104,1,512,512,512.00,0.00,6226,6227
8105,4,176,72,128.00,1788.50,6226,6230
8106,1,512,512,512.00,0.00,6229,6230
8107,1,512,512,512.00,0.00,6229,6230
8108,1,512,512,512.00,0.00,6229,6230
8109,1,512,512,512.00,0.00,6229,6230
8110,2,381,131,256.00,15625.00,6229,6231
8111,7,307,5,73.14,10234.12,6230,6237
8112,1,512,512,512.00,0.00,6236,6237
8113,1,512,512,512.00,0.00,6236,6237
8114,4,489,1,128.00,43507.00,6236,6240
8115,2,453,59,256.00,38809.00,6239,6241
8116,1,512,512,512.00,0.00,6240,6241
8117,1,512,512,512.00,0.00,6240,6241
8118,2,402,110,256.00,21316.00,6240,6242
8119,3,477,4,170.67,47041.56,6241,6244
8120,1,512,512,512.00,0.00,6243,6244
8121,1,512,512,512.00,0.00,6243,6244
8122,1,512,512,512.00,0.00,6243,6244
8123,3,275,52,170.67,8390.89,6243,6246
8124,4,370,26,128.00,19694.00,6245,6249
8125,2,281,231,256.00,625.00,6248,6250
8126,5,167,33,102.40,2549.84,6249,6254
8127,7,268,2,73.14,9248.69,6253,6260
8128,1,512,512,512.00,0.00,6259,6260
8129,4,173,73,128.00,1587.50,6259,6263
8130,1,512,512,512.00,0.00,6262,6263
8131,1,512,512,512.00,0.00,6262,6263
8132,4,191,55,128.00,2421.50,6262,6266
8133,7,310,2,73.14,10782.98,6265,6272
8134,3,367,4,170.67,22401.56,6271,6274
8135,2,474,38,256.00,47524.00,6273,6275
8136,1,512,512,512.00,0.00,6274,6275
8137,1,512,512,512.00,0.00,6274,6275
8138,2,482,30,256.00,51076.00,6274,6276
8139,1,512,512,512.00,0.00,6275,6276
8140,1,512,512,512.00,0.00,6275,6276
8141,1,512,512,512.00,0.00,6275,6276
8142,2,392,120,256.00,18496.00,6275,6277
8143,2,301,211,256.00,2025.00,6276,6278
8144,8,189,2,64.00,3957.50,6277,6285
8145,1,512,512,512.00,0.00,6284,6285
8146,4,405,5,128.00,26013.50,6284,6288
8147,2,455,57,256.00,39601.00,6287,6289
8148,2,428,84,256.00,29584.00,6288,6290
8149,1,512,512,512.00,0.00,6289,6290
8150,1,512,512,512.00,0.00,6289,6290
8151,2,267,245,256.00,121.00,6289,6291
8152,3,465,1,170.67,43653.56,6290,6293
8153,3,243,102,170.67,3320.22,6292,6295
8154,2,342,170,256.00,7396.00,6294,6296
8155,1,512,512,512.00,0.00,6295,6296
8156,3,344,3,170.67,19396.22,6295,6298
8157,6,240,2,85.33,8048.89,6297,6303
8158,1,512,512,512.00,0.00,6302,6303
8159,2,428,84,256.00,29584.00,6302,6304
8160,1,512,512,512.00,0.00,6303,6304
8161,1,512,512,512.00,0.00,6303,6304
8162,1,512,512,512.00,0.00,6303,6304
8163,4,399,17,128.00,25090.50,6303,6307
8164,1,512,512,512.00,0.00,6306,6307
8165,2,319,193,256.00,3969.00,6306,6308
8166,1,512,512,512.00,0.00,6307,6308
8167,1,512,512,512.00,0.00,6307,6308
8168,1,512,512,512.00,0.00,6307,6308
8169,6,251,4,85.33,8064.89,6307,6313
8170,4,294,58,128.00,9446.50,6312,6316
8171,2,273,239,256.00,289.00,6315,6317
8172,1,512,512,512.00,0.00,6316,6317
8173,6,177,10,85.33,4037.89,6316,6322
8174,1,512,512,512.00,0.00,6321,6322
8175,1,512,512,512.00,0.00,6321,6322
8176,2,422,90,256.00,27556.00,6321,6323
8177,7,245,1,73.14,7626.41,6322,6329
8178,5,245,6,102.40,8711.44,6328,6333
8179,5,155,28,102.40,2185.04,6332,6337
8180,1,512,512,512.00,0.00,6336,6337
8181,5,406,1,102.40,24371.44,6336,6341
8182,1,512,512,512.00,0.00,6340,6341
8183,1,512,512,512.00,0.00,6340,6341
8184,2,362,150,256.00,11236.00,6340,6342
8185,1,512,512,512.00,0.00,6341,6342
8186,1,512,512,512.00,0.00,6341,6342
8187,3,382,1,170.67,25061.56,6341,6344
8188,1,512,512,512.00,0.00,6343,6344
8189,1,512,512,512.00,0.00,6343,6344
8190,1,512,512,512.00,0.00,6343,6344
8191,2,387,125,256.00,17161.00,6343,6345
8192,1,512,512,512.00,0.00,6344,6345
8193,1,512,512,512.00,0.00,6344,6345
8194,1,512,512,512.00,0.00,6344,6345
8195,2,448,64,256.00,36864.00,6344,6346
8196,3,496,7,170.67,52921.56,6345,6348
8197,3,307,18,170.67,14053.56,6347,6350
8198,3,427,15,170.67,33357.56,6349,6352
8199,1,512,512,512.00,0.00,6351,6352
8200,1,512,512,512.00,0.00,6351,6352
8201,2,423,89,256.00,27889.00,6351,6353
8202,1,512,512,512.00,0.00,6352,6353
8203,1,512,512,512.00,0.00,6352,6353
8204,5,285,4,102.40,10740.24,6352,6357
8205,2,481,31,256.00,50625.00,6356,6358
8206,4,430,22,128.00,30424.50,6357,6361
8207,3,450,20,170.67,39094.22,6360,6363
8208,4,210,54,128.00,5170.50,6362,6366
8209,2,325,187,256.00,4761.00,6365,6367
8210,1,512,512,512.00,0.00,6366,6367
8211,1,512,512,512.00,0.00,6366,6367
8212,1,512,512,512.00,0.00,6366,6367
8213,1,512,512,512.00,0.00,6366,6367
8214,1,512,512,512.00,0.00,6366,6367
8215,4,273,47,128.00,7413.00,6366,6370
8216,1,512,512,512.00,0.00,6369,6370
8217,6,160,1,85.33,4115.89,6369,6375
8218,1,512,512,512.00,0.00,6374,6375
8219,2,362,150,256.00,11236.00,6374,6376
8220,1,512,512,512.00,0.00,6375,6376
8221,1,512,512,512.00,0.00,6375,6376
8222,3,443,2,170.67,37786.89,6375,6378
8223,4,437,2,128.00,32091.50,6377,6381
8224,3,441,22,170.67,36661.56,6380,6383
8225,3,339,17,170.67,17388.22,6382,6385
8226,3,251,84,170.67,4668.22,6384,6387
8227,1,512,512,512.00,0.00,6386,6387
8228,1,512,512,512.00,0.00,6386,6387
8229,1,512,512,512.00,0.00,6386,6387
8230,2,375,137,256.00,14161.00,6386,6388
8231,2,355,157,256.00,9801.00,6387,6389
8232,2,319,193,256.00,3969.00,6388,6390
8233,2,447,65,256.00,36481.00,6389,6391
8234,2,486,26,256.00,52900.00,6390,6392
8235,1,512,512,512.00,0.00,6391,6392
8236,3,473,10,170.67,45762.89,6391,6394
8237,1,512,512,512.00,0.00,6393,6394
8238,2,466,46,256.00,44100.00,6393,6395
8239,1,512,512,512.00,0.00,6394,6395
8240,2,353,159,256.00,9409.00,6394,6396
8241,1,512,512,512.00,0.00,6395,6396
8242,1,512,512,512.00,0.00,6395,6396
8243,1,512,512,512.00,0.00,6395,6396
8244,4,350,2,128.00,17586.50,6395,6399
8245,1,512,512,512.00,0.00,6398,6399
8246,1,512,512,512.00,0.00,6398,6399
8247,3,391,25,170.67,25113.56,6398,6401
8248,1,512,512,512.00,0.00,6400,6401
8249,1,512,512,512.00,0.00,6400,6401
8250,2,456,56,256.00,40000.00,6400,6402
8251,2,264,248,256.00,64.00,6401,6403
8252,1,512,512,512.00,0.00,6402,6403
8253,1,512,512,512.00,0.00,6402,6403
8254,4,165,93,128.00,1161.00,6402,6406
8255,4,251,74,128.00,5116.50,6405,6409
8256,3,214,129,170.67,1205.56,6408,6411
8257,3,238,62,170.67,6016.89,6410,6413
8258,1,512,512,512.00,0.00,6412,6413
8259,3,423,31,170.67,31957.56,6412,6415
8260,1,512,512,512.00,0.00,6414,6415
8261,1,512,512,512.00,0.00,6414,6415
8262,2,437,75,256.00,32761.00,6414,6416
8263,1,512,512,512.00,0.00,6415,6416
8264,2,314,198,256.00,3364.00,6415,6417
8265,5,388,2,102.40,20669.84,6416,6421
8266,2,344,168,256.00,7744.00,6420,6422
8267,3,353,33,170.67,18064.22,6421,6424
8268,7,355,3,73.14,14675.84,6423,6430
8269,1,512,512,512.00,0.00,6429,6430
8270,1,512,512,512.00,0.00,6429,6430
8271,1,512,512,512.00,0.00,6429,6430
8272,4,233,58,128.00,4305.50,6429,6433
8273,2,290,222,256.00,1156.00,6432,6434
8274,2,296,216,256.00,1600.00,6433,6435
8275,3,499,4,170.67,53905.56,6434,6437
8276,4,385,7,128.00,22534.50,6436,6440
8277,5,218,1,102.40,7023.44,6439,6444
8278,1,512,512,512.00,0.00,6443,6444
8279,2,283,229,256.00,729.00,6443,6445
8280,2,451,61,256.00,38025.00,6444,6446
8281,1,512,512,512.00,0.00,6445,6446
8282,3,303,24,170.67,13076.22,6445,6448
8283,4,376,27,128.00,20655.50,6447,6451
8284,2,445,67,256.00,35721.00,6450,6452
8285,1,512,512,512.00,0.00,6451,6452
8286,1,512,512,512.00,0.00,6451,6452
8287,1,512,512,512.00,0.00,6451,6452
8288,5,252,4,102.40,8304.24,6451,6456
8289,1,512,512,512.00,0.00,6455,6456
8290,1,512,512,512.00,0.00,6455,6456
8291,2,496,16,256.00,57600.00,6455,6457
8292,2,269,243,256.00,169.00,6456,6458
8293,2,379,133,256.00,15129.00,6457,6459
8294,1,512,512,512.00,0.00,6458,6459
8295,3,465,20,170.67,43324.22,6458,6461
8296,1,512,512,512.00,0.00,6460,6461
8297,1,512,512,512.00,0.00,6460,6461
8298,1,512,512,512.00,0.00,6460,6461
8299,1,512,512,512.00,0.00,6460,6461
8300,2,280,232,256.00,576.00,6460,6462
8301,2,458,54,256.00,40804.00,6461,6463
8302,2,260,252,256.00,16.00,6462,6464
8303,3,467,21,170.67,43908.22,6463,6466
8304,1,512,512,512.00,0.00,6465,6466
8305,3,227,68,170.67,5286.89,6465,6468
8306,2,503,9,256.00,61009.00,6467,6469
8307,3,455,6,170.67,40760.22,6468,6471
8308,1,512,512,512.00,0.00,6470,6471
8309,1,512,512,512.00,0.00,6470,6471
8310,1,512,512,512.00,0.00,6470,6471
8311,1,512,512,512.00,0.00,6470,6471
8312,1,512,512,512.00,0.00,6470,6471
8313,1,512,512,512.00,0.00,6470,6471
8314,1,512,512,512.00,0.00,6470,6471
8315,3,360,58,170.67,18139.56,6470,6473
8316,5,217,3,102.40,5907.04,6472,6477
8317,1,512,512,512.00,0.00,6476,6477
8318,3,374,8,170.67,23152.89,6476,6479
8319,1,512,512,512.00,0.00,6478,6479
8320,3,429,5,170.67,34256.22,6478,6481
8321,2,362,150,256.00,11236.00,6480,6482
8322,3,408,10,170.67,29339.56,6481,6484
8323,2,480,32,256.00,50176.00,6483,6485
8324,2,443,69,256.00,34969.00,6484,6486
8325,3,361,53,170.67,18450.89,6485,6488
8326,4,320,1,128.00,16857.50,6487,6491
8327,1,512,512,512.00,0.00,6490,6491
8328,1,512,512,512.00,0.00,6490,6491
8329,2,268,244,256.00,144.00,6490,6492
8330,1,512,512,512.00,0.00,6491,6492
8331,1,512,512,512.00,0.00,6491,6492
8332,1,512,512,512.00,0.00,6491,6492
8333,1,512,512,512.00,0.00,6491,6492
8334,1,512,512,512.00,0.00,6491,6492
8335,2,469,43,256.00,45369.00,6491,6493
8336,1,512,512,512.00,0.00,6492,6493
8337,1,512,512,512.00,0.00,6492,6493
8338,1,512,512,512.00,0.00,6492,6493
8339,1,512,512,512.00,0.00,6492,6493
8340,1,512,512,512.00,0.00,6492,6493
8341,1,512,512,512.00,0.00,6492,6493
8342,4,366,16,128.00,19331.50,6492,6496
8343,1,512,512,512.00,0.00,6495,6496
8344,1,512,512,512.00,0.00,6495,6496
8345,1,512,512,512.00,0.00,6495,6496
8346,1,512,512,512.00,0.00,6495,6496
8347,1,512,512,512.00,0.00,6495,6496
8348,1,512,512,512.00,0.00,6495,6496
8349,1,512,512,512.00,0.00,6495,6496
8350,3,392,40,170.67,24760.89,6495,6498
8351,2,503,9,256.00,61009.00,6497,6499
8352,2,375,137,256.00,14161.00,6498,6500
8353,1,512,512,512.00,0.00,6499,6500
8354,2,498,14,256.00,58564.00,6499,6501
8355,2,511,1,256.00,65025.00,6500,6502
8356,4,399,8,128.00,24963.50,6501,6505
8357,1,512,512,512.00,0.00,6504,6505
8358,1,512,512,512.00,0.00,6504,6505
8359,1,512,512,512.00,0.00,6504,6505
8360,1,512,512,512.00,0.00,6504,6505
8361,3,320,14,170.67,15632.89,6504,6507
8362,2,320,192,256.00,4096.00,6506,6508
8363,1,512,512,512.00,0.00,6507,6508
8364,2,479,33,256.00,49729.00,6507,6509
8365,2,505,7,256.00,62001.00,6508,6510
8366,1,512,512,512.00,0.00,6509,6510
8367,1,512,512,512.00,0.00,6509,6510
8368,2,420,92,256.00,26896.00,6509,6511
8369,2,421,91,256.00,27225.00,6510,6512
8370,1,512,512,512.00,0.00,6511,6512
8371,2,329,183,256.00,5329.00,6511,6513
8372,1,512,512,512.00,0.00,6512,6513
8373,1,512,512,512.00,0.00,6512,6513
8374,1,512,512,512.00,0.00,6512,6513
8375,2,287,225,256.00,961.00,6512,6514
8376,4,202,54,128.00,2938.00,6513,6517
8377,5,237,3,102.40,8363.84,6516,6521
8378,2,499,13,256.00,59049.00,6520,6522
8379,2,504,8,256.00,61504.00,6521,6523
8380,2,455,57,256.00,39601.00,6522,6524
8381,1,512,512,512.00,0.00,6523,6524
8382,1,512,512,512.00,0.00,6523,6524
8383,1,512,512,512.00,0.00,6523,6524
8384,1,512,512,512.00,0.00,6523,6524
8385,1,512,512,512.00,0.00,6523,6524
8386,1,512,512,512.00,0.00,6523,6524
8387,2,261,251,256.00,25.00,6523,6525
8388,2,266,246,256.00,100.00,6524,6526
8389,1,512,512,512.00,0.00,6525,6526
8390,2,399,113,256.00,20449.00,6525,6527
8391,2,312,200,256.00,3136.00,6526,6528
8392,2,468,44,256.00,44944.00,6527,6529
8393,2,403,109,256.00,21609.00,6528,6530
8394,1,512,512,512.00,0.00,6529,6530
8395,1,512,512,512.00,0.00,6529,6530
8396,1,512,512,512.00,0.00,6529,6530
8397,2,425,87,256.00,28561.00,6529,6531
8398,1,512,512,512.00,0.00,6530,6531
8399,1,512,512,512.00,0.00,6530,6531
8400,3,325,2,170.67,17490.89,6530,6533
8401,2,413,99,256.00,24649.00,6532,6534
8402,1,512,512,512.00,0.00,6533,6534
8403,1,512,512,512.00,0.00,6533,6534
8404,2,351,161,256.00,9025.00,6533,6535
8405,1,512,512,512.00,0.00,6534,6535
8406,1,512,512,512.00,0.00,6534,6535
8407,1,512,512,512.00,0.00,6534,6535
8408,1,512,512,512.00,0.00,6534,6535
8409,1,512,512,512.00,0.00,6534,6535
8410,2,368,144,256.00,12544.00,6534,6536
8411,2,493,19,256.00,56169.00,6535,6537
8412,1,512,512,512.00,0.00,6536,6537
8413,1,512,512,512.00,0.00,6536,6537
8414,1,512,512,512.00,0.00,6536,6537
8415,1,512,512,512.00,0.00,6536,6537
8416,3,482,10,170.67,48480.89,6536,6539
8417,3,207,147,170.67,680.22,6538,6541
8418,1,512,512,512.00,0.00,6540,6541
8419,2,368,144,256.00,12544.00,6540,6542
8420,1,512,512,512.00,0.00,6541,6542
8421,1,512,512,512.00,0.00,6541,6542
8422,2,469,43,256.00,45369.00,6541,6543
8423,1,512,512,512.00,0.00,6542,6543
8424,1,512,512,512.00,0.00,6542,6543
8425,4,278,59,128.00,7788.50,6542,6546
8426,2,265,247,256.00,81.00,6545,6547
8427,1,512,512,512.00,0.00,6546,6547
8428,1,512,512,512.00,0.00,6546,6547
8429,1,512,512,512.00,0.00,6546,6547
8430,1,512,512,512.00,0.00,6546,6547
8431,2,454,58,256.00,39204.00,6546,6548
8432,2,391,121,256.00,18225.00,6547,6549
8433,1,512,512,512.00,0.00,6548,6549
8434,2,467,45,256.00,44521.00,6548,6550
8435,1,512,512,512.00,0.00,6549,6550
8436,2,385,127,256.00,16641.00,6549,6551
8437,1,512,512,512.00,0.00,6550,6551
8438,1,512,512,512.00,0.00,6550,6551
8439,1,512,512,512.00,0.00,6550,6551
8440,1,512,512,512.00,0.00,6550,6551
8441,1,512,512,512.00,0.00,6550,6551
8442,1,512,512,512.00,0.00,6550,6551
8443,1,512,512,512.00,0.00,6550,6551
8444,1,512,512,512.00,0.00,6550,6551
8445,3,270,13,170.67,12709.56,6550,6553
8446,1,512,512,512.00,0.00,6552,6553
8447,2,328,184,256.00,5184.00,6552,6554
8448,1,512,512,512.00,0.00,6553,6554
8449,1,512,512,512.00,0.00,6553,6554
8450,4,332,5,128.00,17491.50,6553,6557
8451,1,512,512,512.00,0.00,6556,6557
8452,1,512,512,512.00,0.00,6556,6557
8453,1,512,512,512.00,0.00,6556,6557
8454,1,512,512,512.00,0.00,6556,6557
8455,1,512,512,512.00,0.00,6556,6557
8456,1,512,512,512.00,0.00,6556,6557
8457,1,512,512,512.00,0.00,6556,6557
8458,1,512,512,512.00,0.00,6556,6557
8459,1,512,512,512.00,0.00,6556,6557
8460,2,450,62,256.00,37636.00,6556,6558
8461,1,512,512,512.00,0.00,6557,6558
8462,1,512,512,512.00,0.00,6557,6558
8463,1,512,512,512.00,0.00,6557,6558
8464,1,512,512,512.00,0.00,6557,6558
8465,4,235,6,128.00,6936.50,6557,6561
8466,1,512,512,512.00,0.00,6560,6561
8467,4,263,17,128.00,9821.00,6560,6564
8468,1,512,512,512.00,0.00,6563,6564
8469,1,512,512,512.00,0.00,6563,6564
8470,1,512,512,512.00,0.00,6563,6564
8471,2,465,47,256.00,43681.00,6563,6565
8472,1,512,512,512.00,0.00,6564,6565
8473,5,374,5,102.40,19138.24,6564,6569
8474,1,512,512,512.00,0.00,6568,6569
8475,1,512,512,512.00,0.00,6568,6569
8476,4,223,38,128.00,6114.50,6568,6572
8477,2,425,87,256.00,28561.00,6571,6573
8478,3,277,3,170.67,14393.56,6572,6575
8479,6,198,12,85.33,4861.22,6574,6580
8480,1,512,512,512.00,0.00,6579,6580
8481,2,373,139,256.00,13689.00,6579,6581
8482,2,312,200,256.00,3136.00,6580,6582
8483,1,512,512,512.00,0.00,6581,6582
8484,5,142,2,102.40,2595.84,6581,6586
8485,1,512,512,512.00,0.00,6585,6586
8486,1,512,512,512.00,0.00,6585,6586
8487,3,370,3,170.67,22949.56,6585,6588
8488,2,467,45,256.00,44521.00,6587,6589
8489,3,405,33,170.67,27736.22,6588,6591
8490,1,512,512,512.00,0.00,6590,6591
8491,1,512,512,512.00,0.00,6590,6591
8492,1,512,512,512.00,0.00,6590,6591
8493,1,512,512,512.00,0.00,6590,6591
8494,1,512,512,512.00,0.00,6590,6591
8495,1,512,512,512.00,0.00,6590,6591
8496,1,512,512,512.00,0.00,6590,6591
8497,2,345,167,256.00,7921.00,6590,6592
8498,1,512,512,512.00,0.00,6591,6592
8499,2,310,202,256.00,2916.00,6591,6593
8500,2,463,49,256.00,42849.00,6592,6594
8501,2,319,193,256.00,3969.00,6593,6595
8502,1,512,512,512.00,0.00,6594,6595
8503,3,348,16,170.67,18627.56,6594,6597
8504,1,512,512,512.00,0.00,6596,6597
8505,2,375,137,256.00,14161.00,6596,6598
8506,1,512,512,512.00,0.00,6597,6598
8507,3,339,58,170.67,14709.56,6597,6600
8508,1,512,512,512.00,0.00,6599,6600
8509,3,210,145,170.67,797.56,6599,6602
8510,1,512,512,512.00,0.00,6601,6602
8511,1,512,512,512.00,0.00,6601,6602
8512,3,352,2,170.67,20496.89,6601,6604
8513,1,512,512,512.00,0.00,6603,6604
8514,1,512,512,512.00,0.00,6603,6604
8515,1,512,512,512.00,0.00,6603,6604
8516,3,244,83,170.67,4422.89,6603,6606
8517,1,512,512,512.00,0.00,6605,6606
8518,1,512,512,512.00,0.00,6605,6606
8519,3,277,27,170.67,11113.56,6605,6608
8520,1,512,512,512.00,0.00,6607,6608
8521,1,512,512,512.00,0.00,6607,6608
8522,1,512,512,512.00,0.00,6607,6608
8523,1,512,512,512.00,0.00,6607,6608
8524,1,512,512,512.00,0.00,6607,6608
8525,1,512,512,512.00,0.00,6607,6608
8526,2,402,110,256.00,21316.00,6607,6609
8527,2,460,52,256.00,41616.00,6608,6610
8528,1,512,512,512.00,0.00,6609,6610
8529,1,512,512,512.00,0.00,6609,6610
8530,1,512,512,512.00,0.00,6609,6610
8531,1,512,512,512.00,0.00,6609,6610
8532,1,512,512,512.00,0.00,6609,6610
8533,1,512,512,512.00,0.00,6609,6610
8534,1,512,512,512.00,0.00,6609,6610
8535,1,512,512,512.00,0.00,6609,6610
8536,1,512,512,512.00,0.00,6609,6610
8537,4,186,83,128.00,1558.50,6609,6613
8538,1,512,512,512.00,0.00,6612,6613
8539,1,512,512,512.00,0.00,6612,6613
8540,1,512,512,512.00,0.00,6612,6613
8541,2,460,52,256.00,41616.00,6612,6614
8542,1,512,512,512.00,0.00,6613,6614
8543,1,512,512,512.00,0.00,6613,6614
8544,1,512,512,512.00,0.00,6613,6614
8545,1,512,512,512.00,0.00,6613,6614
8546,2,297,215,256.00,1681.00,6613,6615
8547,1,512,512,512.00,0.00,6614,6615
8548,1,512,512,512.00,0.00,6614,6615
8549,1,512,512,512.00,0.00,6614,6615
8550,1,512,512,512.00,0.00,6614,6615
8551,1,512,512,512.00,0.00,6614,6615
8552,1,512,512,512.00,0.00,6614,6615
8553,3,417,47,170.67,30340.22,6614,6617
8554,1,512,512,512.00,0.00,6616,6617
8555,1,512,512,512.00,0.00,6616,6617
8556,1,512,512,512.00,0.00,6616,6617
8557,1,512,512,512.00,0.00,6616,6617
8558,1,512,512,512.00,0.00,6616,6617
8559,1,512,512,512.00,0.00,6616,6617
8560,2,324,188,256.00,4624.00,6616,6618
8561,1,512,512,512.00,0.00,6617,6618
8562,1,512,512,512.00,0.00,6617,6618
8563,1,512,512,512.00,0.00,6617,6618
8564,1,512,512,512.00,0.00,6617,6618
8565,1,512,512,512.00,0.00,6617,6618
8566,2,443,69,256.00,34969.00,6617,6619
8567,1,512,512,512.00,0.00,6618,6619
8568,1,512,512,512.00,0.00,6618,6619
8569,2,472,40,256.00,46656.00,6618,6620
8570,2,458,54,256.00,40804.00,6619,6621
8571,1,512,512,512.00,0.00,6620,6621
8572,1,512,512,512.00,0.00,6620,6621
8573,1,512,512,512.00,0.00,6620,6621
8574,1,512,512,512.00,0.00,6620,6621
8575,2,372,140,256.00,13456.00,6620,6622
8576,1,512,512,512.00,0.00,6621,6622
8577,1,512,512,512.00,0.00,6621,6622
8578,1,512,512,512.00,0.00,6621,6622
8579,1,512,512,512.00,0.00,6621,6622
8580,1,512,512,512.00,0.00,6621,6622
8581,2,479,33,256.00,49729.00,6621,6623
8582,1,512,512,512.00,0.00,6622,6623
8583,1,512,512,512.00,0.00,6622,6623
8584,1,512,512,512.00,0.00,6622,6623
8585,2,467,45,256.00,44521.00,6622,6624
8586,1,512,512,512.00,0.00,6623,6624
8587,1,512,512,512.00,0.00,6623,6624
8588,1,512,512,512.00,0.00,6623,6624
8589,2,509,3,256.00,64009.00,6623,6625
8590,1,512,512,512.00,0.00,6624,6625
8591,1,512,512,512.00,0.00,6624,6625
8592,1,512,512,512.00,0.00,6624,6625
8593,1,512,512,512.00,0.00,6624,6625
8594,1,512,512,512.00,0.00,6624,6625
8595,2,276,236,256.00,400.00,6624,6626
8596,1,512,512,512.00,0.00,6625,6626
8597,1,512,512,512.00,0.00,6625,6626
8598,1,512,512,512.00,0.00,6625,6626
8599,1,512,512,512.00,0.00,6625,6626
8600,1,512,512,512.00,0.00,6625,6626
8601,1,512,512,512.00,0.00,6625,6626
8602,1,512,512,512.00,0.00,6625,6626
8603,3,379,9,170.67,23905.56,6625,6628
8604,1,512,512,512.00,0.00,6627,6628
8605,1,512,512,512.00,0.00,6627,6628
8606,2,499,13,256.00,59049.00,6627,6629
8607,1,512,512,512.00,0.00,6628,6629
8608,1,512,512,512.00,0.00,6628,6629
8609,1,512,512,512.00,0.00,6628,6629
8610,1,512,512,512.00,0.00,6628,6629
8611,3,440,2,170.67,37040.89,6628,6631
8612,1,512,512,512.00,0.00,6630,6631
8613,1,512,512,512.00,0.00,6630,6631
8614,1,512,512,512.00,0.00,6630,6631
8615,1,512,512,512.00,0.00,6630,6631
8616,1,512,512,512.00,0.00,6630,6631
8617,1,512,512,512.00,0.00,6630,6631
8618,1,512,512,512.00,0.00,6630,6631
8619,1,512,512,512.00,0.00,6630,6631
8620,1,512,512,512.00,0.00,6630,6631
8621,1,512,512,512.00,0.00,6630,6631
8622,2,508,4,256.00,63504.00,6630,6632
8623,1,512,512,512.00,0.00,6631,6632
8624,1,512,512,512.00,0.00,6631,6632
8625,1,512,512,512.00,0.00,6631,6632
8626,1,512,512,512.00,0.00,6631,6632
8627,1,512,512,512.00,0.00,6631,6632
8628,1,512,512,512.00,0.00,6631,6632
8629,2,388,124,256.00,17424.00,6631,6633
8630,1,512,512,512.00,0.00,6632,6633
8631,1,512,512,512.00,0.00,6632,6633
8632,1,512,512,512.00,0.00,6632,6633
8633,1,512,512,512.00,0.00,6632,6633
8634,1,512,512,512.00,0.00,6632,6633
8635,1,512,512,512.00,0.00,6632,6633
8636,1,512,512,512.00,0.00,6632,6633
8637,2,338,174,256.00,6724.00,6632,6634
8638,1,512,512,512.00,0.00,6633,6634
8639,1,512,512,512.00,0.00,6633,6634
8640,1,512,512,512.00,0.00,6633,6634
8641,5,274,26,102.40,9323.44,6633,6638
8642,1,512,512,512.00,0.00,6637,6638
8643,1,512,512,512.00,0.00,6637,6638
8644,1,512,512,512.00,0.00,6637,6638
8645,4,254,40,128.00,8466.00,6637,6641
8646,1,512,512,512.00,0.00,6640,6641
8647,1,512,512,512.00,0.00,6640,6641
8648,1,512,512,512.00,0.00,6640,6641
8649,2,389,123,256.00,17689.00,6640,6642
8650,2,505,7,256.00,62001.00,6641,6643
8651,2,331,181,256.00,5625.00,6642,6644
8652,1,512,512,512.00,0.00,6643,6644
8653,2,502,10,256.00,60516.00,6643,6645
8654,1,512,512,512.00,0.00,6644,6645
8655,3,397,22,170.67,26453.56,6644,6647
8656,2,350,162,256.00,8836.00,6646,6648
8657,1,512,512,512.00,0.00,6647,6648
8658,1,512,512,512.00,0.00,6647,6648
8659,1,512,512,512.00,0.00,6647,6648
8660,1,512,512,512.00,0.00,6647,6648
8661,4,166,50,128.00,2194.50,6647,6651
8662,2,359,153,256.00,10609.00,6650,6652
8663,1,512,512,512.00,0.00,6651,6652
8664,2,510,2,256.00,64516.00,6651,6653
8665,1,512,512,512.00,0.00,6652,6653
8666,1,512,512,512.00,0.00,6652,6653
8667,6,219,2,85.33,7671.22,6652,6658
8668,1,512,512,512.00,0.00,6657,6658
8669,4,338,7,128.00,16140.50,6657,6661
8670,1,512,512,512.00,0.00,6660,6661
8671,1,512,512,512.00,0.00,6660,6661
8672,1,512,512,512.00,0.00,6660,6661
8673,1,512,512,512.00,0.00,6660,6661
8674,1,512,512,512.00,0.00,6660,6661
8675,2,376,136,256.00,14400.00,6660,6662
8676,2,415,97,256.00,25281.00,6661,6663
8677,1,512,512,512.00,0.00,6662,6663
8678,1,512,512,512.00,0.00,6662,6663
8679,3,262,21,170.67,11381.56,6662,6665
8680,1,512,512,512.00,0.00,6664,6665
8681,1,512,512,512.00,0.00,6664,6665
8682,1,512,512,512.00,0.00,6664,6665
8683,1,512,512,512.00,0.00,6664,6665
8684,1,512,512,512.00,0.00,6664,6665
8685,1,512,512,512.00,0.00,6664,6665
8686,1,512,512,512.00,0.00,6664,6665
8687,1,512,512,512.00,0.00,6664,6665
8688,2,458,54,256.00,40804.00,6664,6666
8689,1,512,512,512.00,0.00,6665,6666
8690,1,512,512,512.00,0.00,6665,6666
8691,2,298,214,256.00,1764.00,6665,6667
8692,1,512,512,512.00,0.00,6666,6667
8693,1,512,512,512.00,0.00,6666,6667
8694,6,259,7,85.33,6704.56,6666,6672
8695,1,512,512,512.00,0.00,6671,6672
8696,1,512,512,512.00,0.00,6671,6672
8697,1,512,512,512.00,0.00,6671,6672
8698,1,512,512,512.00,0.00,6671,6672
8699,1,512,512,512.00,0.00,6671,6672
8700,1,512,512,512.00,0.00,6671,6672
8701,1,512,512,512.00,0.00,6671,6672
8702,1,512,512,512.00,0.00,6671,6672
8703,2,463,49,256.00,42849.00,6671,6673
8704,1,512,512,512.00,0.00,6672,6673
8705,1,512,512,512.00,0.00,6672,6673
8706,1,512,512,512.00,0.00,6672,6673
8707,1,512,512,512.00,0.00,6672,6673
8708,4,279,58,128.00,7746.50,6672,6676
8709,1,512,512,512.00,0.00,6675,6676
8710,1,512,512,512.00,0.00,6675,6676
8711,1,512,512,512.00,0.00,6675,6676
8712,2,360,152,256.00,10816.00,6675,6677
8713,1,512,512,512.00,0.00,6676,6677
8714,1,512,512,512.00,0.00,6676,6677
8715,2,468,44,256.00,44944.00,6676,6678
8716,2,494,18,256.00,56644.00,6677,6679
8717,2,326,186,256.00,4900.00,6678,6680
8718,2,467,45,256.00,44521.00,6679,6681
8719,2,359,153,256.00,10609.00,6680,6682
8720,1,512,512,512.00,0.00,6681,6682
8721,1,512,512,512.00,0.00,6681,6682
8722,2,481,31,256.00,50625.00,6681,6683
8723,2,398,114,256.00,20164.00,6682,6684
8724,1,512,512,512.00,0.00,6683,6684
8725,1,512,512,512.00,0.00,6683,6684
8726,1,512,512,512.00,0.00,6683,6684
8727,2,410,102,256.00,23716.00,6683,6685
8728,1,512,512,512.00,0.00,6684,6685
8729,1,512,512,512.00,0.00,6684,6685
8730,1,512,512,512.00,0.00,6684,6685
8731,1,512,512,512.00,0.00,6684,6685
8732,1,512,512,512.00,0.00,6684,6685
8733,1,512,512,512.00,0.00,6684,6685
8734,1,512,512,512.00,0.00,6684,6685
8735,1,512,512,512.00,0.00,6684,6685
8736,1,512,512,512.00,0.00,6684,6685
8737,1,512,512,512.00,0.00,6684,6685
8738,1,512,512,512.00,0.00,6684,6685
8739,1,512,512,512.00,0.00,6684,6685
8740,4,245,1,128.00,12771.50,6684,6688
8741,1,512,512,512.00,0.00,6687,6688
8742,2,337,175,256.00,6561.00,6687,6689
8743,1,512,512,512.00,0.00,6688,6689
8744,1,512,512,512.00,0.00,6688,6689
8745,2,502,10,256.00,60516.00,6688,6690
8746,1,512,512,512.00,0.00,6689,6690
8747,2,447,65,256.00,36481.00,6689,6691
8748,2,424,88,256.00,28224.00,6690,6692
8749,3,327,16,170.67,16121.56,6691,6694
8750,1,512,512,512.00,0.00,6693,6694
8751,1,512,512,512.00,0.00,6693,6694
8752,1,512,512,512.00,0.00,6693,6694
8753,2,390,122,256.00,17956.00,6693,6695
8754,2,277,235,256.00,441.00,6694,6696
8755,3,253,80,170.67,5022.89,6695,6698
8756,1,512,512,512.00,0.00,6697,6698
8757,1,512,512,512.00,0.00,6697,6698
8758,1,512,512,512.00,0.00,6697,6698
8759,1,512,512,512.00,0.00,6697,6698
8760,1,512,512,512.00,0.00,6697,6698
8761,1,512,512,512.00,0.00,6697,6698
8762,2,281,231,256.00,625.00,6697,6699
8763,1,512,512,512.00,0.00,6698,6699
8764,1,512,512,512.00,0.00,6698,6699
8765,1,512,512,512.00,0.00,6698,6699
8766,1,512,512,512.00,0.00,6698,6699
8767,1,512,512,512.00,0.00,6698,6699
8768,2,365,147,256.00,11881.00,6698,6700
8769,1,512,512,512.00,0.00,6699,6700
8770,1,512,512,512.00,0.00,6699,6700
8771,1,512,512,512.00,0.00,6699,6700
8772,1,512,512,512.00,0.00,6699,6700
8773,1,512,512,512.00,0.00,6699,6700
8774,2,419,93,256.00,26569.00,6699,6701
8775,1,512,512,512.00,0.00,6700,6701
8776,1,512,512,512.00,0.00,6700,6701
8777,1,512,512,512.00,0.00,6700,6701
8778,1,512,512,512.00,0.00,6700,6701
8779,1,512,512,512.00,0.00,6700,6701
8780,2,437,75,256.00,32761.00,6700,6702
8781,2,426,86,256.00,28900.00,6701,6703
8782,3,379,21,170.67,23081.56,6702,6705
8783,2,416,96,256.00,25600.00,6704,6706
8784,1,512,512,512.00,0.00,6705,6706
8785,1,512,512,512.00,0.00,6705,6706
8786,1,512,512,512.00,0.00,6705,6706
8787,3,495,3,170.67,52616.22,6705,6708
8788,1,512,512,512.00,0.00,6707,6708
8789,1,512,512,512.00,0.00,6707,6708
8790,3,297,49,170.67,10261.56,6707,6710
8791,1,512,512,512.00,0.00,6709,6710
8792,1,512,512,512.00,0.00,6709,6710
8793,3,311,79,170.67,10154.89,6709,6712
8794,1,512,512,512.00,0.00,6711,6712
8795,1,512,512,512.00,0.00,6711,6712
8796,1,512,512,512.00,0.00,6711,6712
8797,1,512,512,512.00,0.00,6711,6712
8798,3,312,3,170.67,16260.22,6711,6714
8799,1,512,512,512.00,0.00,6713,6714
8800,2,275,237,256.00,361.00,6713,6715
8801,1,512,512,512.00,0.00,6714,6715
8802,1,512,512,512.00,0.00,6714,6715
8803,2,342,170,256.00,7396.00,6714,6716
8804,1,512,512,512.00,0.00,6715,6716
8805,1,512,512,512.00,0.00,6715,6716
8806,1,512,512,512.00,0.00,6715,6716
8807,2,348,164,256.00,8464.00,6715,6717
8808,1,512,512,512.00,0.00,6716,6717
8809,1,512,512,512.00,0.00,6716,6717
8810,1,512,512,512.00,0.00,6716,6717
8811,1,512,512,512.00,0.00,6716,6717
8812,1,512,512,512.00,0.00,6716,6717
8813,2,372,140,256.00,13456.00,6716,6718
8814,1,512,512,512.00,0.00,6717,6718
8815,1,512,512,512.00,0.00,6717,6718
8816,1,512,512,512.00,0.00,6717,6718
8817,1,512,512,512.00,0.00,6717,6718
8818,2,367,145,256.00,12321.00,6717,6719
8819,1,512,512,512.00,0.00,6718,6719
8820,1,512,512,512.00,0.00,6718,6719
8821,1,512,512,512.00,0.00,6718,6719
8822,2,427,85,256.00,29241.00,6718,6720
8823,1,512,512,512.00,0.00,6719,6720
8824,1,512,512,512.00,0.00,6719,6720
8825,1,512,512,512.00,0.00,6719,6720
8826,2,315,197,256.00,3481.00,6719,6721
8827,1,512,512,512.00,0.00,6720,6721
8828,1,512,512,512.00,0.00,6720,6721
8829,2,333,179,256.00,5929.00,6720,6722
8830,1,512,512,512.00,0.00,6721,6722
8831,1,512,512,512.00,0.00,6721,6722
8832,1,512,512,512.00,0.00,6721,6722
8833,1,512,512,512.00,0.00,6721,6722
8834,2,313,199,256.00,3249.00,6721,6723
8835,1,512,512,512.00,0.00,6722,6723
8836,1,512,512,512.00,0.00,6722,6723
8837,1,512,512,512.00,0.00,6722,6723
8838,1,512,512,512.00,0.00,6722,6723
8839,4,334,21,128.00,15599.50,6722,6726
8840,2,400,112,256.00,20736.00,6725,6727
8841,1,512,512,512.00,0.00,6726,6727
8842,2,423,89,256.00,27889.00,6726,6728
8843,1,512,512,512.00,0.00,6727,6728
8844,1,512,512,512.00,0.00,6727,6728
8845,1,512,512,512.00,0.00,6727,6728
8846,2,331,181,256.00,5625.00,6727,6729
8847,2,487,25,256.00,53361.00,6728,6730
8848,2,444,68,256.00,35344.00,6729,6731
8849,3,448,22,170.67,38523.56,6730,6733
8850,2,462,50,256.00,42436.00,6732,6734
8851,1,512,512,512.00,0.00,6733,6734
8852,2,376,136,256.00,14400.00,6733,6735
8853,4,293,5,128.00,15709.50,6734,6738
8854,2,290,222,256.00,1156.00,6737,6739
8855,1,512,512,512.00,0.00,6738,6739
8856,1,512,512,512.00,0.00,6738,6739
8857,3,412,49,170.67,29121.56,6738,6741
8858,1,512,512,512.00,0.00,6740,6741
8859,1,512,512,512.00,0.00,6740,6741
8860,1,512,512,512.00,0.00,6740,6741
8861,1,512,512,512.00,0.00,6740,6741
8862,2,352,160,256.00,9216.00,6740,6742
8863,1,512,512,512.00,0.00,6741,6742
8864,1,512,512,512.00,0.00,6741,6742
8865,1,512,512,512.00,0.00,6741,6742
8866,2,288,224,256.00,1024.00,6741,6743
8867,1,512,512,512.00,0.00,6742,6743
8868,1,512,512,512.00,0.00,6742,6743
8869,2,452,60,256.00,38416.00,6742,6744
8870,1,512,512,512.00,0.00,6743,6744
8871,2,497,15,256.00,58081.00,6743,6745
8872,1,512,512,512.00,0.00,6744,6745
8873,1,512,512,512.00,0.00,6744,6745
8874,2,380,132,256.00,15376.00,6744,6746
8875,1,512,512,512.00,0.00,6745,6746
8876,1,512,512,512.00,0.00,6745,6746
8877,2,418,94,256.00,26244.00,6745,6747
8878,1,512,512,512.00,0.00,6746,6747
8879,1,512,512,512.00,0.00,6746,6747
8880,1,512,512,512.00,0.00,6746,6747
8881,2,445,67,256.00,35721.00,6746,6748
8882,1,512,512,512.00,0.00,6747,6748
8883,1,512,512,512.00,0.00,6747,6748
8884,1,512,512,512.00,0.00,6747,6748
8885,2,319,193,256.00,3969.00,6747,6749
8886,1,512,512,512.00,0.00,6748,6749
8887,2,509,3,256.00,64009.00,6748,6750
8888,1,512,512,512.00,0.00,6749,6750
8889,1,512,512,512.00,0.00,6749,6750
8890,2,272,240,256.00,256.00,6749,6751
8891,4,353,1,128.00,20001.50,6750,6754
8892,1,512,512,512.00,0.00,6753,6754
8893,1,512,512,512.00,0.00,6753,6754
8894,1,512,512,512.00,0.00,6753,6754
8895,1,512,512,512.00,0.00,6753,6754
8896,3,469,3,170.67,44729.56,6753,6756
8897,1,512,512,512.00,0.00,6755,6756
8898,1,512,512,512.00,0.00,6755,6756
8899,4,221,28,128.00,4921.50,6755,6759
8900,2,290,222,256.00,1156.00,6758,6760
8901,2,491,21,256.00,55225.00,6759,6761
8902,1,512,512,512.00,0.00,6760,6761
8903,1,512,512,512.00,0.00,6760,6761
8904,1,512,512,512.00,0.00,6760,6761
8905,2,279,233,256.00,529.00,6760,6762
8906,1,512,512,512.00,0.00,6761,6762
8907,1,512,512,512.00,0.00,6761,6762
8908,1,512,512,512.00,0.00,6761,6762
8909,3,271,97,170.67,5401.56,6761,6764
8910,1,512,512,512.00,0.00,6763,6764
8911,1,512,512,512.00,0.00,6763,6764
8912,2,378,134,256.00,14884.00,6763,6765
8913,1,512,512,512.00,0.00,6764,6765
8914,2,496,16,256.00,57600.00,6764,6766
8915,1,512,512,512.00,0.00,6765,6766
8916,1,512,512,512.00,0.00,6765,6766
8917,2,329,183,256.00,5329.00,6765,6767
8918,1,512,512,512.00,0.00,6766,6767
8919,2,305,207,256.00,2401.00,6766,6768
8920,1,512,512,512.00,0.00,6767,6768
8921,1,512,512,512.00,0.00,6767,6768
8922,1,512,512,512.00,0.00,6767,6768
8923,1,512,512,512.00,0.00,6767,6768
8924,3,337,13,170.67,17533.56,6767,6770
8925,2,386,126,256.00,16900.00,6769,6771
8926,1,512,512,512.00,0.00,6770,6771
8927,1,512,512,512.00,0.00,6770,6771
8928,2,404,108,256.00,21904.00,6770,6772
8929,1,512,512,512.00,0.00,6771,6772
8930,3,274,70,170.67,6939.56,6771,6774
8931,2,324,188,256.00,4624.00,6773,6775
8932,1,512,512,512.00,0.00,6774,6775
8933,2,358,154,256.00,10404.00,6774,6776
8934,1,512,512,512.00,0.00,6775,6776
8935,1,512,512,512.00,0.00,6775,6776
8936,2,276,236,256.00,400.00,6775,6777
8937,4,236,25,128.00,10324.50,6776,6780
8938,1,512,512,512.00,0.00,6779,6780
8939,1,512,512,512.00,0.00,6779,6780
8940,1,512,512,512.00,0.00,6779,6780
8941,2,454,58,256.00,39204.00,6779,6781
8942,2,426,86,256.00,28900.00,6781,6783
8943,2,409,103,256.00,23409.00,6782,6784
8944,1,512,512,512.00,0.00,6783,6784
8945,2,354,158,256.00,9604.00,6783,6785
8946,7,148,2,73.14,2974.12,6784,6791
8947,2,497,15,256.00,58081.00,6790,6792
8948,3,296,33,170.67,11604.22,6791,6794
8949,1,512,512,512.00,0.00,6793,6794
8950,1,512,512,512.00,0.00,6793,6794
8951,1,512,512,512.00,0.00,6793,6794
8952,5,423,3,102.40,25824.64,6793,6798
8953,5,256,18,102.40,6855.44,6797,6802
8954,1,512,512,512.00,0.00,6801,6802
8955,1,512,512,512.00,0.00,6801,6802
8956,1,512,512,512.00,0.00,6801,6802
8957,1,512,512,512.00,0.00,6801,6802
8958,1,512,512,512.00,0.00,6801,6802
8959,4,308,2,128.00,14058.00,6801,6805
8960,1,512,512,512.00,0.00,6804,6805
8961,2,332,180,256.00,5776.00,6804,6806
8962,1,512,512,512.00,0.00,6805,6806
8963,1,512,512,512.00,0.00,6805,6806
8964,1,512,512,512.00,0.00,6805,6806
8965,1,512,512,512.00,0.00,6805,6806
8966,1,512,512,512.00,0.00,6805,6806
8967,1,512,512,512.00,0.00,6805,6806
8968,3,418,7,170.67,31653.56,6805,6808
8969,1,512,512,512.00,0.00,6807,6808
8970,5,269,1,102.40,9384.24,6807,6812
8971,1,512,512,512.00,0.00,6811,6812
8972,2,297,215,256.00,1681.00,6811,6813
8973,2,320,192,256.00,4096.00,6812,6814
8974,1,512,512,512.00,0.00,6813,6814
8975,2,364,148,256.00,11664.00,6813,6815
8976,1,512,512,512.00,0.00,6814,6815
8977,2,502,10,256.00,60516.00,6814,6816
8978,3,283,93,170.67,6617.56,6815,6818
8979,1,512,512,512.00,0.00,6817,6818
8980,1,512,512,512.00,0.00,6817,6818
8981,1,512,512,512.00,0.00,6817,6818
8982,1,512,512,512.00,0.00,6817,6818
8983,3,336,34,170.67,15611.56,6817,6820
8984,4,380,1,128.00,23514.50,6819,6823
8985,5,195,4,102.40,6284.64,6822,6827
8986,2,371,141,256.00,13225.00,6826,6828
8987,1,512,512,512.00,0.00,6827,6828
8988,1,512,512,512.00,0.00,6827,6828
8989,1,512,512,512.00,0.00,6827,6828
8990,1,512,512,512.00,0.00,6827,6828
8991,3,272,58,170.67,7696.89,6827,6830
8992,2,462,50,256.00,42436.00,6829,6831
8993,5,260,17,102.40,8147.04,6830,6835
8994,1,512,512,512.00,0.00,6834,6835
8995,1,512,512,512.00,0.00,6834,6835
8996,1,512,512,512.00,0.00,6834,6835
8997,2,256,256,256.00,0.00,6834,6836
8998,1,512,512,512.00,0.00,6835,6836
8999,1,512,512,512.00,0.00,6835,6836
9000,1,512,512,512.00,0.00,6835,6836
9001,1,512,512,512.00,0.00,6835,6836
9002,2,360,152,256.00,10816.00,6835,6837
9003,1,512,512,512.00,0.00,6836,6837
9004,2,378,134,256.00,14884.00,6836,6838
9005,1,512,512,512.00,0.00,6837,6838
9006,1,512,512,512.00,0.00,6837,6838
9007,1,512,512,512.00,0.00,6837,6838
9008,1,512,512,512.00,0.00,6837,6838
9009,3,472,7,170.67,45513.56,6837,6840
9010,4,210,5,128.00,6849.50,6839,6843
9011,2,324,188,256.00,4624.00,6842,6844
9012,3,354,76,170.67,16811.56,6843,6846
9013,3,428,31,170.67,33190.89,6845,6848
9014,5,178,7,102.40,5253.04,6847,6852
9015,2,279,233,256.00,529.00,6851,6853
9016,5,289,9,102.40,12512.64,6852,6857
9017,2,341,171,256.00,7225.00,6856,6858
9018,1,512,512,512.00,0.00,6857,6858
9019,3,426,10,170.67,33323.56,6857,6860
9020,3,435,2,170.67,35824.22,6860,6863
9021,1,512,512,512.00,0.00,6862,6863
9022,1,512,512,512.00,0.00,6862,6863
9023,5,452,4,102.40,30741.84,6862,6867
9024,1,512,512,512.00,0.00,6866,6867
9025,1,512,512,512.00,0.00,6866,6867
9026,2,440,72,256.00,33856.00,6866,6868
9027,1,512,512,512.00,0.00,6867,6868
9028,1,512,512,512.00,0.00,6867,6868
9029,5,326,10,102.40,14040.24,6867,6872
9030,1,512,512,512.00,0.00,6871,6872
9031,1,512,512,512.00,0.00,6871,6872
9032,2,409,103,256.00,23409.00,6871,6873
9033,1,512,512,512.00,0.00,6872,6873
9034,1,512,512,512.00,0.00,6872,6873
9035,4,285,6,128.00,15187.50,6872,6876
9036,5,332,16,102.40,14037.04,6875,6880
9037,1,512,512,512.00,0.00,6879,6880
9038,1,512,512,512.00,0.00,6879,6880
9039,1,512,512,512.00,0.00,6879,6880
9040,3,349,47,170.67,16694.89,6879,6882
9041,1,512,512,512.00,0.00,6881,6882
9042,2,474,38,256.00,47524.00,6881,6883
9043,1,512,512,512.00,0.00,6882,6883
9044,1,512,512,512.00,0.00,6882,6883
9045,3,430,26,170.67,33776.89,6882,6885
9046,2,500,12,256.00,59536.00,6884,6886
9047,2,337,175,256.00,6561.00,6885,6887
9048,1,512,512,512.00,0.00,6886,6887
9049,3,254,24,170.67,10822.22,6886,6889
9050,1,512,512,512.00,0.00,6888,6889
9051,3,368,55,170.67,19662.89,6888,6891
9052,5,443,1,102.40,29201.44,6890,6895
9053,1,512,512,512.00,0.00,6894,6895
9054,1,512,512,512.00,0.00,6894,6895
9055,1,512,512,512.00,0.00,6894,6895
9056,1,512,512,512.00,0.00,6894,6895
9057,2,394,118,256.00,19044.00,6894,6896
9058,9,208,1,56.89,6376.32,6895,6904
9059,2,482,30,256.00,51076.00,6903,6905
9060,2,482,30,256.00,51076.00,6904,6906
9061,4,427,5,128.00,30117.00,6905,6909
9062,4,423,13,128.00,29354.50,6908,6912
9063,1,512,512,512.00,0.00,6911,6912
9064,3,235,101,170.67,3006.89,6911,6914
9065,4,425,1,128.00,29809.50,6913,6917
9066,1,512,512,512.00,0.00,6916,6917
9067,2,353,159,256.00,9409.00,6916,6918
9068,1,512,512,512.00,0.00,6917,6918
9069,2,343,169,256.00,7569.00,6917,6919
9070,1,512,512,512.00,0.00,6918,6919
9071,1,512,512,512.00,0.00,6918,6919
9072,2,501,11,256.00,60025.00,6918,6920
9073,1,512,512,512.00,0.00,6919,6920
9074,2,310,202,256.00,2916.00,6919,6921
9075,2,345,167,256.00,7921.00,6920,6922
9076,1,512,512,512.00,0.00,6921,6922
9077,2,467,45,256.00,44521.00,6921,6923
9078,1,512,512,512.00,0.00,6922,6923
9079,2,465,47,256.00,43681.00,6922,6924
9080,1,512,512,512.00,0.00,6923,6924
9081,1,512,512,512.00,0.00,6923,6924
9082,5,266,17,102.40,8369.84,6923,6928
9083,1,512,512,512.00,0.00,6927,6928
9084,1,512,512,512.00,0.00,6927,6928
9085,4,169,95,128.00,1038.50,6927,6931
9086,1,512,512,512.00,0.00,6930,6931
9087,4,401,4,128.00,26031.50,6930,6934
9088,1,512,512,512.00,0.00,6933,6934
9089,1,512,512,512.00,0.00,6933,6934
9090,2,329,183,256.00,5329.00,6933,6935
9091,1,512,512,512.00,0.00,6934,6935
9092,1,512,512,512.00,0.00,6934,6935
9093,1,512,512,512.00,0.00,6934,6935
9094,3,413,17,170.67,30066.89,6934,6937
9095,3,466,10,170.67,43723.56,6936,6939
9096,1,512,512,512.00,0.00,6938,6939
9097,1,512,512,512.00,0.00,6938,6939
9098,2,319,193,256.00,3969.00,6938,6940
9099,1,512,512,512.00,0.00,6939,6940
9100,1,512,512,512.00,0.00,6939,6940
9101,4,284,3,128.00,15466.50,6939,6943
9102,2,416,96,256.00,25600.00,6942,6944
9103,1,512,512,512.00,0.00,6943,6944
9104,2,371,141,256.00,13225.00,6943,6945
9105,3,246,110,170.67,3190.22,6944,6947
9106,1,512,512,512.00,0.00,6946,6947
9107,1,512,512,512.00,0.00,6946,6947
9108,3,464,12,170.67,43118.22,6946,6949
9109,1,512,512,512.00,0.00,6948,6949
9110,3,334,64,170.67,13755.56,6948,6951
9111,1,512,512,512.00,0.00,6950,6951
9112,2,439,73,256.00,33489.00,6950,6952
9113,1,512,512,512.00,0.00,6951,6952
9114,1,512,512,512.00,0.00,6951,6952
9115,4,256,6,128.00,12821.50,6951,6955
9116,3,461,1,170.67,42546.89,6954,6957
9117,3,268,3,170.67,14177.56,6956,6959
9118,1,512,512,512.00,0.00,6958,6959
9119,3,426,18,170.67,33014.22,6958,6961
9120,1,512,512,512.00,0.00,6960,6961
9121,2,392,120,256.00,18496.00,6960,6962
9122,7,184,9,73.14,2824.41,6961,6968
9123,1,512,512,512.00,0.00,6967,6968
9124,4,299,14,128.00,13891.50,6967,6971
9125,1,512,512,512.00,0.00,6970,6971
9126,1,512,512,512.00,0.00,6970,6971
9127,1,512,512,512.00,0.00,6970,6971
9128,1,512,512,512.00,0.00,6970,6971
9129,1,512,512,512.00,0.00,6970,6971
9130,2,478,34,256.00,49284.00,6970,6972
9131,1,512,512,512.00,0.00,6971,6972
9132,2,434,78,256.00,31684.00,6971,6973
9133,1,512,512,512.00,0.00,6972,6973
9134,1,512,512,512.00,0.00,6972,6973
9135,2,326,186,256.00,4900.00,6972,6974
9136,1,512,512,512.00,0.00,6973,6974
9137,1,512,512,512.00,0.00,6973,6974
9138,1,512,512,512.00,0.00,6973,6974
9139,2,473,39,256.00,47089.00,6973,6975
9140,1,512,512,512.00,0.00,6974,6975
9141,3,283,8,170.67,13870.89,6974,6977
9142,2,341,171,256.00,7225.00,6976,6978
9143,1,512,512,512.00,0.00,6977,6978
9144,1,512,512,512.00,0.00,6977,6978
9145,4,283,4,128.00,15641.50,6977,6981
9146,10,242,1,51.20,4973.16,6980,6990
9147,2,473,39,256.00,47089.00,6989,6991
9148,1,512,512,512.00,0.00,6990,6991
9149,1,512,512,512.00,0.00,6990,6991
9150,1,512,512,512.00,0.00,6990,6991
9151,5,452,3,102.40,30673.84,6990,6995
9152,1,512,512,512.00,0.00,6994,6995
9153,1,512,512,512.00,0.00,6994,6995
9154,6,188,6,85.33,3363.56,6994,7000
9155,2,260,252,256.00,16.00,6999,7001
9156,1,512,512,512.00,0.00,7000,7001
9157,1,512,512,512.00,0.00,7000,7001
9158,5,251,22,102.40,6585.84,7000,7005
9159,1,512,512,512.00,0.00,7004,7005
9160,2,331,181,256.00,5625.00,7004,7006
9161,2,334,178,256.00,6084.00,7005,7007
9162,2,355,157,256.00,9801.00,7006,7008
9163,1,512,512,512.00,0.00,7007,7008
9164,1,512,512,512.00,0.00,7007,7008
9165,1,512,512,512.00,0.00,7007,7008
9166,4,413,20,128.00,27144.50,7007,7011
9167,1,512,512,512.00,0.00,7010,7011
9168,1,512,512,512.00,0.00,7010,7011
9169,1,512,512,512.00,0.00,7010,7011
9170,2,303,209,256.00,2209.00,7010,7012
9171,1,512,512,512.00,0.00,7011,7012
9172,1,512,512,512.00,0.00,7011,7012
9173,1,512,512,512.00,0.00,7011,7012
9174,4,350,3,128.00,17656.50,7011,7015
9175,4,407,10,128.00,26317.50,7014,7018
9176,1,512,512,512.00,0.00,7017,7018
9177,1,512,512,512.00,0.00,7017,7018
9178,3,478,2,170.67,47376.89,7017,7020
9179,2,418,94,256.00,26244.00,7019,7021
9180,1,512,512,512.00,0.00,7020,7021
9181,2,372,140,256.00,13456.00,7020,7022
9182,1,512,512,512.00,0.00,7021,7022
9183,1,512,512,512.00,0.00,7021,7022
9184,2,474,38,256.00,47524.00,7021,7023
9185,1,512,512,512.00,0.00,7022,7023
9186,1,512,512,512.00,0.00,7022,7023
9187,1,512,512,512.00,0.00,7022,7023
9188,1,512,512,512.00,0.00,7022,7023
9189,1,512,512,512.00,0.00,7022,7023
9190,2,472,40,256.00,46656.00,7022,7024
9191,2,443,69,256.00,34969.00,7023,7025
9192,1,512,512,512.00,0.00,7024,7025
9193,2,448,64,256.00,36864.00,7024,7026
9194,1,512,512,512.00,0.00,7025,7026
9195,1,512,512,512.00,0.00,7025,7026
9196,2,503,9,256.00,61009.00,7025,7027
9197,1,512,512,512.00,0.00,7026,7027
9198,1,512,512,512.00,0.00,7026,7027
9199,1,512,512,512.00,0.00,7026,7027
9200,1,512,512,512.00,0.00,7026,7027
9201,2,473,39,256.00,47089.00,7026,7028
9202,1,512,512,512.00,0.00,7027,7028
9203,1,512,512,512.00,0.00,7027,7028
9204,1,512,512,512.00,0.00,7027,7028
9205,1,512,512,512.00,0.00,7027,7028
9206,4,374,4,128.00,21758.00,7027,7031
9207,1,512,512,512.00,0.00,7030,7031
9208,1,512,512,512.00,0.00,7030,7031
9209,4,319,4,128.00,16528.50,7030,7034
9210,3,428,2,170.67,34176.89,7033,7036
9211,1,512,512,512.00,0.00,7035,7036
9212,1,512,512,512.00,0.00,7035,7036
9213,1,512,512,512.00,0.00,7035,7036
9214,1,512,512,512.00,0.00,7035,7036
9215,2,333,179,256.00,5929.00,7035,7037
9216,1,512,512,512.00,0.00,7036,7037
9217,1,512,512,512.00,0.00,7036,7037
9218,1,512,512,512.00,0.00,7036,7037
9219,1,512,512,512.00,0.00,7036,7037
9220,1,512,512,512.00,0.00,7036,7037
9221,3,222,119,170.67,1768.22,7036,7039
9222,4,286,68,128.00,8373.50,7038,7042
9223,2,463,49,256.00,42849.00,7041,7043
9224,1,512,512,512.00,0.00,7042,7043
9225,2,408,104,256.00,23104.00,7042,7044
9226,7,330,3,73.14,11638.41,7043,7050
9227,1,512,512,512.00,0.00,7049,7050
9228,1,512,512,512.00,0.00,7049,7050
9229,1,512,512,512.00,0.00,7049,7050
9230,1,512,512,512.00,0.00,7049,7050
9231,2,341,171,256.00,7225.00,7049,7051
9232,1,512,512,512.00,0.00,7050,7051
9233,1,512,512,512.00,0.00,7050,7051
9234,1,512,512,512.00,0.00,7050,7051
9235,1,512,512,512.00,0.00,7050,7051
9236,2,426,86,256.00,28900.00,7050,7052
9237,1,512,512,512.00,0.00,7051,7052
9238,1,512,512,512.00,0.00,7051,7052
9239,1,512,512,512.00,0.00,7051,7052
9240,2,274,238,256.00,324.00,7051,7053
9241,1,512,512,512.00,0.00,7052,7053
9242,1,512,512,512.00,0.00,7052,7053
9243,1,512,512,512.00,0.00,7052,7053
9244,2,311,201,256.00,3025.00,7052,7054
9245,1,512,512,512.00,0.00,7053,7054
9246,1,512,512,512.00,0.00,7053,7054
9247,2,375,137,256.00,14161.00,7053,7055
9248,1,512,512,512.00,0.00,7054,7055
9249,1,512,512,512.00,0.00,7054,7055
9250,1,512,512,512.00,0.00,7054,7055
9251,2,330,182,256.00,5476.00,7054,7056
9252,1,512,512,512.00,0.00,7055,7056
9253,1,512,512,512.00,0.00,7055,7056
9254,3,471,2,170.67,45328.22,7055,7058
9255,1,512,512,512.00,0.00,7057,7058
9256,1,512,512,512.00,0.00,7057,7058
9257,3,284,21,170.67,12188.22,7057,7060
9258,1,512,512,512.00,0.00,7059,7060
9259,1,512,512,512.00,0.00,7059,7060
9260,1,512,512,512.00,0.00,7059,7060
9261,1,512,512,512.00,0.00,7059,7060
9262,2,276,236,256.00,400.00,7059,7061
9263,4,379,1,128.00,23445.00,7060,7064
9264,1,512,512,512.00,0.00,7063,7064
9265,2,263,249,256.00,49.00,7063,7065
9266,1,512,512,512.00,0.00,7064,7065
9267,2,421,91,256.00,27225.00,7064,7066
9268,1,512,512,512.00,0.00,7065,7066
9269,4,244,10,128.00,10373.50,7065,7069
9270,1,512,512,512.00,0.00,7068,7069
9271,1,512,512,512.00,0.00,7068,7069
9272,5,235,15,102.40,5433.44,7068,7073
9273,1,512,512,512.00,0.00,7072,7073
9274,3,278,14,170.67,12832.89,7072,7075
9275,2,390,122,256.00,17956.00,7074,7076
9276,3,383,62,170.67,22546.89,7075,7078
9277,1,512,512,512.00,0.00,7077,7078
9278,1,512,512,512.00,0.00,7077,7078
9279,1,512,512,512.00,0.00,7077,7078
9280,5,401,14,102.40,22560.64,7077,7082
9281,4,158,56,128.00,1754.00,7081,7085
9282,2,381,131,256.00,15625.00,7084,7086
9283,4,259,16,128.00,7492.50,7085,7089
9284,3,494,2,170.67,52304.89,7088,7091
9285,1,512,512,512.00,0.00,7090,7091
9286,5,168,29,102.40,1978.64,7090,7095
9287,6,336,1,85.33,16241.89,7094,7100
9288,2,266,246,256.00,100.00,7099,7101
9289,1,512,512,512.00,0.00,7100,7101
9290,1,512,512,512.00,0.00,7100,7101
9291,1,512,512,512.00,0.00,7100,7101
9292,3,415,25,170.67,30217.56,7100,7103
9293,1,512,512,512.00,0.00,7102,7103
9294,1,512,512,512.00,0.00,7102,7103
9295,1,512,512,512.00,0.00,7102,7103
9296,1,512,512,512.00,0.00,7102,7103
9297,1,512,512,512.00,0.00,7102,7103
9298,2,260,252,256.00,16.00,7102,7104
9299,1,512,512,512.00,0.00,7103,7104
9300,1,512,512,512.00,0.00,7103,7104
9301,1,512,512,512.00,0.00,7103,7104
9302,3,316,2,170.67,16704.89,7103,7106
9303,2,491,21,256.00,55225.00,7105,7107
9304,1,512,512,512.00,0.00,7106,7107
9305,1,512,512,512.00,0.00,7106,7107
9306,2,287,225,256.00,961.00,7106,7108
9307,1,512,512,512.00,0.00,7107,7108
9308,2,314,198,256.00,3364.00,7107,7109
9309,1,512,512,512.00,0.00,7108,7109
9310,1,512,512,512.00,0.00,7108,7109
9311,1,512,512,512.00,0.00,7108,7109
9312,4,393,8,128.00,24687.50,7108,7112
9313,1,512,512,512.00,0.00,7111,7112
9314,1,512,512,512.00,0.00,7111,7112
9315,3,367,1,170.67,22681.56,7111,7114
9316,1,512,512,512.00,0.00,7113,7114
9317,1,512,512,512.00,0.00,7113,7114
9318,1,512,512,512.00,0.00,7113,7114
9319,1,512,512,512.00,0.00,7113,7114
9320,2,268,244,256.00,144.00,7113,7115
9321,2,269,243,256.00,169.00,7114,7116
9322,1,512,512,512.00,0.00,7115,7116
9323,2,442,70,256.00,34596.00,7115,7117
9324,2,279,233,256.00,529.00,7116,7118
9325,1,512,512,512.00,0.00,7117,7118
9326,3,261,4,170.67,13921.56,7117,7120
9327,2,349,163,256.00,8649.00,7119,7121
9328,1,512,512,512.00,0.00,7120,7121
9329,2,422,90,256.00,27556.00,7120,7122
9330,1,512,512,512.00,0.00,7121,7122
9331,10,171,1,51.20,3285.96,7121,7131
9332,7,282,1,73.14,9496.41,7130,7137
9333,2,503,9,256.00,61009.00,7136,7138
9334,1,512,512,512.00,0.00,7137,7138
9335,2,467,45,256.00,44521.00,7137,7139
9336,1,512,512,512.00,0.00,7138,7139
9337,1,512,512,512.00,0.00,7138,7139
9338,2,509,3,256.00,64009.00,7138,7140
9339,1,512,512,512.00,0.00,7139,7140
9340,1,512,512,512.00,0.00,7139,7140
9341,2,510,2,256.00,64516.00,7139,7141
9342,2,300,212,256.00,1936.00,7140,7142
9343,1,512,512,512.00,0.00,7141,7142
9344,1,512,512,512.00,0.00,7141,7142
9345,2,274,238,256.00,324.00,7141,7143
9346,1,512,512,512.00,0.00,7142,7143
9347,1,512,512,512.00,0.00,7142,7143
9348,1,512,512,512.00,0.00,7142,7143
9349,1,512,512,512.00,0.00,7142,7143
9350,3,380,2,170.67,24640.89,7142,7145
9351,1,512,512,512.00,0.00,7144,7145
9352,2,421,91,256.00,27225.00,7144,7146
9353,2,411,101,256.00,24025.00,7145,7147
9354,1,512,512,512.00,0.00,7146,7147
9355,4,177,15,128.00,4365.00,7146,7150
9356,5,237,2,102.40,10033.04,7149,7154
9357,1,512,512,512.00,0.00,7153,7154
9358,1,512,512,512.00,0.00,7153,7154
9359,2,405,107,256.00,22201.00,7153,7155
9360,1,512,512,512.00,0.00,7154,7155
9361,2,467,45,256.00,44521.00,7154,7156
9362,2,355,157,256.00,9801.00,7155,7157
9363,1,512,512,512.00,0.00,7156,7157
9364,3,331,55,170.67,13693.56,7156,7159
9365,1,512,512,512.00,0.00,7158,7159
9366,2,311,201,256.00,3025.00,7158,7160
9367,1,512,512,512.00,0.00,7159,7160
9368,1,512,512,512.00,0.00,7159,7160
9369,2,311,201,256.00,3025.00,7159,7161
9370,1,512,512,512.00,0.00,7160,7161
9371,1,512,512,512.00,0.00,7160,7161
9372,2,446,66,256.00,36100.00,7160,7162
9373,5,198,16,102.40,4388.24,7161,7166
9374,4,300,5,128.00,16038.50,7165,7169
9375,1,512,512,512.00,0.00,7168,7169
9376,6,166,2,85.33,4378.56,7168,7174
9377,1,512,512,512.00,0.00,7173,7174
9378,1,512,512,512.00,0.00,7173,7174
9379,4,300,2,128.00,12554.00,7173,7177
9380,1,512,512,512.00,0.00,7176,7177
9381,1,512,512,512.00,0.00,7176,7177
9382,1,512,512,512.00,0.00,7176,7177
9383,4,414,10,128.00,27970.00,7176,7180
9384,2,492,20,256.00,55696.00,7179,7181
9385,5,168,5,102.40,4073.84,7180,7185
9386,1,512,512,512.00,0.00,7184,7185
9387,2,296,216,256.00,1600.00,7184,7186
9388,1,512,512,512.00,0.00,7185,7186
9389,1,512,512,512.00,0.00,7185,7186
9390,1,512,512,512.00,0.00,7185,7186
9391,1,512,512,512.00,0.00,7185,7186
9392,1,512,512,512.00,0.00,7185,7186
9393,1,512,512,512.00,0.00,7185,7186
9394,5,242,16,102.40,9503.44,7185,7190
9395,14,145,1,36.57,2293.39,7189,7203
9396,3,345,40,170.67,16457.56,7202,7205
9397,1,512,512,512.00,0.00,7204,7205
9398,1,512,512,512.00,0.00,7204,7205
9399,1,512,512,512.00,0.00,7204,7205
9400,1,512,512,512.00,0.00,7204,7205
9401,4,172,2,128.00,5294.00,7204,7208
9402,2,448,64,256.00,36864.00,7207,7209
9403,5,215,1,102.40,8076.24,7208,7213
9404,1,512,512,512.00,0.00,7212,7213
9405,5,321,12,102.40,13085.04,7212,7217
9406,1,512,512,512.00,0.00,7216,7217
9407,1,512,512,512.00,0.00,7216,7217
9408,2,345,167,256.00,7921.00,7216,7218
9409,1,512,512,512.00,0.00,7217,7218
9410,1,512,512,512.00,0.00,7217,7218
9411,3,268,45,170.67,8689.56,7217,7220
9412,2,267,245,256.00,121.00,7219,7221
9413,2,309,203,256.00,2809.00,7220,7222
9414,4,301,15,128.00,13109.00,7221,7225
9415,1,512,512,512.00,0.00,7224,7225
9416,1,512,512,512.00,0.00,7224,7225
9417,2,418,94,256.00,26244.00,7224,7226
9418,1,512,512,512.00,0.00,7225,7226
9419,2,322,190,256.00,4356.00,7225,7227
9420,2,373,139,256.00,13689.00,7226,7228
9421,2,347,165,256.00,8281.00,7227,7229
9422,2,427,85,256.00,29241.00,7228,7230
9423,2,388,124,256.00,17424.00,7229,7231
9424,1,512,512,512.00,0.00,7230,7231
9425,1,512,512,512.00,0.00,7230,7231
9426,1,512,512,512.00,0.00,7230,7231
9427,5,307,3,102.40,13607.84,7230,7235
9428,1,512,512,512.00,0.00,7234,7235
9429,3,268,5,170.67,13862.89,7234,7237
9430,2,484,28,256.00,51984.00,7236,7238
9431,1,512,512,512.00,0.00,7237,7238
9432,3,305,47,170.67,11150.89,7237,7240
9433,1,512,512,512.00,0.00,7239,7240
9434,4,406,2,128.00,26378.00,7239,7243
9435,4,370,34,128.00,19732.50,7242,7246
9436,1,512,512,512.00,0.00,7245,7246
9437,4,251,18,128.00,7081.50,7245,7249
9438,4,368,14,128.00,19731.50,7248,7252
9439,1,512,512,512.00,0.00,7251,7252
9440,1,512,512,512.00,0.00,7251,7252
9441,1,512,512,512.00,0.00,7251,7252
9442,2,506,6,256.00,62500.00,7251,7253
9443,4,500,3,128.00,46128.50,7252,7256
9444,2,492,20,256.00,55696.00,7255,7257
9445,2,346,166,256.00,8100.00,7256,7258
9446,1,512,512,512.00,0.00,7257,7258
9447,3,386,14,170.67,24784.89,7257,7260
9448,10,164,1,51.20,3030.76,7259,7269
9449,1,512,512,512.00,0.00,7268,7269
9450,3,427,1,170.67,34001.56,7268,7271
9451,1,512,512,512.00,0.00,7270,7271
9452,1,512,512,512.00,0.00,7270,7271
9453,1,512,512,512.00,0.00,7270,7271
9454,4,411,11,128.00,27001.50,7270,7274
9455,5,247,8,102.40,9270.24,7273,7278
9456,7,222,14,73.14,6004.69,7277,7284
9457,2,468,44,256.00,44944.00,7283,7285
9458,2,426,86,256.00,28900.00,7284,7286
9459,1,512,512,512.00,0.00,7285,7286
9460,1,512,512,512.00,0.00,7285,7286
9461,1,512,512,512.00,0.00,7285,7286
9462,1,512,512,512.00,0.00,7285,7286
9463,2,504,8,256.00,61504.00,7285,7287
9464,2,291,221,256.00,1225.00,7286,7288
9465,2,321,191,256.00,4225.00,7287,7289
9466,1,512,512,512.00,0.00,7288,7289
9467,1,512,512,512.00,0.00,7288,7289
9468,2,403,109,256.00,21609.00,7288,7290
9469,1,512,512,512.00,0.00,7289,7290
9470,1,512,512,512.00,0.00,7289,7290
9471,1,512,512,512.00,0.00,7289,7290
9472,3,268,104,170.67,4952.89,7289,7292
9473,1,512,512,512.00,0.00,7291,7292
9474,2,397,115,256.00,19881.00,7291,7293
9475,1,512,512,512.00,0.00,7292,7293
9476,1,512,512,512.00,0.00,7292,7293
9477,2,347,165,256.00,8281.00,7292,7294
9478,1,512,512,512.00,0.00,7293,7294
9479,1,512,512,512.00,0.00,7293,7294
9480,4,270,1,128.00,14457.50,7293,7297
9481,2,293,219,256.00,1369.00,7296,7298
9482,1,512,512,512.00,0.00,7297,7298
9483,1,512,512,512.00,0.00,7297,7298
9484,1,512,512,512.00,0.00,7297,7298
9485,2,403,109,256.00,21609.00,7297,7299
9486,1,512,512,512.00,0.00,7298,7299
9487,1,512,512,512.00,0.00,7298,7299
9488,1,512,512,512.00,0.00,7298,7299
9489,1,512,512,512.00,0.00,7298,7299
9490,1,512,512,512.00,0.00,7298,7299
9491,2,417,95,256.00,25921.00,7298,7300
9492,1,512,512,512.00,0.00,7299,7300
9493,1,512,512,512.00,0.00,7299,7300
9494,1,512,512,512.00,0.00,7299,7300
9495,1,512,512,512.00,0.00,7299,7300
9496,1,512,512,512.00,0.00,7299,7300
9497,2,463,49,256.00,42849.00,7299,7301
9498,1,512,512,512.00,0.00,7300,7301
9499,1,512,512,512.00,0.00,7300,7301
9500,1,512,512,512.00,0.00,7300,7301
9501,2,445,67,256.00,35721.00,7300,7302
9502,1,512,512,512.00,0.00,7301,7302
9503,1,512,512,512.00,0.00,7301,7302
9504,2,427,85,256.00,29241.00,7301,7303
9505,2,439,73,256.00,33489.00,7302,7304
9506,1,512,512,512.00,0.00,7303,7304
9507,1,512,512,512.00,0.00,7303,7304
9508,1,512,512,512.00,0.00,7303,7304
9509,1,512,512,512.00,0.00,7303,7304
9510,2,344,168,256.00,7744.00,7303,7305
9511,1,512,512,512.00,0.00,7304,7305
9512,1,512,512,512.00,0.00,7304,7305
9513,1,512,512,512.00,0.00,7304,7305
9514,1,512,512,512.00,0.00,7304,7305
9515,2,351,161,256.00,9025.00,7304,7306
9516,1,512,512,512.00,0.00,7305,7306
9517,2,474,38,256.00,47524.00,7305,7307
9518,1,512,512,512.00,0.00,7306,7307
9519,1,512,512,512.00,0.00,7306,7307
9520,2,414,98,256.00,24964.00,7306,7308
9521,2,406,106,256.00,22500.00,7307,7309
9522,1,512,512,512.00,0.00,7308,7309
9523,1,512,512,512.00,0.00,7308,7309
9524,1,512,512,512.00,0.00,7308,7309
9525,1,512,512,512.00,0.00,7308,7309
9526,2,271,241,256.00,225.00,7308,7310
9527,1,512,512,512.00,0.00,7309,7310
9528,1,512,512,512.00,0.00,7309,7310
9529,1,512,512,512.00,0.00,7309,7310
9530,1,512,512,512.00,0.00,7309,7310
9531,1,512,512,512.00,0.00,7309,7310
9532,2,454,58,256.00,39204.00,7309,7311
9533,1,512,512,512.00,0.00,7310,7311
9534,2,256,256,256.00,0.00,7310,7312
9535,1,512,512,512.00,0.00,7311,7312
9536,1,512,512,512.00,0.00,7311,7312
9537,1,512,512,512.00,0.00,7311,7312
9538,2,277,235,256.00,441.00,7311,7313
9539,1,512,512,512.00,0.00,7312,7313
9540,1,512,512,512.00,0.00,7312,7313
9541,1,512,512,512.00,0.00,7312,7313
9542,4,275,3,128.00,10721.00,7312,7316
9543,1,512,512,512.00,0.00,7315,7316
9544,2,424,88,256.00,28224.00,7315,7317
9545,1,512,512,512.00,0.00,7316,7317
9546,1,512,512,512.00,0.00,7316,7317
9547,1,512,512,512.00,0.00,7316,7317
9548,2,368,144,256.00,12544.00,7316,7318
9549,1,512,512,512.00,0.00,7317,7318
9550,2,315,197,256.00,3481.00,7317,7319
9551,1,512,512,512.00,0.00,7318,7319
9552,1,512,512,512.00,0.00,7318,7319
9553,1,512,512,512.00,0.00,7318,7319
9554,1,512,512,512.00,0.00,7318,7319
9555,4,236,6,128.00,10023.50,7318,7322
9556,3,378,5,170.67,24056.22,7321,7324
9557,3,291,68,170.67,8444.22,7323,7326
9558,1,512,512,512.00,0.00,7325,7326
9559,2,381,131,256.00,15625.00,7325,7327
9560,2,353,159,256.00,9409.00,7326,7328
9561,1,512,512,512.00,0.00,7327,7328
9562,1,512,512,512.00,0.00,7327,7328
9563,1,512,512,512.00,0.00,7327,7328
9564,1,512,512,512.00,0.00,7327,7328
9565,5,336,4,102.40,14205.84,7327,7332
9566,1,512,512,512.00,0.00,7331,7332
9567,3,257,75,170.67,5564.22,7331,7334
9568,1,512,512,512.00,0.00,7333,7334
9569,1,512,512,512.00,0.00,7333,7334
9570,3,305,81,170.67,9360.22,7333,7336
9571,2,313,199,256.00,3249.00,7335,7337
9572,2,463,49,256.00,42849.00,7336,7338
9573,1,512,512,512.00,0.00,7337,7338
9574,1,512,512,512.00,0.00,7337,7338
9575,1,512,512,512.00,0.00,7337,7338
9576,2,285,227,256.00,841.00,7337,7339
9577,1,512,512,512.00,0.00,7338,7339
9578,1,512,512,512.00,0.00,7338,7339
9579,1,512,512,512.00,0.00,7338,7339
9580,1,512,512,512.00,0.00,7338,7339
9581,1,512,512,512.00,0.00,7338,7339
9582,2,472,40,256.00,46656.00,7338,7340
9583,1,512,512,512.00,0.00,7339,7340
9584,1,512,512,512.00,0.00,7339,7340
9585,2,334,178,256.00,6084.00,7339,7341
9586,1,512,512,512.00,0.00,7340,7341
9587,1,512,512,512.00,0.00,7340,7341
9588,2,432,80,256.00,30976.00,7340,7342
9589,1,512,512,512.00,0.00,7341,7342
9590,1,512,512,512.00,0.00,7341,7342
9591,1,512,512,512.00,0.00,7341,7342
9592,5,330,7,102.40,15760.24,7341,7346
9593,1,512,512,512.00,0.00,7345,7346
9594,1,512,512,512.00,0.00,7345,7346
9595,2,290,222,256.00,1156.00,7345,7347
9596,1,512,512,512.00,0.00,7346,7347
9597,1,512,512,512.00,0.00,7346,7347
9598,1,512,512,512.00,0.00,7346,7347
9599,2,443,69,256.00,34969.00,7346,7348
9600,1,512,512,512.00,0.00,7347,7348
9601,1,512,512,512.00,0.00,7347,7348
9602,2,369,143,256.00,12769.00,7347,7349
9603,1,512,512,512.00,0.00,7348,7349
9604,1,512,512,512.00,0.00,7348,7349
9605,3,282,78,170.67,7110.22,7348,7351
9606,1,512,512,512.00,0.00,7350,7351
9607,1,512,512,512.00,0.00,7350,7351
9608,2,330,182,256.00,5476.00,7350,7352
9609,2,467,45,256.00,44521.00,7351,7353
9610,1,512,512,512.00,0.00,7352,7353
9611,1,512,512,512.00,0.00,7352,7353
9612,2,313,199,256.00,3249.00,7352,7354
9613,1,512,512,512.00,0.00,7353,7354
9614,1,512,512,512.00,0.00,7353,7354
9615,2,481,31,256.00,50625.00,7353,7355
9616,1,512,512,512.00,0.00,7354,7355
9617,1,512,512,512.00,0.00,7354,7355
9618,1,512,512,512.00,0.00,7354,7355
9619,1,512,512,512.00,0.00,7354,7355
9620,1,512,512,512.00,0.00,7354,7355
9621,2,320,192,256.00,4096.00,7354,7356
9622,1,512,512,512.00,0.00,7355,7356
9623,1,512,512,512.00,0.00,7355,7356
9624,1,512,512,512.00,0.00,7355,7356
9625,1,512,512,512.00,0.00,7355,7356
9626,1,512,512,512.00,0.00,7355,7356
9627,2,309,203,256.00,2809.00,7355,7357
9628,1,512,512,512.00,0.00,7356,7357
9629,1,512,512,512.00,0.00,7356,7357
9630,1,512,512,512.00,0.00,7356,7357
9631,2,363,149,256.00,11449.00,7356,7358
9632,1,512,512,512.00,0.00,7357,7358
9633,1,512,512,512.00,0.00,7357,7358
9634,4,286,38,128.00,9812.00,7357,7361
9635,1,512,512,512.00,0.00,7360,7361
9636,3,284,109,170.67,6438.89,7360,7363
9637,2,479,33,256.00,49729.00,7362,7364
9638,1,512,512,512.00,0.00,7363,7364
9639,1,512,512,512.00,0.00,7363,7364
9640,1,512,512,512.00,0.00,7363,7364
9641,2,431,81,256.00,30625.00,7363,7365
9642,1,512,512,512.00,0.00,7364,7365
9643,2,327,185,256.00,5041.00,7364,7366
9644,1,512,512,512.00,0.00,7365,7366
9645,2,356,156,256.00,10000.00,7365,7367
9646,3,410,9,170.67,29816.22,7366,7369
9647,2,440,72,256.00,33856.00,7368,7370
9648,1,512,512,512.00,0.00,7369,7370
9649,1,512,512,512.00,0.00,7369,7370
9650,1,512,512,512.00,0.00,7369,7370
9651,1,512,512,512.00,0.00,7369,7370
9652,2,320,192,256.00,4096.00,7369,7371
9653,1,512,512,512.00,0.00,7370,7371
9654,2,333,179,256.00,5929.00,7370,7372
9655,1,512,512,512.00,0.00,7371,7372
9656,1,512,512,512.00,0.00,7371,7372
9657,1,512,512,512.00,0.00,7371,7372
9658,2,313,199,256.00,3249.00,7371,7373
9659,1,512,512,512.00,0.00,7372,7373
9660,1,512,512,512.00,0.00,7372,7373
9661,1,512,512,512.00,0.00,7372,7373
9662,3,273,69,170.67,6936.22,7372,7375
9663,2,340,172,256.00,7056.00,7374,7376
9664,1,512,512,512.00,0.00,7375,7376
9665,1,512,512,512.00,0.00,7375,7376
9666,2,331,181,256.00,5625.00,7375,7377
9667,1,512,512,512.00,0.00,7376,7377
9668,1,512,512,512.00,0.00,7376,7377
9669,2,415,97,256.00,25281.00,7376,7378
9670,3,244,34,170.67,9355.56,7377,7380
9671,1,512,512,512.00,0.00,7379,7380
9672,3,372,8,170.67,22830.22,7379,7382
9673,1,512,512,512.00,0.00,7381,7382
9674,2,488,24,256.00,53824.00,7381,7383
9675,2,327,185,256.00,5041.00,7382,7384
9676,2,350,162,256.00,8836.00,7383,7385
9677,1,512,512,512.00,0.00,7384,7385
9678,2,454,58,256.00,39204.00,7384,7386
9679,1,512,512,512.00,0.00,7385,7386
9680,1,512,512,512.00,0.00,7385,7386
9681,2,464,48,256.00,43264.00,7385,7387
9682,1,512,512,512.00,0.00,7386,7387
9683,1,512,512,512.00,0.00,7386,7387
9684,2,377,135,256.00,14641.00,7386,7388
9685,2,478,34,256.00,49284.00,7387,7389
9686,1,512,512,512.00,0.00,7388,7389
9687,2,465,47,256.00,43681.00,7388,7390
9688,1,512,512,512.00,0.00,7389,7390
9689,1,512,512,512.00,0.00,7389,7390
9690,1,512,512,512.00,0.00,7389,7390
9691,2,496,16,256.00,57600.00,7389,7391
9692,1,512,512,512.00,0.00,7390,7391
9693,1,512,512,512.00,0.00,7390,7391
9694,2,325,187,256.00,4761.00,7390,7392
9695,1,512,512,512.00,0.00,7391,7392
9696,1,512,512,512.00,0.00,7391,7392
9697,5,276,12,102.40,8613.84,7391,7396
9698,2,469,43,256.00,45369.00,7395,7397
9699,1,512,512,512.00,0.00,7396,7397
9700,1,512,512,512.00,0.00,7396,7397
9701,2,417,95,256.00,25921.00,7396,7398
9702,1,512,512,512.00,0.00,7397,7398
9703,4,414,6,128.00,27534.00,7397,7401
9704,1,512,512,512.00,0.00,7400,7401
9705,1,512,512,512.00,0.00,7400,7401
9706,1,512,512,512.00,0.00,7400,7401
9707,2,329,183,256.00,5329.00,7400,7402
9708,1,512,512,512.00,0.00,7401,7402
9709,1,512,512,512.00,0.00,7401,7402
9710,1,512,512,512.00,0.00,7401,7402
9711,2,447,65,256.00,36481.00,7401,7403
9712,1,512,512,512.00,0.00,7402,7403
9713,1,512,512,512.00,0.00,7402,7403
9714,1,512,512,512.00,0.00,7402,7403
9715,5,165,3,102.40,3902.24,7402,7407
9716,1,512,512,512.00,0.00,7406,7407
9717,1,512,512,512.00,0.00,7406,7407
9718,2,507,5,256.00,63001.00,7406,7408
9719,3,490,9,170.67,50989.56,7407,7410
9720,1,512,512,512.00,0.00,7409,7410
9721,3,285,99,170.67,6676.22,7409,7412
9722,2,504,8,256.00,61504.00,7411,7413
9723,2,283,229,256.00,729.00,7412,7414
9724,2,410,102,256.00,23716.00,7413,7415
9725,1,512,512,512.00,0.00,7414,7415
9726,1,512,512,512.00,0.00,7414,7415
9727,1,512,512,512.00,0.00,7414,7415
9728,1,512,512,512.00,0.00,7414,7415
9729,2,478,34,256.00,49284.00,7414,7416
9730,2,489,23,256.00,54289.00,7415,7417
9731,1,512,512,512.00,0.00,7416,7417
9732,1,512,512,512.00,0.00,7416,7417
9733,2,509,3,256.00,64009.00,7416,7418
9734,1,512,512,512.00,0.00,7417,7418
9735,1,512,512,512.00,0.00,7417,7418
9736,1,512,512,512.00,0.00,7417,7418
9737,1,512,512,512.00,0.00,7417,7418
9738,2,313,199,256.00,3249.00,7417,7419
9739,2,468,44,256.00,44944.00,7418,7420
9740,1,512,512,512.00,0.00,7419,7420
9741,3,361,71,170.67,18126.89,7419,7422
9742,3,500,1,170.67,54246.89,7421,7424
9743,1,512,512,512.00,0.00,7423,7424
9744,3,268,23,170.67,11270.89,7423,7426
9745,1,512,512,512.00,0.00,7425,7426
9746,1,512,512,512.00,0.00,7425,7426
9747,1,512,512,512.00,0.00,7425,7426
9748,1,512,512,512.00,0.00,7425,7426
9749,2,330,182,256.00,5476.00,7425,7427
9750,1,512,512,512.00,0.00,7426,7427
9751,2,496,16,256.00,57600.00,7426,7428
9752,8,186,2,64.00,4071.00,7427,7435
9753,1,512,512,512.00,0.00,7434,7435
9754,2,446,66,256.00,36100.00,7434,7436
9755,1,512,512,512.00,0.00,7435,7436
9756,1,512,512,512.00,0.00,7435,7436
9757,1,512,512,512.00,0.00,7435,7436
9758,5,347,1,102.40,17091.04,7435,7440
9759,1,512,512,512.00,0.00,7439,7440
9760,1,512,512,512.00,0.00,7439,7440
9761,1,512,512,512.00,0.00,7439,7440
9762,1,512,512,512.00,0.00,7439,7440
9763,1,512,512,512.00,0.00,7439,7440
9764,1,512,512,512.00,0.00,7439,7440
9765,4,242,28,128.00,5994.00,7439,7443
9766,1,512,512,512.00,0.00,7442,7443
9767,2,437,75,256.00,32761.00,7442,7444
9768,3,289,1,170.67,15141.56,7443,7446
9769,1,512,512,512.00,0.00,7445,7446
9770,1,512,512,512.00,0.00,7445,7446
9771,2,421,91,256.00,27225.00,7445,7447
9772,1,512,512,512.00,0.00,7446,7447
9773,1,512,512,512.00,0.00,7446,7447
9774,2,424,88,256.00,28224.00,7446,7448
9775,1,512,512,512.00,0.00,7447,7448
9776,1,512,512,512.00,0.00,7447,7448
9777,3,465,3,170.67,43596.22,7447,7450
9778,1,512,512,512.00,0.00,7449,7450
9779,1,512,512,512.00,0.00,7449,7450
9780,1,512,512,512.00,0.00,7449,7450
9781,2,339,173,256.00,6889.00,7449,7451
9782,1,512,512,512.00,0.00,7450,7451
9783,1,512,512,512.00,0.00,7450,7451
9784,1,512,512,512.00,0.00,7450,7451
9785,2,308,204,256.00,2704.00,7450,7452
9786,1,512,512,512.00,0.00,7451,7452
9787,1,512,512,512.00,0.00,7451,7452
9788,1,512,512,512.00,0.00,7451,7452
9789,1,512,512,512.00,0.00,7451,7452
9790,1,512,512,512.00,0.00,7451,7452
9791,2,352,160,256.00,9216.00,7451,7453
9792,1,512,512,512.00,0.00,7452,7453
9793,2,459,53,256.00,41209.00,7452,7454
9794,1,512,512,512.00,0.00,7453,7454
9795,1,512,512,512.00,0.00,7453,7454
9796,1,512,512,512.00,0.00,7453,7454
9797,2,436,76,256.00,32400.00,7453,7455
9798,1,512,512,512.00,0.00,7454,7455
9799,1,512,512,512.00,0.00,7454,7455
9800,2,323,189,256.00,4489.00,7454,7456
9801,1,512,512,512.00,0.00,7455,7456
9802,1,512,512,512.00,0.00,7455,7456
9803,2,343,169,256.00,7569.00,7455,7457
9804,1,512,512,512.00,0.00,7456,7457
9805,1,512,512,512.00,0.00,7456,7457
9806,1,512,512,512.00,0.00,7456,7457
9807,3,273,52,170.67,8273.56,7456,7459
9808,1,512,512,512.00,0.00,7458,7459
9809,1,512,512,512.00,0.00,7458,7459
9810,2,278,234,256.00,484.00,7458,7460
9811,1,512,512,512.00,0.00,7459,7460
9812,1,512,512,512.00,0.00,7459,7460
9813,1,512,512,512.00,0.00,7459,7460
9814,2,465,47,256.00,43681.00,7459,7461
9815,1,512,512,512.00,0.00,7460,7461
9816,1,512,512,512.00,0.00,7460,7461
9817,3,314,42,170.67,12438.22,7460,7463
9818,2,333,179,256.00,5929.00,7462,7464
9819,2,323,189,256.00,4489.00,7463,7465
9820,1,512,512,512.00,0.00,7464,7465
9821,1,512,512,512.00,0.00,7464,7465
9822,1,512,512,512.00,0.00,7464,7465
9823,1,512,512,512.00,0.00,7464,7465
9824,2,465,47,256.00,43681.00,7464,7466
9825,2,358,154,256.00,10404.00,7465,7467
9826,1,512,512,512.00,0.00,7466,7467
9827,1,512,512,512.00,0.00,7466,7467
9828,3,365,64,170.67,18942.89,7466,7469
9829,1,512,512,512.00,0.00,7468,7469
9830,1,512,512,512.00,0.00,7468,7469
9831,2,319,193,256.00,3969.00,7468,7470
9832,1,512,512,512.00,0.00,7469,7470
9833,1,512,512,512.00,0.00,7469,7470
9834,2,357,155,256.00,10201.00,7469,7471
9835,1,512,512,512.00,0.00,7470,7471
9836,4,373,1,128.00,21579.00,7470,7474
9837,1,512,512,512.00,0.00,7473,7474
9838,1,512,512,512.00,0.00,7473,7474
9839,1,512,512,512.00,0.00,7473,7474
9840,2,319,193,256.00,3969.00,7473,7475
9841,2,361,151,256.00,11025.00,7474,7476
9842,1,512,512,512.00,0.00,7475,7476
9843,2,380,132,256.00,15376.00,7475,7477
9844,1,512,512,512.00,0.00,7476,7477
9845,1,512,512,512.00,0.00,7476,7477
9846,1,512,512,512.00,0.00,7476,7477
9847,2,262,250,256.00,36.00,7476,7478
9848,1,512,512,512.00,0.00,7477,7478
9849,1,512,512,512.00,0.00,7477,7478
9850,1,512,512,512.00,0.00,7477,7478
9851,1,512,512,512.00,0.00,7477,7478
9852,2,418,94,256.00,26244.00,7477,7479
9853,1,512,512,512.00,0.00,7478,7479
9854,1,512,512,512.00,0.00,7478,7479
9855,1,512,512,512.00,0.00,7478,7479
9856,1,512,512,512.00,0.00,7478,7479
9857,2,266,246,256.00,100.00,7478,7480
9858,3,256,31,170.67,9913.56,7479,7482
9859,1,512,512,512.00,0.00,7481,7482
9860,3,407,38,170.67,28066.89,7481,7484
9861,2,378,134,256.00,14884.00,7483,7485
9862,4,399,4,128.00,25025.50,7484,7488
9863,5,391,11,102.40,21197.44,7487,7492
9864,2,486,26,256.00,52900.00,7491,7493
9865,1,512,512,512.00,0.00,7492,7493
9866,1,512,512,512.00,0.00,7492,7493
9867,1,512,512,512.00,0.00,7492,7493
9868,1,512,512,512.00,0.00,7492,7493
9869,3,298,26,170.67,12480.89,7492,7495
9870,2,506,6,256.00,62500.00,7494,7496
9871,1,512,512,512.00,0.00,7495,7496
9872,3,438,23,170.67,35864.22,7495,7498
9873,3,294,31,170.67,11661.56,7497,7500
9874,1,512,512,512.00,0.00,7499,7500
9875,1,512,512,512.00,0.00,7499,7500
9876,1,512,512,512.00,0.00,7499,7500
9877,1,512,512,512.00,0.00,7499,7500
9878,2,481,31,256.00,50625.00,7499,7501
9879,1,512,512,512.00,0.00,7500,7501
9880,1,512,512,512.00,0.00,7500,7501
9881,3,353,9,170.67,19936.22,7500,7503
9882,2,487,25,256.00,53361.00,7502,7504
9883,1,512,512,512.00,0.00,7503,7504
9884,1,512,512,512.00,0.00,7503,7504
9885,2,266,246,256.00,100.00,7503,7505
9886,2,435,77,256.00,32041.00,7504,7506
9887,1,512,512,512.00,0.00,7505,7506
9888,2,355,157,256.00,9801.00,7505,7507
9889,1,512,512,512.00,0.00,7506,7507
9890,1,512,512,512.00,0.00,7506,7507
9891,1,512,512,512.00,0.00,7506,7507
9892,2,505,7,256.00,62001.00,7506,7508
9893,1,512,512,512.00,0.00,7507,7508
9894,3,286,112,170.67,6651.56,7507,7510
9895,1,512,512,512.00,0.00,7509,7510
9896,1,512,512,512.00,0.00,7509,7510
9897,1,512,512,512.00,0.00,7509,7510
9898,1,512,512,512.00,0.00,7509,7510
9899,4,348,2,128.00,18578.00,7509,7513
9900,1,512,512,512.00,0.00,7512,7513
9901,1,512,512,512.00,0.00,7512,7513
9902,1,512,512,512.00,0.00,7512,7513
9903,2,416,96,256.00,25600.00,7512,7514
9904,1,512,512,512.00,0.00,7513,7514
9905,2,286,226,256.00,900.00,7513,7515
9906,1,512,512,512.00,0.00,7514,7515
9907,1,512,512,512.00,0.00,7514,7515
9908,7,316,9,73.14,10250.69,7514,7521
9909,1,512,512,512.00,0.00,7520,7521
9910,2,316,196,256.00,3600.00,7520,7522
9911,1,512,512,512.00,0.00,7521,7522
9912,1,512,512,512.00,0.00,7521,7522
9913,2,499,13,256.00,59049.00,7521,7523
9914,1,512,512,512.00,0.00,7522,7523
9915,1,512,512,512.00,0.00,7522,7523
9916,1,512,512,512.00,0.00,7522,7523
9917,1,512,512,512.00,0.00,7522,7523
9918,2,493,19,256.00,56169.00,7522,7524
9919,2,259,253,256.00,9.00,7523,7525
9920,7,119,3,73.14,2185.84,7524,7531
9921,1,512,512,512.00,0.00,7530,7531
9922,3,376,58,170.67,21147.56,7530,7533
9923,2,405,107,256.00,22201.00,7532,7534
9924,1,512,512,512.00,0.00,7533,7534
9925,1,512,512,512.00,0.00,7533,7534
9926,1,512,512,512.00,0.00,7533,7534
9927,5,352,1,102.40,17022.24,7533,7538
9928,1,512,512,512.00,0.00,7537,7538
9929,4,324,23,128.00,14136.50,7537,7541
9930,2,349,163,256.00,8649.00,7540,7542
9931,1,512,512,512.00,0.00,7541,7542
9932,1,512,512,512.00,0.00,7541,7542
9933,1,512,512,512.00,0.00,7541,7542
9934,6,275,5,85.33,10948.22,7541,7547
9935,2,433,79,256.00,31329.00,7546,7548
9936,1,512,512,512.00,0.00,7547,7548
9937,1,512,512,512.00,0.00,7547,7548
9938,5,328,1,102.40,13380.24,7547,7552
9939,1,512,512,512.00,0.00,7551,7552
9940,1,512,512,512.00,0.00,7551,7552
9941,1,512,512,512.00,0.00,7551,7552
9942,1,512,512,512.00,0.00,7551,7552
9943,3,294,6,170.67,14678.22,7551,7554
9944,1,512,512,512.00,0.00,7553,7554
9945,2,377,135,256.00,14641.00,7553,7555
9946,1,512,512,512.00,0.00,7554,7555
9947,1,512,512,512.00,0.00,7554,7555
9948,1,512,512,512.00,0.00,7554,7555
9949,1,512,512,512.00,0.00,7554,7555
9950,2,432,80,256.00,30976.00,7554,7556
9951,2,415,97,256.00,25281.00,7555,7557
9952,2,461,51,256.00,42025.00,7556,7558
9953,1,512,512,512.00,0.00,7557,7558
9954,1,512,512,512.00,0.00,7557,7558
9955,1,512,512,512.00,0.00,7557,7558
9956,1,512,512,512.00,0.00,7557,7558
9957,2,462,50,256.00,42436.00,7557,7559
9958,2,446,66,256.00,36100.00,7558,7560
9959,1,512,512,512.00,0.00,7559,7560
9960,1,512,512,512.00,0.00,7559,7560
9961,2,476,36,256.00,48400.00,7559,7561
9962,1,512,512,512.00,0.00,7560,7561
9963,1,512,512,512.00,0.00,7560,7561
9964,2,440,72,256.00,33856.00,7560,7562
9965,1,512,512,512.00,0.00,7561,7562
9966,1,512,512,512.00,0.00,7561,7562
9967,1,512,512,512.00,0.00,7561,7562
9968,1,512,512,512.00,0.00,7561,7562
9969,2,348,164,256.00,8464.00,7561,7563
9970,1,512,512,512.00,0.00,7562,7563
9971,1,512,512,512.00,0.00,7562,7563
9972,4,240,13,128.00,10448.50,7562,7566
9973,2,483,29,256.00,51529.00,7565,7567
9974,1,512,512,512.00,0.00,7566,7567
9975,1,512,512,512.00,0.00,7566,7567
9976,1,512,512,512.00,0.00,7566,7567
9977,2,454,58,256.00,39204.00,7566,7568
9978,6,302,3,85.33,10587.89,7567,7573
9979,3,338,6,170.67,18374.22,7572,7575
9980,2,295,217,256.00,1521.00,7574,7576
9981,1,512,512,512.00,0.00,7575,7576
9982,1,512,512,512.00,0.00,7575,7576
9983,1,512,512,512.00,0.00,7575,7576
9984,2,458,54,256.00,40804.00,7575,7577
9985,4,366,1,128.00,20139.50,7576,7580
9986,2,306,206,256.00,2500.00,7579,7581
9987,1,512,512,512.00,0.00,7580,7581
9988,1,512,512,512.00,0.00,7580,7581
9989,1,512,512,512.00,0.00,7580,7581
9990,3,267,1,170.67,14481.56,7580,7583
9991,1,512,512,512.00,0.00,7582,7583
9992,1,512,512,512.00,0.00,7582,7583
9993,1,512,512,512.00,0.00,7582,7583
9994,1,512,512,512.00,0.00,7582,7583
9995,2,359,153,256.00,10609.00,7582,7584
9996,1,512,512,512.00,0.00,7583,7584
9997,1,512,512,512.00,0.00,7583,7584
9998,1,512,512,512.00,0.00,7583,7584
9999,7,151,1,73.14,2018.69,7583,7590
10000,2,314,198,256.00,3364.00,7589,7591
10001,1,512,512,512.00,0.00,7590,7591
10002,2,500,12,256.00,59536.00,7590,7592
10003,1,512,512,512.00,0.00,7591,7592
10004,1,512,512,512.00,0.00,7591,7592
10005,2,361,151,256.00,11025.00,7591,7593
10006,2,419,93,256.00,26569.00,7592,7594
10007,1,512,512,512.00,0.00,7593,7594
10008,1,512,512,512.00,0.00,7593,7594
10009,1,512,512,512.00,0.00,7593,7594
10010,1,512,512,512.00,0.00,7593,7594
10011,1,512,512,512.00,0.00,7593,7594
10012,2,395,117,256.00,19321.00,7593,7595
10013,1,512,512,512.00,0.00,7594,7595
10014,2,257,255,256.00,1.00,7594,7596
10015,1,512,512,512.00,0.00,7595,7596
10016,1,512,512,512.00,0.00,7595,7596
10017,2,288,224,256.00,1024.00,7595,7597
10018,5,269,3,102.40,11392.64,7596,7601
10019,4,260,3,128.00,14263.50,7600,7604
10020,1,512,512,512.00,0.00,7603,7604
10021,1,512,512,512.00,0.00,7603,7604
10022,2,310,202,256.00,2916.00,7603,7605
10023,1,512,512,512.00,0.00,7604,7605
10024,2,356,156,256.00,10000.00,7604,7606
10025,1,512,512,512.00,0.00,7605,7606
10026,3,351,7,170.67,19861.56,7605,7608
10027,2,391,121,256.00,18225.00,7607,7609
10028,1,512,512,512.00,0.00,7608,7609
10029,1,512,512,512.00,0.00,7608,7609
10030,5,251,2,102.40,12181.84,7608,7613
10031,2,363,149,256.00,11449.00,7612,7614
10032,3,254,10,170.67,12912.89,7613,7616
10033,2,358,154,256.00,10404.00,7615,7617
10034,1,512,512,512.00,0.00,7616,7617
10035,1,512,512,512.00,0.00,7616,7617
10036,3,268,105,170.67,4929.56,7616,7619
10037,1,512,512,512.00,0.00,7618,7619
10038,2,280,232,256.00,576.00,7618,7620
10039,1,512,512,512.00,0.00,7619,7620
10040,1,512,512,512.00,0.00,7619,7620
10041,1,512,512,512.00,0.00,7619,7620
10042,2,363,149,256.00,11449.00,7619,7621
10043,3,338,64,170.67,14352.89,7620,7623
10044,3,349,40,170.67,17049.56,7622,7625
10045,1,512,512,512.00,0.00,7624,7625
10046,3,251,11,170.67,12746.89,7624,7627
10047,1,512,512,512.00,0.00,7626,7627
10048,2,270,242,256.00,196.00,7626,7628
10049,1,512,512,512.00,0.00,7627,7628
10050,1,512,512,512.00,0.00,7627,7628
10051,1,512,512,512.00,0.00,7627,7628
10052,2,483,29,256.00,51529.00,7627,7629
10053,1,512,512,512.00,0.00,7628,7629
10054,1,512,512,512.00,0.00,7628,7629
10055,2,289,223,256.00,1089.00,7628,7630
10056,1,512,512,512.00,0.00,7629,7630
10057,2,325,187,256.00,4761.00,7629,7631
10058,1,512,512,512.00,0.00,7630,7631
10059,1,512,512,512.00,0.00,7630,7631
10060,2,430,82,256.00,30276.00,7630,7632
10061,1,512,512,512.00,0.00,7631,7632
10062,1,512,512,512.00,0.00,7631,7632
10063,1,512,512,512.00,0.00,7631,7632
10064,1,512,512,512.00,0.00,7631,7632
10065,1,512,512,512.00,0.00,7631,7632
10066,2,281,231,256.00,625.00,7631,7633
10067,1,512,512,512.00,0.00,7632,7633
10068,1,512,512,512.00,0.00,7632,7633
10069,1,512,512,512.00,0.00,7632,7633
10070,4,253,4,128.00,9830.50,7632,7636
10071,6,252,3,85.33,7990.22,7635,7641
10072,1,512,512,512.00,0.00,7640,7641
10073,1,512,512,512.00,0.00,7640,7641
10074,1,512,512,512.00,0.00,7640,7641
10075,1,512,512,512.00,0.00,7640,7641
10076,1,512,512,512.00,0.00,7640,7641
10077,2,446,66,256.00,36100.00,7640,7642
10078,1,512,512,512.00,0.00,7641,7642
10079,1,512,512,512.00,0.00,7641,7642
10080,3,394,9,170.67,26605.56,7641,7644
10081,2,441,71,256.00,34225.00,7643,7645
10082,1,512,512,512.00,0.00,7644,7645
10083,1,512,512,512.00,0.00,7644,7645
10084,1,512,512,512.00,0.00,7644,7645
10085,3,284,35,170.67,10582.89,7644,7647
10086,1,512,512,512.00,0.00,7646,7647
10087,1,512,512,512.00,0.00,7646,7647
10088,3,391,48,170.67,24377.56,7646,7649
10089,2,419,93,256.00,26569.00,7648,7650
10090,2,486,26,256.00,52900.00,7649,7651
10091,1,512,512,512.00,0.00,7650,7651
10092,1,512,512,512.00,0.00,7650,7651
10093,3,219,133,170.67,1289.56,7650,7653
10094,1,512,512,512.00,0.00,7652,7653
10095,2,364,148,256.00,11664.00,7652,7654
10096,1,512,512,512.00,0.00,7653,7654
10097,1,512,512,512.00,0.00,7653,7654
10098,4,420,24,128.00,28446.00,7653,7657
10099,1,512,512,512.00,0.00,7656,7657
10100,1,512,512,512.00,0.00,7656,7657
10101,2,482,30,256.00,51076.00,7656,7658
10102,1,512,512,512.00,0.00,7657,7658
10103,3,503,1,170.67,55230.89,7657,7660
10104,4,277,5,128.00,12779.00,7659,7663
10105,4,283,9,128.00,14809.00,7662,7666
10106,2,496,16,256.00,57600.00,7665,7667
10107,1,512,512,512.00,0.00,7666,7667
10108,1,512,512,512.00,0.00,7666,7667
10109,1,512,512,512.00,0.00,7666,7667
10110,2,375,137,256.00,14161.00,7666,7668
10111,1,512,512,512.00,0.00,7667,7668
10112,1,512,512,512.00,0.00,7667,7668
10113,1,512,512,512.00,0.00,7667,7668
10114,1,512,512,512.00,0.00,7667,7668
10115,7,351,2,73.14,13352.41,7667,7674
10116,2,398,114,256.00,20164.00,7673,7675
10117,1,512,512,512.00,0.00,7674,7675
10118,2,448,64,256.00,36864.00,7674,7676
10119,1,512,512,512.00,0.00,7675,7676
10120,1,512,512,512.00,0.00,7675,7676
10121,2,318,194,256.00,3844.00,7675,7677
10122,1,512,512,512.00,0.00,7676,7677
10123,2,257,255,256.00,1.00,7676,7678
10124,3,379,1,170.67,24561.56,7677,7680
10125,1,512,512,512.00,0.00,7679,7680
10126,3,416,2,170.67,31504.89,7679,7682
10127,1,512,512,512.00,0.00,7681,7682
10128,1,512,512,512.00,0.00,7681,7682
10129,3,396,15,170.67,26620.22,7681,7684
10130,1,512,512,512.00,0.00,7683,7684
10131,6,226,1,85.33,6301.89,7683,7689
10132,1,512,512,512.00,0.00,7688,7689
10133,1,512,512,512.00,0.00,7688,7689
10134,1,512,512,512.00,0.00,7688,7689
10135,1,512,512,512.00,0.00,7688,7689
10136,1,512,512,512.00,0.00,7688,7689
10137,2,386,126,256.00,16900.00,7688,7690
10138,1,512,512,512.00,0.00,7689,7690
10139,1,512,512,512.00,0.00,7689,7690
10140,1,512,512,512.00,0.00,7689,7690
10141,1,512,512,512.00,0.00,7689,7690
10142,2,499,13,256.00,59049.00,7689,7691
10143,1,512,512,512.00,0.00,7690,7691
10144,1,512,512,512.00,0.00,7690,7691
10145,1,512,512,512.00,0.00,7690,7691
10146,3,287,16,170.67,12974.89,7690,7693
10147,7,340,10,73.14,12146.41,7692,7699
10148,1,512,512,512.00,0.00,7698,7699
10149,2,436,76,256.00,32400.00,7698,7700
10150,1,512,512,512.00,0.00,7699,7700
10151,2,280,232,256.00,576.00,7699,7701
10152,3,279,2,170.67,14608.22,7700,7703
10153,1,512,512,512.00,0.00,7702,7703
10154,1,512,512,512.00,0.00,7702,7703
10155,1,512,512,512.00,0.00,7702,7703
10156,2,405,107,256.00,22201.00,7702,7704
10157,1,512,512,512.00,0.00,7703,7704
10158,1,512,512,512.00,0.00,7703,7704
10159,1,512,512,512.00,0.00,7703,7704
10160,1,512,512,512.00,0.00,7703,7704
10161,1,512,512,512.00,0.00,7703,7704
10162,2,390,122,256.00,17956.00,7703,7705
10163,1,512,512,512.00,0.00,7704,7705
10164,1,512,512,512.00,0.00,7704,7705
10165,2,396,116,256.00,19600.00,7704,7706
10166,1,512,512,512.00,0.00,7705,7706
10167,2,397,115,256.00,19881.00,7705,7707
10168,1,512,512,512.00,0.00,7706,7707
10169,2,489,23,256.00,54289.00,7706,7708
10170,3,324,2,170.67,17398.22,7707,7710
10171,2,492,20,256.00,55696.00,7709,7711
10172,2,285,227,256.00,841.00,7710,7712
10173,1,512,512,512.00,0.00,7711,7712
10174,1,512,512,512.00,0.00,7711,7712
10175,1,512,512,512.00,0.00,7711,7712
10176,2,450,62,256.00,37636.00,7711,7713
10177,1,512,512,512.00,0.00,7712,7713
10178,2,500,12,256.00,59536.00,7712,7714
10179,1,512,512,512.00,0.00,7713,7714
10180,2,380,132,256.00,15376.00,7713,7715
10181,1,512,512,512.00,0.00,7714,7715
10182,2,282,230,256.00,676.00,7714,7716
10183,3,304,9,170.67,14905.56,7715,7718
10184,1,512,512,512.00,0.00,7717,7718
10185,1,512,512,512.00,0.00,7717,7718
10186,1,512,512,512.00,0.00,7717,7718
10187,1,512,512,512.00,0.00,7717,7718
10188,2,477,35,256.00,48841.00,7717,7719
10189,1,512,512,512.00,0.00,7718,7719
10190,1,512,512,512.00,0.00,7718,7719
10191,2,428,84,256.00,29584.00,7718,7720
10192,2,445,67,256.00,35721.00,7719,7721
10193,1,512,512,512.00,0.00,7720,7721
10194,1,512,512,512.00,0.00,7720,7721
10195,2,312,200,256.00,3136.00,7720,7722
10196,1,512,512,512.00,0.00,7721,7722
10197,3,290,15,170.67,13264.22,7721,7724
10198,5,286,3,102.40,12487.04,7723,7728
10199,1,512,512,512.00,0.00,7727,7728
10200,1,512,512,512.00,0.00,7727,7728
10201,2,333,179,256.00,5929.00,7727,7729
10202,1,512,512,512.00,0.00,7728,7729
10203,1,512,512,512.00,0.00,7728,7729
10204,1,512,512,512.00,0.00,7728,7729
10205,1,512,512,512.00,0.00,7728,7729
10206,2,458,54,256.00,40804.00,7729,7731
10207,3,402,2,170.67,28630.22,7730,7733
10208,1,512,512,512.00,0.00,7732,7733
10209,1,512,512,512.00,0.00,7732,7733
10210,2,442,70,256.00,34596.00,7732,7734
10211,5,278,12,102.40,8786.24,7733,7738
10212,1,512,512,512.00,0.00,7737,7738
10213,1,512,512,512.00,0.00,7737,7738
10214,1,512,512,512.00,0.00,7737,7738
10215,1,512,512,512.00,0.00,7737,7738
10216,1,512,512,512.00,0.00,7737,7738
10217,1,512,512,512.00,0.00,7737,7738
10218,2,257,255,256.00,1.00,7737,7739
10219,1,512,512,512.00,0.00,7738,7739
10220,1,512,512,512.00,0.00,7738,7739
10221,2,377,135,256.00,14641.00,7738,7740
10222,1,512,512,512.00,0.00,7739,7740
10223,1,512,512,512.00,0.00,7739,7740
10224,1,512,512,512.00,0.00,7739,7740
10225,3,226,125,170.67,1746.89,7739,7742
10226,1,512,512,512.00,0.00,7741,7742
10227,3,434,2,170.67,35584.89,7741,7744
10228,1,512,512,512.00,0.00,7743,7744
10229,1,512,512,512.00,0.00,7743,7744
10230,1,512,512,512.00,0.00,7743,7744
10231,1,512,512,512.00,0.00,7743,7744
10232,1,512,512,512.00,0.00,7743,7744
10233,1,512,512,512.00,0.00,7743,7744
10234,1,512,512,512.00,0.00,7743,7744
10235,1,512,512,512.00,0.00,7743,7744
10236,2,395,117,256.00,19321.00,7743,7745
10237,1,512,512,512.00,0.00,7744,7745
10238,1,512,512,512.00,0.00,7744,7745
10239,5,148,33,102.40,1817.84,7744,7749
10240,1,512,512,512.00,0.00,7748,7749
10241,1,512,512,512.00,0.00,7748,7749
10242,2,490,22,256.00,54756.00,7748,7750
10243,2,375,137,256.00,14161.00,7749,7751
10244,1,512,512,512.00,0.00,7750,7751
10245,2,464,48,256.00,43264.00,7750,7752
10246,2,278,234,256.00,484.00,7751,7753
10247,3,367,59,170.67,19394.89,7752,7755
10248,3,483,1,170.67,48897.56,7754,7757
10249,5,248,2,102.40,11900.24,7756,7761
10250,4,266,11,128.00,9228.50,7760,7764
10251,3,344,22,170.67,17584.89,7763,7766
10252,2,351,161,256.00,9025.00,7765,7767
10253,1,512,512,512.00,0.00,7766,7767
10254,1,512,512,512.00,0.00,7766,7767
10255,1,512,512,512.00,0.00,7766,7767
10256,4,258,1,128.00,11498.50,7766,7770
10257,1,512,512,512.00,0.00,7769,7770
10258,1,512,512,512.00,0.00,7769,7770
10259,1,512,512,512.00,0.00,7769,7770
10260,1,512,512,512.00,0.00,7769,7770
10261,5,374,13,102.40,18593.84,7769,7774
10262,3,262,59,170.67,7074.89,7773,7776
10263,1,512,512,512.00,0.00,7775,7776
10264,1,512,512,512.00,0.00,7775,7776
10265,1,512,512,512.00,0.00,7775,7776
10266,1,512,512,512.00,0.00,7775,7776
10267,1,512,512,512.00,0.00,7775,7776
10268,2,353,159,256.00,9409.00,7775,7777
10269,1,512,512,512.00,0.00,7776,7777
10270,2,470,42,256.00,45796.00,7776,7778
10271,2,415,97,256.00,25281.00,7777,7779
10272,1,512,512,512.00,0.00,7778,7779
10273,2,258,254,256.00,4.00,7778,7780
10274,2,402,110,256.00,21316.00,7779,7781
10275,3,501,4,170.67,54561.56,7780,7783
10276,1,512,512,512.00,0.00,7782,7783
10277,2,390,122,256.00,17956.00,7782,7784
10278,3,397,27,170.67,26233.56,7783,7786
10279,1,512,512,512.00,0.00,7785,7786
10280,2,263,249,256.00,49.00,7785,7787
10281,1,512,512,512.00,0.00,7786,7787
10282,4,321,8,128.00,13593.50,7786,7790
10283,1,512,512,512.00,0.00,7789,7790
10284,1,512,512,512.00,0.00,7789,7790
10285,1,512,512,512.00,0.00,7789,7790
10286,2,483,29,256.00,51529.00,7789,7791
10287,1,512,512,512.00,0.00,7790,7791
10288,1,512,512,512.00,0.00,7790,7791
10289,2,352,160,256.00,9216.00,7790,7792
10290,1,512,512,512.00,0.00,7791,7792
10291,1,512,512,512.00,0.00,7791,7792
10292,1,512,512,512.00,0.00,7791,7792
10293,2,299,213,256.00,1849.00,7791,7793
10294,1,512,512,512.00,0.00,7792,7793
10295,1,512,512,512.00,0.00,7792,7793
10296,2,443,69,256.00,34969.00,7792,7794
10297,1,512,512,512.00,0.00,7793,7794
10298,1,512,512,512.00,0.00,7793,7794
10299,1,512,512,512.00,0.00,7793,7794
10300,1,512,512,512.00,0.00,7793,7794
10301,2,385,127,256.00,16641.00,7793,7795
10302,1,512,512,512.00,0.00,7794,7795
10303,1,512,512,512.00,0.00,7794,7795
10304,1,512,512,512.00,0.00,7794,7795
10305,3,318,13,170.67,15557.56,7794,7797
10306,1,512,512,512.00,0.00,7796,7797
10307,2,367,145,256.00,12321.00,7796,7798
10308,1,512,512,512.00,0.00,7797,7798
10309,1,512,512,512.00,0.00,7797,7798
10310,3,327,83,170.67,12280.22,7797,7800
10311,1,512,512,512.00,0.00,7799,7800
10312,1,512,512,512.00,0.00,7799,7800
10313,5,218,9,102.40,6567.44,7799,7804
10314,1,512,512,512.00,0.00,7803,7804
10315,1,512,512,512.00,0.00,7803,7804
10316,1,512,512,512.00,0.00,7803,7804
10317,1,512,512,512.00,0.00,7803,7804
10318,1,512,512,512.00,0.00,7803,7804
10319,2,428,84,256.00,29584.00,7803,7805
10320,3,363,8,170.67,21444.22,7804,7807
10321,1,512,512,512.00,0.00,7806,7807
10322,1,512,512,512.00,0.00,7806,7807
10323,1,512,512,512.00,0.00,7806,7807
10324,3,293,64,170.67,8862.89,7806,7809
10325,3,303,12,170.67,14460.22,7808,7811
10326,1,512,512,512.00,0.00,7810,7811
10327,6,265,1,85.33,8688.89,7810,7816
10328,3,385,40,170.67,23337.56,7815,7818
10329,2,261,251,256.00,25.00,7817,7819
10330,3,317,79,170.67,10934.89,7818,7821
10331,1,512,512,512.00,0.00,7820,7821
10332,1,512,512,512.00,0.00,7820,7821
10333,1,512,512,512.00,0.00,7820,7821
10334,2,370,142,256.00,12996.00,7820,7822
10335,2,309,203,256.00,2809.00,7821,7823
10336,1,512,512,512.00,0.00,7822,7823
10337,1,512,512,512.00,0.00,7822,7823
10338,1,512,512,512.00,0.00,7822,7823
10339,1,512,512,512.00,0.00,7822,7823
10340,2,419,93,256.00,26569.00,7822,7824
10341,1,512,512,512.00,0.00,7823,7824
10342,1,512,512,512.00,0.00,7823,7824
10343,1,512,512,512.00,0.00,7823,7824
10344,1,512,512,512.00,0.00,7823,7824
10345,2,390,122,256.00,17956.00,7823,7825
10346,1,512,512,512.00,0.00,7824,7825
10347,1,512,512,512.00,0.00,7824,7825
10348,2,472,40,256.00,46656.00,7824,7826
10349,1,512,512,512.00,0.00,7825,7826
10350,1,512,512,512.00,0.00,7825,7826
10351,1,512,512,512.00,0.00,7825,7826
10352,1,512,512,512.00,0.00,7825,7826
10353,2,385,127,256.00,16641.00,7825,7827
10354,1,512,512,512.00,0.00,7826,7827
10355,1,512,512,512.00,0.00,7826,7827
10356,1,512,512,512.00,0.00,7826,7827
10357,5,360,5,102.40,17069.84,7826,7831
10358,1,512,512,512.00,0.00,7830,7831
10359,3,267,87,170.67,5480.22,7830,7833
10360,2,310,202,256.00,2916.00,7832,7834
10361,1,512,512,512.00,0.00,7833,7834
10362,1,512,512,512.00,0.00,7833,7834
10363,1,512,512,512.00,0.00,7833,7834
10364,1,512,512,512.00,0.00,7833,7834
10365,3,485,1,170.67,49506.89,7833,7836
10366,1,512,512,512.00,0.00,7835,7836
10367,1,512,512,512.00,0.00,7835,7836
10368,3,421,31,170.67,31473.56,7835,7838
10369,3,375,18,170.67,22576.22,7837,7840
10370,1,512,512,512.00,0.00,7839,7840
10371,4,201,29,128.00,3927.50,7839,7843
10372,3,281,42,170.67,9688.22,7842,7845
10373,2,283,229,256.00,729.00,7844,7846
10374,1,512,512,512.00,0.00,7845,7846
10375,1,512,512,512.00,0.00,7845,7846
10376,1,512,512,512.00,0.00,7845,7846
10377,2,270,242,256.00,196.00,7845,7847
10378,1,512,512,512.00,0.00,7846,7847
10379,1,512,512,512.00,0.00,7846,7847
10380,1,512,512,512.00,0.00,7846,7847
10381,1,512,512,512.00,0.00,7846,7847
10382,2,424,88,256.00,28224.00,7846,7848
10383,1,512,512,512.00,0.00,7847,7848
10384,3,431,38,170.67,33890.89,7847,7850
10385,1,512,512,512.00,0.00,7849,7850
10386,1,512,512,512.00,0.00,7849,7850
10387,2,379,133,256.00,15129.00,7849,7851
10388,1,512,512,512.00,0.00,7850,7851
10389,6,195,16,85.33,4345.89,7850,7856
10390,2,334,178,256.00,6084.00,7855,7857
10391,2,424,88,256.00,28224.00,7856,7858
10392,1,512,512,512.00,0.00,7857,7858
10393,1,512,512,512.00,0.00,7857,7858
10394,1,512,512,512.00,0.00,7857,7858
10395,3,264,35,170.67,9636.22,7857,7860
10396,1,512,512,512.00,0.00,7859,7860
10397,5,339,16,102.40,14269.04,7859,7864
10398,5,179,21,102.40,3735.04,7863,7868
10399,1,512,512,512.00,0.00,7867,7868
10400,2,470,42,256.00,45796.00,7867,7869
10401,1,512,512,512.00,0.00,7868,7869
10402,1,512,512,512.00,0.00,7868,7869
10403,1,512,512,512.00,0.00,7868,7869
10404,1,512,512,512.00,0.00,7868,7869
10405,1,512,512,512.00,0.00,7868,7869
10406,3,304,18,170.67,13819.56,7868,7871
10407,2,343,169,256.00,7569.00,7870,7872
10408,3,282,40,170.67,9947.56,7871,7874
10409,1,512,512,512.00,0.00,7873,7874
10410,1,512,512,512.00,0.00,7873,7874
10411,2,276,236,256.00,400.00,7873,7875
10412,1,512,512,512.00,0.00,7874,7875
10413,1,512,512,512.00,0.00,7874,7875
10414,2,404,108,256.00,21904.00,7874,7876
10415,1,512,512,512.00,0.00,7875,7876
10416,1,512,512,512.00,0.00,7875,7876
10417,1,512,512,512.00,0.00,7875,7876
10418,2,455,57,256.00,39601.00,7875,7877
10419,1,512,512,512.00,0.00,7876,7877
10420,1,512,512,512.00,0.00,7876,7877
10421,1,512,512,512.00,0.00,7876,7877
10422,1,512,512,512.00,0.00,7876,7877
10423,3,332,1,170.67,18294.89,7876,7879
10424,1,512,512,512.00,0.00,7878,7879
10425,1,512,512,512.00,0.00,7878,7879
10426,1,512,512,512.00,0.00,7878,7879
10427,2,273,239,256.00,289.00,7878,7880
10428,1,512,512,512.00,0.00,7879,7880
10429,2,317,195,256.00,3721.00,7879,7881
10430,1,512,512,512.00,0.00,7880,7881
10431,1,512,512,512.00,0.00,7880,7881
10432,2,422,90,256.00,27556.00,7880,7882
10433,2,333,179,256.00,5929.00,7881,7883
10434,1,512,512,512.00,0.00,7882,7883
10435,1,512,512,512.00,0.00,7882,7883
10436,2,317,195,256.00,3721.00,7882,7884
10437,1,512,512,512.00,0.00,7883,7884
10438,1,512,512,512.00,0.00,7883,7884
10439,1,512,512,512.00,0.00,7883,7884
10440,4,489,5,128.00,43443.50,7883,7887
10441,1,512,512,512.00,0.00,7886,7887
10442,2,500,12,256.00,59536.00,7886,7888
10443,5,215,10,102.40,5439.04,7887,7892
10444,6,354,1,85.33,15802.22,7891,7897
10445,1,512,512,512.00,0.00,7896,7897
10446,1,512,512,512.00,0.00,7896,7897
10447,3,437,22,170.67,35626.89,7896,7899
10448,2,461,51,256.00,42025.00,7898,7900
10449,1,512,512,512.00,0.00,7899,7900
10450,1,512,512,512.00,0.00,7899,7900
10451,1,512,512,512.00,0.00,7899,7900
10452,2,437,75,256.00,32761.00,7899,7901
10453,1,512,512,512.00,0.00,7900,7901
10454,1,512,512,512.00,0.00,7900,7901
10455,1,512,512,512.00,0.00,7900,7901
10456,2,324,188,256.00,4624.00,7900,7902
10457,1,512,512,512.00,0.00,7901,7902
10458,1,512,512,512.00,0.00,7901,7902
10459,1,512,512,512.00,0.00,7901,7902
10460,1,512,512,512.00,0.00,7901,7902
10461,1,512,512,512.00,0.00,7901,7902
10462,1,512,512,512.00,0.00,7901,7902
10463,2,450,62,256.00,37636.00,7901,7903
10464,2,468,44,256.00,44944.00,7902,7904
10465,1,512,512,512.00,0.00,7903,7904
10466,1,512,512,512.00,0.00,7903,7904
10467,1,512,512,512.00,0.00,7903,7904
10468,2,423,89,256.00,27889.00,7903,7905
10469,1,512,512,512.00,0.00,7904,7905
10470,2,412,100,256.00,24336.00,7904,7906
10471,1,512,512,512.00,0.00,7905,7906
10472,1,512,512,512.00,0.00,7905,7906
10473,2,466,46,256.00,44100.00,7905,7907
10474,1,512,512,512.00,0.00,7906,7907
10475,2,361,151,256.00,11025.00,7906,7908
10476,1,512,512,512.00,0.00,7907,7908
10477,2,500,12,256.00,59536.00,7907,7909
10478,1,512,512,512.00,0.00,7908,7909
10479,2,277,235,256.00,441.00,7908,7910
10480,2,407,105,256.00,22801.00,7909,7911
10481,1,512,512,512.00,0.00,7910,7911
10482,1,512,512,512.00,0.00,7910,7911
10483,3,338,5,170.67,18482.89,7910,7913
10484,1,512,512,512.00,0.00,7912,7913
10485,1,512,512,512.00,0.00,7912,7913
10486,1,512,512,512.00,0.00,7912,7913
10487,2,437,75,256.00,32761.00,7912,7914
10488,1,512,512,512.00,0.00,7913,7914
10489,2,449,63,256.00,37249.00,7913,7915
10490,2,369,143,256.00,12769.00,7914,7916
10491,1,512,512,512.00,0.00,7915,7916
10492,2,441,71,256.00,34225.00,7915,7917
10493,2,388,124,256.00,17424.00,7916,7918
10494,1,512,512,512.00,0.00,7917,7918
10495,2,271,241,256.00,225.00,7917,7919
10496,2,342,170,256.00,7396.00,7918,7920
10497,2,305,207,256.00,2401.00,7919,7921
10498,1,512,512,512.00,0.00,7920,7921
10499,1,512,512,512.00,0.00,7920,7921
10500,2,318,194,256.00,3844.00,7920,7922
10501,2,411,101,256.00,24025.00,7921,7923
10502,1,512,512,512.00,0.00,7922,7923
10503,2,451,61,256.00,38025.00,7922,7924
10504,1,512,512,512.00,0.00,7923,7924
10505,3,408,51,170.67,28164.22,7923,7926
10506,1,512,512,512.00,0.00,7925,7926
10507,3,247,21,170.67,11201.56,7925,7928
10508,2,403,109,256.00,21609.00,7927,7929
10509,3,305,83,170.67,9302.89,7928,7931
10510,1,512,512,512.00,0.00,7930,7931
10511,3,239,128,170.67,2382.89,7930,7933
10512,1,512,512,512.00,0.00,7932,7933
10513,1,512,512,512.00,0.00,7932,7933
10514,2,327,185,256.00,5041.00,7932,7934
10515,1,512,512,512.00,0.00,7933,7934
10516,1,512,512,512.00,0.00,7933,7934
10517,1,512,512,512.00,0.00,7933,7934
10518,1,512,512,512.00,0.00,7933,7934
10519,2,259,253,256.00,9.00,7933,7935
10520,1,512,512,512.00,0.00,7934,7935
10521,1,512,512,512.00,0.00,7934,7935
10522,1,512,512,512.00,0.00,7934,7935
10523,2,484,28,256.00,51984.00,7934,7936
10524,2,502,10,256.00,60516.00,7935,7937
10525,3,233,52,170.67,7046.89,7936,7939
10526,2,425,87,256.00,28561.00,7938,7940
10527,2,467,45,256.00,44521.00,7939,7941
10528,1,512,512,512.00,0.00,7940,7941
10529,1,512,512,512.00,0.00,7940,7941
10530,1,512,512,512.00,0.00,7940,7941
10531,2,454,58,256.00,39204.00,7940,7942
10532,1,512,512,512.00,0.00,7941,7942
10533,1,512,512,512.00,0.00,7941,7942
10534,1,512,512,512.00,0.00,7941,7942
10535,2,389,123,256.00,17689.00,7941,7943
10536,1,512,512,512.00,0.00,7942,7943
10537,1,512,512,512.00,0.00,7942,7943
10538,1,512,512,512.00,0.00,7942,7943
10539,1,512,512,512.00,0.00,7942,7943
10540,2,502,10,256.00,60516.00,7942,7944
10541,1,512,512,512.00,0.00,7943,7944
10542,1,512,512,512.00,0.00,7943,7944
10543,2,489,23,256.00,54289.00,7943,7945
10544,2,494,18,256.00,56644.00,7944,7946
10545,1,512,512,512.00,0.00,7945,7946
10546,2,311,201,256.00,3025.00,7945,7947
10547,1,512,512,512.00,0.00,7946,7947
10548,2,303,209,256.00,2209.00,7946,7948
10549,4,245,48,128.00,6571.50,7947,7951
10550,1,512,512,512.00,0.00,7950,7951
10551,1,512,512,512.00,0.00,7950,7951
10552,1,512,512,512.00,0.00,7950,7951
10553,1,512,512,512.00,0.00,7950,7951
10554,3,383,21,170.67,23804.22,7950,7953
10555,1,512,512,512.00,0.00,7952,7953
10556,2,467,45,256.00,44521.00,7952,7954
10557,2,287,225,256.00,961.00,7953,7955
10558,1,512,512,512.00,0.00,7954,7955
10559,1,512,512,512.00,0.00,7954,7955
10560,1,512,512,512.00,0.00,7954,7955
10561,2,401,111,256.00,21025.00,7954,7956
10562,1,512,512,512.00,0.00,7955,7956
10563,1,512,512,512.00,0.00,7955,7956
10564,1,512,512,512.00,0.00,7955,7956
10565,1,512,512,512.00,0.00,7955,7956
10566,1,512,512,512.00,0.00,7955,7956
10567,2,446,66,256.00,36100.00,7955,7957
10568,1,512,512,512.00,0.00,7956,7957
10569,1,512,512,512.00,0.00,7956,7957
10570,2,477,35,256.00,48841.00,7956,7958
10571,2,383,129,256.00,16129.00,7957,7959
10572,1,512,512,512.00,0.00,7958,7959
10573,1,512,512,512.00,0.00,7958,7959
10574,1,512,512,512.00,0.00,7958,7959
10575,1,512,512,512.00,0.00,7958,7959
10576,2,379,133,256.00,15129.00,7958,7960
10577,1,512,512,512.00,0.00,7959,7960
10578,3,314,86,170.67,10384.89,7959,7962
10579,1,512,512,512.00,0.00,7961,7962
10580,1,512,512,512.00,0.00,7961,7962
10581,1,512,512,512.00,0.00,7961,7962
10582,2,264,248,256.00,64.00,7961,7963
10583,2,511,1,256.00,65025.00,7962,7964
10584,1,512,512,512.00,0.00,7963,7964
10585,1,512,512,512.00,0.00,7963,7964
10586,2,313,199,256.00,3249.00,7963,7965
10587,1,512,512,512.00,0.00,7964,7965
10588,1,512,512,512.00,0.00,7964,7965
10589,3,347,58,170.67,15946.89,7964,7967
10590,1,512,512,512.00,0.00,7966,7967
10591,1,512,512,512.00,0.00,7966,7967
10592,1,512,512,512.00,0.00,7966,7967
10593,1,512,512,512.00,0.00,7966,7967
10594,2,471,41,256.00,46225.00,7966,7968
10595,1,512,512,512.00,0.00,7967,7968
10596,1,512,512,512.00,0.00,7967,7968
10597,1,512,512,512.00,0.00,7967,7968
10598,1,512,512,512.00,0.00,7967,7968
10599,2,296,216,256.00,1600.00,7967,7969
10600,1,512,512,512.00,0.00,7968,7969
10601,1,512,512,512.00,0.00,7968,7969
10602,2,297,215,256.00,1681.00,7968,7970
10603,1,512,512,512.00,0.00,7969,7970
10604,1,512,512,512.00,0.00,7969,7970
10605,2,311,201,256.00,3025.00,7969,7971
10606,1,512,512,512.00,0.00,7970,7971
10607,1,512,512,512.00,0.00,7970,7971
10608,1,512,512,512.00,0.00,7970,7971
10609,1,512,512,512.00,0.00,7970,7971
10610,2,256,256,256.00,0.00,7970,7972
10611,2,297,215,256.00,1681.00,7971,7973
10612,1,512,512,512.00,0.00,7972,7973
10613,1,512,512,512.00,0.00,7972,7973
10614,2,281,231,256.00,625.00,7972,7974
10615,1,512,512,512.00,0.00,7973,7974
10616,1,512,512,512.00,0.00,7973,7974
10617,1,512,512,512.00,0.00,7973,7974
10618,2,479,33,256.00,49729.00,7973,7975
10619,1,512,512,512.00,0.00,7974,7975
10620,1,512,512,512.00,0.00,7974,7975
10621,1,512,512,512.00,0.00,7974,7975
10622,1,512,512,512.00,0.00,7974,7975
10623,2,425,87,256.00,28561.00,7974,7976
10624,2,503,9,256.00,61009.00,7975,7977
10625,1,512,512,512.00,0.00,7976,7977
10626,2,473,39,256.00,47089.00,7976,7978
10627,2,474,38,256.00,47524.00,7977,7979
10628,1,512,512,512.00,0.00,7978,7979
10629,1,512,512,512.00,0.00,7978,7979
10630,1,512,512,512.00,0.00,7978,7979
10631,2,318,194,256.00,3844.00,7978,7980
10632,2,419,93,256.00,26569.00,7979,7981
10633,2,496,16,256.00,57600.00,7980,7982
10634,1,512,512,512.00,0.00,7981,7982
10635,1,512,512,512.00,0.00,7981,7982
10636,1,512,512,512.00,0.00,7981,7982
10637,1,512,512,512.00,0.00,7981,7982
10638,1,512,512,512.00,0.00,7981,7982
10639,2,396,116,256.00,19600.00,7981,7983
10640,1,512,512,512.00,0.00,7982,7983
10641,2,435,77,256.00,32041.00,7982,7984
10642,2,482,30,256.00,51076.00,7983,7985
10643,2,400,112,256.00,20736.00,7984,7986
10644,1,512,512,512.00,0.00,7985,7986
10645,1,512,512,512.00,0.00,7985,7986
10646,1,512,512,512.00,0.00,7985,7986
10647,2,426,86,256.00,28900.00,7985,7987
10648,1,512,512,512.00,0.00,7986,7987
10649,1,512,512,512.00,0.00,7986,7987
10650,1,512,512,512.00,0.00,7986,7987
10651,1,512,512,512.00,0.00,7986,7987
10652,1,512,512,512.00,0.00,7986,7987
10653,1,512,512,512.00,0.00,7986,7987
10654,2,343,169,256.00,7569.00,7986,7988
10655,1,512,512,512.00,0.00,7987,7988
10656,2,435,77,256.00,32041.00,7987,7989
10657,1,512,512,512.00,0.00,7988,7989
10658,1,512,512,512.00,0.00,7988,7989
10659,3,419,1,170.67,32214.89,7988,7991
10660,1,512,512,512.00,0.00,7990,7991
10661,2,482,30,256.00,51076.00,7990,7992
10662,1,512,512,512.00,0.00,7991,7992
10663,2,408,104,256.00,23104.00,7991,7993
10664,1,512,512,512.00,0.00,7992,7993
10665,1,512,512,512.00,0.00,7992,7993
10666,1,512,512,512.00,0.00,7992,7993
10667,2,332,180,256.00,5776.00,7992,7994
10668,1,512,512,512.00,0.00,7993,7994
10669,1,512,512,512.00,0.00,7993,7994
10670,1,512,512,512.00,0.00,7993,7994
10671,1,512,512,512.00,0.00,7993,7994
10672,1,512,512,512.00,0.00,7993,7994
10673,2,364,148,256.00,11664.00,7993,7995
10674,1,512,512,512.00,0.00,7994,7995
10675,2,412,100,256.00,24336.00,7994,7996
10676,1,512,512,512.00,0.00,7995,7996
10677,1,512,512,512.00,0.00,7995,7996
10678,3,384,53,170.67,22836.22,7995,7998
10679,2,261,251,256.00,25.00,7997,7999
10680,1,512,512,512.00,0.00,7998,7999
10681,1,512,512,512.00,0.00,7998,7999
10682,1,512,512,512.00,0.00,7998,7999
10683,1,512,512,512.00,0.00,7998,7999
10684,2,267,245,256.00,121.00,7998,8000
10685,1,512,512,512.00,0.00,7999,8000
10686,1,512,512,512.00,0.00,7999,8000
10687,1,512,512,512.00,0.00,7999,8000
10688,1,512,512,512.00,0.00,7999,8000
10689,2,320,192,256.00,4096.00,7999,8001
10690,1,512,512,512.00,0.00,8000,8001
10691,1,512,512,512.00,0.00,8000,8001
10692,2,412,100,256.00,24336.00,8000,8002
10693,1,512,512,512.00,0.00,8001,8002
10694,1,512,512,512.00,0.00,8001,8002
10695,1,512,512,512.00,0.00,8001,8002
10696,1,512,512,512.00,0.00,8001,8002
10697,2,278,234,256.00,484.00,8001,8003
10698,1,512,512,512.00,0.00,8002,8003
10699,1,512,512,512.00,0.00,8002,8003
10700,1,512,512,512.00,0.00,8002,8003
10701,2,480,32,256.00,50176.00,8002,8004
10702,1,512,512,512.00,0.00,8003,8004
10703,2,394,118,256.00,19044.00,8003,8005
10704,1,512,512,512.00,0.00,8004,8005
10705,1,512,512,512.00,0.00,8004,8005
10706,2,377,135,256.00,14641.00,8004,8006
10707,3,380,39,170.67,22396.22,8005,8008
10708,1,512,512,512.00,0.00,8007,8008
10709,1,512,512,512.00,0.00,8007,8008
10710,1,512,512,512.00,0.00,8007,8008
10711,2,423,89,256.00,27889.00,8007,8009
10712,1,512,512,512.00,0.00,8008,8009
10713,3,428,40,170.67,33112.89,8008,8011
10714,1,512,512,512.00,0.00,8010,8011
10715,1,512,512,512.00,0.00,8010,8011
10716,1,512,512,512.00,0.00,8010,8011
10717,3,339,2,170.67,18928.22,8010,8013
10718,2,481,31,256.00,50625.00,8012,8014
10719,1,512,512,512.00,0.00,8013,8014
10720,1,512,512,512.00,0.00,8013,8014
10721,2,448,64,256.00,36864.00,8013,8015
10722,3,306,87,170.67,9328.22,8014,8017
10723,1,512,512,512.00,0.00,8016,8017
10724,1,512,512,512.00,0.00,8016,8017
10725,1,512,512,512.00,0.00,8016,8017
10726,2,457,55,256.00,40401.00,8016,8018
10727,1,512,512,512.00,0.00,8017,8018
10728,1,512,512,512.00,0.00,8017,8018
10729,3,220,141,170.67,1233.56,8017,8020
10730,3,271,6,170.67,13773.56,8019,8022
10731,1,512,512,512.00,0.00,8021,8022
10732,2,336,176,256.00,6400.00,8021,8023
10733,1,512,512,512.00,0.00,8022,8023
10734,1,512,512,512.00,0.00,8022,8023
10735,1,512,512,512.00,0.00,8022,8023
10736,2,425,87,256.00,28561.00,8022,8024
10737,2,414,98,256.00,24964.00,8023,8025
10738,1,512,512,512.00,0.00,8024,8025
10739,1,512,512,512.00,0.00,8024,8025
10740,2,487,25,256.00,53361.00,8024,8026
10741,1,512,512,512.00,0.00,8025,8026
10742,1,512,512,512.00,0.00,8025,8026
10743,1,512,512,512.00,0.00,8025,8026
10744,1,512,512,512.00,0.00,8025,8026
10745,1,512,512,512.00,0.00,8025,8026
10746,1,512,512,512.00,0.00,8025,8026
10747,3,295,2,170.67,15290.89,8025,8028
10748,1,512,512,512.00,0.00,8027,8028
10749,1,512,512,512.00,0.00,8027,8028
10750,3,262,41,170.67,8874.89,8027,8030
10751,2,293,219,256.00,1369.00,8029,8031
10752,1,512,512,512.00,0.00,8030,8031
10753,1,512,512,512.00,0.00,8030,8031
10754,1,512,512,512.00,0.00,8030,8031
10755,2,345,167,256.00,7921.00,8030,8032
10756,1,512,512,512.00,0.00,8031,8032
10757,1,512,512,512.00,0.00,8031,8032
10758,1,512,512,512.00,0.00,8031,8032
10759,2,262,250,256.00,36.00,8031,8033
10760,1,512,512,512.00,0.00,8032,8033
10761,2,502,10,256.00,60516.00,8032,8034
10762,1,512,512,512.00,0.00,8033,8034
10763,1,512,512,512.00,0.00,8033,8034
10764,2,318,194,256.00,3844.00,8033,8035
10765,2,485,27,256.00,52441.00,8034,8036
10766,2,305,207,256.00,2401.00,8035,8037
10767,3,269,46,170.67,8634.89,8036,8039
10768,1,512,512,512.00,0.00,8038,8039
10769,2,412,100,256.00,24336.00,8038,8040
10770,1,512,512,512.00,0.00,8039,8040
10771,1,512,512,512.00,0.00,8039,8040
10772,1,512,512,512.00,0.00,8039,8040
10773,1,512,512,512.00,0.00,8039,8040
10774,1,512,512,512.00,0.00,8039,8040
10775,2,257,255,256.00,1.00,8039,8041
10776,1,512,512,512.00,0.00,8040,8041
10777,1,512,512,512.00,0.00,8040,8041
10778,1,512,512,512.00,0.00,8040,8041
10779,2,369,143,256.00,12769.00,8040,8042
10780,1,512,512,512.00,0.00,8041,8042
10781,2,433,79,256.00,31329.00,8041,8043
10782,1,512,512,512.00,0.00,8042,8043
10783,1,512,512,512.00,0.00,8042,8043
10784,1,512,512,512.00,0.00,8042,8043
10785,2,436,76,256.00,32400.00,8042,8044
10786,2,411,101,256.00,24025.00,8043,8045
10787,2,509,3,256.00,64009.00,8044,8046
10788,1,512,512,512.00,0.00,8045,8046
10789,1,512,512,512.00,0.00,8045,8046
10790,1,512,512,512.00,0.00,8045,8046
10791,1,512,512,512.00,0.00,8045,8046
10792,1,512,512,512.00,0.00,8045,8046
10793,3,495,3,170.67,52616.22,8045,8048
10794,1,512,512,512.00,0.00,8047,8048
10795,1,512,512,512.00,0.00,8047,8048
10796,2,438,74,256.00,33124.00,8047,8049
10797,2,302,210,256.00,2116.00,8048,8050
10798,1,512,512,512.00,0.00,8049,8050
10799,1,512,512,512.00,0.00,8049,8050
10800,1,512,512,512.00,0.00,8049,8050
10801,2,415,97,256.00,25281.00,8049,8051
10802,1,512,512,512.00,0.00,8050,8051
10803,2,444,68,256.00,35344.00,8050,8052
10804,3,299,94,170.67,8338.89,8051,8054
10805,1,512,512,512.00,0.00,8053,8054
10806,1,512,512,512.00,0.00,8053,8054
10807,1,512,512,512.00,0.00,8053,8054
10808,1,512,512,512.00,0.00,8053,8054
10809,1,512,512,512.00,0.00,8053,8054
10810,2,456,56,256.00,40000.00,8053,8055
10811,1,512,512,512.00,0.00,8054,8055
10812,1,512,512,512.00,0.00,8054,8055
10813,1,512,512,512.00,0.00,8054,8055
10814,1,512,512,512.00,0.00,8054,8055
10815,3,232,50,170.67,7280.89,8054,8057
10816,1,512,512,512.00,0.00,8056,8057
10817,2,484,28,256.00,51984.00,8056,8058
10818,2,418,94,256.00,26244.00,8057,8059
10819,1,512,512,512.00,0.00,8058,8059
10820,1,512,512,512.00,0.00,8058,8059
10821,1,512,512,512.00,0.00,8058,8059
10822,1,512,512,512.00,0.00,8058,8059
10823,2,312,200,256.00,3136.00,8058,8060
10824,1,512,512,512.00,0.00,8059,8060
10825,1,512,512,512.00,0.00,8059,8060
10826,1,512,512,512.00,0.00,8059,8060
10827,3,402,37,170.67,26973.56,8059,8062
10828,1,512,512,512.00,0.00,8061,8062
10829,2,485,27,256.00,52441.00,8061,8063
10830,1,512,512,512.00,0.00,8062,8063
10831,3,248,100,170.67,3672.89,8062,8065
10832,1,512,512,512.00,0.00,8064,8065
10833,2,385,127,256.00,16641.00,8064,8066
10834,1,512,512,512.00,0.00,8065,8066
10835,2,270,242,256.00,196.00,8065,8067
10836,1,512,512,512.00,0.00,8066,8067
10837,2,390,122,256.00,17956.00,8066,8068
10838,1,512,512,512.00,0.00,8067,8068
10839,2,300,212,256.00,1936.00,8067,8069
10840,2,274,238,256.00,324.00,8068,8070
10841,1,512,512,512.00,0.00,8069,8070
10842,1,512,512,512.00,0.00,8069,8070
10843,1,512,512,512.00,0.00,8069,8070
10844,1,512,512,512.00,0.00,8069,8070
10845,1,512,512,512.00,0.00,8069,8070
10846,3,274,111,170.67,5381.56,8069,8072
10847,1,512,512,512.00,0.00,8071,8072
10848,2,464,48,256.00,43264.00,8071,8073
10849,1,512,512,512.00,0.00,8072,8073
10850,1,512,512,512.00,0.00,8072,8073
10851,1,512,512,512.00,0.00,8072,8073
10852,2,257,255,256.00,1.00,8072,8074
10853,1,512,512,512.00,0.00,8073,8074
10854,1,512,512,512.00,0.00,8073,8074
10855,1,512,512,512.00,0.00,8073,8074
10856,1,512,512,512.00,0.00,8073,8074
10857,2,282,230,256.00,676.00,8073,8075
10858,2,434,78,256.00,31684.00,8074,8076
10859,1,512,512,512.00,0.00,8075,8076
10860,2,428,84,256.00,29584.00,8075,8077
10861,2,292,220,256.00,1296.00,8076,8078
10862,2,396,116,256.00,19600.00,8077,8079
10863,1,512,512,512.00,0.00,8078,8079
10864,1,512,512,512.00,0.00,8078,8079
10865,1,512,512,512.00,0.00,8078,8079
10866,1,512,512,512.00,0.00,8078,8079
10867,2,257,255,256.00,1.00,8078,8080
10868,1,512,512,512.00,0.00,8079,8080
10869,1,512,512,512.00,0.00,8079,8080
10870,1,512,512,512.00,0.00,8079,8080
10871,2,437,75,256.00,32761.00,8079,8081
10872,1,512,512,512.00,0.00,8080,8081
10873,1,512,512,512.00,0.00,8080,8081
10874,1,512,512,512.00,0.00,8080,8081
10875,2,308,204,256.00,2704.00,8080,8082
10876,1,512,512,512.00,0.00,8081,8082
10877,1,512,512,512.00,0.00,8081,8082
10878,1,512,512,512.00,0.00,8081,8082
10879,1,512,512,512.00,0.00,8081,8082
10880,2,461,51,256.00,42025.00,8081,8083
10881,2,422,90,256.00,27556.00,8082,8084
10882,2,411,101,256.00,24025.00,8083,8085
10883,1,512,512,512.00,0.00,8084,8085
10884,1,512,512,512.00,0.00,8084,8085
10885,2,468,44,256.00,44944.00,8084,8086
10886,1,512,512,512.00,0.00,8085,8086
10887,1,512,512,512.00,0.00,8085,8086
10888,1,512,512,512.00,0.00,8085,8086
10889,2,451,61,256.00,38025.00,8085,8087
10890,2,318,194,256.00,3844.00,8086,8088
10891,1,512,512,512.00,0.00,8087,8088
10892,1,512,512,512.00,0.00,8087,8088
10893,3,288,7,170.67,14233.56,8087,8090
10894,3,251,79,170.67,4994.89,8089,8092
10895,1,512,512,512.00,0.00,8091,8092
10896,2,428,84,256.00,29584.00,8091,8093
10897,4,317,12,128.00,13213.50,8092,8096
10898,2,475,37,256.00,47961.00,8095,8097
10899,1,512,512,512.00,0.00,8096,8097
10900,1,512,512,512.00,0.00,8096,8097
10901,2,377,135,256.00,14641.00,8096,8098
10902,1,512,512,512.00,0.00,8097,8098
10903,1,512,512,512.00,0.00,8097,8098
10904,2,333,179,256.00,5929.00,8097,8099
10905,1,512,512,512.00,0.00,8098,8099
10906,1,512,512,512.00,0.00,8098,8099
10907,1,512,512,512.00,0.00,8098,8099
10908,2,343,169,256.00,7569.00,8098,8100
10909,1,512,512,512.00,0.00,8099,8100
10910,2,311,201,256.00,3025.00,8099,8101
10911,1,512,512,512.00,0.00,8100,8101
10912,1,512,512,512.00,0.00,8100,8101
10913,5,388,6,102.40,21213.44,8100,8105
10914,1,512,512,512.00,0.00,8104,8105
10915,1,512,512,512.00,0.00,8104,8105
10916,2,340,172,256.00,7056.00,8104,8106
10917,1,512,512,512.00,0.00,8105,8106
10918,1,512,512,512.00,0.00,8105,8106
10919,2,463,49,256.00,42849.00,8105,8107
10920,1,512,512,512.00,0.00,8106,8107
10921,1,512,512,512.00,0.00,8106,8107
10922,1,512,512,512.00,0.00,8106,8107
10923,2,322,190,256.00,4356.00,8106,8108
10924,2,342,170,256.00,7396.00,8107,8109
10925,1,512,512,512.00,0.00,8108,8109
10926,1,512,512,512.00,0.00,8108,8109
10927,1,512,512,512.00,0.00,8108,8109
10928,1,512,512,512.00,0.00,8108,8109
10929,2,510,2,256.00,64516.00,8108,8110
10930,4,414,2,128.00,27956.00,8110,8114
10931,1,512,512,512.00,0.00,8113,8114
10932,3,441,1,170.67,37333.56,8113,8116
10933,1,512,512,512.00,0.00,8115,8116
10934,1,512,512,512.00,0.00,8115,8116
10935,1,512,512,512.00,0.00,8115,8116
10936,5,367,8,102.40,19000.24,8116,8121
10937,2,334,178,256.00,6084.00,8120,8122
10938,1,512,512,512.00,0.00,8121,8122
10939,1,512,512,512.00,0.00,8121,8122
10940,2,414,98,256.00,24964.00,8121,8123
10941,4,421,25,128.00,28645.00,8122,8126
10942,4,494,3,128.00,44665.50,8125,8129
10943,3,372,31,170.67,21281.56,8128,8131
10944,2,449,63,256.00,37249.00,8130,8132
10945,1,512,512,512.00,0.00,8131,8132
10946,1,512,512,512.00,0.00,8131,8132
10947,3,280,21,170.67,11993.56,8131,8134
10948,2,394,118,256.00,19044.00,8133,8135
10949,2,264,248,256.00,64.00,8134,8136
10950,1,512,512,512.00,0.00,8135,8136
10951,1,512,512,512.00,0.00,8135,8136
10952,3,505,2,170.67,55890.89,8135,8138
10953,1,512,512,512.00,0.00,8137,8138
10954,1,512,512,512.00,0.00,8137,8138
10955,1,512,512,512.00,0.00,8137,8138
10956,1,512,512,512.00,0.00,8137,8138
10957,2,459,53,256.00,41209.00,8137,8139
10958,1,512,512,512.00,0.00,8138,8139
10959,1,512,512,512.00,0.00,8138,8139
10960,1,512,512,512.00,0.00,8138,8139
10961,1,512,512,512.00,0.00,8138,8139
10962,2,500,12,256.00,59536.00,8138,8140
10963,1,512,512,512.00,0.00,8139,8140
10964,2,327,185,256.00,5041.00,8139,8141
10965,1,512,512,512.00,0.00,8140,8141
10966,1,512,512,512.00,0.00,8140,8141
10967,1,512,512,512.00,0.00,8140,8141
10968,1,512,512,512.00,0.00,8140,8141
10969,3,292,58,170.67,9163.56,8140,8143
10970,1,512,512,512.00,0.00,8142,8143
10971,1,512,512,512.00,0.00,8142,8143
10972,1,512,512,512.00,0.00,8142,8143
10973,2,387,125,256.00,17161.00,8142,8144
10974,4,296,61,128.00,9459.50,8143,8147
10975,2,393,119,256.00,18769.00,8146,8148
10976,4,265,33,128.00,7173.50,8147,8151
10977,2,281,231,256.00,625.00,8150,8152
10978,2,310,202,256.00,2916.00,8151,8153
10979,2,474,38,256.00,47524.00,8152,8154
10980,2,264,248,256.00,64.00,8153,8155
10981,1,512,512,512.00,0.00,8154,8155
10982,1,512,512,512.00,0.00,8154,8155
10983,2,455,57,256.00,39601.00,8154,8156
10984,1,512,512,512.00,0.00,8155,8156
10985,2,339,173,256.00,6889.00,8155,8157
10986,1,512,512,512.00,0.00,8156,8157
10987,1,512,512,512.00,0.00,8156,8157
10988,2,310,202,256.00,2916.00,8156,8158
10989,1,512,512,512.00,0.00,8157,8158
10990,1,512,512,512.00,0.00,8157,8158
10991,1,512,512,512.00,0.00,8157,8158
10992,2,325,187,256.00,4761.00,8157,8159
10993,2,378,134,256.00,14884.00,8158,8160
10994,2,286,226,256.00,900.00,8159,8161
10995,1,512,512,512.00,0.00,8160,8161
10996,5,289,25,102.40,9271.84,8160,8165
10997,1,512,512,512.00,0.00,8164,8165
10998,2,504,8,256.00,61504.00,8164,8166
10999,1,512,512,512.00,0.00,8165,8166
11000,1,512,512,512.00,0.00,8165,8166
11001,1,512,512,512.00,0.00,8165,8166
11002,2,265,247,256.00,81.00,8165,8167
11003,1,512,512,512.00,0.00,8166,8167
11004,1,512,512,512.00,0.00,8166,8167
11005,1,512,512,512.00,0.00,8166,8167
11006,2,415,97,256.00,25281.00,8166,8168
11007,2,378,134,256.00,14884.00,8167,8169
11008,1,512,512,512.00,0.00,8168,8169
11009,2,431,81,256.00,30625.00,8168,8170
11010,2,493,19,256.00,56169.00,8169,8171
11011,1,512,512,512.00,0.00,8170,8171
11012,2,306,206,256.00,2500.00,8170,8172
11013,4,345,36,128.00,15851.50,8171,8175
11014,1,512,512,512.00,0.00,8174,8175
11015,1,512,512,512.00,0.00,8174,8175
11016,1,512,512,512.00,0.00,8174,8175
11017,2,411,101,256.00,24025.00,8174,8176
11018,3,362,10,170.67,21120.89,8175,8178
11019,1,512,512,512.00,0.00,8177,8178
11020,1,512,512,512.00,0.00,8177,8178
11021,1,512,512,512.00,0.00,8177,8178
11022,1,512,512,512.00,0.00,8177,8178
11023,2,446,66,256.00,36100.00,8177,8179
11024,1,512,512,512.00,0.00,8178,8179
11025,2,263,249,256.00,49.00,8178,8180
11026,1,512,512,512.00,0.00,8179,8180
11027,2,463,49,256.00,42849.00,8179,8181
11028,1,512,512,512.00,0.00,8180,8181
11029,1,512,512,512.00,0.00,8180,8181
11030,1,512,512,512.00,0.00,8180,8181
11031,2,428,84,256.00,29584.00,8180,8182
11032,2,496,16,256.00,57600.00,8181,8183
11033,2,265,247,256.00,81.00,8182,8184
11034,1,512,512,512.00,0.00,8183,8184
11035,1,512,512,512.00,0.00,8183,8184
11036,1,512,512,512.00,0.00,8183,8184
11037,3,336,71,170.67,13860.22,8183,8186
11038,1,512,512,512.00,0.00,8185,8186
11039,4,164,102,128.00,603.50,8185,8189
11040,1,512,512,512.00,0.00,8188,8189
11041,1,512,512,512.00,0.00,8188,8189
11042,1,512,512,512.00,0.00,8188,8189
11043,2,506,6,256.00,62500.00,8188,8190
11044,1,512,512,512.00,0.00,8189,8190
11045,1,512,512,512.00,0.00,8189,8190
11046,1,512,512,512.00,0.00,8189,8190
11047,1,512,512,512.00,0.00,8189,8190
11048,4,270,7,128.00,12326.50,8189,8193
11049,1,512,512,512.00,0.00,8192,8193
11050,1,512,512,512.00,0.00,8192,8193
11051,1,512,512,512.00,0.00,8192,8193
11052,1,512,512,512.00,0.00,8192,8193
11053,1,512,512,512.00,0.00,8192,8193
11054,3,442,15,170.67,37077.56,8192,8195
11055,1,512,512,512.00,0.00,8194,8195
11056,2,403,109,256.00,21609.00,8194,8196
11057,1,512,512,512.00,0.00,8195,8196
11058,3,263,32,170.67,9966.89,8195,8198
11059,1,512,512,512.00,0.00,8197,8198
11060,2,358,154,256.00,10404.00,8197,8199
11061,1,512,512,512.00,0.00,8198,8199
11062,1,512,512,512.00,0.00,8198,8199
11063,2,428,84,256.00,29584.00,8198,8200
11064,1,512,512,512.00,0.00,8199,8200
11065,3,337,66,170.67,14141.56,8199,8202
11066,1,512,512,512.00,0.00,8201,8202
11067,1,512,512,512.00,0.00,8201,8202
11068,1,512,512,512.00,0.00,8201,8202
11069,1,512,512,512.00,0.00,8201,8202
11070,5,198,22,102.40,4903.04,8201,8206
11071,1,512,512,512.00,0.00,8205,8206
11072,2,315,197,256.00,3481.00,8205,8207
11073,2,260,252,256.00,16.00,8206,8208
11074,1,512,512,512.00,0.00,8207,8208
11075,1,512,512,512.00,0.00,8207,8208
11076,3,361,2,170.67,21714.89,8207,8210
11077,1,512,512,512.00,0.00,8209,8210
11078,2,507,5,256.00,63001.00,8209,8211
11079,4,286,2,128.00,15042.50,8210,8214
11080,2,425,87,256.00,28561.00,8213,8215
11081,1,512,512,512.00,0.00,8214,8215
11082,2,323,189,256.00,4489.00,8214,8216
11083,1,512,512,512.00,0.00,8215,8216
11084,2,427,85,256.00,29241.00,8215,8217
11085,1,512,512,512.00,0.00,8216,8217
11086,3,507,1,170.67,56561.56,8216,8219
11087,1,512,512,512.00,0.00,8218,8219
11088,2,505,7,256.00,62001.00,8218,8220
11089,2,425,87,256.00,28561.00,8219,8221
11090,1,512,512,512.00,0.00,8220,8221
11091,2,422,90,256.00,27556.00,8220,8222
11092,1,512,512,512.00,0.00,8221,8222
11093,2,448,64,256.00,36864.00,8221,8223
11094,1,512,512,512.00,0.00,8222,8223
11095,1,512,512,512.00,0.00,8222,8223
11096,1,512,512,512.00,0.00,8222,8223
11097,1,512,512,512.00,0.00,8222,8223
11098,1,512,512,512.00,0.00,8222,8223
11099,2,488,24,256.00,53824.00,8222,8224
11100,2,326,186,256.00,4900.00,8223,8225
11101,2,334,178,256.00,6084.00,8224,8226
11102,3,284,112,170.67,6424.89,8225,8228
11103,1,512,512,512.00,0.00,8227,8228
11104,1,512,512,512.00,0.00,8227,8228
11105,1,512,512,512.00,0.00,8227,8228
11106,1,512,512,512.00,0.00,8227,8228
11107,1,512,512,512.00,0.00,8227,8228
11108,2,480,32,256.00,50176.00,8227,8229
11109,1,512,512,512.00,0.00,8228,8229
11110,2,353,159,256.00,9409.00,8228,8230
11111,1,512,512,512.00,0.00,8229,8230
11112,1,512,512,512.00,0.00,8229,8230
11113,2,261,251,256.00,25.00,8229,8231
11114,1,512,512,512.00,0.00,8230,8231
11115,1,512,512,512.00,0.00,8230,8231
11116,2,403,109,256.00,21609.00,8230,8232
11117,1,512,512,512.00,0.00,8231,8232
11118,2,472,40,256.00,46656.00,8231,8233
11119,1,512,512,512.00,0.00,8232,8233
11120,2,322,190,256.00,4356.00,8232,8234
11121,1,512,512,512.00,0.00,8233,8234
11122,1,512,512,512.00,0.00,8233,8234
11123,2,355,157,256.00,9801.00,8233,8235
11124,1,512,512,512.00,0.00,8234,8235
11125,7,264,1,73.14,9390.41,8234,8241
11126,1,512,512,512.00,0.00,8240,8241
11127,1,512,512,512.00,0.00,8240,8241
11128,1,512,512,512.00,0.00,8240,8241
11129,1,512,512,512.00,0.00,8240,8241
11130,1,512,512,512.00,0.00,8240,8241
11131,1,512,512,512.00,0.00,8240,8241
11132,4,340,28,128.00,15416.50,8240,8244
11133,1,512,512,512.00,0.00,8243,8244
11134,2,451,61,256.00,38025.00,8243,8245
11135,1,512,512,512.00,0.00,8244,8245
11136,2,408,104,256.00,23104.00,8244,8246
11137,1,512,512,512.00,0.00,8245,8246
11138,1,512,512,512.00,0.00,8245,8246
11139,3,249,47,170.67,7828.22,8245,8248
11140,2,268,244,256.00,144.00,8247,8249
11141,2,400,112,256.00,20736.00,8248,8250
11142,1,512,512,512.00,0.00,8249,8250
11143,2,338,174,256.00,6724.00,8249,8251
11144,1,512,512,512.00,0.00,8250,8251
11145,1,512,512,512.00,0.00,8250,8251
11146,2,421,91,256.00,27225.00,8250,8252
11147,1,512,512,512.00,0.00,8251,8252
11148,1,512,512,512.00,0.00,8251,8252
11149,2,343,169,256.00,7569.00,8251,8253
11150,2,494,18,256.00,56644.00,8252,8254
11151,3,266,61,170.67,7106.89,8253,8256
11152,1,512,512,512.00,0.00,8255,8256
11153,1,512,512,512.00,0.00,8255,8256
11154,2,305,207,256.00,2401.00,8255,8257
11155,1,512,512,512.00,0.00,8256,8257
11156,1,512,512,512.00,0.00,8256,8257
11157,2,510,2,256.00,64516.00,8256,8258
11158,2,298,214,256.00,1764.00,8257,8259
11159,1,512,512,512.00,0.00,8258,8259
11160,1,512,512,512.00,0.00,8258,8259
11161,2,324,188,256.00,4624.00,8258,8260
11162,1,512,512,512.00,0.00,8259,8260
11163,1,512,512,512.00,0.00,8259,8260
11164,1,512,512,512.00,0.00,8259,8260
11165,1,512,512,512.00,0.00,8259,8260
11166,2,314,198,256.00,3364.00,8259,8261
11167,1,512,512,512.00,0.00,8260,8261
11168,1,512,512,512.00,0.00,8260,8261
11169,4,265,32,128.00,7207.50,8260,8264
11170,1,512,512,512.00,0.00,8263,8264
11171,1,512,512,512.00,0.00,8263,8264
11172,1,512,512,512.00,0.00,8263,8264
11173,2,325,187,256.00,4761.00,8263,8265
11174,1,512,512,512.00,0.00,8264,8265
11175,1,512,512,512.00,0.00,8264,8265
11176,4,451,8,128.00,34986.50,8264,8268
11177,1,512,512,512.00,0.00,8267,8268
11178,1,512,512,512.00,0.00,8267,8268
11179,2,432,80,256.00,30976.00,8267,8269
11180,3,463,4,170.67,43009.56,8268,8271
11181,2,313,199,256.00,3249.00,8270,8272
11182,1,512,512,512.00,0.00,8271,8272
11183,1,512,512,512.00,0.00,8271,8272
11184,1,512,512,512.00,0.00,8271,8272
11185,1,512,512,512.00,0.00,8271,8272
11186,2,267,245,256.00,121.00,8271,8273
11187,2,506,6,256.00,62500.00,8272,8274
11188,1,512,512,512.00,0.00,8273,8274
11189,2,462,50,256.00,42436.00,8273,8275
11190,2,461,51,256.00,42025.00,8274,8276
11191,1,512,512,512.00,0.00,8275,8276
11192,1,512,512,512.00,0.00,8275,8276
11193,1,512,512,512.00,0.00,8275,8276
11194,2,435,77,256.00,32041.00,8275,8277
11195,1,512,512,512.00,0.00,8276,8277
11196,1,512,512,512.00,0.00,8276,8277
11197,1,512,512,512.00,0.00,8276,8277
11198,2,493,19,256.00,56169.00,8276,8278
11199,1,512,512,512.00,0.00,8277,8278
11200,1,512,512,512.00,0.00,8277,8278
11201,1,512,512,512.00,0.00,8277,8278
11202,2,374,138,256.00,13924.00,8277,8279
11203,1,512,512,512.00,0.00,8278,8279
11204,1,512,512,512.00,0.00,8278,8279
11205,1,512,512,512.00,0.00,8278,8279
11206,1,512,512,512.00,0.00,8278,8279
11207,4,300,1,128.00,11817.50,8278,8282
11208,2,321,191,256.00,4225.00,8281,8283
11209,2,469,43,256.00,45369.00,8282,8284
11210,2,450,62,256.00,37636.00,8283,8285
11211,3,256,14,170.67,12304.89,8284,8287
11212,1,512,512,512.00,0.00,8286,8287
11213,2,457,55,256.00,40401.00,8286,8288
11214,5,415,1,102.40,24966.24,8287,8292
11215,1,512,512,512.00,0.00,8291,8292
11216,1,512,512,512.00,0.00,8291,8292
11217,1,512,512,512.00,0.00,8291,8292
11218,1,512,512,512.00,0.00,8291,8292
11219,2,499,13,256.00,59049.00,8291,8293
11220,3,239,44,170.67,8038.89,8292,8295
11221,1,512,512,512.00,0.00,8294,8295
11222,3,471,1,170.67,45353.56,8294,8297
11223,1,512,512,512.00,0.00,8296,8297
11224,1,512,512,512.00,0.00,8296,8297
11225,2,334,178,256.00,6084.00,8296,8298
11226,1,512,512,512.00,0.00,8297,8298
11227,2,506,6,256.00,62500.00,8297,8299
11228,1,512,512,512.00,0.00,8298,8299
11229,3,196,133,170.67,737.56,8298,8301
11230,2,414,98,256.00,24964.00,8300,8302
11231,1,512,512,512.00,0.00,8301,8302
11232,1,512,512,512.00,0.00,8301,8302
11233,1,512,512,512.00,0.00,8301,8302
11234,2,472,40,256.00,46656.00,8301,8303
11235,2,264,248,256.00,64.00,8302,8304
11236,1,512,512,512.00,0.00,8303,8304
11237,1,512,512,512.00,0.00,8303,8304
11238,2,393,119,256.00,18769.00,8303,8305
11239,1,512,512,512.00,0.00,8304,8305
11240,1,512,512,512.00,0.00,8304,8305
11241,2,273,239,256.00,289.00,8304,8306
11242,2,421,91,256.00,27225.00,8305,8307
11243,2,300,212,256.00,1936.00,8306,8308
11244,3,321,5,170.67,16760.22,8307,8310
11245,2,485,27,256.00,52441.00,8309,8311
11246,1,512,512,512.00,0.00,8310,8311
11247,2,380,132,256.00,15376.00,8310,8312
11248,1,512,512,512.00,0.00,8311,8312
11249,1,512,512,512.00,0.00,8311,8312
11250,2,404,108,256.00,21904.00,8311,8313
11251,1,512,512,512.00,0.00,8312,8313
11252,1,512,512,512.00,0.00,8312,8313
11253,2,384,128,256.00,16384.00,8312,8314
11254,2,324,188,256.00,4624.00,8313,8315
11255,1,512,512,512.00,0.00,8314,8315
11256,1,512,512,512.00,0.00,8314,8315
11257,1,512,512,512.00,0.00,8314,8315
11258,3,353,20,170.67,18982.89,8314,8317
11259,2,383,129,256.00,16129.00,8316,8318
11260,2,452,60,256.00,38416.00,8317,8319
11261,3,290,4,170.67,14752.89,8318,8321
11262,1,512,512,512.00,0.00,8320,8321
11263,2,458,54,256.00,40804.00,8320,8322
11264,1,512,512,512.00,0.00,8321,8322
11265,1,512,512,512.00,0.00,8321,8322
11266,1,512,512,512.00,0.00,8321,8322
11267,1,512,512,512.00,0.00,8321,8322
11268,2,315,197,256.00,3481.00,8321,8323
11269,1,512,512,512.00,0.00,8322,8323
11270,2,471,41,256.00,46225.00,8322,8324
11271,2,315,197,256.00,3481.00,8323,8325
11272,2,474,38,256.00,47524.00,8324,8326
11273,2,281,231,256.00,625.00,8325,8327
11274,2,323,189,256.00,4489.00,8326,8328
11275,1,512,512,512.00,0.00,8327,8328
11276,1,512,512,512.00,0.00,8327,8328
11277,2,426,86,256.00,28900.00,8327,8329
11278,1,512,512,512.00,0.00,8328,8329
11279,1,512,512,512.00,0.00,8328,8329
11280,2,379,133,256.00,15129.00,8328,8330
11281,1,512,512,512.00,0.00,8329,8330
11282,1,512,512,512.00,0.00,8329,8330
11283,1,512,512,512.00,0.00,8329,8330
11284,1,512,512,512.00,0.00,8329,8330
11285,1,512,512,512.00,0.00,8329,8330
11286,3,302,4,170.67,15424.89,8329,8332
11287,1,512,512,512.00,0.00,8331,8332
11288,1,512,512,512.00,0.00,8331,8332
11289,1,512,512,512.00,0.00,8331,8332
11290,2,366,146,256.00,12100.00,8331,8333
11291,2,429,83,256.00,29929.00,8332,8334
11292,1,512,512,512.00,0.00,8333,8334
11293,1,512,512,512.00,0.00,8333,8334
11294,4,305,22,128.00,11974.50,8333,8337
11295,1,512,512,512.00,0.00,8336,8337
11296,2,268,244,256.00,144.00,8336,8338
11297,2,274,238,256.00,324.00,8337,8339
11298,1,512,512,512.00,0.00,8338,8339
11299,1,512,512,512.00,0.00,8338,8339
11300,1,512,512,512.00,0.00,8338,8339
11301,2,478,34,256.00,49284.00,8338,8340
11302,1,512,512,512.00,0.00,8339,8340
11303,1,512,512,512.00,0.00,8339,8340
11304,1,512,512,512.00,0.00,8339,8340
11305,2,357,155,256.00,10201.00,8339,8341
11306,2,273,239,256.00,289.00,8340,8342
11307,1,512,512,512.00,0.00,8341,8342
11308,2,398,114,256.00,20164.00,8341,8343
11309,2,457,55,256.00,40401.00,8342,8344
11310,1,512,512,512.00,0.00,8343,8344
11311,1,512,512,512.00,0.00,8343,8344
11312,3,287,93,170.67,7020.22,8343,8346
11313,1,512,512,512.00,0.00,8345,8346
11314,1,512,512,512.00,0.00,8345,8346
11315,1,512,512,512.00,0.00,8345,8346
11316,2,481,31,256.00,50625.00,8345,8347
11317,1,512,512,512.00,0.00,8346,8347
11318,1,512,512,512.00,0.00,8346,8347
11319,1,512,512,512.00,0.00,8346,8347
11320,1,512,512,512.00,0.00,8346,8347
11321,2,415,97,256.00,25281.00,8346,8348
11322,3,300,1,170.67,15713.56,8347,8350
11323,3,269,61,170.67,7274.89,8349,8352
11324,2,379,133,256.00,15129.00,8351,8353
11325,1,512,512,512.00,0.00,8352,8353
11326,1,512,512,512.00,0.00,8352,8353
11327,1,512,512,512.00,0.00,8352,8353
11328,2,411,101,256.00,24025.00,8352,8354
11329,1,512,512,512.00,0.00,8353,8354
11330,1,512,512,512.00,0.00,8353,8354
11331,1,512,512,512.00,0.00,8353,8354
11332,5,411,6,102.40,24092.24,8353,8358
11333,3,320,79,170.67,11342.89,8357,8360
11334,1,512,512,512.00,0.00,8359,8360
11335,3,433,6,170.67,35157.56,8359,8362
11336,2,271,241,256.00,225.00,8361,8363
11337,2,475,37,256.00,47961.00,8362,8364
11338,2,276,236,256.00,400.00,8363,8365
11339,1,512,512,512.00,0.00,8364,8365
11340,2,311,201,256.00,3025.00,8364,8366
11341,1,512,512,512.00,0.00,8365,8366
11342,1,512,512,512.00,0.00,8365,8366
11343,3,455,10,170.67,40650.89,8365,8368
11344,1,512,512,512.00,0.00,8367,8368
11345,1,512,512,512.00,0.00,8367,8368
11346,1,512,512,512.00,0.00,8367,8368
11347,2,322,190,256.00,4356.00,8367,8369
11348,1,512,512,512.00,0.00,8368,8369
11349,1,512,512,512.00,0.00,8368,8369
11350,1,512,512,512.00,0.00,8368,8369
11351,1,512,512,512.00,0.00,8368,8369
11352,1,512,512,512.00,0.00,8368,8369
11353,3,265,76,170.67,5953.56,8368,8371
11354,4,265,61,128.00,6525.00,8370,8374
11355,1,512,512,512.00,0.00,8373,8374
11356,1,512,512,512.00,0.00,8373,8374
11357,1,512,512,512.00,0.00,8373,8374
11358,2,314,198,256.00,3364.00,8373,8375
11359,1,512,512,512.00,0.00,8374,8375
11360,1,512,512,512.00,0.00,8374,8375
11361,2,427,85,256.00,29241.00,8374,8376
11362,1,512,512,512.00,0.00,8375,8376
11363,2,477,35,256.00,48841.00,8375,8377
11364,1,512,512,512.00,0.00,8376,8377
11365,1,512,512,512.00,0.00,8376,8377
11366,3,286,74,170.67,7664.89,8376,8379
11367,1,512,512,512.00,0.00,8378,8379
11368,2,431,81,256.00,30625.00,8378,8380
11369,1,512,512,512.00,0.00,8379,8380
11370,1,512,512,512.00,0.00,8379,8380
11371,1,512,512,512.00,0.00,8379,8380
11372,2,346,166,256.00,8100.00,8379,8381
11373,1,512,512,512.00,0.00,8380,8381
11374,1,512,512,512.00,0.00,8380,8381
11375,1,512,512,512.00,0.00,8380,8381
11376,3,494,2,170.67,52304.89,8380,8383
11377,1,512,512,512.00,0.00,8382,8383
11378,1,512,512,512.00,0.00,8382,8383
11379,3,400,3,170.67,28169.56,8382,8385
11380,3,378,1,170.67,24397.56,8384,8387
11381,1,512,512,512.00,0.00,8386,8387
11382,2,510,2,256.00,64516.00,8386,8388
11383,1,512,512,512.00,0.00,8387,8388
11384,1,512,512,512.00,0.00,8387,8388
11385,2,323,189,256.00,4489.00,8387,8389
11386,3,352,37,170.67,17673.56,8388,8391
11387,1,512,512,512.00,0.00,8390,8391
11388,2,501,11,256.00,60025.00,8390,8392
11389,2,427,85,256.00,29241.00,8391,8393
11390,2,293,219,256.00,1369.00,8392,8394
11391,1,512,512,512.00,0.00,8393,8394
11392,1,512,512,512.00,0.00,8393,8394
11393,2,420,92,256.00,26896.00,8393,8395
11394,1,512,512,512.00,0.00,8394,8395
11395,1,512,512,512.00,0.00,8394,8395
11396,1,512,512,512.00,0.00,8394,8395
11397,1,512,512,512.00,0.00,8394,8395
11398,1,512,512,512.00,0.00,8394,8395
11399,3,229,89,170.67,3538.89,8394,8397
11400,2,286,226,256.00,900.00,8396,8398
11401,1,512,512,512.00,0.00,8397,8398
11402,1,512,512,512.00,0.00,8397,8398
11403,3,316,60,170.67,11523.56,8397,8400
11404,2,403,109,256.00,21609.00,8399,8401
11405,2,433,79,256.00,31329.00,8400,8402
11406,1,512,512,512.00,0.00,8401,8402
11407,1,512,512,512.00,0.00,8401,8402
11408,1,512,512,512.00,0.00,8401,8402
11409,2,442,70,256.00,34596.00,8401,8403
11410,1,512,512,512.00,0.00,8402,8403
11411,1,512,512,512.00,0.00,8402,8403
11412,1,512,512,512.00,0.00,8402,8403
11413,2,495,17,256.00,57121.00,8402,8404
11414,3,349,75,170.67,15929.56,8403,8406
11415,1,512,512,512.00,0.00,8405,8406
11416,1,512,512,512.00,0.00,8405,8406
11417,1,512,512,512.00,0.00,8405,8406
11418,1,512,512,512.00,0.00,8405,8406
11419,3,414,18,170.67,30246.22,8405,8408
11420,1,512,512,512.00,0.00,8407,8408
11421,3,494,2,170.67,52304.89,8407,8410
11422,1,512,512,512.00,0.00,8409,8410
11423,1,512,512,512.00,0.00,8409,8410
11424,1,512,512,512.00,0.00,8409,8410
11425,1,512,512,512.00,0.00,8409,8410
11426,1,512,512,512.00,0.00,8409,8410
11427,4,280,19,128.00,11533.50,8409,8413
11428,1,512,512,512.00,0.00,8412,8413
11429,3,373,5,170.67,23242.89,8412,8415
11430,1,512,512,512.00,0.00,8414,8415
11431,1,512,512,512.00,0.00,8414,8415
11432,4,294,34,128.00,9818.00,8414,8418
11433,2,475,37,256.00,47961.00,8417,8419
11434,1,512,512,512.00,0.00,8418,8419
11435,1,512,512,512.00,0.00,8418,8419
11436,2,453,59,256.00,38809.00,8418,8420
11437,1,512,512,512.00,0.00,8419,8420
11438,1,512,512,512.00,0.00,8419,8420
11439,1,512,512,512.00,0.00,8419,8420
11440,2,451,61,256.00,38025.00,8419,8421
11441,1,512,512,512.00,0.00,8420,8421
11442,2,319,193,256.00,3969.00,8420,8422
11443,2,301,211,256.00,2025.00,8421,8423
11444,1,512,512,512.00,0.00,8422,8423
11445,1,512,512,512.00,0.00,8422,8423
11446,1,512,512,512.00,0.00,8422,8423
11447,2,472,40,256.00,46656.00,8422,8424
11448,1,512,512,512.00,0.00,8423,8424
11449,2,294,218,256.00,1444.00,8423,8425
11450,1,512,512,512.00,0.00,8424,8425
11451,2,362,150,256.00,11236.00,8424,8426
11452,1,512,512,512.00,0.00,8425,8426
11453,2,487,25,256.00,53361.00,8425,8427
11454,1,512,512,512.00,0.00,8426,8427
11455,2,310,202,256.00,2916.00,8426,8428
11456,2,470,42,256.00,45796.00,8427,8429
11457,1,512,512,512.00,0.00,8428,8429
11458,1,512,512,512.00,0.00,8428,8429
11459,1,512,512,512.00,0.00,8428,8429
11460,1,512,512,512.00,0.00,8428,8429
11461,1,512,512,512.00,0.00,8428,8429
11462,2,288,224,256.00,1024.00,8428,8430
11463,2,321,191,256.00,4225.00,8429,8431
11464,2,323,189,256.00,4489.00,8430,8432
11465,1,512,512,512.00,0.00,8431,8432
11466,1,512,512,512.00,0.00,8431,8432
11467,2,324,188,256.00,4624.00,8431,8433
11468,1,512,512,512.00,0.00,8432,8433
11469,2,455,57,256.00,39601.00,8432,8434
11470,2,442,70,256.00,34596.00,8433,8435
11471,4,313,27,128.00,12020.50,8434,8438
11472,1,512,512,512.00,0.00,8437,8438
11473,2,303,209,256.00,2209.00,8437,8439
11474,1,512,512,512.00,0.00,8438,8439
11475,1,512,512,512.00,0.00,8438,8439
11476,3,398,13,170.67,27130.89,8438,8441
11477,2,433,79,256.00,31329.00,8440,8442
11478,1,512,512,512.00,0.00,8441,8442
11479,2,400,112,256.00,20736.00,8441,8443
11480,1,512,512,512.00,0.00,8442,8443
11481,2,387,125,256.00,17161.00,8442,8444
11482,1,512,512,512.00,0.00,8443,8444
11483,1,512,512,512.00,0.00,8443,8444
11484,2,448,64,256.00,36864.00,8443,8445
11485,3,235,60,170.67,6177.56,8444,8447
11486,1,512,512,512.00,0.00,8446,8447
11487,1,512,512,512.00,0.00,8446,8447
11488,1,512,512,512.00,0.00,8446,8447
11489,2,407,105,256.00,22801.00,8446,8448
11490,3,440,1,170.67,37086.89,8447,8450
11491,2,433,79,256.00,31329.00,8449,8451
11492,1,512,512,512.00,0.00,8450,8451
11493,1,512,512,512.00,0.00,8450,8451
11494,2,426,86,256.00,28900.00,8450,8452
11495,1,512,512,512.00,0.00,8451,8452
11496,4,336,4,128.00,15566.50,8451,8455
11497,1,512,512,512.00,0.00,8454,8455
11498,2,479,33,256.00,49729.00,8454,8456
11499,2,313,199,256.00,3249.00,8455,8457
11500,3,262,120,170.67,4187.56,8456,8459
11501,1,512,512,512.00,0.00,8458,8459
11502,1,512,512,512.00,0.00,8458,8459
11503,1,512,512,512.00,0.00,8458,8459
11504,1,512,512,512.00,0.00,8458,8459
11505,1,512,512,512.00,0.00,8458,8459
11506,2,268,244,256.00,144.00,8458,8460
11507,1,512,512,512.00,0.00,8459,8460
11508,1,512,512,512.00,0.00,8459,8460
11509,1,512,512,512.00,0.00,8459,8460
11510,1,512,512,512.00,0.00,8459,8460
11511,2,375,137,256.00,14161.00,8459,8461
11512,1,512,512,512.00,0.00,8460,8461
11513,1,512,512,512.00,0.00,8460,8461
11514,2,491,21,256.00,55225.00,8460,8462
11515,1,512,512,512.00,0.00,8461,8462
11516,1,512,512,512.00,0.00,8461,8462
11517,2,490,22,256.00,54756.00,8461,8463
11518,1,512,512,512.00,0.00,8462,8463
11519,1,512,512,512.00,0.00,8462,8463
11520,1,512,512,512.00,0.00,8462,8463
11521,1,512,512,512.00,0.00,8462,8463
11522,2,316,196,256.00,3600.00,8462,8464
11523,1,512,512,512.00,0.00,8463,8464
11524,1,512,512,512.00,0.00,8463,8464
11525,1,512,512,512.00,0.00,8463,8464
11526,1,512,512,512.00,0.00,8463,8464
11527,1,512,512,512.00,0.00,8463,8464
11528,2,431,81,256.00,30625.00,8463,8465
11529,1,512,512,512.00,0.00,8464,8465
11530,1,512,512,512.00,0.00,8464,8465
11531,1,512,512,512.00,0.00,8464,8465
11532,1,512,512,512.00,0.00,8464,8465
11533,2,433,79,256.00,31329.00,8464,8466
11534,1,512,512,512.00,0.00,8465,8466
11535,1,512,512,512.00,0.00,8465,8466
11536,1,512,512,512.00,0.00,8465,8466
11537,1,512,512,512.00,0.00,8465,8466
11538,1,512,512,512.00,0.00,8465,8466
11539,3,284,40,170.67,10072.89,8465,8468
11540,1,512,512,512.00,0.00,8467,8468
11541,1,512,512,512.00,0.00,8467,8468
11542,4,316,25,128.00,12436.50,8467,8471
11543,2,290,222,256.00,1156.00,8470,8472
11544,1,512,512,512.00,0.00,8471,8472
11545,3,497,6,170.67,53248.22,8471,8474
11546,1,512,512,512.00,0.00,8473,8474
11547,1,512,512,512.00,0.00,8473,8474
11548,2,303,209,256.00,2209.00,8473,8475
11549,1,512,512,512.00,0.00,8474,8475
11550,1,512,512,512.00,0.00,8474,8475
11551,1,512,512,512.00,0.00,8474,8475
11552,1,512,512,512.00,0.00,8474,8475
11553,2,423,89,256.00,27889.00,8474,8476
11554,6,421,1,85.33,23088.89,8475,8481
11555,1,512,512,512.00,0.00,8480,8481
11556,1,512,512,512.00,0.00,8480,8481
11557,2,288,224,256.00,1024.00,8480,8482
11558,2,412,100,256.00,24336.00,8481,8483
11559,2,280,232,256.00,576.00,8482,8484
11560,1,512,512,512.00,0.00,8483,8484
11561,1,512,512,512.00,0.00,8483,8484
11562,3,419,44,170.67,30838.89,8483,8486
11563,1,512,512,512.00,0.00,8485,8486
11564,1,512,512,512.00,0.00,8485,8486
11565,2,377,135,256.00,14641.00,8485,8487
11566,1,512,512,512.00,0.00,8486,8487
11567,5,291,22,102.40,10121.84,8486,8491
11568,3,506,1,170.67,56226.89,8490,8493
11569,2,498,14,256.00,58564.00,8492,8494
11570,1,512,512,512.00,0.00,8493,8494
11571,2,369,143,256.00,12769.00,8493,8495
11572,1,512,512,512.00,0.00,8494,8495
11573,2,434,78,256.00,31684.00,8494,8496
11574,1,512,512,512.00,0.00,8495,8496
11575,2,263,249,256.00,49.00,8495,8497
11576,1,512,512,512.00,0.00,8496,8497
11577,2,353,159,256.00,9409.00,8496,8498
11578,1,512,512,512.00,0.00,8497,8498
11579,2,425,87,256.00,28561.00,8497,8499
11580,2,283,229,256.00,729.00,8498,8500
11581,1,512,512,512.00,0.00,8499,8500
11582,2,259,253,256.00,9.00,8499,8501
11583,2,354,158,256.00,9604.00,8500,8502
11584,1,512,512,512.00,0.00,8501,8502
11585,1,512,512,512.00,0.00,8501,8502
11586,1,512,512,512.00,0.00,8501,8502
11587,1,512,512,512.00,0.00,8501,8502
11588,2,386,126,256.00,16900.00,8501,8503
11589,1,512,512,512.00,0.00,8502,8503
11590,5,410,3,102.40,24268.24,8502,8507
11591,4,262,27,128.00,8450.50,8506,8510
11592,1,512,512,512.00,0.00,8509,8510
11593,1,512,512,512.00,0.00,8509,8510
11594,2,291,221,256.00,1225.00,8509,8511
11595,1,512,512,512.00,0.00,8510,8511
11596,1,512,512,512.00,0.00,8510,8511
11597,1,512,512,512.00,0.00,8510,8511
11598,2,457,55,256.00,40401.00,8510,8512
11599,3,402,47,170.67,26800.22,8511,8514
11600,1,512,512,512.00,0.00,8513,8514
11601,1,512,512,512.00,0.00,8513,8514
11602,1,512,512,512.00,0.00,8513,8514
11603,4,380,2,128.00,23814.00,8513,8517
11604,1,512,512,512.00,0.00,8516,8517
11605,1,512,512,512.00,0.00,8516,8517
11606,1,512,512,512.00,0.00,8516,8517
11607,1,512,512,512.00,0.00,8516,8517
11608,1,512,512,512.00,0.00,8516,8517
11609,2,362,150,256.00,11236.00,8516,8518
11610,1,512,512,512.00,0.00,8517,8518
11611,2,507,5,256.00,63001.00,8517,8519
11612,2,465,47,256.00,43681.00,8518,8520
11613,4,247,42,128.00,6701.50,8519,8523
11614,4,426,4,128.00,30117.50,8522,8526
11615,3,403,46,170.67,27037.56,8525,8528
11616,1,512,512,512.00,0.00,8527,8528
11617,1,512,512,512.00,0.00,8527,8528
11618,4,219,39,128.00,5019.00,8527,8531
11619,1,512,512,512.00,0.00,8530,8531
11620,1,512,512,512.00,0.00,8530,8531
11621,2,480,32,256.00,50176.00,8530,8532
11622,1,512,512,512.00,0.00,8531,8532
11623,2,432,80,256.00,30976.00,8531,8533
11624,1,512,512,512.00,0.00,8532,8533
11625,1,512,512,512.00,0.00,8532,8533
11626,2,501,11,256.00,60025.00,8532,8534
11627,1,512,512,512.00,0.00,8533,8534
11628,1,512,512,512.00,0.00,8533,8534
11629,3,319,71,170.67,11434.89,8533,8536
11630,1,512,512,512.00,0.00,8535,8536
11631,1,512,512,512.00,0.00,8535,8536
11632,2,367,145,256.00,12321.00,8535,8537
11633,1,512,512,512.00,0.00,8536,8537
11634,1,512,512,512.00,0.00,8536,8537
11635,3,291,101,170.67,7300.22,8536,8539
11636,2,266,246,256.00,100.00,8538,8540
11637,1,512,512,512.00,0.00,8539,8540
11638,1,512,512,512.00,0.00,8539,8540
11639,1,512,512,512.00,0.00,8539,8540
11640,3,243,59,170.67,6416.22,8539,8542
11641,1,512,512,512.00,0.00,8541,8542
11642,1,512,512,512.00,0.00,8541,8542
11643,3,266,87,170.67,5408.22,8541,8544
11644,1,512,512,512.00,0.00,8543,8544
11645,1,512,512,512.00,0.00,8543,8544
11646,1,512,512,512.00,0.00,8543,8544
11647,1,512,512,512.00,0.00,8543,8544
11648,4,238,40,128.00,5046.00,8543,8547
11649,1,512,512,512.00,0.00,8546,8547
11650,1,512,512,512.00,0.00,8546,8547
11651,2,428,84,256.00,29584.00,8546,8548
11652,2,486,26,256.00,52900.00,8547,8549
11653,2,300,212,256.00,1936.00,8548,8550
11654,1,512,512,512.00,0.00,8549,8550
11655,1,512,512,512.00,0.00,8549,8550
11656,1,512,512,512.00,0.00,8549,8550
11657,1,512,512,512.00,0.00,8549,8550
11658,2,472,40,256.00,46656.00,8549,8551
11659,1,512,512,512.00,0.00,8550,8551
11660,1,512,512,512.00,0.00,8550,8551
11661,2,438,74,256.00,33124.00,8550,8552
11662,1,512,512,512.00,0.00,8551,8552
11663,1,512,512,512.00,0.00,8551,8552
11664,2,320,192,256.00,4096.00,8551,8553
11665,1,512,512,512.00,0.00,8552,8553
11666,1,512,512,512.00,0.00,8552,8553
11667,3,268,90,170.67,5419.56,8552,8555
11668,4,334,3,128.00,17546.50,8554,8558
11669,2,354,158,256.00,9604.00,8557,8559
11670,1,512,512,512.00,0.00,8558,8559
11671,1,512,512,512.00,0.00,8558,8559
11672,1,512,512,512.00,0.00,8558,8559
11673,1,512,512,512.00,0.00,8558,8559
11674,8,209,2,64.00,5239.00,8558,8566
11675,1,512,512,512.00,0.00,8565,8566
11676,1,512,512,512.00,0.00,8565,8566
11677,1,512,512,512.00,0.00,8565,8566
11678,3,349,46,170.67,16741.56,8565,8568
11679,1,512,512,512.00,0.00,8567,8568
11680,3,471,2,170.67,45328.22,8567,8570
11681,3,480,1,170.67,47993.56,8569,8572
11682,1,512,512,512.00,0.00,8571,8572
11683,1,512,512,512.00,0.00,8571,8572
11684,1,512,512,512.00,0.00,8571,8572
11685,2,277,235,256.00,441.00,8571,8573
11686,1,512,512,512.00,0.00,8572,8573
11687,1,512,512,512.00,0.00,8572,8573
11688,1,512,512,512.00,0.00,8572,8573
11689,2,447,65,256.00,36481.00,8572,8574
11690,1,512,512,512.00,0.00,8573,8574
11691,1,512,512,512.00,0.00,8573,8574
11692,1,512,512,512.00,0.00,8573,8574
11693,5,185,3,102.40,3475.84,8573,8578
11694,2,418,94,256.00,26244.00,8577,8579
11695,1,512,512,512.00,0.00,8578,8579
11696,2,426,86,256.00,28900.00,8578,8580
11697,1,512,512,512.00,0.00,8579,8580
11698,1,512,512,512.00,0.00,8579,8580
11699,1,512,512,512.00,0.00,8579,8580
11700,1,512,512,512.00,0.00,8579,8580
11701,2,444,68,256.00,35344.00,8579,8581
11702,2,426,86,256.00,28900.00,8580,8582
11703,1,512,512,512.00,0.00,8581,8582
11704,1,512,512,512.00,0.00,8581,8582
11705,1,512,512,512.00,0.00,8581,8582
11706,2,396,116,256.00,19600.00,8581,8583
11707,1,512,512,512.00,0.00,8582,8583
11708,1,512,512,512.00,0.00,8582,8583
11709,1,512,512,512.00,0.00,8582,8583
11710,2,423,89,256.00,27889.00,8582,8584
11711,1,512,512,512.00,0.00,8583,8584
11712,2,259,253,256.00,9.00,8583,8585
11713,2,376,136,256.00,14400.00,8584,8586
11714,1,512,512,512.00,0.00,8585,8586
11715,1,512,512,512.00,0.00,8585,8586
11716,1,512,512,512.00,0.00,8585,8586
11717,2,329,183,256.00,5329.00,8585,8587
11718,1,512,512,512.00,0.00,8586,8587
11719,1,512,512,512.00,0.00,8586,8587
11720,1,512,512,512.00,0.00,8586,8587
11721,2,265,247,256.00,81.00,8586,8588
11722,3,255,107,170.67,3864.22,8587,8590
11723,1,512,512,512.00,0.00,8589,8590
11724,2,291,221,256.00,1225.00,8589,8591
11725,1,512,512,512.00,0.00,8590,8591
11726,2,446,66,256.00,36100.00,8590,8592
11727,1,512,512,512.00,0.00,8591,8592
11728,1,512,512,512.00,0.00,8591,8592
11729,1,512,512,512.00,0.00,8591,8592
11730,3,305,60,170.67,10284.22,8591,8594
11731,8,203,2,64.00,3937.25,8593,8601
11732,1,512,512,512.00,0.00,8600,8601
11733,1,512,512,512.00,0.00,8600,8601
11734,1,512,512,512.00,0.00,8600,8601
11735,2,293,219,256.00,1369.00,8600,8602
11736,1,512,512,512.00,0.00,8601,8602
11737,1,512,512,512.00,0.00,8601,8602
11738,1,512,512,512.00,0.00,8601,8602
11739,1,512,512,512.00,0.00,8601,8602
11740,2,414,98,256.00,24964.00,8601,8603
11741,1,512,512,512.00,0.00,8602,8603
11742,2,421,91,256.00,27225.00,8602,8604
11743,1,512,512,512.00,0.00,8603,8604
11744,1,512,512,512.00,0.00,8603,8604
11745,2,409,103,256.00,23409.00,8603,8605
11746,1,512,512,512.00,0.00,8604,8605
11747,2,310,202,256.00,2916.00,8604,8606
11748,1,512,512,512.00,0.00,8605,8606
11749,2,297,215,256.00,1681.00,8605,8607
11750,1,512,512,512.00,0.00,8606,8607
11751,1,512,512,512.00,0.00,8606,8607
11752,1,512,512,512.00,0.00,8606,8607
11753,1,512,512,512.00,0.00,8606,8607
11754,3,302,55,170.67,10290.89,8606,8609
11755,4,372,22,128.00,20145.50,8608,8612
11756,1,512,512,512.00,0.00,8611,8612
11757,1,512,512,512.00,0.00,8611,8612
11758,1,512,512,512.00,0.00,8611,8612
11759,2,326,186,256.00,4900.00,8611,8613
11760,2,488,24,256.00,53824.00,8612,8614
11761,1,512,512,512.00,0.00,8613,8614
11762,5,191,6,102.40,5089.84,8613,8618
11763,6,198,3,85.33,6621.22,8617,8623
11764,1,512,512,512.00,0.00,8622,8623
11765,1,512,512,512.00,0.00,8622,8623
11766,2,500,12,256.00,59536.00,8622,8624
11767,2,405,107,256.00,22201.00,8623,8625
11768,3,279,2,170.67,14608.22,8624,8627
11769,1,512,512,512.00,0.00,8626,8627
11770,1,512,512,512.00,0.00,8626,8627
11771,2,289,223,256.00,1089.00,8626,8628
11772,2,273,239,256.00,289.00,8627,8629
11773,1,512,512,512.00,0.00,8628,8629
11774,3,312,2,170.67,16390.22,8628,8631
11775,1,512,512,512.00,0.00,8630,8631
11776,1,512,512,512.00,0.00,8630,8631
11777,2,345,167,256.00,7921.00,8630,8632
11778,5,170,65,102.40,1404.24,8631,8636
11779,1,512,512,512.00,0.00,8635,8636
11780,1,512,512,512.00,0.00,8635,8636
11781,1,512,512,512.00,0.00,8635,8636
11782,2,353,159,256.00,9409.00,8635,8637
11783,4,163,85,128.00,1064.50,8636,8640
11784,1,512,512,512.00,0.00,8639,8640
11785,2,349,163,256.00,8649.00,8639,8641
11786,4,266,27,128.00,8343.50,8640,8644
11787,1,512,512,512.00,0.00,8643,8644
11788,4,284,31,128.00,10047.50,8643,8647
11789,1,512,512,512.00,0.00,8646,8647
11790,2,511,1,256.00,65025.00,8646,8648
11791,1,512,512,512.00,0.00,8647,8648
11792,1,512,512,512.00,0.00,8647,8648
11793,1,512,512,512.00,0.00,8647,8648
11794,1,512,512,512.00,0.00,8647,8648
11795,2,406,106,256.00,22500.00,8647,8649
11796,1,512,512,512.00,0.00,8648,8649
11797,1,512,512,512.00,0.00,8648,8649
11798,1,512,512,512.00,0.00,8648,8649
11799,1,512,512,512.00,0.00,8648,8649
11800,1,512,512,512.00,0.00,8648,8649
11801,1,512,512,512.00,0.00,8648,8649
11802,2,432,80,256.00,30976.00,8648,8650
11803,1,512,512,512.00,0.00,8649,8650
11804,4,253,54,128.00,5603.50,8649,8653
11805,1,512,512,512.00,0.00,8652,8653
11806,4,344,31,128.00,15852.50,8652,8656
11807,1,512,512,512.00,0.00,8655,8656
11808,1,512,512,512.00,0.00,8655,8656
11809,1,512,512,512.00,0.00,8655,8656
11810,1,512,512,512.00,0.00,8655,8656
11811,2,426,86,256.00,28900.00,8655,8657
11812,1,512,512,512.00,0.00,8656,8657
11813,1,512,512,512.00,0.00,8656,8657
11814,2,279,233,256.00,529.00,8656,8658
11815,4,385,4,128.00,23428.50,8657,8661
11816,1,512,512,512.00,0.00,8660,8661
11817,4,388,1,128.00,23234.50,8660,8664
11818,1,512,512,512.00,0.00,8663,8664
11819,2,288,224,256.00,1024.00,8663,8665
11820,2,507,5,256.00,63001.00,8664,8666
11821,1,512,512,512.00,0.00,8665,8666
11822,4,245,2,128.00,10887.50,8665,8669
11823,2,308,204,256.00,2704.00,8668,8670
11824,3,358,3,170.67,21197.56,8669,8672
11825,4,485,3,128.00,42498.50,8671,8675
11826,2,418,94,256.00,26244.00,8674,8676
11827,2,460,52,256.00,41616.00,8675,8677
11828,2,391,121,256.00,18225.00,8676,8678
11829,2,472,40,256.00,46656.00,8677,8679
11830,1,512,512,512.00,0.00,8678,8679
11831,1,512,512,512.00,0.00,8678,8679
11832,2,371,141,256.00,13225.00,8678,8680
11833,1,512,512,512.00,0.00,8679,8680
11834,4,403,13,128.00,25924.50,8679,8683
11835,2,413,99,256.00,24649.00,8682,8684
11836,2,329,183,256.00,5329.00,8683,8685
11837,1,512,512,512.00,0.00,8684,8685
11838,2,401,111,256.00,21025.00,8684,8686
11839,1,512,512,512.00,0.00,8685,8686
11840,1,512,512,512.00,0.00,8685,8686
11841,1,512,512,512.00,0.00,8685,8686
11842,2,373,139,256.00,13689.00,8685,8687
11843,1,512,512,512.00,0.00,8686,8687
11844,1,512,512,512.00,0.00,8686,8687
11845,3,345,35,170.67,16764.22,8686,8689
11846,1,512,512,512.00,0.00,8688,8689
11847,2,270,242,256.00,196.00,8688,8690
11848,1,512,512,512.00,0.00,8689,8690
11849,1,512,512,512.00,0.00,8689,8690
11850,1,512,512,512.00,0.00,8689,8690
11851,4,215,13,128.00,5346.50,8689,8693
11852,1,512,512,512.00,0.00,8692,8693
11853,2,344,168,256.00,7744.00,8692,8694
11854,1,512,512,512.00,0.00,8693,8694
11855,2,385,127,256.00,16641.00,8693,8695
11856,1,512,512,512.00,0.00,8694,8695
11857,1,512,512,512.00,0.00,8694,8695
11858,1,512,512,512.00,0.00,8694,8695
11859,1,512,512,512.00,0.00,8694,8695
11860,3,200,116,170.67,1496.89,8694,8697
11861,1,512,512,512.00,0.00,8696,8697
11862,2,443,69,256.00,34969.00,8696,8698
11863,2,344,168,256.00,7744.00,8697,8699
11864,1,512,512,512.00,0.00,8698,8699
11865,2,383,129,256.00,16129.00,8698,8700
11866,1,512,512,512.00,0.00,8699,8700
11867,2,312,200,256.00,3136.00,8699,8701
11868,2,460,52,256.00,41616.00,8700,8702
11869,2,489,23,256.00,54289.00,8701,8703
11870,6,365,1,85.33,17168.89,8702,8708
11871,4,313,2,128.00,16701.50,8707,8711
11872,1,512,512,512.00,0.00,8710,8711
11873,1,512,512,512.00,0.00,8710,8711
11874,1,512,512,512.00,0.00,8710,8711
11875,2,508,4,256.00,63504.00,8710,8712
11876,3,509,1,170.67,57234.89,8711,8714
11877,1,512,512,512.00,0.00,8713,8714
11878,1,512,512,512.00,0.00,8713,8714
11879,4,254,11,128.00,8391.50,8713,8717
11880,1,512,512,512.00,0.00,8716,8717
11881,1,512,512,512.00,0.00,8716,8717
11882,2,393,119,256.00,18769.00,8716,8718
11883,3,225,64,170.67,5689.56,8717,8720
11884,1,512,512,512.00,0.00,8719,8720
11885,1,512,512,512.00,0.00,8719,8720
11886,1,512,512,512.00,0.00,8719,8720
11887,2,322,190,256.00,4356.00,8719,8721
11888,1,512,512,512.00,0.00,8720,8721
11889,1,512,512,512.00,0.00,8720,8721
11890,1,512,512,512.00,0.00,8720,8721
11891,2,317,195,256.00,3721.00,8720,8722
11892,3,194,155,170.67,282.89,8721,8724
11893,1,512,512,512.00,0.00,8723,8724
11894,1,512,512,512.00,0.00,8723,8724
11895,1,512,512,512.00,0.00,8723,8724
11896,2,507,5,256.00,63001.00,8723,8725
11897,1,512,512,512.00,0.00,8724,8725
11898,1,512,512,512.00,0.00,8724,8725
11899,1,512,512,512.00,0.00,8724,8725
11900,1,512,512,512.00,0.00,8724,8725
11901,4,170,57,128.00,2106.50,8724,8728
11902,1,512,512,512.00,0.00,8727,8728
11903,4,345,6,128.00,19106.50,8727,8731
11904,2,409,103,256.00,23409.00,8730,8732
11905,1,512,512,512.00,0.00,8731,8732
11906,1,512,512,512.00,0.00,8731,8732
11907,1,512,512,512.00,0.00,8731,8732
11908,1,512,512,512.00,0.00,8731,8732
11909,4,421,3,128.00,29138.50,8731,8735
11910,5,248,4,102.40,13303.44,8734,8739
11911,2,446,66,256.00,36100.00,8738,8740
11912,3,366,13,170.67,21477.56,8739,8742
11913,1,512,512,512.00,0.00,8741,8742
11914,1,512,512,512.00,0.00,8741,8742
11915,2,391,121,256.00,18225.00,8741,8743
11916,1,512,512,512.00,0.00,8742,8743
11917,1,512,512,512.00,0.00,8742,8743
11918,2,505,7,256.00,62001.00,8742,8744
11919,2,491,21,256.00,55225.00,8743,8745
11920,1,512,512,512.00,0.00,8744,8745
11921,2,268,244,256.00,144.00,8744,8746
11922,2,439,73,256.00,33489.00,8745,8747
11923,1,512,512,512.00,0.00,8746,8747
11924,1,512,512,512.00,0.00,8746,8747
11925,2,354,158,256.00,9604.00,8746,8748
11926,3,281,99,170.67,6268.22,8747,8750
11927,3,389,11,170.67,25534.89,8749,8752
11928,3,374,7,170.67,23234.89,8751,8754
11929,2,311,201,256.00,3025.00,8753,8755
11930,2,347,165,256.00,8281.00,8754,8756
11931,4,308,20,128.00,14044.50,8755,8759
11932,1,512,512,512.00,0.00,8758,8759
11933,1,512,512,512.00,0.00,8758,8759
11934,1,512,512,512.00,0.00,8758,8759
11935,1,512,512,512.00,0.00,8758,8759
11936,1,512,512,512.00,0.00,8758,8759
11937,2,279,233,256.00,529.00,8758,8760
11938,1,512,512,512.00,0.00,8759,8760
11939,1,512,512,512.00,0.00,8759,8760
11940,1,512,512,512.00,0.00,8759,8760
11941,3,474,4,170.67,46155.56,8759,8762
11942,3,396,29,170.67,25948.22,8761,8764
11943,4,384,13,128.00,23121.50,8763,8767
11944,4,231,16,128.00,7509.50,8766,8770
11945,1,512,512,512.00,0.00,8769,8770
11946,1,512,512,512.00,0.00,8769,8770
11947,2,388,124,256.00,17424.00,8769,8771
11948,1,512,512,512.00,0.00,8770,8771
11949,1,512,512,512.00,0.00,8770,8771
11950,1,512,512,512.00,0.00,8770,8771
11951,1,512,512,512.00,0.00,8770,8771
11952,2,323,189,256.00,4489.00,8770,8772
11953,2,418,94,256.00,26244.00,8771,8773
11954,1,512,512,512.00,0.00,8772,8773
11955,1,512,512,512.00,0.00,8772,8773
11956,2,279,233,256.00,529.00,8772,8774
11957,2,340,172,256.00,7056.00,8773,8775
11958,1,512,512,512.00,0.00,8774,8775
11959,2,496,16,256.00,57600.00,8774,8776
11960,1,512,512,512.00,0.00,8775,8776
11961,3,233,79,170.67,4382.89,8775,8778
11962,1,512,512,512.00,0.00,8777,8778
11963,2,391,121,256.00,18225.00,8777,8779
11964,1,512,512,512.00,0.00,8778,8779
11965,1,512,512,512.00,0.00,8778,8779
11966,3,223,127,170.67,1573.56,8778,8781
11967,1,512,512,512.00,0.00,8780,8781
11968,1,512,512,512.00,0.00,8780,8781
11969,1,512,512,512.00,0.00,8780,8781
11970,6,374,5,85.33,16933.56,8780,8786
11971,6,386,2,85.33,18824.56,8785,8791
11972,1,512,512,512.00,0.00,8790,8791
11973,1,512,512,512.00,0.00,8790,8791
11974,2,359,153,256.00,10609.00,8790,8792
11975,4,181,79,128.00,1696.50,8791,8795
11976,2,424,88,256.00,28224.00,8794,8796
11977,2,308,204,256.00,2704.00,8795,8797
11978,1,512,512,512.00,0.00,8796,8797
11979,1,512,512,512.00,0.00,8796,8797
11980,1,512,512,512.00,0.00,8796,8797
11981,2,480,32,256.00,50176.00,8796,8798
11982,1,512,512,512.00,0.00,8797,8798
11983,2,507,5,256.00,63001.00,8797,8799
11984,1,512,512,512.00,0.00,8798,8799
11985,2,395,117,256.00,19321.00,8798,8800
11986,1,512,512,512.00,0.00,8799,8800
11987,1,512,512,512.00,0.00,8799,8800
11988,4,332,8,128.00,16038.00,8799,8803
11989,2,300,212,256.00,1936.00,8802,8804
11990,1,512,512,512.00,0.00,8803,8804
11991,1,512,512,512.00,0.00,8803,8804
11992,1,512,512,512.00,0.00,8803,8804
11993,4,345,4,128.00,17225.50,8803,8807
11994,3,303,3,170.67,15624.22,8806,8809
11995,3,335,1,170.67,18606.89,8808,8811
11996,3,393,31,170.67,25257.56,8810,8813
11997,1,512,512,512.00,0.00,8812,8813
11998,1,512,512,512.00,0.00,8812,8813
11999,1,512,512,512.00,0.00,8812,8813
12000,1,512,512,512.00,0.00,8812,8813
12001,3,385,40,170.67,23337.56,8812,8815
12002,2,505,7,256.00,62001.00,8814,8816
12003,1,512,512,512.00,0.00,8815,8816
12004,3,318,9,170.67,16016.22,8815,8818
12005,1,512,512,512.00,0.00,8817,8818
12006,4,261,55,128.00,6469.00,8817,8821
12007,1,512,512,512.00,0.00,8820,8821
12008,1,512,512,512.00,0.00,8820,8821
12009,3,485,1,170.67,49506.89,8820,8823
12010,1,512,512,512.00,0.00,8822,8823
12011,3,262,76,170.67,5771.56,8822,8825
12012,4,318,10,128.00,14036.00,8824,8828
12013,1,512,512,512.00,0.00,8827,8828
12014,1,512,512,512.00,0.00,8827,8828
12015,1,512,512,512.00,0.00,8827,8828
12016,1,512,512,512.00,0.00,8827,8828
12017,2,422,90,256.00,27556.00,8827,8829
12018,1,512,512,512.00,0.00,8828,8829
12019,1,512,512,512.00,0.00,8828,8829
12020,1,512,512,512.00,0.00,8828,8829
12021,1,512,512,512.00,0.00,8828,8829
12022,2,316,196,256.00,3600.00,8828,8830
12023,1,512,512,512.00,0.00,8829,8830
12024,1,512,512,512.00,0.00,8829,8830
12025,2,452,60,256.00,38416.00,8829,8831
12026,2,458,54,256.00,40804.00,8830,8832
12027,1,512,512,512.00,0.00,8831,8832
12028,1,512,512,512.00,0.00,8831,8832
12029,2,483,29,256.00,51529.00,8831,8833
12030,1,512,512,512.00,0.00,8832,8833
12031,2,405,107,256.00,22201.00,8832,8834
12032,3,246,108,170.67,3254.22,8833,8836
12033,1,512,512,512.00,0.00,8835,8836
12034,1,512,512,512.00,0.00,8835,8836
12035,1,512,512,512.00,0.00,8835,8836
12036,2,302,210,256.00,2116.00,8835,8837
12037,1,512,512,512.00,0.00,8836,8837
12038,2,490,22,256.00,54756.00,8836,8838
12039,2,405,107,256.00,22201.00,8837,8839
12040,2,457,55,256.00,40401.00,8838,8840
12041,4,290,2,128.00,12374.00,8839,8843
12042,2,289,223,256.00,1089.00,8842,8844
12043,2,333,179,256.00,5929.00,8843,8845
12044,1,512,512,512.00,0.00,8844,8845
12045,4,264,2,128.00,13605.50,8844,8848
12046,1,512,512,512.00,0.00,8847,8848
12047,1,512,512,512.00,0.00,8847,8848
12048,1,512,512,512.00,0.00,8847,8848
12049,3,246,41,170.67,8480.22,8847,8850
12050,1,512,512,512.00,0.00,8849,8850
12051,1,512,512,512.00,0.00,8849,8850
12052,1,512,512,512.00,0.00,8849,8850
12053,1,512,512,512.00,0.00,8849,8850
12054,1,512,512,512.00,0.00,8849,8850
12055,4,228,3,128.00,6604.50,8849,8853
12056,4,214,47,128.00,6193.50,8852,8856
12057,1,512,512,512.00,0.00,8855,8856
12058,1,512,512,512.00,0.00,8855,8856
12059,2,391,121,256.00,18225.00,8855,8857
12060,1,512,512,512.00,0.00,8856,8857
12061,5,203,8,102.40,5678.64,8856,8861
12062,1,512,512,512.00,0.00,8860,8861
12063,2,420,92,256.00,26896.00,8860,8862
12064,1,512,512,512.00,0.00,8861,8862
12065,2,506,6,256.00,62500.00,8861,8863
12066,1,512,512,512.00,0.00,8862,8863
12067,4,153,88,128.00,590.50,8862,8866
12068,1,512,512,512.00,0.00,8865,8866
12069,1,512,512,512.00,0.00,8865,8866
12070,1,512,512,512.00,0.00,8865,8866
12071,2,480,32,256.00,50176.00,8865,8867
12072,2,427,85,256.00,29241.00,8866,8868
12073,1,512,512,512.00,0.00,8867,8868
12074,1,512,512,512.00,0.00,8867,8868
12075,1,512,512,512.00,0.00,8867,8868
12076,2,415,97,256.00,25281.00,8867,8869
12077,2,380,132,256.00,15376.00,8868,8870
12078,4,480,2,128.00,41342.00,8869,8873
12079,4,203,77,128.00,2640.50,8872,8876
12080,2,304,208,256.00,2304.00,8875,8877
12081,2,372,140,256.00,13456.00,8876,8878
12082,1,512,512,512.00,0.00,8877,8878
12083,2,331,181,256.00,5625.00,8877,8879
12084,1,512,512,512.00,0.00,8878,8879
12085,1,512,512,512.00,0.00,8878,8879
12086,1,512,512,512.00,0.00,8878,8879
12087,1,512,512,512.00,0.00,8878,8879
12088,1,512,512,512.00,0.00,8878,8879
12089,2,421,91,256.00,27225.00,8878,8880
12090,2,445,67,256.00,35721.00,8879,8881
12091,1,512,512,512.00,0.00,8880,8881
12092,1,512,512,512.00,0.00,8880,8881
12093,3,278,8,170.67,13680.89,8880,8883
12094,2,270,242,256.00,196.00,8882,8884
12095,4,255,24,128.00,10288.50,8883,8887
12096,1,512,512,512.00,0.00,8886,8887
12097,1,512,512,512.00,0.00,8886,8887
12098,2,401,111,256.00,21025.00,8886,8888
12099,1,512,512,512.00,0.00,8887,8888
12100,1,512,512,512.00,0.00,8887,8888
12101,2,396,116,256.00,19600.00,8887,8889
12102,1,512,512,512.00,0.00,8888,8889
12103,3,386,40,170.67,23536.89,8888,8891
12104,1,512,512,512.00,0.00,8890,8891
12105,1,512,512,512.00,0.00,8890,8891
12106,1,512,512,512.00,0.00,8890,8891
12107,2,420,92,256.00,26896.00,8890,8892
12108,2,291,221,256.00,1225.00,8891,8893
12109,2,315,197,256.00,3481.00,8892,8894
12110,2,382,130,256.00,15876.00,8893,8895
12111,1,512,512,512.00,0.00,8894,8895
12112,2,371,141,256.00,13225.00,8894,8896
12113,1,512,512,512.00,0.00,8895,8896
12114,1,512,512,512.00,0.00,8895,8896
12115,1,512,512,512.00,0.00,8895,8896
12116,3,254,65,170.67,6202.89,8895,8898
12117,2,334,178,256.00,6084.00,8897,8899
12118,2,433,79,256.00,31329.00,8898,8900
12119,1,512,512,512.00,0.00,8899,8900
12120,1,512,512,512.00,0.00,8899,8900
12121,1,512,512,512.00,0.00,8899,8900
12122,1,512,512,512.00,0.00,8899,8900
12123,2,484,28,256.00,51984.00,8899,8901
12124,1,512,512,512.00,0.00,8900,8901
12125,1,512,512,512.00,0.00,8900,8901
12126,1,512,512,512.00,0.00,8900,8901
12127,1,512,512,512.00,0.00,8900,8901
12128,2,329,183,256.00,5329.00,8900,8902
12129,1,512,512,512.00,0.00,8901,8902
12130,2,369,143,256.00,12769.00,8901,8903
12131,1,512,512,512.00,0.00,8902,8903
12132,1,512,512,512.00,0.00,8902,8903
12133,2,369,143,256.00,12769.00,8902,8904
12134,1,512,512,512.00,0.00,8903,8904
12135,1,512,512,512.00,0.00,8903,8904
12136,2,396,116,256.00,19600.00,8903,8905
12137,2,289,223,256.00,1089.00,8904,8906
12138,2,417,95,256.00,25921.00,8905,8907
12139,1,512,512,512.00,0.00,8906,8907
12140,7,239,1,73.14,6802.69,8906,8913
12141,2,373,139,256.00,13689.00,8912,8914
12142,2,329,183,256.00,5329.00,8913,8915
12143,2,301,211,256.00,2025.00,8914,8916
12144,1,512,512,512.00,0.00,8915,8916
12145,1,512,512,512.00,0.00,8915,8916
12146,2,381,131,256.00,15625.00,8915,8917
12147,2,470,42,256.00,45796.00,8916,8918
12148,3,287,91,170.67,7074.89,8917,8920
12149,1,512,512,512.00,0.00,8919,8920
12150,1,512,512,512.00,0.00,8919,8920
12151,1,512,512,512.00,0.00,8919,8920
12152,2,457,55,256.00,40401.00,8919,8921
12153,1,512,512,512.00,0.00,8920,8921
12154,1,512,512,512.00,0.00,8920,8921
12155,2,256,256,256.00,0.00,8920,8922
12156,3,357,1,170.67,21261.56,8921,8924
12157,2,309,203,256.00,2809.00,8923,8925
12158,1,512,512,512.00,0.00,8924,8925
12159,1,512,512,512.00,0.00,8924,8925
12160,3,331,43,170.67,14357.56,8924,8927
12161,2,317,195,256.00,3721.00,8926,8928
12162,2,401,111,256.00,21025.00,8927,8929
12163,3,266,21,170.67,11480.22,8928,8931
12164,1,512,512,512.00,0.00,8930,8931
12165,1,512,512,512.00,0.00,8930,8931
12166,1,512,512,512.00,0.00,8930,8931
12167,3,388,3,170.67,25937.56,8930,8933
12168,1,512,512,512.00,0.00,8932,8933
12169,1,512,512,512.00,0.00,8932,8933
12170,2,345,167,256.00,7921.00,8932,8934
12171,1,512,512,512.00,0.00,8933,8934
12172,4,436,1,128.00,32473.50,8933,8937
12173,1,512,512,512.00,0.00,8936,8937
12174,1,512,512,512.00,0.00,8936,8937
12175,1,512,512,512.00,0.00,8936,8937
12176,1,512,512,512.00,0.00,8936,8937
12177,1,512,512,512.00,0.00,8936,8937
12178,4,380,2,128.00,23454.00,8936,8940
12179,1,512,512,512.00,0.00,8939,8940
12180,1,512,512,512.00,0.00,8939,8940
12181,1,512,512,512.00,0.00,8939,8940
12182,1,512,512,512.00,0.00,8939,8940
12183,1,512,512,512.00,0.00,8939,8940
12184,2,502,10,256.00,60516.00,8939,8941
12185,3,363,72,170.67,18500.22,8940,8943
12186,2,455,57,256.00,39601.00,8942,8944
12187,1,512,512,512.00,0.00,8943,8944
12188,1,512,512,512.00,0.00,8943,8944
12189,1,512,512,512.00,0.00,8943,8944
12190,2,497,15,256.00,58081.00,8943,8945
12191,2,271,241,256.00,225.00,8944,8946
12192,3,232,78,170.67,4443.56,8945,8948
12193,1,512,512,512.00,0.00,8947,8948
12194,4,459,2,128.00,36802.50,8947,8951
12195,4,331,46,128.00,13904.50,8951,8955
12196,1,512,512,512.00,0.00,8954,8955
12197,1,512,512,512.00,0.00,8954,8955
12198,2,498,14,256.00,58564.00,8954,8956
12199,1,512,512,512.00,0.00,8955,8956
12200,6,329,11,85.33,12193.22,8955,8961
12201,1,512,512,512.00,0.00,8960,8961
12202,4,337,7,128.00,16348.50,8960,8964
12203,1,512,512,512.00,0.00,8963,8964
12204,1,512,512,512.00,0.00,8963,8964
12205,2,442,70,256.00,34596.00,8963,8965
12206,1,512,512,512.00,0.00,8964,8965
12207,1,512,512,512.00,0.00,8964,8965
12208,1,512,512,512.00,0.00,8964,8965
12209,2,489,23,256.00,54289.00,8964,8966
12210,2,422,90,256.00,27556.00,8965,8967
12211,1,512,512,512.00,0.00,8966,8967
12212,1,512,512,512.00,0.00,8966,8967
12213,3,357,38,170.67,18400.22,8966,8969
12214,1,512,512,512.00,0.00,8968,8969
12215,1,512,512,512.00,0.00,8968,8969
12216,3,351,19,170.67,18781.56,8968,8971
12217,1,512,512,512.00,0.00,8970,8971
12218,1,512,512,512.00,0.00,8970,8971
12219,4,254,2,128.00,13662.50,8970,8974
12220,3,243,132,170.67,2620.22,8973,8976
12221,1,512,512,512.00,0.00,8975,8976
12222,1,512,512,512.00,0.00,8975,8976
12223,1,512,512,512.00,0.00,8975,8976
12224,4,242,9,128.00,8622.50,8975,8979
12225,2,324,188,256.00,4624.00,8978,8980
12226,3,256,3,170.67,14057.56,8979,8982
12227,1,512,512,512.00,0.00,8981,8982
12228,1,512,512,512.00,0.00,8981,8982
12229,1,512,512,512.00,0.00,8981,8982
12230,2,295,217,256.00,1521.00,8981,8983
12231,2,421,91,256.00,27225.00,8982,8984
12232,1,512,512,512.00,0.00,8983,8984
12233,1,512,512,512.00,0.00,8983,8984
12234,2,458,54,256.00,40804.00,8983,8985
12235,3,300,47,170.67,10684.22,8984,8987
12236,1,512,512,512.00,0.00,8986,8987
12237,1,512,512,512.00,0.00,8986,8987
12238,4,314,2,128.00,15732.50,8986,8990
12239,2,461,51,256.00,42025.00,8989,8991
12240,1,512,512,512.00,0.00,8990,8991
12241,1,512,512,512.00,0.00,8990,8991
12242,5,230,8,102.40,7201.04,8990,8995
12243,1,512,512,512.00,0.00,8994,8995
12244,1,512,512,512.00,0.00,8994,8995
12245,1,512,512,512.00,0.00,8994,8995
12246,3,481,11,170.67,48166.89,8994,8997
12247,1,512,512,512.00,0.00,8996,8997
12248,3,286,2,170.67,14864.89,8996,8999
12249,1,512,512,512.00,0.00,8998,8999
12250,2,383,129,256.00,16129.00,8998,9000
12251,3,484,3,170.67,49169.56,8999,9002
12252,4,277,24,128.00,11510.50,9001,9005
12253,3,455,7,170.67,40730.89,9004,9007
12254,3,466,15,170.67,43653.56,9006,9009
12255,1,512,512,512.00,0.00,9008,9009
12256,2,301,211,256.00,2025.00,9008,9010
12257,1,512,512,512.00,0.00,9009,9010
12258,1,512,512,512.00,0.00,9009,9010
12259,2,264,248,256.00,64.00,9009,9011
12260,1,512,512,512.00,0.00,9010,9011
12261,1,512,512,512.00,0.00,9010,9011
12262,1,512,512,512.00,0.00,9010,9011
12263,1,512,512,512.00,0.00,9010,9011
12264,2,362,150,256.00,11236.00,9010,9012
12265,3,344,7,170.67,18974.89,9011,9014
12266,3,388,47,170.67,23766.89,9013,9016
12267,2,416,96,256.00,25600.00,9015,9017
12268,1,512,512,512.00,0.00,9016,9017
12269,3,294,7,170.67,14541.56,9016,9019
12270,1,512,512,512.00,0.00,9018,9019
12271,1,512,512,512.00,0.00,9018,9019
12272,1,512,512,512.00,0.00,9018,9019
12273,7,316,1,73.14,10986.69,9018,9025
12274,1,512,512,512.00,0.00,9024,9025
12275,1,512,512,512.00,0.00,9024,9025
12276,1,512,512,512.00,0.00,9024,9025
12277,4,325,57,128.00,12955.00,9024,9028
12278,2,383,129,256.00,16129.00,9027,9029
12279,2,359,153,256.00,10609.00,9028,9030
12280,3,484,8,170.67,49112.89,9029,9032
12281,1,512,512,512.00,0.00,9031,9032
12282,3,313,29,170.67,13442.89,9031,9034
12283,2,336,176,256.00,6400.00,9033,9035
12284,3,283,83,170.67,6970.89,9034,9037
12285,1,512,512,512.00,0.00,9036,9037
12286,3,362,54,170.67,18598.22,9036,9039
12287,1,512,512,512.00,0.00,9038,9039
12288,2,385,127,256.00,16641.00,9038,9040
12289,2,463,49,256.00,42849.00,9039,9041
12290,1,512,512,512.00,0.00,9040,9041
12291,3,282,84,170.67,6838.22,9040,9043
12292,3,321,20,170.67,15100.22,9042,9045
12293,2,315,197,256.00,3481.00,9044,9046
12294,1,512,512,512.00,0.00,9045,9046
12295,2,431,81,256.00,30625.00,9045,9047
12296,1,512,512,512.00,0.00,9046,9047
12297,5,235,38,102.40,4971.84,9046,9051
12298,1,512,512,512.00,0.00,9050,9051
12299,1,512,512,512.00,0.00,9050,9051
12300,3,416,23,170.67,30510.89,9050,9053
12301,6,307,2,85.33,10866.22,9052,9058
12302,4,191,41,128.00,3177.00,9057,9061
12303,1,512,512,512.00,0.00,9060,9061
12304,1,512,512,512.00,0.00,9060,9061
12305,1,512,512,512.00,0.00,9060,9061
12306,1,512,512,512.00,0.00,9060,9061
12307,3,397,55,170.67,25617.56,9060,9063
12308,3,283,97,170.67,6513.56,9062,9065
12309,1,512,512,512.00,0.00,9064,9065
12310,4,198,52,128.00,3038.00,9064,9068
12311,1,512,512,512.00,0.00,9067,9068
12312,1,512,512,512.00,0.00,9067,9068
12313,2,259,253,256.00,9.00,9067,9069
12314,7,198,1,73.14,5134.98,9068,9075
12315,4,425,2,128.00,29712.50,9074,9078
12316,1,512,512,512.00,0.00,9077,9078
12317,2,487,25,256.00,53361.00,9077,9079
12318,1,512,512,512.00,0.00,9078,9079
12319,2,505,7,256.00,62001.00,9078,9080
12320,1,512,512,512.00,0.00,9079,9080
12321,1,512,512,512.00,0.00,9079,9080
12322,1,512,512,512.00,0.00,9079,9080
12323,7,191,6,73.14,3492.69,9079,9086
12324,1,512,512,512.00,0.00,9085,9086
12325,1,512,512,512.00,0.00,9085,9086
12326,1,512,512,512.00,0.00,9085,9086
12327,1,512,512,512.00,0.00,9085,9086
12328,2,495,17,256.00,57121.00,9085,9087
12329,1,512,512,512.00,0.00,9086,9087
12330,1,512,512,512.00,0.00,9086,9087
12331,3,265,45,170.67,8557.56,9086,9089
12332,7,318,1,73.14,10888.41,9088,9095
12333,1,512,512,512.00,0.00,9094,9095
12334,4,292,1,128.00,15205.50,9094,9098
12335,5,431,2,102.40,27283.44,9097,9102
12336,1,512,512,512.00,0.00,9101,9102
12337,1,512,512,512.00,0.00,9101,9102
12338,8,205,1,64.00,4011.50,9101,9109
12339,4,209,15,128.00,5721.00,9108,9112
12340,2,491,21,256.00,55225.00,9111,9113
12341,3,494,4,170.67,52288.89,9112,9115
12342,1,512,512,512.00,0.00,9114,9115
12343,1,512,512,512.00,0.00,9114,9115
12344,1,512,512,512.00,0.00,9114,9115
12345,1,512,512,512.00,0.00,9114,9115
12346,1,512,512,512.00,0.00,9114,9115
12347,3,214,127,170.67,1261.56,9114,9117
12348,3,398,16,170.67,26960.89,9116,9119
12349,1,512,512,512.00,0.00,9118,9119
12350,2,369,143,256.00,12769.00,9118,9120
12351,1,512,512,512.00,0.00,9119,9120
12352,1,512,512,512.00,0.00,9119,9120
12353,2,348,164,256.00,8464.00,9119,9121
12354,2,447,65,256.00,36481.00,9120,9122
12355,7,287,2,73.14,8494.98,9121,9128
12356,1,512,512,512.00,0.00,9127,9128
12357,1,512,512,512.00,0.00,9127,9128
12358,1,512,512,512.00,0.00,9127,9128
12359,4,286,4,128.00,12679.50,9127,9131
12360,1,512,512,512.00,0.00,9130,9131
12361,1,512,512,512.00,0.00,9130,9131
12362,2,270,242,256.00,196.00,9130,9132
12363,1,512,512,512.00,0.00,9131,9132
12364,1,512,512,512.00,0.00,9131,9132
12365,1,512,512,512.00,0.00,9131,9132
12366,1,512,512,512.00,0.00,9131,9132
12367,2,503,9,256.00,61009.00,9131,9133
12368,1,512,512,512.00,0.00,9132,9133
12369,1,512,512,512.00,0.00,9132,9133
12370,1,512,512,512.00,0.00,9132,9133
12371,1,512,512,512.00,0.00,9132,9133
12372,1,512,512,512.00,0.00,9132,9133
12373,2,312,200,256.00,3136.00,9132,9134
12374,1,512,512,512.00,0.00,9133,9134
12375,2,426,86,256.00,28900.00,9133,9135
12376,2,291,221,256.00,1225.00,9134,9136
12377,1,512,512,512.00,0.00,9135,9136
12378,2,293,219,256.00,1369.00,9135,9137
12379,1,512,512,512.00,0.00,9136,9137
12380,5,246,23,102.40,6704.24,9136,9141
12381,1,512,512,512.00,0.00,9140,9141
12382,2,479,33,256.00,49729.00,9140,9142
12383,1,512,512,512.00,0.00,9141,9142
12384,1,512,512,512.00,0.00,9141,9142
12385,1,512,512,512.00,0.00,9141,9142
12386,1,512,512,512.00,0.00,9141,9142
12387,1,512,512,512.00,0.00,9141,9142
12388,5,262,2,102.40,8773.04,9141,9146
12389,2,334,178,256.00,6084.00,9145,9147
12390,1,512,512,512.00,0.00,9146,9147
12391,4,319,5,128.00,14493.00,9146,9150
12392,1,512,512,512.00,0.00,9149,9150
12393,1,512,512,512.00,0.00,9149,9150
12394,1,512,512,512.00,0.00,9149,9150
12395,3,388,26,170.67,24480.89,9149,9152
12396,1,512,512,512.00,0.00,9151,9152
12397,1,512,512,512.00,0.00,9151,9152
12398,3,296,50,170.67,10096.89,9151,9154
12399,4,414,12,128.00,27667.50,9153,9157
12400,9,228,2,56.89,5594.10,9156,9165
12401,2,443,69,256.00,34969.00,9164,9166
12402,1,512,512,512.00,0.00,9165,9166
12403,1,512,512,512.00,0.00,9165,9166
12404,2,502,10,256.00,60516.00,9165,9167
12405,3,500,4,170.67,54232.89,9166,9169
12406,3,397,17,170.67,26706.89,9168,9171
12407,1,512,512,512.00,0.00,9170,9171
12408,2,403,109,256.00,21609.00,9170,9172
12409,1,512,512,512.00,0.00,9171,9172
12410,3,281,88,170.67,6590.89,9171,9174
12411,4,175,68,128.00,1609.50,9173,9177
12412,1,512,512,512.00,0.00,9176,9177
12413,4,386,3,128.00,23886.50,9176,9180
12414,2,347,165,256.00,8281.00,9179,9181
12415,1,512,512,512.00,0.00,9180,9181
12416,3,288,92,170.67,7150.22,9180,9183
12417,1,512,512,512.00,0.00,9182,9183
12418,2,308,204,256.00,2704.00,9182,9184
12419,1,512,512,512.00,0.00,9183,9184
12420,2,352,160,256.00,9216.00,9183,9185
12421,1,512,512,512.00,0.00,9184,9185
12422,1,512,512,512.00,0.00,9184,9185
12423,3,269,90,170.67,5496.22,9184,9187
12424,1,512,512,512.00,0.00,9186,9187
12425,2,273,239,256.00,289.00,9186,9188
12426,6,236,1,85.33,8206.22,9187,9193
12427,1,512,512,512.00,0.00,9192,9193
12428,1,512,512,512.00,0.00,9192,9193
12429,1,512,512,512.00,0.00,9192,9193
12430,9,221,1,56.89,6790.10,9192,9201
12431,5,337,1,102.40,16870.24,9200,9205
12432,2,442,70,256.00,34596.00,9204,9206
12433,2,268,244,256.00,144.00,9205,9207
12434,2,400,112,256.00,20736.00,9206,9208
12435,3,506,2,170.67,56224.89,9207,9210
12436,4,497,1,128.00,45405.50,9209,9213
12437,1,512,512,512.00,0.00,9212,9213
12438,2,323,189,256.00,4489.00,9212,9214
12439,1,512,512,512.00,0.00,9213,9214
12440,1,512,512,512.00,0.00,9213,9214
12441,1,512,512,512.00,0.00,9213,9214
12442,1,512,512,512.00,0.00,9213,9214
12443,3,313,64,170.67,10969.56,9213,9216
12444,1,512,512,512.00,0.00,9215,9216
12445,1,512,512,512.00,0.00,9215,9216
12446,1,512,512,512.00,0.00,9215,9216
12447,1,512,512,512.00,0.00,9215,9216
12448,1,512,512,512.00,0.00,9215,9216
12449,8,340,1,64.00,12013.50,9215,9223
12450,1,512,512,512.00,0.00,9222,9223
12451,1,512,512,512.00,0.00,9222,9223
12452,7,255,1,73.14,9706.69,9222,9229
12453,1,512,512,512.00,0.00,9228,9229
12454,2,489,23,256.00,54289.00,9228,9230
12455,1,512,512,512.00,0.00,9229,9230
12456,2,355,157,256.00,9801.00,9229,9231
12457,7,309,1,73.14,11645.55,9230,9237
12458,3,385,5,170.67,25250.89,9236,9239
12459,2,509,3,256.00,64009.00,9238,9240
12460,2,447,65,256.00,36481.00,9239,9241
12461,1,512,512,512.00,0.00,9240,9241
12462,1,512,512,512.00,0.00,9240,9241
12463,1,512,512,512.00,0.00,9240,9241
12464,2,430,82,256.00,30276.00,9240,9242
12465,1,512,512,512.00,0.00,9241,9242
12466,2,452,60,256.00,38416.00,9241,9243
12467,2,424,88,256.00,28224.00,9242,9244
12468,1,512,512,512.00,0.00,9243,9244
12469,1,512,512,512.00,0.00,9243,9244
12470,1,512,512,512.00,0.00,9243,9244
12471,2,356,156,256.00,10000.00,9243,9245
12472,5,228,6,102.40,7755.44,9244,9249
12473,2,352,160,256.00,9216.00,9248,9250
12474,1,512,512,512.00,0.00,9249,9250
12475,1,512,512,512.00,0.00,9249,9250
12476,3,350,41,170.67,17146.89,9249,9252
12477,1,512,512,512.00,0.00,9251,9252
12478,1,512,512,512.00,0.00,9251,9252
12479,1,512,512,512.00,0.00,9251,9252
12480,4,201,9,128.00,5169.00,9251,9255
12481,2,421,91,256.00,27225.00,9254,9256
12482,1,512,512,512.00,0.00,9255,9256
12483,1,512,512,512.00,0.00,9255,9256
12484,3,290,83,170.67,7642.89,9255,9258
12485,5,372,1,102.40,19141.84,9257,9262
12486,4,470,5,128.00,39054.50,9261,9265
12487,1,512,512,512.00,0.00,9264,9265
12488,1,512,512,512.00,0.00,9264,9265
12489,1,512,512,512.00,0.00,9264,9265
12490,2,442,70,256.00,34596.00,9264,9266
12491,5,268,1,102.40,14135.44,9265,9270
12492,1,512,512,512.00,0.00,9269,9270
12493,3,296,1,170.67,15486.89,9269,9272
12494,1,512,512,512.00,0.00,9271,9272
12495,1,512,512,512.00,0.00,9271,9272
12496,1,512,512,512.00,0.00,9271,9272
12497,2,327,185,256.00,5041.00,9271,9273
12498,5,395,2,102.40,22001.84,9272,9277
12499,1,512,512,512.00,0.00,9276,9277
12500,1,512,512,512.00,0.00,9276,9277
12501,1,512,512,512.00,0.00,9276,9277
12502,3,277,105,170.67,5757.56,9276,9279
12503,1,512,512,512.00,0.00,9278,9279
12504,1,512,512,512.00,0.00,9278,9279
12505,3,354,13,170.67,19709.56,9278,9281
12506,4,265,2,128.00,11451.50,9280,9284
12507,3,270,18,170.67,12006.22,9283,9286
12508,4,282,2,128.00,11054.00,9285,9289
12509,4,355,2,128.00,20079.50,9288,9292
12510,4,390,1,128.00,24506.50,9291,9295
12511,1,512,512,512.00,0.00,9294,9295
12512,1,512,512,512.00,0.00,9294,9295
12513,1,512,512,512.00,0.00,9294,9295
12514,1,512,512,512.00,0.00,9294,9295
12515,3,311,5,170.67,15926.89,9294,9297
12516,3,271,43,170.67,9037.56,9296,9299
12517,2,466,46,256.00,44100.00,9298,9300
12518,1,512,512,512.00,0.00,9299,9300
12519,1,512,512,512.00,0.00,9299,9300
12520,1,512,512,512.00,0.00,9299,9300
12521,2,382,130,256.00,15876.00,9299,9301
12522,1,512,512,512.00,0.00,9300,9301
12523,1,512,512,512.00,0.00,9300,9301
12524,3,393,3,170.67,26844.22,9300,9303
12525,1,512,512,512.00,0.00,9302,9303
12526,1,512,512,512.00,0.00,9302,9303
12527,1,512,512,512.00,0.00,9302,9303
12528,1,512,512,512.00,0.00,9302,9303
12529,5,298,1,102.40,11501.44,9302,9307
12530,1,512,512,512.00,0.00,9306,9307
12531,1,512,512,512.00,0.00,9306,9307
12532,4,272,68,128.00,6990.50,9306,9310
12533,2,359,153,256.00,10609.00,9309,9311
12534,3,211,131,170.67,1066.89,9310,9313
12535,2,452,60,256.00,38416.00,9312,9314
12536,4,242,38,128.00,5738.00,9313,9317
12537,1,512,512,512.00,0.00,9316,9317
12538,2,434,78,256.00,31684.00,9316,9318
12539,2,325,187,256.00,4761.00,9317,9319
12540,7,149,3,73.14,2560.41,9318,9325
12541,3,454,4,170.67,40555.56,9324,9327
12542,1,512,512,512.00,0.00,9326,9327
12543,4,252,11,128.00,10842.50,9326,9330
12544,2,502,10,256.00,60516.00,9329,9331
12545,2,437,75,256.00,32761.00,9330,9332
12546,1,512,512,512.00,0.00,9331,9332
12547,3,202,114,170.67,1611.56,9331,9334
12548,3,273,104,170.67,5396.22,9333,9336
12549,6,302,3,85.33,13428.22,9335,9341
12550,1,512,512,512.00,0.00,9340,9341
12551,1,512,512,512.00,0.00,9340,9341
12552,1,512,512,512.00,0.00,9340,9341
12553,1,512,512,512.00,0.00,9340,9341
12554,6,200,5,85.33,4185.56,9340,9346
12555,1,512,512,512.00,0.00,9345,9346
12556,7,171,5,73.14,3415.55,9345,9352
12557,3,450,5,170.67,39464.22,9351,9354
12558,1,512,512,512.00,0.00,9353,9354
12559,1,512,512,512.00,0.00,9353,9354
12560,3,238,128,170.67,2320.89,9353,9356
12561,1,512,512,512.00,0.00,9355,9356
12562,1,512,512,512.00,0.00,9355,9356
12563,4,371,8,128.00,21288.50,9355,9359
12564,1,512,512,512.00,0.00,9358,9359
12565,1,512,512,512.00,0.00,9358,9359
12566,2,445,67,256.00,35721.00,9358,9360
12567,1,512,512,512.00,0.00,9359,9360
12568,1,512,512,512.00,0.00,9359,9360
12569,1,512,512,512.00,0.00,9359,9360
12570,5,238,3,102.40,9121.84,9359,9364
12571,1,512,512,512.00,0.00,9363,9364
12572,1,512,512,512.00,0.00,9363,9364
12573,1,512,512,512.00,0.00,9363,9364
12574,1,512,512,512.00,0.00,9363,9364
12575,2,402,110,256.00,21316.00,9363,9365
12576,1,512,512,512.00,0.00,9364,9365
12577,5,304,4,102.40,14045.44,9364,9369
12578,4,350,1,128.00,17806.50,9368,9372
12579,2,437,75,256.00,32761.00,9371,9373
12580,2,275,237,256.00,361.00,9372,9374
12581,1,512,512,512.00,0.00,9373,9374
12582,2,350,162,256.00,8836.00,9373,9375
12583,6,234,17,85.33,5663.22,9374,9380
12584,1,512,512,512.00,0.00,9379,9380
12585,4,495,1,128.00,44922.50,9379,9383
12586,6,270,1,85.33,10758.56,9382,9388
12587,1,512,512,512.00,0.00,9387,9388
12588,1,512,512,512.00,0.00,9387,9388
12589,3,210,125,170.67,1224.22,9387,9390
12590,2,276,236,256.00,400.00,9389,9391
12591,3,328,21,170.67,15737.56,9390,9393
12592,1,512,512,512.00,0.00,9392,9393
12593,3,285,96,170.67,6740.22,9392,9395
12594,5,458,1,102.40,31719.44,9394,9399
12595,1,512,512,512.00,0.00,9398,9399
12596,3,383,14,170.67,24242.89,9398,9401
12597,1,512,512,512.00,0.00,9400,9401
12598,1,512,512,512.00,0.00,9400,9401
12599,1,512,512,512.00,0.00,9400,9401
12600,1,512,512,512.00,0.00,9400,9401
12601,2,498,14,256.00,58564.00,9400,9402
12602,1,512,512,512.00,0.00,9401,9402
12603,1,512,512,512.00,0.00,9401,9402
12604,1,512,512,512.00,0.00,9401,9402
12605,6,397,1,85.33,19914.22,9401,9407
12606,2,451,61,256.00,38025.00,9406,9408
12607,1,512,512,512.00,0.00,9407,9408
12608,1,512,512,512.00,0.00,9407,9408
12609,1,512,512,512.00,0.00,9407,9408
12610,1,512,512,512.00,0.00,9407,9408
12611,4,274,1,128.00,9472.50,9407,9411
12612,1,512,512,512.00,0.00,9410,9411
12613,1,512,512,512.00,0.00,9410,9411
12614,5,229,12,102.40,6774.24,9410,9415
12615,3,399,6,170.67,27768.22,9414,9417
12616,4,224,37,128.00,7537.50,9416,9420
12617,2,481,31,256.00,50625.00,9419,9421
12618,5,303,2,102.40,11464.64,9420,9425
12619,3,399,2,170.67,28048.22,9424,9427
12620,2,495,17,256.00,57121.00,9426,9428
12621,1,512,512,512.00,0.00,9427,9428
12622,1,512,512,512.00,0.00,9427,9428
12623,1,512,512,512.00,0.00,9427,9428
12624,1,512,512,512.00,0.00,9427,9428
12625,3,237,124,170.67,2321.56,9427,9430
12626,2,396,116,256.00,19600.00,9429,9431
12627,2,400,112,256.00,20736.00,9430,9432
12628,2,498,14,256.00,58564.00,9431,9433
12629,2,300,212,256.00,1936.00,9432,9434
12630,5,207,11,102.40,5037.44,9433,9438
12631,1,512,512,512.00,0.00,9437,9438
12632,1,512,512,512.00,0.00,9437,9438
12633,5,243,3,102.40,7971.04,9437,9442
12634,1,512,512,512.00,0.00,9441,9442
12635,1,512,512,512.00,0.00,9441,9442
12636,3,270,27,170.67,10824.22,9441,9444
12637,2,433,79,256.00,31329.00,9443,9445
12638,1,512,512,512.00,0.00,9444,9445
12639,1,512,512,512.00,0.00,9444,9445
12640,2,503,9,256.00,61009.00,9444,9446
12641,1,512,512,512.00,0.00,9445,9446
12642,2,275,237,256.00,361.00,9445,9447
12643,2,342,170,256.00,7396.00,9446,9448
12644,1,512,512,512.00,0.00,9447,9448
12645,1,512,512,512.00,0.00,9447,9448
12646,1,512,512,512.00,0.00,9447,9448
12647,1,512,512,512.00,0.00,9447,9448
12648,2,283,229,256.00,729.00,9447,9449
12649,1,512,512,512.00,0.00,9448,9449
12650,4,243,6,128.00,8068.50,9448,9452
12651,2,417,95,256.00,25921.00,9451,9453
12652,1,512,512,512.00,0.00,9452,9453
12653,1,512,512,512.00,0.00,9452,9453
12654,2,461,51,256.00,42025.00,9452,9454
12655,2,368,144,256.00,12544.00,9453,9455
12656,1,512,512,512.00,0.00,9454,9455
12657,9,175,4,56.89,3466.54,9454,9463
12658,1,512,512,512.00,0.00,9462,9463
12659,1,512,512,512.00,0.00,9462,9463
12660,3,273,107,170.67,5340.22,9462,9465
12661,1,512,512,512.00,0.00,9464,9465
12662,1,512,512,512.00,0.00,9464,9465
12663,10,130,4,51.20,2136.76,9464,9474
12664,10,343,1,51.20,9913.56,9473,9483
12665,1,512,512,512.00,0.00,9482,9483
12666,4,295,48,128.00,9528.50,9482,9486
12667,1,512,512,512.00,0.00,9485,9486
12668,2,453,59,256.00,38809.00,9485,9487
12669,1,512,512,512.00,0.00,9486,9487
12670,3,344,4,170.67,19288.89,9486,9489
12671,4,184,58,128.00,2578.00,9488,9492
12672,1,512,512,512.00,0.00,9491,9492
12673,5,281,3,102.40,12652.64,9491,9496
12674,1,512,512,512.00,0.00,9495,9496
12675,2,267,245,256.00,121.00,9495,9497
12676,4,413,3,128.00,28425.00,9496,9500
12677,1,512,512,512.00,0.00,9499,9500
12678,1,512,512,512.00,0.00,9499,9500
12679,3,269,8,170.67,13422.89,9499,9502
12680,2,268,244,256.00,144.00,9501,9503
12681,1,512,512,512.00,0.00,9502,9503
12682,3,225,69,170.67,5176.22,9502,9505
12683,1,512,512,512.00,0.00,9504,9505
12684,1,512,512,512.00,0.00,9504,9505
12685,1,512,512,512.00,0.00,9504,9505
12686,1,512,512,512.00,0.00,9504,9505
12687,1,512,512,512.00,0.00,9504,9505
12688,1,512,512,512.00,0.00,9504,9505
12689,5,149,17,102.40,2716.64,9504,9509
12690,1,512,512,512.00,0.00,9508,9509
12691,1,512,512,512.00,0.00,9508,9509
12692,1,512,512,512.00,0.00,9508,9509
12693,1,512,512,512.00,0.00,9508,9509
12694,4,233,74,128.00,3820.50,9508,9512
12695,1,512,512,512.00,0.00,9511,9512
12696,1,512,512,512.00,0.00,9511,9512
12697,2,338,174,256.00,6724.00,9511,9513
12698,2,275,237,256.00,361.00,9512,9514
12699,1,512,512,512.00,0.00,9513,9514
12700,1,512,512,512.00,0.00,9513,9514
12701,1,512,512,512.00,0.00,9513,9514
12702,1,512,512,512.00,0.00,9513,9514
12703,7,188,10,73.14,3828.69,9513,9520
12704,2,392,120,256.00,18496.00,9519,9521
12705,4,214,61,128.00,4192.50,9520,9524
12706,1,512,512,512.00,0.00,9523,9524
12707,1,512,512,512.00,0.00,9523,9524
12708,2,428,84,256.00,29584.00,9523,9525
12709,1,512,512,512.00,0.00,9524,9525
12710,5,370,2,102.40,19085.84,9524,9529
12711,2,366,146,256.00,12100.00,9528,9530
12712,1,512,512,512.00,0.00,9529,9530
12713,4,297,30,128.00,11767.50,9529,9533
12714,2,312,200,256.00,3136.00,9532,9534
12715,2,292,220,256.00,1296.00,9533,9535
12716,5,187,21,102.40,4729.04,9534,9539
12717,4,342,3,128.00,19426.50,9538,9542
12718,1,512,512,512.00,0.00,9541,9542
12719,1,512,512,512.00,0.00,9541,9542
12720,12,148,1,42.67,2704.39,9541,9553
12721,6,331,9,85.33,12695.22,9552,9558
12722,1,512,512,512.00,0.00,9557,9558
12723,1,512,512,512.00,0.00,9557,9558
12724,1,512,512,512.00,0.00,9557,9558
12725,4,459,5,128.00,36678.50,9557,9561
12726,3,401,10,170.67,27906.89,9560,9563
12727,1,512,512,512.00,0.00,9562,9563
12728,3,330,40,170.67,14427.56,9562,9565
12729,4,382,5,128.00,22057.50,9564,9568
12730,7,358,1,73.14,14155.55,9567,9574
12731,1,512,512,512.00,0.00,9573,9574
12732,1,512,512,512.00,0.00,9573,9574
12733,1,512,512,512.00,0.00,9573,9574
12734,2,332,180,256.00,5776.00,9573,9575
12735,4,465,5,128.00,38011.50,9574,9578
12736,1,512,512,512.00,0.00,9577,9578
12737,1,512,512,512.00,0.00,9577,9578
12738,4,377,5,128.00,21379.50,9577,9581
12739,1,512,512,512.00,0.00,9580,9581
12740,1,512,512,512.00,0.00,9580,9581
12741,2,256,256,256.00,0.00,9580,9582
12742,1,512,512,512.00,0.00,9581,9582
12743,1,512,512,512.00,0.00,9581,9582
12744,4,305,13,128.00,12341.00,9581,9585
12745,1,512,512,512.00,0.00,9584,9585
12746,1,512,512,512.00,0.00,9584,9585
12747,3,283,88,170.67,6777.56,9584,9587
12748,1,512,512,512.00,0.00,9586,9587
12749,2,285,227,256.00,841.00,9586,9588
12750,1,512,512,512.00,0.00,9587,9588
12751,2,482,30,256.00,51076.00,9587,9589
12752,1,512,512,512.00,0.00,9588,9589
12753,1,512,512,512.00,0.00,9588,9589
12754,1,512,512,512.00,0.00,9588,9589
12755,2,324,188,256.00,4624.00,9588,9590
12756,1,512,512,512.00,0.00,9589,9590
12757,1,512,512,512.00,0.00,9589,9590
12758,2,281,231,256.00,625.00,9589,9591
12759,1,512,512,512.00,0.00,9590,9591
12760,1,512,512,512.00,0.00,9590,9591
12761,5,300,1,102.40,10870.24,9590,9595
12762,3,335,61,170.67,14006.89,9594,9597
12763,3,392,49,170.67,24574.89,9596,9599
12764,1,512,512,512.00,0.00,9598,9599
12765,1,512,512,512.00,0.00,9598,9599
12766,5,317,6,102.40,15309.04,9598,9603
12767,3,270,1,170.67,14533.56,9602,9605
12768,1,512,512,512.00,0.00,9604,9605
12769,3,365,60,170.67,19004.22,9604,9607
12770,1,512,512,512.00,0.00,9606,9607
12771,1,512,512,512.00,0.00,9606,9607
12772,2,462,50,256.00,42436.00,9606,9608
12773,1,512,512,512.00,0.00,9607,9608
12774,1,512,512,512.00,0.00,9607,9608
12775,2,305,207,256.00,2401.00,9607,9609
12776,1,512,512,512.00,0.00,9608,9609
12777,1,512,512,512.00,0.00,9608,9609
12778,2,399,113,256.00,20449.00,9608,9610
12779,3,494,1,170.67,52314.89,9609,9612
12780,1,512,512,512.00,0.00,9611,9612
12781,1,512,512,512.00,0.00,9611,9612
12782,2,273,239,256.00,289.00,9611,9613
12783,1,512,512,512.00,0.00,9612,9613
12784,1,512,512,512.00,0.00,9612,9613
12785,1,512,512,512.00,0.00,9612,9613
12786,1,512,512,512.00,0.00,9612,9613
12787,3,462,22,170.67,42443.56,9612,9615
12788,3,344,6,170.67,19078.22,9614,9617
12789,1,512,512,512.00,0.00,9616,9617
12790,1,512,512,512.00,0.00,9616,9617
12791,1,512,512,512.00,0.00,9616,9617
12792,5,190,2,102.40,3862.64,9616,9621
12793,1,512,512,512.00,0.00,9620,9621
12794,1,512,512,512.00,0.00,9620,9621
12795,3,360,1,170.67,21673.56,9620,9623
12796,5,173,16,102.40,3588.64,9622,9627
12797,1,512,512,512.00,0.00,9626,9627
12798,2,387,125,256.00,17161.00,9626,9628
12799,2,502,10,256.00,60516.00,9627,9629
12800,2,336,176,256.00,6400.00,9628,9630
12801,1,512,512,512.00,0.00,9629,9630
12802,1,512,512,512.00,0.00,9629,9630
12803,1,512,512,512.00,0.00,9629,9630
12804,1,512,512,512.00,0.00,9629,9630
12805,3,440,10,170.67,36720.89,9629,9632
12806,1,512,512,512.00,0.00,9631,9632
12807,1,512,512,512.00,0.00,9631,9632
12808,1,512,512,512.00,0.00,9631,9632
12809,1,512,512,512.00,0.00,9631,9632
12810,1,512,512,512.00,0.00,9631,9632
12811,5,207,9,102.40,5020.24,9631,9636
12812,1,512,512,512.00,0.00,9635,9636
12813,1,512,512,512.00,0.00,9635,9636
12814,1,512,512,512.00,0.00,9635,9636
12815,1,512,512,512.00,0.00,9635,9636
12816,1,512,512,512.00,0.00,9635,9636
12817,5,295,6,102.40,12840.24,9635,9640
12818,1,512,512,512.00,0.00,9639,9640
12819,4,384,10,128.00,23086.00,9639,9643
12820,1,512,512,512.00,0.00,9642,9643
12821,4,341,17,128.00,16923.50,9642,9646
12822,5,309,11,102.40,12753.44,9645,9650
12823,4,154,93,128.00,656.50,9649,9653
12824,4,394,13,128.00,23923.50,9652,9656
12825,1,512,512,512.00,0.00,9655,9656
12826,1,512,512,512.00,0.00,9655,9656
12827,1,512,512,512.00,0.00,9655,9656
12828,1,512,512,512.00,0.00,9655,9656
12829,1,512,512,512.00,0.00,9655,9656
12830,1,512,512,512.00,0.00,9655,9656
12831,6,391,2,85.33,18869.89,9655,9661
12832,2,482,30,256.00,51076.00,9660,9662
12833,3,370,9,170.67,22429.56,9661,9664
12834,5,268,4,102.40,9594.64,9663,9668
12835,1,512,512,512.00,0.00,9667,9668
12836,3,504,3,170.67,55556.22,9667,9670
12837,2,320,192,256.00,4096.00,9669,9671
12838,2,493,19,256.00,56169.00,9670,9672
12839,6,266,3,85.33,8946.89,9671,9677
12840,2,426,86,256.00,28900.00,9676,9678
12841,3,270,1,170.67,14533.56,9677,9680
12842,1,512,512,512.00,0.00,9679,9680
12843,1,512,512,512.00,0.00,9679,9680
12844,1,512,512,512.00,0.00,9679,9680
12845,2,324,188,256.00,4624.00,9679,9681
12846,1,512,512,512.00,0.00,9680,9681
12847,3,487,5,170.67,50070.89,9680,9683
12848,1,512,512,512.00,0.00,9682,9683
12849,3,502,1,170.67,54901.56,9682,9685
12850,1,512,512,512.00,0.00,9684,9685
12851,4,405,14,128.00,26052.50,9684,9688
12852,1,512,512,512.00,0.00,9687,9688
12853,1,512,512,512.00,0.00,9687,9688
12854,1,512,512,512.00,0.00,9687,9688
12855,4,397,28,128.00,24161.50,9687,9691
12856,1,512,512,512.00,0.00,9690,9691
12857,1,512,512,512.00,0.00,9690,9691
12858,1,512,512,512.00,0.00,9690,9691
12859,1,512,512,512.00,0.00,9690,9691
12860,1,512,512,512.00,0.00,9690,9691
12861,1,512,512,512.00,0.00,9690,9691
12862,2,501,11,256.00,60025.00,9690,9692
12863,1,512,512,512.00,0.00,9691,9692
12864,1,512,512,512.00,0.00,9691,9692
12865,1,512,512,512.00,0.00,9691,9692
12866,1,512,512,512.00,0.00,9691,9692
12867,1,512,512,512.00,0.00,9691,9692
12868,4,354,4,128.00,18971.50,9691,9695
12869,2,318,194,256.00,3844.00,9694,9696
12870,2,432,80,256.00,30976.00,9695,9697
12871,5,238,3,102.40,10451.84,9696,9701
12872,1,512,512,512.00,0.00,9700,9701
12873,1,512,512,512.00,0.00,9700,9701
12874,1,512,512,512.00,0.00,9700,9701
12875,1,512,512,512.00,0.00,9700,9701
12876,2,508,4,256.00,63504.00,9700,9702
12877,2,316,196,256.00,3600.00,9701,9703
12878,2,470,42,256.00,45796.00,9702,9704
12879,1,512,512,512.00,0.00,9703,9704
12880,1,512,512,512.00,0.00,9703,9704
12881,1,512,512,512.00,0.00,9703,9704
12882,2,492,20,256.00,55696.00,9703,9705
12883,1,512,512,512.00,0.00,9704,9705
12884,1,512,512,512.00,0.00,9704,9705
12885,1,512,512,512.00,0.00,9704,9705
12886,1,512,512,512.00,0.00,9704,9705
12887,1,512,512,512.00,0.00,9704,9705
12888,1,512,512,512.00,0.00,9704,9705
12889,4,235,16,128.00,9161.50,9704,9708
12890,7,301,2,73.14,10157.84,9707,9714
12891,1,512,512,512.00,0.00,9713,9714
12892,1,512,512,512.00,0.00,9713,9714
12893,2,283,229,256.00,729.00,9713,9715
12894,2,372,140,256.00,13456.00,9714,9716
12895,2,349,163,256.00,8649.00,9715,9717
12896,2,508,4,256.00,63504.00,9716,9718
12897,1,512,512,512.00,0.00,9717,9718
12898,1,512,512,512.00,0.00,9717,9718
12899,2,479,33,256.00,49729.00,9717,9719
12900,1,512,512,512.00,0.00,9718,9719
12901,2,413,99,256.00,24649.00,9718,9720
12902,1,512,512,512.00,0.00,9719,9720
12903,1,512,512,512.00,0.00,9719,9720
12904,1,512,512,512.00,0.00,9719,9720
12905,2,504,8,256.00,61504.00,9719,9721
12906,4,321,6,128.00,17149.50,9720,9724
12907,1,512,512,512.00,0.00,9723,9724
12908,1,512,512,512.00,0.00,9723,9724
12909,1,512,512,512.00,0.00,9723,9724
12910,2,412,100,256.00,24336.00,9723,9725
12911,1,512,512,512.00,0.00,9724,9725
12912,1,512,512,512.00,0.00,9724,9725
12913,1,512,512,512.00,0.00,9724,9725
12914,1,512,512,512.00,0.00,9724,9725
12915,2,391,121,256.00,18225.00,9724,9726
12916,3,395,12,170.67,26604.22,9725,9728
12917,5,316,5,102.40,15388.64,9727,9732
12918,1,512,512,512.00,0.00,9731,9732
12919,1,512,512,512.00,0.00,9731,9732
12920,1,512,512,512.00,0.00,9731,9732
12921,1,512,512,512.00,0.00,9731,9732
12922,2,294,218,256.00,1444.00,9731,9733
12923,1,512,512,512.00,0.00,9732,9733
12924,3,247,77,170.67,4966.89,9732,9735
12925,4,281,4,128.00,9867.50,9734,9738
12926,1,512,512,512.00,0.00,9737,9738
12927,1,512,512,512.00,0.00,9737,9738
12928,2,400,112,256.00,20736.00,9737,9739
12929,1,512,512,512.00,0.00,9738,9739
12930,1,512,512,512.00,0.00,9738,9739
12931,2,424,88,256.00,28224.00,9738,9740
12932,1,512,512,512.00,0.00,9739,9740
12933,5,193,5,102.40,6371.04,9739,9744
12934,1,512,512,512.00,0.00,9743,9744
12935,1,512,512,512.00,0.00,9743,9744
12936,2,442,70,256.00,34596.00,9743,9745
12937,1,512,512,512.00,0.00,9744,9745
12938,1,512,512,512.00,0.00,9744,9745
12939,1,512,512,512.00,0.00,9744,9745
12940,2,426,86,256.00,28900.00,9744,9746
12941,1,512,512,512.00,0.00,9745,9746
12942,2,329,183,256.00,5329.00,9745,9747
12943,1,512,512,512.00,0.00,9746,9747
12944,3,260,59,170.67,6982.89,9746,9749
12945,1,512,512,512.00,0.00,9748,9749
12946,2,326,186,256.00,4900.00,9748,9750
12947,2,291,221,256.00,1225.00,9749,9751
12948,1,512,512,512.00,0.00,9750,9751
12949,4,315,47,128.00,11799.50,9750,9754
12950,1,512,512,512.00,0.00,9753,9754
12951,1,512,512,512.00,0.00,9753,9754
12952,1,512,512,512.00,0.00,9753,9754
12953,2,498,14,256.00,58564.00,9753,9755
12954,2,321,191,256.00,4225.00,9754,9756
12955,1,512,512,512.00,0.00,9755,9756
12956,1,512,512,512.00,0.00,9755,9756
12957,1,512,512,512.00,0.00,9755,9756
12958,1,512,512,512.00,0.00,9755,9756
12959,1,512,512,512.00,0.00,9755,9756
12960,2,437,75,256.00,32761.00,9755,9757
12961,1,512,512,512.00,0.00,9756,9757
12962,1,512,512,512.00,0.00,9756,9757
12963,1,512,512,512.00,0.00,9756,9757
12964,1,512,512,512.00,0.00,9756,9757
12965,1,512,512,512.00,0.00,9756,9757
12966,2,495,17,256.00,57121.00,9756,9758
12967,3,474,13,170.67,46029.56,9757,9760
12968,6,202,3,85.33,3722.22,9759,9765
12969,2,456,56,256.00,40000.00,9764,9766
12970,1,512,512,512.00,0.00,9765,9766
12971,2,320,192,256.00,4096.00,9765,9767
12972,1,512,512,512.00,0.00,9766,9767
12973,5,247,8,102.40,10011.04,9766,9771
12974,3,350,10,170.67,19440.89,9770,9773
12975,2,345,167,256.00,7921.00,9772,9774
12976,2,299,213,256.00,1849.00,9773,9775
12977,1,512,512,512.00,0.00,9774,9775
12978,1,512,512,512.00,0.00,9774,9775
12979,2,258,254,256.00,4.00,9774,9776
12980,1,512,512,512.00,0.00,9775,9776
12981,1,512,512,512.00,0.00,9775,9776
12982,3,481,4,170.67,48241.56,9775,9778
12983,2,273,239,256.00,289.00,9777,9779
12984,3,393,7,170.67,26553.56,9778,9781
12985,1,512,512,512.00,0.00,9780,9781
12986,1,512,512,512.00,0.00,9780,9781
12987,2,316,196,256.00,3600.00,9780,9782
12988,1,512,512,512.00,0.00,9781,9782
12989,1,512,512,512.00,0.00,9781,9782
12990,2,494,18,256.00,56644.00,9781,9783
12991,1,512,512,512.00,0.00,9782,9783
12992,2,441,71,256.00,34225.00,9782,9784
12993,4,397,26,128.00,24232.50,9783,9787
12994,2,308,204,256.00,2704.00,9786,9788
12995,3,380,6,170.67,24310.22,9787,9790
12996,1,512,512,512.00,0.00,9789,9790
12997,1,512,512,512.00,0.00,9789,9790
12998,2,425,87,256.00,28561.00,9789,9791
12999,4,337,7,128.00,17348.50,9790,9794
13000,3,444,31,170.67,37361.56,9793,9796
13001,1,512,512,512.00,0.00,9795,9796
13002,1,512,512,512.00,0.00,9795,9796
13003,3,387,9,170.67,25308.22,9795,9798
13004,1,512,512,512.00,0.00,9797,9798
13005,1,512,512,512.00,0.00,9797,9798
13006,3,251,36,170.67,9180.22,9797,9800
13007,2,270,242,256.00,196.00,9799,9801
13008,1,512,512,512.00,0.00,9800,9801
13009,1,512,512,512.00,0.00,9800,9801
13010,3,182,152,170.67,176.89,9800,9803
13011,2,277,235,256.00,441.00,9802,9804
13012,3,243,46,170.67,7837.56,9803,9806
13013,2,380,132,256.00,15376.00,9805,9807
13014,3,197,151,170.67,374.89,9806,9809
13015,1,512,512,512.00,0.00,9808,9809
13016,1,512,512,512.00,0.00,9808,9809
13017,1,512,512,512.00,0.00,9808,9809
13018,5,288,4,102.40,14379.44,9808,9813
13019,1,512,512,512.00,0.00,9812,9813
13020,1,512,512,512.00,0.00,9812,9813
13021,1,512,512,512.00,0.00,9812,9813
13022,3,222,68,170.67,5270.22,9812,9815
13023,5,472,1,102.40,34294.24,9814,9819
13024,2,453,59,256.00,38809.00,9818,9820
13025,1,512,512,512.00,0.00,9819,9820
13026,1,512,512,512.00,0.00,9819,9820
13027,2,324,188,256.00,4624.00,9819,9821
13028,1,512,512,512.00,0.00,9820,9821
13029,1,512,512,512.00,0.00,9820,9821
13030,1,512,512,512.00,0.00,9820,9821
13031,1,512,512,512.00,0.00,9820,9821
13032,1,512,512,512.00,0.00,9820,9821
13033,4,334,12,128.00,15035.50,9820,9824
13034,1,512,512,512.00,0.00,9823,9824
13035,3,310,1,170.67,16373.56,9823,9826
13036,2,380,132,256.00,15376.00,9825,9827
13037,1,512,512,512.00,0.00,9826,9827
13038,1,512,512,512.00,0.00,9826,9827
13039,3,389,11,170.67,25534.89,9826,9829
13040,1,512,512,512.00,0.00,9828,9829
13041,4,284,28,128.00,11088.50,9828,9832
13042,4,457,4,128.00,36178.50,9831,9835
13043,1,512,512,512.00,0.00,9834,9835
13044,1,512,512,512.00,0.00,9834,9835
13045,1,512,512,512.00,0.00,9834,9835
13046,2,303,209,256.00,2209.00,9834,9836
13047,1,512,512,512.00,0.00,9835,9836
13048,1,512,512,512.00,0.00,9835,9836
13049,1,512,512,512.00,0.00,9835,9836
13050,1,512,512,512.00,0.00,9835,9836
13051,3,291,16,170.67,13193.56,9835,9838
13052,1,512,512,512.00,0.00,9837,9838
13053,1,512,512,512.00,0.00,9837,9838
13054,1,512,512,512.00,0.00,9837,9838
13055,1,512,512,512.00,0.00,9837,9838
13056,2,291,221,256.00,1225.00,9837,9839
13057,1,512,512,512.00,0.00,9838,9839
13058,1,512,512,512.00,0.00,9838,9839
13059,2,332,180,256.00,5776.00,9838,9840
13060,1,512,512,512.00,0.00,9839,9840
13061,3,326,81,170.67,12160.22,9839,9842
13062,3,441,6,170.67,37120.22,9841,9844
13063,1,512,512,512.00,0.00,9843,9844
13064,5,218,21,102.40,5898.64,9843,9848
13065,1,512,512,512.00,0.00,9847,9848
13066,1,512,512,512.00,0.00,9847,9848
13067,3,300,57,170.67,9964.22,9847,9850
13068,1,512,512,512.00,0.00,9849,9850
13069,1,512,512,512.00,0.00,9849,9850
13070,1,512,512,512.00,0.00,9849,9850
13071,2,428,84,256.00,29584.00,9849,9851
13072,1,512,512,512.00,0.00,9850,9851
13073,2,307,205,256.00,2601.00,9850,9852
13074,3,379,53,170.67,21822.89,9851,9854
13075,4,177,6,128.00,5008.50,9853,9857
13076,2,339,173,256.00,6889.00,9856,9858
13077,1,512,512,512.00,0.00,9857,9858
13078,1,512,512,512.00,0.00,9857,9858
13079,5,292,5,102.40,10146.64,9857,9862
13080,3,246,75,170.67,5080.22,9861,9864
13081,1,512,512,512.00,0.00,9863,9864
13082,6,218,1,85.33,9024.89,9863,9869
13083,2,302,210,256.00,2116.00,9868,9870
13084,5,323,1,102.40,14135.44,9869,9874
13085,2,469,43,256.00,45369.00,9873,9875
13086,2,328,184,256.00,5184.00,9874,9876
13087,1,512,512,512.00,0.00,9875,9876
13088,1,512,512,512.00,0.00,9875,9876
13089,1,512,512,512.00,0.00,9875,9876
13090,2,331,181,256.00,5625.00,9875,9877
13091,4,341,17,128.00,16781.00,9876,9880
13092,1,512,512,512.00,0.00,9879,9880
13093,1,512,512,512.00,0.00,9879,9880
13094,2,417,95,256.00,25921.00,9879,9881
13095,3,431,7,170.67,34634.89,9880,9883
13096,2,392,120,256.00,18496.00,9882,9884
13097,1,512,512,512.00,0.00,9883,9884
13098,4,197,61,128.00,3035.00,9883,9887
13099,1,512,512,512.00,0.00,9886,9887
13100,1,512,512,512.00,0.00,9886,9887
13101,2,473,39,256.00,47089.00,9886,9888
13102,1,512,512,512.00,0.00,9887,9888
13103,5,155,17,102.40,2778.64,9887,9892
13104,1,512,512,512.00,0.00,9891,9892
13105,3,255,98,170.67,4176.22,9891,9894
13106,1,512,512,512.00,0.00,9893,9894
13107,1,512,512,512.00,0.00,9893,9894
13108,1,512,512,512.00,0.00,9893,9894
13109,7,328,2,73.14,11465.84,9893,9900
13110,2,333,179,256.00,5929.00,9899,9901
13111,1,512,512,512.00,0.00,9900,9901
13112,1,512,512,512.00,0.00,9900,9901
13113,7,274,1,73.14,7485.84,9900,9907
13114,1,512,512,512.00,0.00,9906,9907
13115,1,512,512,512.00,0.00,9906,9907
13116,3,273,9,170.67,13376.22,9906,9909
13117,1,512,512,512.00,0.00,9908,9909
13118,2,296,216,256.00,1600.00,9908,9910
13119,1,512,512,512.00,0.00,9909,9910
13120,1,512,512,512.00,0.00,9909,9910
13121,1,512,512,512.00,0.00,9909,9910
13122,3,335,12,170.67,17404.22,9909,9912
13123,2,472,40,256.00,46656.00,9911,9913
13124,3,472,13,170.67,45433.56,9912,9915
13125,4,258,13,128.00,13019.50,9914,9918
13126,1,512,512,512.00,0.00,9917,9918
13127,2,454,58,256.00,39204.00,9917,9919
13128,4,321,2,128.00,14095.50,9918,9922
13129,2,457,55,256.00,40401.00,9921,9923
13130,2,325,187,256.00,4761.00,9922,9924
13131,1,512,512,512.00,0.00,9923,9924
13132,1,512,512,512.00,0.00,9923,9924
13133,1,512,512,512.00,0.00,9923,9924
13134,9,162,1,56.89,3875.65,9923,9932
13135,1,512,512,512.00,0.00,9931,9932
13136,1,512,512,512.00,0.00,9931,9932
13137,1,512,512,512.00,0.00,9931,9932
13138,2,278,234,256.00,484.00,9931,9933
13139,1,512,512,512.00,0.00,9932,9933
13140,1,512,512,512.00,0.00,9932,9933
13141,3,359,9,170.67,20772.22,9932,9935
13142,1,512,512,512.00,0.00,9934,9935
13143,3,410,8,170.67,29872.89,9934,9937
13144,1,512,512,512.00,0.00,9936,9937
13145,5,165,2,102.40,3535.04,9936,9941
13146,3,319,7,170.67,16341.56,9940,9943
13147,3,308,95,170.67,9462.89,9942,9945
13148,3,260,29,170.67,10262.89,9944,9947
13149,5,316,12,102.40,13004.24,9946,9951
13150,2,365,147,256.00,11881.00,9950,9952
13151,1,512,512,512.00,0.00,9951,9952
13152,4,282,53,128.00,8143.50,9951,9955
13153,3,468,1,170.67,44497.56,9954,9957
13154,3,216,140,170.67,1070.22,9956,9959
13155,2,463,49,256.00,42849.00,9958,9960
13156,3,217,108,170.67,2113.56,9959,9962
13157,1,512,512,512.00,0.00,9961,9962
13158,1,512,512,512.00,0.00,9961,9962
13159,4,205,85,128.00,2089.00,9961,9965
13160,1,512,512,512.00,0.00,9964,9965
13161,4,449,3,128.00,34710.50,9964,9968
13162,1,512,512,512.00,0.00,9967,9968
13163,3,299,56,170.67,9934.89,9967,9970
13164,1,512,512,512.00,0.00,9969,9970
13165,1,512,512,512.00,0.00,9969,9970
13166,1,512,512,512.00,0.00,9969,9970
13167,2,345,167,256.00,7921.00,9969,9971
13168,2,337,175,256.00,6561.00,9970,9972
13169,1,512,512,512.00,0.00,9971,9972
13170,1,512,512,512.00,0.00,9971,9972
13171,3,318,75,170.67,11176.22,9971,9974
13172,1,512,512,512.00,0.00,9973,9974
13173,1,512,512,512.00,0.00,9973,9974
13174,1,512,512,512.00,0.00,9973,9974
13175,1,512,512,512.00,0.00,9973,9974
13176,1,512,512,512.00,0.00,9973,9974
13177,1,512,512,512.00,0.00,9973,9974
13178,1,512,512,512.00,0.00,9973,9974
13179,1,512,512,512.00,0.00,9973,9974
13180,1,512,512,512.00,0.00,9973,9974
13181,4,185,72,128.00,3081.50,9973,9977
13182,1,512,512,512.00,0.00,9976,9977
13183,1,512,512,512.00,0.00,9976,9977
13184,2,316,196,256.00,3600.00,9976,9978
13185,2,312,200,256.00,3136.00,9977,9979
13186,1,512,512,512.00,0.00,9978,9979
13187,1,512,512,512.00,0.00,9978,9979
13188,1,512,512,512.00,0.00,9978,9979
13189,1,512,512,512.00,0.00,9978,9979
13190,1,512,512,512.00,0.00,9978,9979
13191,1,512,512,512.00,0.00,9978,9979
13192,2,480,32,256.00,50176.00,9978,9980
13193,1,512,512,512.00,0.00,9979,9980
13194,2,337,175,256.00,6561.00,9979,9981
13195,2,335,177,256.00,6241.00,9980,9982
13196,1,512,512,512.00,0.00,9981,9982
13197,2,338,174,256.00,6724.00,9981,9983
13198,2,418,94,256.00,26244.00,9982,9984
13199,1,512,512,512.00,0.00,9983,9984
13200,2,325,187,256.00,4761.00,9983,9985
13201,3,342,75,170.67,14744.22,9984,9987
13202,1,512,512,512.00,0.00,9986,9987
13203,1,512,512,512.00,0.00,9986,9987
13204,1,512,512,512.00,0.00,9986,9987
13205,3,297,77,170.67,8600.22,9986,9989
13206,1,512,512,512.00,0.00,9988,9989
13207,2,340,172,256.00,7056.00,9988,9990
13208,2,367,145,256.00,12321.00,9989,9991
13209,1,512,512,512.00,0.00,9990,9991
13210,3,293,94,170.67,7642.89,9990,9993
13211,6,159,1,85.33,4423.89,9992,9998
13212,10,210,1,51.20,6061.36,9997,10007
13213,4,372,5,128.00,20706.50,10006,10010
13214,1,512,512,512.00,0.00,10009,10010
13215,1,512,512,512.00,0.00,10009,10010
13216,1,512,512,512.00,0.00,10009,10010
13217,1,512,512,512.00,0.00,10009,10010
13218,1,512,512,512.00,0.00,10009,10010
13219,2,411,101,256.00,24025.00,10009,10011
13220,2,288,224,256.00,1024.00,10010,10012
13221,1,512,512,512.00,0.00,10011,10012
13222,1,512,512,512.00,0.00,10011,10012
13223,5,315,6,102.40,12803.44,10011,10016
13224,2,500,12,256.00,59536.00,10015,10017
13225,2,320,192,256.00,4096.00,10016,10018
13226,2,305,207,256.00,2401.00,10017,10019
13227,3,461,13,170.67,42250.89,10018,10021
13228,7,327,4,73.14,11381.55,10020,10027
13229,3,477,9,170.67,46968.22,10026,10029
13230,1,512,512,512.00,0.00,10028,10029
13231,2,395,117,256.00,19321.00,10028,10030
13232,1,512,512,512.00,0.00,10029,10030
13233,1,512,512,512.00,0.00,10029,10030
13234,1,512,512,512.00,0.00,10029,10030
13235,6,307,3,85.33,11240.56,10029,10035
13236,2,369,143,256.00,12769.00,10034,10036
13237,4,337,1,128.00,15865.00,10035,10039
13238,1,512,512,512.00,0.00,10038,10039
13239,1,512,512,512.00,0.00,10038,10039
13240,3,432,30,170.67,34214.22,10038,10041
13241,1,512,512,512.00,0.00,10040,10041
13242,1,512,512,512.00,0.00,10040,10041
13243,1,512,512,512.00,0.00,10040,10041
13244,1,512,512,512.00,0.00,10040,10041
13245,1,512,512,512.00,0.00,10040,10041
13246,1,512,512,512.00,0.00,10040,10041
13247,1,512,512,512.00,0.00,10040,10041
13248,9,296,3,56.89,7986.10,10040,10049
13249,2,499,13,256.00,59049.00,10048,10050
13250,1,512,512,512.00,0.00,10049,10050
13251,5,207,2,102.40,6106.64,10049,10054
13252,1,512,512,512.00,0.00,10053,10054
13253,1,512,512,512.00,0.00,10053,10054
13254,2,507,5,256.00,63001.00,10053,10055
13255,3,299,80,170.67,8702.89,10054,10057
13256,1,512,512,512.00,0.00,10056,10057
13257,2,273,239,256.00,289.00,10056,10058
13258,5,225,1,102.40,5562.24,10057,10062
13259,1,512,512,512.00,0.00,10061,10062
13260,1,512,512,512.00,0.00,10061,10062
13261,3,375,43,170.67,21309.56,10061,10064
13262,1,512,512,512.00,0.00,10063,10064
13263,2,478,34,256.00,49284.00,10063,10065
13264,1,512,512,512.00,0.00,10064,10065
13265,1,512,512,512.00,0.00,10064,10065
13266,1,512,512,512.00,0.00,10064,10065
13267,5,409,8,102.40,23602.64,10064,10069
13268,2,273,239,256.00,289.00,10068,10070
13269,2,318,194,256.00,3844.00,10069,10071
13270,3,247,112,170.67,3193.56,10070,10073
13271,2,429,83,256.00,29929.00,10072,10074
13272,4,368,1,128.00,20931.50,10073,10077
13273,1,512,512,512.00,0.00,10076,10077
13274,2,499,13,256.00,59049.00,10076,10078
13275,2,489,23,256.00,54289.00,10077,10079
13276,1,512,512,512.00,0.00,10078,10079
13277,2,388,124,256.00,17424.00,10078,10080
13278,3,263,76,170.67,5830.89,10079,10082
13279,5,323,17,102.40,12691.04,10081,10086
13280,3,456,6,170.67,41030.22,10085,10088
13281,2,494,18,256.00,56644.00,10087,10089
13282,1,512,512,512.00,0.00,10088,10089
13283,1,512,512,512.00,0.00,10088,10089
13284,1,512,512,512.00,0.00,10088,10089
13285,5,227,3,102.40,7259.84,10088,10093
13286,1,512,512,512.00,0.00,10092,10093
13287,3,447,12,170.67,38460.22,10092,10095
13288,3,289,90,170.67,7309.56,10094,10097
13289,1,512,512,512.00,0.00,10096,10097
13290,6,205,3,85.33,6362.56,10096,10102
13291,1,512,512,512.00,0.00,10101,10102
13292,1,512,512,512.00,0.00,10101,10102
13293,2,271,241,256.00,225.00,10101,10103
13294,1,512,512,512.00,0.00,10102,10103
13295,1,512,512,512.00,0.00,10102,10103
13296,1,512,512,512.00,0.00,10102,10103
13297,2,468,44,256.00,44944.00,10102,10104
13298,1,512,512,512.00,0.00,10103,10104
13299,2,484,28,256.00,51984.00,10103,10105
13300,5,279,12,102.40,10409.44,10104,10109
13301,6,175,21,85.33,3548.89,10108,10114
13302,1,512,512,512.00,0.00,10113,10114
13303,1,512,512,512.00,0.00,10113,10114
13304,4,454,10,128.00,35518.50,10113,10117
13305,1,512,512,512.00,0.00,10116,10117
13306,1,512,512,512.00,0.00,10116,10117
13307,1,512,512,512.00,0.00,10116,10117
13308,1,512,512,512.00,0.00,10116,10117
13309,1,512,512,512.00,0.00,10116,10117
13310,1,512,512,512.00,0.00,10116,10117
13311,1,512,512,512.00,0.00,10116,10117
13312,1,512,512,512.00,0.00,10116,10117
13313,1,512,512,512.00,0.00,10116,10117
13314,1,512,512,512.00,0.00,10116,10117
13315,1,512,512,512.00,0.00,10116,10117
13316,2,308,204,256.00,2704.00,10116,10118
13317,1,512,512,512.00,0.00,10117,10118
13318,1,512,512,512.00,0.00,10117,10118
13319,1,512,512,512.00,0.00,10117,10118
13320,2,309,203,256.00,2809.00,10117,10119
13321,3,313,24,170.67,13929.56,10118,10121
13322,1,512,512,512.00,0.00,10120,10121
13323,1,512,512,512.00,0.00,10120,10121
13324,4,359,31,128.00,18301.50,10120,10124
13325,1,512,512,512.00,0.00,10123,10124
13326,2,259,253,256.00,9.00,10123,10125
13327,1,512,512,512.00,0.00,10124,10125
13328,1,512,512,512.00,0.00,10124,10125
13329,1,512,512,512.00,0.00,10124,10125
13330,1,512,512,512.00,0.00,10124,10125
13331,1,512,512,512.00,0.00,10124,10125
13332,2,314,198,256.00,3364.00,10124,10126
13333,1,512,512,512.00,0.00,10125,10126
13334,5,223,23,102.40,5904.64,10125,10130
13335,3,292,25,170.67,12177.56,10129,10132
13336,2,312,200,256.00,3136.00,10131,10133
13337,3,280,60,170.67,8067.56,10132,10135
13338,2,444,68,256.00,35344.00,10134,10136
13339,1,512,512,512.00,0.00,10135,10136
13340,3,216,140,170.67,1070.22,10135,10138
13341,1,512,512,512.00,0.00,10137,10138
13342,1,512,512,512.00,0.00,10137,10138
13343,1,512,512,512.00,0.00,10137,10138
13344,1,512,512,512.00,0.00,10137,10138
13345,1,512,512,512.00,0.00,10137,10138
13346,2,395,117,256.00,19321.00,10137,10139
13347,2,413,99,256.00,24649.00,10138,10140
13348,2,441,71,256.00,34225.00,10139,10141
13349,1,512,512,512.00,0.00,10140,10141
13350,1,512,512,512.00,0.00,10140,10141
13351,1,512,512,512.00,0.00,10140,10141
13352,2,348,164,256.00,8464.00,10140,10142
13353,4,151,86,128.00,624.50,10141,10145
13354,1,512,512,512.00,0.00,10144,10145
13355,1,512,512,512.00,0.00,10144,10145
13356,1,512,512,512.00,0.00,10144,10145
13357,1,512,512,512.00,0.00,10144,10145
13358,1,512,512,512.00,0.00,10144,10145
13359,1,512,512,512.00,0.00,10144,10145
13360,2,497,15,256.00,58081.00,10144,10146
13361,4,431,3,128.00,30827.00,10145,10149
13362,7,305,1,73.14,9722.12,10148,10155
13363,4,201,77,128.00,2187.50,10154,10158
13364,3,391,7,170.67,26181.56,10157,10160
13365,1,512,512,512.00,0.00,10159,10160
13366,1,512,512,512.00,0.00,10159,10160
13367,1,512,512,512.00,0.00,10159,10160
13368,7,258,4,73.14,8096.98,10159,10166
13369,1,512,512,512.00,0.00,10165,10166
13370,1,512,512,512.00,0.00,10165,10166
13371,1,512,512,512.00,0.00,10165,10166
13372,1,512,512,512.00,0.00,10165,10166
13373,1,512,512,512.00,0.00,10165,10166
13374,1,512,512,512.00,0.00,10165,10166
13375,3,425,19,170.67,32742.89,10165,10168
13376,1,512,512,512.00,0.00,10167,10168
13377,3,442,14,170.67,37104.89,10167,10170
13378,2,344,168,256.00,7744.00,10169,10171
13379,1,512,512,512.00,0.00,10170,10171
13380,3,468,10,170.67,44299.56,10170,10173
13381,1,512,512,512.00,0.00,10172,10173
13382,3,202,143,170.67,586.89,10172,10175
13383,1,512,512,512.00,0.00,10174,10175
13384,1,512,512,512.00,0.00,10174,10175
13385,1,512,512,512.00,0.00,10174,10175
13386,1,512,512,512.00,0.00,10174,10175
13387,3,287,6,170.67,14328.22,10174,10177
13388,2,305,207,256.00,2401.00,10176,10178
13389,3,387,2,170.67,25840.22,10177,10180
13390,3,405,1,170.67,29293.56,10179,10182
13391,2,368,144,256.00,12544.00,10181,10183
13392,1,512,512,512.00,0.00,10182,10183
13393,1,512,512,512.00,0.00,10182,10183
13394,2,504,8,256.00,61504.00,10182,10184
13395,1,512,512,512.00,0.00,10183,10184
13396,5,169,6,102.40,3683.84,10183,10188
13397,1,512,512,512.00,0.00,10187,10188
13398,1,512,512,512.00,0.00,10187,10188
13399,1,512,512,512.00,0.00,10187,10188
13400,2,401,111,256.00,21025.00,10187,10189
13401,1,512,512,512.00,0.00,10188,10189
13402,1,512,512,512.00,0.00,10188,10189
13403,1,512,512,512.00,0.00,10188,10189
13404,3,395,58,170.67,25162.89,10188,10191
13405,1,512,512,512.00,0.00,10190,10191
13406,1,512,512,512.00,0.00,10190,10191
13407,1,512,512,512.00,0.00,10190,10191
13408,2,483,29,256.00,51529.00,10190,10192
13409,1,512,512,512.00,0.00,10191,10192
13410,1,512,512,512.00,0.00,10191,10192
13411,6,322,2,85.33,12121.56,10191,10197
13412,2,427,85,256.00,29241.00,10196,10198
13413,1,512,512,512.00,0.00,10197,10198
13414,1,512,512,512.00,0.00,10197,10198
13415,1,512,512,512.00,0.00,10197,10198
13416,5,165,39,102.40,1657.44,10197,10202
13417,1,512,512,512.00,0.00,10201,10202
13418,1,512,512,512.00,0.00,10201,10202
13419,1,512,512,512.00,0.00,10201,10202
13420,1,512,512,512.00,0.00,10201,10202
13421,1,512,512,512.00,0.00,10201,10202
13422,2,347,165,256.00,8281.00,10201,10203
13423,3,465,1,170.67,43653.56,10202,10205
13424,1,512,512,512.00,0.00,10204,10205
13425,1,512,512,512.00,0.00,10204,10205
13426,1,512,512,512.00,0.00,10204,10205
13427,1,512,512,512.00,0.00,10204,10205
13428,1,512,512,512.00,0.00,10204,10205
13429,1,512,512,512.00,0.00,10204,10205
13430,1,512,512,512.00,0.00,10204,10205
13431,1,512,512,512.00,0.00,10204,10205
13432,1,512,512,512.00,0.00,10204,10205
13433,1,512,512,512.00,0.00,10204,10205
13434,3,264,1,170.67,14441.56,10204,10207
13435,3,290,101,170.67,7186.89,10206,10209
13436,6,193,4,85.33,4293.89,10208,10214
13437,2,292,220,256.00,1296.00,10213,10215
13438,1,512,512,512.00,0.00,10214,10215
13439,2,352,160,256.00,9216.00,10214,10216
13440,1,512,512,512.00,0.00,10215,10216
13441,2,313,199,256.00,3249.00,10215,10217
13442,2,459,53,256.00,41209.00,10216,10218
13443,7,206,11,73.14,3819.84,10217,10224
13444,5,236,24,102.40,6812.24,10223,10228
13445,2,462,50,256.00,42436.00,10227,10229
13446,1,512,512,512.00,0.00,10228,10229
13447,1,512,512,512.00,0.00,10228,10229
13448,2,281,231,256.00,625.00,10228,10230
13449,1,512,512,512.00,0.00,10229,10230
13450,1,512,512,512.00,0.00,10229,10230
13451,1,512,512,512.00,0.00,10229,10230
13452,1,512,512,512.00,0.00,10229,10230
13453,1,512,512,512.00,0.00,10229,10230
13454,1,512,512,512.00,0.00,10229,10230
13455,1,512,512,512.00,0.00,10229,10230
13456,1,512,512,512.00,0.00,10229,10230
13457,1,512,512,512.00,0.00,10229,10230
13458,1,512,512,512.00,0.00,10229,10230
13459,2,448,64,256.00,36864.00,10229,10231
13460,1,512,512,512.00,0.00,10230,10231
13461,1,512,512,512.00,0.00,10230,10231
13462,1,512,512,512.00,0.00,10230,10231
13463,3,209,97,170.67,2714.89,10230,10233
13464,2,382,130,256.00,15876.00,10232,10234
13465,3,379,11,170.67,23754.89,10233,10236
13466,1,512,512,512.00,0.00,10235,10236
13467,1,512,512,512.00,0.00,10235,10236
13468,1,512,512,512.00,0.00,10235,10236
13469,4,278,2,128.00,9930.50,10235,10239
13470,2,287,225,256.00,961.00,10238,10240
13471,1,512,512,512.00,0.00,10239,10240
13472,1,512,512,512.00,0.00,10239,10240
13473,4,200,61,128.00,2917.50,10239,10243
13474,5,224,6,102.40,6309.04,10242,10247
13475,2,363,149,256.00,11449.00,10246,10248
13476,4,239,53,128.00,4733.00,10247,10251
13477,1,512,512,512.00,0.00,10250,10251
13478,1,512,512,512.00,0.00,10250,10251
13479,2,431,81,256.00,30625.00,10250,10252
13480,4,478,3,128.00,40925.50,10251,10255
13481,2,499,13,256.00,59049.00,10254,10256
13482,1,512,512,512.00,0.00,10255,10256
13483,3,244,37,170.67,8961.56,10255,10258
13484,4,288,2,128.00,11865.50,10257,10261
13485,1,512,512,512.00,0.00,10260,10261
13486,1,512,512,512.00,0.00,10260,10261
13487,1,512,512,512.00,0.00,10260,10261
13488,2,483,29,256.00,51529.00,10260,10262
13489,1,512,512,512.00,0.00,10261,10262
13490,1,512,512,512.00,0.00,10261,10262
13491,4,338,3,128.00,16537.50,10261,10265
13492,1,512,512,512.00,0.00,10264,10265
13493,1,512,512,512.00,0.00,10264,10265
13494,1,512,512,512.00,0.00,10264,10265
13495,1,512,512,512.00,0.00,10264,10265
13496,1,512,512,512.00,0.00,10264,10265
13497,1,512,512,512.00,0.00,10264,10265
13498,2,464,48,256.00,43264.00,10264,10266
13499,5,343,13,102.40,15749.44,10265,10270
13500,1,512,512,512.00,0.00,10269,10270
13501,2,349,163,256.00,8649.00,10269,10271
13502,3,406,2,170.67,29424.89,10270,10273
13503,4,267,55,128.00,7045.00,10272,10276
13504,3,342,4,170.67,19051.56,10275,10278
13505,3,267,3,170.67,14160.22,10277,10280
13506,3,333,3,170.67,18164.22,10279,10282
13507,1,512,512,512.00,0.00,10281,10282
13508,1,512,512,512.00,0.00,10281,10282
13509,3,320,88,170.67,11192.89,10281,10284
13510,6,221,1,85.33,7040.22,10283,10289
13511,1,512,512,512.00,0.00,10288,10289
13512,1,512,512,512.00,0.00,10288,10289
13513,3,336,8,170.67,17934.22,10288,10291
13514,2,289,223,256.00,1089.00,10290,10292
13515,1,512,512,512.00,0.00,10291,10292
13516,1,512,512,512.00,0.00,10291,10292
13517,1,512,512,512.00,0.00,10291,10292
13518,1,512,512,512.00,0.00,10291,10292
13519,2,406,106,256.00,22500.00,10291,10293
13520,1,512,512,512.00,0.00,10292,10293
13521,7,201,1,73.14,5939.55,10292,10299
13522,6,496,2,85.33,33730.56,10298,10304
13523,1,512,512,512.00,0.00,10303,10304
13524,2,256,256,256.00,0.00,10303,10305
13525,4,303,5,128.00,15737.00,10304,10308
13526,3,352,14,170.67,19344.89,10307,10310
13527,3,332,8,170.67,17496.89,10309,10312
13528,1,512,512,512.00,0.00,10311,10312
13529,2,285,227,256.00,841.00,10311,10313
13530,1,512,512,512.00,0.00,10312,10313
13531,1,512,512,512.00,0.00,10312,10313
13532,1,512,512,512.00,0.00,10312,10313
13533,1,512,512,512.00,0.00,10312,10313
13534,1,512,512,512.00,0.00,10312,10313
13535,1,512,512,512.00,0.00,10312,10313
13536,1,512,512,512.00,0.00,10312,10313
13537,1,512,512,512.00,0.00,10312,10313
13538,1,512,512,512.00,0.00,10312,10313
13539,2,467,45,256.00,44521.00,10312,10314
13540,2,274,238,256.00,324.00,10313,10315
13541,4,362,3,128.00,20161.50,10314,10318
13542,2,464,48,256.00,43264.00,10317,10319
13543,1,512,512,512.00,0.00,10318,10319
13544,2,450,62,256.00,37636.00,10318,10320
13545,1,512,512,512.00,0.00,10319,10320
13546,1,512,512,512.00,0.00,10319,10320
13547,7,157,1,73.14,3774.41,10319,10326
13548,3,284,1,170.67,14934.89,10325,10328
13549,2,468,44,256.00,44944.00,10327,10329
13550,2,410,102,256.00,23716.00,10328,10330
13551,3,233,118,170.67,2250.89,10329,10332
13552,1,512,512,512.00,0.00,10331,10332
13553,1,512,512,512.00,0.00,10331,10332
13554,1,512,512,512.00,0.00,10331,10332
13555,1,512,512,512.00,0.00,10331,10332
13556,3,506,1,170.67,56226.89,10331,10334
13557,1,512,512,512.00,0.00,10333,10334
13558,1,512,512,512.00,0.00,10333,10334
13559,2,365,147,256.00,11881.00,10333,10335
13560,1,512,512,512.00,0.00,10334,10335
13561,3,327,72,170.67,12500.22,10334,10337
13562,1,512,512,512.00,0.00,10336,10337
13563,2,394,118,256.00,19044.00,10336,10338
13564,2,472,40,256.00,46656.00,10337,10339
13565,1,512,512,512.00,0.00,10338,10339
13566,1,512,512,512.00,0.00,10338,10339
13567,1,512,512,512.00,0.00,10338,10339
13568,1,512,512,512.00,0.00,10338,10339
13569,1,512,512,512.00,0.00,10338,10339
13570,4,191,15,128.00,5075.00,10338,10342
13571,3,307,2,170.67,16026.89,10341,10344
13572,1,512,512,512.00,0.00,10343,10344
13573,1,512,512,512.00,0.00,10343,10344
13574,2,500,12,256.00,59536.00,10343,10345
13575,1,512,512,512.00,0.00,10344,10345
13576,2,314,198,256.00,3364.00,10344,10346
13577,4,258,21,128.00,7174.50,10345,10349
13578,1,512,512,512.00,0.00,10348,10349
13579,2,409,103,256.00,23409.00,10348,10350
13580,1,512,512,512.00,0.00,10349,10350
13581,5,206,15,102.40,5080.64,10349,10354
13582,4,423,12,128.00,29170.50,10353,10357
13583,3,314,41,170.67,12514.89,10356,10359
13584,1,512,512,512.00,0.00,10358,10359
13585,2,319,193,256.00,3969.00,10358,10360
13586,6,299,18,85.33,9643.56,10359,10365
13587,4,350,5,128.00,20029.50,10364,10368
13588,1,512,512,512.00,0.00,10367,10368
13589,1,512,512,512.00,0.00,10367,10368
13590,1,512,512,512.00,0.00,10367,10368
13591,1,512,512,512.00,0.00,10367,10368
13592,3,238,93,170.67,3557.56,10367,10370
13593,1,512,512,512.00,0.00,10369,10370
13594,5,156,14,102.40,2408.24,10369,10374
13595,3,255,53,170.67,7356.22,10373,10376
13596,1,512,512,512.00,0.00,10375,10376
13597,2,297,215,256.00,1681.00,10375,10377
13598,1,512,512,512.00,0.00,10376,10377
13599,1,512,512,512.00,0.00,10376,10377
13600,1,512,512,512.00,0.00,10376,10377
13601,1,512,512,512.00,0.00,10376,10377
13602,4,276,1,128.00,15891.50,10376,10380
13603,1,512,512,512.00,0.00,10379,10380
13604,1,512,512,512.00,0.00,10379,10380
13605,1,512,512,512.00,0.00,10379,10380
13606,1,512,512,512.00,0.00,10379,10380
13607,1,512,512,512.00,0.00,10379,10380
13608,3,428,35,170.67,33142.89,10379,10382
13609,2,449,63,256.00,37249.00,10381,10383
13610,1,512,512,512.00,0.00,10382,10383
13611,1,512,512,512.00,0.00,10382,10383
13612,2,384,128,256.00,16384.00,10382,10384
13613,4,334,4,128.00,17674.00,10383,10387
13614,2,409,103,256.00,23409.00,10386,10388
13615,1,512,512,512.00,0.00,10387,10388
13616,2,410,102,256.00,23716.00,10387,10389
13617,2,334,178,256.00,6084.00,10388,10390
13618,3,270,93,170.67,5456.22,10389,10392
13619,1,512,512,512.00,0.00,10391,10392
13620,4,302,2,128.00,16926.50,10391,10395
13621,1,512,512,512.00,0.00,10394,10395
13622,1,512,512,512.00,0.00,10394,10395
13623,1,512,512,512.00,0.00,10394,10395
13624,1,512,512,512.00,0.00,10394,10395
13625,1,512,512,512.00,0.00,10394,10395
13626,3,355,2,170.67,20890.89,10394,10397
13627,1,512,512,512.00,0.00,10396,10397
13628,1,512,512,512.00,0.00,10396,10397
13629,1,512,512,512.00,0.00,10396,10397
13630,4,342,52,128.00,15274.00,10396,10400
13631,1,512,512,512.00,0.00,10399,10400
13632,3,442,34,170.67,36811.56,10399,10402
13633,3,462,3,170.67,42760.22,10401,10404
13634,2,371,141,256.00,13225.00,10403,10405
13635,3,339,2,170.67,18928.22,10404,10407
13636,1,512,512,512.00,0.00,10406,10407
13637,1,512,512,512.00,0.00,10406,10407
13638,1,512,512,512.00,0.00,10406,10407
13639,1,512,512,512.00,0.00,10406,10407
13640,1,512,512,512.00,0.00,10406,10407
13641,2,311,201,256.00,3025.00,10406,10408
13642,1,512,512,512.00,0.00,10407,10408
13643,1,512,512,512.00,0.00,10407,10408
13644,1,512,512,512.00,0.00,10407,10408
13645,1,512,512,512.00,0.00,10407,10408
13646,1,512,512,512.00,0.00,10407,10408
13647,4,347,3,128.00,19313.00,10407,10411
13648,6,250,1,85.33,10652.89,10410,10416
13649,3,303,6,170.67,15224.22,10415,10418
13650,2,401,111,256.00,21025.00,10417,10419
13651,1,512,512,512.00,0.00,10418,10419
13652,1,512,512,512.00,0.00,10418,10419
13653,3,293,83,170.67,7950.89,10418,10421
13654,1,512,512,512.00,0.00,10420,10421
13655,1,512,512,512.00,0.00,10420,10421
13656,2,316,196,256.00,3600.00,10420,10422
13657,1,512,512,512.00,0.00,10421,10422
13658,1,512,512,512.00,0.00,10421,10422
13659,3,427,38,170.67,32866.89,10421,10424
13660,1,512,512,512.00,0.00,10423,10424
13661,1,512,512,512.00,0.00,10423,10424
13662,6,252,15,85.33,6936.56,10423,10429
13663,5,404,3,102.40,22964.24,10429,10434
13664,3,231,126,170.67,1960.22,10433,10436
13665,1,512,512,512.00,0.00,10435,10436
13666,3,294,102,170.67,7638.22,10435,10438
13667,1,512,512,512.00,0.00,10437,10438
13668,1,512,512,512.00,0.00,10437,10438
13669,2,496,16,256.00,57600.00,10437,10439
13670,2,391,121,256.00,18225.00,10438,10440
13671,1,512,512,512.00,0.00,10439,10440
13672,1,512,512,512.00,0.00,10439,10440
13673,1,512,512,512.00,0.00,10439,10440
13674,1,512,512,512.00,0.00,10439,10440
13675,1,512,512,512.00,0.00,10439,10440
13676,1,512,512,512.00,0.00,10439,10440
13677,4,334,2,128.00,18906.00,10439,10443
13678,1,512,512,512.00,0.00,10442,10443
13679,1,512,512,512.00,0.00,10442,10443
13680,1,512,512,512.00,0.00,10442,10443
13681,4,315,1,128.00,17009.00,10442,10446
13682,1,512,512,512.00,0.00,10445,10446
13683,1,512,512,512.00,0.00,10445,10446
13684,1,512,512,512.00,0.00,10445,10446
13685,2,428,84,256.00,29584.00,10445,10447
13686,4,229,50,128.00,4878.50,10446,10450
13687,1,512,512,512.00,0.00,10449,10450
13688,5,264,2,102.40,10918.64,10449,10454
13689,1,512,512,512.00,0.00,10453,10454
13690,2,342,170,256.00,7396.00,10453,10455
13691,1,512,512,512.00,0.00,10454,10455
13692,3,372,21,170.67,21868.22,10454,10457
13693,4,314,9,128.00,14128.50,10456,10460
13694,3,292,10,170.67,14027.56,10459,10462
13695,1,512,512,512.00,0.00,10461,10462
13696,1,512,512,512.00,0.00,10461,10462
13697,1,512,512,512.00,0.00,10461,10462
13698,1,512,512,512.00,0.00,10461,10462
13699,1,512,512,512.00,0.00,10461,10462
13700,1,512,512,512.00,0.00,10461,10462
13701,1,512,512,512.00,0.00,10461,10462
13702,3,250,56,170.67,6896.89,10461,10464
13703,1,512,512,512.00,0.00,10463,10464
13704,1,512,512,512.00,0.00,10463,10464
13705,1,512,512,512.00,0.00,10463,10464
13706,3,233,112,170.67,2446.89,10463,10466
13707,1,512,512,512.00,0.00,10465,10466
13708,3,246,112,170.67,3131.56,10465,10468
13709,1,512,512,512.00,0.00,10467,10468
13710,3,374,3,170.67,23576.22,10467,10470
13711,3,310,26,170.67,13456.89,10469,10472
13712,1,512,512,512.00,0.00,10471,10472
13713,1,512,512,512.00,0.00,10471,10472
13714,1,512,512,512.00,0.00,10471,10472
13715,1,512,512,512.00,0.00,10471,10472
13716,4,259,1,128.00,10124.50,10471,10475
13717,1,512,512,512.00,0.00,10474,10475
13718,2,293,219,256.00,1369.00,10474,10476
13719,2,464,48,256.00,43264.00,10475,10477
13720,1,512,512,512.00,0.00,10476,10477
13721,2,368,144,256.00,12544.00,10476,10478
13722,1,512,512,512.00,0.00,10477,10478
13723,2,396,116,256.00,19600.00,10477,10479
13724,2,263,249,256.00,49.00,10478,10480
13725,5,487,2,102.40,37010.64,10479,10484
13726,2,497,15,256.00,58081.00,10483,10485
13727,1,512,512,512.00,0.00,10484,10485
13728,2,509,3,256.00,64009.00,10484,10486
13729,1,512,512,512.00,0.00,10485,10486
13730,3,290,92,170.67,7360.89,10485,10488
13731,4,277,1,128.00,14643.00,10487,10491
13732,1,512,512,512.00,0.00,10490,10491
13733,1,512,512,512.00,0.00,10490,10491
13734,1,512,512,512.00,0.00,10490,10491
13735,2,331,181,256.00,5625.00,10490,10492
13736,1,512,512,512.00,0.00,10491,10492
13737,2,271,241,256.00,225.00,10491,10493
13738,1,512,512,512.00,0.00,10492,10493
13739,1,512,512,512.00,0.00,10492,10493
13740,1,512,512,512.00,0.00,10492,10493
13741,3,346,54,170.67,15931.56,10492,10495
13742,4,153,102,128.00,556.50,10494,10498
13743,2,320,192,256.00,4096.00,10497,10499
13744,3,310,87,170.67,9837.56,10498,10501
13745,1,512,512,512.00,0.00,10500,10501
13746,5,265,16,102.40,8142.64,10500,10505
13747,2,287,225,256.00,961.00,10504,10506
13748,2,297,215,256.00,1681.00,10505,10507
13749,2,423,89,256.00,27889.00,10506,10508
13750,1,512,512,512.00,0.00,10507,10508
13751,5,252,1,102.40,9250.64,10507,10512
13752,1,512,512,512.00,0.00,10511,10512
13753,1,512,512,512.00,0.00,10511,10512
13754,1,512,512,512.00,0.00,10511,10512
13755,2,351,161,256.00,9025.00,10511,10513
13756,1,512,512,512.00,0.00,10512,10513
13757,3,357,50,170.67,17864.22,10512,10515
13758,1,512,512,512.00,0.00,10514,10515
13759,1,512,512,512.00,0.00,10514,10515
13760,1,512,512,512.00,0.00,10514,10515
13761,1,512,512,512.00,0.00,10514,10515
13762,2,485,27,256.00,52441.00,10514,10516
13763,1,512,512,512.00,0.00,10515,10516
13764,1,512,512,512.00,0.00,10515,10516
13765,1,512,512,512.00,0.00,10515,10516
13766,3,300,30,170.67,12214.22,10515,10518
13767,3,296,30,170.67,11910.22,10517,10520
13768,2,452,60,256.00,38416.00,10519,10521
13769,3,307,26,170.67,13194.89,10520,10523
13770,1,512,512,512.00,0.00,10522,10523
13771,2,431,81,256.00,30625.00,10522,10524
13772,1,512,512,512.00,0.00,10523,10524
13773,1,512,512,512.00,0.00,10523,10524
13774,2,496,16,256.00,57600.00,10523,10525
13775,1,512,512,512.00,0.00,10524,10525
13776,4,418,2,128.00,29280.50,10524,10528
13777,1,512,512,512.00,0.00,10527,10528
13778,1,512,512,512.00,0.00,10527,10528
13779,2,415,97,256.00,25281.00,10527,10529
13780,1,512,512,512.00,0.00,10528,10529
13781,1,512,512,512.00,0.00,10528,10529
13782,1,512,512,512.00,0.00,10528,10529
13783,1,512,512,512.00,0.00,10528,10529
13784,2,366,146,256.00,12100.00,10528,10530
13785,1,512,512,512.00,0.00,10529,10530
13786,1,512,512,512.00,0.00,10529,10530
13787,1,512,512,512.00,0.00,10529,10530
13788,2,264,248,256.00,64.00,10529,10531
13789,3,496,8,170.67,52920.89,10530,10533
13790,4,363,42,128.00,18496.50,10532,10536
13791,1,512,512,512.00,0.00,10535,10536
13792,3,267,25,170.67,10977.56,10535,10538
13793,1,512,512,512.00,0.00,10537,10538
13794,1,512,512,512.00,0.00,10537,10538
13795,3,485,6,170.67,49440.22,10537,10540
13796,1,512,512,512.00,0.00,10539,10540
13797,1,512,512,512.00,0.00,10539,10540
13798,1,512,512,512.00,0.00,10539,10540
13799,6,172,1,85.33,3611.89,10539,10545
13800,1,512,512,512.00,0.00,10544,10545
13801,1,512,512,512.00,0.00,10544,10545
13802,4,246,1,128.00,9938.50,10544,10548
13803,1,512,512,512.00,0.00,10547,10548
13804,1,512,512,512.00,0.00,10547,10548
13805,2,295,217,256.00,1521.00,10547,10549
13806,1,512,512,512.00,0.00,10548,10549
13807,1,512,512,512.00,0.00,10548,10549
13808,1,512,512,512.00,0.00,10548,10549
13809,1,512,512,512.00,0.00,10548,10549
13810,2,273,239,256.00,289.00,10548,10550
13811,3,357,63,170.67,17500.22,10549,10552
13812,1,512,512,512.00,0.00,10551,10552
13813,1,512,512,512.00,0.00,10551,10552
13814,4,409,5,128.00,27443.00,10551,10555
13815,2,503,9,256.00,61009.00,10554,10556
13816,1,512,512,512.00,0.00,10555,10556
13817,1,512,512,512.00,0.00,10555,10556
13818,1,512,512,512.00,0.00,10555,10556
13819,5,171,4,102.40,4421.84,10555,10560
13820,5,203,16,102.40,6433.84,10559,10564
13821,2,265,247,256.00,81.00,10563,10565
13822,2,373,139,256.00,13689.00,10564,10566
13823,1,512,512,512.00,0.00,10565,10566
13824,2,300,212,256.00,1936.00,10565,10567
13825,1,512,512,512.00,0.00,10566,10567
13826,3,264,95,170.67,4916.22,10566,10569
13827,1,512,512,512.00,0.00,10568,10569
13828,3,407,18,170.67,28720.22,10568,10571
13829,1,512,512,512.00,0.00,10570,10571
13830,2,308,204,256.00,2704.00,10570,10572
13831,1,512,512,512.00,0.00,10571,10572
13832,1,512,512,512.00,0.00,10571,10572
13833,8,405,1,64.00,16945.25,10571,10579
13834,1,512,512,512.00,0.00,10578,10579
13835,1,512,512,512.00,0.00,10578,10579
13836,1,512,512,512.00,0.00,10578,10579
13837,1,512,512,512.00,0.00,10578,10579
13838,4,477,3,128.00,40713.00,10578,10582
13839,1,512,512,512.00,0.00,10581,10582
13840,1,512,512,512.00,0.00,10581,10582
13841,2,399,113,256.00,20449.00,10581,10583
13842,3,397,1,170.67,27741.56,10582,10585
13843,2,468,44,256.00,44944.00,10584,10586
13844,4,202,15,128.00,5786.50,10585,10589
13845,1,512,512,512.00,0.00,10588,10589
13846,1,512,512,512.00,0.00,10588,10589
13847,1,512,512,512.00,0.00,10588,10589
13848,4,346,20,128.00,16394.00,10588,10592
13849,1,512,512,512.00,0.00,10591,10592
13850,2,289,223,256.00,1089.00,10591,10593
13851,3,357,67,170.67,17433.56,10592,10595
13852,4,308,1,128.00,15969.50,10594,10598
13853,4,241,6,128.00,9698.50,10597,10601
13854,2,437,75,256.00,32761.00,10600,10602
13855,1,512,512,512.00,0.00,10601,10602
13856,1,512,512,512.00,0.00,10601,10602
13857,2,404,108,256.00,21904.00,10601,10603
13858,1,512,512,512.00,0.00,10602,10603
13859,2,423,89,256.00,27889.00,10602,10604
13860,2,379,133,256.00,15129.00,10603,10605
13861,2,397,115,256.00,19881.00,10604,10606
13862,1,512,512,512.00,0.00,10605,10606
13863,1,512,512,512.00,0.00,10605,10606
13864,1,512,512,512.00,0.00,10605,10606
13865,1,512,512,512.00,0.00,10605,10606
13866,2,416,96,256.00,25600.00,10605,10607
13867,2,314,198,256.00,3364.00,10606,10608
13868,1,512,512,512.00,0.00,10607,10608
13869,1,512,512,512.00,0.00,10607,10608
13870,1,512,512,512.00,0.00,10607,10608
13871,2,493,19,256.00,56169.00,10607,10609
13872,1,512,512,512.00,0.00,10608,10609
13873,2,461,51,256.00,42025.00,10608,10610
13874,1,512,512,512.00,0.00,10609,10610
13875,1,512,512,512.00,0.00,10609,10610
13876,1,512,512,512.00,0.00,10609,10610
13877,1,512,512,512.00,0.00,10609,10610
13878,3,356,9,170.67,20348.22,10609,10612
13879,1,512,512,512.00,0.00,10611,10612
13880,2,399,113,256.00,20449.00,10611,10613
13881,1,512,512,512.00,0.00,10612,10613
13882,1,512,512,512.00,0.00,10612,10613
13883,2,359,153,256.00,10609.00,10612,10614
13884,2,356,156,256.00,10000.00,10613,10615
13885,2,262,250,256.00,36.00,10614,10616
13886,1,512,512,512.00,0.00,10615,10616
13887,2,297,215,256.00,1681.00,10615,10617
13888,1,512,512,512.00,0.00,10616,10617
13889,1,512,512,512.00,0.00,10616,10617
13890,1,512,512,512.00,0.00,10616,10617
13891,1,512,512,512.00,0.00,10616,10617
13892,2,301,211,256.00,2025.00,10616,10618
13893,2,335,177,256.00,6241.00,10617,10619
13894,1,512,512,512.00,0.00,10618,10619
13895,2,417,95,256.00,25921.00,10618,10620
13896,1,512,512,512.00,0.00,10619,10620
13897,4,285,5,128.00,15089.00,10619,10623
13898,1,512,512,512.00,0.00,10622,10623
13899,2,344,168,256.00,7744.00,10622,10624
13900,1,512,512,512.00,0.00,10623,10624
13901,1,512,512,512.00,0.00,10623,10624
13902,1,512,512,512.00,0.00,10623,10624
13903,2,298,214,256.00,1764.00,10623,10625
13904,1,512,512,512.00,0.00,10624,10625
13905,4,143,117,128.00,89.00,10624,10628
13906,1,512,512,512.00,0.00,10627,10628
13907,1,512,512,512.00,0.00,10627,10628
13908,1,512,512,512.00,0.00,10627,10628
13909,1,512,512,512.00,0.00,10627,10628
13910,2,478,34,256.00,49284.00,10627,10629
13911,1,512,512,512.00,0.00,10628,10629
13912,1,512,512,512.00,0.00,10628,10629
13913,2,265,247,256.00,81.00,10628,10630
13914,1,512,512,512.00,0.00,10629,10630
13915,1,512,512,512.00,0.00,10629,10630
13916,1,512,512,512.00,0.00,10629,10630
13917,3,191,145,170.67,366.89,10629,10632
13918,1,512,512,512.00,0.00,10631,10632
13919,2,389,123,256.00,17689.00,10631,10633
13920,2,430,82,256.00,30276.00,10632,10634
13921,2,398,114,256.00,20164.00,10633,10635
13922,2,436,76,256.00,32400.00,10634,10636
13923,1,512,512,512.00,0.00,10635,10636
13924,1,512,512,512.00,0.00,10635,10636
13925,1,512,512,512.00,0.00,10635,10636
13926,2,324,188,256.00,4624.00,10635,10637
13927,1,512,512,512.00,0.00,10636,10637
13928,1,512,512,512.00,0.00,10636,10637
13929,2,448,64,256.00,36864.00,10636,10638
13930,1,512,512,512.00,0.00,10637,10638
13931,1,512,512,512.00,0.00,10637,10638
13932,2,260,252,256.00,16.00,10637,10639
13933,1,512,512,512.00,0.00,10638,10639
13934,2,337,175,256.00,6561.00,10638,10640
13935,1,512,512,512.00,0.00,10639,10640
13936,1,512,512,512.00,0.00,10639,10640
13937,1,512,512,512.00,0.00,10639,10640
13938,2,260,252,256.00,16.00,10639,10641
13939,1,512,512,512.00,0.00,10640,10641
13940,1,512,512,512.00,0.00,10640,10641
13941,3,195,138,170.67,576.22,10640,10643
13942,1,512,512,512.00,0.00,10642,10643
13943,2,462,50,256.00,42436.00,10642,10644
13944,1,512,512,512.00,0.00,10643,10644
13945,1,512,512,512.00,0.00,10643,10644
13946,2,385,127,256.00,16641.00,10643,10645
13947,1,512,512,512.00,0.00,10644,10645
13948,1,512,512,512.00,0.00,10644,10645
13949,1,512,512,512.00,0.00,10644,10645
13950,1,512,512,512.00,0.00,10644,10645
13951,2,482,30,256.00,51076.00,10644,10646
13952,3,344,66,170.67,15238.22,10645,10648
13953,2,430,82,256.00,30276.00,10647,10649
13954,1,512,512,512.00,0.00,10648,10649
13955,3,325,63,170.67,12529.56,10648,10651
13956,1,512,512,512.00,0.00,10650,10651
13957,1,512,512,512.00,0.00,10650,10651
13958,2,416,96,256.00,25600.00,10650,10652
13959,1,512,512,512.00,0.00,10651,10652
13960,1,512,512,512.00,0.00,10651,10652
13961,1,512,512,512.00,0.00,10651,10652
13962,2,343,169,256.00,7569.00,10651,10653
13963,1,512,512,512.00,0.00,10652,10653
13964,1,512,512,512.00,0.00,10652,10653
13965,1,512,512,512.00,0.00,10652,10653
13966,1,512,512,512.00,0.00,10652,10653
13967,2,505,7,256.00,62001.00,10652,10654
13968,1,512,512,512.00,0.00,10653,10654
13969,1,512,512,512.00,0.00,10653,10654
13970,1,512,512,512.00,0.00,10653,10654
13971,3,433,28,170.67,34497.56,10653,10656
13972,2,324,188,256.00,4624.00,10655,10657
13973,1,512,512,512.00,0.00,10656,10657
13974,1,512,512,512.00,0.00,10656,10657
13975,3,389,8,170.67,25742.89,10656,10659
13976,1,512,512,512.00,0.00,10658,10659
13977,1,512,512,512.00,0.00,10658,10659
13978,1,512,512,512.00,0.00,10658,10659
13979,2,437,75,256.00,32761.00,10658,10660
13980,1,512,512,512.00,0.00,10659,10660
13981,2,348,164,256.00,8464.00,10659,10661
13982,1,512,512,512.00,0.00,10660,10661
13983,1,512,512,512.00,0.00,10660,10661
13984,1,512,512,512.00,0.00,10660,10661
13985,1,512,512,512.00,0.00,10660,10661
13986,1,512,512,512.00,0.00,10660,10661
13987,1,512,512,512.00,0.00,10660,10661
13988,2,336,176,256.00,6400.00,10660,10662
13989,1,512,512,512.00,0.00,10661,10662
13990,2,425,87,256.00,28561.00,10661,10663
13991,1,512,512,512.00,0.00,10662,10663
13992,2,466,46,256.00,44100.00,10662,10664
13993,3,411,48,170.67,28884.22,10663,10666
13994,1,512,512,512.00,0.00,10665,10666
13995,1,512,512,512.00,0.00,10665,10666
13996,1,512,512,512.00,0.00,10665,10666
13997,2,507,5,256.00,63001.00,10665,10667
13998,1,512,512,512.00,0.00,10666,10667
13999,1,512,512,512.00,0.00,10666,10667
14000,2,398,114,256.00,20164.00,10666,10668
14001,2,349,163,256.00,8649.00,10667,10669
14002,2,321,191,256.00,4225.00,10668,10670
14003,1,512,512,512.00,0.00,10669,10670
14004,3,416,12,170.67,30958.22,10669,10672
14005,2,379,133,256.00,15129.00,10671,10673
14006,1,512,512,512.00,0.00,10672,10673
14007,1,512,512,512.00,0.00,10672,10673
14008,2,322,190,256.00,4356.00,10672,10674
14009,2,325,187,256.00,4761.00,10673,10675
14010,1,512,512,512.00,0.00,10674,10675
14011,1,512,512,512.00,0.00,10674,10675
14012,4,318,9,128.00,13573.50,10674,10678
14013,1,512,512,512.00,0.00,10677,10678
14014,1,512,512,512.00,0.00,10677,10678
14015,1,512,512,512.00,0.00,10677,10678
14016,1,512,512,512.00,0.00,10677,10678
14017,1,512,512,512.00,0.00,10677,10678
14018,3,310,47,170.67,11650.89,10677,10680
14019,1,512,512,512.00,0.00,10679,10680
14020,2,387,125,256.00,17161.00,10679,10681
14021,1,512,512,512.00,0.00,10680,10681
14022,2,277,235,256.00,441.00,10680,10682
14023,1,512,512,512.00,0.00,10681,10682
14024,1,512,512,512.00,0.00,10681,10682
14025,3,279,46,170.67,9181.56,10681,10684
14026,1,512,512,512.00,0.00,10683,10684
14027,1,512,512,512.00,0.00,10683,10684
14028,2,351,161,256.00,9025.00,10683,10685
14029,1,512,512,512.00,0.00,10684,10685
14030,1,512,512,512.00,0.00,10684,10685
14031,1,512,512,512.00,0.00,10684,10685
14032,1,512,512,512.00,0.00,10684,10685
14033,2,476,36,256.00,48400.00,10684,10686
14034,2,464,48,256.00,43264.00,10685,10687
14035,2,426,86,256.00,28900.00,10686,10688
14036,6,371,3,85.33,16958.89,10687,10693
14037,2,491,21,256.00,55225.00,10692,10694
14038,1,512,512,512.00,0.00,10693,10694
14039,3,239,72,170.67,5108.22,10693,10696
14040,1,512,512,512.00,0.00,10695,10696
14041,4,420,13,128.00,28691.50,10695,10699
14042,6,323,10,85.33,11930.56,10698,10704
14043,3,271,65,170.67,7086.89,10703,10706
14044,1,512,512,512.00,0.00,10705,10706
14045,1,512,512,512.00,0.00,10705,10706
14046,1,512,512,512.00,0.00,10705,10706
14047,1,512,512,512.00,0.00,10705,10706
14048,2,467,45,256.00,44521.00,10705,10707
14049,1,512,512,512.00,0.00,10706,10707
14050,1,512,512,512.00,0.00,10706,10707
14051,1,512,512,512.00,0.00,10706,10707
14052,2,437,75,256.00,32761.00,10706,10708
14053,1,512,512,512.00,0.00,10707,10708
14054,1,512,512,512.00,0.00,10707,10708
14055,3,316,1,170.67,16833.56,10707,10710
14056,3,360,3,170.67,21476.22,10709,10712
14057,1,512,512,512.00,0.00,10711,10712
14058,1,512,512,512.00,0.00,10711,10712
14059,2,344,168,256.00,7744.00,10711,10713
14060,2,369,143,256.00,12769.00,10712,10714
14061,1,512,512,512.00,0.00,10713,10714
14062,2,463,49,256.00,42849.00,10713,10715
14063,1,512,512,512.00,0.00,10714,10715
14064,1,512,512,512.00,0.00,10714,10715
14065,2,365,147,256.00,11881.00,10714,10716
14066,1,512,512,512.00,0.00,10715,10716
14067,1,512,512,512.00,0.00,10715,10716
14068,1,512,512,512.00,0.00,10715,10716
14069,2,257,255,256.00,1.00,10715,10717
14070,1,512,512,512.00,0.00,10716,10717
14071,1,512,512,512.00,0.00,10716,10717
14072,2,348,164,256.00,8464.00,10716,10718
14073,1,512,512,512.00,0.00,10717,10718
14074,1,512,512,512.00,0.00,10717,10718
14075,1,512,512,512.00,0.00,10717,10718
14076,2,277,235,256.00,441.00,10717,10719
14077,3,291,69,170.67,8388.22,10718,10721
14078,2,280,232,256.00,576.00,10720,10722
14079,4,325,12,128.00,13952.50,10721,10725
14080,1,512,512,512.00,0.00,10724,10725
14081,1,512,512,512.00,0.00,10724,10725
14082,2,490,22,256.00,54756.00,10724,10726
14083,1,512,512,512.00,0.00,10725,10726
14084,2,504,8,256.00,61504.00,10725,10727
14085,1,512,512,512.00,0.00,10726,10727
14086,2,476,36,256.00,48400.00,10726,10728
14087,1,512,512,512.00,0.00,10727,10728
14088,3,439,1,170.67,36841.56,10727,10730
14089,1,512,512,512.00,0.00,10729,10730
14090,3,322,12,170.67,16043.56,10729,10732
14091,1,512,512,512.00,0.00,10731,10732
14092,1,512,512,512.00,0.00,10731,10732
14093,1,512,512,512.00,0.00,10731,10732
14094,1,512,512,512.00,0.00,10731,10732
14095,1,512,512,512.00,0.00,10731,10732
14096,2,279,233,256.00,529.00,10731,10733
14097,1,512,512,512.00,0.00,10732,10733
14098,1,512,512,512.00,0.00,10732,10733
14099,2,317,195,256.00,3721.00,10732,10734
14100,1,512,512,512.00,0.00,10733,10734
14101,1,512,512,512.00,0.00,10733,10734
14102,1,512,512,512.00,0.00,10733,10734
14103,1,512,512,512.00,0.00,10733,10734
14104,2,442,70,256.00,34596.00,10733,10735
14105,1,512,512,512.00,0.00,10734,10735
14106,1,512,512,512.00,0.00,10734,10735
14107,1,512,512,512.00,0.00,10734,10735
14108,1,512,512,512.00,0.00,10734,10735
14109,2,408,104,256.00,23104.00,10734,10736
14110,1,512,512,512.00,0.00,10735,10736
14111,2,339,173,256.00,6889.00,10735,10737
14112,1,512,512,512.00,0.00,10736,10737
14113,1,512,512,512.00,0.00,10736,10737
14114,2,447,65,256.00,36481.00,10736,10738
14115,2,339,173,256.00,6889.00,10737,10739
14116,2,343,169,256.00,7569.00,10738,10740
14117,1,512,512,512.00,0.00,10739,10740
14118,2,499,13,256.00,59049.00,10739,10741
14119,1,512,512,512.00,0.00,10740,10741
14120,1,512,512,512.00,0.00,10740,10741
14121,1,512,512,512.00,0.00,10740,10741
14122,2,368,144,256.00,12544.00,10740,10742
14123,1,512,512,512.00,0.00,10741,10742
14124,1,512,512,512.00,0.00,10741,10742
14125,2,370,142,256.00,12996.00,10741,10743
14126,1,512,512,512.00,0.00,10742,10743
14127,2,320,192,256.00,4096.00,10742,10744
14128,2,446,66,256.00,36100.00,10743,10745
14129,2,389,123,256.00,17689.00,10744,10746
14130,1,512,512,512.00,0.00,10745,10746
14131,1,512,512,512.00,0.00,10745,10746
14132,1,512,512,512.00,0.00,10745,10746
14133,2,430,82,256.00,30276.00,10745,10747
14134,2,361,151,256.00,11025.00,10746,10748
14135,3,299,7,170.67,14834.89,10747,10750
14136,1,512,512,512.00,0.00,10749,10750
14137,1,512,512,512.00,0.00,10749,10750
14138,2,312,200,256.00,3136.00,10749,10751
14139,1,512,512,512.00,0.00,10750,10751
14140,1,512,512,512.00,0.00,10750,10751
14141,3,347,28,170.67,17526.89,10750,10753
14142,1,512,512,512.00,0.00,10752,10753
14143,2,430,82,256.00,30276.00,10752,10754
14144,1,512,512,512.00,0.00,10753,10754
14145,1,512,512,512.00,0.00,10753,10754
14146,1,512,512,512.00,0.00,10753,10754
14147,1,512,512,512.00,0.00,10753,10754
14148,2,493,19,256.00,56169.00,10753,10755
14149,1,512,512,512.00,0.00,10754,10755
14150,2,451,61,256.00,38025.00,10754,10756
14151,3,482,6,170.67,48518.22,10755,10758
14152,1,512,512,512.00,0.00,10757,10758
14153,1,512,512,512.00,0.00,10757,10758
14154,2,339,173,256.00,6889.00,10757,10759
14155,1,512,512,512.00,0.00,10758,10759
14156,4,275,18,128.00,8734.50,10758,10762
14157,1,512,512,512.00,0.00,10761,10762
14158,1,512,512,512.00,0.00,10761,10762
14159,1,512,512,512.00,0.00,10761,10762
14160,2,511,1,256.00,65025.00,10761,10763
14161,2,310,202,256.00,2916.00,10762,10764
14162,3,477,7,170.67,46993.56,10763,10766
14163,1,512,512,512.00,0.00,10765,10766
14164,1,512,512,512.00,0.00,10765,10766
14165,4,256,8,128.00,9948.50,10765,10769
14166,5,311,3,102.40,14349.44,10768,10773
14167,2,486,26,256.00,52900.00,10772,10774
14168,4,296,32,128.00,10020.50,10773,10777
14169,1,512,512,512.00,0.00,10776,10777
14170,1,512,512,512.00,0.00,10776,10777
14171,2,486,26,256.00,52900.00,10776,10778
14172,1,512,512,512.00,0.00,10777,10778
14173,2,458,54,256.00,40804.00,10777,10779
14174,1,512,512,512.00,0.00,10778,10779
14175,3,267,62,170.67,7080.22,10778,10781
14176,1,512,512,512.00,0.00,10780,10781
14177,2,417,95,256.00,25921.00,10780,10782
14178,2,279,233,256.00,529.00,10781,10783
14179,1,512,512,512.00,0.00,10782,10783
14180,2,318,194,256.00,3844.00,10782,10784
14181,1,512,512,512.00,0.00,10783,10784
14182,1,512,512,512.00,0.00,10783,10784
14183,3,229,106,170.67,2541.56,10783,10786
14184,1,512,512,512.00,0.00,10785,10786
14185,1,512,512,512.00,0.00,10785,10786
14186,1,512,512,512.00,0.00,10785,10786
14187,3,325,86,170.67,11946.89,10785,10788
14188,2,398,114,256.00,20164.00,10787,10789
14189,2,289,223,256.00,1089.00,10788,10790
14190,1,512,512,512.00,0.00,10789,10790
14191,1,512,512,512.00,0.00,10789,10790
14192,2,467,45,256.00,44521.00,10789,10791
14193,1,512,512,512.00,0.00,10790,10791
14194,2,266,246,256.00,100.00,10790,10792
14195,1,512,512,512.00,0.00,10791,10792
14196,1,512,512,512.00,0.00,10791,10792
14197,1,512,512,512.00,0.00,10791,10792
14198,1,512,512,512.00,0.00,10791,10792
14199,2,324,188,256.00,4624.00,10791,10793
14200,2,407,105,256.00,22801.00,10792,10794
14201,2,343,169,256.00,7569.00,10793,10795
14202,1,512,512,512.00,0.00,10794,10795
14203,1,512,512,512.00,0.00,10794,10795
14204,1,512,512,512.00,0.00,10794,10795
14205,3,402,2,170.67,28630.22,10794,10797
14206,1,512,512,512.00,0.00,10796,10797
14207,1,512,512,512.00,0.00,10796,10797
14208,2,472,40,256.00,46656.00,10796,10798
14209,3,458,8,170.67,41520.89,10797,10800
14210,4,316,10,128.00,13942.00,10799,10803
14211,1,512,512,512.00,0.00,10802,10803
14212,1,512,512,512.00,0.00,10802,10803
14213,2,418,94,256.00,26244.00,10802,10804
14214,4,306,8,128.00,12663.50,10803,10807
14215,1,512,512,512.00,0.00,10806,10807
14216,6,266,1,85.33,12831.56,10806,10812
14217,1,512,512,512.00,0.00,10811,10812
14218,1,512,512,512.00,0.00,10811,10812
14219,1,512,512,512.00,0.00,10811,10812
14220,2,432,80,256.00,30976.00,10811,10813
14221,1,512,512,512.00,0.00,10812,10813
14222,2,358,154,256.00,10404.00,10812,10814
14223,2,268,244,256.00,144.00,10813,10815
14224,1,512,512,512.00,0.00,10814,10815
14225,1,512,512,512.00,0.00,10814,10815
14226,1,512,512,512.00,0.00,10814,10815
14227,1,512,512,512.00,0.00,10814,10815
14228,2,388,124,256.00,17424.00,10814,10816
14229,1,512,512,512.00,0.00,10815,10816
14230,1,512,512,512.00,0.00,10815,10816
14231,1,512,512,512.00,0.00,10815,10816
14232,1,512,512,512.00,0.00,10815,10816
14233,1,512,512,512.00,0.00,10815,10816
14234,1,512,512,512.00,0.00,10815,10816
14235,2,428,84,256.00,29584.00,10815,10817
14236,1,512,512,512.00,0.00,10816,10817
14237,2,487,25,256.00,53361.00,10816,10818
14238,1,512,512,512.00,0.00,10817,10818
14239,1,512,512,512.00,0.00,10817,10818
14240,1,512,512,512.00,0.00,10817,10818
14241,14,176,3,36.57,2362.53,10817,10831
14242,1,512,512,512.00,0.00,10830,10831
14243,1,512,512,512.00,0.00,10830,10831
14244,2,313,199,256.00,3249.00,10830,10832
14245,2,438,74,256.00,33124.00,10831,10833
14246,1,512,512,512.00,0.00,10832,10833
14247,2,443,69,256.00,34969.00,10832,10834
14248,2,415,97,256.00,25281.00,10833,10835
14249,2,303,209,256.00,2209.00,10834,10836
14250,2,375,137,256.00,14161.00,10835,10837
14251,1,512,512,512.00,0.00,10836,10837
14252,2,305,207,256.00,2401.00,10836,10838
14253,1,512,512,512.00,0.00,10837,10838
14254,2,482,30,256.00,51076.00,10837,10839
14255,1,512,512,512.00,0.00,10838,10839
14256,1,512,512,512.00,0.00,10838,10839
14257,1,512,512,512.00,0.00,10838,10839
14258,2,349,163,256.00,8649.00,10838,10840
14259,1,512,512,512.00,0.00,10839,10840
14260,1,512,512,512.00,0.00,10839,10840
14261,2,424,88,256.00,28224.00,10839,10841
14262,1,512,512,512.00,0.00,10840,10841
14263,1,512,512,512.00,0.00,10840,10841
14264,1,512,512,512.00,0.00,10840,10841
14265,1,512,512,512.00,0.00,10840,10841
14266,2,321,191,256.00,4225.00,10840,10842
14267,1,512,512,512.00,0.00,10841,10842
14268,1,512,512,512.00,0.00,10841,10842
14269,1,512,512,512.00,0.00,10841,10842
14270,1,512,512,512.00,0.00,10841,10842
14271,1,512,512,512.00,0.00,10841,10842
14272,3,264,22,170.67,11291.56,10841,10844
14273,1,512,512,512.00,0.00,10843,10844
14274,1,512,512,512.00,0.00,10843,10844
14275,1,512,512,512.00,0.00,10843,10844
14276,1,512,512,512.00,0.00,10843,10844
14277,1,512,512,512.00,0.00,10843,10844
14278,2,460,52,256.00,41616.00,10843,10845
14279,1,512,512,512.00,0.00,10844,10845
14280,1,512,512,512.00,0.00,10844,10845
14281,1,512,512,512.00,0.00,10844,10845
14282,3,430,28,170.67,33739.56,10844,10847
14283,3,441,1,170.67,37333.56,10846,10849
14284,1,512,512,512.00,0.00,10848,10849
14285,1,512,512,512.00,0.00,10848,10849
14286,3,368,10,170.67,22032.89,10848,10851
14287,2,322,190,256.00,4356.00,10850,10852
14288,1,512,512,512.00,0.00,10851,10852
14289,1,512,512,512.00,0.00,10851,10852
14290,1,512,512,512.00,0.00,10851,10852
14291,4,323,5,128.00,15561.00,10851,10855
14292,1,512,512,512.00,0.00,10854,10855
14293,1,512,512,512.00,0.00,10854,10855
14294,1,512,512,512.00,0.00,10854,10855
14295,1,512,512,512.00,0.00,10854,10855
14296,9,240,2,56.89,5404.54,10854,10863
14297,2,363,149,256.00,11449.00,10862,10864
14298,1,512,512,512.00,0.00,10863,10864
14299,5,349,13,102.40,16158.64,10863,10868
14300,1,512,512,512.00,0.00,10867,10868
14301,1,512,512,512.00,0.00,10867,10868
14302,1,512,512,512.00,0.00,10867,10868
14303,1,512,512,512.00,0.00,10867,10868
14304,2,501,11,256.00,60025.00,10867,10869
14305,2,467,45,256.00,44521.00,10868,10870
14306,1,512,512,512.00,0.00,10869,10870
14307,1,512,512,512.00,0.00,10869,10870
14308,1,512,512,512.00,0.00,10869,10870
14309,1,512,512,512.00,0.00,10869,10870
14310,2,257,255,256.00,1.00,10869,10871
14311,1,512,512,512.00,0.00,10870,10871
14312,1,512,512,512.00,0.00,10870,10871
14313,1,512,512,512.00,0.00,10870,10871
14314,1,512,512,512.00,0.00,10870,10871
14315,1,512,512,512.00,0.00,10870,10871
14316,2,377,135,256.00,14641.00,10870,10872
14317,1,512,512,512.00,0.00,10871,10872
14318,1,512,512,512.00,0.00,10871,10872
14319,2,341,171,256.00,7225.00,10871,10873
14320,1,512,512,512.00,0.00,10872,10873
14321,5,215,4,102.40,7688.24,10872,10877
14322,3,487,1,170.67,50121.56,10876,10879
14323,4,250,3,128.00,14298.50,10878,10882
14324,2,271,241,256.00,225.00,10881,10883
14325,1,512,512,512.00,0.00,10882,10883
14326,3,348,48,170.67,16494.22,10882,10885
14327,1,512,512,512.00,0.00,10884,10885
14328,1,512,512,512.00,0.00,10884,10885
14329,1,512,512,512.00,0.00,10884,10885
14330,1,512,512,512.00,0.00,10884,10885
14331,2,338,174,256.00,6724.00,10884,10886
14332,1,512,512,512.00,0.00,10885,10886
14333,2,365,147,256.00,11881.00,10885,10887
14334,1,512,512,512.00,0.00,10886,10887
14335,2,460,52,256.00,41616.00,10886,10888
14336,1,512,512,512.00,0.00,10887,10888
14337,1,512,512,512.00,0.00,10887,10888
14338,2,275,237,256.00,361.00,10887,10889
14339,1,512,512,512.00,0.00,10888,10889
14340,1,512,512,512.00,0.00,10888,10889
14341,1,512,512,512.00,0.00,10888,10889
14342,1,512,512,512.00,0.00,10888,10889
14343,2,292,220,256.00,1296.00,10888,10890
14344,1,512,512,512.00,0.00,10889,10890
14345,1,512,512,512.00,0.00,10889,10890
14346,1,512,512,512.00,0.00,10889,10890
14347,5,284,4,102.40,13560.64,10889,10894
14348,1,512,512,512.00,0.00,10893,10894
14349,1,512,512,512.00,0.00,10893,10894
14350,3,427,12,170.67,33473.56,10893,10896
14351,2,472,40,256.00,46656.00,10895,10897
14352,5,209,4,102.40,6648.24,10896,10901
14353,2,393,119,256.00,18769.00,10900,10902
14354,1,512,512,512.00,0.00,10901,10902
14355,1,512,512,512.00,0.00,10901,10902
14356,1,512,512,512.00,0.00,10901,10902
14357,2,275,237,256.00,361.00,10901,10903
14358,1,512,512,512.00,0.00,10902,10903
14359,2,366,146,256.00,12100.00,10902,10904
14360,1,512,512,512.00,0.00,10903,10904
14361,1,512,512,512.00,0.00,10903,10904
14362,1,512,512,512.00,0.00,10903,10904
14363,2,457,55,256.00,40401.00,10903,10905
14364,1,512,512,512.00,0.00,10904,10905
14365,3,439,5,170.67,36662.89,10904,10907
14366,4,434,7,128.00,31578.50,10906,10910
14367,1,512,512,512.00,0.00,10909,10910
14368,1,512,512,512.00,0.00,10909,10910
14369,1,512,512,512.00,0.00,10909,10910
14370,2,396,116,256.00,19600.00,10909,10911
14371,1,512,512,512.00,0.00,10910,10911
14372,1,512,512,512.00,0.00,10910,10911
14373,1,512,512,512.00,0.00,10910,10911
14374,2,268,244,256.00,144.00,10910,10912
14375,1,512,512,512.00,0.00,10911,10912
14376,1,512,512,512.00,0.00,10911,10912
14377,2,409,103,256.00,23409.00,10911,10913
14378,1,512,512,512.00,0.00,10912,10913
14379,1,512,512,512.00,0.00,10912,10913
14380,1,512,512,512.00,0.00,10912,10913
14381,3,252,92,170.67,4270.22,10912,10915
14382,2,268,244,256.00,144.00,10914,10916
14383,1,512,512,512.00,0.00,10915,10916
14384,2,453,59,256.00,38809.00,10915,10917
14385,2,412,100,256.00,24336.00,10916,10918
14386,1,512,512,512.00,0.00,10917,10918
14387,1,512,512,512.00,0.00,10917,10918
14388,2,339,173,256.00,6889.00,10917,10919
14389,1,512,512,512.00,0.00,10918,10919
14390,2,422,90,256.00,27556.00,10918,10920
14391,1,512,512,512.00,0.00,10919,10920
14392,1,512,512,512.00,0.00,10919,10920
14393,2,414,98,256.00,24964.00,10919,10921
14394,4,402,2,128.00,26828.00,10920,10924
14395,1,512,512,512.00,0.00,10923,10924
14396,2,333,179,256.00,5929.00,10923,10925
14397,2,401,111,256.00,21025.00,10924,10926
14398,1,512,512,512.00,0.00,10925,10926
14399,1,512,512,512.00,0.00,10925,10926
14400,1,512,512,512.00,0.00,10925,10926
14401,2,446,66,256.00,36100.00,10925,10927
14402,1,512,512,512.00,0.00,10926,10927
14403,1,512,512,512.00,0.00,10926,10927
14404,3,196,148,170.67,387.56,10926,10929
14405,2,329,183,256.00,5329.00,10928,10930
14406,1,512,512,512.00,0.00,10929,10930
14407,1,512,512,512.00,0.00,10929,10930
14408,1,512,512,512.00,0.00,10929,10930
14409,1,512,512,512.00,0.00,10929,10930
14410,1,512,512,512.00,0.00,10929,10930
14411,4,323,1,128.00,14297.00,10929,10933
14412,1,512,512,512.00,0.00,10932,10933
14413,1,512,512,512.00,0.00,10932,10933
14414,1,512,512,512.00,0.00,10932,10933
14415,1,512,512,512.00,0.00,10932,10933
14416,1,512,512,512.00,0.00,10932,10933
14417,2,378,134,256.00,14884.00,10932,10934
14418,1,512,512,512.00,0.00,10933,10934
14419,1,512,512,512.00,0.00,10933,10934
14420,1,512,512,512.00,0.00,10933,10934
14421,1,512,512,512.00,0.00,10933,10934
14422,2,399,113,256.00,20449.00,10933,10935
14423,1,512,512,512.00,0.00,10934,10935
14424,1,512,512,512.00,0.00,10934,10935
14425,2,499,13,256.00,59049.00,10934,10936
14426,2,257,255,256.00,1.00,10935,10937
14427,1,512,512,512.00,0.00,10936,10937
14428,1,512,512,512.00,0.00,10936,10937
14429,2,275,237,256.00,361.00,10936,10938
14430,1,512,512,512.00,0.00,10937,10938
14431,1,512,512,512.00,0.00,10937,10938
14432,1,512,512,512.00,0.00,10937,10938
14433,2,322,190,256.00,4356.00,10937,10939
14434,1,512,512,512.00,0.00,10938,10939
14435,2,349,163,256.00,8649.00,10938,10940
14436,2,290,222,256.00,1156.00,10939,10941
14437,1,512,512,512.00,0.00,10940,10941
14438,1,512,512,512.00,0.00,10940,10941
14439,1,512,512,512.00,0.00,10940,10941
14440,1,512,512,512.00,0.00,10940,10941
14441,1,512,512,512.00,0.00,10940,10941
14442,2,501,11,256.00,60025.00,10940,10942
14443,1,512,512,512.00,0.00,10941,10942
14444,1,512,512,512.00,0.00,10941,10942
14445,1,512,512,512.00,0.00,10941,10942
14446,2,306,206,256.00,2500.00,10941,10943
14447,1,512,512,512.00,0.00,10942,10943
14448,1,512,512,512.00,0.00,10942,10943
14449,1,512,512,512.00,0.00,10942,10943
14450,1,512,512,512.00,0.00,10942,10943
14451,2,328,184,256.00,5184.00,10942,10944
14452,1,512,512,512.00,0.00,10943,10944
14453,1,512,512,512.00,0.00,10943,10944
14454,1,512,512,512.00,0.00,10943,10944
14455,2,405,107,256.00,22201.00,10943,10945
14456,3,477,11,170.67,46948.22,10944,10947
14457,1,512,512,512.00,0.00,10946,10947
14458,2,334,178,256.00,6084.00,10946,10948
14459,1,512,512,512.00,0.00,10947,10948
14460,3,284,14,170.67,13088.89,10947,10950
14461,2,486,26,256.00,52900.00,10949,10951
14462,3,247,132,170.67,2913.56,10950,10953
14463,1,512,512,512.00,0.00,10952,10953
14464,3,291,2,170.67,15088.22,10952,10955
14465,1,512,512,512.00,0.00,10954,10955
14466,2,321,191,256.00,4225.00,10954,10956
14467,2,313,199,256.00,3249.00,10955,10957
14468,1,512,512,512.00,0.00,10956,10957
14469,1,512,512,512.00,0.00,10956,10957
14470,1,512,512,512.00,0.00,10956,10957
14471,1,512,512,512.00,0.00,10956,10957
14472,1,512,512,512.00,0.00,10956,10957
14473,2,390,122,256.00,17956.00,10956,10958
14474,2,483,29,256.00,51529.00,10957,10959
14475,1,512,512,512.00,0.00,10958,10959
14476,3,374,45,170.67,21056.22,10958,10961
14477,2,262,250,256.00,36.00,10960,10962
14478,1,512,512,512.00,0.00,10961,10962
14479,1,512,512,512.00,0.00,10961,10962
14480,3,384,3,170.67,25236.22,10961,10964
14481,1,512,512,512.00,0.00,10963,10964
14482,1,512,512,512.00,0.00,10963,10964
14483,1,512,512,512.00,0.00,10963,10964
14484,3,489,1,170.67,50741.56,10963,10966
14485,1,512,512,512.00,0.00,10965,10966
14486,1,512,512,512.00,0.00,10965,10966
14487,1,512,512,512.00,0.00,10965,10966
14488,3,203,130,170.67,922.89,10965,10968
14489,1,512,512,512.00,0.00,10967,10968
14490,1,512,512,512.00,0.00,10967,10968
14491,1,512,512,512.00,0.00,10967,10968
14492,1,512,512,512.00,0.00,10967,10968
14493,1,512,512,512.00,0.00,10967,10968
14494,2,365,147,256.00,11881.00,10967,10969
14495,1,512,512,512.00,0.00,10968,10969
14496,2,361,151,256.00,11025.00,10968,10970
14497,3,486,11,170.67,49720.22,10969,10972
14498,1,512,512,512.00,0.00,10971,10972
14499,5,295,11,102.40,9856.64,10971,10976
14500,1,512,512,512.00,0.00,10975,10976
14501,2,278,234,256.00,484.00,10975,10977
14502,1,512,512,512.00,0.00,10976,10977
14503,1,512,512,512.00,0.00,10976,10977
14504,1,512,512,512.00,0.00,10976,10977
14505,1,512,512,512.00,0.00,10976,10977
14506,1,512,512,512.00,0.00,10976,10977
14507,4,226,42,128.00,7388.50,10976,10980
14508,2,437,75,256.00,32761.00,10979,10981
14509,2,356,156,256.00,10000.00,10980,10982
14510,2,396,116,256.00,19600.00,10981,10983
14511,2,259,253,256.00,9.00,10982,10984
14512,2,289,223,256.00,1089.00,10983,10985
14513,3,298,17,170.67,13506.89,10984,10987
14514,4,360,6,128.00,18697.50,10986,10990
14515,2,511,1,256.00,65025.00,10989,10991
14516,1,512,512,512.00,0.00,10990,10991
14517,1,512,512,512.00,0.00,10990,10991
14518,1,512,512,512.00,0.00,10990,10991
14519,4,357,19,128.00,18602.50,10990,10994
14520,1,512,512,512.00,0.00,10993,10994
14521,1,512,512,512.00,0.00,10993,10994
14522,2,408,104,256.00,23104.00,10993,10995
14523,1,512,512,512.00,0.00,10994,10995
14524,1,512,512,512.00,0.00,10994,10995
14525,1,512,512,512.00,0.00,10994,10995
14526,1,512,512,512.00,0.00,10994,10995
14527,1,512,512,512.00,0.00,10994,10995
14528,2,287,225,256.00,961.00,10994,10996
14529,1,512,512,512.00,0.00,10995,10996
14530,1,512,512,512.00,0.00,10995,10996
14531,2,463,49,256.00,42849.00,10995,10997
14532,1,512,512,512.00,0.00,10996,10997
14533,1,512,512,512.00,0.00,10996,10997
14534,2,511,1,256.00,65025.00,10996,10998
14535,2,400,112,256.00,20736.00,10997,10999
14536,2,381,131,256.00,15625.00,10998,11000
14537,1,512,512,512.00,0.00,10999,11000
14538,1,512,512,512.00,0.00,10999,11000
14539,1,512,512,512.00,0.00,10999,11000
14540,2,288,224,256.00,1024.00,10999,11001
14541,1,512,512,512.00,0.00,11000,11001
14542,1,512,512,512.00,0.00,11000,11001
14543,1,512,512,512.00,0.00,11000,11001
14544,2,307,205,256.00,2601.00,11000,11002
14545,1,512,512,512.00,0.00,11001,11002
14546,2,340,172,256.00,7056.00,11001,11003
14547,2,453,59,256.00,38809.00,11002,11004
14548,2,396,116,256.00,19600.00,11003,11005
14549,2,496,16,256.00,57600.00,11004,11006
14550,1,512,512,512.00,0.00,11005,11006
14551,3,473,6,170.67,45824.22,11005,11008
14552,1,512,512,512.00,0.00,11007,11008
14553,1,512,512,512.00,0.00,11007,11008
14554,1,512,512,512.00,0.00,11007,11008
14555,1,512,512,512.00,0.00,11007,11008
14556,1,512,512,512.00,0.00,11007,11008
14557,3,203,142,170.67,626.89,11007,11010
14558,1,512,512,512.00,0.00,11009,11010
14559,1,512,512,512.00,0.00,11009,11010
14560,1,512,512,512.00,0.00,11009,11010
14561,1,512,512,512.00,0.00,11009,11010
14562,2,391,121,256.00,18225.00,11009,11011
14563,4,174,63,128.00,2095.50,11010,11014
14564,3,341,29,170.67,16634.89,11013,11016
14565,1,512,512,512.00,0.00,11015,11016
14566,3,413,28,170.67,29670.89,11015,11018
14567,1,512,512,512.00,0.00,11017,11018
14568,2,339,173,256.00,6889.00,11017,11019
14569,1,512,512,512.00,0.00,11018,11019
14570,1,512,512,512.00,0.00,11018,11019
14571,2,270,242,256.00,196.00,11018,11020
14572,1,512,512,512.00,0.00,11019,11020
14573,1,512,512,512.00,0.00,11019,11020
14574,2,415,97,256.00,25281.00,11019,11021
14575,1,512,512,512.00,0.00,11020,11021
14576,1,512,512,512.00,0.00,11020,11021
14577,1,512,512,512.00,0.00,11020,11021
14578,1,512,512,512.00,0.00,11020,11021
14579,2,480,32,256.00,50176.00,11020,11022
14580,2,432,80,256.00,30976.00,11021,11023
14581,1,512,512,512.00,0.00,11022,11023
14582,1,512,512,512.00,0.00,11022,11023
14583,2,301,211,256.00,2025.00,11022,11024
14584,1,512,512,512.00,0.00,11023,11024
14585,1,512,512,512.00,0.00,11023,11024
14586,3,274,60,170.67,7659.56,11023,11026
14587,1,512,512,512.00,0.00,11025,11026
14588,3,306,1,170.67,16093.56,11025,11028
14589,2,315,197,256.00,3481.00,11027,11029
14590,2,385,127,256.00,16641.00,11028,11030
14591,3,407,13,170.67,28966.89,11029,11032
14592,3,365,48,170.67,19316.22,11031,11034
14593,1,512,512,512.00,0.00,11033,11034
14594,2,341,171,256.00,7225.00,11033,11035
14595,1,512,512,512.00,0.00,11034,11035
14596,1,512,512,512.00,0.00,11034,11035
14597,2,359,153,256.00,10609.00,11034,11036
14598,2,393,119,256.00,18769.00,11035,11037
14599,1,512,512,512.00,0.00,11036,11037
14600,4,215,17,128.00,7709.00,11036,11040
14601,1,512,512,512.00,0.00,11039,11040
14602,3,304,62,170.67,10064.89,11039,11042
14603,1,512,512,512.00,0.00,11041,11042
14604,1,512,512,512.00,0.00,11041,11042
14605,1,512,512,512.00,0.00,11041,11042
14606,1,512,512,512.00,0.00,11041,11042
14607,4,315,6,128.00,13244.50,11041,11045
14608,3,358,65,170.67,17642.89,11044,11047
14609,1,512,512,512.00,0.00,11046,11047
14610,1,512,512,512.00,0.00,11046,11047
14611,1,512,512,512.00,0.00,11046,11047
14612,1,512,512,512.00,0.00,11046,11047
14613,1,512,512,512.00,0.00,11046,11047
14614,2,470,42,256.00,45796.00,11046,11048
14615,1,512,512,512.00,0.00,11047,11048
14616,1,512,512,512.00,0.00,11047,11048
14617,1,512,512,512.00,0.00,11047,11048
14618,1,512,512,512.00,0.00,11047,11048
14619,1,512,512,512.00,0.00,11047,11048
14620,2,486,26,256.00,52900.00,11047,11049
14621,1,512,512,512.00,0.00,11048,11049
14622,1,512,512,512.00,0.00,11048,11049
14623,1,512,512,512.00,0.00,11048,11049
14624,1,512,512,512.00,0.00,11048,11049
14625,2,300,212,256.00,1936.00,11048,11050
14626,3,468,1,170.67,44497.56,11049,11052
14627,1,512,512,512.00,0.00,11051,11052
14628,1,512,512,512.00,0.00,11051,11052
14629,1,512,512,512.00,0.00,11051,11052
14630,2,326,186,256.00,4900.00,11051,11053
14631,2,380,132,256.00,15376.00,11052,11054
14632,2,486,26,256.00,52900.00,11053,11055
14633,2,278,234,256.00,484.00,11054,11056
14634,1,512,512,512.00,0.00,11055,11056
14635,1,512,512,512.00,0.00,11055,11056
14636,2,303,209,256.00,2209.00,11055,11057
14637,2,276,236,256.00,400.00,11056,11058
14638,1,512,512,512.00,0.00,11057,11058
14639,3,264,119,170.67,4372.22,11057,11060
14640,3,335,51,170.67,14440.22,11059,11062
14641,1,512,512,512.00,0.00,11061,11062
14642,1,512,512,512.00,0.00,11061,11062
14643,1,512,512,512.00,0.00,11061,11062
14644,1,512,512,512.00,0.00,11061,11062
14645,2,432,80,256.00,30976.00,11061,11063
14646,1,512,512,512.00,0.00,11062,11063
14647,1,512,512,512.00,0.00,11062,11063
14648,1,512,512,512.00,0.00,11062,11063
14649,2,311,201,256.00,3025.00,11062,11064
14650,1,512,512,512.00,0.00,11063,11064
14651,3,240,96,170.67,3470.22,11063,11066
14652,4,295,23,128.00,10281.00,11065,11069
14653,1,512,512,512.00,0.00,11068,11069
14654,1,512,512,512.00,0.00,11068,11069
14655,2,279,233,256.00,529.00,11068,11070
14656,3,260,13,170.67,12502.89,11069,11072
14657,1,512,512,512.00,0.00,11071,11072
14658,1,512,512,512.00,0.00,11071,11072
14659,1,512,512,512.00,0.00,11071,11072
14660,2,487,25,256.00,53361.00,11071,11073
14661,1,512,512,512.00,0.00,11072,11073
14662,2,324,188,256.00,4624.00,11072,11074
14663,3,299,10,170.67,14442.89,11073,11076
14664,1,512,512,512.00,0.00,11075,11076
14665,3,323,13,170.67,16030.89,11075,11078
14666,1,512,512,512.00,0.00,11077,11078
14667,1,512,512,512.00,0.00,11077,11078
14668,1,512,512,512.00,0.00,11077,11078
14669,2,380,132,256.00,15376.00,11077,11079
14670,2,369,143,256.00,12769.00,11078,11080
14671,1,512,512,512.00,0.00,11079,11080
14672,2,285,227,256.00,841.00,11079,11081
14673,1,512,512,512.00,0.00,11080,11081
14674,2,345,167,256.00,7921.00,11080,11082
14675,1,512,512,512.00,0.00,11081,11082
14676,2,452,60,256.00,38416.00,11081,11083
14677,1,512,512,512.00,0.00,11082,11083
14678,3,230,137,170.67,1770.89,11082,11085
14679,1,512,512,512.00,0.00,11084,11085
14680,1,512,512,512.00,0.00,11084,11085
14681,1,512,512,512.00,0.00,11084,11085
14682,1,512,512,512.00,0.00,11084,11085
14683,2,435,77,256.00,32041.00,11084,11086
14684,1,512,512,512.00,0.00,11085,11086
14685,1,512,512,512.00,0.00,11085,11086
14686,1,512,512,512.00,0.00,11085,11086
14687,1,512,512,512.00,0.00,11085,11086
14688,1,512,512,512.00,0.00,11085,11086
14689,2,397,115,256.00,19881.00,11085,11087
14690,1,512,512,512.00,0.00,11086,11087
14691,2,473,39,256.00,47089.00,11086,11088
14692,1,512,512,512.00,0.00,11087,11088
14693,2,351,161,256.00,9025.00,11087,11089
14694,2,269,243,256.00,169.00,11088,11090
14695,1,512,512,512.00,0.00,11089,11090
14696,1,512,512,512.00,0.00,11089,11090
14697,2,403,109,256.00,21609.00,11089,11091
14698,1,512,512,512.00,0.00,11090,11091
14699,2,481,31,256.00,50625.00,11090,11092
14700,1,512,512,512.00,0.00,11091,11092
14701,3,277,96,170.67,5961.56,11091,11094
14702,1,512,512,512.00,0.00,11093,11094
14703,2,411,101,256.00,24025.00,11093,11095
14704,1,512,512,512.00,0.00,11094,11095
14705,1,512,512,512.00,0.00,11094,11095
14706,1,512,512,512.00,0.00,11094,11095
14707,1,512,512,512.00,0.00,11094,11095
14708,2,315,197,256.00,3481.00,11094,11096
14709,1,512,512,512.00,0.00,11095,11096
14710,1,512,512,512.00,0.00,11095,11096
14711,1,512,512,512.00,0.00,11095,11096
14712,2,495,17,256.00,57121.00,11095,11097
14713,1,512,512,512.00,0.00,11096,11097
14714,1,512,512,512.00,0.00,11096,11097
14715,2,256,256,256.00,0.00,11096,11098
14716,1,512,512,512.00,0.00,11097,11098
14717,1,512,512,512.00,0.00,11097,11098
14718,2,366,146,256.00,12100.00,11097,11099
14719,1,512,512,512.00,0.00,11098,11099
14720,1,512,512,512.00,0.00,11098,11099
14721,1,512,512,512.00,0.00,11098,11099
14722,1,512,512,512.00,0.00,11098,11099
14723,2,304,208,256.00,2304.00,11098,11100
14724,1,512,512,512.00,0.00,11099,11100
14725,1,512,512,512.00,0.00,11099,11100
14726,1,512,512,512.00,0.00,11099,11100
14727,2,440,72,256.00,33856.00,11099,11101
14728,1,512,512,512.00,0.00,11100,11101
14729,1,512,512,512.00,0.00,11100,11101
14730,1,512,512,512.00,0.00,11100,11101
14731,2,389,123,256.00,17689.00,11100,11102
14732,2,314,198,256.00,3364.00,11101,11103
14733,1,512,512,512.00,0.00,11102,11103
14734,1,512,512,512.00,0.00,11102,11103
14735,2,441,71,256.00,34225.00,11102,11104
14736,1,512,512,512.00,0.00,11103,11104
14737,1,512,512,512.00,0.00,11103,11104
14738,2,273,239,256.00,289.00,11103,11105
14739,1,512,512,512.00,0.00,11104,11105
14740,3,426,1,170.67,33773.56,11104,11107
14741,2,348,164,256.00,8464.00,11106,11108
14742,1,512,512,512.00,0.00,11107,11108
14743,1,512,512,512.00,0.00,11107,11108
14744,5,355,17,102.40,16296.64,11107,11112
14745,1,512,512,512.00,0.00,11111,11112
14746,1,512,512,512.00,0.00,11111,11112
14747,1,512,512,512.00,0.00,11111,11112
14748,1,512,512,512.00,0.00,11111,11112
14749,2,390,122,256.00,17956.00,11111,11113
14750,1,512,512,512.00,0.00,11112,11113
14751,1,512,512,512.00,0.00,11112,11113
14752,1,512,512,512.00,0.00,11112,11113
14753,1,512,512,512.00,0.00,11112,11113
14754,3,253,92,170.67,4326.89,11112,11115
14755,2,438,74,256.00,33124.00,11114,11116
14756,4,367,10,128.00,20257.50,11115,11119
14757,1,512,512,512.00,0.00,11118,11119
14758,1,512,512,512.00,0.00,11118,11119
14759,1,512,512,512.00,0.00,11118,11119
14760,2,316,196,256.00,3600.00,11118,11120
14761,1,512,512,512.00,0.00,11119,11120
14762,2,337,175,256.00,6561.00,11119,11121
14763,2,462,50,256.00,42436.00,11120,11122
14764,1,512,512,512.00,0.00,11121,11122
14765,1,512,512,512.00,0.00,11121,11122
14766,3,394,3,170.67,27029.56,11121,11124
14767,6,268,1,85.33,8725.22,11123,11129
14768,1,512,512,512.00,0.00,11128,11129
14769,2,308,204,256.00,2704.00,11128,11130
14770,4,283,27,128.00,9401.50,11129,11133
14771,1,512,512,512.00,0.00,11132,11133
14772,1,512,512,512.00,0.00,11132,11133
14773,4,321,36,128.00,13168.50,11132,11136
14774,1,512,512,512.00,0.00,11135,11136
14775,1,512,512,512.00,0.00,11135,11136
14776,1,512,512,512.00,0.00,11135,11136
14777,1,512,512,512.00,0.00,11135,11136
14778,1,512,512,512.00,0.00,11135,11136
14779,2,269,243,256.00,169.00,11135,11137
14780,1,512,512,512.00,0.00,11136,11137
14781,1,512,512,512.00,0.00,11136,11137
14782,2,511,1,256.00,65025.00,11136,11138
14783,2,392,120,256.00,18496.00,11137,11139
14784,2,412,100,256.00,24336.00,11138,11140
14785,1,512,512,512.00,0.00,11139,11140
14786,2,409,103,256.00,23409.00,11139,11141
14787,2,396,116,256.00,19600.00,11140,11142
14788,2,471,41,256.00,46225.00,11141,11143
14789,1,512,512,512.00,0.00,11142,11143
14790,2,487,25,256.00,53361.00,11142,11144
14791,1,512,512,512.00,0.00,11143,11144
14792,1,512,512,512.00,0.00,11143,11144
14793,1,512,512,512.00,0.00,11143,11144
14794,2,361,151,256.00,11025.00,11143,11145
14795,3,278,30,170.67,10806.22,11144,11147
14796,1,512,512,512.00,0.00,11146,11147
14797,1,512,512,512.00,0.00,11146,11147
14798,3,282,100,170.67,6347.56,11146,11149
14799,2,437,75,256.00,32761.00,11148,11150
14800,1,512,512,512.00,0.00,11149,11150
14801,3,376,24,170.67,22371.56,11149,11152
14802,3,314,70,170.67,10832.89,11151,11154
14803,1,512,512,512.00,0.00,11153,11154
14804,1,512,512,512.00,0.00,11153,11154
14805,1,512,512,512.00,0.00,11153,11154
14806,1,512,512,512.00,0.00,11153,11154
14807,2,496,16,256.00,57600.00,11153,11155
14808,1,512,512,512.00,0.00,11154,11155
14809,2,421,91,256.00,27225.00,11154,11156
14810,1,512,512,512.00,0.00,11155,11156
14811,1,512,512,512.00,0.00,11155,11156
14812,3,332,56,170.67,13784.89,11155,11158
14813,1,512,512,512.00,0.00,11157,11158
14814,1,512,512,512.00,0.00,11157,11158
14815,2,307,205,256.00,2601.00,11157,11159
14816,1,512,512,512.00,0.00,11158,11159
14817,1,512,512,512.00,0.00,11158,11159
14818,1,512,512,512.00,0.00,11158,11159
14819,1,512,512,512.00,0.00,11158,11159
14820,2,452,60,256.00,38416.00,11158,11160
14821,2,442,70,256.00,34596.00,11159,11161
14822,1,512,512,512.00,0.00,11160,11161
14823,1,512,512,512.00,0.00,11160,11161
14824,2,306,206,256.00,2500.00,11160,11162
14825,1,512,512,512.00,0.00,11161,11162
14826,2,498,14,256.00,58564.00,11161,11163
14827,1,512,512,512.00,0.00,11162,11163
14828,2,398,114,256.00,20164.00,11162,11164
14829,1,512,512,512.00,0.00,11163,11164
14830,3,334,8,170.67,17712.89,11163,11166
14831,1,512,512,512.00,0.00,11165,11166
14832,3,229,103,170.67,2689.56,11165,11168
14833,4,407,11,128.00,26163.00,11167,11171
14834,1,512,512,512.00,0.00,11170,11171
14835,6,297,8,85.33,10020.22,11170,11176
14836,1,512,512,512.00,0.00,11175,11176
14837,2,268,244,256.00,144.00,11175,11177
14838,1,512,512,512.00,0.00,11176,11177
14839,1,512,512,512.00,0.00,11176,11177
14840,4,323,2,128.00,18256.50,11176,11180
14841,2,447,65,256.00,36481.00,11179,11181
14842,1,512,512,512.00,0.00,11180,11181
14843,1,512,512,512.00,0.00,11180,11181
14844,2,438,74,256.00,33124.00,11180,11182
14845,1,512,512,512.00,0.00,11181,11182
14846,1,512,512,512.00,0.00,11181,11182
14847,2,486,26,256.00,52900.00,11181,11183
14848,1,512,512,512.00,0.00,11182,11183
14849,1,512,512,512.00,0.00,11182,11183
14850,1,512,512,512.00,0.00,11182,11183
14851,1,512,512,512.00,0.00,11182,11183
14852,2,343,169,256.00,7569.00,11182,11184
14853,1,512,512,512.00,0.00,11183,11184
14854,1,512,512,512.00,0.00,11183,11184
14855,7,137,17,73.14,1337.55,11183,11190
14856,1,512,512,512.00,0.00,11189,11190
14857,1,512,512,512.00,0.00,11189,11190
14858,1,512,512,512.00,0.00,11189,11190
14859,1,512,512,512.00,0.00,11189,11190
14860,1,512,512,512.00,0.00,11189,11190
14861,2,273,239,256.00,289.00,11189,11191
14862,1,512,512,512.00,0.00,11190,11191
14863,2,365,147,256.00,11881.00,11190,11192
14864,3,410,2,170.67,30240.89,11191,11194
14865,4,389,21,128.00,23077.50,11193,11197
14866,2,498,14,256.00,58564.00,11196,11198
14867,1,512,512,512.00,0.00,11197,11198
14868,1,512,512,512.00,0.00,11197,11198
14869,1,512,512,512.00,0.00,11197,11198
14870,2,330,182,256.00,5476.00,11197,11199
14871,1,512,512,512.00,0.00,11198,11199
14872,4,280,5,128.00,14713.50,11198,11202
14873,1,512,512,512.00,0.00,11201,11202
14874,1,512,512,512.00,0.00,11201,11202
14875,2,299,213,256.00,1849.00,11201,11203
14876,1,512,512,512.00,0.00,11202,11203
14877,2,489,23,256.00,54289.00,11202,11204
14878,1,512,512,512.00,0.00,11203,11204
14879,1,512,512,512.00,0.00,11203,11204
14880,1,512,512,512.00,0.00,11203,11204
14881,2,482,30,256.00,51076.00,11203,11205
14882,1,512,512,512.00,0.00,11204,11205
14883,1,512,512,512.00,0.00,11204,11205
14884,1,512,512,512.00,0.00,11204,11205
14885,1,512,512,512.00,0.00,11204,11205
14886,1,512,512,512.00,0.00,11204,11205
14887,2,284,228,256.00,784.00,11204,11206
14888,2,295,217,256.00,1521.00,11205,11207
14889,1,512,512,512.00,0.00,11206,11207
14890,1,512,512,512.00,0.00,11206,11207
14891,1,512,512,512.00,0.00,11206,11207
14892,2,407,105,256.00,22801.00,11206,11208
14893,1,512,512,512.00,0.00,11207,11208
14894,1,512,512,512.00,0.00,11207,11208
14895,1,512,512,512.00,0.00,11207,11208
14896,3,250,13,170.67,12429.56,11207,11210
14897,3,232,57,170.67,6473.56,11209,11212
14898,1,512,512,512.00,0.00,11211,11212
14899,1,512,512,512.00,0.00,11211,11212
14900,2,407,105,256.00,22801.00,11211,11213
14901,1,512,512,512.00,0.00,11212,11213
14902,3,419,34,170.67,30938.89,11212,11215
14903,1,512,512,512.00,0.00,11214,11215
14904,1,512,512,512.00,0.00,11214,11215
14905,1,512,512,512.00,0.00,11214,11215
14906,1,512,512,512.00,0.00,11214,11215
14907,2,477,35,256.00,48841.00,11214,11216
14908,1,512,512,512.00,0.00,11215,11216
14909,4,395,2,128.00,25761.50,11215,11219
14910,2,297,215,256.00,1681.00,11218,11220
14911,1,512,512,512.00,0.00,11219,11220
14912,1,512,512,512.00,0.00,11219,11220
14913,2,311,201,256.00,3025.00,11219,11221
14914,1,512,512,512.00,0.00,11220,11221
14915,2,467,45,256.00,44521.00,11220,11222
14916,2,300,212,256.00,1936.00,11221,11223
14917,1,512,512,512.00,0.00,11222,11223
14918,2,460,52,256.00,41616.00,11222,11224
14919,2,268,244,256.00,144.00,11223,11225
14920,1,512,512,512.00,0.00,11224,11225
14921,1,512,512,512.00,0.00,11224,11225
14922,1,512,512,512.00,0.00,11224,11225
14923,4,382,12,128.00,22486.00,11224,11228
14924,1,512,512,512.00,0.00,11227,11228
14925,1,512,512,512.00,0.00,11227,11228
14926,1,512,512,512.00,0.00,11227,11228
14927,1,512,512,512.00,0.00,11227,11228
14928,3,289,20,170.67,12582.89,11227,11230
14929,3,298,48,170.67,10427.56,11229,11232
14930,2,400,112,256.00,20736.00,11231,11233
14931,2,314,198,256.00,3364.00,11232,11234
14932,1,512,512,512.00,0.00,11233,11234
14933,2,281,231,256.00,625.00,11233,11235
14934,1,512,512,512.00,0.00,11234,11235
14935,1,512,512,512.00,0.00,11234,11235
14936,2,365,147,256.00,11881.00,11234,11236
14937,1,512,512,512.00,0.00,11235,11236
14938,2,278,234,256.00,484.00,11235,11237
14939,1,512,512,512.00,0.00,11236,11237
14940,2,479,33,256.00,49729.00,11236,11238
14941,1,512,512,512.00,0.00,11237,11238
14942,4,257,2,128.00,14916.50,11237,11241
14943,1,512,512,512.00,0.00,11240,11241
14944,4,389,38,128.00,22716.50,11240,11244
14945,1,512,512,512.00,0.00,11243,11244
14946,1,512,512,512.00,0.00,11243,11244
14947,1,512,512,512.00,0.00,11243,11244
14948,1,512,512,512.00,0.00,11243,11244
14949,1,512,512,512.00,0.00,11243,11244
14950,2,280,232,256.00,576.00,11243,11245
14951,1,512,512,512.00,0.00,11244,11245
14952,1,512,512,512.00,0.00,11244,11245
14953,1,512,512,512.00,0.00,11244,11245
14954,3,319,25,170.67,14409.56,11244,11247
14955,5,188,2,102.40,3959.04,11246,11251
14956,1,512,512,512.00,0.00,11250,11251
14957,1,512,512,512.00,0.00,11250,11251
14958,2,353,159,256.00,9409.00,11250,11252
14959,1,512,512,512.00,0.00,11251,11252
14960,2,381,131,256.00,15625.00,11251,11253
14961,2,376,136,256.00,14400.00,11252,11254
14962,1,512,512,512.00,0.00,11253,11254
14963,4,224,2,128.00,8498.00,11253,11257
14964,1,512,512,512.00,0.00,11256,11257
14965,2,349,163,256.00,8649.00,11256,11258
14966,1,512,512,512.00,0.00,11257,11258
14967,1,512,512,512.00,0.00,11257,11258
14968,1,512,512,512.00,0.00,11257,11258
14969,3,443,10,170.67,37482.89,11257,11260
14970,1,512,512,512.00,0.00,11259,11260
14971,6,245,2,85.33,6634.89,11259,11265
14972,1,512,512,512.00,0.00,11264,11265
14973,2,454,58,256.00,39204.00,11264,11266
14974,5,428,2,102.40,26729.04,11265,11270
14975,6,258,3,85.33,8245.56,11269,11275
14976,1,512,512,512.00,0.00,11274,11275
14977,1,512,512,512.00,0.00,11274,11275
14978,1,512,512,512.00,0.00,11274,11275
14979,5,258,2,102.40,11562.64,11274,11279
14980,2,489,23,256.00,54289.00,11278,11280
14981,2,320,192,256.00,4096.00,11279,11281
14982,1,512,512,512.00,0.00,11280,11281
14983,1,512,512,512.00,0.00,11280,11281
14984,1,512,512,512.00,0.00,11280,11281
14985,3,323,34,170.67,14042.89,11280,11283
14986,4,309,10,128.00,15822.50,11282,11286
14987,1,512,512,512.00,0.00,11285,11286
14988,1,512,512,512.00,0.00,11285,11286
14989,1,512,512,512.00,0.00,11285,11286
14990,1,512,512,512.00,0.00,11285,11286
14991,2,337,175,256.00,6561.00,11285,11287
14992,1,512,512,512.00,0.00,11286,11287
14993,1,512,512,512.00,0.00,11286,11287
14994,1,512,512,512.00,0.00,11286,11287
14995,5,225,7,102.40,5238.24,11286,11291
14996,1,512,512,512.00,0.00,11290,11291
14997,1,512,512,512.00,0.00,11290,11291
14998,2,478,34,256.00,49284.00,11290,11292
14999,4,246,4,128.00,9070.00,11291,11295
15000,1,512,512,512.00,0.00,11294,11295
15001,2,293,219,256.00,1369.00,11294,11296
15002,1,512,512,512.00,0.00,11295,11296
15003,1,512,512,512.00,0.00,11295,11296
15004,3,267,3,170.67,14160.22,11295,11298
15005,2,498,14,256.00,58564.00,11297,11299
15006,2,273,239,256.00,289.00,11298,11300
15007,6,195,4,85.33,6185.89,11299,11305
15008,2,397,115,256.00,19881.00,11304,11306
15009,1,512,512,512.00,0.00,11305,11306
15010,1,512,512,512.00,0.00,11305,11306
15011,4,327,10,128.00,14202.50,11305,11309
15012,1,512,512,512.00,0.00,11308,11309
15013,6,174,11,85.33,3593.89,11308,11314
15014,4,482,4,128.00,41803.50,11313,11317
15015,1,512,512,512.00,0.00,11316,11317
15016,1,512,512,512.00,0.00,11316,11317
15017,1,512,512,512.00,0.00,11316,11317
15018,1,512,512,512.00,0.00,11316,11317
15019,3,422,9,170.67,32448.22,11316,11319
15020,1,512,512,512.00,0.00,11318,11319
15021,1,512,512,512.00,0.00,11318,11319
15022,2,333,179,256.00,5929.00,11318,11320
15023,1,512,512,512.00,0.00,11319,11320
15024,2,265,247,256.00,81.00,11319,11321
15025,3,405,48,170.67,27476.22,11320,11323
15026,1,512,512,512.00,0.00,11322,11323
15027,2,479,33,256.00,49729.00,11322,11324
15028,2,298,214,256.00,1764.00,11323,11325
15029,2,376,136,256.00,14400.00,11324,11326
15030,4,243,23,128.00,9687.50,11325,11329
15031,2,286,226,256.00,900.00,11328,11330
15032,3,315,36,170.67,13020.22,11329,11332
15033,2,505,7,256.00,62001.00,11331,11333
15034,1,512,512,512.00,0.00,11332,11333
15035,1,512,512,512.00,0.00,11332,11333
15036,2,497,15,256.00,58081.00,11332,11334
15037,1,512,512,512.00,0.00,11333,11334
15038,1,512,512,512.00,0.00,11333,11334
15039,1,512,512,512.00,0.00,11333,11334
15040,1,512,512,512.00,0.00,11333,11334
15041,2,271,241,256.00,225.00,11333,11335
15042,2,386,126,256.00,16900.00,11334,11336
15043,1,512,512,512.00,0.00,11335,11336
15044,2,481,31,256.00,50625.00,11335,11337
15045,2,410,102,256.00,23716.00,11336,11338
15046,2,277,235,256.00,441.00,11337,11339
15047,5,272,2,102.40,9889.04,11338,11343
15048,1,512,512,512.00,0.00,11342,11343
15049,1,512,512,512.00,0.00,11342,11343
15050,2,458,54,256.00,40804.00,11342,11344
15051,1,512,512,512.00,0.00,11343,11344
15052,1,512,512,512.00,0.00,11343,11344
15053,2,431,81,256.00,30625.00,11343,11345
15054,2,486,26,256.00,52900.00,11344,11346
15055,1,512,512,512.00,0.00,11345,11346
15056,2,472,40,256.00,46656.00,11345,11347
15057,2,352,160,256.00,9216.00,11346,11348
15058,1,512,512,512.00,0.00,11347,11348
15059,1,512,512,512.00,0.00,11347,11348
15060,1,512,512,512.00,0.00,11347,11348
15061,1,512,512,512.00,0.00,11347,11348
15062,2,480,32,256.00,50176.00,11347,11349
15063,1,512,512,512.00,0.00,11348,11349
15064,1,512,512,512.00,0.00,11348,11349
15065,2,388,124,256.00,17424.00,11348,11350
15066,4,293,11,128.00,10518.50,11349,11353
15067,1,512,512,512.00,0.00,11352,11353
15068,1,512,512,512.00,0.00,11352,11353
15069,3,367,43,170.67,19853.56,11352,11355
15070,2,290,222,256.00,1156.00,11354,11356
15071,2,387,125,256.00,17161.00,11355,11357
15072,2,318,194,256.00,3844.00,11356,11358
15073,2,428,84,256.00,29584.00,11357,11359
15074,4,249,16,128.00,6834.50,11358,11362
15075,3,409,2,170.67,30034.89,11361,11364
15076,1,512,512,512.00,0.00,11363,11364
15077,3,314,2,170.67,16544.89,11363,11366
15078,1,512,512,512.00,0.00,11365,11366
15079,2,505,7,256.00,62001.00,11365,11367
15080,1,512,512,512.00,0.00,11366,11367
15081,2,375,137,256.00,14161.00,11366,11368
15082,2,459,53,256.00,41209.00,11367,11369
15083,2,486,26,256.00,52900.00,11368,11370
15084,4,287,2,128.00,12078.50,11369,11373
15085,3,278,7,170.67,13826.89,11372,11375
15086,2,363,149,256.00,11449.00,11374,11376
15087,1,512,512,512.00,0.00,11375,11376
15088,4,289,3,128.00,16166.50,11375,11379
15089,1,512,512,512.00,0.00,11378,11379
15090,1,512,512,512.00,0.00,11378,11379
15091,1,512,512,512.00,0.00,11378,11379
15092,1,512,512,512.00,0.00,11378,11379
15093,3,449,14,170.67,38938.89,11378,11381
15094,4,484,1,128.00,42316.50,11380,11384
15095,4,310,28,128.00,13303.50,11383,11387
15096,2,323,189,256.00,4489.00,11386,11388
15097,1,512,512,512.00,0.00,11387,11388
15098,1,512,512,512.00,0.00,11387,11388
15099,1,512,512,512.00,0.00,11387,11388
15100,1,512,512,512.00,0.00,11387,11388
15101,1,512,512,512.00,0.00,11387,11388
15102,1,512,512,512.00,0.00,11387,11388
15103,2,356,156,256.00,10000.00,11387,11389
15104,1,512,512,512.00,0.00,11388,11389
15105,1,512,512,512.00,0.00,11388,11389
15106,1,512,512,512.00,0.00,11388,11389
15107,1,512,512,512.00,0.00,11388,11389
15108,1,512,512,512.00,0.00,11388,11389
15109,1,512,512,512.00,0.00,11388,11389
15110,1,512,512,512.00,0.00,11388,11389
15111,2,486,26,256.00,52900.00,11388,11390
15112,1,512,512,512.00,0.00,11389,11390
15113,1,512,512,512.00,0.00,11389,11390
15114,1,512,512,512.00,0.00,11389,11390
15115,4,269,2,128.00,9670.50,11389,11393
15116,1,512,512,512.00,0.00,11392,11393
15117,1,512,512,512.00,0.00,11392,11393
15118,1,512,512,512.00,0.00,11392,11393
15119,1,512,512,512.00,0.00,11392,11393
15120,2,262,250,256.00,36.00,11392,11394
15121,1,512,512,512.00,0.00,11393,11394
15122,2,304,208,256.00,2304.00,11393,11395
15123,1,512,512,512.00,0.00,11394,11395
15124,1,512,512,512.00,0.00,11394,11395
15125,1,512,512,512.00,0.00,11394,11395
15126,4,453,11,128.00,35277.00,11394,11398
15127,3,506,1,170.67,56226.89,11397,11400
15128,3,212,121,170.67,1414.89,11399,11402
15129,1,512,512,512.00,0.00,11401,11402
15130,2,336,176,256.00,6400.00,11401,11403
15131,1,512,512,512.00,0.00,11402,11403
15132,1,512,512,512.00,0.00,11402,11403
15133,1,512,512,512.00,0.00,11402,11403
15134,1,512,512,512.00,0.00,11402,11403
15135,4,302,1,128.00,16248.50,11402,11406
15136,1,512,512,512.00,0.00,11405,11406
15137,1,512,512,512.00,0.00,11405,11406
15138,2,474,38,256.00,47524.00,11405,11407
15139,1,512,512,512.00,0.00,11406,11407
15140,3,405,2,170.67,29224.22,11406,11409
15141,1,512,512,512.00,0.00,11408,11409
15142,1,512,512,512.00,0.00,11408,11409
15143,1,512,512,512.00,0.00,11408,11409
15144,2,423,89,256.00,27889.00,11408,11410
15145,1,512,512,512.00,0.00,11409,11410
15146,1,512,512,512.00,0.00,11409,11410
15147,1,512,512,512.00,0.00,11409,11410
15148,2,303,209,256.00,2209.00,11409,11411
15149,2,492,20,256.00,55696.00,11410,11412
15150,1,512,512,512.00,0.00,11411,11412
15151,4,236,1,128.00,8424.50,11411,11415
15152,3,405,31,170.67,27793.56,11414,11417
15153,1,512,512,512.00,0.00,11416,11417
15154,1,512,512,512.00,0.00,11416,11417
15155,2,485,27,256.00,52441.00,11416,11418
15156,1,512,512,512.00,0.00,11417,11418
15157,1,512,512,512.00,0.00,11417,11418
15158,2,359,153,256.00,10609.00,11417,11419
15159,1,512,512,512.00,0.00,11418,11419
15160,1,512,512,512.00,0.00,11418,11419
15161,2,331,181,256.00,5625.00,11418,11420
15162,1,512,512,512.00,0.00,11419,11420
15163,2,257,255,256.00,1.00,11419,11421
15164,1,512,512,512.00,0.00,11420,11421
15165,2,420,92,256.00,26896.00,11420,11422
15166,4,199,54,128.00,3758.50,11421,11425
15167,2,425,87,256.00,28561.00,11424,11426
15168,5,283,1,102.40,10373.44,11425,11430
15169,1,512,512,512.00,0.00,11429,11430
15170,1,512,512,512.00,0.00,11429,11430
15171,2,323,189,256.00,4489.00,11429,11431
15172,1,512,512,512.00,0.00,11430,11431
15173,1,512,512,512.00,0.00,11430,11431
15174,1,512,512,512.00,0.00,11430,11431
15175,2,356,156,256.00,10000.00,11430,11432
15176,1,512,512,512.00,0.00,11431,11432
15177,1,512,512,512.00,0.00,11431,11432
15178,1,512,512,512.00,0.00,11431,11432
15179,2,301,211,256.00,2025.00,11431,11433
15180,1,512,512,512.00,0.00,11432,11433
15181,1,512,512,512.00,0.00,11432,11433
15182,4,437,8,128.00,32088.50,11432,11436
15183,3,313,14,170.67,15002.89,11435,11438
15184,1,512,512,512.00,0.00,11437,11438
15185,1,512,512,512.00,0.00,11437,11438
15186,1,512,512,512.00,0.00,11437,11438
15187,1,512,512,512.00,0.00,11437,11438
15188,5,415,1,102.40,25618.24,11437,11442
15189,3,451,12,170.67,39521.56,11441,11444
15190,1,512,512,512.00,0.00,11443,11444
15191,2,388,124,256.00,17424.00,11443,11445
15192,1,512,512,512.00,0.00,11444,11445
15193,3,296,2,170.67,15344.89,11444,11447
15194,1,512,512,512.00,0.00,11446,11447
15195,1,512,512,512.00,0.00,11446,11447
15196,1,512,512,512.00,0.00,11446,11447
15197,2,500,12,256.00,59536.00,11446,11448
15198,1,512,512,512.00,0.00,11447,11448
15199,1,512,512,512.00,0.00,11447,11448
15200,1,512,512,512.00,0.00,11447,11448
15201,2,386,126,256.00,16900.00,11447,11449
15202,2,418,94,256.00,26244.00,11448,11450
15203,2,442,70,256.00,34596.00,11449,11451
15204,1,512,512,512.00,0.00,11450,11451
15205,1,512,512,512.00,0.00,11450,11451
15206,2,363,149,256.00,11449.00,11450,11452
15207,1,512,512,512.00,0.00,11451,11452
15208,1,512,512,512.00,0.00,11451,11452
15209,2,400,112,256.00,20736.00,11451,11453
15210,4,242,1,128.00,7393.50,11452,11456
15211,1,512,512,512.00,0.00,11455,11456
15212,1,512,512,512.00,0.00,11455,11456
15213,1,512,512,512.00,0.00,11455,11456
15214,1,512,512,512.00,0.00,11455,11456
15215,3,408,1,170.67,29897.56,11455,11458
15216,2,390,122,256.00,17956.00,11457,11459
15217,1,512,512,512.00,0.00,11458,11459
15218,3,442,30,170.67,36827.56,11458,11461
15219,2,469,43,256.00,45369.00,11460,11462
15220,4,443,5,128.00,33484.50,11461,11465
15221,1,512,512,512.00,0.00,11464,11465
15222,2,395,117,256.00,19321.00,11464,11466
15223,1,512,512,512.00,0.00,11465,11466
15224,2,327,185,256.00,5041.00,11465,11467
15225,1,512,512,512.00,0.00,11466,11467
15226,1,512,512,512.00,0.00,11466,11467
15227,1,512,512,512.00,0.00,11466,11467
15228,1,512,512,512.00,0.00,11466,11467
15229,1,512,512,512.00,0.00,11466,11467
15230,4,231,33,128.00,5974.50,11466,11470
15231,1,512,512,512.00,0.00,11469,11470
15232,2,444,68,256.00,35344.00,11469,11471
15233,1,512,512,512.00,0.00,11470,11471
15234,1,512,512,512.00,0.00,11470,11471
15235,2,506,6,256.00,62500.00,11470,11472
15236,1,512,512,512.00,0.00,11472,11473
15237,4,450,1,128.00,34709.50,11472,11476
15238,2,421,91,256.00,27225.00,11475,11477
15239,5,413,1,102.40,24717.44,11476,11481
15240,3,285,32,170.67,10964.22,11480,11483
15241,1,512,512,512.00,0.00,11482,11483
15242,1,512,512,512.00,0.00,11482,11483
15243,1,512,512,512.00,0.00,11482,11483
15244,3,362,9,170.67,21208.22,11482,11485
15245,4,226,65,128.00,3666.50,11484,11488
15246,3,371,43,170.67,20570.89,11487,11490
15247,3,222,74,170.67,4678.22,11489,11492
15248,3,468,12,170.67,44270.22,11491,11494
15249,1,512,512,512.00,0.00,11493,11494
15250,1,512,512,512.00,0.00,11493,11494
15251,1,512,512,512.00,0.00,11493,11494
15252,1,512,512,512.00,0.00,11493,11494
15253,2,486,26,256.00,52900.00,11493,11495
15254,1,512,512,512.00,0.00,11494,11495
15255,1,512,512,512.00,0.00,11494,11495
15256,1,512,512,512.00,0.00,11494,11495
15257,6,411,1,85.33,22179.56,11494,11500
15258,1,512,512,512.00,0.00,11499,11500
15259,1,512,512,512.00,0.00,11499,11500
15260,1,512,512,512.00,0.00,11499,11500
15261,1,512,512,512.00,0.00,11499,11500
15262,4,213,1,128.00,6279.50,11499,11503
15263,1,512,512,512.00,0.00,11502,11503
15264,2,349,163,256.00,8649.00,11502,11504
15265,1,512,512,512.00,0.00,11503,11504
15266,4,283,15,128.00,11799.50,11503,11507
15267,1,512,512,512.00,0.00,11506,11507
15268,3,441,33,170.67,36544.22,11506,11509
15269,1,512,512,512.00,0.00,11508,11509
15270,3,270,38,170.67,9526.22,11508,11511
15271,1,512,512,512.00,0.00,11510,11511
15272,2,257,255,256.00,1.00,11510,11512
15273,1,512,512,512.00,0.00,11511,11512
15274,1,512,512,512.00,0.00,11511,11512
15275,1,512,512,512.00,0.00,11511,11512
15276,1,512,512,512.00,0.00,11511,11512
15277,1,512,512,512.00,0.00,11511,11512
15278,2,386,126,256.00,16900.00,11511,11513
15279,1,512,512,512.00,0.00,11512,11513
15280,1,512,512,512.00,0.00,11512,11513
15281,2,381,131,256.00,15625.00,11512,11514
15282,1,512,512,512.00,0.00,11513,11514
15283,1,512,512,512.00,0.00,11513,11514
15284,4,308,12,128.00,12088.50,11513,11517
15285,3,428,2,170.67,34176.89,11516,11519
15286,1,512,512,512.00,0.00,11518,11519
15287,7,317,5,73.14,10678.69,11518,11525
15288,1,512,512,512.00,0.00,11524,11525
15289,1,512,512,512.00,0.00,11524,11525
15290,4,354,5,128.00,18507.50,11524,11528
15291,1,512,512,512.00,0.00,11527,11528
15292,1,512,512,512.00,0.00,11527,11528
15293,1,512,512,512.00,0.00,11527,11528
15294,1,512,512,512.00,0.00,11527,11528
15295,2,377,135,256.00,14641.00,11527,11529
15296,5,255,10,102.40,6951.44,11528,11533
15297,2,354,158,256.00,9604.00,11532,11534
15298,1,512,512,512.00,0.00,11533,11534
15299,1,512,512,512.00,0.00,11533,11534
15300,2,456,56,256.00,40000.00,11533,11535
15301,1,512,512,512.00,0.00,11534,11535
15302,1,512,512,512.00,0.00,11534,11535
15303,7,265,4,73.14,7982.12,11534,11541
15304,1,512,512,512.00,0.00,11540,11541
15305,1,512,512,512.00,0.00,11540,11541
15306,1,512,512,512.00,0.00,11540,11541
15307,1,512,512,512.00,0.00,11540,11541
15308,2,460,52,256.00,41616.00,11540,11542
15309,1,512,512,512.00,0.00,11541,11542
15310,1,512,512,512.00,0.00,11541,11542
15311,1,512,512,512.00,0.00,11541,11542
15312,3,382,2,170.67,24976.89,11541,11544
15313,4,435,17,128.00,31462.50,11543,11547
15314,3,362,5,170.67,21570.89,11546,11549
15315,1,512,512,512.00,0.00,11548,11549
15316,1,512,512,512.00,0.00,11548,11549
15317,1,512,512,512.00,0.00,11548,11549
15318,1,512,512,512.00,0.00,11548,11549
15319,1,512,512,512.00,0.00,11548,11549
15320,1,512,512,512.00,0.00,11548,11549
15321,1,512,512,512.00,0.00,11548,11549
15322,1,512,512,512.00,0.00,11548,11549
15323,5,288,6,102.40,10727.44,11548,11553
15324,1,512,512,512.00,0.00,11552,11553
15325,1,512,512,512.00,0.00,11552,11553
15326,2,485,27,256.00,52441.00,11552,11554
15327,1,512,512,512.00,0.00,11553,11554
15328,2,331,181,256.00,5625.00,11553,11555
15329,1,512,512,512.00,0.00,11554,11555
15330,1,512,512,512.00,0.00,11554,11555
15331,2,389,123,256.00,17689.00,11554,11556
15332,1,512,512,512.00,0.00,11555,11556
15333,1,512,512,512.00,0.00,11555,11556
15334,7,263,1,73.14,9564.98,11555,11562
15335,1,512,512,512.00,0.00,11561,11562
15336,2,336,176,256.00,6400.00,11561,11563
15337,2,356,156,256.00,10000.00,11562,11564
15338,1,512,512,512.00,0.00,11563,11564
15339,1,512,512,512.00,0.00,11563,11564
15340,3,309,4,170.67,15905.56,11563,11566
15341,4,259,56,128.00,6297.50,11565,11569
15342,1,512,512,512.00,0.00,11568,11569
15343,1,512,512,512.00,0.00,11568,11569
15344,1,512,512,512.00,0.00,11568,11569
15345,1,512,512,512.00,0.00,11568,11569
15346,2,351,161,256.00,9025.00,11568,11570
15347,4,265,12,128.00,12671.50,11569,11573
15348,1,512,512,512.00,0.00,11572,11573
15349,1,512,512,512.00,0.00,11572,11573
15350,1,512,512,512.00,0.00,11572,11573
15351,3,474,2,170.67,46198.22,11572,11575
15352,3,311,69,170.67,10508.22,11575,11578
15353,1,512,512,512.00,0.00,11577,11578
15354,1,512,512,512.00,0.00,11577,11578
15355,4,302,18,128.00,13770.50,11577,11581
15356,1,512,512,512.00,0.00,11580,11581
15357,1,512,512,512.00,0.00,11580,11581
15358,1,512,512,512.00,0.00,11580,11581
15359,1,512,512,512.00,0.00,11580,11581
15360,4,330,2,128.00,14894.00,11580,11584
15361,5,316,2,102.40,14399.44,11583,11588
15362,4,465,1,128.00,38035.00,11587,11591
15363,2,331,181,256.00,5625.00,11590,11592
15364,2,326,186,256.00,4900.00,11591,11593
15365,1,512,512,512.00,0.00,11592,11593
15366,3,476,14,170.67,46624.89,11592,11595
15367,7,213,1,73.14,6112.12,11594,11601
15368,6,305,2,85.33,10948.89,11600,11606
15369,3,317,27,170.67,14020.22,11605,11608
15370,1,512,512,512.00,0.00,11607,11608
15371,1,512,512,512.00,0.00,11607,11608
15372,4,288,19,128.00,12935.50,11607,11611
15373,2,446,66,256.00,36100.00,11610,11612
15374,3,439,4,170.67,36705.56,11611,11614
15375,5,426,1,102.40,26565.04,11613,11618
15376,2,334,178,256.00,6084.00,11617,11619
15377,2,510,2,256.00,64516.00,11618,11620
15378,1,512,512,512.00,0.00,11619,11620
15379,2,325,187,256.00,4761.00,11619,11621
15380,2,258,254,256.00,4.00,11620,11622
15381,1,512,512,512.00,0.00,11621,11622
15382,2,280,232,256.00,576.00,11621,11623
15383,2,336,176,256.00,6400.00,11622,11624
15384,5,232,2,102.40,6269.84,11623,11628
15385,3,385,10,170.67,24877.56,11627,11630
15386,5,342,3,102.40,15710.64,11629,11634
15387,1,512,512,512.00,0.00,11633,11634
15388,1,512,512,512.00,0.00,11633,11634
15389,2,260,252,256.00,16.00,11633,11635
15390,1,512,512,512.00,0.00,11634,11635
15391,3,283,51,170.67,8997.56,11634,11637
15392,1,512,512,512.00,0.00,11636,11637
15393,1,512,512,512.00,0.00,11636,11637
15394,1,512,512,512.00,0.00,11636,11637
15395,2,456,56,256.00,40000.00,11636,11638
15396,1,512,512,512.00,0.00,11637,11638
15397,4,372,35,128.00,19932.50,11637,11641
15398,1,512,512,512.00,0.00,11640,11641
15399,1,512,512,512.00,0.00,11640,11641
15400,1,512,512,512.00,0.00,11640,11641
15401,1,512,512,512.00,0.00,11640,11641
15402,3,260,43,170.67,8582.89,11640,11643
15403,1,512,512,512.00,0.00,11642,11643
15404,1,512,512,512.00,0.00,11642,11643
15405,1,512,512,512.00,0.00,11642,11643
15406,2,356,156,256.00,10000.00,11642,11644
15407,9,255,3,56.89,5795.43,11643,11652
15408,2,406,106,256.00,22500.00,11651,11653
15409,3,336,65,170.67,14020.22,11652,11655
15410,1,512,512,512.00,0.00,11654,11655
15411,2,503,9,256.00,61009.00,11654,11656
15412,1,512,512,512.00,0.00,11655,11656
15413,4,194,21,128.00,4791.50,11655,11659
15414,1,512,512,512.00,0.00,11658,11659
15415,1,512,512,512.00,0.00,11658,11659
15416,3,267,1,170.67,14481.56,11658,11661
15417,1,512,512,512.00,0.00,11660,11661
15418,1,512,512,512.00,0.00,11660,11661
15419,1,512,512,512.00,0.00,11660,11661
15420,1,512,512,512.00,0.00,11660,11661
15421,3,309,82,170.67,9821.56,11660,11663
15422,1,512,512,512.00,0.00,11662,11663
15423,1,512,512,512.00,0.00,11662,11663
15424,3,218,107,170.67,2186.89,11662,11665
15425,1,512,512,512.00,0.00,11664,11665
15426,2,263,249,256.00,49.00,11664,11666
15427,1,512,512,512.00,0.00,11665,11666
15428,1,512,512,512.00,0.00,11665,11666
15429,1,512,512,512.00,0.00,11665,11666
15430,2,313,199,256.00,3249.00,11665,11667
15431,1,512,512,512.00,0.00,11666,11667
15432,1,512,512,512.00,0.00,11666,11667
15433,1,512,512,512.00,0.00,11666,11667
15434,5,424,2,102.40,25983.44,11666,11671
15435,2,285,227,256.00,841.00,11670,11672
15436,1,512,512,512.00,0.00,11671,11672
15437,2,403,109,256.00,21609.00,11671,11673
15438,1,512,512,512.00,0.00,11672,11673
15439,2,345,167,256.00,7921.00,11672,11674
15440,4,243,3,128.00,10837.50,11673,11677
15441,1,512,512,512.00,0.00,11676,11677
15442,1,512,512,512.00,0.00,11676,11677
15443,1,512,512,512.00,0.00,11676,11677
15444,8,266,1,64.00,9721.00,11676,11684
15445,6,377,2,85.33,18494.89,11683,11689
15446,1,512,512,512.00,0.00,11688,11689
15447,1,512,512,512.00,0.00,11688,11689
15448,2,469,43,256.00,45369.00,11688,11690
15449,2,269,243,256.00,169.00,11689,11691
15450,1,512,512,512.00,0.00,11690,11691
15451,1,512,512,512.00,0.00,11690,11691
15452,1,512,512,512.00,0.00,11690,11691
15453,1,512,512,512.00,0.00,11690,11691
15454,1,512,512,512.00,0.00,11690,11691
15455,3,494,8,170.67,52272.89,11690,11693
15456,2,367,145,256.00,12321.00,11692,11694
15457,1,512,512,512.00,0.00,11693,11694
15458,1,512,512,512.00,0.00,11693,11694
15459,2,366,146,256.00,12100.00,11693,11695
15460,4,398,1,128.00,24816.50,11694,11698
15461,1,512,512,512.00,0.00,11697,11698
15462,1,512,512,512.00,0.00,11697,11698
15463,1,512,512,512.00,0.00,11697,11698
15464,1,512,512,512.00,0.00,11697,11698
15465,1,512,512,512.00,0.00,11697,11698
15466,2,361,151,256.00,11025.00,11697,11699
15467,2,459,53,256.00,41209.00,11698,11700
15468,1,512,512,512.00,0.00,11699,11700
15469,2,282,230,256.00,676.00,11699,11701
15470,5,293,1,102.40,10303.04,11700,11705
15471,3,504,4,170.67,55555.56,11704,11707
15472,2,484,28,256.00,51984.00,11706,11708
15473,1,512,512,512.00,0.00,11707,11708
15474,5,245,1,102.40,9923.04,11707,11712
15475,4,261,2,128.00,11400.50,11711,11715
15476,5,207,33,102.40,4637.44,11714,11719
15477,4,216,18,128.00,6534.00,11718,11722
15478,1,512,512,512.00,0.00,11721,11722
15479,1,512,512,512.00,0.00,11721,11722
15480,2,449,63,256.00,37249.00,11721,11723
15481,4,338,36,128.00,15009.50,11722,11726
15482,1,512,512,512.00,0.00,11725,11726
15483,1,512,512,512.00,0.00,11725,11726
15484,2,309,203,256.00,2809.00,11725,11727
15485,1,512,512,512.00,0.00,11726,11727
15486,1,512,512,512.00,0.00,11726,11727
15487,2,397,115,256.00,19881.00,11726,11728
15488,1,512,512,512.00,0.00,11727,11728
15489,1,512,512,512.00,0.00,11727,11728
15490,1,512,512,512.00,0.00,11727,11728
15491,1,512,512,512.00,0.00,11727,11728
15492,3,336,63,170.67,14084.22,11727,11730
15493,1,512,512,512.00,0.00,11729,11730
15494,1,512,512,512.00,0.00,11729,11730
15495,4,324,6,128.00,17290.00,11729,11733
15496,1,512,512,512.00,0.00,11732,11733
15497,2,351,161,256.00,9025.00,11732,11734
15498,2,379,133,256.00,15129.00,11733,11735
15499,3,264,7,170.67,13481.56,11734,11737
15500,1,512,512,512.00,0.00,11736,11737
15501,2,477,35,256.00,48841.00,11736,11738
15502,5,211,6,102.40,5355.44,11737,11742
15503,1,512,512,512.00,0.00,11741,11742
15504,6,196,17,85.33,4259.89,11741,11747
15505,3,250,20,170.67,11360.89,11746,11749
15506,1,512,512,512.00,0.00,11748,11749
15507,1,512,512,512.00,0.00,11748,11749
15508,2,348,164,256.00,8464.00,11748,11750
15509,3,455,3,170.67,40856.22,11749,11752
15510,1,512,512,512.00,0.00,11751,11752
15511,1,512,512,512.00,0.00,11751,11752
15512,2,380,132,256.00,15376.00,11751,11753
15513,1,512,512,512.00,0.00,11752,11753
15514,1,512,512,512.00,0.00,11752,11753
15515,3,495,3,170.67,52616.22,11752,11755
15516,2,284,228,256.00,784.00,11754,11756
15517,1,512,512,512.00,0.00,11755,11756
15518,1,512,512,512.00,0.00,11755,11756
15519,1,512,512,512.00,0.00,11755,11756
15520,1,512,512,512.00,0.00,11755,11756
15521,2,502,10,256.00,60516.00,11755,11757
15522,1,512,512,512.00,0.00,11756,11757
15523,3,392,6,170.67,26438.22,11756,11759
15524,3,281,111,170.67,6100.22,11758,11761
15525,1,512,512,512.00,0.00,11760,11761
15526,1,512,512,512.00,0.00,11760,11761
15527,1,512,512,512.00,0.00,11760,11761
15528,1,512,512,512.00,0.00,11760,11761
15529,1,512,512,512.00,0.00,11760,11761
15530,3,410,36,170.67,28790.22,11760,11763
15531,1,512,512,512.00,0.00,11762,11763
15532,1,512,512,512.00,0.00,11762,11763
15533,1,512,512,512.00,0.00,11762,11763
15534,2,460,52,256.00,41616.00,11762,11764
15535,3,318,23,170.67,14504.22,11763,11766
15536,1,512,512,512.00,0.00,11765,11766
15537,2,334,178,256.00,6084.00,11765,11767
15538,1,512,512,512.00,0.00,11766,11767
15539,4,266,45,128.00,7357.50,11766,11770
15540,5,280,1,102.40,10524.24,11769,11774
15541,4,216,77,128.00,2785.50,11773,11777
15542,1,512,512,512.00,0.00,11776,11777
15543,6,352,13,85.33,14619.22,11776,11782
15544,3,323,59,170.67,12442.89,11781,11784
15545,1,512,512,512.00,0.00,11783,11784
15546,1,512,512,512.00,0.00,11783,11784
15547,1,512,512,512.00,0.00,11783,11784
15548,1,512,512,512.00,0.00,11783,11784
15549,2,480,32,256.00,50176.00,11783,11785
15550,1,512,512,512.00,0.00,11784,11785
15551,1,512,512,512.00,0.00,11784,11785
15552,1,512,512,512.00,0.00,11784,11785
15553,6,346,4,85.33,14327.89,11784,11790
15554,9,297,3,56.89,7586.10,11789,11798
15555,1,512,512,512.00,0.00,11797,11798
15556,1,512,512,512.00,0.00,11797,11798
15557,2,387,125,256.00,17161.00,11797,11799
15558,2,456,56,256.00,40000.00,11798,11800
15559,1,512,512,512.00,0.00,11799,11800
15560,3,354,8,170.67,20166.22,11799,11802
15561,1,512,512,512.00,0.00,11801,11802
15562,2,419,93,256.00,26569.00,11801,11803
15563,4,337,2,128.00,15870.50,11802,11806
15564,1,512,512,512.00,0.00,11805,11806
15565,1,512,512,512.00,0.00,11805,11806
15566,1,512,512,512.00,0.00,11805,11806
15567,1,512,512,512.00,0.00,11805,11806
15568,2,309,203,256.00,2809.00,11805,11807
15569,1,512,512,512.00,0.00,11806,11807
15570,1,512,512,512.00,0.00,11806,11807
15571,1,512,512,512.00,0.00,11806,11807
15572,1,512,512,512.00,0.00,11806,11807
15573,1,512,512,512.00,0.00,11806,11807
15574,4,367,1,128.00,21621.00,11806,11810
15575,2,281,231,256.00,625.00,11809,11811
15576,4,379,2,128.00,23212.50,11810,11814
15577,3,240,86,170.67,4070.22,11813,11816
15578,3,204,154,170.67,555.56,11815,11818
15579,1,512,512,512.00,0.00,11817,11818
15580,1,512,512,512.00,0.00,11817,11818
15581,1,512,512,512.00,0.00,11817,11818
15582,3,384,19,170.67,24105.56,11817,11820
15583,3,461,3,170.67,42484.22,11819,11822
15584,2,321,191,256.00,4225.00,11821,11823
15585,4,312,1,128.00,13463.50,11822,11826
15586,1,512,512,512.00,0.00,11825,11826
15587,1,512,512,512.00,0.00,11825,11826
15588,1,512,512,512.00,0.00,11825,11826
15589,1,512,512,512.00,0.00,11825,11826
15590,2,277,235,256.00,441.00,11825,11827
15591,2,315,197,256.00,3481.00,11826,11828
15592,1,512,512,512.00,0.00,11827,11828
15593,4,391,1,128.00,25318.50,11827,11831
15594,1,512,512,512.00,0.00,11830,11831
15595,1,512,512,512.00,0.00,11830,11831
15596,2,265,247,256.00,81.00,11830,11832
15597,6,199,34,85.33,3113.56,11831,11837
15598,1,512,512,512.00,0.00,11836,11837
15599,1,512,512,512.00,0.00,11836,11837
15600,1,512,512,512.00,0.00,11836,11837
15601,1,512,512,512.00,0.00,11836,11837
15602,6,224,4,85.33,6270.22,11836,11842
15603,8,300,1,64.00,10068.25,11841,11849
15604,2,426,86,256.00,28900.00,11848,11850
15605,1,512,512,512.00,0.00,11849,11850
15606,5,352,2,102.40,18408.24,11849,11854
15607,4,272,1,128.00,9330.50,11853,11857
15608,2,411,101,256.00,24025.00,11856,11858
15609,1,512,512,512.00,0.00,11857,11858
15610,1,512,512,512.00,0.00,11857,11858
15611,1,512,512,512.00,0.00,11857,11858
15612,6,240,5,85.33,5945.22,11857,11863
15613,6,366,5,85.33,16309.89,11862,11868
15614,1,512,512,512.00,0.00,11867,11868
15615,1,512,512,512.00,0.00,11867,11868
15616,1,512,512,512.00,0.00,11867,11868
15617,1,512,512,512.00,0.00,11867,11868
15618,1,512,512,512.00,0.00,11867,11868
15619,3,287,6,170.67,14328.22,11867,11870
15620,1,512,512,512.00,0.00,11869,11870
15621,1,512,512,512.00,0.00,11869,11870
15622,1,512,512,512.00,0.00,11869,11870
15623,1,512,512,512.00,0.00,11869,11870
15624,3,389,26,170.67,24674.89,11869,11872
15625,1,512,512,512.00,0.00,11871,11872
15626,1,512,512,512.00,0.00,11871,11872
15627,1,512,512,512.00,0.00,11871,11872
15628,1,512,512,512.00,0.00,11871,11872
15629,2,309,203,256.00,2809.00,11871,11873
15630,1,512,512,512.00,0.00,11872,11873
15631,1,512,512,512.00,0.00,11872,11873
15632,3,284,1,170.67,14934.89,11872,11875
15633,1,512,512,512.00,0.00,11874,11875
15634,1,512,512,512.00,0.00,11874,11875
15635,1,512,512,512.00,0.00,11874,11875
15636,1,512,512,512.00,0.00,11874,11875
15637,2,358,154,256.00,10404.00,11874,11876
15638,2,505,7,256.00,62001.00,11875,11877
15639,5,310,2,102.40,13046.64,11876,11881
15640,1,512,512,512.00,0.00,11880,11881
15641,1,512,512,512.00,0.00,11880,11881
15642,2,269,243,256.00,169.00,11880,11882
15643,1,512,512,512.00,0.00,11881,11882
15644,1,512,512,512.00,0.00,11881,11882
15645,1,512,512,512.00,0.00,11881,11882
15646,1,512,512,512.00,0.00,11881,11882
15647,1,512,512,512.00,0.00,11881,11882
15648,1,512,512,512.00,0.00,11881,11882
15649,1,512,512,512.00,0.00,11881,11882
15650,1,512,512,512.00,0.00,11881,11882
15651,4,351,1,128.00,20429.00,11881,11885
15652,3,250,57,170.67,6797.56,11884,11887
15653,1,512,512,512.00,0.00,11886,11887
15654,7,189,2,73.14,5353.55,11886,11893
15655,3,376,1,170.67,24073.56,11892,11895
15656,1,512,512,512.00,0.00,11894,11895
15657,1,512,512,512.00,0.00,11894,11895
15658,1,512,512,512.00,0.00,11894,11895
15659,1,512,512,512.00,0.00,11894,11895
15660,1,512,512,512.00,0.00,11894,11895
15661,1,512,512,512.00,0.00,11894,11895
15662,1,512,512,512.00,0.00,11894,11895
15663,2,485,27,256.00,52441.00,11894,11896
15664,5,219,21,102.40,7432.64,11895,11900
15665,1,512,512,512.00,0.00,11899,11900
15666,1,512,512,512.00,0.00,11899,11900
15667,1,512,512,512.00,0.00,11899,11900
15668,1,512,512,512.00,0.00,11899,11900
15669,1,512,512,512.00,0.00,11899,11900
15670,3,403,26,170.67,27530.89,11899,11902
15671,4,332,7,128.00,16578.50,11901,11905
15672,1,512,512,512.00,0.00,11904,11905
15673,2,472,40,256.00,46656.00,11904,11906
15674,2,335,177,256.00,6241.00,11905,11907
15675,2,405,107,256.00,22201.00,11906,11908
15676,1,512,512,512.00,0.00,11907,11908
15677,1,512,512,512.00,0.00,11907,11908
15678,1,512,512,512.00,0.00,11907,11908
15679,1,512,512,512.00,0.00,11907,11908
15680,5,250,6,102.40,8026.24,11907,11912
15681,1,512,512,512.00,0.00,11911,11912
15682,1,512,512,512.00,0.00,11911,11912
15683,1,512,512,512.00,0.00,11911,11912
15684,1,512,512,512.00,0.00,11911,11912
15685,1,512,512,512.00,0.00,11911,11912
15686,1,512,512,512.00,0.00,11911,11912
15687,1,512,512,512.00,0.00,11911,11912
15688,1,512,512,512.00,0.00,11911,11912
15689,2,328,184,256.00,5184.00,11911,11913
15690,4,254,26,128.00,8502.50,11912,11916
15691,1,512,512,512.00,0.00,11915,11916
15692,1,512,512,512.00,0.00,11915,11916
15693,4,250,33,128.00,7608.50,11915,11919
15694,2,460,52,256.00,41616.00,11918,11920
15695,3,461,18,170.67,42184.22,11919,11922
15696,1,512,512,512.00,0.00,11921,11922
15697,2,313,199,256.00,3249.00,11921,11923
15698,2,503,9,256.00,61009.00,11922,11924
15699,1,512,512,512.00,0.00,11924,11925
15700,5,297,2,102.40,14446.64,11924,11929
15701,1,512,512,512.00,0.00,11928,11929
15702,1,512,512,512.00,0.00,11928,11929
15703,1,512,512,512.00,0.00,11928,11929
15704,1,512,512,512.00,0.00,11928,11929
15705,1,512,512,512.00,0.00,11928,11929
15706,3,437,3,170.67,36260.22,11928,11931
15707,1,512,512,512.00,0.00,11930,11931
15708,3,267,12,170.67,12780.22,11930,11933
15709,5,232,4,102.40,6312.24,11932,11937
15710,1,512,512,512.00,0.00,11936,11937
15711,1,512,512,512.00,0.00,11936,11937
15712,1,512,512,512.00,0.00,11936,11937
15713,1,512,512,512.00,0.00,11936,11937
15714,1,512,512,512.00,0.00,11936,11937
15715,1,512,512,512.00,0.00,11936,11937
15716,1,512,512,512.00,0.00,11936,11937
15717,1,512,512,512.00,0.00,11936,11937
15718,2,454,58,256.00,39204.00,11936,11938
15719,1,512,512,512.00,0.00,11937,11938
15720,2,485,27,256.00,52441.00,11937,11939
15721,5,240,4,102.40,11190.64,11938,11943
15722,5,155,31,102.40,1910.64,11942,11947
15723,1,512,512,512.00,0.00,11946,11947
15724,3,283,77,170.67,7246.89,11946,11949
15725,1,512,512,512.00,0.00,11948,11949
15726,3,344,38,170.67,16432.89,11948,11951
15727,1,512,512,512.00,0.00,11950,11951
15728,2,471,41,256.00,46225.00,11950,11952
15729,1,512,512,512.00,0.00,11951,11952
15730,5,150,34,102.40,1664.64,11951,11956
15731,2,420,92,256.00,26896.00,11955,11957
15732,1,512,512,512.00,0.00,11956,11957
15733,1,512,512,512.00,0.00,11956,11957
15734,1,512,512,512.00,0.00,11956,11957
15735,1,512,512,512.00,0.00,11956,11957
15736,1,512,512,512.00,0.00,11956,11957
15737,1,512,512,512.00,0.00,11956,11957
15738,6,193,10,85.33,4156.89,11956,11962
15739,1,512,512,512.00,0.00,11961,11962
15740,1,512,512,512.00,0.00,11961,11962
15741,1,512,512,512.00,0.00,11961,11962
15742,2,439,73,256.00,33489.00,11961,11963
15743,3,306,66,170.67,10070.22,11962,11965
15744,1,512,512,512.00,0.00,11964,11965
15745,1,512,512,512.00,0.00,11964,11965
15746,1,512,512,512.00,0.00,11964,11965
15747,1,512,512,512.00,0.00,11964,11965
15748,2,306,206,256.00,2500.00,11964,11966
15749,1,512,512,512.00,0.00,11965,11966
15750,2,317,195,256.00,3721.00,11965,11967
15751,1,512,512,512.00,0.00,11966,11967
15752,2,489,23,256.00,54289.00,11966,11968
15753,1,512,512,512.00,0.00,11967,11968
15754,1,512,512,512.00,0.00,11967,11968
15755,7,242,3,73.14,8656.41,11967,11974
15756,2,508,4,256.00,63504.00,11973,11975
15757,1,512,512,512.00,0.00,11974,11975
15758,1,512,512,512.00,0.00,11974,11975
15759,1,512,512,512.00,0.00,11974,11975
15760,1,512,512,512.00,0.00,11974,11975
15761,1,512,512,512.00,0.00,11974,11975
15762,1,512,512,512.00,0.00,11974,11975
15763,1,512,512,512.00,0.00,11974,11975
15764,1,512,512,512.00,0.00,11974,11975
15765,3,418,3,170.67,31877.56,11974,11977
15766,1,512,512,512.00,0.00,11976,11977
15767,1,512,512,512.00,0.00,11976,11977
15768,2,258,254,256.00,4.00,11976,11978
15769,2,471,41,256.00,46225.00,11977,11979
15770,1,512,512,512.00,0.00,11978,11979
15771,1,512,512,512.00,0.00,11978,11979
15772,1,512,512,512.00,0.00,11978,11979
15773,2,454,58,256.00,39204.00,11978,11980
15774,3,318,4,170.67,16619.56,11979,11982
15775,1,512,512,512.00,0.00,11981,11982
15776,1,512,512,512.00,0.00,11981,11982
15777,1,512,512,512.00,0.00,11981,11982
15778,1,512,512,512.00,0.00,11981,11982
15779,2,286,226,256.00,900.00,11981,11983
15780,1,512,512,512.00,0.00,11982,11983
15781,1,512,512,512.00,0.00,11982,11983
15782,4,373,8,128.00,21087.50,11982,11986
15783,1,512,512,512.00,0.00,11985,11986
15784,2,500,12,256.00,59536.00,11985,11987
15785,1,512,512,512.00,0.00,11986,11987
15786,2,425,87,256.00,28561.00,11986,11988
15787,1,512,512,512.00,0.00,11987,11988
15788,1,512,512,512.00,0.00,11987,11988
15789,1,512,512,512.00,0.00,11987,11988
15790,2,398,114,256.00,20164.00,11987,11989
15791,1,512,512,512.00,0.00,11988,11989
15792,1,512,512,512.00,0.00,11988,11989
15793,2,343,169,256.00,7569.00,11988,11990
15794,1,512,512,512.00,0.00,11989,11990
15795,1,512,512,512.00,0.00,11989,11990
15796,1,512,512,512.00,0.00,11989,11990
15797,1,512,512,512.00,0.00,11989,11990
15798,1,512,512,512.00,0.00,11989,11990
15799,1,512,512,512.00,0.00,11989,11990
15800,2,355,157,256.00,9801.00,11989,11991
15801,1,512,512,512.00,0.00,11990,11991
15802,1,512,512,512.00,0.00,11990,11991
15803,1,512,512,512.00,0.00,11990,11991
15804,1,512,512,512.00,0.00,11990,11991
15805,1,512,512,512.00,0.00,11990,11991
15806,3,265,6,170.67,13653.56,11990,11993
15807,1,512,512,512.00,0.00,11992,11993
15808,1,512,512,512.00,0.00,11992,11993
15809,1,512,512,512.00,0.00,11992,11993
15810,1,512,512,512.00,0.00,11992,11993
15811,1,512,512,512.00,0.00,11992,11993
15812,1,512,512,512.00,0.00,11992,11993
15813,6,413,2,85.33,21604.89,11992,11998
15814,1,512,512,512.00,0.00,11997,11998
15815,1,512,512,512.00,0.00,11997,11998
15816,1,512,512,512.00,0.00,11997,11998
15817,2,492,20,256.00,55696.00,11997,11999
15818,3,259,24,170.67,10905.56,11998,12001
15819,2,332,180,256.00,5776.00,12000,12002
15820,2,327,185,256.00,5041.00,12001,12003
15821,3,297,47,170.67,10420.22,12002,12005
15822,9,198,1,56.89,4225.88,12004,12013
15823,5,326,2,102.40,13770.24,12013,12018
15824,3,376,9,170.67,23401.56,12017,12020
15825,3,441,32,170.67,36548.22,12019,12022
15826,2,391,121,256.00,18225.00,12021,12023
15827,1,512,512,512.00,0.00,12022,12023
15828,2,397,115,256.00,19881.00,12022,12024
15829,5,433,3,102.40,27499.84,12023,12028
15830,3,194,131,170.67,794.89,12027,12030
15831,2,322,190,256.00,4356.00,12029,12031
15832,2,397,115,256.00,19881.00,12030,12032
15833,1,512,512,512.00,0.00,12031,12032
15834,1,512,512,512.00,0.00,12031,12032
15835,3,424,44,170.67,32088.89,12031,12034
15836,1,512,512,512.00,0.00,12033,12034
15837,6,323,4,85.33,12749.89,12033,12039
15838,1,512,512,512.00,0.00,12038,12039
15839,1,512,512,512.00,0.00,12038,12039
15840,3,346,51,170.67,16053.56,12038,12041
15841,1,512,512,512.00,0.00,12040,12041
15842,4,291,6,128.00,10678.50,12040,12044
15843,2,309,203,256.00,2809.00,12043,12045
15844,1,512,512,512.00,0.00,12044,12045
15845,1,512,512,512.00,0.00,12044,12045
15846,1,512,512,512.00,0.00,12044,12045
15847,3,363,7,170.67,21533.56,12044,12047
15848,1,512,512,512.00,0.00,12046,12047
15849,4,437,6,128.00,32067.50,12046,12050
15850,1,512,512,512.00,0.00,12049,12050
15851,1,512,512,512.00,0.00,12049,12050
15852,4,229,25,128.00,6715.50,12049,12053
15853,4,222,28,128.00,4826.00,12052,12056
15854,1,512,512,512.00,0.00,12055,12056
15855,4,246,17,128.00,7513.50,12055,12059
15856,1,512,512,512.00,0.00,12058,12059
15857,1,512,512,512.00,0.00,12058,12059
15858,1,512,512,512.00,0.00,12058,12059
15859,1,512,512,512.00,0.00,12058,12059
15860,1,512,512,512.00,0.00,12058,12059
15861,2,340,172,256.00,7056.00,12058,12060
15862,5,285,3,102.40,13450.24,12059,12064
15863,1,512,512,512.00,0.00,12063,12064
15864,1,512,512,512.00,0.00,12063,12064
15865,1,512,512,512.00,0.00,12063,12064
15866,1,512,512,512.00,0.00,12063,12064
15867,2,350,162,256.00,8836.00,12063,12065
15868,2,362,150,256.00,11236.00,12064,12066
15869,1,512,512,512.00,0.00,12065,12066
15870,1,512,512,512.00,0.00,12065,12066
15871,1,512,512,512.00,0.00,12065,12066
15872,1,512,512,512.00,0.00,12065,12066
15873,1,512,512,512.00,0.00,12065,12066
15874,1,512,512,512.00,0.00,12065,12066
15875,1,512,512,512.00,0.00,12065,12066
15876,2,444,68,256.00,35344.00,12065,12067
15877,1,512,512,512.00,0.00,12066,12067
15878,1,512,512,512.00,0.00,12066,12067
15879,1,512,512,512.00,0.00,12066,12067
15880,5,193,17,102.40,4853.04,12066,12071
15881,3,231,112,170.67,2361.56,12070,12073
15882,1,512,512,512.00,0.00,12072,12073
15883,2,425,87,256.00,28561.00,12072,12074
15884,2,484,28,256.00,51984.00,12073,12075
15885,3,271,3,170.67,14237.56,12074,12077
15886,1,512,512,512.00,0.00,12076,12077
15887,1,512,512,512.00,0.00,12076,12077
15888,1,512,512,512.00,0.00,12076,12077
15889,4,345,10,128.00,17258.50,12076,12080
15890,1,512,512,512.00,0.00,12079,12080
15891,1,512,512,512.00,0.00,12079,12080
15892,1,512,512,512.00,0.00,12079,12080
15893,1,512,512,512.00,0.00,12079,12080
15894,3,445,24,170.67,37689.56,12079,12082
15895,1,512,512,512.00,0.00,12081,12082
15896,1,512,512,512.00,0.00,12081,12082
15897,1,512,512,512.00,0.00,12081,12082
15898,3,416,26,170.67,30416.89,12081,12084
15899,1,512,512,512.00,0.00,12083,12084
15900,1,512,512,512.00,0.00,12083,12084
15901,2,499,13,256.00,59049.00,12083,12085
15902,2,500,12,256.00,59536.00,12084,12086
15903,1,512,512,512.00,0.00,12085,12086
15904,1,512,512,512.00,0.00,12085,12086
15905,1,512,512,512.00,0.00,12085,12086
15906,1,512,512,512.00,0.00,12085,12086
15907,1,512,512,512.00,0.00,12085,12086
15908,1,512,512,512.00,0.00,12085,12086
15909,2,487,25,256.00,53361.00,12085,12087
15910,4,294,2,128.00,16676.00,12086,12090
15911,1,512,512,512.00,0.00,12089,12090
15912,1,512,512,512.00,0.00,12089,12090
15913,2,343,169,256.00,7569.00,12089,12091
15914,1,512,512,512.00,0.00,12090,12091
15915,2,278,234,256.00,484.00,12090,12092
15916,1,512,512,512.00,0.00,12091,12092
15917,1,512,512,512.00,0.00,12091,12092
15918,1,512,512,512.00,0.00,12091,12092
15919,1,512,512,512.00,0.00,12091,12092
15920,1,512,512,512.00,0.00,12091,12092
15921,1,512,512,512.00,0.00,12091,12092
15922,1,512,512,512.00,0.00,12091,12092
15923,2,341,171,256.00,7225.00,12091,12093
15924,2,407,105,256.00,22801.00,12092,12094
15925,1,512,512,512.00,0.00,12093,12094
15926,1,512,512,512.00,0.00,12093,12094
15927,5,405,6,102.40,23048.64,12093,12098
15928,1,512,512,512.00,0.00,12097,12098
15929,3,457,2,170.67,41426.89,12097,12100
15930,1,512,512,512.00,0.00,12099,12100
15931,1,512,512,512.00,0.00,12099,12100
15932,1,512,512,512.00,0.00,12099,12100
15933,1,512,512,512.00,0.00,12099,12100
15934,1,512,512,512.00,0.00,12099,12100
15935,3,299,6,170.67,14968.22,12099,12102
15936,1,512,512,512.00,0.00,12101,12102
15937,1,512,512,512.00,0.00,12101,12102
15938,1,512,512,512.00,0.00,12101,12102
15939,1,512,512,512.00,0.00,12101,12102
15940,1,512,512,512.00,0.00,12101,12102
15941,1,512,512,512.00,0.00,12101,12102
15942,1,512,512,512.00,0.00,12101,12102
15943,3,369,53,170.67,19896.22,12101,12104
15944,2,457,55,256.00,40401.00,12103,12105
15945,1,512,512,512.00,0.00,12104,12105
15946,1,512,512,512.00,0.00,12104,12105
15947,1,512,512,512.00,0.00,12104,12105
15948,1,512,512,512.00,0.00,12104,12105
15949,1,512,512,512.00,0.00,12104,12105
15950,2,303,209,256.00,2209.00,12104,12106
15951,1,512,512,512.00,0.00,12105,12106
15952,1,512,512,512.00,0.00,12105,12106
15953,1,512,512,512.00,0.00,12105,12106
15954,4,262,19,128.00,11908.50,12105,12109
15955,3,256,11,170.67,12766.89,12108,12111
15956,1,512,512,512.00,0.00,12110,12111
15957,1,512,512,512.00,0.00,12110,12111
15958,1,512,512,512.00,0.00,12110,12111
15959,1,512,512,512.00,0.00,12110,12111
15960,1,512,512,512.00,0.00,12110,12111
15961,1,512,512,512.00,0.00,12110,12111
15962,1,512,512,512.00,0.00,12110,12111
15963,2,401,111,256.00,21025.00,12110,12112
15964,1,512,512,512.00,0.00,12111,12112
15965,1,512,512,512.00,0.00,12111,12112
15966,1,512,512,512.00,0.00,12111,12112
15967,1,512,512,512.00,0.00,12111,12112
15968,3,362,54,170.67,18598.22,12111,12114
15969,5,254,19,102.40,8421.04,12113,12118
15970,3,293,66,170.67,8744.22,12117,12120
15971,9,225,2,56.89,7832.54,12119,12128
15972,2,296,216,256.00,1600.00,12127,12129
15973,3,408,25,170.67,28649.56,12128,12131
15974,1,512,512,512.00,0.00,12130,12131
15975,2,428,84,256.00,29584.00,12130,12132
15976,1,512,512,512.00,0.00,12131,12132
15977,1,512,512,512.00,0.00,12131,12132
15978,1,512,512,512.00,0.00,12131,12132
15979,1,512,512,512.00,0.00,12131,12132
15980,1,512,512,512.00,0.00,12131,12132
15981,3,369,7,170.67,22441.56,12131,12134
15982,1,512,512,512.00,0.00,12133,12134
15983,1,512,512,512.00,0.00,12133,12134
15984,2,304,208,256.00,2304.00,12133,12135
15985,1,512,512,512.00,0.00,12134,12135
15986,1,512,512,512.00,0.00,12134,12135
15987,1,512,512,512.00,0.00,12134,12135
15988,1,512,512,512.00,0.00,12134,12135
15989,2,398,114,256.00,20164.00,12134,12136
15990,1,512,512,512.00,0.00,12135,12136
15991,3,438,26,170.67,35814.22,12135,12138
15992,2,275,237,256.00,361.00,12137,12139
15993,1,512,512,512.00,0.00,12138,12139
15994,1,512,512,512.00,0.00,12138,12139
15995,1,512,512,512.00,0.00,12138,12139
15996,1,512,512,512.00,0.00,12138,12139
15997,2,349,163,256.00,8649.00,12138,12140
15998,1,512,512,512.00,0.00,12139,12140
15999,1,512,512,512.00,0.00,12139,12140
16000,1,512,512,512.00,0.00,12139,12140
16001,1,512,512,512.00,0.00,12139,12140
16002,1,512,512,512.00,0.00,12139,12140
16003,2,510,2,256.00,64516.00,12139,12141
16004,1,512,512,512.00,0.00,12140,12141
16005,1,512,512,512.00,0.00,12140,12141
16006,1,512,512,512.00,0.00,12140,12141
16007,2,266,246,256.00,100.00,12140,12142
16008,2,350,162,256.00,8836.00,12141,12143
16009,2,504,8,256.00,61504.00,12142,12144
16010,2,322,190,256.00,4356.00,12143,12145
16011,1,512,512,512.00,0.00,12144,12145
16012,1,512,512,512.00,0.00,12144,12145
16013,2,446,66,256.00,36100.00,12144,12146
16014,1,512,512,512.00,0.00,12145,12146
16015,1,512,512,512.00,0.00,12145,12146
16016,2,494,18,256.00,56644.00,12145,12147
16017,2,364,148,256.00,11664.00,12146,12148
16018,1,512,512,512.00,0.00,12147,12148
16019,4,207,32,128.00,5980.50,12147,12151
16020,3,190,142,170.67,427.56,12150,12153
16021,2,473,39,256.00,47089.00,12152,12154
16022,1,512,512,512.00,0.00,12153,12154
16023,2,418,94,256.00,26244.00,12153,12155
16024,1,512,512,512.00,0.00,12154,12155
16025,3,309,16,170.67,14441.56,12154,12157
16026,1,512,512,512.00,0.00,12156,12157
16027,1,512,512,512.00,0.00,12156,12157
16028,4,208,86,128.00,2239.50,12156,12160
16029,1,512,512,512.00,0.00,12159,12160
16030,1,512,512,512.00,0.00,12159,12160
16031,1,512,512,512.00,0.00,12159,12160
16032,1,512,512,512.00,0.00,12159,12160
16033,3,359,61,170.67,17894.89,12159,12162
16034,1,512,512,512.00,0.00,12161,12162
16035,1,512,512,512.00,0.00,12161,12162
16036,1,512,512,512.00,0.00,12161,12162
16037,2,395,117,256.00,19321.00,12161,12163
16038,2,281,231,256.00,625.00,12162,12164
16039,2,470,42,256.00,45796.00,12163,12165
16040,1,512,512,512.00,0.00,12164,12165
16041,1,512,512,512.00,0.00,12164,12165
16042,2,437,75,256.00,32761.00,12164,12166
16043,1,512,512,512.00,0.00,12165,12166
16044,2,491,21,256.00,55225.00,12165,12167
16045,1,512,512,512.00,0.00,12166,12167
16046,1,512,512,512.00,0.00,12166,12167
16047,2,471,41,256.00,46225.00,12166,12168
16048,1,512,512,512.00,0.00,12167,12168
16049,1,512,512,512.00,0.00,12167,12168
16050,5,273,1,102.40,9530.24,12167,12172
16051,1,512,512,512.00,0.00,12171,12172
16052,1,512,512,512.00,0.00,12171,12172
16053,1,512,512,512.00,0.00,12171,12172
16054,1,512,512,512.00,0.00,12171,12172
16055,2,408,104,256.00,23104.00,12171,12173
16056,1,512,512,512.00,0.00,12172,12173
16057,1,512,512,512.00,0.00,12172,12173
16058,1,512,512,512.00,0.00,12172,12173
16059,2,439,73,256.00,33489.00,12172,12174
16060,1,512,512,512.00,0.00,12173,12174
16061,1,512,512,512.00,0.00,12173,12174
16062,1,512,512,512.00,0.00,12173,12174
16063,3,420,45,170.67,31084.22,12173,12176
16064,2,418,94,256.00,26244.00,12175,12177
16065,3,263,77,170.67,5766.89,12176,12179
16066,1,512,512,512.00,0.00,12178,12179
16067,2,492,20,256.00,55696.00,12178,12180
16068,1,512,512,512.00,0.00,12179,12180
16069,1,512,512,512.00,0.00,12179,12180
16070,3,458,16,170.67,41360.89,12179,12182
16071,6,162,14,85.33,3158.56,12181,12187
16072,3,275,69,170.67,7076.22,12186,12189
16073,5,221,6,102.40,7861.84,12188,12193
16074,1,512,512,512.00,0.00,12192,12193
16075,1,512,512,512.00,0.00,12192,12193
16076,2,267,245,256.00,121.00,12192,12194
16077,2,496,16,256.00,57600.00,12193,12195
16078,2,495,17,256.00,57121.00,12194,12196
16079,1,512,512,512.00,0.00,12195,12196
16080,2,377,135,256.00,14641.00,12195,12197
16081,2,464,48,256.00,43264.00,12196,12198
16082,1,512,512,512.00,0.00,12197,12198
16083,2,260,252,256.00,16.00,12197,12199
16084,2,307,205,256.00,2601.00,12198,12200
16085,3,432,1,170.67,35161.56,12199,12202
16086,5,248,5,102.40,7265.04,12201,12206
16087,3,300,52,170.67,10307.56,12205,12208
16088,1,512,512,512.00,0.00,12207,12208
16089,1,512,512,512.00,0.00,12207,12208
16090,2,492,20,256.00,55696.00,12207,12209
16091,1,512,512,512.00,0.00,12208,12209
16092,1,512,512,512.00,0.00,12208,12209
16093,4,239,1,128.00,8549.00,12208,12212
16094,1,512,512,512.00,0.00,12211,12212
16095,3,413,37,170.67,29466.89,12211,12214
16096,1,512,512,512.00,0.00,12213,12214
16097,5,312,2,102.40,13931.84,12213,12218
16098,1,512,512,512.00,0.00,12217,12218
16099,4,364,29,128.00,18873.50,12217,12221
16100,4,398,1,128.00,25554.50,12220,12224
16101,1,512,512,512.00,0.00,12223,12224
16102,1,512,512,512.00,0.00,12223,12224
16103,1,512,512,512.00,0.00,12223,12224
16104,1,512,512,512.00,0.00,12223,12224
16105,2,355,157,256.00,9801.00,12223,12225
16106,2,289,223,256.00,1089.00,12224,12226
16107,1,512,512,512.00,0.00,12225,12226
16108,3,243,37,170.67,8953.56,12225,12228
16109,1,512,512,512.00,0.00,12227,12228
16110,1,512,512,512.00,0.00,12227,12228
16111,1,512,512,512.00,0.00,12227,12228
16112,3,330,1,170.67,18093.56,12227,12230
16113,1,512,512,512.00,0.00,12229,12230
16114,1,512,512,512.00,0.00,12229,12230
16115,1,512,512,512.00,0.00,12229,12230
16116,2,456,56,256.00,40000.00,12229,12231
16117,7,209,1,73.14,4498.41,12230,12237
16118,2,378,134,256.00,14884.00,12236,12238
16119,4,188,43,128.00,2955.50,12237,12241
16120,2,427,85,256.00,29241.00,12240,12242
16121,1,512,512,512.00,0.00,12241,12242
16122,1,512,512,512.00,0.00,12241,12242
16123,3,414,25,170.67,29989.56,12241,12244
16124,3,244,43,170.67,8209.56,12243,12246
16125,1,512,512,512.00,0.00,12245,12246
16126,2,425,87,256.00,28561.00,12245,12247
16127,1,512,512,512.00,0.00,12246,12247
16128,2,270,242,256.00,196.00,12246,12248
16129,2,414,98,256.00,24964.00,12247,12249
16130,1,512,512,512.00,0.00,12248,12249
16131,1,512,512,512.00,0.00,12248,12249
16132,1,512,512,512.00,0.00,12248,12249
16133,2,363,149,256.00,11449.00,12248,12250
16134,1,512,512,512.00,0.00,12249,12250
16135,1,512,512,512.00,0.00,12249,12250
16136,1,512,512,512.00,0.00,12249,12250
16137,2,402,110,256.00,21316.00,12249,12251
16138,2,291,221,256.00,1225.00,12250,12252
16139,5,189,2,102.40,3689.84,12251,12256
16140,1,512,512,512.00,0.00,12255,12256
16141,1,512,512,512.00,0.00,12255,12256
16142,4,343,1,128.00,16628.50,12255,12259
16143,1,512,512,512.00,0.00,12258,12259
16144,1,512,512,512.00,0.00,12258,12259
16145,3,374,64,170.67,20688.89,12258,12261
16146,3,395,39,170.67,25416.22,12260,12263
16147,1,512,512,512.00,0.00,12262,12263
16148,1,512,512,512.00,0.00,12262,12263
16149,1,512,512,512.00,0.00,12262,12263
16150,1,512,512,512.00,0.00,12262,12263
16151,4,331,51,128.00,13801.00,12262,12266
16152,1,512,512,512.00,0.00,12265,12266
16153,4,486,1,128.00,42788.50,12265,12269
16154,1,512,512,512.00,0.00,12268,12269
16155,2,307,205,256.00,2601.00,12268,12270
16156,1,512,512,512.00,0.00,12269,12270
16157,1,512,512,512.00,0.00,12269,12270
16158,1,512,512,512.00,0.00,12269,12270
16159,3,290,89,170.67,7442.89,12269,12272
16160,3,467,12,170.67,43980.22,12271,12274
16161,3,458,2,170.67,41696.89,12273,12276
16162,3,271,74,170.67,6474.89,12275,12278
16163,1,512,512,512.00,0.00,12277,12278
16164,1,512,512,512.00,0.00,12277,12278
16165,3,412,1,170.67,30721.56,12277,12280
16166,2,375,137,256.00,14161.00,12279,12281
16167,1,512,512,512.00,0.00,12280,12281
16168,8,206,1,64.00,5302.25,12280,12288
16169,1,512,512,512.00,0.00,12287,12288
16170,1,512,512,512.00,0.00,12287,12288
16171,2,346,166,256.00,8100.00,12287,12289
16172,3,205,147,170.67,617.56,12288,12291
16173,1,512,512,512.00,0.00,12290,12291
16174,4,416,2,128.00,28867.50,12290,12294
16175,1,512,512,512.00,0.00,12293,12294
16176,4,243,9,128.00,6873.00,12293,12297
16177,3,202,146,170.67,544.89,12296,12299
16178,6,214,5,85.33,7658.89,12298,12304
16179,2,332,180,256.00,5776.00,12303,12305
16180,1,512,512,512.00,0.00,12304,12305
16181,2,328,184,256.00,5184.00,12304,12306
16182,2,472,40,256.00,46656.00,12305,12307
16183,2,426,86,256.00,28900.00,12306,12308
16184,1,512,512,512.00,0.00,12307,12308
16185,1,512,512,512.00,0.00,12307,12308
16186,1,512,512,512.00,0.00,12307,12308
16187,2,479,33,256.00,49729.00,12307,12309
16188,1,512,512,512.00,0.00,12308,12309
16189,1,512,512,512.00,0.00,12308,12309
16190,2,494,18,256.00,56644.00,12308,12310
16191,2,434,78,256.00,31684.00,12309,12311
16192,1,512,512,512.00,0.00,12310,12311
16193,1,512,512,512.00,0.00,12310,12311
16194,1,512,512,512.00,0.00,12310,12311
16195,2,328,184,256.00,5184.00,12310,12312
16196,2,425,87,256.00,28561.00,12311,12313
16197,8,264,2,64.00,6942.75,12312,12320
16198,1,512,512,512.00,0.00,12319,12320
16199,1,512,512,512.00,0.00,12319,12320
16200,1,512,512,512.00,0.00,12319,12320
16201,1,512,512,512.00,0.00,12319,12320
16202,1,512,512,512.00,0.00,12319,12320
16203,3,310,44,170.67,11872.89,12319,12322
16204,1,512,512,512.00,0.00,12321,12322
16205,2,278,234,256.00,484.00,12321,12323
16206,5,437,8,102.40,28021.84,12322,12327
16207,1,512,512,512.00,0.00,12326,12327
16208,1,512,512,512.00,0.00,12326,12327
16209,1,512,512,512.00,0.00,12326,12327
16210,1,512,512,512.00,0.00,12326,12327
16211,2,334,178,256.00,6084.00,12326,12328
16212,1,512,512,512.00,0.00,12327,12328
16213,1,512,512,512.00,0.00,12327,12328
16214,1,512,512,512.00,0.00,12327,12328
16215,2,336,176,256.00,6400.00,12327,12329
16216,3,230,114,170.67,2246.22,12328,12331
16217,2,272,240,256.00,256.00,12330,12332
16218,1,512,512,512.00,0.00,12331,12332
16219,1,512,512,512.00,0.00,12331,12332
16220,1,512,512,512.00,0.00,12331,12332
16221,3,346,60,170.67,15723.56,12331,12334
16222,1,512,512,512.00,0.00,12333,12334
16223,1,512,512,512.00,0.00,12333,12334
16224,1,512,512,512.00,0.00,12333,12334
16225,2,431,81,256.00,30625.00,12333,12335
16226,1,512,512,512.00,0.00,12334,12335
16227,1,512,512,512.00,0.00,12334,12335
16228,3,304,1,170.67,15961.56,12334,12337
16229,1,512,512,512.00,0.00,12336,12337
16230,2,508,4,256.00,63504.00,12336,12338
16231,2,394,118,256.00,19044.00,12337,12339
16232,1,512,512,512.00,0.00,12338,12339
16233,1,512,512,512.00,0.00,12338,12339
16234,1,512,512,512.00,0.00,12338,12339
16235,1,512,512,512.00,0.00,12338,12339
16236,3,330,34,170.67,14859.56,12338,12341
16237,3,364,58,170.67,18859.56,12340,12343
16238,1,512,512,512.00,0.00,12342,12343
16239,1,512,512,512.00,0.00,12342,12343
16240,1,512,512,512.00,0.00,12342,12343
16241,2,266,246,256.00,100.00,12342,12344
16242,1,512,512,512.00,0.00,12343,12344
16243,2,400,112,256.00,20736.00,12343,12345
16244,1,512,512,512.00,0.00,12344,12345
16245,1,512,512,512.00,0.00,12344,12345
16246,1,512,512,512.00,0.00,12344,12345
16247,1,512,512,512.00,0.00,12344,12345
16248,2,317,195,256.00,3721.00,12344,12346
16249,1,512,512,512.00,0.00,12345,12346
16250,1,512,512,512.00,0.00,12345,12346
16251,1,512,512,512.00,0.00,12345,12346
16252,1,512,512,512.00,0.00,12345,12346
16253,3,310,42,170.67,12027.56,12345,12348
16254,2,287,225,256.00,961.00,12347,12349
16255,1,512,512,512.00,0.00,12348,12349
16256,1,512,512,512.00,0.00,12348,12349
16257,1,512,512,512.00,0.00,12348,12349
16258,1,512,512,512.00,0.00,12348,12349
16259,2,412,100,256.00,24336.00,12348,12350
16260,1,512,512,512.00,0.00,12349,12350
16261,1,512,512,512.00,0.00,12349,12350
16262,2,275,237,256.00,361.00,12349,12351
16263,1,512,512,512.00,0.00,12350,12351
16264,1,512,512,512.00,0.00,12350,12351
16265,1,512,512,512.00,0.00,12350,12351
16266,3,372,31,170.67,21281.56,12350,12353
16267,1,512,512,512.00,0.00,12352,12353
16268,3,336,83,170.67,13684.22,12352,12355
16269,1,512,512,512.00,0.00,12354,12355
16270,1,512,512,512.00,0.00,12354,12355
16271,2,405,107,256.00,22201.00,12354,12356
16272,3,234,127,170.67,2101.56,12355,12358
16273,1,512,512,512.00,0.00,12357,12358
16274,1,512,512,512.00,0.00,12357,12358
16275,1,512,512,512.00,0.00,12357,12358
16276,1,512,512,512.00,0.00,12357,12358
16277,1,512,512,512.00,0.00,12357,12358
16278,2,462,50,256.00,42436.00,12357,12359
16279,1,512,512,512.00,0.00,12358,12359
16280,1,512,512,512.00,0.00,12358,12359
16281,1,512,512,512.00,0.00,12358,12359
16282,1,512,512,512.00,0.00,12358,12359
16283,1,512,512,512.00,0.00,12358,12359
16284,1,512,512,512.00,0.00,12358,12359
16285,2,321,191,256.00,4225.00,12358,12360
16286,1,512,512,512.00,0.00,12359,12360
16287,1,512,512,512.00,0.00,12359,12360
16288,2,290,222,256.00,1156.00,12359,12361
16289,2,499,13,256.00,59049.00,12360,12362
16290,1,512,512,512.00,0.00,12361,12362
16291,1,512,512,512.00,0.00,12361,12362
16292,1,512,512,512.00,0.00,12361,12362
16293,1,512,512,512.00,0.00,12361,12362
16294,2,494,18,256.00,56644.00,12361,12363
16295,1,512,512,512.00,0.00,12362,12363
16296,2,406,106,256.00,22500.00,12362,12364
16297,1,512,512,512.00,0.00,12363,12364
16298,2,497,15,256.00,58081.00,12363,12365
16299,1,512,512,512.00,0.00,12364,12365
16300,1,512,512,512.00,0.00,12364,12365
16301,2,317,195,256.00,3721.00,12364,12366
16302,1,512,512,512.00,0.00,12365,12366
16303,1,512,512,512.00,0.00,12365,12366
16304,1,512,512,512.00,0.00,12365,12366
16305,3,242,46,170.67,7824.89,12365,12368
16306,1,512,512,512.00,0.00,12367,12368
16307,2,384,128,256.00,16384.00,12367,12369
16308,1,512,512,512.00,0.00,12368,12369
16309,3,466,4,170.67,43851.56,12368,12371
16310,1,512,512,512.00,0.00,12370,12371
16311,1,512,512,512.00,0.00,12370,12371
16312,1,512,512,512.00,0.00,12370,12371
16313,4,488,2,128.00,43254.00,12370,12374
16314,2,380,132,256.00,15376.00,12373,12375
16315,1,512,512,512.00,0.00,12374,12375
16316,1,512,512,512.00,0.00,12374,12375
16317,4,201,9,128.00,5149.50,12374,12378
16318,1,512,512,512.00,0.00,12377,12378
16319,3,336,70,170.67,13883.56,12377,12380
16320,1,512,512,512.00,0.00,12379,12380
16321,1,512,512,512.00,0.00,12379,12380
16322,3,406,31,170.67,28013.56,12379,12382
16323,2,468,44,256.00,44944.00,12381,12383
16324,2,317,195,256.00,3721.00,12382,12384
16325,3,424,4,170.67,33155.56,12383,12386
16326,2,370,142,256.00,12996.00,12385,12387
16327,1,512,512,512.00,0.00,12386,12387
16328,1,512,512,512.00,0.00,12386,12387
16329,2,259,253,256.00,9.00,12386,12388
16330,2,393,119,256.00,18769.00,12387,12389
16331,2,455,57,256.00,39601.00,12388,12390
16332,1,512,512,512.00,0.00,12389,12390
16333,2,329,183,256.00,5329.00,12389,12391
16334,1,512,512,512.00,0.00,12390,12391
16335,2,325,187,256.00,4761.00,12390,12392
16336,1,512,512,512.00,0.00,12391,12392
16337,1,512,512,512.00,0.00,12391,12392
16338,3,226,72,170.67,4891.56,12391,12394
16339,1,512,512,512.00,0.00,12393,12394
16340,1,512,512,512.00,0.00,12393,12394
16341,2,483,29,256.00,51529.00,12393,12395
16342,1,512,512,512.00,0.00,12394,12395
16343,1,512,512,512.00,0.00,12394,12395
16344,1,512,512,512.00,0.00,12394,12395
16345,3,310,32,170.67,12880.89,12394,12397
16346,2,436,76,256.00,32400.00,12396,12398
16347,2,424,88,256.00,28224.00,12397,12399
16348,1,512,512,512.00,0.00,12398,12399
16349,1,512,512,512.00,0.00,12398,12399
16350,2,403,109,256.00,21609.00,12398,12400
16351,1,512,512,512.00,0.00,12399,12400
16352,2,323,189,256.00,4489.00,12399,12401
16353,1,512,512,512.00,0.00,12400,12401
16354,2,447,65,256.00,36481.00,12400,12402
16355,2,359,153,256.00,10609.00,12401,12403
16356,1,512,512,512.00,0.00,12402,12403
16357,1,512,512,512.00,0.00,12402,12403
16358,1,512,512,512.00,0.00,12402,12403
16359,2,380,132,256.00,15376.00,12402,12404
16360,2,376,136,256.00,14400.00,12403,12405
16361,2,467,45,256.00,44521.00,12404,12406
16362,1,512,512,512.00,0.00,12405,12406
16363,1,512,512,512.00,0.00,12405,12406
16364,2,277,235,256.00,441.00,12405,12407
16365,1,512,512,512.00,0.00,12406,12407
16366,2,327,185,256.00,5041.00,12406,12408
16367,2,449,63,256.00,37249.00,12407,12409
16368,2,319,193,256.00,3969.00,12408,12410
16369,1,512,512,512.00,0.00,12409,12410
16370,1,512,512,512.00,0.00,12409,12410
16371,1,512,512,512.00,0.00,12409,12410
16372,2,461,51,256.00,42025.00,12409,12411
16373,1,512,512,512.00,0.00,12410,12411
16374,1,512,512,512.00,0.00,12410,12411
16375,1,512,512,512.00,0.00,12410,12411
16376,1,512,512,512.00,0.00,12410,12411
16377,2,459,53,256.00,41209.00,12410,12412
16378,1,512,512,512.00,0.00,12411,12412
16379,1,512,512,512.00,0.00,12411,12412
16380,1,512,512,512.00,0.00,12411,12412
16381,1,512,512,512.00,0.00,12411,12412
16382,2,288,224,256.00,1024.00,12411,12413
16383,1,512,512,512.00,0.00,12412,12413
16384,1,512,512,512.00,0.00,12412,12413
16385,2,295,217,256.00,1521.00,12412,12414
16386,1,512,512,512.00,0.00,12413,12414
16387,2,268,244,256.00,144.00,12413,12415
16388,1,512,512,512.00,0.00,12414,12415
16389,2,325,187,256.00,4761.00,12414,12416
16390,2,330,182,256.00,5476.00,12415,12417
16391,1,512,512,512.00,0.00,12416,12417
16392,3,318,75,170.67,11176.22,12416,12419
16393,1,512,512,512.00,0.00,12418,12419
16394,1,512,512,512.00,0.00,12418,12419
16395,2,455,57,256.00,39601.00,12418,12420
16396,1,512,512,512.00,0.00,12419,12420
16397,1,512,512,512.00,0.00,12419,12420
16398,1,512,512,512.00,0.00,12419,12420
16399,2,403,109,256.00,21609.00,12419,12421
16400,1,512,512,512.00,0.00,12420,12421
16401,2,270,242,256.00,196.00,12420,12422
16402,4,186,3,128.00,5539.50,12421,12425
16403,1,512,512,512.00,0.00,12424,12425
16404,1,512,512,512.00,0.00,12424,12425
16405,1,512,512,512.00,0.00,12424,12425
16406,3,274,7,170.67,13701.56,12424,12427
16407,1,512,512,512.00,0.00,12426,12427
16408,2,345,167,256.00,7921.00,12426,12428
16409,1,512,512,512.00,0.00,12427,12428
16410,1,512,512,512.00,0.00,12427,12428
16411,1,512,512,512.00,0.00,12427,12428
16412,2,398,114,256.00,20164.00,12427,12429
16413,1,512,512,512.00,0.00,12428,12429
16414,1,512,512,512.00,0.00,12428,12429
16415,2,266,246,256.00,100.00,12428,12430
16416,1,512,512,512.00,0.00,12429,12430
16417,1,512,512,512.00,0.00,12429,12430
16418,2,265,247,256.00,81.00,12429,12431
16419,1,512,512,512.00,0.00,12430,12431
16420,1,512,512,512.00,0.00,12430,12431
16421,2,452,60,256.00,38416.00,12430,12432
16422,1,512,512,512.00,0.00,12431,12432
16423,2,267,245,256.00,121.00,12431,12433
16424,2,283,229,256.00,729.00,12432,12434
16425,1,512,512,512.00,0.00,12433,12434
16426,1,512,512,512.00,0.00,12433,12434
16427,1,512,512,512.00,0.00,12433,12434
16428,1,512,512,512.00,0.00,12433,12434
16429,2,261,251,256.00,25.00,12433,12435
16430,1,512,512,512.00,0.00,12434,12435
16431,1,512,512,512.00,0.00,12434,12435
16432,2,474,38,256.00,47524.00,12434,12436
16433,1,512,512,512.00,0.00,12435,12436
16434,1,512,512,512.00,0.00,12435,12436
16435,2,377,135,256.00,14641.00,12435,12437
16436,1,512,512,512.00,0.00,12436,12437
16437,2,363,149,256.00,11449.00,12436,12438
16438,2,358,154,256.00,10404.00,12437,12439
16439,1,512,512,512.00,0.00,12438,12439
16440,1,512,512,512.00,0.00,12438,12439
16441,2,380,132,256.00,15376.00,12438,12440
16442,1,512,512,512.00,0.00,12439,12440
16443,1,512,512,512.00,0.00,12439,12440
16444,3,487,2,170.67,50106.89,12439,12442
16445,2,296,216,256.00,1600.00,12441,12443
16446,2,507,5,256.00,63001.00,12442,12444
16447,1,512,512,512.00,0.00,12443,12444
16448,1,512,512,512.00,0.00,12443,12444
16449,3,374,2,170.67,23664.89,12443,12446
16450,2,448,64,256.00,36864.00,12445,12447
16451,1,512,512,512.00,0.00,12446,12447
16452,2,321,191,256.00,4225.00,12446,12448
16453,1,512,512,512.00,0.00,12447,12448
16454,1,512,512,512.00,0.00,12447,12448
16455,1,512,512,512.00,0.00,12447,12448
16456,1,512,512,512.00,0.00,12447,12448
16457,2,288,224,256.00,1024.00,12447,12449
16458,1,512,512,512.00,0.00,12448,12449
16459,2,295,217,256.00,1521.00,12448,12450
16460,2,300,212,256.00,1936.00,12449,12451
16461,1,512,512,512.00,0.00,12450,12451
16462,1,512,512,512.00,0.00,12450,12451
16463,2,309,203,256.00,2809.00,12450,12452
16464,1,512,512,512.00,0.00,12451,12452
16465,2,298,214,256.00,1764.00,12451,12453
16466,1,512,512,512.00,0.00,12452,12453
16467,1,512,512,512.00,0.00,12452,12453
16468,1,512,512,512.00,0.00,12452,12453
16469,1,512,512,512.00,0.00,12452,12453
16470,1,512,512,512.00,0.00,12452,12453
16471,2,373,139,256.00,13689.00,12452,12454
16472,1,512,512,512.00,0.00,12453,12454
16473,1,512,512,512.00,0.00,12453,12454
16474,1,512,512,512.00,0.00,12453,12454
16475,2,442,70,256.00,34596.00,12453,12455
16476,1,512,512,512.00,0.00,12454,12455
16477,1,512,512,512.00,0.00,12454,12455
16478,1,512,512,512.00,0.00,12454,12455
16479,1,512,512,512.00,0.00,12454,12455
16480,2,324,188,256.00,4624.00,12454,12456
16481,1,512,512,512.00,0.00,12455,12456
16482,1,512,512,512.00,0.00,12455,12456
16483,3,381,60,170.67,22140.22,12455,12458
16484,2,307,205,256.00,2601.00,12457,12459
16485,1,512,512,512.00,0.00,12458,12459
16486,2,443,69,256.00,34969.00,12458,12460
16487,1,512,512,512.00,0.00,12459,12460
16488,1,512,512,512.00,0.00,12459,12460
16489,1,512,512,512.00,0.00,12459,12460
16490,1,512,512,512.00,0.00,12459,12460
16491,3,450,17,170.67,39144.22,12459,12462
16492,1,512,512,512.00,0.00,12461,12462
16493,1,512,512,512.00,0.00,12461,12462
16494,1,512,512,512.00,0.00,12461,12462
16495,1,512,512,512.00,0.00,12461,12462
16496,2,271,241,256.00,225.00,12461,12463
16497,3,328,2,170.67,17776.89,12462,12465
16498,1,512,512,512.00,0.00,12464,12465
16499,1,512,512,512.00,0.00,12464,12465
16500,2,264,248,256.00,64.00,12464,12466
16501,4,232,10,128.00,8257.50,12465,12469
16502,1,512,512,512.00,0.00,12468,12469
16503,1,512,512,512.00,0.00,12468,12469
16504,1,512,512,512.00,0.00,12468,12469
16505,3,193,139,170.67,529.56,12468,12471
16506,1,512,512,512.00,0.00,12470,12471
16507,3,441,17,170.67,36768.22,12470,12473
16508,1,512,512,512.00,0.00,12472,12473
16509,1,512,512,512.00,0.00,12472,12473
16510,4,259,3,128.00,14361.50,12472,12476
16511,2,277,235,256.00,441.00,12475,12477
16512,1,512,512,512.00,0.00,12476,12477
16513,2,397,115,256.00,19881.00,12476,12478
16514,1,512,512,512.00,0.00,12477,12478
16515,1,512,512,512.00,0.00,12477,12478
16516,1,512,512,512.00,0.00,12477,12478
16517,1,512,512,512.00,0.00,12477,12478
16518,2,274,238,256.00,324.00,12477,12479
16519,2,404,108,256.00,21904.00,12478,12480
16520,2,411,101,256.00,24025.00,12479,12481
16521,1,512,512,512.00,0.00,12480,12481
16522,1,512,512,512.00,0.00,12480,12481
16523,1,512,512,512.00,0.00,12480,12481
16524,2,344,168,256.00,7744.00,12480,12482
16525,1,512,512,512.00,0.00,12481,12482
16526,1,512,512,512.00,0.00,12481,12482
16527,1,512,512,512.00,0.00,12481,12482
16528,1,512,512,512.00,0.00,12481,12482
16529,1,512,512,512.00,0.00,12481,12482
16530,1,512,512,512.00,0.00,12481,12482
16531,2,463,49,256.00,42849.00,12481,12483
16532,1,512,512,512.00,0.00,12482,12483
16533,4,225,6,128.00,9077.50,12482,12486
16534,2,441,71,256.00,34225.00,12485,12487
16535,1,512,512,512.00,0.00,12486,12487
16536,1,512,512,512.00,0.00,12486,12487
16537,1,512,512,512.00,0.00,12486,12487
16538,2,376,136,256.00,14400.00,12486,12488
16539,2,410,102,256.00,23716.00,12487,12489
16540,2,415,97,256.00,25281.00,12488,12490
16541,1,512,512,512.00,0.00,12489,12490
16542,1,512,512,512.00,0.00,12489,12490
16543,2,507,5,256.00,63001.00,12489,12491
16544,1,512,512,512.00,0.00,12490,12491
16545,2,376,136,256.00,14400.00,12490,12492
16546,2,282,230,256.00,676.00,12491,12493
16547,1,512,512,512.00,0.00,12492,12493
16548,1,512,512,512.00,0.00,12492,12493
16549,3,180,158,170.67,86.22,12492,12495
16550,1,512,512,512.00,0.00,12494,12495
16551,1,512,512,512.00,0.00,12494,12495
16552,1,512,512,512.00,0.00,12494,12495
16553,2,401,111,256.00,21025.00,12494,12496
16554,2,391,121,256.00,18225.00,12495,12497
16555,1,512,512,512.00,0.00,12496,12497
16556,2,297,215,256.00,1681.00,12496,12498
16557,4,310,13,128.00,15151.50,12497,12501
16558,1,512,512,512.00,0.00,12500,12501
16559,2,457,55,256.00,40401.00,12500,12502
16560,1,512,512,512.00,0.00,12501,12502
16561,1,512,512,512.00,0.00,12501,12502
16562,3,359,2,170.67,21434.89,12501,12504
16563,3,500,4,170.67,54232.89,12503,12506
16564,1,512,512,512.00,0.00,12505,12506
16565,3,346,53,170.67,15970.89,12505,12508
16566,1,512,512,512.00,0.00,12507,12508
16567,2,282,230,256.00,676.00,12507,12509
16568,1,512,512,512.00,0.00,12508,12509
16569,2,386,126,256.00,16900.00,12508,12510
16570,1,512,512,512.00,0.00,12509,12510
16571,2,258,254,256.00,4.00,12509,12511
16572,1,512,512,512.00,0.00,12510,12511
16573,2,454,58,256.00,39204.00,12510,12512
16574,2,305,207,256.00,2401.00,12511,12513
16575,2,270,242,256.00,196.00,12512,12514
16576,1,512,512,512.00,0.00,12513,12514
16577,1,512,512,512.00,0.00,12513,12514
16578,1,512,512,512.00,0.00,12513,12514
16579,3,451,26,170.67,39306.89,12513,12516
16580,3,298,27,170.67,12373.56,12515,12518
16581,1,512,512,512.00,0.00,12517,12518
16582,1,512,512,512.00,0.00,12517,12518
16583,2,318,194,256.00,3844.00,12517,12519
16584,1,512,512,512.00,0.00,12518,12519
16585,1,512,512,512.00,0.00,12518,12519
16586,2,402,110,256.00,21316.00,12518,12520
16587,1,512,512,512.00,0.00,12519,12520
16588,1,512,512,512.00,0.00,12519,12520
16589,2,495,17,256.00,57121.00,12519,12521
16590,1,512,512,512.00,0.00,12520,12521
16591,1,512,512,512.00,0.00,12520,12521
16592,1,512,512,512.00,0.00,12520,12521
16593,2,468,44,256.00,44944.00,12520,12522
16594,1,512,512,512.00,0.00,12521,12522
16595,1,512,512,512.00,0.00,12521,12522
16596,1,512,512,512.00,0.00,12521,12522
16597,6,138,31,85.33,1485.22,12521,12527
16598,1,512,512,512.00,0.00,12526,12527
16599,1,512,512,512.00,0.00,12526,12527
16600,2,485,27,256.00,52441.00,12526,12528
16601,1,512,512,512.00,0.00,12527,12528
16602,2,333,179,256.00,5929.00,12527,12529
16603,1,512,512,512.00,0.00,12528,12529
16604,2,489,23,256.00,54289.00,12528,12530
16605,2,371,141,256.00,13225.00,12529,12531
16606,3,273,98,170.67,5544.22,12530,12533
16607,1,512,512,512.00,0.00,12532,12533
16608,1,512,512,512.00,0.00,12532,12533
16609,2,400,112,256.00,20736.00,12532,12534
16610,1,512,512,512.00,0.00,12533,12534
16611,3,301,97,170.67,8541.56,12533,12536
16612,1,512,512,512.00,0.00,12535,12536
16613,1,512,512,512.00,0.00,12535,12536
16614,1,512,512,512.00,0.00,12535,12536
16615,1,512,512,512.00,0.00,12535,12536
16616,5,234,1,102.40,6986.64,12535,12540
16617,1,512,512,512.00,0.00,12539,12540
16618,1,512,512,512.00,0.00,12539,12540
16619,2,302,210,256.00,2116.00,12539,12541
16620,1,512,512,512.00,0.00,12540,12541
16621,1,512,512,512.00,0.00,12540,12541
16622,1,512,512,512.00,0.00,12540,12541
16623,2,468,44,256.00,44944.00,12540,12542
16624,1,512,512,512.00,0.00,12541,12542
16625,1,512,512,512.00,0.00,12541,12542
16626,1,512,512,512.00,0.00,12541,12542
16627,1,512,512,512.00,0.00,12541,12542
16628,2,474,38,256.00,47524.00,12541,12543
16629,4,282,3,128.00,13945.50,12542,12546
16630,1,512,512,512.00,0.00,12545,12546
16631,1,512,512,512.00,0.00,12545,12546
16632,1,512,512,512.00,0.00,12545,12546
16633,1,512,512,512.00,0.00,12545,12546
16634,2,302,210,256.00,2116.00,12545,12547
16635,1,512,512,512.00,0.00,12546,12547
16636,2,445,67,256.00,35721.00,12546,12548
16637,1,512,512,512.00,0.00,12547,12548
16638,2,301,211,256.00,2025.00,12547,12549
16639,1,512,512,512.00,0.00,12548,12549
16640,1,512,512,512.00,0.00,12548,12549
16641,1,512,512,512.00,0.00,12548,12549
16642,3,260,2,170.67,14240.89,12548,12551
16643,3,243,74,170.67,5056.22,12550,12553
16644,1,512,512,512.00,0.00,12552,12553
16645,1,512,512,512.00,0.00,12552,12553
16646,1,512,512,512.00,0.00,12552,12553
16647,2,457,55,256.00,40401.00,12552,12554
16648,1,512,512,512.00,0.00,12553,12554
16649,3,296,6,170.67,14790.22,12553,12556
16650,1,512,512,512.00,0.00,12555,12556
16651,1,512,512,512.00,0.00,12555,12556
16652,1,512,512,512.00,0.00,12555,12556
16653,1,512,512,512.00,0.00,12555,12556
16654,2,352,160,256.00,9216.00,12555,12557
16655,2,285,227,256.00,841.00,12556,12558
16656,1,512,512,512.00,0.00,12557,12558
16657,1,512,512,512.00,0.00,12557,12558
16658,2,476,36,256.00,48400.00,12557,12559
16659,1,512,512,512.00,0.00,12558,12559
16660,2,274,238,256.00,324.00,12558,12560
16661,2,317,195,256.00,3721.00,12559,12561
16662,1,512,512,512.00,0.00,12560,12561
16663,2,305,207,256.00,2401.00,12560,12562
16664,1,512,512,512.00,0.00,12561,12562
16665,2,354,158,256.00,9604.00,12561,12563
16666,1,512,512,512.00,0.00,12562,12563
16667,1,512,512,512.00,0.00,12562,12563
16668,1,512,512,512.00,0.00,12562,12563
16669,3,251,105,170.67,3660.22,12562,12565
16670,1,512,512,512.00,0.00,12564,12565
16671,1,512,512,512.00,0.00,12564,12565
16672,2,366,146,256.00,12100.00,12564,12566
16673,1,512,512,512.00,0.00,12565,12566
16674,2,372,140,256.00,13456.00,12565,12567
16675,1,512,512,512.00,0.00,12566,12567
16676,1,512,512,512.00,0.00,12566,12567
16677,1,512,512,512.00,0.00,12566,12567
16678,2,487,25,256.00,53361.00,12566,12568
16679,1,512,512,512.00,0.00,12567,12568
16680,1,512,512,512.00,0.00,12567,12568
16681,2,489,23,256.00,54289.00,12567,12569
16682,2,396,116,256.00,19600.00,12568,12570
16683,1,512,512,512.00,0.00,12569,12570
16684,1,512,512,512.00,0.00,12569,12570
16685,3,313,41,170.67,12410.89,12569,12572
16686,1,512,512,512.00,0.00,12571,12572
16687,1,512,512,512.00,0.00,12571,12572
16688,1,512,512,512.00,0.00,12571,12572
16689,2,508,4,256.00,63504.00,12571,12573
16690,1,512,512,512.00,0.00,12572,12573
16691,1,512,512,512.00,0.00,12572,12573
16692,2,510,2,256.00,64516.00,12572,12574
16693,1,512,512,512.00,0.00,12573,12574
16694,1,512,512,512.00,0.00,12573,12574
16695,1,512,512,512.00,0.00,12573,12574
16696,1,512,512,512.00,0.00,12573,12574
16697,2,354,158,256.00,9604.00,12573,12575
16698,1,512,512,512.00,0.00,12574,12575
16699,2,486,26,256.00,52900.00,12574,12576
16700,1,512,512,512.00,0.00,12575,12576
16701,4,316,12,128.00,14708.50,12575,12579
16702,6,482,2,85.33,31480.56,12578,12584
16703,2,396,116,256.00,19600.00,12583,12585
16704,2,398,114,256.00,20164.00,12584,12586
16705,1,512,512,512.00,0.00,12585,12586
16706,1,512,512,512.00,0.00,12585,12586
16707,2,447,65,256.00,36481.00,12585,12587
16708,1,512,512,512.00,0.00,12586,12587
16709,1,512,512,512.00,0.00,12586,12587
16710,2,325,187,256.00,4761.00,12586,12588
16711,1,512,512,512.00,0.00,12587,12588
16712,1,512,512,512.00,0.00,12587,12588
16713,1,512,512,512.00,0.00,12587,12588
16714,2,322,190,256.00,4356.00,12587,12589
16715,1,512,512,512.00,0.00,12588,12589
16716,1,512,512,512.00,0.00,12588,12589
16717,1,512,512,512.00,0.00,12588,12589
16718,4,206,71,128.00,2949.50,12588,12592
16719,1,512,512,512.00,0.00,12591,12592
16720,2,380,132,256.00,15376.00,12591,12593
16721,3,509,1,170.67,57234.89,12592,12595
16722,3,422,5,170.67,32650.89,12595,12598
16723,1,512,512,512.00,0.00,12597,12598
16724,1,512,512,512.00,0.00,12597,12598
16725,2,451,61,256.00,38025.00,12597,12599
16726,1,512,512,512.00,0.00,12598,12599
16727,2,284,228,256.00,784.00,12598,12600
16728,2,265,247,256.00,81.00,12599,12601
16729,1,512,512,512.00,0.00,12600,12601
16730,1,512,512,512.00,0.00,12600,12601
16731,1,512,512,512.00,0.00,12600,12601
16732,2,263,249,256.00,49.00,12600,12602
16733,3,353,8,170.67,20030.89,12601,12604
16734,1,512,512,512.00,0.00,12603,12604
16735,1,512,512,512.00,0.00,12603,12604
16736,2,345,167,256.00,7921.00,12603,12605
16737,2,386,126,256.00,16900.00,12604,12606
16738,1,512,512,512.00,0.00,12605,12606
16739,1,512,512,512.00,0.00,12605,12606
16740,2,479,33,256.00,49729.00,12605,12607
16741,1,512,512,512.00,0.00,12606,12607
16742,1,512,512,512.00,0.00,12606,12607
16743,1,512,512,512.00,0.00,12606,12607
16744,1,512,512,512.00,0.00,12606,12607
16745,2,401,111,256.00,21025.00,12606,12608
16746,1,512,512,512.00,0.00,12607,12608
16747,1,512,512,512.00,0.00,12607,12608
16748,1,512,512,512.00,0.00,12607,12608
16749,1,512,512,512.00,0.00,12607,12608
16750,1,512,512,512.00,0.00,12607,12608
16751,2,459,53,256.00,41209.00,12607,12609
16752,1,512,512,512.00,0.00,12608,12609
16753,2,300,212,256.00,1936.00,12608,12610
16754,2,443,69,256.00,34969.00,12609,12611
16755,3,499,4,170.67,53905.56,12610,12613
16756,2,499,13,256.00,59049.00,12612,12614
16757,1,512,512,512.00,0.00,12613,12614
16758,1,512,512,512.00,0.00,12613,12614
16759,1,512,512,512.00,0.00,12613,12614
16760,4,327,10,128.00,16479.50,12613,12617
16761,1,512,512,512.00,0.00,12616,12617
16762,1,512,512,512.00,0.00,12616,12617
16763,2,479,33,256.00,49729.00,12616,12618
16764,1,512,512,512.00,0.00,12617,12618
16765,2,413,99,256.00,24649.00,12617,12619
16766,1,512,512,512.00,0.00,12618,12619
16767,1,512,512,512.00,0.00,12618,12619
16768,2,391,121,256.00,18225.00,12618,12620
16769,1,512,512,512.00,0.00,12619,12620
16770,1,512,512,512.00,0.00,12619,12620
16771,1,512,512,512.00,0.00,12619,12620
16772,1,512,512,512.00,0.00,12619,12620
16773,1,512,512,512.00,0.00,12619,12620
16774,2,509,3,256.00,64009.00,12619,12621
16775,1,512,512,512.00,0.00,12620,12621
16776,2,467,45,256.00,44521.00,12620,12622
16777,1,512,512,512.00,0.00,12621,12622
16778,1,512,512,512.00,0.00,12621,12622
16779,2,401,111,256.00,21025.00,12621,12623
16780,2,287,225,256.00,961.00,12622,12624
16781,5,206,4,102.40,6395.44,12623,12628
16782,2,481,31,256.00,50625.00,12627,12629
16783,1,512,512,512.00,0.00,12628,12629
16784,2,442,70,256.00,34596.00,12628,12630
16785,1,512,512,512.00,0.00,12629,12630
16786,1,512,512,512.00,0.00,12629,12630
16787,2,488,24,256.00,53824.00,12629,12631
16788,4,298,20,128.00,12362.00,12630,12634
16789,1,512,512,512.00,0.00,12633,12634
16790,5,438,5,102.40,28303.04,12633,12638
16791,2,410,102,256.00,23716.00,12637,12639
16792,2,464,48,256.00,43264.00,12638,12640
16793,1,512,512,512.00,0.00,12639,12640
16794,1,512,512,512.00,0.00,12639,12640
16795,4,322,5,128.00,14146.50,12639,12643
16796,1,512,512,512.00,0.00,12642,12643
16797,2,413,99,256.00,24649.00,12642,12644
16798,1,512,512,512.00,0.00,12643,12644
16799,1,512,512,512.00,0.00,12643,12644
16800,2,342,170,256.00,7396.00,12643,12645
16801,1,512,512,512.00,0.00,12644,12645
16802,2,382,130,256.00,15876.00,12644,12646
16803,1,512,512,512.00,0.00,12645,12646
16804,1,512,512,512.00,0.00,12645,12646
16805,2,280,232,256.00,576.00,12645,12647
16806,1,512,512,512.00,0.00,12646,12647
16807,2,427,85,256.00,29241.00,12646,12648
16808,1,512,512,512.00,0.00,12647,12648
16809,1,512,512,512.00,0.00,12647,12648
16810,1,512,512,512.00,0.00,12647,12648
16811,5,235,3,102.40,8708.64,12647,12652
16812,1,512,512,512.00,0.00,12651,12652
16813,1,512,512,512.00,0.00,12651,12652
16814,1,512,512,512.00,0.00,12651,12652
16815,3,346,63,170.67,15637.56,12651,12654
16816,3,246,34,170.67,9371.56,12653,12656
16817,1,512,512,512.00,0.00,12655,12656
16818,4,316,19,128.00,13366.50,12655,12659
16819,2,484,28,256.00,51984.00,12658,12660
16820,2,411,101,256.00,24025.00,12659,12661
16821,1,512,512,512.00,0.00,12660,12661
16822,3,438,5,170.67,36416.22,12660,12663
16823,3,374,2,170.67,23664.89,12662,12665
16824,2,276,236,256.00,400.00,12664,12666
16825,2,321,191,256.00,4225.00,12665,12667
16826,1,512,512,512.00,0.00,12666,12667
16827,1,512,512,512.00,0.00,12666,12667
16828,3,253,28,170.67,10257.56,12666,12669
16829,1,512,512,512.00,0.00,12668,12669
16830,2,356,156,256.00,10000.00,12668,12670
16831,1,512,512,512.00,0.00,12669,12670
16832,2,301,211,256.00,2025.00,12669,12671
16833,1,512,512,512.00,0.00,12670,12671
16834,2,471,41,256.00,46225.00,12670,12672
16835,1,512,512,512.00,0.00,12671,12672
16836,1,512,512,512.00,0.00,12671,12672
16837,1,512,512,512.00,0.00,12671,12672
16838,1,512,512,512.00,0.00,12671,12672
16839,2,406,106,256.00,22500.00,12671,12673
16840,1,512,512,512.00,0.00,12672,12673
16841,1,512,512,512.00,0.00,12672,12673
16842,1,512,512,512.00,0.00,12672,12673
16843,1,512,512,512.00,0.00,12672,12673
16844,2,410,102,256.00,23716.00,12672,12674
16845,1,512,512,512.00,0.00,12673,12674
16846,1,512,512,512.00,0.00,12673,12674
16847,2,328,184,256.00,5184.00,12673,12675
16848,1,512,512,512.00,0.00,12674,12675
16849,3,421,45,170.67,31333.56,12674,12677
16850,2,315,197,256.00,3481.00,12676,12678
16851,1,512,512,512.00,0.00,12677,12678
16852,3,414,1,170.67,31141.56,12677,12680
16853,3,341,20,170.67,17366.89,12679,12682
16854,1,512,512,512.00,0.00,12681,12682
16855,1,512,512,512.00,0.00,12681,12682
16856,1,512,512,512.00,0.00,12681,12682
16857,2,341,171,256.00,7225.00,12681,12683
16858,1,512,512,512.00,0.00,12682,12683
16859,1,512,512,512.00,0.00,12682,12683
16860,1,512,512,512.00,0.00,12682,12683
16861,1,512,512,512.00,0.00,12682,12683
16862,1,512,512,512.00,0.00,12682,12683
16863,2,418,94,256.00,26244.00,12682,12684
16864,1,512,512,512.00,0.00,12683,12684
16865,1,512,512,512.00,0.00,12683,12684
16866,1,512,512,512.00,0.00,12683,12684
16867,2,337,175,256.00,6561.00,12683,12685
16868,1,512,512,512.00,0.00,12684,12685
16869,2,508,4,256.00,63504.00,12684,12686
16870,1,512,512,512.00,0.00,12685,12686
16871,1,512,512,512.00,0.00,12685,12686
16872,2,398,114,256.00,20164.00,12685,12687
16873,2,314,198,256.00,3364.00,12686,12688
16874,1,512,512,512.00,0.00,12687,12688
16875,1,512,512,512.00,0.00,12687,12688
16876,2,329,183,256.00,5329.00,12687,12689
16877,1,512,512,512.00,0.00,12688,12689
16878,1,512,512,512.00,0.00,12688,12689
16879,2,392,120,256.00,18496.00,12688,12690
16880,3,428,19,170.67,33462.89,12689,12692
16881,1,512,512,512.00,0.00,12691,12692
16882,2,314,198,256.00,3364.00,12691,12693
16883,2,311,201,256.00,3025.00,12692,12694
16884,1,512,512,512.00,0.00,12693,12694
16885,1,512,512,512.00,0.00,12693,12694
16886,2,437,75,256.00,32761.00,12693,12695
16887,1,512,512,512.00,0.00,12694,12695
16888,1,512,512,512.00,0.00,12694,12695
16889,4,452,5,128.00,35091.50,12694,12698
16890,2,285,227,256.00,841.00,12697,12699
16891,2,489,23,256.00,54289.00,12698,12700
16892,1,512,512,512.00,0.00,12699,12700
16893,1,512,512,512.00,0.00,12699,12700
16894,1,512,512,512.00,0.00,12699,12700
16895,1,512,512,512.00,0.00,12699,12700
16896,1,512,512,512.00,0.00,12699,12700
16897,2,436,76,256.00,32400.00,12699,12701
16898,1,512,512,512.00,0.00,12700,12701
16899,1,512,512,512.00,0.00,12700,12701
16900,1,512,512,512.00,0.00,12700,12701
16901,1,512,512,512.00,0.00,12700,12701
16902,1,512,512,512.00,0.00,12700,12701
16903,2,499,13,256.00,59049.00,12700,12702
16904,1,512,512,512.00,0.00,12701,12702
16905,2,374,138,256.00,13924.00,12701,12703
16906,1,512,512,512.00,0.00,12702,12703
16907,1,512,512,512.00,0.00,12702,12703
16908,1,512,512,512.00,0.00,12702,12703
16909,4,237,13,128.00,6283.00,12702,12706
16910,2,459,53,256.00,41209.00,12705,12707
16911,1,512,512,512.00,0.00,12706,12707
16912,3,275,14,170.67,12722.89,12706,12709
16913,1,512,512,512.00,0.00,12708,12709
16914,1,512,512,512.00,0.00,12708,12709
16915,1,512,512,512.00,0.00,12708,12709
16916,1,512,512,512.00,0.00,12708,12709
16917,5,171,63,102.40,1891.44,12708,12713
16918,1,512,512,512.00,0.00,12712,12713
16919,2,439,73,256.00,33489.00,12712,12714
16920,1,512,512,512.00,0.00,12713,12714
16921,1,512,512,512.00,0.00,12713,12714
16922,1,512,512,512.00,0.00,12713,12714
16923,1,512,512,512.00,0.00,12713,12714
16924,5,429,1,102.40,27131.04,12713,12718
16925,1,512,512,512.00,0.00,12717,12718
16926,1,512,512,512.00,0.00,12717,12718
16927,2,433,79,256.00,31329.00,12717,12719
16928,1,512,512,512.00,0.00,12718,12719
16929,1,512,512,512.00,0.00,12718,12719
16930,2,336,176,256.00,6400.00,12718,12720
16931,1,512,512,512.00,0.00,12719,12720
16932,1,512,512,512.00,0.00,12719,12720
16933,5,198,3,102.40,6809.84,12719,12724
16934,4,316,14,128.00,14394.00,12723,12727
16935,1,512,512,512.00,0.00,12726,12727
16936,2,474,38,256.00,47524.00,12726,12728
16937,1,512,512,512.00,0.00,12727,12728
16938,1,512,512,512.00,0.00,12727,12728
16939,2,401,111,256.00,21025.00,12727,12729
16940,1,512,512,512.00,0.00,12728,12729
16941,1,512,512,512.00,0.00,12728,12729
16942,2,286,226,256.00,900.00,12728,12730
16943,1,512,512,512.00,0.00,12729,12730
16944,2,414,98,256.00,24964.00,12729,12731
16945,1,512,512,512.00,0.00,12730,12731
16946,1,512,512,512.00,0.00,12730,12731
16947,1,512,512,512.00,0.00,12730,12731
16948,1,512,512,512.00,0.00,12730,12731
16949,3,191,148,170.67,310.89,12730,12733
16950,1,512,512,512.00,0.00,12732,12733
16951,1,512,512,512.00,0.00,12732,12733
16952,1,512,512,512.00,0.00,12732,12733
16953,3,244,80,170.67,4632.89,12732,12735
16954,2,415,97,256.00,25281.00,12734,12736
16955,1,512,512,512.00,0.00,12735,12736
16956,1,512,512,512.00,0.00,12735,12736
16957,1,512,512,512.00,0.00,12735,12736
16958,3,459,1,170.67,42001.56,12735,12738
16959,1,512,512,512.00,0.00,12737,12738
16960,2,286,226,256.00,900.00,12737,12739
16961,1,512,512,512.00,0.00,12738,12739
16962,1,512,512,512.00,0.00,12738,12739
16963,1,512,512,512.00,0.00,12738,12739
16964,2,363,149,256.00,11449.00,12738,12740
16965,1,512,512,512.00,0.00,12739,12740
16966,1,512,512,512.00,0.00,12739,12740
16967,3,291,43,170.67,10277.56,12739,12742
16968,1,512,512,512.00,0.00,12741,12742
16969,1,512,512,512.00,0.00,12741,12742
16970,1,512,512,512.00,0.00,12741,12742
16971,2,260,252,256.00,16.00,12741,12743
16972,1,512,512,512.00,0.00,12742,12743
16973,1,512,512,512.00,0.00,12742,12743
16974,1,512,512,512.00,0.00,12742,12743
16975,1,512,512,512.00,0.00,12742,12743
16976,1,512,512,512.00,0.00,12742,12743
16977,2,263,249,256.00,49.00,12742,12744
16978,2,334,178,256.00,6084.00,12743,12745
16979,1,512,512,512.00,0.00,12744,12745
16980,1,512,512,512.00,0.00,12744,12745
16981,1,512,512,512.00,0.00,12744,12745
16982,2,369,143,256.00,12769.00,12744,12746
16983,2,443,69,256.00,34969.00,12745,12747
16984,1,512,512,512.00,0.00,12746,12747
16985,3,220,93,170.67,3089.56,12746,12749
16986,2,422,90,256.00,27556.00,12748,12750
16987,1,512,512,512.00,0.00,12749,12750
16988,1,512,512,512.00,0.00,12749,12750
16989,2,286,226,256.00,900.00,12749,12751
16990,4,243,13,128.00,6617.00,12750,12754
16991,1,512,512,512.00,0.00,12753,12754
16992,3,229,133,170.67,1749.56,12753,12756
16993,2,383,129,256.00,16129.00,12755,12757
16994,5,208,2,102.40,5954.64,12756,12761
16995,1,512,512,512.00,0.00,12760,12761
16996,1,512,512,512.00,0.00,12760,12761
16997,2,370,142,256.00,12996.00,12760,12762
16998,1,512,512,512.00,0.00,12761,12762
16999,3,251,12,170.67,12588.22,12761,12764
17000,3,461,9,170.67,42328.22,12763,12766
17001,2,337,175,256.00,6561.00,12765,12767
17002,1,512,512,512.00,0.00,12766,12767
17003,1,512,512,512.00,0.00,12766,12767
17004,1,512,512,512.00,0.00,12766,12767
17005,2,393,119,256.00,18769.00,12766,12768
17006,1,512,512,512.00,0.00,12767,12768
17007,1,512,512,512.00,0.00,12767,12768
17008,2,485,27,256.00,52441.00,12767,12769
17009,1,512,512,512.00,0.00,12768,12769
17010,4,270,1,128.00,13757.50,12768,12772
17011,3,397,8,170.67,27246.89,12771,12774
17012,4,363,6,128.00,19376.50,12773,12777
17013,1,512,512,512.00,0.00,12776,12777
17014,1,512,512,512.00,0.00,12776,12777
17015,2,356,156,256.00,10000.00,12776,12778
17016,1,512,512,512.00,0.00,12777,12778
17017,1,512,512,512.00,0.00,12777,12778
17018,1,512,512,512.00,0.00,12777,12778
17019,2,298,214,256.00,1764.00,12777,12779
17020,2,414,98,256.00,24964.00,12778,12780
17021,2,503,9,256.00,61009.00,12779,12781
17022,3,291,94,170.67,7421.56,12780,12783
17023,2,384,128,256.00,16384.00,12782,12784
17024,2,419,93,256.00,26569.00,12783,12785
17025,1,512,512,512.00,0.00,12784,12785
17026,1,512,512,512.00,0.00,12784,12785
17027,1,512,512,512.00,0.00,12784,12785
17028,1,512,512,512.00,0.00,12784,12785
17029,2,406,106,256.00,22500.00,12784,12786
17030,1,512,512,512.00,0.00,12785,12786
17031,1,512,512,512.00,0.00,12785,12786
17032,1,512,512,512.00,0.00,12785,12786
17033,2,387,125,256.00,17161.00,12785,12787
17034,2,430,82,256.00,30276.00,12786,12788
17035,1,512,512,512.00,0.00,12787,12788
17036,3,454,2,170.67,40624.89,12787,12790
17037,2,414,98,256.00,24964.00,12789,12791
17038,2,341,171,256.00,7225.00,12790,12792
17039,1,512,512,512.00,0.00,12791,12792
17040,1,512,512,512.00,0.00,12791,12792
17041,2,498,14,256.00,58564.00,12791,12793
17042,2,403,109,256.00,21609.00,12792,12794
17043,1,512,512,512.00,0.00,12793,12794
17044,1,512,512,512.00,0.00,12793,12794
17045,2,451,61,256.00,38025.00,12793,12795
17046,1,512,512,512.00,0.00,12794,12795
17047,1,512,512,512.00,0.00,12794,12795
17048,1,512,512,512.00,0.00,12794,12795
17049,2,315,197,256.00,3481.00,12794,12796
17050,2,468,44,256.00,44944.00,12795,12797
17051,3,307,26,170.67,13194.89,12796,12799
17052,1,512,512,512.00,0.00,12798,12799
17053,1,512,512,512.00,0.00,12798,12799
17054,1,512,512,512.00,0.00,12798,12799
17055,1,512,512,512.00,0.00,12798,12799
17056,1,512,512,512.00,0.00,12798,12799
17057,2,406,106,256.00,22500.00,12798,12800
17058,2,351,161,256.00,9025.00,12799,12801
17059,4,332,35,128.00,14161.50,12800,12804
17060,1,512,512,512.00,0.00,12803,12804
17061,1,512,512,512.00,0.00,12803,12804
17062,1,512,512,512.00,0.00,12803,12804
17063,4,381,23,128.00,21537.00,12803,12807
17064,3,246,25,170.67,10613.56,12806,12809
17065,3,465,21,170.67,43320.22,12808,12811
17066,2,349,163,256.00,8649.00,12810,12812
17067,2,389,123,256.00,17689.00,12811,12813
17068,1,512,512,512.00,0.00,12812,12813
17069,1,512,512,512.00,0.00,12812,12813
17070,2,450,62,256.00,37636.00,12812,12814
17071,1,512,512,512.00,0.00,12813,12814
17072,1,512,512,512.00,0.00,12813,12814
17073,1,512,512,512.00,0.00,12813,12814
17074,4,325,12,128.00,15264.50,12813,12817
17075,1,512,512,512.00,0.00,12816,12817
17076,4,465,7,128.00,37889.00,12816,12820
17077,2,483,29,256.00,51529.00,12819,12821
17078,1,512,512,512.00,0.00,12820,12821
17079,1,512,512,512.00,0.00,12820,12821
17080,1,512,512,512.00,0.00,12820,12821
17081,6,237,3,85.33,8325.22,12820,12826
17082,1,512,512,512.00,0.00,12825,12826
17083,2,476,36,256.00,48400.00,12825,12827
17084,1,512,512,512.00,0.00,12826,12827
17085,1,512,512,512.00,0.00,12826,12827
17086,2,287,225,256.00,961.00,12826,12828
17087,1,512,512,512.00,0.00,12827,12828
17088,2,450,62,256.00,37636.00,12827,12829
17089,1,512,512,512.00,0.00,12828,12829
17090,2,290,222,256.00,1156.00,12828,12830
17091,1,512,512,512.00,0.00,12829,12830
17092,1,512,512,512.00,0.00,12829,12830
17093,2,432,80,256.00,30976.00,12829,12831
17094,3,397,2,170.67,27666.89,12830,12833
17095,1,512,512,512.00,0.00,12832,12833
17096,1,512,512,512.00,0.00,12832,12833
17097,1,512,512,512.00,0.00,12832,12833
17098,1,512,512,512.00,0.00,12832,12833
17099,2,327,185,256.00,5041.00,12832,12834
17100,1,512,512,512.00,0.00,12833,12834
17101,1,512,512,512.00,0.00,12833,12834
17102,1,512,512,512.00,0.00,12833,12834
17103,2,315,197,256.00,3481.00,12833,12835
17104,1,512,512,512.00,0.00,12834,12835
17105,1,512,512,512.00,0.00,12834,12835
17106,1,512,512,512.00,0.00,12834,12835
17107,1,512,512,512.00,0.00,12834,12835
17108,1,512,512,512.00,0.00,12834,12835
17109,3,349,3,170.67,20009.56,12834,12837
17110,1,512,512,512.00,0.00,12836,12837
17111,1,512,512,512.00,0.00,12836,12837
17112,2,444,68,256.00,35344.00,12836,12838
17113,3,219,126,170.67,1448.22,12837,12840
17114,1,512,512,512.00,0.00,12839,12840
17115,1,512,512,512.00,0.00,12839,12840
17116,1,512,512,512.00,0.00,12839,12840
17117,1,512,512,512.00,0.00,12839,12840
17118,1,512,512,512.00,0.00,12839,12840
17119,2,350,162,256.00,8836.00,12839,12841
17120,1,512,512,512.00,0.00,12840,12841
17121,3,191,158,170.67,210.89,12840,12843
17122,1,512,512,512.00,0.00,12842,12843
17123,1,512,512,512.00,0.00,12842,12843
17124,1,512,512,512.00,0.00,12842,12843
17125,2,448,64,256.00,36864.00,12842,12844
17126,1,512,512,512.00,0.00,12843,12844
17127,1,512,512,512.00,0.00,12843,12844
17128,1,512,512,512.00,0.00,12843,12844
17129,1,512,512,512.00,0.00,12843,12844
17130,1,512,512,512.00,0.00,12843,12844
17131,5,169,24,102.40,4118.64,12843,12848
17132,1,512,512,512.00,0.00,12847,12848
17133,1,512,512,512.00,0.00,12847,12848
17134,3,214,104,170.67,2288.89,12847,12850
17135,1,512,512,512.00,0.00,12849,12850
17136,1,512,512,512.00,0.00,12849,12850
17137,1,512,512,512.00,0.00,12849,12850
17138,1,512,512,512.00,0.00,12849,12850
17139,2,493,19,256.00,56169.00,12849,12851
17140,1,512,512,512.00,0.00,12850,12851
17141,1,512,512,512.00,0.00,12850,12851
17142,3,290,96,170.67,7270.22,12850,12853
17143,3,364,39,170.67,19505.56,12852,12855
17144,1,512,512,512.00,0.00,12854,12855
17145,4,319,1,128.00,18177.00,12854,12858
17146,5,362,1,102.40,17232.24,12857,12862
17147,1,512,512,512.00,0.00,12861,12862
17148,1,512,512,512.00,0.00,12861,12862
17149,2,268,244,256.00,144.00,12861,12863
17150,2,498,14,256.00,58564.00,12862,12864
17151,1,512,512,512.00,0.00,12863,12864
17152,2,441,71,256.00,34225.00,12863,12865
17153,4,240,1,128.00,9897.50,12864,12868
17154,1,512,512,512.00,0.00,12867,12868
17155,1,512,512,512.00,0.00,12867,12868
17156,1,512,512,512.00,0.00,12867,12868
17157,8,237,1,64.00,5585.75,12867,12875
17158,1,512,512,512.00,0.00,12874,12875
17159,1,512,512,512.00,0.00,12874,12875
17160,1,512,512,512.00,0.00,12874,12875
17161,2,355,157,256.00,9801.00,12874,12876
17162,1,512,512,512.00,0.00,12875,12876
17163,1,512,512,512.00,0.00,12875,12876
17164,3,253,21,170.67,11237.56,12875,12878
17165,1,512,512,512.00,0.00,12877,12878
17166,1,512,512,512.00,0.00,12877,12878
17167,1,512,512,512.00,0.00,12877,12878
17168,2,279,233,256.00,529.00,12877,12879
17169,1,512,512,512.00,0.00,12878,12879
17170,1,512,512,512.00,0.00,12878,12879
17171,1,512,512,512.00,0.00,12878,12879
17172,2,368,144,256.00,12544.00,12878,12880
17173,1,512,512,512.00,0.00,12879,12880
17174,1,512,512,512.00,0.00,12879,12880
17175,2,464,48,256.00,43264.00,12879,12881
17176,1,512,512,512.00,0.00,12880,12881
17177,1,512,512,512.00,0.00,12880,12881
17178,1,512,512,512.00,0.00,12880,12881
17179,1,512,512,512.00,0.00,12880,12881
17180,2,419,93,256.00,26569.00,12880,12882
17181,1,512,512,512.00,0.00,12881,12882
17182,2,491,21,256.00,55225.00,12881,12883
17183,3,286,106,170.67,6683.56,12882,12885
17184,3,256,27,170.67,10441.56,12884,12887
17185,7,290,1,73.14,9160.98,12886,12893
17186,1,512,512,512.00,0.00,12892,12893
17187,1,512,512,512.00,0.00,12892,12893
17188,3,430,22,170.67,33867.56,12892,12895
17189,1,512,512,512.00,0.00,12894,12895
17190,2,422,90,256.00,27556.00,12894,12896
17191,1,512,512,512.00,0.00,12895,12896
17192,1,512,512,512.00,0.00,12895,12896
17193,3,487,4,170.67,50081.56,12895,12898
17194,3,291,7,170.67,14381.56,12897,12900
17195,1,512,512,512.00,0.00,12899,12900
17196,1,512,512,512.00,0.00,12899,12900
17197,1,512,512,512.00,0.00,12899,12900
17198,2,290,222,256.00,1156.00,12899,12901
17199,1,512,512,512.00,0.00,12900,12901
17200,1,512,512,512.00,0.00,12900,12901
17201,3,386,2,170.67,25664.89,12900,12903
17202,2,430,82,256.00,30276.00,12902,12904
17203,2,482,30,256.00,51076.00,12903,12905
17204,3,381,5,170.67,24560.22,12904,12907
17205,3,441,7,170.67,37081.56,12906,12909
17206,4,404,1,128.00,26631.50,12908,12912
17207,2,474,38,256.00,47524.00,12911,12913
17208,1,512,512,512.00,0.00,12912,12913
17209,1,512,512,512.00,0.00,12912,12913
17210,2,390,122,256.00,17956.00,12912,12914
17211,2,495,17,256.00,57121.00,12913,12915
17212,1,512,512,512.00,0.00,12914,12915
17213,1,512,512,512.00,0.00,12914,12915
17214,5,297,4,102.40,12280.24,12914,12919
17215,3,213,135,170.67,1036.22,12918,12921
17216,2,335,177,256.00,6241.00,12920,12922
17217,2,325,187,256.00,4761.00,12921,12923
17218,2,288,224,256.00,1024.00,12922,12924
17219,6,279,1,85.33,9186.22,12923,12929
17220,1,512,512,512.00,0.00,12928,12929
17221,1,512,512,512.00,0.00,12928,12929
17222,2,323,189,256.00,4489.00,12928,12930
17223,4,436,4,128.00,32304.00,12929,12933
17224,2,403,109,256.00,21609.00,12932,12934
17225,1,512,512,512.00,0.00,12933,12934
17226,4,362,10,128.00,19910.00,12933,12937
17227,1,512,512,512.00,0.00,12936,12937
17228,2,358,154,256.00,10404.00,12936,12938
17229,1,512,512,512.00,0.00,12937,12938
17230,1,512,512,512.00,0.00,12937,12938
17231,1,512,512,512.00,0.00,12937,12938
17232,1,512,512,512.00,0.00,12937,12938
17233,2,386,126,256.00,16900.00,12937,12939
17234,1,512,512,512.00,0.00,12938,12939
17235,1,512,512,512.00,0.00,12938,12939
17236,1,512,512,512.00,0.00,12938,12939
17237,2,429,83,256.00,29929.00,12938,12940
17238,1,512,512,512.00,0.00,12939,12940
17239,1,512,512,512.00,0.00,12939,12940
17240,2,358,154,256.00,10404.00,12939,12941
17241,5,248,1,102.40,11315.44,12940,12945
17242,1,512,512,512.00,0.00,12944,12945
17243,2,465,47,256.00,43681.00,12944,12946
17244,1,512,512,512.00,0.00,12945,12946
17245,1,512,512,512.00,0.00,12945,12946
17246,1,512,512,512.00,0.00,12945,12946
17247,1,512,512,512.00,0.00,12945,12946
17248,1,512,512,512.00,0.00,12945,12946
17249,1,512,512,512.00,0.00,12945,12946
17250,4,408,15,128.00,26468.50,12945,12949
17251,2,439,73,256.00,33489.00,12948,12950
17252,1,512,512,512.00,0.00,12949,12950
17253,2,349,163,256.00,8649.00,12949,12951
17254,1,512,512,512.00,0.00,12950,12951
17255,1,512,512,512.00,0.00,12950,12951
17256,2,409,103,256.00,23409.00,12950,12952
17257,1,512,512,512.00,0.00,12951,12952
17258,1,512,512,512.00,0.00,12951,12952
17259,5,244,34,102.40,6815.44,12951,12956
17260,1,512,512,512.00,0.00,12955,12956
17261,1,512,512,512.00,0.00,12955,12956
17262,1,512,512,512.00,0.00,12955,12956
17263,5,452,4,102.40,30683.84,12955,12960
17264,1,512,512,512.00,0.00,12959,12960
17265,2,322,190,256.00,4356.00,12959,12961
17266,3,296,23,170.67,12670.89,12960,12963
17267,1,512,512,512.00,0.00,12962,12963
17268,1,512,512,512.00,0.00,12962,12963
17269,3,460,11,170.67,42006.89,12962,12965
17270,1,512,512,512.00,0.00,12964,12965
17271,1,512,512,512.00,0.00,12964,12965
17272,7,300,1,73.14,9845.27,12964,12971
17273,1,512,512,512.00,0.00,12970,12971
17274,1,512,512,512.00,0.00,12970,12971
17275,2,419,93,256.00,26569.00,12970,12972
17276,1,512,512,512.00,0.00,12971,12972
17277,1,512,512,512.00,0.00,12971,12972
17278,1,512,512,512.00,0.00,12971,12972
17279,2,289,223,256.00,1089.00,12971,12973
17280,2,370,142,256.00,12996.00,12972,12974
17281,4,246,3,128.00,10474.50,12973,12977
17282,1,512,512,512.00,0.00,12976,12977
17283,1,512,512,512.00,0.00,12976,12977
17284,1,512,512,512.00,0.00,12976,12977
17285,1,512,512,512.00,0.00,12976,12977
17286,2,323,189,256.00,4489.00,12976,12978
17287,3,363,6,170.67,21624.22,12977,12980
17288,1,512,512,512.00,0.00,12979,12980
17289,2,347,165,256.00,8281.00,12979,12981
17290,1,512,512,512.00,0.00,12980,12981
17291,1,512,512,512.00,0.00,12980,12981
17292,2,476,36,256.00,48400.00,12980,12982
17293,4,275,3,128.00,10473.50,12981,12985
17294,3,441,8,170.67,37044.22,12984,12987
17295,1,512,512,512.00,0.00,12986,12987
17296,1,512,512,512.00,0.00,12986,12987
17297,2,345,167,256.00,7921.00,12986,12988
17298,1,512,512,512.00,0.00,12987,12988
17299,2,504,8,256.00,61504.00,12987,12989
17300,3,342,33,170.67,16480.22,12988,12991
17301,8,217,1,64.00,5652.75,12990,12998
17302,1,512,512,512.00,0.00,12997,12998
17303,2,368,144,256.00,12544.00,12997,12999
17304,1,512,512,512.00,0.00,12998,12999
17305,3,442,10,170.67,37227.56,12998,13001
17306,1,512,512,512.00,0.00,13000,13001
17307,10,196,1,51.20,3728.76,13000,13010
17308,1,512,512,512.00,0.00,13009,13010
17309,1,512,512,512.00,0.00,13009,13010
17310,1,512,512,512.00,0.00,13009,13010
17311,3,388,15,170.67,25089.56,13009,13012
17312,1,512,512,512.00,0.00,13011,13012
17313,1,512,512,512.00,0.00,13011,13012
17314,1,512,512,512.00,0.00,13011,13012
17315,1,512,512,512.00,0.00,13011,13012
17316,1,512,512,512.00,0.00,13011,13012
17317,4,242,1,128.00,8787.50,13011,13015
17318,1,512,512,512.00,0.00,13014,13015
17319,1,512,512,512.00,0.00,13014,13015
17320,1,512,512,512.00,0.00,13014,13015
17321,1,512,512,512.00,0.00,13014,13015
17322,2,500,12,256.00,59536.00,13014,13016
17323,1,512,512,512.00,0.00,13015,13016
17324,1,512,512,512.00,0.00,13015,13016
17325,1,512,512,512.00,0.00,13015,13016
17326,1,512,512,512.00,0.00,13015,13016
17327,1,512,512,512.00,0.00,13015,13016
17328,1,512,512,512.00,0.00,13015,13016
17329,1,512,512,512.00,0.00,13015,13016
17330,1,512,512,512.00,0.00,13015,13016
17331,2,463,49,256.00,42849.00,13015,13017
17332,1,512,512,512.00,0.00,13016,13017
17333,1,512,512,512.00,0.00,13016,13017
17334,1,512,512,512.00,0.00,13016,13017
17335,2,474,38,256.00,47524.00,13016,13018
17336,2,397,115,256.00,19881.00,13017,13019
17337,1,512,512,512.00,0.00,13018,13019
17338,4,221,45,128.00,4059.00,13018,13022
17339,1,512,512,512.00,0.00,13021,13022
17340,1,512,512,512.00,0.00,13021,13022
17341,2,478,34,256.00,49284.00,13021,13023
17342,1,512,512,512.00,0.00,13022,13023
17343,2,511,1,256.00,65025.00,13022,13024
17344,1,512,512,512.00,0.00,13023,13024
17345,1,512,512,512.00,0.00,13023,13024
17346,1,512,512,512.00,0.00,13023,13024
17347,1,512,512,512.00,0.00,13023,13024
17348,2,399,113,256.00,20449.00,13023,13025
17349,1,512,512,512.00,0.00,13024,13025
17350,1,512,512,512.00,0.00,13024,13025
17351,1,512,512,512.00,0.00,13024,13025
17352,1,512,512,512.00,0.00,13024,13025
17353,1,512,512,512.00,0.00,13024,13025
17354,2,498,14,256.00,58564.00,13024,13026
17355,1,512,512,512.00,0.00,13025,13026
17356,1,512,512,512.00,0.00,13025,13026
17357,1,512,512,512.00,0.00,13025,13026
17358,3,444,4,170.67,37955.56,13025,13028
17359,4,336,4,128.00,18662.50,13027,13031
17360,3,337,22,170.67,16693.56,13030,13033
17361,1,512,512,512.00,0.00,13032,13033
17362,1,512,512,512.00,0.00,13032,13033
17363,2,375,137,256.00,14161.00,13032,13034
17364,1,512,512,512.00,0.00,13033,13034
17365,1,512,512,512.00,0.00,13033,13034
17366,1,512,512,512.00,0.00,13033,13034
17367,2,442,70,256.00,34596.00,13033,13035
17368,1,512,512,512.00,0.00,13034,13035
17369,1,512,512,512.00,0.00,13034,13035
17370,1,512,512,512.00,0.00,13034,13035
17371,1,512,512,512.00,0.00,13034,13035
17372,1,512,512,512.00,0.00,13034,13035
17373,4,334,4,128.00,15714.00,13034,13038
17374,4,232,9,128.00,6300.50,13037,13041
17375,1,512,512,512.00,0.00,13040,13041
17376,1,512,512,512.00,0.00,13040,13041
17377,3,444,31,170.67,37361.56,13040,13043
17378,1,512,512,512.00,0.00,13042,13043
17379,1,512,512,512.00,0.00,13042,13043
17380,1,512,512,512.00,0.00,13042,13043
17381,4,290,12,128.00,10197.50,13042,13046
17382,1,512,512,512.00,0.00,13045,13046
17383,1,512,512,512.00,0.00,13045,13046
17384,4,266,3,128.00,10966.50,13045,13049
17385,1,512,512,512.00,0.00,13048,13049
17386,1,512,512,512.00,0.00,13048,13049
17387,1,512,512,512.00,0.00,13048,13049
17388,3,337,5,170.67,18370.89,13048,13051
17389,5,442,3,102.40,28981.44,13050,13055
17390,1,512,512,512.00,0.00,13054,13055
17391,2,434,78,256.00,31684.00,13054,13056
17392,1,512,512,512.00,0.00,13055,13056
17393,1,512,512,512.00,0.00,13055,13056
17394,1,512,512,512.00,0.00,13055,13056
17395,3,312,75,170.67,10404.22,13055,13058
17396,2,374,138,256.00,13924.00,13057,13059
17397,1,512,512,512.00,0.00,13058,13059
17398,2,434,78,256.00,31684.00,13058,13060
17399,3,406,5,170.67,29226.89,13059,13062
17400,1,512,512,512.00,0.00,13061,13062
17401,1,512,512,512.00,0.00,13061,13062
17402,1,512,512,512.00,0.00,13061,13062
17403,1,512,512,512.00,0.00,13061,13062
17404,1,512,512,512.00,0.00,13061,13062
17405,1,512,512,512.00,0.00,13061,13062
17406,1,512,512,512.00,0.00,13061,13062
17407,1,512,512,512.00,0.00,13061,13062
17408,2,381,131,256.00,15625.00,13061,13063
17409,3,273,10,170.67,13229.56,13062,13065
17410,1,512,512,512.00,0.00,13064,13065
17411,1,512,512,512.00,0.00,13064,13065
17412,2,427,85,256.00,29241.00,13064,13066
17413,1,512,512,512.00,0.00,13065,13066
17414,1,512,512,512.00,0.00,13065,13066
17415,1,512,512,512.00,0.00,13065,13066
17416,2,403,109,256.00,21609.00,13065,13067
17417,3,325,67,170.67,12377.56,13066,13069
17418,1,512,512,512.00,0.00,13068,13069
17419,1,512,512,512.00,0.00,13068,13069
17420,1,512,512,512.00,0.00,13068,13069
17421,1,512,512,512.00,0.00,13068,13069
17422,2,406,106,256.00,22500.00,13068,13070
17423,1,512,512,512.00,0.00,13069,13070
17424,2,387,125,256.00,17161.00,13069,13071
17425,2,281,231,256.00,625.00,13070,13072
17426,1,512,512,512.00,0.00,13071,13072
17427,4,350,8,128.00,18626.00,13071,13075
17428,2,470,42,256.00,45796.00,13074,13076
17429,1,512,512,512.00,0.00,13075,13076
17430,4,265,3,128.00,12061.00,13075,13079
17431,1,512,512,512.00,0.00,13078,13079
17432,4,269,25,128.00,11003.00,13078,13082
17433,2,393,119,256.00,18769.00,13081,13083
17434,1,512,512,512.00,0.00,13082,13083
17435,1,512,512,512.00,0.00,13082,13083
17436,4,271,1,128.00,10744.50,13082,13086
17437,2,400,112,256.00,20736.00,13085,13087
17438,2,454,58,256.00,39204.00,13086,13088
17439,2,343,169,256.00,7569.00,13087,13089
17440,4,215,90,128.00,2589.50,13088,13092
17441,1,512,512,512.00,0.00,13091,13092
17442,1,512,512,512.00,0.00,13091,13092
17443,2,469,43,256.00,45369.00,13091,13093
17444,2,453,59,256.00,38809.00,13092,13094
17445,1,512,512,512.00,0.00,13093,13094
17446,1,512,512,512.00,0.00,13093,13094
17447,2,467,45,256.00,44521.00,13093,13095
17448,1,512,512,512.00,0.00,13094,13095
17449,3,494,6,170.67,52278.22,13094,13097
17450,1,512,512,512.00,0.00,13096,13097
17451,1,512,512,512.00,0.00,13096,13097
17452,1,512,512,512.00,0.00,13096,13097
17453,1,512,512,512.00,0.00,13096,13097
17454,2,334,178,256.00,6084.00,13096,13098
17455,1,512,512,512.00,0.00,13097,13098
17456,1,512,512,512.00,0.00,13097,13098
17457,1,512,512,512.00,0.00,13097,13098
17458,1,512,512,512.00,0.00,13097,13098
17459,1,512,512,512.00,0.00,13097,13098
17460,6,313,1,85.33,12794.22,13097,13103
17461,1,512,512,512.00,0.00,13102,13103
17462,1,512,512,512.00,0.00,13102,13103
17463,1,512,512,512.00,0.00,13102,13103
17464,1,512,512,512.00,0.00,13102,13103
17465,1,512,512,512.00,0.00,13102,13103
17466,1,512,512,512.00,0.00,13102,13103
17467,1,512,512,512.00,0.00,13102,13103
17468,1,512,512,512.00,0.00,13102,13103
17469,1,512,512,512.00,0.00,13102,13103
17470,3,266,60,170.67,7190.22,13102,13105
17471,1,512,512,512.00,0.00,13104,13105
17472,1,512,512,512.00,0.00,13104,13105
17473,2,401,111,256.00,21025.00,13104,13106
17474,1,512,512,512.00,0.00,13105,13106
17475,6,236,1,85.33,8234.56,13105,13111
17476,1,512,512,512.00,0.00,13110,13111
17477,4,324,1,128.00,18509.50,13110,13114
17478,1,512,512,512.00,0.00,13113,13114
17479,1,512,512,512.00,0.00,13113,13114
17480,3,328,31,170.67,14857.56,13113,13116
17481,3,429,23,170.67,33596.22,13115,13118
17482,1,512,512,512.00,0.00,13117,13118
17483,1,512,512,512.00,0.00,13117,13118
17484,1,512,512,512.00,0.00,13117,13118
17485,2,426,86,256.00,28900.00,13117,13119
17486,1,512,512,512.00,0.00,13118,13119
17487,1,512,512,512.00,0.00,13118,13119
17488,3,329,82,170.67,12594.89,13118,13121
17489,2,273,239,256.00,289.00,13120,13122
17490,1,512,512,512.00,0.00,13121,13122
17491,1,512,512,512.00,0.00,13121,13122
17492,2,402,110,256.00,21316.00,13121,13123
17493,1,512,512,512.00,0.00,13122,13123
17494,1,512,512,512.00,0.00,13122,13123
17495,1,512,512,512.00,0.00,13122,13123
17496,1,512,512,512.00,0.00,13122,13123
17497,4,274,1,128.00,11059.50,13122,13126
17498,6,241,3,85.33,7912.89,13125,13131
17499,1,512,512,512.00,0.00,13130,13131
17500,1,512,512,512.00,0.00,13130,13131
17501,5,262,4,102.40,13763.44,13130,13135
17502,1,512,512,512.00,0.00,13134,13135
17503,1,512,512,512.00,0.00,13134,13135
17504,3,405,1,170.67,29293.56,13134,13137
17505,2,294,218,256.00,1444.00,13136,13138
17506,2,368,144,256.00,12544.00,13137,13139
17507,1,512,512,512.00,0.00,13138,13139
17508,2,505,7,256.00,62001.00,13138,13140
17509,1,512,512,512.00,0.00,13139,13140
17510,1,512,512,512.00,0.00,13139,13140
17511,2,269,243,256.00,169.00,13139,13141
17512,3,421,6,170.67,32373.56,13140,13143
17513,1,512,512,512.00,0.00,13142,13143
17514,1,512,512,512.00,0.00,13142,13143
17515,2,266,246,256.00,100.00,13142,13144
17516,4,458,3,128.00,36504.50,13143,13147
17517,2,507,5,256.00,63001.00,13146,13148
17518,1,512,512,512.00,0.00,13147,13148
17519,1,512,512,512.00,0.00,13147,13148
17520,1,512,512,512.00,0.00,13147,13148
17521,3,295,3,170.67,15149.56,13147,13150
17522,2,435,77,256.00,32041.00,13149,13151
17523,1,512,512,512.00,0.00,13150,13151
17524,1,512,512,512.00,0.00,13150,13151
17525,6,203,4,85.33,4889.89,13150,13156
17526,1,512,512,512.00,0.00,13155,13156
17527,1,512,512,512.00,0.00,13155,13156
17528,2,273,239,256.00,289.00,13155,13157
17529,2,452,60,256.00,38416.00,13156,13158
17530,2,479,33,256.00,49729.00,13157,13159
17531,2,295,217,256.00,1521.00,13158,13160
17532,6,241,1,85.33,6456.56,13159,13165
17533,2,502,10,256.00,60516.00,13164,13166
17534,1,512,512,512.00,0.00,13165,13166
17535,3,400,40,170.67,26467.56,13165,13168
17536,3,283,5,170.67,14302.89,13167,13170
17537,1,512,512,512.00,0.00,13169,13170
17538,2,498,14,256.00,58564.00,13169,13171
17539,1,512,512,512.00,0.00,13170,13171
17540,1,512,512,512.00,0.00,13170,13171
17541,1,512,512,512.00,0.00,13170,13171
17542,1,512,512,512.00,0.00,13170,13171
17543,1,512,512,512.00,0.00,13170,13171
17544,1,512,512,512.00,0.00,13170,13171
17545,1,512,512,512.00,0.00,13170,13171
17546,2,356,156,256.00,10000.00,13170,13172
17547,1,512,512,512.00,0.00,13171,13172
17548,1,512,512,512.00,0.00,13171,13172
17549,1,512,512,512.00,0.00,13171,13172
17550,1,512,512,512.00,0.00,13171,13172
17551,4,337,3,128.00,15769.00,13171,13175
17552,3,286,1,170.67,15013.56,13174,13177
17553,1,512,512,512.00,0.00,13176,13177
17554,2,498,14,256.00,58564.00,13176,13178
17555,2,451,61,256.00,38025.00,13177,13179
17556,1,512,512,512.00,0.00,13178,13179
17557,1,512,512,512.00,0.00,13178,13179
17558,1,512,512,512.00,0.00,13178,13179
17559,2,485,27,256.00,52441.00,13178,13180
17560,1,512,512,512.00,0.00,13179,13180
17561,3,326,23,170.67,15330.89,13179,13182
17562,1,512,512,512.00,0.00,13181,13182
17563,3,333,58,170.67,13837.56,13181,13184
17564,1,512,512,512.00,0.00,13183,13184
17565,2,393,119,256.00,18769.00,13183,13185
17566,3,333,5,170.67,17936.22,13184,13187
17567,2,315,197,256.00,3481.00,13186,13188
17568,1,512,512,512.00,0.00,13187,13188
17569,1,512,512,512.00,0.00,13187,13188
17570,1,512,512,512.00,0.00,13187,13188
17571,2,260,252,256.00,16.00,13187,13189
17572,4,269,32,128.00,8307.50,13188,13192
17573,3,331,2,170.67,18074.89,13191,13194
17574,2,262,250,256.00,36.00,13193,13195
17575,1,512,512,512.00,0.00,13194,13195
17576,3,421,3,170.67,32537.56,13194,13197
17577,1,512,512,512.00,0.00,13196,13197
17578,1,512,512,512.00,0.00,13196,13197
17579,1,512,512,512.00,0.00,13196,13197
17580,3,224,79,170.67,4238.89,13196,13199
17581,2,431,81,256.00,30625.00,13198,13200
17582,1,512,512,512.00,0.00,13199,13200
17583,1,512,512,512.00,0.00,13199,13200
17584,2,493,19,256.00,56169.00,13199,13201
17585,1,512,512,512.00,0.00,13200,13201
17586,1,512,512,512.00,0.00,13200,13201
17587,2,496,16,256.00,57600.00,13200,13202
17588,1,512,512,512.00,0.00,13201,13202
17589,2,277,235,256.00,441.00,13201,13203
17590,3,293,17,170.67,13186.89,13202,13205
17591,3,481,11,170.67,48166.89,13204,13207
17592,2,381,131,256.00,15625.00,13206,13208
17593,1,512,512,512.00,0.00,13207,13208
17594,1,512,512,512.00,0.00,13207,13208
17595,2,302,210,256.00,2116.00,13207,13209
17596,2,368,144,256.00,12544.00,13208,13210
17597,3,339,16,170.67,17481.56,13209,13212
17598,1,512,512,512.00,0.00,13211,13212
17599,1,512,512,512.00,0.00,13211,13212
17600,3,271,13,170.67,12737.56,13211,13214
17601,1,512,512,512.00,0.00,13213,13214
17602,2,288,224,256.00,1024.00,13213,13215
17603,1,512,512,512.00,0.00,13214,13215
17604,1,512,512,512.00,0.00,13214,13215
17605,1,512,512,512.00,0.00,13214,13215
17606,3,251,13,170.67,12430.89,13214,13217
17607,4,310,25,128.00,12091.50,13216,13220
17608,1,512,512,512.00,0.00,13219,13220
17609,1,512,512,512.00,0.00,13219,13220
17610,1,512,512,512.00,0.00,13219,13220
17611,2,278,234,256.00,484.00,13219,13221
17612,1,512,512,512.00,0.00,13220,13221
17613,1,512,512,512.00,0.00,13220,13221
17614,1,512,512,512.00,0.00,13220,13221
17615,1,512,512,512.00,0.00,13220,13221
17616,2,463,49,256.00,42849.00,13220,13222
17617,1,512,512,512.00,0.00,13221,13222
17618,5,473,1,102.40,34427.44,13221,13226
17619,1,512,512,512.00,0.00,13225,13226
17620,1,512,512,512.00,0.00,13225,13226
17621,1,512,512,512.00,0.00,13225,13226
17622,1,512,512,512.00,0.00,13225,13226
17623,3,314,12,170.67,15318.22,13225,13228
17624,2,501,11,256.00,60025.00,13227,13229
17625,1,512,512,512.00,0.00,13228,13229
17626,1,512,512,512.00,0.00,13228,13229
17627,1,512,512,512.00,0.00,13228,13229
17628,1,512,512,512.00,0.00,13228,13229
17629,2,375,137,256.00,14161.00,13228,13230
17630,3,312,7,170.67,15753.56,13229,13232
17631,1,512,512,512.00,0.00,13231,13232
17632,3,483,1,170.67,48897.56,13231,13234
17633,1,512,512,512.00,0.00,13233,13234
17634,1,512,512,512.00,0.00,13233,13234
17635,1,512,512,512.00,0.00,13233,13234
17636,1,512,512,512.00,0.00,13233,13234
17637,3,405,42,170.67,27544.22,13233,13236
17638,1,512,512,512.00,0.00,13235,13236
17639,1,512,512,512.00,0.00,13235,13236
17640,6,358,3,85.33,16036.22,13235,13241
17641,1,512,512,512.00,0.00,13240,13241
17642,1,512,512,512.00,0.00,13240,13241
17643,1,512,512,512.00,0.00,13240,13241
17644,1,512,512,512.00,0.00,13240,13241
17645,2,428,84,256.00,29584.00,13240,13242
17646,1,512,512,512.00,0.00,13241,13242
17647,1,512,512,512.00,0.00,13241,13242
17648,2,470,42,256.00,45796.00,13241,13243
17649,2,383,129,256.00,16129.00,13242,13244
17650,4,261,1,128.00,16147.00,13243,13247
17651,1,512,512,512.00,0.00,13246,13247
17652,1,512,512,512.00,0.00,13246,13247
17653,1,512,512,512.00,0.00,13246,13247
17654,3,357,39,170.67,18348.22,13246,13249
17655,4,461,1,128.00,37259.00,13248,13252
17656,1,512,512,512.00,0.00,13251,13252
17657,3,277,17,170.67,12386.89,13251,13254
17658,2,453,59,256.00,38809.00,13253,13255
17659,1,512,512,512.00,0.00,13254,13255
17660,1,512,512,512.00,0.00,13254,13255
17661,6,360,5,85.33,15579.89,13254,13260
17662,2,471,41,256.00,46225.00,13259,13261
17663,1,512,512,512.00,0.00,13260,13261
17664,1,512,512,512.00,0.00,13260,13261
17665,1,512,512,512.00,0.00,13260,13261
17666,5,260,17,102.40,7123.44,13260,13265
17667,3,497,4,170.67,53254.89,13264,13267
17668,1,512,512,512.00,0.00,13266,13267
17669,2,453,59,256.00,38809.00,13266,13268
17670,2,357,155,256.00,10201.00,13267,13269
17671,1,512,512,512.00,0.00,13268,13269
17672,1,512,512,512.00,0.00,13268,13269
17673,1,512,512,512.00,0.00,13268,13269
17674,1,512,512,512.00,0.00,13268,13269
17675,2,389,123,256.00,17689.00,13268,13270
17676,1,512,512,512.00,0.00,13269,13270
17677,3,428,32,170.67,33176.89,13269,13272
17678,1,512,512,512.00,0.00,13271,13272
17679,1,512,512,512.00,0.00,13271,13272
17680,3,403,12,170.67,28193.56,13271,13274
17681,1,512,512,512.00,0.00,13273,13274
17682,1,512,512,512.00,0.00,13273,13274
17683,3,275,86,170.67,6146.89,13273,13276
17684,2,349,163,256.00,8649.00,13275,13277
17685,2,272,240,256.00,256.00,13276,13278
17686,2,292,220,256.00,1296.00,13277,13279
17687,1,512,512,512.00,0.00,13278,13279
17688,1,512,512,512.00,0.00,13278,13279
17689,1,512,512,512.00,0.00,13278,13279
17690,2,320,192,256.00,4096.00,13278,13280
17691,1,512,512,512.00,0.00,13279,13280
17692,2,497,15,256.00,58081.00,13279,13281
17693,1,512,512,512.00,0.00,13280,13281
17694,2,370,142,256.00,12996.00,13280,13282
17695,1,512,512,512.00,0.00,13281,13282
17696,1,512,512,512.00,0.00,13281,13282
17697,3,280,72,170.67,7267.56,13281,13284
17698,2,472,40,256.00,46656.00,13283,13285
17699,1,512,512,512.00,0.00,13284,13285
17700,2,384,128,256.00,16384.00,13284,13286
17701,1,512,512,512.00,0.00,13285,13286
17702,1,512,512,512.00,0.00,13285,13286
17703,1,512,512,512.00,0.00,13285,13286
17704,1,512,512,512.00,0.00,13285,13286
17705,3,433,16,170.67,34777.56,13285,13288
17706,5,455,1,102.40,31196.24,13287,13292
17707,3,461,3,170.67,42484.22,13291,13294
17708,3,244,80,170.67,4632.89,13293,13296
17709,6,214,1,85.33,7436.89,13295,13301
17710,1,512,512,512.00,0.00,13300,13301
17711,2,387,125,256.00,17161.00,13300,13302
17712,3,506,1,170.67,56226.89,13301,13304
17713,4,459,3,128.00,36781.50,13303,13307
17714,2,418,94,256.00,26244.00,13306,13308
17715,3,284,100,170.67,6552.89,13307,13310
17716,2,293,219,256.00,1369.00,13309,13311
17717,1,512,512,512.00,0.00,13310,13311
17718,1,512,512,512.00,0.00,13310,13311
17719,2,403,109,256.00,21609.00,13310,13312
17720,1,512,512,512.00,0.00,13311,13312
17721,1,512,512,512.00,0.00,13311,13312
17722,1,512,512,512.00,0.00,13311,13312
17723,1,512,512,512.00,0.00,13311,13312
17724,1,512,512,512.00,0.00,13311,13312
17725,4,401,8,128.00,25224.50,13311,13315
17726,1,512,512,512.00,0.00,13314,13315
17727,1,512,512,512.00,0.00,13314,13315
17728,2,391,121,256.00,18225.00,13314,13316
17729,2,371,141,256.00,13225.00,13315,13317
17730,2,309,203,256.00,2809.00,13316,13318
17731,1,512,512,512.00,0.00,13317,13318
17732,1,512,512,512.00,0.00,13317,13318
17733,2,322,190,256.00,4356.00,13317,13319
17734,1,512,512,512.00,0.00,13318,13319
17735,1,512,512,512.00,0.00,13318,13319
17736,1,512,512,512.00,0.00,13318,13319
17737,2,359,153,256.00,10609.00,13318,13320
17738,1,512,512,512.00,0.00,13319,13320
17739,1,512,512,512.00,0.00,13319,13320
17740,1,512,512,512.00,0.00,13319,13320
17741,1,512,512,512.00,0.00,13319,13320
17742,1,512,512,512.00,0.00,13319,13320
17743,1,512,512,512.00,0.00,13319,13320
17744,1,512,512,512.00,0.00,13319,13320
17745,1,512,512,512.00,0.00,13319,13320
17746,1,512,512,512.00,0.00,13319,13320
17747,1,512,512,512.00,0.00,13319,13320
17748,1,512,512,512.00,0.00,13319,13320
17749,1,512,512,512.00,0.00,13319,13320
17750,3,475,4,170.67,46449.56,13319,13322
17751,1,512,512,512.00,0.00,13321,13322
17752,1,512,512,512.00,0.00,13321,13322
17753,2,504,8,256.00,61504.00,13321,13323
17754,1,512,512,512.00,0.00,13322,13323
17755,2,422,90,256.00,27556.00,13322,13324
17756,1,512,512,512.00,0.00,13323,13324
17757,1,512,512,512.00,0.00,13323,13324
17758,1,512,512,512.00,0.00,13323,13324
17759,3,333,56,170.67,13924.22,13323,13326
17760,4,385,10,128.00,23074.50,13325,13329
17761,2,458,54,256.00,40804.00,13328,13330
17762,3,409,2,170.67,30034.89,13329,13332
17763,1,512,512,512.00,0.00,13331,13332
17764,1,512,512,512.00,0.00,13331,13332
17765,1,512,512,512.00,0.00,13331,13332
17766,1,512,512,512.00,0.00,13331,13332
17767,3,434,7,170.67,35354.89,13331,13334
17768,4,418,2,128.00,29238.00,13333,13337
17769,1,512,512,512.00,0.00,13336,13337
17770,1,512,512,512.00,0.00,13336,13337
17771,2,411,101,256.00,24025.00,13336,13338
17772,1,512,512,512.00,0.00,13337,13338
17773,1,512,512,512.00,0.00,13337,13338
17774,5,361,3,102.40,18631.04,13337,13342
17775,2,426,86,256.00,28900.00,13341,13343
17776,1,512,512,512.00,0.00,13342,13343
17777,2,428,84,256.00,29584.00,13342,13344
17778,1,512,512,512.00,0.00,13343,13344
17779,1,512,512,512.00,0.00,13343,13344
17780,3,428,2,170.67,34176.89,13343,13346
17781,1,512,512,512.00,0.00,13345,13346
17782,1,512,512,512.00,0.00,13345,13346
17783,3,306,34,170.67,12331.56,13345,13348
17784,1,512,512,512.00,0.00,13347,13348
17785,1,512,512,512.00,0.00,13347,13348
17786,2,418,94,256.00,26244.00,13347,13349
17787,3,484,13,170.67,49089.56,13348,13351
17788,1,512,512,512.00,0.00,13350,13351
17789,1,512,512,512.00,0.00,13350,13351
17790,1,512,512,512.00,0.00,13350,13351
17791,2,493,19,256.00,56169.00,13350,13352
17792,1,512,512,512.00,0.00,13351,13352
17793,1,512,512,512.00,0.00,13351,13352
17794,5,235,33,102.40,4918.24,13351,13356
17795,2,356,156,256.00,10000.00,13355,13357
17796,1,512,512,512.00,0.00,13356,13357
17797,3,280,36,170.67,10243.56,13356,13359
17798,1,512,512,512.00,0.00,13358,13359
17799,4,360,3,128.00,19321.50,13358,13362
17800,1,512,512,512.00,0.00,13361,13362
17801,1,512,512,512.00,0.00,13361,13362
17802,1,512,512,512.00,0.00,13361,13362
17803,1,512,512,512.00,0.00,13361,13362
17804,1,512,512,512.00,0.00,13361,13362
17805,1,512,512,512.00,0.00,13361,13362
17806,1,512,512,512.00,0.00,13361,13362
17807,1,512,512,512.00,0.00,13361,13362
17808,2,359,153,256.00,10609.00,13361,13363
17809,2,460,52,256.00,41616.00,13362,13364
17810,1,512,512,512.00,0.00,13363,13364
17811,1,512,512,512.00,0.00,13363,13364
17812,1,512,512,512.00,0.00,13363,13364
17813,1,512,512,512.00,0.00,13363,13364
17814,3,317,3,170.67,16660.22,13363,13366
17815,4,337,8,128.00,15576.50,13365,13369
17816,1,512,512,512.00,0.00,13368,13369
17817,1,512,512,512.00,0.00,13368,13369
17818,1,512,512,512.00,0.00,13368,13369
17819,5,275,1,102.40,8905.04,13368,13373
17820,1,512,512,512.00,0.00,13372,13373
17821,1,512,512,512.00,0.00,13372,13373
17822,2,503,9,256.00,61009.00,13372,13374
17823,3,441,8,170.67,37044.22,13373,13376
17824,1,512,512,512.00,0.00,13375,13376
17825,1,512,512,512.00,0.00,13375,13376
17826,1,512,512,512.00,0.00,13375,13376
17827,1,512,512,512.00,0.00,13375,13376
17828,2,293,219,256.00,1369.00,13375,13377
17829,1,512,512,512.00,0.00,13376,13377
17830,5,238,2,102.40,6257.84,13376,13381
17831,1,512,512,512.00,0.00,13380,13381
17832,2,350,162,256.00,8836.00,13380,13382
17833,2,436,76,256.00,32400.00,13381,13383
17834,1,512,512,512.00,0.00,13382,13383
17835,1,512,512,512.00,0.00,13382,13383
17836,1,512,512,512.00,0.00,13382,13383
17837,2,461,51,256.00,42025.00,13382,13384
17838,2,504,8,256.00,61504.00,13384,13386
17839,1,512,512,512.00,0.00,13385,13386
17840,2,370,142,256.00,12996.00,13385,13387
17841,1,512,512,512.00,0.00,13386,13387
17842,1,512,512,512.00,0.00,13386,13387
17843,1,512,512,512.00,0.00,13386,13387
17844,2,414,98,256.00,24964.00,13386,13388
17845,4,421,4,128.00,29129.50,13387,13391
17846,2,431,81,256.00,30625.00,13390,13392
17847,1,512,512,512.00,0.00,13391,13392
17848,2,501,11,256.00,60025.00,13391,13393
17849,3,210,97,170.67,2717.56,13392,13395
17850,1,512,512,512.00,0.00,13394,13395
17851,1,512,512,512.00,0.00,13394,13395
17852,1,512,512,512.00,0.00,13394,13395
17853,3,479,16,170.67,47534.89,13394,13397
17854,1,512,512,512.00,0.00,13396,13397
17855,2,278,234,256.00,484.00,13396,13398
17856,1,512,512,512.00,0.00,13397,13398
17857,1,512,512,512.00,0.00,13397,13398
17858,1,512,512,512.00,0.00,13397,13398
17859,3,332,7,170.67,17606.89,13397,13400
17860,2,322,190,256.00,4356.00,13399,13401
17861,1,512,512,512.00,0.00,13400,13401
17862,1,512,512,512.00,0.00,13400,13401
17863,1,512,512,512.00,0.00,13400,13401
17864,1,512,512,512.00,0.00,13400,13401
17865,3,458,3,170.67,41664.22,13400,13403
17866,2,322,190,256.00,4356.00,13402,13404
17867,1,512,512,512.00,0.00,13403,13404
17868,1,512,512,512.00,0.00,13403,13404
17869,2,412,100,256.00,24336.00,13403,13405
17870,3,361,1,170.67,21813.56,13404,13407
17871,1,512,512,512.00,0.00,13406,13407
17872,1,512,512,512.00,0.00,13406,13407
17873,1,512,512,512.00,0.00,13406,13407
17874,1,512,512,512.00,0.00,13406,13407
17875,2,327,185,256.00,5041.00,13406,13408
17876,1,512,512,512.00,0.00,13407,13408
17877,1,512,512,512.00,0.00,13407,13408
17878,1,512,512,512.00,0.00,13407,13408
17879,1,512,512,512.00,0.00,13407,13408
17880,1,512,512,512.00,0.00,13407,13408
17881,1,512,512,512.00,0.00,13407,13408
17882,3,457,12,170.67,41153.56,13407,13410
17883,1,512,512,512.00,0.00,13409,13410
17884,1,512,512,512.00,0.00,13409,13410
17885,2,409,103,256.00,23409.00,13409,13411
17886,3,277,21,170.67,11861.56,13410,13413
17887,5,304,2,102.40,11365.84,13412,13417
17888,1,512,512,512.00,0.00,13416,13417
17889,1,512,512,512.00,0.00,13416,13417
17890,1,512,512,512.00,0.00,13416,13417
17891,3,354,33,170.67,18216.22,13416,13419
17892,3,358,42,170.67,18363.56,13418,13421
17893,1,512,512,512.00,0.00,13420,13421
17894,1,512,512,512.00,0.00,13420,13421
17895,1,512,512,512.00,0.00,13420,13421
17896,2,482,30,256.00,51076.00,13420,13422
17897,2,464,48,256.00,43264.00,13421,13423
17898,2,485,27,256.00,52441.00,13422,13424
17899,3,311,5,170.67,15926.89,13423,13426
17900,1,512,512,512.00,0.00,13425,13426
17901,1,512,512,512.00,0.00,13425,13426
17902,1,512,512,512.00,0.00,13425,13426
17903,1,512,512,512.00,0.00,13425,13426
17904,1,512,512,512.00,0.00,13425,13426
17905,1,512,512,512.00,0.00,13425,13426
17906,1,512,512,512.00,0.00,13425,13426
17907,2,496,16,256.00,57600.00,13425,13427
17908,1,512,512,512.00,0.00,13426,13427
17909,1,512,512,512.00,0.00,13426,13427
17910,2,322,190,256.00,4356.00,13426,13428
17911,2,358,154,256.00,10404.00,13427,13429
17912,2,358,154,256.00,10404.00,13428,13430
17913,2,408,104,256.00,23104.00,13429,13431
17914,2,461,51,256.00,42025.00,13430,13432
17915,1,512,512,512.00,0.00,13431,13432
17916,1,512,512,512.00,0.00,13431,13432
17917,3,278,18,170.67,12294.22,13431,13434
17918,1,512,512,512.00,0.00,13433,13434
17919,1,512,512,512.00,0.00,13433,13434
17920,2,286,226,256.00,900.00,13433,13435
17921,1,512,512,512.00,0.00,13434,13435
17922,2,483,29,256.00,51529.00,13434,13436
17923,2,302,210,256.00,2116.00,13435,13437
17924,1,512,512,512.00,0.00,13436,13437
17925,1,512,512,512.00,0.00,13436,13437
17926,1,512,512,512.00,0.00,13436,13437
17927,2,310,202,256.00,2916.00,13436,13438
17928,2,461,51,256.00,42025.00,13437,13439
17929,2,408,104,256.00,23104.00,13438,13440
17930,2,266,246,256.00,100.00,13439,13441
17931,1,512,512,512.00,0.00,13440,13441
17932,2,334,178,256.00,6084.00,13440,13442
17933,1,512,512,512.00,0.00,13441,13442
17934,1,512,512,512.00,0.00,13441,13442
17935,1,512,512,512.00,0.00,13441,13442
17936,2,296,216,256.00,1600.00,13441,13443
17937,1,512,512,512.00,0.00,13442,13443
17938,1,512,512,512.00,0.00,13442,13443
17939,1,512,512,512.00,0.00,13442,13443
17940,1,512,512,512.00,0.00,13442,13443
17941,2,282,230,256.00,676.00,13442,13444
17942,1,512,512,512.00,0.00,13443,13444
17943,1,512,512,512.00,0.00,13443,13444
17944,1,512,512,512.00,0.00,13443,13444
17945,1,512,512,512.00,0.00,13443,13444
17946,1,512,512,512.00,0.00,13443,13444
17947,2,444,68,256.00,35344.00,13443,13445
17948,2,500,12,256.00,59536.00,13444,13446
17949,1,512,512,512.00,0.00,13445,13446
17950,1,512,512,512.00,0.00,13445,13446
17951,2,429,83,256.00,29929.00,13445,13447
17952,2,444,68,256.00,35344.00,13446,13448
17953,2,383,129,256.00,16129.00,13447,13449
17954,1,512,512,512.00,0.00,13448,13449
17955,1,512,512,512.00,0.00,13448,13449
17956,1,512,512,512.00,0.00,13448,13449
17957,2,462,50,256.00,42436.00,13448,13450
17958,1,512,512,512.00,0.00,13449,13450
17959,1,512,512,512.00,0.00,13449,13450
17960,1,512,512,512.00,0.00,13449,13450
17961,1,512,512,512.00,0.00,13449,13450
17962,3,356,5,170.67,20726.89,13449,13452
17963,2,434,78,256.00,31684.00,13451,13453
17964,1,512,512,512.00,0.00,13452,13453
17965,2,504,8,256.00,61504.00,13452,13454
17966,1,512,512,512.00,0.00,13453,13454
17967,1,512,512,512.00,0.00,13453,13454
17968,1,512,512,512.00,0.00,13453,13454
17969,2,335,177,256.00,6241.00,13453,13455
17970,1,512,512,512.00,0.00,13454,13455
17971,3,207,137,170.67,820.22,13454,13457
17972,1,512,512,512.00,0.00,13456,13457
17973,1,512,512,512.00,0.00,13456,13457
17974,2,320,192,256.00,4096.00,13456,13458
17975,1,512,512,512.00,0.00,13457,13458
17976,2,333,179,256.00,5929.00,13457,13459
17977,2,361,151,256.00,11025.00,13458,13460
17978,2,429,83,256.00,29929.00,13459,13461
17979,1,512,512,512.00,0.00,13460,13461
17980,2,361,151,256.00,11025.00,13460,13462
17981,1,512,512,512.00,0.00,13461,13462
17982,2,423,89,256.00,27889.00,13461,13463
17983,1,512,512,512.00,0.00,13462,13463
17984,2,500,12,256.00,59536.00,13462,13464
17985,1,512,512,512.00,0.00,13463,13464
17986,2,443,69,256.00,34969.00,13463,13465
17987,1,512,512,512.00,0.00,13464,13465
17988,1,512,512,512.00,0.00,13464,13465
17989,1,512,512,512.00,0.00,13464,13465
17990,1,512,512,512.00,0.00,13464,13465
17991,2,272,240,256.00,256.00,13464,13466
17992,1,512,512,512.00,0.00,13465,13466
17993,2,486,26,256.00,52900.00,13465,13467
17994,2,435,77,256.00,32041.00,13466,13468
17995,1,512,512,512.00,0.00,13467,13468
17996,1,512,512,512.00,0.00,13467,13468
17997,1,512,512,512.00,0.00,13467,13468
17998,1,512,512,512.00,0.00,13467,13468
17999,2,418,94,256.00,26244.00,13467,13469
18000,4,394,16,128.00,24239.50,13468,13472
18001,3,222,76,170.67,4491.56,13471,13474
18002,6,195,1,85.33,3967.22,13473,13479
18003,1,512,512,512.00,0.00,13478,13479
18004,1,512,512,512.00,0.00,13478,13479
18005,2,376,136,256.00,14400.00,13478,13480
18006,1,512,512,512.00,0.00,13479,13480
18007,1,512,512,512.00,0.00,13479,13480
18008,2,374,138,256.00,13924.00,13479,13481
18009,1,512,512,512.00,0.00,13480,13481
18010,3,402,45,170.67,26824.22,13480,13483
18011,1,512,512,512.00,0.00,13482,13483
18012,1,512,512,512.00,0.00,13482,13483
18013,1,512,512,512.00,0.00,13482,13483
18014,3,226,66,170.67,5483.56,13482,13485
18015,1,512,512,512.00,0.00,13484,13485
18016,1,512,512,512.00,0.00,13484,13485
18017,2,437,75,256.00,32761.00,13484,13486
18018,1,512,512,512.00,0.00,13485,13486
18019,4,267,8,128.00,12661.50,13485,13489
18020,1,512,512,512.00,0.00,13488,13489
18021,1,512,512,512.00,0.00,13488,13489
18022,2,486,26,256.00,52900.00,13488,13490
18023,1,512,512,512.00,0.00,13489,13490
18024,2,455,57,256.00,39601.00,13489,13491
18025,1,512,512,512.00,0.00,13490,13491
18026,1,512,512,512.00,0.00,13490,13491
18027,2,394,118,256.00,19044.00,13490,13492
18028,1,512,512,512.00,0.00,13491,13492
18029,1,512,512,512.00,0.00,13491,13492
18030,3,487,7,170.67,50053.56,13491,13494
18031,1,512,512,512.00,0.00,13493,13494
18032,5,272,5,102.40,9516.24,13493,13498
18033,1,512,512,512.00,0.00,13497,13498
18034,1,512,512,512.00,0.00,13497,13498
18035,4,277,27,128.00,9589.00,13497,13501
18036,1,512,512,512.00,0.00,13500,13501
18037,1,512,512,512.00,0.00,13500,13501
18038,1,512,512,512.00,0.00,13500,13501
18039,1,512,512,512.00,0.00,13500,13501
18040,1,512,512,512.00,0.00,13500,13501
18041,4,172,81,128.00,1667.50,13500,13504
18042,2,483,29,256.00,51529.00,13503,13505
18043,2,304,208,256.00,2304.00,13504,13506
18044,4,365,11,128.00,19656.50,13505,13509
18045,2,342,170,256.00,7396.00,13508,13510
18046,1,512,512,512.00,0.00,13509,13510
18047,2,264,248,256.00,64.00,13509,13511
18048,1,512,512,512.00,0.00,13510,13511
18049,1,512,512,512.00,0.00,13510,13511
18050,2,501,11,256.00,60025.00,13510,13512
18051,3,468,7,170.67,44353.56,13511,13514
18052,1,512,512,512.00,0.00,13513,13514
18053,1,512,512,512.00,0.00,13513,13514
18054,4,346,20,128.00,17109.50,13513,13517
18055,2,328,184,256.00,5184.00,13516,13518
18056,2,345,167,256.00,7921.00,13517,13519
18057,1,512,512,512.00,0.00,13518,13519
18058,1,512,512,512.00,0.00,13518,13519
18059,1,512,512,512.00,0.00,13518,13519
18060,1,512,512,512.00,0.00,13518,13519
18061,1,512,512,512.00,0.00,13518,13519
18062,2,475,37,256.00,47961.00,13518,13520
18063,1,512,512,512.00,0.00,13519,13520
18064,1,512,512,512.00,0.00,13519,13520
18065,1,512,512,512.00,0.00,13519,13520
18066,2,438,74,256.00,33124.00,13519,13521
18067,1,512,512,512.00,0.00,13520,13521
18068,1,512,512,512.00,0.00,13520,13521
18069,1,512,512,512.00,0.00,13520,13521
18070,1,512,512,512.00,0.00,13520,13521
18071,1,512,512,512.00,0.00,13520,13521
18072,3,474,11,170.67,46048.22,13521,13524
18073,2,309,203,256.00,2809.00,13523,13525
18074,1,512,512,512.00,0.00,13524,13525
18075,3,475,5,170.67,46430.89,13524,13527
18076,2,500,12,256.00,59536.00,13526,13528
18077,1,512,512,512.00,0.00,13527,13528
18078,1,512,512,512.00,0.00,13527,13528
18079,2,510,2,256.00,64516.00,13527,13529
18080,1,512,512,512.00,0.00,13528,13529
18081,2,504,8,256.00,61504.00,13528,13530
18082,1,512,512,512.00,0.00,13529,13530
18083,1,512,512,512.00,0.00,13529,13530
18084,1,512,512,512.00,0.00,13529,13530
18085,2,468,44,256.00,44944.00,13529,13531
18086,2,357,155,256.00,10201.00,13530,13532
18087,4,363,12,128.00,18968.50,13531,13535
18088,1,512,512,512.00,0.00,13534,13535
18089,1,512,512,512.00,0.00,13534,13535
18090,1,512,512,512.00,0.00,13534,13535
18091,1,512,512,512.00,0.00,13534,13535
18092,1,512,512,512.00,0.00,13534,13535
18093,1,512,512,512.00,0.00,13534,13535
18094,2,268,244,256.00,144.00,13534,13536
18095,1,512,512,512.00,0.00,13535,13536
18096,1,512,512,512.00,0.00,13535,13536
18097,1,512,512,512.00,0.00,13535,13536
18098,4,457,8,128.00,36135.50,13535,13539
18099,1,512,512,512.00,0.00,13538,13539
18100,2,459,53,256.00,41209.00,13538,13540
18101,1,512,512,512.00,0.00,13539,13540
18102,1,512,512,512.00,0.00,13539,13540
18103,1,512,512,512.00,0.00,13539,13540
18104,1,512,512,512.00,0.00,13539,13540
18105,1,512,512,512.00,0.00,13539,13540
18106,3,344,21,170.67,17668.22,13539,13542
18107,1,512,512,512.00,0.00,13541,13542
18108,1,512,512,512.00,0.00,13541,13542
18109,2,511,1,256.00,65025.00,13541,13543
18110,1,512,512,512.00,0.00,13542,13543
18111,3,221,120,170.67,1700.22,13542,13545
18112,1,512,512,512.00,0.00,13544,13545
18113,1,512,512,512.00,0.00,13544,13545
18114,3,361,4,170.67,21521.56,13544,13547
18115,3,261,22,170.67,11221.56,13546,13549
18116,1,512,512,512.00,0.00,13548,13549
18117,1,512,512,512.00,0.00,13548,13549
18118,1,512,512,512.00,0.00,13548,13549
18119,2,399,113,256.00,20449.00,13548,13550
18120,2,280,232,256.00,576.00,13549,13551
18121,1,512,512,512.00,0.00,13550,13551
18122,1,512,512,512.00,0.00,13550,13551
18123,2,355,157,256.00,9801.00,13550,13552
18124,1,512,512,512.00,0.00,13551,13552
18125,1,512,512,512.00,0.00,13551,13552
18126,1,512,512,512.00,0.00,13551,13552
18127,1,512,512,512.00,0.00,13551,13552
18128,1,512,512,512.00,0.00,13551,13552
18129,1,512,512,512.00,0.00,13551,13552
18130,2,302,210,256.00,2116.00,13551,13553
18131,2,328,184,256.00,5184.00,13552,13554
18132,1,512,512,512.00,0.00,13553,13554
18133,1,512,512,512.00,0.00,13553,13554
18134,1,512,512,512.00,0.00,13553,13554
18135,2,421,91,256.00,27225.00,13553,13555
18136,2,488,24,256.00,53824.00,13554,13556
18137,1,512,512,512.00,0.00,13555,13556
18138,2,387,125,256.00,17161.00,13555,13557
18139,1,512,512,512.00,0.00,13556,13557
18140,1,512,512,512.00,0.00,13556,13557
18141,2,427,85,256.00,29241.00,13556,13558
18142,1,512,512,512.00,0.00,13557,13558
18143,1,512,512,512.00,0.00,13557,13558
18144,1,512,512,512.00,0.00,13557,13558
18145,1,512,512,512.00,0.00,13557,13558
18146,1,512,512,512.00,0.00,13557,13558
18147,2,326,186,256.00,4900.00,13557,13559
18148,1,512,512,512.00,0.00,13558,13559
18149,1,512,512,512.00,0.00,13558,13559
18150,1,512,512,512.00,0.00,13558,13559
18151,1,512,512,512.00,0.00,13558,13559
18152,1,512,512,512.00,0.00,13558,13559
18153,1,512,512,512.00,0.00,13558,13559
18154,2,437,75,256.00,32761.00,13558,13560
18155,1,512,512,512.00,0.00,13559,13560
18156,1,512,512,512.00,0.00,13559,13560
18157,2,309,203,256.00,2809.00,13559,13561
18158,1,512,512,512.00,0.00,13560,13561
18159,1,512,512,512.00,0.00,13560,13561
18160,2,355,157,256.00,9801.00,13560,13562
18161,2,487,25,256.00,53361.00,13561,13563
18162,1,512,512,512.00,0.00,13562,13563
18163,1,512,512,512.00,0.00,13562,13563
18164,1,512,512,512.00,0.00,13562,13563
18165,1,512,512,512.00,0.00,13562,13563
18166,1,512,512,512.00,0.00,13562,13563
18167,1,512,512,512.00,0.00,13562,13563
18168,1,512,512,512.00,0.00,13562,13563
18169,2,425,87,256.00,28561.00,13562,13564
18170,1,512,512,512.00,0.00,13563,13564
18171,1,512,512,512.00,0.00,13563,13564
18172,1,512,512,512.00,0.00,13563,13564
18173,1,512,512,512.00,0.00,13563,13564
18174,1,512,512,512.00,0.00,13563,13564
18175,2,456,56,256.00,40000.00,13563,13565
18176,2,437,75,256.00,32761.00,13564,13566
18177,1,512,512,512.00,0.00,13565,13566
18178,3,338,67,170.67,14266.89,13565,13568
18179,1,512,512,512.00,0.00,13567,13568
18180,1,512,512,512.00,0.00,13567,13568
18181,1,512,512,512.00,0.00,13568,13569
18182,1,512,512,512.00,0.00,13568,13569
18183,1,512,512,512.00,0.00,13568,13569
18184,1,512,512,512.00,0.00,13568,13569
18185,1,512,512,512.00,0.00,13568,13569
18186,1,512,512,512.00,0.00,13568,13569
18187,3,460,7,170.67,42097.56,13568,13571
18188,2,334,178,256.00,6084.00,13570,13572
18189,1,512,512,512.00,0.00,13571,13572
18190,5,195,3,102.40,4048.64,13571,13576
18191,2,360,152,256.00,10816.00,13575,13577
18192,1,512,512,512.00,0.00,13576,13577
18193,1,512,512,512.00,0.00,13576,13577
18194,1,512,512,512.00,0.00,13576,13577
18195,1,512,512,512.00,0.00,13576,13577
18196,1,512,512,512.00,0.00,13576,13577
18197,1,512,512,512.00,0.00,13576,13577
18198,2,383,129,256.00,16129.00,13576,13578
18199,1,512,512,512.00,0.00,13577,13578
18200,1,512,512,512.00,0.00,13577,13578
18201,1,512,512,512.00,0.00,13577,13578
18202,3,284,107,170.67,6454.89,13577,13580
18203,3,254,15,170.67,12136.22,13579,13582
18204,2,335,177,256.00,6241.00,13581,13583
18205,1,512,512,512.00,0.00,13582,13583
18206,1,512,512,512.00,0.00,13582,13583
18207,1,512,512,512.00,0.00,13582,13583
18208,1,512,512,512.00,0.00,13582,13583
18209,1,512,512,512.00,0.00,13582,13583
18210,5,410,3,102.40,24632.24,13582,13587
18211,1,512,512,512.00,0.00,13586,13587
18212,1,512,512,512.00,0.00,13586,13587
18213,4,246,13,128.00,6924.50,13586,13590
18214,1,512,512,512.00,0.00,13589,13590
18215,1,512,512,512.00,0.00,13589,13590
18216,1,512,512,512.00,0.00,13589,13590
18217,1,512,512,512.00,0.00,13589,13590
18218,2,373,139,256.00,13689.00,13589,13591
18219,2,278,234,256.00,484.00,13590,13592
18220,1,512,512,512.00,0.00,13591,13592
18221,2,491,21,256.00,55225.00,13591,13593
18222,1,512,512,512.00,0.00,13592,13593
18223,2,488,24,256.00,53824.00,13592,13594
18224,1,512,512,512.00,0.00,13593,13594
18225,1,512,512,512.00,0.00,13593,13594
18226,3,339,3,170.67,18816.22,13593,13596
18227,1,512,512,512.00,0.00,13595,13596
18228,2,508,4,256.00,63504.00,13595,13597
18229,2,455,57,256.00,39601.00,13596,13598
18230,2,468,44,256.00,44944.00,13597,13599
18231,1,512,512,512.00,0.00,13598,13599
18232,1,512,512,512.00,0.00,13598,13599
18233,2,476,36,256.00,48400.00,13598,13600
18234,1,512,512,512.00,0.00,13599,13600
18235,1,512,512,512.00,0.00,13599,13600
18236,1,512,512,512.00,0.00,13599,13600
18237,3,338,49,170.67,14962.89,13599,13602
18238,1,512,512,512.00,0.00,13601,13602
18239,1,512,512,512.00,0.00,13601,13602
18240,1,512,512,512.00,0.00,13601,13602
18241,1,512,512,512.00,0.00,13601,13602
18242,2,510,2,256.00,64516.00,13601,13603
18243,1,512,512,512.00,0.00,13602,13603
18244,1,512,512,512.00,0.00,13602,13603
18245,1,512,512,512.00,0.00,13602,13603
18246,2,286,226,256.00,900.00,13602,13604
18247,1,512,512,512.00,0.00,13603,13604
18248,1,512,512,512.00,0.00,13603,13604
18249,1,512,512,512.00,0.00,13603,13604
18250,2,448,64,256.00,36864.00,13603,13605
18251,1,512,512,512.00,0.00,13604,13605
18252,1,512,512,512.00,0.00,13604,13605
18253,1,512,512,512.00,0.00,13604,13605
18254,1,512,512,512.00,0.00,13604,13605
18255,4,366,6,128.00,19636.00,13604,13608
18256,1,512,512,512.00,0.00,13607,13608
18257,1,512,512,512.00,0.00,13607,13608
18258,2,281,231,256.00,625.00,13607,13609
18259,1,512,512,512.00,0.00,13608,13609
18260,2,478,34,256.00,49284.00,13608,13610
18261,1,512,512,512.00,0.00,13609,13610
18262,3,252,31,170.67,9841.56,13609,13612
18263,2,430,82,256.00,30276.00,13611,13613
18264,1,512,512,512.00,0.00,13612,13613
18265,2,412,100,256.00,24336.00,13612,13614
18266,1,512,512,512.00,0.00,13613,13614
18267,1,512,512,512.00,0.00,13613,13614
18268,1,512,512,512.00,0.00,13613,13614
18269,4,220,2,128.00,8750.00,13613,13617
18270,2,351,161,256.00,9025.00,13616,13618
18271,2,405,107,256.00,22201.00,13617,13619
18272,1,512,512,512.00,0.00,13618,13619
18273,1,512,512,512.00,0.00,13618,13619
18274,2,425,87,256.00,28561.00,13618,13620
18275,1,512,512,512.00,0.00,13619,13620
18276,1,512,512,512.00,0.00,13619,13620
18277,1,512,512,512.00,0.00,13619,13620
18278,1,512,512,512.00,0.00,13619,13620
18279,1,512,512,512.00,0.00,13619,13620
18280,2,477,35,256.00,48841.00,13619,13621
18281,2,401,111,256.00,21025.00,13620,13622
18282,1,512,512,512.00,0.00,13621,13622
18283,1,512,512,512.00,0.00,13621,13622
18284,2,338,174,256.00,6724.00,13621,13623
18285,3,283,61,170.67,8217.56,13622,13625
18286,1,512,512,512.00,0.00,13624,13625
18287,1,512,512,512.00,0.00,13624,13625
18288,2,419,93,256.00,26569.00,13624,13626
18289,1,512,512,512.00,0.00,13625,13626
18290,1,512,512,512.00,0.00,13625,13626
18291,1,512,512,512.00,0.00,13625,13626
18292,2,315,197,256.00,3481.00,13625,13627
18293,1,512,512,512.00,0.00,13626,13627
18294,2,495,17,256.00,57121.00,13626,13628
18295,1,512,512,512.00,0.00,13627,13628
18296,1,512,512,512.00,0.00,13627,13628
18297,2,406,106,256.00,22500.00,13627,13629
18298,1,512,512,512.00,0.00,13628,13629
18299,2,411,101,256.00,24025.00,13628,13630
18300,1,512,512,512.00,0.00,13629,13630
18301,1,512,512,512.00,0.00,13629,13630
18302,2,474,38,256.00,47524.00,13629,13631
18303,1,512,512,512.00,0.00,13630,13631
18304,3,428,3,170.67,34124.22,13630,13633
18305,2,395,117,256.00,19321.00,13632,13634
18306,1,512,512,512.00,0.00,13633,13634
18307,1,512,512,512.00,0.00,13633,13634
18308,1,512,512,512.00,0.00,13633,13634
18309,1,512,512,512.00,0.00,13633,13634
18310,2,274,238,256.00,324.00,13633,13635
18311,1,512,512,512.00,0.00,13634,13635
18312,2,456,56,256.00,40000.00,13634,13636
18313,1,512,512,512.00,0.00,13635,13636
18314,2,309,203,256.00,2809.00,13635,13637
18315,1,512,512,512.00,0.00,13636,13637
18316,1,512,512,512.00,0.00,13636,13637
18317,1,512,512,512.00,0.00,13636,13637
18318,1,512,512,512.00,0.00,13636,13637
18319,2,348,164,256.00,8464.00,13636,13638
18320,1,512,512,512.00,0.00,13637,13638
18321,2,494,18,256.00,56644.00,13637,13639
18322,1,512,512,512.00,0.00,13638,13639
18323,1,512,512,512.00,0.00,13638,13639
18324,4,337,21,128.00,15245.00,13638,13642
18325,1,512,512,512.00,0.00,13641,13642
18326,1,512,512,512.00,0.00,13641,13642
18327,1,512,512,512.00,0.00,13641,13642
18328,1,512,512,512.00,0.00,13641,13642
18329,2,269,243,256.00,169.00,13641,13643
18330,1,512,512,512.00,0.00,13642,13643
18331,1,512,512,512.00,0.00,13642,13643
18332,1,512,512,512.00,0.00,13642,13643
18333,1,512,512,512.00,0.00,13642,13643
18334,1,512,512,512.00,0.00,13642,13643
18335,3,260,72,170.67,5934.22,13642,13645
18336,1,512,512,512.00,0.00,13644,13645
18337,1,512,512,512.00,0.00,13644,13645
18338,2,306,206,256.00,2500.00,13644,13646
18339,1,512,512,512.00,0.00,13645,13646
18340,1,512,512,512.00,0.00,13645,13646
18341,1,512,512,512.00,0.00,13645,13646
18342,1,512,512,512.00,0.00,13645,13646
18343,2,334,178,256.00,6084.00,13645,13647
18344,1,512,512,512.00,0.00,13646,13647
18345,2,507,5,256.00,63001.00,13646,13648
18346,1,512,512,512.00,0.00,13647,13648
18347,2,273,239,256.00,289.00,13647,13649
18348,1,512,512,512.00,0.00,13648,13649
18349,3,301,10,170.67,14573.56,13648,13651
18350,1,512,512,512.00,0.00,13650,13651
18351,1,512,512,512.00,0.00,13650,13651
18352,2,388,124,256.00,17424.00,13650,13652
18353,2,433,79,256.00,31329.00,13651,13653
18354,1,512,512,512.00,0.00,13652,13653
18355,1,512,512,512.00,0.00,13652,13653
18356,1,512,512,512.00,0.00,13652,13653
18357,1,512,512,512.00,0.00,13652,13653
18358,1,512,512,512.00,0.00,13652,13653
18359,2,510,2,256.00,64516.00,13652,13654
18360,1,512,512,512.00,0.00,13653,13654
18361,1,512,512,512.00,0.00,13653,13654
18362,2,327,185,256.00,5041.00,13653,13655
18363,2,386,126,256.00,16900.00,13654,13656
18364,1,512,512,512.00,0.00,13655,13656
18365,1,512,512,512.00,0.00,13655,13656
18366,2,432,80,256.00,30976.00,13655,13657
18367,2,377,135,256.00,14641.00,13656,13658
18368,1,512,512,512.00,0.00,13657,13658
18369,1,512,512,512.00,0.00,13657,13658
18370,1,512,512,512.00,0.00,13657,13658
18371,2,455,57,256.00,39601.00,13657,13659
18372,1,512,512,512.00,0.00,13658,13659
18373,1,512,512,512.00,0.00,13658,13659
18374,1,512,512,512.00,0.00,13658,13659
18375,2,482,30,256.00,51076.00,13658,13660
18376,1,512,512,512.00,0.00,13659,13660
18377,1,512,512,512.00,0.00,13659,13660
18378,1,512,512,512.00,0.00,13659,13660
18379,1,512,512,512.00,0.00,13659,13660
18380,1,512,512,512.00,0.00,13659,13660
18381,1,512,512,512.00,0.00,13659,13660
18382,2,497,15,256.00,58081.00,13659,13661
18383,1,512,512,512.00,0.00,13660,13661
18384,2,497,15,256.00,58081.00,13660,13662
18385,1,512,512,512.00,0.00,13661,13662
18386,1,512,512,512.00,0.00,13661,13662
18387,1,512,512,512.00,0.00,13661,13662
18388,2,507,5,256.00,63001.00,13661,13663
18389,2,424,88,256.00,28224.00,13662,13664
18390,1,512,512,512.00,0.00,13663,13664
18391,1,512,512,512.00,0.00,13663,13664
18392,1,512,512,512.00,0.00,13663,13664
18393,1,512,512,512.00,0.00,13663,13664
18394,2,488,24,256.00,53824.00,13663,13665
18395,1,512,512,512.00,0.00,13664,13665
18396,2,401,111,256.00,21025.00,13664,13666
18397,3,321,37,170.67,13581.56,13665,13668
18398,1,512,512,512.00,0.00,13667,13668
18399,1,512,512,512.00,0.00,13667,13668
18400,1,512,512,512.00,0.00,13667,13668
18401,1,512,512,512.00,0.00,13667,13668
18402,2,457,55,256.00,40401.00,13667,13669
18403,1,512,512,512.00,0.00,13668,13669
18404,1,512,512,512.00,0.00,13668,13669
18405,3,223,108,170.67,2257.56,13668,13671
18406,1,512,512,512.00,0.00,13670,13671
18407,1,512,512,512.00,0.00,13670,13671
18408,2,290,222,256.00,1156.00,13670,13672
18409,1,512,512,512.00,0.00,13671,13672
18410,1,512,512,512.00,0.00,13671,13672
18411,1,512,512,512.00,0.00,13671,13672
18412,1,512,512,512.00,0.00,13671,13672
18413,1,512,512,512.00,0.00,13671,13672
18414,2,308,204,256.00,2704.00,13671,13673
18415,2,510,2,256.00,64516.00,13672,13674
18416,2,456,56,256.00,40000.00,13673,13675
18417,1,512,512,512.00,0.00,13674,13675
18418,2,299,213,256.00,1849.00,13674,13676
18419,2,401,111,256.00,21025.00,13675,13677
18420,1,512,512,512.00,0.00,13676,13677
18421,1,512,512,512.00,0.00,13676,13677
18422,1,512,512,512.00,0.00,13676,13677
18423,3,349,15,170.67,18849.56,13676,13679
18424,1,512,512,512.00,0.00,13678,13679
18425,2,485,27,256.00,52441.00,13678,13680
18426,1,512,512,512.00,0.00,13679,13680
18427,1,512,512,512.00,0.00,13679,13680
18428,2,262,250,256.00,36.00,13679,13681
18429,1,512,512,512.00,0.00,13680,13681
18430,1,512,512,512.00,0.00,13680,13681
18431,2,269,243,256.00,169.00,13680,13682
18432,1,512,512,512.00,0.00,13681,13682
18433,2,273,239,256.00,289.00,13681,13683
18434,2,348,164,256.00,8464.00,13682,13684
18435,1,512,512,512.00,0.00,13683,13684
18436,1,512,512,512.00,0.00,13683,13684
18437,2,332,180,256.00,5776.00,13683,13685
18438,2,433,79,256.00,31329.00,13684,13686
18439,1,512,512,512.00,0.00,13685,13686
18440,1,512,512,512.00,0.00,13685,13686
18441,1,512,512,512.00,0.00,13685,13686
18442,2,325,187,256.00,4761.00,13685,13687
18443,1,512,512,512.00,0.00,13686,13687
18444,1,512,512,512.00,0.00,13686,13687
18445,1,512,512,512.00,0.00,13686,13687
18446,2,497,15,256.00,58081.00,13686,13688
18447,1,512,512,512.00,0.00,13687,13688
18448,2,279,233,256.00,529.00,13687,13689
18449,1,512,512,512.00,0.00,13688,13689
18450,1,512,512,512.00,0.00,13688,13689
18451,3,456,26,170.67,40710.22,13688,13691
18452,1,512,512,512.00,0.00,13690,13691
18453,1,512,512,512.00,0.00,13690,13691
18454,2,413,99,256.00,24649.00,13690,13692
18455,2,340,172,256.00,7056.00,13691,13693
18456,1,512,512,512.00,0.00,13692,13693
18457,2,290,222,256.00,1156.00,13692,13694
18458,1,512,512,512.00,0.00,13693,13694
18459,1,512,512,512.00,0.00,13693,13694
18460,1,512,512,512.00,0.00,13693,13694
18461,2,392,120,256.00,18496.00,13693,13695
18462,1,512,512,512.00,0.00,13694,13695
18463,1,512,512,512.00,0.00,13694,13695
18464,1,512,512,512.00,0.00,13694,13695
18465,3,403,19,170.67,27829.56,13694,13697
18466,1,512,512,512.00,0.00,13696,13697
18467,1,512,512,512.00,0.00,13696,13697
18468,1,512,512,512.00,0.00,13696,13697
18469,1,512,512,512.00,0.00,13696,13697
18470,1,512,512,512.00,0.00,13696,13697
18471,2,432,80,256.00,30976.00,13696,13698
18472,2,285,227,256.00,841.00,13697,13699
18473,1,512,512,512.00,0.00,13698,13699
18474,2,483,29,256.00,51529.00,13698,13700
18475,2,490,22,256.00,54756.00,13699,13701
18476,1,512,512,512.00,0.00,13700,13701
18477,1,512,512,512.00,0.00,13700,13701
18478,1,512,512,512.00,0.00,13700,13701
18479,1,512,512,512.00,0.00,13700,13701
18480,1,512,512,512.00,0.00,13700,13701
18481,2,327,185,256.00,5041.00,13700,13702
18482,2,317,195,256.00,3721.00,13701,13703
18483,1,512,512,512.00,0.00,13702,13703
18484,4,253,45,128.00,7649.00,13702,13706
18485,2,359,153,256.00,10609.00,13705,13707
18486,1,512,512,512.00,0.00,13706,13707
18487,1,512,512,512.00,0.00,13706,13707
18488,1,512,512,512.00,0.00,13706,13707
18489,1,512,512,512.00,0.00,13706,13707
18490,1,512,512,512.00,0.00,13706,13707
18491,2,442,70,256.00,34596.00,13706,13708
18492,2,471,41,256.00,46225.00,13707,13709
18493,2,495,17,256.00,57121.00,13708,13710
18494,2,442,70,256.00,34596.00,13709,13711
18495,1,512,512,512.00,0.00,13710,13711
18496,1,512,512,512.00,0.00,13710,13711
18497,1,512,512,512.00,0.00,13710,13711
18498,1,512,512,512.00,0.00,13710,13711
18499,4,324,38,128.00,13298.00,13710,13714
18500,1,512,512,512.00,0.00,13713,13714
18501,1,512,512,512.00,0.00,13713,13714
18502,1,512,512,512.00,0.00,13713,13714
18503,2,390,122,256.00,17956.00,13713,13715
18504,1,512,512,512.00,0.00,13714,13715
18505,1,512,512,512.00,0.00,13714,13715
18506,1,512,512,512.00,0.00,13714,13715
18507,2,368,144,256.00,12544.00,13714,13716
18508,1,512,512,512.00,0.00,13715,13716
18509,1,512,512,512.00,0.00,13715,13716
18510,3,258,28,170.67,10347.56,13715,13718
18511,1,512,512,512.00,0.00,13717,13718
18512,3,368,22,170.67,21136.89,13717,13720
18513,1,512,512,512.00,0.00,13719,13720
18514,1,512,512,512.00,0.00,13719,13720
18515,1,512,512,512.00,0.00,13719,13720
18516,2,409,103,256.00,23409.00,13719,13721
18517,1,512,512,512.00,0.00,13720,13721
18518,2,506,6,256.00,62500.00,13720,13722
18519,1,512,512,512.00,0.00,13721,13722
18520,1,512,512,512.00,0.00,13721,13722
18521,1,512,512,512.00,0.00,13721,13722
18522,2,404,108,256.00,21904.00,13721,13723
18523,1,512,512,512.00,0.00,13722,13723
18524,1,512,512,512.00,0.00,13722,13723
18525,2,450,62,256.00,37636.00,13722,13724
18526,1,512,512,512.00,0.00,13723,13724
18527,1,512,512,512.00,0.00,13723,13724
18528,4,453,4,128.00,35301.50,13723,13727
18529,1,512,512,512.00,0.00,13726,13727
18530,1,512,512,512.00,0.00,13726,13727
18531,1,512,512,512.00,0.00,13726,13727
18532,2,431,81,256.00,30625.00,13726,13728
18533,2,340,172,256.00,7056.00,13727,13729
18534,1,512,512,512.00,0.00,13728,13729
18535,3,251,24,170.67,10788.22,13728,13731
18536,2,462,50,256.00,42436.00,13730,13732
18537,1,512,512,512.00,0.00,13731,13732
18538,1,512,512,512.00,0.00,13731,13732
18539,1,512,512,512.00,0.00,13731,13732
18540,2,496,16,256.00,57600.00,13731,13733
18541,2,266,246,256.00,100.00,13732,13734
18542,2,269,243,256.00,169.00,13733,13735
18543,2,500,12,256.00,59536.00,13734,13736
18544,1,512,512,512.00,0.00,13735,13736
18545,1,512,512,512.00,0.00,13735,13736
18546,1,512,512,512.00,0.00,13735,13736
18547,1,512,512,512.00,0.00,13735,13736
18548,1,512,512,512.00,0.00,13735,13736
18549,2,305,207,256.00,2401.00,13735,13737
18550,2,295,217,256.00,1521.00,13736,13738
18551,1,512,512,512.00,0.00,13737,13738
18552,3,225,121,170.67,1813.56,13737,13740
18553,1,512,512,512.00,0.00,13739,13740
18554,1,512,512,512.00,0.00,13739,13740
18555,1,512,512,512.00,0.00,13739,13740
18556,1,512,512,512.00,0.00,13739,13740
18557,2,451,61,256.00,38025.00,13739,13741
18558,2,355,157,256.00,9801.00,13740,13742
18559,1,512,512,512.00,0.00,13741,13742
18560,2,364,148,256.00,11664.00,13741,13743
18561,2,418,94,256.00,26244.00,13742,13744
18562,1,512,512,512.00,0.00,13743,13744
18563,1,512,512,512.00,0.00,13743,13744
18564,1,512,512,512.00,0.00,13743,13744
18565,1,512,512,512.00,0.00,13743,13744
18566,2,274,238,256.00,324.00,13743,13745
18567,1,512,512,512.00,0.00,13744,13745
18568,1,512,512,512.00,0.00,13744,13745
18569,3,286,93,170.67,6917.56,13744,13747
18570,1,512,512,512.00,0.00,13746,13747
18571,3,211,130,170.67,1093.56,13746,13749
18572,1,512,512,512.00,0.00,13748,13749
18573,2,385,127,256.00,16641.00,13748,13750
18574,1,512,512,512.00,0.00,13749,13750
18575,1,512,512,512.00,0.00,13749,13750
18576,2,401,111,256.00,21025.00,13749,13751
18577,1,512,512,512.00,0.00,13750,13751
18578,1,512,512,512.00,0.00,13750,13751
18579,1,512,512,512.00,0.00,13750,13751
18580,1,512,512,512.00,0.00,13750,13751
18581,2,330,182,256.00,5476.00,13750,13752
18582,1,512,512,512.00,0.00,13751,13752
18583,1,512,512,512.00,0.00,13751,13752
18584,1,512,512,512.00,0.00,13751,13752
18585,3,353,77,170.67,16626.89,13751,13754
18586,2,508,4,256.00,63504.00,13753,13755
18587,1,512,512,512.00,0.00,13754,13755
18588,2,509,3,256.00,64009.00,13754,13756
18589,3,344,26,170.67,17264.89,13755,13758
18590,3,246,35,170.67,9240.22,13757,13760
18591,1,512,512,512.00,0.00,13759,13760
18592,1,512,512,512.00,0.00,13759,13760
18593,1,512,512,512.00,0.00,13759,13760
18594,1,512,512,512.00,0.00,13759,13760
18595,1,512,512,512.00,0.00,13759,13760
18596,3,251,19,170.67,11514.89,13759,13762
18597,1,512,512,512.00,0.00,13761,13762
18598,2,351,161,256.00,9025.00,13761,13763
18599,1,512,512,512.00,0.00,13762,13763
18600,3,237,135,170.67,2204.22,13762,13765
18601,2,386,126,256.00,16900.00,13764,13766
18602,1,512,512,512.00,0.00,13765,13766
18603,3,410,39,170.67,28736.22,13765,13768
18604,1,512,512,512.00,0.00,13767,13768
18605,1,512,512,512.00,0.00,13767,13768
18606,2,333,179,256.00,5929.00,13767,13769
18607,1,512,512,512.00,0.00,13768,13769
18608,2,281,231,256.00,625.00,13768,13770
18609,2,432,80,256.00,30976.00,13769,13771
18610,2,408,104,256.00,23104.00,13770,13772
18611,1,512,512,512.00,0.00,13771,13772
18612,1,512,512,512.00,0.00,13771,13772
18613,1,512,512,512.00,0.00,13771,13772
18614,1,512,512,512.00,0.00,13771,13772
18615,2,502,10,256.00,60516.00,13771,13773
18616,2,503,9,256.00,61009.00,13772,13774
18617,1,512,512,512.00,0.00,13773,13774
18618,2,319,193,256.00,3969.00,13773,13775
18619,1,512,512,512.00,0.00,13774,13775
18620,2,439,73,256.00,33489.00,13774,13776
18621,1,512,512,512.00,0.00,13775,13776
18622,1,512,512,512.00,0.00,13775,13776
18623,1,512,512,512.00,0.00,13775,13776
18624,1,512,512,512.00,0.00,13775,13776
18625,2,441,71,256.00,34225.00,13775,13777
18626,1,512,512,512.00,0.00,13776,13777
18627,1,512,512,512.00,0.00,13776,13777
18628,2,320,192,256.00,4096.00,13776,13778
18629,1,512,512,512.00,0.00,13777,13778
18630,1,512,512,512.00,0.00,13777,13778
18631,1,512,512,512.00,0.00,13777,13778
18632,1,512,512,512.00,0.00,13777,13778
18633,3,256,115,170.67,3753.56,13777,13780
18634,1,512,512,512.00,0.00,13779,13780
18635,1,512,512,512.00,0.00,13779,13780
18636,2,354,158,256.00,9604.00,13779,13781
18637,1,512,512,512.00,0.00,13780,13781
18638,1,512,512,512.00,0.00,13780,13781
18639,1,512,512,512.00,0.00,13780,13781
18640,2,307,205,256.00,2601.00,13780,13782
18641,1,512,512,512.00,0.00,13781,13782
18642,5,227,5,102.40,10108.24,13781,13786
18643,1,512,512,512.00,0.00,13785,13786
18644,1,512,512,512.00,0.00,13785,13786
18645,1,512,512,512.00,0.00,13785,13786
18646,1,512,512,512.00,0.00,13785,13786
18647,2,417,95,256.00,25921.00,13785,13787
18648,1,512,512,512.00,0.00,13786,13787
18649,1,512,512,512.00,0.00,13786,13787
18650,1,512,512,512.00,0.00,13786,13787
18651,3,313,39,170.67,12569.56,13786,13789
18652,1,512,512,512.00,0.00,13788,13789
18653,2,444,68,256.00,35344.00,13788,13790
18654,3,229,72,170.67,4921.56,13789,13792
18655,1,512,512,512.00,0.00,13791,13792
18656,2,302,210,256.00,2116.00,13791,13793
18657,1,512,512,512.00,0.00,13792,13793
18658,1,512,512,512.00,0.00,13792,13793
18659,3,271,37,170.67,9681.56,13792,13795
18660,1,512,512,512.00,0.00,13794,13795
18661,1,512,512,512.00,0.00,13794,13795
18662,2,319,193,256.00,3969.00,13794,13796
18663,1,512,512,512.00,0.00,13795,13796
18664,1,512,512,512.00,0.00,13795,13796
18665,1,512,512,512.00,0.00,13795,13796
18666,1,512,512,512.00,0.00,13795,13796
18667,2,287,225,256.00,961.00,13795,13797
18668,1,512,512,512.00,0.00,13796,13797
18669,1,512,512,512.00,0.00,13796,13797
18670,1,512,512,512.00,0.00,13796,13797
18671,2,483,29,256.00,51529.00,13796,13798
18672,1,512,512,512.00,0.00,13797,13798
18673,2,404,108,256.00,21904.00,13797,13799
18674,2,291,221,256.00,1225.00,13798,13800
18675,1,512,512,512.00,0.00,13799,13800
18676,1,512,512,512.00,0.00,13799,13800
18677,1,512,512,512.00,0.00,13799,13800
18678,1,512,512,512.00,0.00,13799,13800
18679,2,402,110,256.00,21316.00,13799,13801
18680,1,512,512,512.00,0.00,13800,13801
18681,1,512,512,512.00,0.00,13800,13801
18682,3,271,48,170.67,8537.56,13800,13803
18683,1,512,512,512.00,0.00,13802,13803
18684,1,512,512,512.00,0.00,13802,13803
18685,2,302,210,256.00,2116.00,13802,13804
18686,1,512,512,512.00,0.00,13803,13804
18687,2,340,172,256.00,7056.00,13803,13805
18688,1,512,512,512.00,0.00,13804,13805
18689,3,428,11,170.67,33750.89,13804,13807
18690,1,512,512,512.00,0.00,13806,13807
18691,1,512,512,512.00,0.00,13806,13807
18692,1,512,512,512.00,0.00,13806,13807
18693,2,327,185,256.00,5041.00,13806,13808
18694,1,512,512,512.00,0.00,13807,13808
18695,1,512,512,512.00,0.00,13807,13808
18696,1,512,512,512.00,0.00,13807,13808
18697,1,512,512,512.00,0.00,13807,13808
18698,1,512,512,512.00,0.00,13807,13808
18699,4,401,1,128.00,25641.50,13807,13811
18700,1,512,512,512.00,0.00,13810,13811
18701,3,263,31,170.67,10090.89,13810,13813
18702,1,512,512,512.00,0.00,13812,13813
18703,2,460,52,256.00,41616.00,13812,13814
18704,1,512,512,512.00,0.00,13813,13814
18705,1,512,512,512.00,0.00,13813,13814
18706,2,364,148,256.00,11664.00,13813,13815
18707,5,348,2,102.40,16829.84,13814,13819
18708,1,512,512,512.00,0.00,13818,13819
18709,1,512,512,512.00,0.00,13818,13819
18710,3,230,136,170.67,1776.89,13818,13821
18711,1,512,512,512.00,0.00,13820,13821
18712,1,512,512,512.00,0.00,13820,13821
18713,1,512,512,512.00,0.00,13820,13821
18714,2,390,122,256.00,17956.00,13820,13822
18715,2,279,233,256.00,529.00,13821,13823
18716,1,512,512,512.00,0.00,13822,13823
18717,2,386,126,256.00,16900.00,13822,13824
18718,1,512,512,512.00,0.00,13823,13824
18719,1,512,512,512.00,0.00,13823,13824
18720,2,423,89,256.00,27889.00,13823,13825
18721,1,512,512,512.00,0.00,13824,13825
18722,1,512,512,512.00,0.00,13824,13825
18723,2,481,31,256.00,50625.00,13824,13826
18724,2,297,215,256.00,1681.00,13825,13827
18725,1,512,512,512.00,0.00,13826,13827
18726,4,459,7,128.00,36563.50,13826,13830
18727,1,512,512,512.00,0.00,13829,13830
18728,2,321,191,256.00,4225.00,13829,13831
18729,1,512,512,512.00,0.00,13830,13831
18730,2,281,231,256.00,625.00,13830,13832
18731,1,512,512,512.00,0.00,13831,13832
18732,2,509,3,256.00,64009.00,13831,13833
18733,1,512,512,512.00,0.00,13832,13833
18734,4,179,80,128.00,2088.50,13832,13836
18735,3,313,70,170.67,10709.56,13835,13838
18736,2,487,25,256.00,53361.00,13837,13839
18737,2,413,99,256.00,24649.00,13838,13840
18738,1,512,512,512.00,0.00,13839,13840
18739,1,512,512,512.00,0.00,13839,13840
18740,2,299,213,256.00,1849.00,13839,13841
18741,2,324,188,256.00,4624.00,13840,13842
18742,1,512,512,512.00,0.00,13841,13842
18743,2,262,250,256.00,36.00,13841,13843
18744,1,512,512,512.00,0.00,13842,13843
18745,1,512,512,512.00,0.00,13842,13843
18746,1,512,512,512.00,0.00,13842,13843
18747,2,467,45,256.00,44521.00,13842,13844
18748,1,512,512,512.00,0.00,13843,13844
18749,2,274,238,256.00,324.00,13843,13845
18750,1,512,512,512.00,0.00,13844,13845
18751,2,351,161,256.00,9025.00,13844,13846
18752,1,512,512,512.00,0.00,13845,13846
18753,1,512,512,512.00,0.00,13845,13846
18754,2,484,28,256.00,51984.00,13845,13847
18755,1,512,512,512.00,0.00,13846,13847
18756,2,340,172,256.00,7056.00,13846,13848
18757,2,258,254,256.00,4.00,13847,13849
18758,1,512,512,512.00,0.00,13848,13849
18759,2,476,36,256.00,48400.00,13848,13850
18760,1,512,512,512.00,0.00,13849,13850
18761,1,512,512,512.00,0.00,13849,13850
18762,1,512,512,512.00,0.00,13849,13850
18763,1,512,512,512.00,0.00,13849,13850
18764,2,411,101,256.00,24025.00,13849,13851
18765,1,512,512,512.00,0.00,13850,13851
18766,1,512,512,512.00,0.00,13850,13851
18767,3,426,28,170.67,32747.56,13850,13853
18768,2,284,228,256.00,784.00,13852,13854
18769,1,512,512,512.00,0.00,13853,13854
18770,1,512,512,512.00,0.00,13853,13854
18771,1,512,512,512.00,0.00,13853,13854
18772,2,379,133,256.00,15129.00,13853,13855
18773,1,512,512,512.00,0.00,13854,13855
18774,3,296,10,170.67,14256.89,13854,13857
18775,4,278,3,128.00,10470.50,13856,13860
18776,2,269,243,256.00,169.00,13859,13861
18777,3,230,104,170.67,2672.89,13860,13863
18778,1,512,512,512.00,0.00,13862,13863
18779,2,394,118,256.00,19044.00,13862,13864
18780,1,512,512,512.00,0.00,13863,13864
18781,1,512,512,512.00,0.00,13863,13864
18782,4,210,64,128.00,2926.00,13863,13867
18783,1,512,512,512.00,0.00,13866,13867
18784,2,355,157,256.00,9801.00,13866,13868
18785,1,512,512,512.00,0.00,13867,13868
18786,1,512,512,512.00,0.00,13867,13868
18787,2,410,102,256.00,23716.00,13867,13869
18788,2,505,7,256.00,62001.00,13868,13870
18789,1,512,512,512.00,0.00,13869,13870
18790,1,512,512,512.00,0.00,13869,13870
18791,3,296,34,170.67,11504.89,13869,13872
18792,1,512,512,512.00,0.00,13871,13872
18793,1,512,512,512.00,0.00,13871,13872
18794,1,512,512,512.00,0.00,13871,13872
18795,2,376,136,256.00,14400.00,13871,13873
18796,1,512,512,512.00,0.00,13872,13873
18797,1,512,512,512.00,0.00,13872,13873
18798,2,496,16,256.00,57600.00,13872,13874
18799,2,295,217,256.00,1521.00,13873,13875
18800,1,512,512,512.00,0.00,13874,13875
18801,1,512,512,512.00,0.00,13874,13875
18802,2,497,15,256.00,58081.00,13874,13876
18803,1,512,512,512.00,0.00,13875,13876
18804,2,317,195,256.00,3721.00,13875,13877
18805,2,417,95,256.00,25921.00,13876,13878
18806,3,377,2,170.67,24146.89,13877,13880
18807,1,512,512,512.00,0.00,13879,13880
18808,2,405,107,256.00,22201.00,13879,13881
18809,1,512,512,512.00,0.00,13880,13881
18810,1,512,512,512.00,0.00,13880,13881
18811,2,479,33,256.00,49729.00,13880,13882
18812,1,512,512,512.00,0.00,13881,13882
18813,1,512,512,512.00,0.00,13881,13882
18814,2,329,183,256.00,5329.00,13881,13883
18815,6,204,1,85.33,4973.56,13882,13888
18816,3,420,38,170.67,31126.22,13887,13890
18817,1,512,512,512.00,0.00,13889,13890
18818,1,512,512,512.00,0.00,13889,13890
18819,1,512,512,512.00,0.00,13889,13890
18820,1,512,512,512.00,0.00,13889,13890
18821,1,512,512,512.00,0.00,13889,13890
18822,3,440,23,170.67,36382.89,13889,13892
18823,1,512,512,512.00,0.00,13891,13892
18824,1,512,512,512.00,0.00,13891,13892
18825,1,512,512,512.00,0.00,13891,13892
18826,2,321,191,256.00,4225.00,13891,13893
18827,1,512,512,512.00,0.00,13892,13893
18828,5,163,62,102.40,1370.64,13892,13897
18829,2,377,135,256.00,14641.00,13896,13898
18830,1,512,512,512.00,0.00,13897,13898
18831,1,512,512,512.00,0.00,13897,13898
18832,1,512,512,512.00,0.00,13897,13898
18833,1,512,512,512.00,0.00,13897,13898
18834,1,512,512,512.00,0.00,13897,13898
18835,3,464,1,170.67,43374.89,13897,13900
18836,1,512,512,512.00,0.00,13899,13900
18837,2,279,233,256.00,529.00,13899,13901
18838,2,313,199,256.00,3249.00,13900,13902
18839,2,398,114,256.00,20164.00,13901,13903
18840,2,448,64,256.00,36864.00,13902,13904
18841,3,278,21,170.67,11904.22,13903,13906
18842,1,512,512,512.00,0.00,13905,13906
18843,3,242,114,170.67,2838.22,13905,13908
18844,2,491,21,256.00,55225.00,13907,13909
18845,4,261,63,128.00,6069.00,13908,13912
18846,1,512,512,512.00,0.00,13911,13912
18847,1,512,512,512.00,0.00,13911,13912
18848,1,512,512,512.00,0.00,13911,13912
18849,2,326,186,256.00,4900.00,13911,13913
18850,1,512,512,512.00,0.00,13912,13913
18851,1,512,512,512.00,0.00,13912,13913
18852,2,278,234,256.00,484.00,13912,13914
18853,3,243,97,170.67,3553.56,13913,13916
18854,1,512,512,512.00,0.00,13915,13916
18855,2,304,208,256.00,2304.00,13915,13917
18856,1,512,512,512.00,0.00,13916,13917
18857,6,295,5,85.33,11280.89,13916,13922
18858,4,218,9,128.00,6048.50,13921,13925
18859,2,377,135,256.00,14641.00,13924,13926
18860,1,512,512,512.00,0.00,13925,13926
18861,6,269,1,85.33,11413.56,13925,13931
18862,3,311,54,170.67,11288.22,13930,13933
18863,1,512,512,512.00,0.00,13932,13933
18864,1,512,512,512.00,0.00,13932,13933
18865,2,368,144,256.00,12544.00,13932,13934
18866,4,420,8,128.00,28794.50,13933,13937
18867,1,512,512,512.00,0.00,13936,13937
18868,1,512,512,512.00,0.00,13936,13937
18869,1,512,512,512.00,0.00,13936,13937
18870,2,407,105,256.00,22801.00,13936,13938
18871,1,512,512,512.00,0.00,13937,13938
18872,1,512,512,512.00,0.00,13937,13938
18873,2,356,156,256.00,10000.00,13937,13939
18874,1,512,512,512.00,0.00,13938,13939
18875,1,512,512,512.00,0.00,13938,13939
18876,1,512,512,512.00,0.00,13938,13939
18877,1,512,512,512.00,0.00,13938,13939
18878,2,489,23,256.00,54289.00,13938,13940
18879,1,512,512,512.00,0.00,13939,13940
18880,2,304,208,256.00,2304.00,13939,13941
18881,3,394,3,170.67,27029.56,13940,13943
18882,1,512,512,512.00,0.00,13942,13943
18883,2,333,179,256.00,5929.00,13942,13944
18884,2,275,237,256.00,361.00,13943,13945
18885,1,512,512,512.00,0.00,13944,13945
18886,1,512,512,512.00,0.00,13944,13945
18887,2,449,63,256.00,37249.00,13944,13946
18888,3,300,10,170.67,14507.56,13945,13948
18889,1,512,512,512.00,0.00,13947,13948
18890,1,512,512,512.00,0.00,13947,13948
18891,2,376,136,256.00,14400.00,13947,13949
18892,1,512,512,512.00,0.00,13948,13949
18893,1,512,512,512.00,0.00,13948,13949
18894,2,469,43,256.00,45369.00,13948,13950
18895,2,350,162,256.00,8836.00,13949,13951
18896,2,319,193,256.00,3969.00,13950,13952
18897,1,512,512,512.00,0.00,13951,13952
18898,1,512,512,512.00,0.00,13951,13952
18899,1,512,512,512.00,0.00,13951,13952
18900,1,512,512,512.00,0.00,13951,13952
18901,2,485,27,256.00,52441.00,13951,13953
18902,5,267,5,102.40,8988.64,13952,13957
18903,2,441,71,256.00,34225.00,13956,13958
18904,3,487,7,170.67,50053.56,13957,13960
18905,2,396,116,256.00,19600.00,13959,13961
18906,3,266,14,170.67,12464.89,13960,13963
18907,1,512,512,512.00,0.00,13962,13963
18908,2,430,82,256.00,30276.00,13962,13964
18909,2,351,161,256.00,9025.00,13963,13965
18910,1,512,512,512.00,0.00,13964,13965
18911,1,512,512,512.00,0.00,13964,13965
18912,2,406,106,256.00,22500.00,13964,13966
18913,2,489,23,256.00,54289.00,13965,13967
18914,3,257,6,170.67,13568.22,13966,13969
18915,1,512,512,512.00,0.00,13968,13969
18916,2,364,148,256.00,11664.00,13968,13970
18917,1,512,512,512.00,0.00,13969,13970
18918,1,512,512,512.00,0.00,13969,13970
18919,2,465,47,256.00,43681.00,13969,13971
18920,1,512,512,512.00,0.00,13970,13971
18921,2,381,131,256.00,15625.00,13970,13972
18922,3,385,50,170.67,23090.89,13971,13974
18923,1,512,512,512.00,0.00,13973,13974
18924,1,512,512,512.00,0.00,13973,13974
18925,1,512,512,512.00,0.00,13973,13974
18926,2,277,235,256.00,441.00,13973,13975
18927,1,512,512,512.00,0.00,13974,13975
18928,1,512,512,512.00,0.00,13974,13975
18929,2,333,179,256.00,5929.00,13974,13976
18930,1,512,512,512.00,0.00,13975,13976
18931,1,512,512,512.00,0.00,13975,13976
18932,1,512,512,512.00,0.00,13975,13976
18933,1,512,512,512.00,0.00,13975,13976
18934,2,495,17,256.00,57121.00,13975,13977
18935,1,512,512,512.00,0.00,13976,13977
18936,2,271,241,256.00,225.00,13976,13978
18937,1,512,512,512.00,0.00,13977,13978
18938,1,512,512,512.00,0.00,13977,13978
18939,1,512,512,512.00,0.00,13977,13978
18940,6,255,2,85.33,11953.56,13977,13983
18941,1,512,512,512.00,0.00,13982,13983
18942,1,512,512,512.00,0.00,13982,13983
18943,1,512,512,512.00,0.00,13982,13983
18944,3,254,31,170.67,9874.89,13982,13985
18945,2,299,213,256.00,1849.00,13984,13986
18946,1,512,512,512.00,0.00,13985,13986
18947,1,512,512,512.00,0.00,13985,13986
18948,1,512,512,512.00,0.00,13985,13986
18949,4,242,69,128.00,4668.50,13985,13989
18950,1,512,512,512.00,0.00,13988,13989
18951,2,289,223,256.00,1089.00,13988,13990
18952,1,512,512,512.00,0.00,13989,13990
18953,1,512,512,512.00,0.00,13989,13990
18954,1,512,512,512.00,0.00,13989,13990
18955,2,447,65,256.00,36481.00,13989,13991
18956,2,280,232,256.00,576.00,13990,13992
18957,3,460,12,170.67,41987.56,13991,13994
18958,3,217,132,170.67,1233.56,13993,13996
18959,3,509,1,170.67,57234.89,13995,13998
18960,1,512,512,512.00,0.00,13997,13998
18961,1,512,512,512.00,0.00,13997,13998
18962,1,512,512,512.00,0.00,13997,13998
18963,2,347,165,256.00,8281.00,13997,13999
18964,1,512,512,512.00,0.00,13998,13999
18965,1,512,512,512.00,0.00,13998,13999
18966,1,512,512,512.00,0.00,13998,13999
18967,2,475,37,256.00,47961.00,13998,14000
18968,1,512,512,512.00,0.00,13999,14000
18969,2,314,198,256.00,3364.00,13999,14001
18970,4,202,5,128.00,6397.50,14000,14004
18971,1,512,512,512.00,0.00,14003,14004
18972,1,512,512,512.00,0.00,14003,14004
18973,1,512,512,512.00,0.00,14003,14004
18974,1,512,512,512.00,0.00,14003,14004
18975,3,269,75,170.67,6276.22,14003,14006
18976,1,512,512,512.00,0.00,14005,14006
18977,1,512,512,512.00,0.00,14005,14006
18978,1,512,512,512.00,0.00,14005,14006
18979,2,329,183,256.00,5329.00,14005,14007
18980,2,473,39,256.00,47089.00,14006,14008
18981,1,512,512,512.00,0.00,14007,14008
18982,2,390,122,256.00,17956.00,14007,14009
18983,2,402,110,256.00,21316.00,14008,14010
18984,2,290,222,256.00,1156.00,14009,14011
18985,2,339,173,256.00,6889.00,14010,14012
18986,1,512,512,512.00,0.00,14011,14012
18987,1,512,512,512.00,0.00,14011,14012
18988,1,512,512,512.00,0.00,14011,14012
18989,2,307,205,256.00,2601.00,14011,14013
18990,1,512,512,512.00,0.00,14012,14013
18991,1,512,512,512.00,0.00,14012,14013
18992,1,512,512,512.00,0.00,14012,14013
18993,2,389,123,256.00,17689.00,14012,14014
18994,1,512,512,512.00,0.00,14013,14014
18995,2,285,227,256.00,841.00,14013,14015
18996,1,512,512,512.00,0.00,14014,14015
18997,1,512,512,512.00,0.00,14014,14015
18998,1,512,512,512.00,0.00,14014,14015
18999,1,512,512,512.00,0.00,14014,14015
19000,2,354,158,256.00,9604.00,14014,14016
19001,1,512,512,512.00,0.00,14015,14016
19002,1,512,512,512.00,0.00,14015,14016
19003,1,512,512,512.00,0.00,14015,14016
19004,2,257,255,256.00,1.00,14015,14017
19005,1,512,512,512.00,0.00,14016,14017
19006,3,286,78,170.67,7467.56,14016,14019
19007,1,512,512,512.00,0.00,14018,14019
19008,4,296,2,128.00,11930.00,14018,14022
19009,1,512,512,512.00,0.00,14021,14022
19010,1,512,512,512.00,0.00,14021,14022
19011,2,425,87,256.00,28561.00,14021,14023
19012,1,512,512,512.00,0.00,14022,14023
19013,2,327,185,256.00,5041.00,14022,14024
19014,2,343,169,256.00,7569.00,14023,14025
19015,1,512,512,512.00,0.00,14024,14025
19016,1,512,512,512.00,0.00,14024,14025
19017,1,512,512,512.00,0.00,14024,14025
19018,1,512,512,512.00,0.00,14024,14025
19019,1,512,512,512.00,0.00,14024,14025
19020,2,460,52,256.00,41616.00,14024,14026
19021,4,389,1,128.00,23451.50,14025,14029
19022,3,256,23,170.67,10990.89,14028,14031
19023,1,512,512,512.00,0.00,14030,14031
19024,1,512,512,512.00,0.00,14030,14031
19025,1,512,512,512.00,0.00,14030,14031
19026,1,512,512,512.00,0.00,14030,14031
19027,1,512,512,512.00,0.00,14030,14031
19028,2,401,111,256.00,21025.00,14030,14032
19029,1,512,512,512.00,0.00,14031,14032
19030,1,512,512,512.00,0.00,14031,14032
19031,3,434,3,170.67,35536.22,14031,14034
19032,1,512,512,512.00,0.00,14033,14034
19033,2,298,214,256.00,1764.00,14033,14035
19034,6,278,2,85.33,8473.56,14034,14040
19035,1,512,512,512.00,0.00,14039,14040
19036,4,248,34,128.00,6343.50,14039,14043
19037,2,259,253,256.00,9.00,14042,14044
19038,1,512,512,512.00,0.00,14043,14044
19039,1,512,512,512.00,0.00,14043,14044
19040,1,512,512,512.00,0.00,14043,14044
19041,1,512,512,512.00,0.00,14043,14044
19042,2,409,103,256.00,23409.00,14043,14045
19043,1,512,512,512.00,0.00,14044,14045
19044,1,512,512,512.00,0.00,14044,14045
19045,1,512,512,512.00,0.00,14044,14045
19046,2,381,131,256.00,15625.00,14044,14046
19047,1,512,512,512.00,0.00,14045,14046
19048,3,354,69,170.67,16872.22,14045,14048
19049,2,335,177,256.00,6241.00,14047,14049
19050,4,315,29,128.00,13461.00,14048,14052
19051,2,267,245,256.00,121.00,14051,14053
19052,2,506,6,256.00,62500.00,14052,14054
19053,1,512,512,512.00,0.00,14053,14054
19054,1,512,512,512.00,0.00,14053,14054
19055,3,309,28,170.67,13169.56,14053,14056
19056,1,512,512,512.00,0.00,14055,14056
19057,3,393,11,170.67,26284.22,14055,14058
19058,4,307,22,128.00,11675.50,14057,14061
19059,1,512,512,512.00,0.00,14060,14061
19060,2,509,3,256.00,64009.00,14060,14062
19061,3,215,85,170.67,3670.89,14061,14064
19062,1,512,512,512.00,0.00,14063,14064
19063,2,303,209,256.00,2209.00,14063,14065
19064,1,512,512,512.00,0.00,14064,14065
19065,1,512,512,512.00,0.00,14064,14065
19066,1,512,512,512.00,0.00,14064,14065
19067,1,512,512,512.00,0.00,14064,14065
19068,2,271,241,256.00,225.00,14064,14066
19069,1,512,512,512.00,0.00,14065,14066
19070,1,512,512,512.00,0.00,14065,14066
19071,2,459,53,256.00,41209.00,14065,14067
19072,1,512,512,512.00,0.00,14066,14067
19073,2,495,17,256.00,57121.00,14066,14068
19074,1,512,512,512.00,0.00,14067,14068
19075,2,420,92,256.00,26896.00,14067,14069
19076,1,512,512,512.00,0.00,14068,14069
19077,4,270,52,128.00,7574.00,14068,14072
19078,1,512,512,512.00,0.00,14071,14072
19079,1,512,512,512.00,0.00,14071,14072
19080,1,512,512,512.00,0.00,14071,14072
19081,3,414,2,170.67,31078.22,14071,14074
19082,1,512,512,512.00,0.00,14073,14074
19083,1,512,512,512.00,0.00,14073,14074
19084,4,412,9,128.00,27143.50,14073,14077
19085,1,512,512,512.00,0.00,14076,14077
19086,1,512,512,512.00,0.00,14076,14077
19087,2,305,207,256.00,2401.00,14076,14078
19088,1,512,512,512.00,0.00,14077,14078
19089,1,512,512,512.00,0.00,14077,14078
19090,2,370,142,256.00,12996.00,14077,14079
19091,1,512,512,512.00,0.00,14078,14079
19092,1,512,512,512.00,0.00,14078,14079
19093,1,512,512,512.00,0.00,14078,14079
19094,3,276,14,170.67,12758.22,14078,14081
19095,1,512,512,512.00,0.00,14080,14081
19096,1,512,512,512.00,0.00,14080,14081
19097,1,512,512,512.00,0.00,14080,14081
19098,2,295,217,256.00,1521.00,14080,14082
19099,1,512,512,512.00,0.00,14081,14082
19100,1,512,512,512.00,0.00,14081,14082
19101,1,512,512,512.00,0.00,14081,14082
19102,2,425,87,256.00,28561.00,14081,14083
19103,1,512,512,512.00,0.00,14082,14083
19104,1,512,512,512.00,0.00,14082,14083
19105,1,512,512,512.00,0.00,14082,14083
19106,2,420,92,256.00,26896.00,14082,14084
19107,3,329,22,170.67,15754.89,14083,14086
19108,1,512,512,512.00,0.00,14085,14086
19109,1,512,512,512.00,0.00,14085,14086
19110,1,512,512,512.00,0.00,14085,14086
19111,2,263,249,256.00,49.00,14085,14087
19112,1,512,512,512.00,0.00,14086,14087
19113,1,512,512,512.00,0.00,14086,14087
19114,1,512,512,512.00,0.00,14086,14087
19115,1,512,512,512.00,0.00,14086,14087
19116,2,432,80,256.00,30976.00,14086,14088
19117,1,512,512,512.00,0.00,14087,14088
19118,1,512,512,512.00,0.00,14087,14088
19119,1,512,512,512.00,0.00,14087,14088
19120,3,261,13,170.67,12517.56,14087,14090
19121,1,512,512,512.00,0.00,14089,14090
19122,1,512,512,512.00,0.00,14089,14090
19123,1,512,512,512.00,0.00,14089,14090
19124,2,266,246,256.00,100.00,14089,14091
19125,3,374,6,170.67,23318.22,14090,14093
19126,2,414,98,256.00,24964.00,14092,14094
19127,1,512,512,512.00,0.00,14093,14094
19128,3,258,27,170.67,10480.22,14093,14096
19129,2,412,100,256.00,24336.00,14095,14097
19130,2,437,75,256.00,32761.00,14096,14098
19131,1,512,512,512.00,0.00,14097,14098
19132,1,512,512,512.00,0.00,14097,14098
19133,1,512,512,512.00,0.00,14097,14098
19134,1,512,512,512.00,0.00,14097,14098
19135,2,280,232,256.00,576.00,14097,14099
19136,1,512,512,512.00,0.00,14098,14099
19137,1,512,512,512.00,0.00,14098,14099
19138,2,503,9,256.00,61009.00,14098,14100
19139,2,500,12,256.00,59536.00,14099,14101
19140,2,468,44,256.00,44944.00,14100,14102
19141,3,254,20,170.67,11392.89,14101,14104
19142,3,404,2,170.67,29024.89,14103,14106
19143,1,512,512,512.00,0.00,14105,14106
19144,2,508,4,256.00,63504.00,14105,14107
19145,1,512,512,512.00,0.00,14106,14107
19146,1,512,512,512.00,0.00,14106,14107
19147,4,169,85,128.00,1103.50,14106,14110
19148,1,512,512,512.00,0.00,14109,14110
19149,1,512,512,512.00,0.00,14109,14110
19150,1,512,512,512.00,0.00,14109,14110
19151,2,441,71,256.00,34225.00,14109,14111
19152,1,512,512,512.00,0.00,14110,14111
19153,1,512,512,512.00,0.00,14110,14111
19154,3,419,23,170.67,31202.89,14110,14113
19155,1,512,512,512.00,0.00,14112,14113
19156,1,512,512,512.00,0.00,14112,14113
19157,1,512,512,512.00,0.00,14112,14113
19158,2,454,58,256.00,39204.00,14112,14114
19159,1,512,512,512.00,0.00,14113,14114
19160,2,476,36,256.00,48400.00,14113,14115
19161,1,512,512,512.00,0.00,14114,14115
19162,1,512,512,512.00,0.00,14114,14115
19163,2,343,169,256.00,7569.00,14114,14116
19164,1,512,512,512.00,0.00,14115,14116
19165,2,417,95,256.00,25921.00,14115,14117
19166,2,359,153,256.00,10609.00,14116,14118
19167,1,512,512,512.00,0.00,14117,14118
19168,1,512,512,512.00,0.00,14117,14118
19169,3,436,22,170.67,35371.56,14117,14120
19170,4,390,5,128.00,23449.50,14119,14123
19171,1,512,512,512.00,0.00,14122,14123
19172,1,512,512,512.00,0.00,14122,14123
19173,1,512,512,512.00,0.00,14122,14123
19174,2,484,28,256.00,51984.00,14122,14124
19175,1,512,512,512.00,0.00,14123,14124
19176,1,512,512,512.00,0.00,14123,14124
19177,1,512,512,512.00,0.00,14123,14124
19178,1,512,512,512.00,0.00,14123,14124
19179,3,320,20,170.67,15000.89,14123,14126
19180,1,512,512,512.00,0.00,14125,14126
19181,2,373,139,256.00,13689.00,14125,14127
19182,1,512,512,512.00,0.00,14126,14127
19183,1,512,512,512.00,0.00,14126,14127
19184,2,388,124,256.00,17424.00,14126,14128
19185,1,512,512,512.00,0.00,14127,14128
19186,3,307,30,170.67,12797.56,14127,14130
19187,1,512,512,512.00,0.00,14129,14130
19188,1,512,512,512.00,0.00,14129,14130
19189,2,378,134,256.00,14884.00,14129,14131
19190,1,512,512,512.00,0.00,14130,14131
19191,2,502,10,256.00,60516.00,14130,14132
19192,3,432,39,170.67,34148.22,14131,14134
19193,1,512,512,512.00,0.00,14133,14134
19194,2,288,224,256.00,1024.00,14133,14135
19195,1,512,512,512.00,0.00,14134,14135
19196,1,512,512,512.00,0.00,14134,14135
19197,2,263,249,256.00,49.00,14134,14136
19198,1,512,512,512.00,0.00,14135,14136
19199,1,512,512,512.00,0.00,14135,14136
19200,1,512,512,512.00,0.00,14135,14136
19201,2,329,183,256.00,5329.00,14135,14137
19202,1,512,512,512.00,0.00,14136,14137
19203,2,355,157,256.00,9801.00,14136,14138
19204,1,512,512,512.00,0.00,14137,14138
19205,5,289,28,102.40,8951.44,14137,14142
19206,1,512,512,512.00,0.00,14141,14142
19207,1,512,512,512.00,0.00,14141,14142
19208,1,512,512,512.00,0.00,14141,14142
19209,1,512,512,512.00,0.00,14141,14142
19210,2,352,160,256.00,9216.00,14141,14143
19211,1,512,512,512.00,0.00,14142,14143
19212,2,442,70,256.00,34596.00,14142,14144
19213,2,464,48,256.00,43264.00,14143,14145
19214,2,357,155,256.00,10201.00,14144,14146
19215,2,495,17,256.00,57121.00,14145,14147
19216,2,276,236,256.00,400.00,14146,14148
19217,1,512,512,512.00,0.00,14147,14148
19218,1,512,512,512.00,0.00,14147,14148
19219,1,512,512,512.00,0.00,14147,14148
19220,3,272,115,170.67,5150.89,14147,14150
19221,1,512,512,512.00,0.00,14149,14150
19222,1,512,512,512.00,0.00,14149,14150
19223,1,512,512,512.00,0.00,14149,14150
19224,1,512,512,512.00,0.00,14149,14150
19225,2,506,6,256.00,62500.00,14149,14151
19226,1,512,512,512.00,0.00,14150,14151
19227,2,361,151,256.00,11025.00,14150,14152
19228,2,503,9,256.00,61009.00,14151,14153
19229,1,512,512,512.00,0.00,14152,14153
19230,1,512,512,512.00,0.00,14152,14153
19231,2,287,225,256.00,961.00,14152,14154
19232,1,512,512,512.00,0.00,14153,14154
19233,3,428,40,170.67,33112.89,14153,14156
19234,1,512,512,512.00,0.00,14155,14156
19235,1,512,512,512.00,0.00,14155,14156
19236,2,341,171,256.00,7225.00,14155,14157
19237,2,400,112,256.00,20736.00,14156,14158
19238,1,512,512,512.00,0.00,14157,14158
19239,1,512,512,512.00,0.00,14157,14158
19240,1,512,512,512.00,0.00,14157,14158
19241,1,512,512,512.00,0.00,14157,14158
19242,2,300,212,256.00,1936.00,14157,14159
19243,1,512,512,512.00,0.00,14158,14159
19244,1,512,512,512.00,0.00,14158,14159
19245,5,429,4,102.40,26850.64,14158,14163
19246,1,512,512,512.00,0.00,14162,14163
19247,2,466,46,256.00,44100.00,14162,14164
19248,1,512,512,512.00,0.00,14163,14164
19249,1,512,512,512.00,0.00,14163,14164
19250,4,239,50,128.00,6567.50,14163,14167
19251,3,425,23,170.67,32622.89,14166,14169
19252,1,512,512,512.00,0.00,14168,14169
19253,1,512,512,512.00,0.00,14168,14169
19254,3,356,43,170.67,17990.89,14168,14171
19255,1,512,512,512.00,0.00,14170,14171
19256,1,512,512,512.00,0.00,14170,14171
19257,1,512,512,512.00,0.00,14170,14171
19258,1,512,512,512.00,0.00,14170,14171
19259,1,512,512,512.00,0.00,14170,14171
19260,2,270,242,256.00,196.00,14170,14172
19261,1,512,512,512.00,0.00,14171,14172
19262,2,258,254,256.00,4.00,14171,14173
19263,2,271,241,256.00,225.00,14172,14174
19264,1,512,512,512.00,0.00,14173,14174
19265,1,512,512,512.00,0.00,14173,14174
19266,1,512,512,512.00,0.00,14173,14174
19267,1,512,512,512.00,0.00,14173,14174
19268,3,326,89,170.67,12074.89,14173,14176
19269,1,512,512,512.00,0.00,14175,14176
19270,1,512,512,512.00,0.00,14175,14176
19271,2,511,1,256.00,65025.00,14175,14177
19272,1,512,512,512.00,0.00,14176,14177
19273,2,286,226,256.00,900.00,14176,14178
19274,1,512,512,512.00,0.00,14177,14178
19275,7,148,3,73.14,2586.41,14177,14184
19276,4,303,47,128.00,10545.50,14183,14187
19277,2,487,25,256.00,53361.00,14186,14188
19278,2,499,13,256.00,59049.00,14187,14189
19279,3,468,6,170.67,44374.22,14188,14191
19280,1,512,512,512.00,0.00,14190,14191
19281,1,512,512,512.00,0.00,14190,14191
19282,1,512,512,512.00,0.00,14190,14191
19283,2,509,3,256.00,64009.00,14190,14192
19284,2,423,89,256.00,27889.00,14191,14193
19285,1,512,512,512.00,0.00,14192,14193
19286,1,512,512,512.00,0.00,14192,14193
19287,1,512,512,512.00,0.00,14192,14193
19288,1,512,512,512.00,0.00,14192,14193
19289,3,392,46,170.67,24624.89,14192,14195
19290,2,280,232,256.00,576.00,14194,14196
19291,1,512,512,512.00,0.00,14195,14196
19292,2,472,40,256.00,46656.00,14195,14197
19293,2,270,242,256.00,196.00,14196,14198
19294,2,356,156,256.00,10000.00,14197,14199
19295,1,512,512,512.00,0.00,14198,14199
19296,1,512,512,512.00,0.00,14198,14199
19297,2,373,139,256.00,13689.00,14198,14200
19298,1,512,512,512.00,0.00,14199,14200
19299,1,512,512,512.00,0.00,14199,14200
19300,2,470,42,256.00,45796.00,14199,14201
19301,1,512,512,512.00,0.00,14200,14201
19302,1,512,512,512.00,0.00,14200,14201
19303,1,512,512,512.00,0.00,14200,14201
19304,2,437,75,256.00,32761.00,14200,14202
19305,1,512,512,512.00,0.00,14201,14202
19306,1,512,512,512.00,0.00,14201,14202
19307,3,319,46,170.67,12701.56,14201,14204
19308,2,381,131,256.00,15625.00,14203,14205
19309,1,512,512,512.00,0.00,14204,14205
19310,1,512,512,512.00,0.00,14204,14205
19311,2,457,55,256.00,40401.00,14204,14206
19312,2,311,201,256.00,3025.00,14205,14207
19313,1,512,512,512.00,0.00,14206,14207
19314,1,512,512,512.00,0.00,14206,14207
19315,1,512,512,512.00,0.00,14206,14207
19316,2,401,111,256.00,21025.00,14206,14208
19317,1,512,512,512.00,0.00,14207,14208
19318,1,512,512,512.00,0.00,14207,14208
19319,1,512,512,512.00,0.00,14207,14208
19320,2,494,18,256.00,56644.00,14207,14209
19321,2,291,221,256.00,1225.00,14208,14210
19322,1,512,512,512.00,0.00,14209,14210
19323,1,512,512,512.00,0.00,14209,14210
19324,2,487,25,256.00,53361.00,14209,14211
19325,2,479,33,256.00,49729.00,14210,14212
19326,2,382,130,256.00,15876.00,14212,14214
19327,2,472,40,256.00,46656.00,14213,14215
19328,1,512,512,512.00,0.00,14214,14215
19329,1,512,512,512.00,0.00,14214,14215
19330,1,512,512,512.00,0.00,14214,14215
19331,2,352,160,256.00,9216.00,14214,14216
19332,1,512,512,512.00,0.00,14215,14216
19333,1,512,512,512.00,0.00,14215,14216
19334,2,317,195,256.00,3721.00,14215,14217
19335,1,512,512,512.00,0.00,14216,14217
19336,1,512,512,512.00,0.00,14216,14217
19337,2,339,173,256.00,6889.00,14216,14218
19338,1,512,512,512.00,0.00,14217,14218
19339,2,416,96,256.00,25600.00,14217,14219
19340,4,432,1,128.00,31055.50,14218,14222
19341,1,512,512,512.00,0.00,14221,14222
19342,1,512,512,512.00,0.00,14221,14222
19343,2,296,216,256.00,1600.00,14221,14223
19344,3,304,10,170.67,14779.56,14222,14225
19345,1,512,512,512.00,0.00,14224,14225
19346,1,512,512,512.00,0.00,14224,14225
19347,3,265,29,170.67,10402.89,14224,14227
19348,1,512,512,512.00,0.00,14226,14227
19349,1,512,512,512.00,0.00,14226,14227
19350,1,512,512,512.00,0.00,14226,14227
19351,2,370,142,256.00,12996.00,14226,14228
19352,1,512,512,512.00,0.00,14227,14228
19353,1,512,512,512.00,0.00,14227,14228
19354,2,511,1,256.00,65025.00,14227,14229
19355,2,259,253,256.00,9.00,14228,14230
19356,2,339,173,256.00,6889.00,14229,14231
19357,1,512,512,512.00,0.00,14230,14231
19358,1,512,512,512.00,0.00,14230,14231
19359,1,512,512,512.00,0.00,14230,14231
19360,1,512,512,512.00,0.00,14230,14231
19361,3,359,5,170.67,21142.89,14230,14233
19362,1,512,512,512.00,0.00,14232,14233
19363,1,512,512,512.00,0.00,14232,14233
19364,1,512,512,512.00,0.00,14232,14233
19365,3,396,30,170.67,25910.22,14232,14235
19366,1,512,512,512.00,0.00,14234,14235
19367,1,512,512,512.00,0.00,14234,14235
19368,1,512,512,512.00,0.00,14234,14235
19369,2,323,189,256.00,4489.00,14234,14236
19370,1,512,512,512.00,0.00,14235,14236
19371,1,512,512,512.00,0.00,14235,14236
19372,2,292,220,256.00,1296.00,14235,14237
19373,1,512,512,512.00,0.00,14236,14237
19374,1,512,512,512.00,0.00,14236,14237
19375,2,310,202,256.00,2916.00,14236,14238
19376,1,512,512,512.00,0.00,14237,14238
19377,1,512,512,512.00,0.00,14237,14238
19378,1,512,512,512.00,0.00,14237,14238
19379,1,512,512,512.00,0.00,14237,14238
19380,2,441,71,256.00,34225.00,14237,14239
19381,2,430,82,256.00,30276.00,14238,14240
19382,5,171,23,102.40,2768.24,14239,14244
19383,2,277,235,256.00,441.00,14243,14245
19384,2,324,188,256.00,4624.00,14244,14246
19385,1,512,512,512.00,0.00,14245,14246
19386,1,512,512,512.00,0.00,14245,14246
19387,2,459,53,256.00,41209.00,14245,14247
19388,1,512,512,512.00,0.00,14246,14247
19389,3,312,40,170.67,12387.56,14246,14249
19390,3,337,22,170.67,16693.56,14248,14251
19391,2,486,26,256.00,52900.00,14250,14252
19392,1,512,512,512.00,0.00,14251,14252
19393,2,472,40,256.00,46656.00,14251,14253
19394,1,512,512,512.00,0.00,14252,14253
19395,1,512,512,512.00,0.00,14252,14253
19396,1,512,512,512.00,0.00,14252,14253
19397,1,512,512,512.00,0.00,14252,14253
19398,2,320,192,256.00,4096.00,14252,14254
19399,2,291,221,256.00,1225.00,14253,14255
19400,1,512,512,512.00,0.00,14254,14255
19401,2,405,107,256.00,22201.00,14254,14256
19402,1,512,512,512.00,0.00,14255,14256
19403,1,512,512,512.00,0.00,14255,14256
19404,1,512,512,512.00,0.00,14255,14256
19405,1,512,512,512.00,0.00,14255,14256
19406,2,419,93,256.00,26569.00,14255,14257
19407,1,512,512,512.00,0.00,14256,14257
19408,1,512,512,512.00,0.00,14256,14257
19409,1,512,512,512.00,0.00,14256,14257
19410,5,163,15,102.40,2520.64,14256,14261
19411,2,307,205,256.00,2601.00,14260,14262
19412,2,296,216,256.00,1600.00,14261,14263
19413,1,512,512,512.00,0.00,14262,14263
19414,2,509,3,256.00,64009.00,14262,14264
19415,4,386,18,128.00,22516.50,14263,14267
19416,1,512,512,512.00,0.00,14266,14267
19417,1,512,512,512.00,0.00,14266,14267
19418,2,277,235,256.00,441.00,14266,14268
19419,1,512,512,512.00,0.00,14267,14268
19420,1,512,512,512.00,0.00,14267,14268
19421,2,264,248,256.00,64.00,14267,14269
19422,1,512,512,512.00,0.00,14268,14269
19423,1,512,512,512.00,0.00,14268,14269
19424,1,512,512,512.00,0.00,14268,14269
19425,2,404,108,256.00,21904.00,14268,14270
19426,1,512,512,512.00,0.00,14269,14270
19427,1,512,512,512.00,0.00,14269,14270
19428,1,512,512,512.00,0.00,14269,14270
19429,1,512,512,512.00,0.00,14269,14270
19430,1,512,512,512.00,0.00,14269,14270
19431,1,512,512,512.00,0.00,14269,14270
19432,2,466,46,256.00,44100.00,14269,14271
19433,3,404,28,170.67,27672.89,14270,14273
19434,1,512,512,512.00,0.00,14272,14273
19435,2,314,198,256.00,3364.00,14272,14274
19436,1,512,512,512.00,0.00,14273,14274
19437,1,512,512,512.00,0.00,14273,14274
19438,1,512,512,512.00,0.00,14273,14274
19439,1,512,512,512.00,0.00,14273,14274
19440,2,396,116,256.00,19600.00,14273,14275
19441,6,198,4,85.33,6328.89,14274,14280
19442,2,292,220,256.00,1296.00,14279,14281
19443,2,310,202,256.00,2916.00,14280,14282
19444,1,512,512,512.00,0.00,14281,14282
19445,1,512,512,512.00,0.00,14281,14282
19446,2,432,80,256.00,30976.00,14281,14283
19447,1,512,512,512.00,0.00,14282,14283
19448,1,512,512,512.00,0.00,14282,14283
19449,2,296,216,256.00,1600.00,14282,14284
19450,1,512,512,512.00,0.00,14283,14284
19451,1,512,512,512.00,0.00,14283,14284
19452,3,425,2,170.67,33490.89,14283,14286
19453,1,512,512,512.00,0.00,14285,14286
19454,1,512,512,512.00,0.00,14285,14286
19455,3,279,10,170.67,13429.56,14285,14288
19456,3,321,77,170.67,11528.22,14287,14290
19457,2,342,170,256.00,7396.00,14289,14291
19458,1,512,512,512.00,0.00,14290,14291
19459,2,430,82,256.00,30276.00,14290,14292
19460,1,512,512,512.00,0.00,14291,14292
19461,1,512,512,512.00,0.00,14291,14292
19462,3,212,91,170.67,3174.89,14291,14294
19463,1,512,512,512.00,0.00,14293,14294
19464,1,512,512,512.00,0.00,14293,14294
19465,1,512,512,512.00,0.00,14293,14294
19466,1,512,512,512.00,0.00,14293,14294
19467,2,317,195,256.00,3721.00,14293,14295
19468,1,512,512,512.00,0.00,14294,14295
19469,1,512,512,512.00,0.00,14294,14295
19470,3,430,13,170.67,34149.56,14294,14297
19471,4,410,3,128.00,27498.50,14296,14300
19472,1,512,512,512.00,0.00,14299,14300
19473,2,305,207,256.00,2401.00,14299,14301
19474,2,312,200,256.00,3136.00,14300,14302
19475,2,404,108,256.00,21904.00,14301,14303
19476,1,512,512,512.00,0.00,14302,14303
19477,1,512,512,512.00,0.00,14302,14303
19478,1,512,512,512.00,0.00,14302,14303
19479,2,406,106,256.00,22500.00,14302,14304
19480,1,512,512,512.00,0.00,14303,14304
19481,4,250,1,128.00,8536.50,14303,14307
19482,1,512,512,512.00,0.00,14306,14307
19483,1,512,512,512.00,0.00,14306,14307
19484,2,266,246,256.00,100.00,14306,14308
19485,2,413,99,256.00,24649.00,14307,14309
19486,1,512,512,512.00,0.00,14308,14309
19487,1,512,512,512.00,0.00,14308,14309
19488,2,350,162,256.00,8836.00,14308,14310
19489,1,512,512,512.00,0.00,14309,14310
19490,3,388,3,170.67,25937.56,14309,14312
19491,3,389,11,170.67,25534.89,14311,14314
19492,3,299,65,170.67,9382.89,14313,14316
19493,1,512,512,512.00,0.00,14315,14316
19494,1,512,512,512.00,0.00,14315,14316
19495,1,512,512,512.00,0.00,14315,14316
19496,1,512,512,512.00,0.00,14315,14316
19497,3,373,7,170.67,23073.56,14315,14318
19498,3,436,21,170.67,35393.56,14317,14320
19499,1,512,512,512.00,0.00,14319,14320
19500,3,394,1,170.67,27181.56,14319,14322
19501,1,512,512,512.00,0.00,14321,14322
19502,1,512,512,512.00,0.00,14321,14322
19503,1,512,512,512.00,0.00,14321,14322
19504,3,374,51,170.67,20888.22,14321,14324
19505,1,512,512,512.00,0.00,14323,14324
19506,1,512,512,512.00,0.00,14323,14324
19507,1,512,512,512.00,0.00,14323,14324
19508,5,230,5,102.40,6636.24,14323,14328
19509,2,467,45,256.00,44521.00,14327,14329
19510,2,491,21,256.00,55225.00,14328,14330
19511,1,512,512,512.00,0.00,14329,14330
19512,1,512,512,512.00,0.00,14329,14330
19513,2,440,72,256.00,33856.00,14329,14331
19514,4,324,16,128.00,13886.50,14330,14334
19515,1,512,512,512.00,0.00,14333,14334
19516,1,512,512,512.00,0.00,14333,14334
19517,2,486,26,256.00,52900.00,14333,14335
19518,2,340,172,256.00,7056.00,14334,14336
19519,2,492,20,256.00,55696.00,14335,14337
19520,3,419,16,170.67,31454.89,14336,14339
19521,1,512,512,512.00,0.00,14338,14339
19522,1,512,512,512.00,0.00,14338,14339
19523,1,512,512,512.00,0.00,14338,14339
19524,1,512,512,512.00,0.00,14338,14339
19525,2,375,137,256.00,14161.00,14338,14340
19526,2,290,222,256.00,1156.00,14339,14341
19527,1,512,512,512.00,0.00,14340,14341
19528,3,399,2,170.67,28048.22,14340,14343
19529,1,512,512,512.00,0.00,14342,14343
19530,1,512,512,512.00,0.00,14342,14343
19531,1,512,512,512.00,0.00,14342,14343
19532,1,512,512,512.00,0.00,14342,14343
19533,3,314,28,170.67,13632.89,14342,14345
19534,1,512,512,512.00,0.00,14344,14345
19535,1,512,512,512.00,0.00,14344,14345
19536,1,512,512,512.00,0.00,14344,14345
19537,2,341,171,256.00,7225.00,14344,14346
19538,1,512,512,512.00,0.00,14345,14346
19539,1,512,512,512.00,0.00,14345,14346
19540,1,512,512,512.00,0.00,14345,14346
19541,3,263,42,170.67,8800.22,14345,14348
19542,1,512,512,512.00,0.00,14347,14348
19543,2,279,233,256.00,529.00,14347,14349
19544,1,512,512,512.00,0.00,14348,14349
19545,3,421,9,170.67,32221.56,14348,14351
19546,1,512,512,512.00,0.00,14350,14351
19547,3,312,6,170.67,15878.22,14350,14353
19548,5,244,5,102.40,6329.44,14352,14357
19549,2,348,164,256.00,8464.00,14356,14358
19550,2,390,122,256.00,17956.00,14357,14359
19551,3,222,109,170.67,2181.56,14358,14361
19552,2,304,208,256.00,2304.00,14360,14362
19553,2,280,232,256.00,576.00,14361,14363
19554,1,512,512,512.00,0.00,14362,14363
19555,1,512,512,512.00,0.00,14362,14363
19556,1,512,512,512.00,0.00,14362,14363
19557,1,512,512,512.00,0.00,14362,14363
19558,2,489,23,256.00,54289.00,14362,14364
19559,1,512,512,512.00,0.00,14363,14364
19560,3,389,46,170.67,23994.89,14363,14366
19561,1,512,512,512.00,0.00,14365,14366
19562,1,512,512,512.00,0.00,14365,14366
19563,1,512,512,512.00,0.00,14365,14366
19564,1,512,512,512.00,0.00,14365,14366
19565,2,321,191,256.00,4225.00,14365,14367
19566,2,434,78,256.00,31684.00,14366,14368
19567,1,512,512,512.00,0.00,14367,14368
19568,1,512,512,512.00,0.00,14367,14368
19569,1,512,512,512.00,0.00,14367,14368
19570,3,292,42,170.67,10443.56,14367,14370
19571,4,378,12,128.00,21955.50,14369,14373
19572,1,512,512,512.00,0.00,14372,14373
19573,3,252,64,170.67,6211.56,14372,14375
19574,3,327,1,170.67,17801.56,14374,14377
19575,1,512,512,512.00,0.00,14376,14377
19576,2,457,55,256.00,40401.00,14376,14378
19577,1,512,512,512.00,0.00,14377,14378
19578,1,512,512,512.00,0.00,14377,14378
19579,5,299,4,102.40,12713.84,14377,14382
19580,1,512,512,512.00,0.00,14381,14382
19581,1,512,512,512.00,0.00,14381,14382
19582,3,301,59,170.67,9934.89,14381,14384
19583,1,512,512,512.00,0.00,14383,14384
19584,3,475,3,170.67,46469.56,14383,14386
19585,1,512,512,512.00,0.00,14385,14386
19586,1,512,512,512.00,0.00,14385,14386
19587,2,364,148,256.00,11664.00,14385,14387
19588,4,245,28,128.00,7974.50,14386,14390
19589,3,371,3,170.67,23104.22,14389,14392
19590,1,512,512,512.00,0.00,14391,14392
19591,2,451,61,256.00,38025.00,14391,14393
19592,1,512,512,512.00,0.00,14392,14393
19593,2,474,38,256.00,47524.00,14392,14394
19594,1,512,512,512.00,0.00,14393,14394
19595,3,393,33,170.67,25184.22,14393,14396
19596,2,297,215,256.00,1681.00,14395,14397
19597,1,512,512,512.00,0.00,14396,14397
19598,1,512,512,512.00,0.00,14396,14397
19599,1,512,512,512.00,0.00,14396,14397
19600,2,290,222,256.00,1156.00,14396,14398
19601,1,512,512,512.00,0.00,14397,14398
19602,3,327,58,170.67,13013.56,14397,14400
19603,1,512,512,512.00,0.00,14399,14400
19604,1,512,512,512.00,0.00,14399,14400
19605,3,335,16,170.67,17006.89,14399,14402
19606,2,268,244,256.00,144.00,14402,14404
19607,2,309,203,256.00,2809.00,14403,14405
19608,1,512,512,512.00,0.00,14404,14405
19609,2,468,44,256.00,44944.00,14404,14406
19610,3,330,60,170.67,13334.22,14405,14408
19611,1,512,512,512.00,0.00,14407,14408
19612,1,512,512,512.00,0.00,14407,14408
19613,1,512,512,512.00,0.00,14407,14408
19614,2,343,169,256.00,7569.00,14407,14409
19615,2,366,146,256.00,12100.00,14408,14410
19616,1,512,512,512.00,0.00,14409,14410
19617,1,512,512,512.00,0.00,14409,14410
19618,1,512,512,512.00,0.00,14409,14410
19619,2,470,42,256.00,45796.00,14409,14411
19620,1,512,512,512.00,0.00,14410,14411
19621,1,512,512,512.00,0.00,14410,14411
19622,4,368,15,128.00,20203.50,14410,14414
19623,1,512,512,512.00,0.00,14413,14414
19624,1,512,512,512.00,0.00,14413,14414
19625,1,512,512,512.00,0.00,14413,14414
19626,3,341,46,170.67,15546.89,14413,14416
19627,1,512,512,512.00,0.00,14415,14416
19628,2,269,243,256.00,169.00,14415,14417
19629,4,228,26,128.00,9806.00,14416,14420
19630,1,512,512,512.00,0.00,14419,14420
19631,1,512,512,512.00,0.00,14419,14420
19632,3,300,103,170.67,8369.56,14419,14422
19633,1,512,512,512.00,0.00,14421,14422
19634,1,512,512,512.00,0.00,14421,14422
19635,1,512,512,512.00,0.00,14421,14422
19636,3,452,4,170.67,40024.89,14421,14424
19637,1,512,512,512.00,0.00,14423,14424
19638,1,512,512,512.00,0.00,14423,14424
19639,2,304,208,256.00,2304.00,14423,14425
19640,1,512,512,512.00,0.00,14424,14425
19641,3,323,20,170.67,15302.89,14424,14427
19642,3,439,10,170.67,36469.56,14426,14429
19643,3,441,2,170.67,37288.22,14428,14431
19644,1,512,512,512.00,0.00,14430,14431
19645,1,512,512,512.00,0.00,14430,14431
19646,1,512,512,512.00,0.00,14430,14431
19647,2,490,22,256.00,54756.00,14430,14432
19648,2,482,30,256.00,51076.00,14431,14433
19649,1,512,512,512.00,0.00,14432,14433
19650,1,512,512,512.00,0.00,14432,14433
19651,1,512,512,512.00,0.00,14432,14433
19652,2,495,17,256.00,57121.00,14432,14434
19653,1,512,512,512.00,0.00,14433,14434
19654,1,512,512,512.00,0.00,14433,14434
19655,1,512,512,512.00,0.00,14433,14434
19656,2,411,101,256.00,24025.00,14433,14435
19657,2,291,221,256.00,1225.00,14434,14436
19658,5,207,20,102.40,4114.64,14435,14440
19659,1,512,512,512.00,0.00,14439,14440
19660,1,512,512,512.00,0.00,14439,14440
19661,4,370,42,128.00,19534.00,14439,14443
19662,4,308,1,128.00,14313.50,14442,14446
19663,10,162,7,51.20,2017.36,14445,14455
19664,2,459,53,256.00,41209.00,14454,14456
19665,1,512,512,512.00,0.00,14455,14456
19666,1,512,512,512.00,0.00,14455,14456
19667,1,512,512,512.00,0.00,14455,14456
19668,2,291,221,256.00,1225.00,14455,14457
19669,2,295,217,256.00,1521.00,14456,14458
19670,1,512,512,512.00,0.00,14457,14458
19671,1,512,512,512.00,0.00,14457,14458
19672,1,512,512,512.00,0.00,14457,14458
19673,2,442,70,256.00,34596.00,14457,14459
19674,1,512,512,512.00,0.00,14458,14459
19675,1,512,512,512.00,0.00,14458,14459
19676,2,460,52,256.00,41616.00,14458,14460
19677,1,512,512,512.00,0.00,14459,14460
19678,1,512,512,512.00,0.00,14459,14460
19679,1,512,512,512.00,0.00,14459,14460
19680,2,312,200,256.00,3136.00,14459,14461
19681,1,512,512,512.00,0.00,14460,14461
19682,2,324,188,256.00,4624.00,14460,14462
19683,2,296,216,256.00,1600.00,14461,14463
19684,2,503,9,256.00,61009.00,14462,14464
19685,3,264,114,170.67,4422.22,14463,14466
19686,1,512,512,512.00,0.00,14465,14466
19687,4,269,9,128.00,13179.00,14465,14469
19688,1,512,512,512.00,0.00,14468,14469
19689,1,512,512,512.00,0.00,14468,14469
19690,1,512,512,512.00,0.00,14468,14469
19691,1,512,512,512.00,0.00,14468,14469
19692,6,332,2,85.33,12821.89,14468,14474
19693,6,206,6,85.33,7323.22,14473,14479
19694,3,458,4,170.67,41632.89,14478,14481
19695,2,272,240,256.00,256.00,14480,14482
19696,1,512,512,512.00,0.00,14481,14482
19697,1,512,512,512.00,0.00,14481,14482
19698,1,512,512,512.00,0.00,14481,14482
19699,3,291,28,170.67,11777.56,14481,14484
19700,1,512,512,512.00,0.00,14483,14484
19701,1,512,512,512.00,0.00,14483,14484
19702,4,197,52,128.00,3865.50,14483,14487
19703,1,512,512,512.00,0.00,14486,14487
19704,1,512,512,512.00,0.00,14486,14487
19705,8,176,1,64.00,3277.00,14486,14494
19706,3,329,90,170.67,12536.22,14493,14496
19707,1,512,512,512.00,0.00,14495,14496
19708,2,289,223,256.00,1089.00,14495,14497
19709,1,512,512,512.00,0.00,14496,14497
19710,1,512,512,512.00,0.00,14496,14497
19711,2,456,56,256.00,40000.00,14496,14498
19712,1,512,512,512.00,0.00,14497,14498
19713,1,512,512,512.00,0.00,14497,14498
19714,1,512,512,512.00,0.00,14497,14498
19715,4,280,1,128.00,9914.50,14497,14501
19716,2,348,164,256.00,8464.00,14500,14502
19717,2,466,46,256.00,44100.00,14501,14503
19718,2,501,11,256.00,60025.00,14502,14504
19719,1,512,512,512.00,0.00,14503,14504
19720,1,512,512,512.00,0.00,14503,14504
19721,1,512,512,512.00,0.00,14503,14504
19722,2,464,48,256.00,43264.00,14503,14505
19723,1,512,512,512.00,0.00,14504,14505
19724,3,279,102,170.67,6008.22,14504,14507
19725,1,512,512,512.00,0.00,14506,14507
19726,3,315,54,170.67,11736.22,14506,14509
19727,2,439,73,256.00,33489.00,14508,14510
19728,1,512,512,512.00,0.00,14509,14510
19729,5,318,5,102.40,13736.24,14509,14514
19730,2,494,18,256.00,56644.00,14513,14515
19731,3,266,71,170.67,6346.89,14514,14517
19732,1,512,512,512.00,0.00,14516,14517
19733,1,512,512,512.00,0.00,14516,14517
19734,1,512,512,512.00,0.00,14516,14517
19735,1,512,512,512.00,0.00,14516,14517
19736,3,304,31,170.67,12441.56,14516,14519
19737,1,512,512,512.00,0.00,14518,14519
19738,1,512,512,512.00,0.00,14518,14519
19739,3,337,3,170.67,18593.56,14518,14521
19740,1,512,512,512.00,0.00,14520,14521
19741,1,512,512,512.00,0.00,14520,14521
19742,3,384,36,170.67,23278.22,14520,14523
19743,1,512,512,512.00,0.00,14522,14523
19744,1,512,512,512.00,0.00,14522,14523
19745,4,298,2,128.00,15134.00,14522,14526
19746,1,512,512,512.00,0.00,14525,14526
19747,2,460,52,256.00,41616.00,14525,14527
19748,1,512,512,512.00,0.00,14526,14527
19749,1,512,512,512.00,0.00,14526,14527
19750,2,397,115,256.00,19881.00,14526,14528
19751,1,512,512,512.00,0.00,14527,14528
19752,1,512,512,512.00,0.00,14527,14528
19753,2,445,67,256.00,35721.00,14527,14529
19754,1,512,512,512.00,0.00,14528,14529
19755,1,512,512,512.00,0.00,14528,14529
19756,2,262,250,256.00,36.00,14528,14530
19757,2,504,8,256.00,61504.00,14529,14531
19758,1,512,512,512.00,0.00,14530,14531
19759,2,279,233,256.00,529.00,14530,14532
19760,1,512,512,512.00,0.00,14531,14532
19761,2,500,12,256.00,59536.00,14531,14533
19762,1,512,512,512.00,0.00,14532,14533
19763,3,361,32,170.67,19374.89,14532,14535
19764,1,512,512,512.00,0.00,14534,14535
19765,1,512,512,512.00,0.00,14534,14535
19766,1,512,512,512.00,0.00,14534,14535
19767,1,512,512,512.00,0.00,14534,14535
19768,2,452,60,256.00,38416.00,14534,14536
19769,1,512,512,512.00,0.00,14535,14536
19770,1,512,512,512.00,0.00,14535,14536
19771,3,257,2,170.67,14226.89,14535,14538
19772,1,512,512,512.00,0.00,14537,14538
19773,4,309,60,128.00,10963.50,14537,14541
19774,1,512,512,512.00,0.00,14540,14541
19775,2,507,5,256.00,63001.00,14540,14542
19776,3,346,24,170.67,17691.56,14541,14544
19777,1,512,512,512.00,0.00,14543,14544
19778,1,512,512,512.00,0.00,14543,14544
19779,1,512,512,512.00,0.00,14543,14544
19780,1,512,512,512.00,0.00,14543,14544
19781,1,512,512,512.00,0.00,14543,14544
19782,1,512,512,512.00,0.00,14543,14544
19783,3,231,73,170.67,4857.56,14543,14546
19784,3,266,14,170.67,12464.89,14545,14548
19785,3,439,8,170.67,36542.89,14547,14550
19786,2,414,98,256.00,24964.00,14549,14551
19787,1,512,512,512.00,0.00,14551,14552
19788,1,512,512,512.00,0.00,14551,14552
19789,3,219,137,170.67,1228.22,14551,14554
19790,1,512,512,512.00,0.00,14553,14554
19791,1,512,512,512.00,0.00,14553,14554
19792,2,394,118,256.00,19044.00,14553,14555
19793,2,425,87,256.00,28561.00,14554,14556
19794,1,512,512,512.00,0.00,14555,14556
19795,1,512,512,512.00,0.00,14555,14556
19796,1,512,512,512.00,0.00,14555,14556
19797,2,356,156,256.00,10000.00,14555,14557
19798,3,330,3,170.67,17856.22,14556,14559
19799,2,349,163,256.00,8649.00,14558,14560
19800,2,509,3,256.00,64009.00,14559,14561
19801,1,512,512,512.00,0.00,14560,14561
19802,2,326,186,256.00,4900.00,14560,14562
19803,3,403,39,170.67,27149.56,14561,14564
19804,1,512,512,512.00,0.00,14563,14564
19805,1,512,512,512.00,0.00,14563,14564
19806,1,512,512,512.00,0.00,14563,14564
19807,1,512,512,512.00,0.00,14563,14564
19808,1,512,512,512.00,0.00,14563,14564
19809,3,258,83,170.67,5104.22,14563,14566
19810,1,512,512,512.00,0.00,14565,14566
19811,3,345,9,170.67,18896.22,14565,14568
19812,2,358,154,256.00,10404.00,14567,14569
19813,1,512,512,512.00,0.00,14568,14569
19814,2,346,166,256.00,8100.00,14568,14570
19815,1,512,512,512.00,0.00,14569,14570
19816,1,512,512,512.00,0.00,14569,14570
19817,3,314,26,170.67,13824.89,14569,14572
19818,4,245,10,128.00,13344.50,14571,14575
19819,2,463,49,256.00,42849.00,14574,14576
19820,2,344,168,256.00,7744.00,14575,14577
19821,2,437,75,256.00,32761.00,14576,14578
19822,1,512,512,512.00,0.00,14577,14578
19823,1,512,512,512.00,0.00,14577,14578
19824,1,512,512,512.00,0.00,14577,14578
19825,3,263,7,170.67,13466.89,14577,14580
19826,1,512,512,512.00,0.00,14579,14580
19827,1,512,512,512.00,0.00,14579,14580
19828,1,512,512,512.00,0.00,14579,14580
19829,1,512,512,512.00,0.00,14579,14580
19830,2,507,5,256.00,63001.00,14579,14581
19831,1,512,512,512.00,0.00,14580,14581
19832,1,512,512,512.00,0.00,14580,14581
19833,2,399,113,256.00,20449.00,14580,14582
19834,1,512,512,512.00,0.00,14581,14582
19835,1,512,512,512.00,0.00,14581,14582
19836,1,512,512,512.00,0.00,14581,14582
19837,4,233,45,128.00,6051.50,14581,14585
19838,2,296,216,256.00,1600.00,14584,14586
19839,4,289,17,128.00,9985.50,14585,14589
19840,1,512,512,512.00,0.00,14588,14589
19841,2,337,175,256.00,6561.00,14588,14590
19842,3,254,39,170.67,8872.22,14589,14592
19843,1,512,512,512.00,0.00,14591,14592
19844,4,229,48,128.00,4908.50,14591,14595
19845,3,412,16,170.67,29891.56,14594,14597
19846,2,430,82,256.00,30276.00,14596,14598
19847,3,333,71,170.67,13404.22,14597,14600
19848,4,300,3,128.00,12904.50,14599,14603
19849,1,512,512,512.00,0.00,14602,14603
19850,13,194,1,39.38,2741.47,14602,14615
19851,2,373,139,256.00,13689.00,14614,14616
19852,1,512,512,512.00,0.00,14615,14616
19853,2,308,204,256.00,2704.00,14615,14617
19854,1,512,512,512.00,0.00,14616,14617
19855,1,512,512,512.00,0.00,14616,14617
19856,1,512,512,512.00,0.00,14616,14617
19857,2,345,167,256.00,7921.00,14616,14618
19858,2,445,67,256.00,35721.00,14617,14619
19859,1,512,512,512.00,0.00,14618,14619
19860,1,512,512,512.00,0.00,14618,14619
19861,1,512,512,512.00,0.00,14618,14619
19862,4,371,1,128.00,22857.00,14618,14622
19863,3,275,26,170.67,11146.89,14621,14624
19864,2,372,140,256.00,13456.00,14623,14625
19865,1,512,512,512.00,0.00,14624,14625
19866,1,512,512,512.00,0.00,14624,14625
19867,1,512,512,512.00,0.00,14624,14625
19868,3,279,39,170.67,9872.22,14624,14627
19869,1,512,512,512.00,0.00,14626,14627
19870,1,512,512,512.00,0.00,14626,14627
19871,1,512,512,512.00,0.00,14626,14627
19872,1,512,512,512.00,0.00,14626,14627
19873,3,469,1,170.67,44781.56,14626,14629
19874,1,512,512,512.00,0.00,14628,14629
19875,1,512,512,512.00,0.00,14628,14629
19876,3,269,83,170.67,5822.89,14628,14631
19877,1,512,512,512.00,0.00,14630,14631
19878,1,512,512,512.00,0.00,14630,14631
19879,1,512,512,512.00,0.00,14630,14631
19880,1,512,512,512.00,0.00,14630,14631
19881,3,462,24,170.67,42438.22,14630,14633
19882,2,314,198,256.00,3364.00,14632,14634
19883,1,512,512,512.00,0.00,14633,14634
19884,1,512,512,512.00,0.00,14633,14634
19885,2,273,239,256.00,289.00,14633,14635
19886,1,512,512,512.00,0.00,14634,14635
19887,1,512,512,512.00,0.00,14634,14635
19888,1,512,512,512.00,0.00,14634,14635
19889,4,325,2,128.00,15954.50,14634,14638
19890,1,512,512,512.00,0.00,14637,14638
19891,4,455,3,128.00,35789.00,14637,14641
19892,2,470,42,256.00,45796.00,14640,14642
19893,1,512,512,512.00,0.00,14641,14642
19894,1,512,512,512.00,0.00,14641,14642
19895,2,262,250,256.00,36.00,14641,14643
19896,1,512,512,512.00,0.00,14642,14643
19897,3,274,81,170.67,6301.56,14642,14645
19898,1,512,512,512.00,0.00,14644,14645
19899,1,512,512,512.00,0.00,14644,14645
19900,1,512,512,512.00,0.00,14644,14645
19901,2,266,246,256.00,100.00,14644,14646
19902,2,392,120,256.00,18496.00,14645,14647
19903,4,348,2,128.00,17354.00,14646,14650
19904,2,323,189,256.00,4489.00,14649,14651
19905,3,471,9,170.67,45188.22,14650,14653
19906,1,512,512,512.00,0.00,14652,14653
19907,4,340,31,128.00,15431.50,14652,14656
19908,3,446,1,170.67,38586.89,14655,14658
19909,2,479,33,256.00,49729.00,14657,14659
19910,1,512,512,512.00,0.00,14658,14659
19911,2,355,157,256.00,9801.00,14658,14660
19912,1,512,512,512.00,0.00,14659,14660
19913,1,512,512,512.00,0.00,14659,14660
19914,1,512,512,512.00,0.00,14659,14660
19915,1,512,512,512.00,0.00,14659,14660
19916,2,459,53,256.00,41209.00,14659,14661
19917,4,320,3,128.00,16029.50,14660,14664
19918,1,512,512,512.00,0.00,14663,14664
19919,1,512,512,512.00,0.00,14663,14664
19920,1,512,512,512.00,0.00,14663,14664
19921,2,489,23,256.00,54289.00,14663,14665
19922,1,512,512,512.00,0.00,14664,14665
19923,1,512,512,512.00,0.00,14664,14665
19924,1,512,512,512.00,0.00,14664,14665
19925,3,334,53,170.67,14202.89,14664,14667
19926,2,268,244,256.00,144.00,14666,14668
19927,1,512,512,512.00,0.00,14667,14668
19928,1,512,512,512.00,0.00,14667,14668
19929,1,512,512,512.00,0.00,14667,14668
19930,1,512,512,512.00,0.00,14667,14668
19931,3,431,5,170.67,34726.89,14667,14670
19932,4,266,2,128.00,8772.50,14669,14673
19933,1,512,512,512.00,0.00,14672,14673
19934,1,512,512,512.00,0.00,14672,14673
19935,2,443,69,256.00,34969.00,14672,14674
19936,1,512,512,512.00,0.00,14673,14674
19937,3,340,14,170.67,17792.89,14673,14676
19938,2,449,63,256.00,37249.00,14675,14677
19939,7,197,2,73.14,4524.69,14676,14683
19940,1,512,512,512.00,0.00,14682,14683
19941,2,403,109,256.00,21609.00,14682,14684
19942,1,512,512,512.00,0.00,14683,14684
19943,2,356,156,256.00,10000.00,14683,14685
19944,1,512,512,512.00,0.00,14684,14685
19945,1,512,512,512.00,0.00,14684,14685
19946,2,421,91,256.00,27225.00,14684,14686
19947,1,512,512,512.00,0.00,14685,14686
19948,1,512,512,512.00,0.00,14685,14686
19949,2,319,193,256.00,3969.00,14685,14687
19950,1,512,512,512.00,0.00,14686,14687
19951,2,267,245,256.00,121.00,14686,14688
19952,1,512,512,512.00,0.00,14687,14688
19953,1,512,512,512.00,0.00,14687,14688
19954,2,435,77,256.00,32041.00,14687,14689
19955,2,454,58,256.00,39204.00,14688,14690
19956,1,512,512,512.00,0.00,14689,14690
19957,3,318,19,170.67,14909.56,14689,14692
19958,4,207,36,128.00,5128.50,14691,14695
19959,3,421,41,170.67,31346.89,14694,14697
19960,1,512,512,512.00,0.00,14696,14697
19961,1,512,512,512.00,0.00,14696,14697
19962,1,512,512,512.00,0.00,14696,14697
19963,1,512,512,512.00,0.00,14696,14697
19964,1,512,512,512.00,0.00,14696,14697
19965,1,512,512,512.00,0.00,14696,14697
19966,1,512,512,512.00,0.00,14696,14697
19967,2,449,63,256.00,37249.00,14696,14698
19968,3,490,2,170.67,51040.89,14697,14700
19969,1,512,512,512.00,0.00,14699,14700
19970,1,512,512,512.00,0.00,14699,14700
19971,1,512,512,512.00,0.00,14699,14700
19972,2,322,190,256.00,4356.00,14699,14701
19973,1,512,512,512.00,0.00,14700,14701
19974,2,279,233,256.00,529.00,14700,14702
19975,1,512,512,512.00,0.00,14701,14702
19976,3,253,105,170.67,3789.56,14701,14704
19977,5,411,3,102.40,24227.04,14703,14708
19978,1,512,512,512.00,0.00,14707,14708
19979,1,512,512,512.00,0.00,14707,14708
19980,3,440,9,170.67,36756.22,14707,14710
19981,1,512,512,512.00,0.00,14709,14710
19982,1,512,512,512.00,0.00,14709,14710
19983,1,512,512,512.00,0.00,14709,14710
19984,2,344,168,256.00,7744.00,14709,14711
19985,2,465,47,256.00,43681.00,14710,14712
19986,2,483,29,256.00,51529.00,14711,14713
19987,2,478,34,256.00,49284.00,14712,14714
19988,1,512,512,512.00,0.00,14713,14714
19989,1,512,512,512.00,0.00,14713,14714
19990,2,409,103,256.00,23409.00,14713,14715
19991,1,512,512,512.00,0.00,14714,14715
19992,1,512,512,512.00,0.00,14714,14715
19993,3,246,102,170.67,3478.22,14714,14717
19994,2,376,136,256.00,14400.00,14716,14718
19995,2,314,198,256.00,3364.00,14717,14719
19996,3,502,2,170.67,54896.89,14718,14721
19997,3,266,104,170.67,4784.89,14720,14723
19998,1,512,512,512.00,0.00,14722,14723
19999,1,512,512,512.00,0.00,14722,14723
20000,2,384,128,256.00,16384.00,14722,14724
20001,3,321,4,170.67,16881.56,14723,14726
20002,1,512,512,512.00,0.00,14725,14726
20003,2,472,40,256.00,46656.00,14725,14727
20004,1,512,512,512.00,0.00,14726,14727
20005,1,512,512,512.00,0.00,14726,14727
20006,1,512,512,512.00,0.00,14726,14727
20007,1,512,512,512.00,0.00,14726,14727
20008,2,439,73,256.00,33489.00,14726,14728
20009,1,512,512,512.00,0.00,14727,14728
20010,2,282,230,256.00,676.00,14727,14729
20011,2,269,243,256.00,169.00,14728,14730
20012,1,512,512,512.00,0.00,14729,14730
20013,3,228,93,170.67,3244.22,14729,14732
20014,3,359,32,170.67,19054.89,14731,14734
20015,2,501,11,256.00,60025.00,14733,14735
20016,1,512,512,512.00,0.00,14734,14735
20017,1,512,512,512.00,0.00,14734,14735
20018,6,227,42,85.33,4312.22,14734,14740
20019,2,458,54,256.00,40804.00,14739,14741
20020,1,512,512,512.00,0.00,14740,14741
20021,1,512,512,512.00,0.00,14740,14741
20022,4,223,3,128.00,6277.00,14740,14744
20023,1,512,512,512.00,0.00,14743,14744
20024,7,241,1,73.14,7360.12,14743,14750
20025,1,512,512,512.00,0.00,14749,14750
20026,1,512,512,512.00,0.00,14749,14750
20027,2,510,2,256.00,64516.00,14749,14751
20028,2,511,1,256.00,65025.00,14750,14752
20029,1,512,512,512.00,0.00,14751,14752
20030,2,328,184,256.00,5184.00,14751,14753
20031,1,512,512,512.00,0.00,14752,14753
20032,2,316,196,256.00,3600.00,14752,14754
20033,1,512,512,512.00,0.00,14753,14754
20034,1,512,512,512.00,0.00,14753,14754
20035,1,512,512,512.00,0.00,14753,14754
20036,1,512,512,512.00,0.00,14753,14754
20037,3,391,2,170.67,26554.89,14753,14756
20038,1,512,512,512.00,0.00,14755,14756
20039,3,385,49,170.67,23109.56,14755,14758
20040,2,463,49,256.00,42849.00,14757,14759
20041,1,512,512,512.00,0.00,14758,14759
20042,2,276,236,256.00,400.00,14758,14760
20043,1,512,512,512.00,0.00,14759,14760
20044,4,374,2,128.00,20898.50,14759,14763
20045,1,512,512,512.00,0.00,14762,14763
20046,4,351,14,128.00,17187.50,14762,14766
20047,1,512,512,512.00,0.00,14765,14766
20048,3,383,10,170.67,24522.89,14765,14768
20049,1,512,512,512.00,0.00,14767,14768
20050,1,512,512,512.00,0.00,14767,14768
20051,2,287,225,256.00,961.00,14767,14769
20052,1,512,512,512.00,0.00,14768,14769
20053,1,512,512,512.00,0.00,14768,14769
20054,2,396,116,256.00,19600.00,14768,14770
20055,1,512,512,512.00,0.00,14769,14770
20056,2,383,129,256.00,16129.00,14769,14771
20057,1,512,512,512.00,0.00,14770,14771
20058,1,512,512,512.00,0.00,14770,14771
20059,1,512,512,512.00,0.00,14770,14771
20060,1,512,512,512.00,0.00,14770,14771
20061,3,270,49,170.67,8389.56,14770,14773
20062,1,512,512,512.00,0.00,14772,14773
20063,2,470,42,256.00,45796.00,14772,14774
20064,1,512,512,512.00,0.00,14773,14774
20065,5,186,15,102.40,4633.04,14773,14778
20066,1,512,512,512.00,0.00,14777,14778
20067,2,399,113,256.00,20449.00,14777,14779
20068,5,374,3,102.40,19239.04,14778,14783
20069,2,502,10,256.00,60516.00,14782,14784
20070,1,512,512,512.00,0.00,14783,14784
20071,1,512,512,512.00,0.00,14783,14784
20072,2,388,124,256.00,17424.00,14783,14785
20073,2,446,66,256.00,36100.00,14784,14786
20074,1,512,512,512.00,0.00,14785,14786
20075,1,512,512,512.00,0.00,14785,14786
20076,4,376,2,128.00,22887.50,14785,14789
20077,1,512,512,512.00,0.00,14788,14789
20078,1,512,512,512.00,0.00,14788,14789
20079,2,451,61,256.00,38025.00,14788,14790
20080,2,477,35,256.00,48841.00,14789,14791
20081,1,512,512,512.00,0.00,14790,14791
20082,2,421,91,256.00,27225.00,14790,14792
20083,1,512,512,512.00,0.00,14791,14792
20084,5,231,20,102.40,5667.44,14791,14796
20085,1,512,512,512.00,0.00,14795,14796
20086,2,430,82,256.00,30276.00,14795,14797
20087,3,304,82,170.67,9211.56,14796,14799
20088,1,512,512,512.00,0.00,14798,14799
20089,4,272,3,128.00,10263.50,14798,14802
20090,4,398,1,128.00,25894.50,14801,14805
20091,1,512,512,512.00,0.00,14804,14805
20092,1,512,512,512.00,0.00,14804,14805
20093,1,512,512,512.00,0.00,14804,14805
20094,3,362,3,170.67,21760.22,14804,14807
20095,1,512,512,512.00,0.00,14806,14807
20096,1,512,512,512.00,0.00,14806,14807
20097,1,512,512,512.00,0.00,14806,14807
20098,6,176,1,85.33,4662.56,14806,14812
20099,6,265,2,85.33,9610.56,14811,14817
20100,2,375,137,256.00,14161.00,14816,14818
20101,2,328,184,256.00,5184.00,14817,14819
20102,1,512,512,512.00,0.00,14818,14819
20103,1,512,512,512.00,0.00,14818,14819
20104,1,512,512,512.00,0.00,14818,14819
20105,2,288,224,256.00,1024.00,14818,14820
20106,2,506,6,256.00,62500.00,14819,14821
20107,1,512,512,512.00,0.00,14820,14821
20108,1,512,512,512.00,0.00,14820,14821
20109,4,393,2,128.00,25536.50,14820,14824
20110,1,512,512,512.00,0.00,14823,14824
20111,1,512,512,512.00,0.00,14823,14824
20112,2,261,251,256.00,25.00,14823,14825
20113,2,256,256,256.00,0.00,14824,14826
20114,1,512,512,512.00,0.00,14825,14826
20115,4,319,5,128.00,16680.50,14825,14829
20116,1,512,512,512.00,0.00,14828,14829
20117,1,512,512,512.00,0.00,14828,14829
20118,1,512,512,512.00,0.00,14828,14829
20119,2,280,232,256.00,576.00,14828,14830
20120,1,512,512,512.00,0.00,14829,14830
20121,1,512,512,512.00,0.00,14829,14830
20122,2,266,246,256.00,100.00,14829,14831
20123,1,512,512,512.00,0.00,14830,14831
20124,2,394,118,256.00,19044.00,14830,14832
20125,1,512,512,512.00,0.00,14831,14832
20126,1,512,512,512.00,0.00,14831,14832
20127,2,434,78,256.00,31684.00,14831,14833
20128,1,512,512,512.00,0.00,14832,14833
20129,1,512,512,512.00,0.00,14832,14833
20130,1,512,512,512.00,0.00,14832,14833
20131,1,512,512,512.00,0.00,14832,14833
20132,3,348,28,170.67,17667.56,14832,14835
20133,2,373,139,256.00,13689.00,14834,14836
20134,1,512,512,512.00,0.00,14835,14836
20135,2,457,55,256.00,40401.00,14835,14837
20136,4,451,2,128.00,35202.50,14836,14840
20137,1,512,512,512.00,0.00,14839,14840
20138,1,512,512,512.00,0.00,14839,14840
20139,1,512,512,512.00,0.00,14839,14840
20140,5,252,3,102.40,10980.64,14839,14844
20141,2,348,164,256.00,8464.00,14843,14845
20142,2,392,120,256.00,18496.00,14844,14846
20143,1,512,512,512.00,0.00,14845,14846
20144,3,297,27,170.67,12300.22,14845,14848
20145,2,474,38,256.00,47524.00,14847,14849
20146,3,306,3,170.67,15824.22,14848,14851
20147,1,512,512,512.00,0.00,14850,14851
20148,1,512,512,512.00,0.00,14850,14851
20149,2,475,37,256.00,47961.00,14850,14852
20150,1,512,512,512.00,0.00,14851,14852
20151,2,337,175,256.00,6561.00,14851,14853
20152,1,512,512,512.00,0.00,14852,14853
20153,1,512,512,512.00,0.00,14852,14853
20154,2,279,233,256.00,529.00,14852,14854
20155,2,472,40,256.00,46656.00,14853,14855
20156,1,512,512,512.00,0.00,14854,14855
20157,3,431,20,170.67,34166.89,14854,14857
20158,1,512,512,512.00,0.00,14856,14857
20159,1,512,512,512.00,0.00,14856,14857
20160,1,512,512,512.00,0.00,14856,14857
20161,1,512,512,512.00,0.00,14856,14857
20162,2,398,114,256.00,20164.00,14856,14858
20163,1,512,512,512.00,0.00,14857,14858
20164,1,512,512,512.00,0.00,14857,14858
20165,1,512,512,512.00,0.00,14857,14858
20166,1,512,512,512.00,0.00,14857,14858
20167,1,512,512,512.00,0.00,14857,14858
20168,5,142,12,102.40,2297.84,14857,14862
20169,1,512,512,512.00,0.00,14861,14862
20170,3,286,21,170.67,12293.56,14861,14864
20171,1,512,512,512.00,0.00,14863,14864
20172,1,512,512,512.00,0.00,14863,14864
20173,1,512,512,512.00,0.00,14863,14864
20174,3,431,40,170.67,33886.89,14863,14866
20175,1,512,512,512.00,0.00,14865,14866
20176,2,307,205,256.00,2601.00,14865,14867
20177,2,411,101,256.00,24025.00,14866,14868
20178,1,512,512,512.00,0.00,14867,14868
20179,1,512,512,512.00,0.00,14867,14868
20180,1,512,512,512.00,0.00,14867,14868
20181,1,512,512,512.00,0.00,14867,14868
20182,2,298,214,256.00,1764.00,14867,14869
20183,2,280,232,256.00,576.00,14868,14870
20184,1,512,512,512.00,0.00,14869,14870
20185,1,512,512,512.00,0.00,14869,14870
20186,2,347,165,256.00,8281.00,14869,14871
20187,4,234,6,128.00,7012.00,14870,14874
20188,2,392,120,256.00,18496.00,14873,14875
20189,3,476,18,170.67,46614.22,14874,14877
20190,1,512,512,512.00,0.00,14876,14877
20191,2,417,95,256.00,25921.00,14876,14878
20192,1,512,512,512.00,0.00,14877,14878
20193,1,512,512,512.00,0.00,14877,14878
20194,2,416,96,256.00,25600.00,14877,14879
20195,2,266,246,256.00,100.00,14878,14880
20196,1,512,512,512.00,0.00,14879,14880
20197,1,512,512,512.00,0.00,14879,14880
20198,2,430,82,256.00,30276.00,14879,14881
20199,1,512,512,512.00,0.00,14880,14881
20200,1,512,512,512.00,0.00,14880,14881
20201,2,496,16,256.00,57600.00,14880,14882
20202,1,512,512,512.00,0.00,14881,14882
20203,1,512,512,512.00,0.00,14881,14882
20204,2,304,208,256.00,2304.00,14881,14883
20205,2,302,210,256.00,2116.00,14882,14884
20206,1,512,512,512.00,0.00,14883,14884
20207,1,512,512,512.00,0.00,14883,14884
20208,1,512,512,512.00,0.00,14883,14884
20209,3,264,58,170.67,7259.56,14883,14886
20210,2,384,128,256.00,16384.00,14885,14887
20211,1,512,512,512.00,0.00,14886,14887
20212,3,266,8,170.67,13360.89,14886,14889
20213,1,512,512,512.00,0.00,14888,14889
20214,1,512,512,512.00,0.00,14888,14889
20215,1,512,512,512.00,0.00,14888,14889
20216,2,262,250,256.00,36.00,14888,14890
20217,1,512,512,512.00,0.00,14889,14890
20218,1,512,512,512.00,0.00,14889,14890
20219,1,512,512,512.00,0.00,14889,14890
20220,2,297,215,256.00,1681.00,14889,14891
20221,2,292,220,256.00,1296.00,14890,14892
20222,1,512,512,512.00,0.00,14891,14892
20223,2,461,51,256.00,42025.00,14891,14893
20224,1,512,512,512.00,0.00,14892,14893
20225,1,512,512,512.00,0.00,14892,14893
20226,1,512,512,512.00,0.00,14892,14893
20227,1,512,512,512.00,0.00,14892,14893
20228,1,512,512,512.00,0.00,14892,14893
20229,1,512,512,512.00,0.00,14892,14893
20230,2,458,54,256.00,40804.00,14892,14894
20231,2,391,121,256.00,18225.00,14893,14895
20232,1,512,512,512.00,0.00,14894,14895
20233,2,403,109,256.00,21609.00,14894,14896
20234,2,339,173,256.00,6889.00,14895,14897
20235,1,512,512,512.00,0.00,14896,14897
20236,1,512,512,512.00,0.00,14896,14897
20237,3,459,4,170.67,41905.56,14896,14899
20238,1,512,512,512.00,0.00,14898,14899
20239,2,482,30,256.00,51076.00,14898,14900
20240,1,512,512,512.00,0.00,14899,14900
20241,1,512,512,512.00,0.00,14899,14900
20242,1,512,512,512.00,0.00,14899,14900
20243,2,479,33,256.00,49729.00,14899,14901
20244,2,425,87,256.00,28561.00,14900,14902
20245,3,316,24,170.67,14211.56,14901,14904
20246,1,512,512,512.00,0.00,14903,14904
20247,2,275,237,256.00,361.00,14903,14905
20248,2,437,75,256.00,32761.00,14904,14906
20249,1,512,512,512.00,0.00,14905,14906
20250,1,512,512,512.00,0.00,14905,14906
20251,1,512,512,512.00,0.00,14905,14906
20252,1,512,512,512.00,0.00,14905,14906
20253,5,280,3,102.40,14385.84,14905,14910
20254,1,512,512,512.00,0.00,14909,14910
20255,2,357,155,256.00,10201.00,14909,14911
20256,2,316,196,256.00,3600.00,14910,14912
20257,1,512,512,512.00,0.00,14911,14912
20258,1,512,512,512.00,0.00,14911,14912
20259,1,512,512,512.00,0.00,14911,14912
20260,3,320,4,170.67,16792.89,14911,14914
20261,1,512,512,512.00,0.00,14913,14914
20262,4,453,4,128.00,35328.50,14913,14917
20263,1,512,512,512.00,0.00,14916,14917
20264,2,423,89,256.00,27889.00,14916,14918
20265,1,512,512,512.00,0.00,14917,14918
20266,1,512,512,512.00,0.00,14917,14918
20267,1,512,512,512.00,0.00,14917,14918
20268,2,496,16,256.00,57600.00,14917,14919
20269,1,512,512,512.00,0.00,14918,14919
20270,2,402,110,256.00,21316.00,14918,14920
20271,1,512,512,512.00,0.00,14919,14920
20272,3,306,39,170.67,11888.22,14919,14922
20273,2,272,240,256.00,256.00,14921,14923
20274,1,512,512,512.00,0.00,14922,14923
20275,2,349,163,256.00,8649.00,14922,14924
20276,1,512,512,512.00,0.00,14923,14924
20277,2,422,90,256.00,27556.00,14923,14925
20278,1,512,512,512.00,0.00,14924,14925
20279,1,512,512,512.00,0.00,14924,14925
20280,1,512,512,512.00,0.00,14924,14925
20281,1,512,512,512.00,0.00,14924,14925
20282,2,263,249,256.00,49.00,14924,14926
20283,1,512,512,512.00,0.00,14925,14926
20284,1,512,512,512.00,0.00,14925,14926
20285,2,388,124,256.00,17424.00,14925,14927
20286,1,512,512,512.00,0.00,14926,14927
20287,1,512,512,512.00,0.00,14926,14927
20288,2,283,229,256.00,729.00,14926,14928
20289,2,510,2,256.00,64516.00,14927,14929
20290,3,362,50,170.67,18720.89,14928,14931
20291,1,512,512,512.00,0.00,14930,14931
20292,1,512,512,512.00,0.00,14930,14931
20293,1,512,512,512.00,0.00,14930,14931
20294,2,433,79,256.00,31329.00,14930,14932
20295,4,183,58,128.00,2037.50,14931,14935
20296,1,512,512,512.00,0.00,14934,14935
20297,2,477,35,256.00,48841.00,14934,14936
20298,1,512,512,512.00,0.00,14935,14936
20299,1,512,512,512.00,0.00,14935,14936
20300,2,402,110,256.00,21316.00,14935,14937
20301,1,512,512,512.00,0.00,14936,14937
20302,1,512,512,512.00,0.00,14936,14937
20303,2,370,142,256.00,12996.00,14936,14938
20304,2,467,45,256.00,44521.00,14937,14939
20305,1,512,512,512.00,0.00,14938,14939
20306,2,347,165,256.00,8281.00,14938,14940
20307,1,512,512,512.00,0.00,14939,14940
20308,5,318,4,102.40,13253.04,14939,14944
20309,1,512,512,512.00,0.00,14943,14944
20310,2,453,59,256.00,38809.00,14943,14945
20311,1,512,512,512.00,0.00,14944,14945
20312,2,507,5,256.00,63001.00,14944,14946
20313,1,512,512,512.00,0.00,14945,14946
20314,1,512,512,512.00,0.00,14945,14946
20315,1,512,512,512.00,0.00,14945,14946
20316,1,512,512,512.00,0.00,14945,14946
20317,1,512,512,512.00,0.00,14945,14946
20318,4,394,33,128.00,23610.50,14945,14949
20319,3,399,26,170.67,26688.22,14948,14951
20320,1,512,512,512.00,0.00,14950,14951
20321,2,433,79,256.00,31329.00,14950,14952
20322,1,512,512,512.00,0.00,14951,14952
20323,1,512,512,512.00,0.00,14951,14952
20324,1,512,512,512.00,0.00,14951,14952
20325,1,512,512,512.00,0.00,14951,14952
20326,2,297,215,256.00,1681.00,14951,14953
20327,1,512,512,512.00,0.00,14952,14953
20328,1,512,512,512.00,0.00,14952,14953
20329,2,442,70,256.00,34596.00,14952,14954
20330,1,512,512,512.00,0.00,14953,14954
20331,2,436,76,256.00,32400.00,14953,14955
20332,1,512,512,512.00,0.00,14954,14955
20333,1,512,512,512.00,0.00,14954,14955
20334,1,512,512,512.00,0.00,14954,14955
20335,4,228,50,128.00,5539.50,14954,14958
20336,1,512,512,512.00,0.00,14957,14958
20337,2,430,82,256.00,30276.00,14957,14959
20338,2,368,144,256.00,12544.00,14958,14960
20339,1,512,512,512.00,0.00,14959,14960
20340,1,512,512,512.00,0.00,14959,14960
20341,2,466,46,256.00,44100.00,14959,14961
20342,2,428,84,256.00,29584.00,14960,14962
20343,4,400,5,128.00,26088.50,14961,14965
20344,2,360,152,256.00,10816.00,14964,14966
20345,1,512,512,512.00,0.00,14965,14966
20346,1,512,512,512.00,0.00,14965,14966
20347,3,290,1,170.67,15186.89,14965,14968
20348,1,512,512,512.00,0.00,14967,14968
20349,1,512,512,512.00,0.00,14967,14968
20350,1,512,512,512.00,0.00,14967,14968
20351,2,296,216,256.00,1600.00,14967,14969
20352,1,512,512,512.00,0.00,14968,14969
20353,1,512,512,512.00,0.00,14968,14969
20354,1,512,512,512.00,0.00,14968,14969
20355,1,512,512,512.00,0.00,14968,14969
20356,2,430,82,256.00,30276.00,14968,14970
20357,3,355,6,170.67,20493.56,14969,14972
20358,2,500,12,256.00,59536.00,14971,14973
20359,1,512,512,512.00,0.00,14972,14973
20360,3,323,11,170.67,16250.89,14972,14975
20361,1,512,512,512.00,0.00,14974,14975
20362,2,433,79,256.00,31329.00,14974,14976
20363,2,447,65,256.00,36481.00,14975,14977
20364,2,478,34,256.00,49284.00,14976,14978
20365,1,512,512,512.00,0.00,14977,14978
20366,2,278,234,256.00,484.00,14977,14979
20367,2,374,138,256.00,13924.00,14978,14980
20368,1,512,512,512.00,0.00,14979,14980
20369,1,512,512,512.00,0.00,14979,14980
20370,4,339,2,128.00,19005.50,14979,14983
20371,1,512,512,512.00,0.00,14982,14983
20372,1,512,512,512.00,0.00,14982,14983
20373,2,443,69,256.00,34969.00,14982,14984
20374,1,512,512,512.00,0.00,14983,14984
20375,1,512,512,512.00,0.00,14983,14984
20376,1,512,512,512.00,0.00,14983,14984
20377,3,302,21,170.67,13328.22,14983,14986
20378,1,512,512,512.00,0.00,14985,14986
20379,1,512,512,512.00,0.00,14985,14986
20380,1,512,512,512.00,0.00,14985,14986
20381,2,425,87,256.00,28561.00,14985,14987
20382,1,512,512,512.00,0.00,14986,14987
20383,2,321,191,256.00,4225.00,14986,14988
20384,1,512,512,512.00,0.00,14987,14988
20385,1,512,512,512.00,0.00,14987,14988
20386,3,337,6,170.67,18261.56,14987,14990
20387,1,512,512,512.00,0.00,14989,14990
20388,1,512,512,512.00,0.00,14989,14990
20389,2,488,24,256.00,53824.00,14989,14991
20390,3,484,3,170.67,49169.56,14990,14993
20391,1,512,512,512.00,0.00,14992,14993
20392,2,343,169,256.00,7569.00,14992,14994
20393,1,512,512,512.00,0.00,14993,14994
20394,3,351,6,170.67,19960.22,14993,14996
20395,1,512,512,512.00,0.00,14995,14996
20396,1,512,512,512.00,0.00,14995,14996
20397,2,335,177,256.00,6241.00,14995,14997
20398,1,512,512,512.00,0.00,14996,14997
20399,1,512,512,512.00,0.00,14996,14997
20400,1,512,512,512.00,0.00,14996,14997
20401,1,512,512,512.00,0.00,14996,14997
20402,2,284,228,256.00,784.00,14996,14998
20403,1,512,512,512.00,0.00,14997,14998
20404,1,512,512,512.00,0.00,14997,14998
20405,1,512,512,512.00,0.00,14997,14998
20406,3,469,6,170.67,44661.56,14997,15000
20407,1,512,512,512.00,0.00,14999,15000
20408,2,261,251,256.00,25.00,14999,15001
20409,1,512,512,512.00,0.00,15000,15001
20410,1,512,512,512.00,0.00,15000,15001
20411,1,512,512,512.00,0.00,15000,15001
20412,2,390,122,256.00,17956.00,15000,15002
20413,2,273,239,256.00,289.00,15001,15003
20414,1,512,512,512.00,0.00,15002,15003
20415,1,512,512,512.00,0.00,15002,15003
20416,4,293,33,128.00,10515.50,15002,15006
20417,1,512,512,512.00,0.00,15005,15006
20418,1,512,512,512.00,0.00,15005,15006
20419,1,512,512,512.00,0.00,15005,15006
20420,1,512,512,512.00,0.00,15005,15006
20421,2,358,154,256.00,10404.00,15005,15007
20422,1,512,512,512.00,0.00,15006,15007
20423,2,459,53,256.00,41209.00,15006,15008
20424,1,512,512,512.00,0.00,15007,15008
20425,2,262,250,256.00,36.00,15007,15009
20426,1,512,512,512.00,0.00,15008,15009
20427,1,512,512,512.00,0.00,15008,15009
20428,1,512,512,512.00,0.00,15008,15009
20429,1,512,512,512.00,0.00,15008,15009
20430,4,215,9,128.00,7421.00,15008,15012
20431,1,512,512,512.00,0.00,15011,15012
20432,1,512,512,512.00,0.00,15011,15012
20433,2,421,91,256.00,27225.00,15011,15013
20434,5,286,4,102.40,11819.44,15012,15017
20435,2,481,31,256.00,50625.00,15016,15018
20436,1,512,512,512.00,0.00,15017,15018
20437,3,420,30,170.67,31254.22,15017,15020
20438,1,512,512,512.00,0.00,15019,15020
20439,1,512,512,512.00,0.00,15019,15020
20440,2,315,197,256.00,3481.00,15019,15021
20441,1,512,512,512.00,0.00,15020,15021
20442,1,512,512,512.00,0.00,15020,15021
20443,2,348,164,256.00,8464.00,15020,15022
20444,2,399,113,256.00,20449.00,15021,15023
20445,1,512,512,512.00,0.00,15022,15023
20446,3,294,1,170.67,15381.56,15022,15025
20447,1,512,512,512.00,0.00,15024,15025
20448,3,267,118,170.67,4653.56,15024,15027
20449,1,512,512,512.00,0.00,15026,15027
20450,1,512,512,512.00,0.00,15026,15027
20451,3,427,17,170.67,33286.89,15026,15029
20452,1,512,512,512.00,0.00,15028,15029
20453,2,303,209,256.00,2209.00,15028,15030
20454,1,512,512,512.00,0.00,15029,15030
20455,3,451,14,170.67,39474.89,15029,15032
20456,1,512,512,512.00,0.00,15031,15032
20457,2,370,142,256.00,12996.00,15031,15033
20458,5,181,16,102.40,5425.84,15032,15037
20459,1,512,512,512.00,0.00,15036,15037
20460,1,512,512,512.00,0.00,15036,15037
20461,1,512,512,512.00,0.00,15036,15037
20462,2,382,130,256.00,15876.00,15036,15038
20463,2,413,99,256.00,24649.00,15037,15039
20464,1,512,512,512.00,0.00,15038,15039
20465,2,348,164,256.00,8464.00,15038,15040
20466,4,400,2,128.00,25394.00,15039,15043
20467,2,343,169,256.00,7569.00,15042,15044
20468,1,512,512,512.00,0.00,15043,15044
20469,1,512,512,512.00,0.00,15043,15044
20470,2,267,245,256.00,121.00,15043,15045
20471,1,512,512,512.00,0.00,15044,15045
20472,1,512,512,512.00,0.00,15044,15045
20473,1,512,512,512.00,0.00,15044,15045
20474,1,512,512,512.00,0.00,15044,15045
20475,2,496,16,256.00,57600.00,15044,15046
20476,1,512,512,512.00,0.00,15045,15046
20477,2,321,191,256.00,4225.00,15045,15047
20478,3,338,59,170.67,14522.89,15046,15049
20479,4,211,34,128.00,4612.50,15048,15052
20480,1,512,512,512.00,0.00,15051,15052
20481,1,512,512,512.00,0.00,15051,15052
20482,1,512,512,512.00,0.00,15051,15052
20483,2,506,6,256.00,62500.00,15051,15053
20484,1,512,512,512.00,0.00,15052,15053
20485,1,512,512,512.00,0.00,15052,15053
20486,1,512,512,512.00,0.00,15052,15053
20487,3,360,17,170.67,20244.22,15052,15055
20488,4,320,3,128.00,16029.50,15054,15058
20489,1,512,512,512.00,0.00,15057,15058
20490,2,505,7,256.00,62001.00,15057,15059
20491,1,512,512,512.00,0.00,15058,15059
20492,1,512,512,512.00,0.00,15058,15059
20493,2,392,120,256.00,18496.00,15058,15060
20494,1,512,512,512.00,0.00,15059,15060
20495,1,512,512,512.00,0.00,15059,15060
20496,1,512,512,512.00,0.00,15059,15060
20497,1,512,512,512.00,0.00,15059,15060
20498,2,257,255,256.00,1.00,15059,15061
20499,3,385,10,170.67,24877.56,15060,15063
20500,2,433,79,256.00,31329.00,15062,15064
20501,2,470,42,256.00,45796.00,15063,15065
20502,1,512,512,512.00,0.00,15064,15065
20503,1,512,512,512.00,0.00,15064,15065
20504,1,512,512,512.00,0.00,15064,15065
20505,1,512,512,512.00,0.00,15064,15065
20506,1,512,512,512.00,0.00,15064,15065
20507,3,349,45,170.67,16789.56,15064,15067
20508,2,359,153,256.00,10609.00,15066,15068
20509,1,512,512,512.00,0.00,15067,15068
20510,1,512,512,512.00,0.00,15067,15068
20511,2,443,69,256.00,34969.00,15067,15069
20512,1,512,512,512.00,0.00,15068,15069
20513,2,459,53,256.00,41209.00,15068,15070
20514,1,512,512,512.00,0.00,15069,15070
20515,1,512,512,512.00,0.00,15069,15070
20516,3,380,45,170.67,22204.22,15069,15072
20517,1,512,512,512.00,0.00,15071,15072
20518,3,349,57,170.67,16301.56,15071,15074
20519,1,512,512,512.00,0.00,15073,15074
20520,1,512,512,512.00,0.00,15073,15074
20521,3,302,38,170.67,11616.89,15073,15076
20522,1,512,512,512.00,0.00,15075,15076
20523,1,512,512,512.00,0.00,15075,15076
20524,2,433,79,256.00,31329.00,15075,15077
20525,2,325,187,256.00,4761.00,15076,15078
20526,1,512,512,512.00,0.00,15077,15078
20527,1,512,512,512.00,0.00,15077,15078
20528,2,285,227,256.00,841.00,15077,15079
20529,3,452,2,170.67,40096.89,15078,15081
20530,3,351,29,170.67,18028.22,15080,15083
20531,1,512,512,512.00,0.00,15082,15083
20532,1,512,512,512.00,0.00,15082,15083
20533,2,291,221,256.00,1225.00,15082,15084
20534,2,419,93,256.00,26569.00,15083,15085
20535,1,512,512,512.00,0.00,15084,15085
20536,1,512,512,512.00,0.00,15084,15085
20537,1,512,512,512.00,0.00,15084,15085
20538,1,512,512,512.00,0.00,15084,15085
20539,2,466,46,256.00,44100.00,15084,15086
20540,1,512,512,512.00,0.00,15085,15086
20541,3,356,9,170.67,20348.22,15085,15088
20542,1,512,512,512.00,0.00,15087,15088
20543,2,441,71,256.00,34225.00,15087,15089
20544,1,512,512,512.00,0.00,15088,15089
20545,3,294,76,170.67,8331.56,15088,15091
20546,1,512,512,512.00,0.00,15090,15091
20547,1,512,512,512.00,0.00,15090,15091
20548,2,316,196,256.00,3600.00,15090,15092
20549,1,512,512,512.00,0.00,15091,15092
20550,1,512,512,512.00,0.00,15091,15092
20551,6,224,10,85.33,4816.56,15091,15097
20552,1,512,512,512.00,0.00,15096,15097
20553,1,512,512,512.00,0.00,15096,15097
20554,1,512,512,512.00,0.00,15096,15097
20555,1,512,512,512.00,0.00,15096,15097
20556,1,512,512,512.00,0.00,15096,15097
20557,3,365,72,170.67,18884.22,15096,15099
20558,1,512,512,512.00,0.00,15098,15099
20559,1,512,512,512.00,0.00,15098,15099
20560,1,512,512,512.00,0.00,15098,15099
20561,1,512,512,512.00,0.00,15098,15099
20562,3,236,85,170.67,4006.89,15098,15101
20563,1,512,512,512.00,0.00,15100,15101
20564,1,512,512,512.00,0.00,15100,15101
20565,1,512,512,512.00,0.00,15100,15101
20566,2,482,30,256.00,51076.00,15100,15102
20567,1,512,512,512.00,0.00,15101,15102
20568,1,512,512,512.00,0.00,15101,15102
20569,2,454,58,256.00,39204.00,15101,15103
20570,1,512,512,512.00,0.00,15102,15103
20571,1,512,512,512.00,0.00,15102,15103
20572,2,431,81,256.00,30625.00,15102,15104
20573,1,512,512,512.00,0.00,15103,15104
20574,2,454,58,256.00,39204.00,15103,15105
20575,1,512,512,512.00,0.00,15104,15105
20576,2,310,202,256.00,2916.00,15104,15106
20577,3,295,1,170.67,15433.56,15105,15108
20578,2,423,89,256.00,27889.00,15107,15109
20579,1,512,512,512.00,0.00,15108,15109
20580,1,512,512,512.00,0.00,15108,15109
20581,1,512,512,512.00,0.00,15108,15109
20582,1,512,512,512.00,0.00,15108,15109
20583,2,473,39,256.00,47089.00,15108,15110
20584,1,512,512,512.00,0.00,15109,15110
20585,1,512,512,512.00,0.00,15109,15110
20586,2,389,123,256.00,17689.00,15109,15111
20587,1,512,512,512.00,0.00,15110,15111
20588,1,512,512,512.00,0.00,15110,15111
20589,2,465,47,256.00,43681.00,15110,15112
20590,5,427,3,102.40,26675.84,15111,15116
20591,1,512,512,512.00,0.00,15115,15116
20592,3,462,23,170.67,42440.22,15115,15118
20593,1,512,512,512.00,0.00,15117,15118
20594,1,512,512,512.00,0.00,15117,15118
20595,1,512,512,512.00,0.00,15117,15118
20596,1,512,512,512.00,0.00,15117,15118
20597,4,392,8,128.00,24338.00,15117,15121
20598,1,512,512,512.00,0.00,15120,15121
20599,3,227,66,170.67,5488.22,15120,15123
20600,1,512,512,512.00,0.00,15122,15123
20601,2,459,53,256.00,41209.00,15122,15124
20602,2,414,98,256.00,24964.00,15123,15125
20603,1,512,512,512.00,0.00,15124,15125
20604,1,512,512,512.00,0.00,15124,15125
20605,2,474,38,256.00,47524.00,15124,15126
20606,3,422,3,170.67,32760.22,15125,15128
20607,2,459,53,256.00,41209.00,15127,15129
20608,2,319,193,256.00,3969.00,15128,15130
20609,1,512,512,512.00,0.00,15129,15130
20610,1,512,512,512.00,0.00,15129,15130
20611,1,512,512,512.00,0.00,15129,15130
20612,2,268,244,256.00,144.00,15129,15131
20613,2,384,128,256.00,16384.00,15130,15132
20614,2,271,241,256.00,225.00,15131,15133
20615,1,512,512,512.00,0.00,15132,15133
20616,1,512,512,512.00,0.00,15132,15133
20617,3,222,92,170.67,3190.22,15132,15135
20618,1,512,512,512.00,0.00,15134,15135
20619,1,512,512,512.00,0.00,15134,15135
20620,1,512,512,512.00,0.00,15134,15135
20621,7,267,1,73.14,7798.98,15134,15141
20622,1,512,512,512.00,0.00,15140,15141
20623,2,396,116,256.00,19600.00,15140,15142
20624,2,451,61,256.00,38025.00,15141,15143
20625,2,268,244,256.00,144.00,15142,15144
20626,1,512,512,512.00,0.00,15143,15144
20627,3,226,80,170.67,4176.89,15143,15146
20628,2,284,228,256.00,784.00,15145,15147
20629,1,512,512,512.00,0.00,15146,15147
20630,1,512,512,512.00,0.00,15146,15147
20631,3,259,66,170.67,6341.56,15146,15149
20632,1,512,512,512.00,0.00,15148,15149
20633,1,512,512,512.00,0.00,15148,15149
20634,4,244,53,128.00,6108.50,15148,15152
20635,2,457,55,256.00,40401.00,15151,15153
20636,6,124,3,85.33,1608.89,15152,15158
20637,1,512,512,512.00,0.00,15157,15158
20638,3,267,13,170.67,12633.56,15157,15160
20639,1,512,512,512.00,0.00,15159,15160
20640,2,411,101,256.00,24025.00,15159,15161
20641,1,512,512,512.00,0.00,15160,15161
20642,1,512,512,512.00,0.00,15160,15161
20643,2,392,120,256.00,18496.00,15160,15162
20644,2,282,230,256.00,676.00,15161,15163
20645,2,394,118,256.00,19044.00,15162,15164
20646,1,512,512,512.00,0.00,15163,15164
20647,3,420,27,170.67,31324.22,15163,15166
20648,2,342,170,256.00,7396.00,15165,15167
20649,1,512,512,512.00,0.00,15166,15167
20650,3,502,5,170.67,54890.89,15166,15169
20651,1,512,512,512.00,0.00,15168,15169
20652,1,512,512,512.00,0.00,15168,15169
20653,1,512,512,512.00,0.00,15168,15169
20654,3,333,41,170.67,14744.22,15168,15171
20655,2,382,130,256.00,15876.00,15170,15172
20656,1,512,512,512.00,0.00,15171,15172
20657,2,340,172,256.00,7056.00,15171,15173
20658,1,512,512,512.00,0.00,15172,15173
20659,1,512,512,512.00,0.00,15172,15173
20660,1,512,512,512.00,0.00,15172,15173
20661,2,412,100,256.00,24336.00,15172,15174
20662,1,512,512,512.00,0.00,15173,15174
20663,1,512,512,512.00,0.00,15173,15174
20664,4,377,2,128.00,21570.50,15173,15177
20665,1,512,512,512.00,0.00,15176,15177
20666,1,512,512,512.00,0.00,15176,15177
20667,1,512,512,512.00,0.00,15176,15177
20668,1,512,512,512.00,0.00,15176,15177
20669,1,512,512,512.00,0.00,15176,15177
20670,3,273,9,170.67,13376.22,15176,15179
20671,1,512,512,512.00,0.00,15178,15179
20672,2,266,246,256.00,100.00,15178,15180
20673,1,512,512,512.00,0.00,15179,15180
20674,1,512,512,512.00,0.00,15179,15180
20675,4,228,43,128.00,4769.50,15179,15183
20676,1,512,512,512.00,0.00,15182,15183
20677,1,512,512,512.00,0.00,15182,15183
20678,2,281,231,256.00,625.00,15182,15184
20679,1,512,512,512.00,0.00,15183,15184
20680,2,494,18,256.00,56644.00,15183,15185
20681,1,512,512,512.00,0.00,15184,15185
20682,2,282,230,256.00,676.00,15184,15186
20683,2,353,159,256.00,9409.00,15185,15187
20684,1,512,512,512.00,0.00,15186,15187
20685,1,512,512,512.00,0.00,15186,15187
20686,4,228,5,128.00,7944.50,15186,15190
20687,1,512,512,512.00,0.00,15189,15190
20688,2,502,10,256.00,60516.00,15189,15191
20689,1,512,512,512.00,0.00,15190,15191
20690,3,464,5,170.67,43262.89,15190,15193
20691,1,512,512,512.00,0.00,15192,15193
20692,1,512,512,512.00,0.00,15192,15193
20693,2,326,186,256.00,4900.00,15192,15194
20694,1,512,512,512.00,0.00,15193,15194
20695,1,512,512,512.00,0.00,15193,15194
20696,2,340,172,256.00,7056.00,15193,15195
20697,2,292,220,256.00,1296.00,15194,15196
20698,1,512,512,512.00,0.00,15195,15196
20699,1,512,512,512.00,0.00,15195,15196
20700,3,432,20,170.67,34414.22,15195,15198
20701,2,270,242,256.00,196.00,15197,15199
20702,1,512,512,512.00,0.00,15198,15199
20703,1,512,512,512.00,0.00,15198,15199
20704,1,512,512,512.00,0.00,15198,15199
20705,2,448,64,256.00,36864.00,15198,15200
20706,1,512,512,512.00,0.00,15199,15200
20707,1,512,512,512.00,0.00,15199,15200
20708,4,344,6,128.00,18230.00,15199,15203
20709,1,512,512,512.00,0.00,15202,15203
20710,1,512,512,512.00,0.00,15202,15203
20711,1,512,512,512.00,0.00,15202,15203
20712,2,435,77,256.00,32041.00,15202,15204
20713,1,512,512,512.00,0.00,15203,15204
20714,1,512,512,512.00,0.00,15203,15204
20715,1,512,512,512.00,0.00,15203,15204
20716,1,512,512,512.00,0.00,15203,15204
20717,1,512,512,512.00,0.00,15203,15204
20718,2,443,69,256.00,34969.00,15203,15205
20719,3,347,60,170.67,15884.22,15204,15207
20720,1,512,512,512.00,0.00,15206,15207
20721,1,512,512,512.00,0.00,15206,15207
20722,1,512,512,512.00,0.00,15206,15207
20723,1,512,512,512.00,0.00,15206,15207
20724,5,203,2,102.40,5760.24,15206,15211
20725,1,512,512,512.00,0.00,15210,15211
20726,1,512,512,512.00,0.00,15210,15211
20727,1,512,512,512.00,0.00,15210,15211
20728,2,466,46,256.00,44100.00,15210,15212
20729,1,512,512,512.00,0.00,15211,15212
20730,1,512,512,512.00,0.00,15211,15212
20731,1,512,512,512.00,0.00,15211,15212
20732,1,512,512,512.00,0.00,15211,15212
20733,2,489,23,256.00,54289.00,15211,15213
20734,1,512,512,512.00,0.00,15212,15213
20735,1,512,512,512.00,0.00,15212,15213
20736,2,404,108,256.00,21904.00,15212,15214
20737,1,512,512,512.00,0.00,15213,15214
20738,2,381,131,256.00,15625.00,15213,15215
20739,1,512,512,512.00,0.00,15214,15215
20740,1,512,512,512.00,0.00,15214,15215
20741,1,512,512,512.00,0.00,15214,15215
20742,2,425,87,256.00,28561.00,15214,15216
20743,4,199,44,128.00,3541.50,15215,15219
20744,1,512,512,512.00,0.00,15218,15219
20745,2,295,217,256.00,1521.00,15218,15220
20746,1,512,512,512.00,0.00,15219,15220
20747,2,380,132,256.00,15376.00,15219,15221
20748,1,512,512,512.00,0.00,15220,15221
20749,1,512,512,512.00,0.00,15220,15221
20750,2,400,112,256.00,20736.00,15220,15222
20751,1,512,512,512.00,0.00,15221,15222
20752,5,388,2,102.40,20770.64,15221,15226
20753,1,512,512,512.00,0.00,15225,15226
20754,2,405,107,256.00,22201.00,15225,15227
20755,1,512,512,512.00,0.00,15226,15227
20756,3,363,37,170.67,19433.56,15226,15229
20757,1,512,512,512.00,0.00,15228,15229
20758,1,512,512,512.00,0.00,15228,15229
20759,1,512,512,512.00,0.00,15228,15229
20760,3,430,22,170.67,33867.56,15228,15231
20761,1,512,512,512.00,0.00,15230,15231
20762,1,512,512,512.00,0.00,15230,15231
20763,1,512,512,512.00,0.00,15230,15231
20764,2,325,187,256.00,4761.00,15230,15232
20765,1,512,512,512.00,0.00,15231,15232
20766,1,512,512,512.00,0.00,15231,15232
20767,1,512,512,512.00,0.00,15231,15232
20768,2,443,69,256.00,34969.00,15231,15233
20769,1,512,512,512.00,0.00,15232,15233
20770,1,512,512,512.00,0.00,15232,15233
20771,2,477,35,256.00,48841.00,15232,15234
20772,1,512,512,512.00,0.00,15233,15234
20773,1,512,512,512.00,0.00,15233,15234
20774,2,420,92,256.00,26896.00,15233,15235
20775,1,512,512,512.00,0.00,15234,15235
20776,1,512,512,512.00,0.00,15234,15235
20777,2,329,183,256.00,5329.00,15234,15236
20778,1,512,512,512.00,0.00,15235,15236
20779,1,512,512,512.00,0.00,15235,15236
20780,1,512,512,512.00,0.00,15235,15236
20781,1,512,512,512.00,0.00,15235,15236
20782,1,512,512,512.00,0.00,15235,15236
20783,1,512,512,512.00,0.00,15235,15236
20784,1,512,512,512.00,0.00,15235,15236
20785,1,512,512,512.00,0.00,15235,15236
20786,1,512,512,512.00,0.00,15235,15236
20787,4,276,29,128.00,8236.50,15235,15239
20788,3,332,21,170.67,16188.22,15238,15241
20789,3,469,17,170.67,44514.89,15240,15243
20790,2,291,221,256.00,1225.00,15242,15244
20791,1,512,512,512.00,0.00,15243,15244
20792,1,512,512,512.00,0.00,15243,15244
20793,1,512,512,512.00,0.00,15243,15244
20794,1,512,512,512.00,0.00,15243,15244
20795,2,499,13,256.00,59049.00,15243,15245
20796,1,512,512,512.00,0.00,15244,15245
20797,3,298,11,170.67,14250.89,15244,15247
20798,1,512,512,512.00,0.00,15246,15247
20799,2,334,178,256.00,6084.00,15246,15248
20800,1,512,512,512.00,0.00,15247,15248
20801,1,512,512,512.00,0.00,15247,15248
20802,1,512,512,512.00,0.00,15247,15248
20803,1,512,512,512.00,0.00,15247,15248
20804,2,461,51,256.00,42025.00,15247,15249
20805,1,512,512,512.00,0.00,15248,15249
20806,1,512,512,512.00,0.00,15248,15249
20807,1,512,512,512.00,0.00,15248,15249
20808,5,309,3,102.40,15212.64,15248,15253
20809,1,512,512,512.00,0.00,15252,15253
20810,3,498,6,170.67,53574.22,15252,15255
20811,2,501,11,256.00,60025.00,15254,15256
20812,1,512,512,512.00,0.00,15255,15256
20813,1,512,512,512.00,0.00,15255,15256
20814,4,298,1,128.00,12523.50,15255,15259
20815,2,372,140,256.00,13456.00,15258,15260
20816,2,304,208,256.00,2304.00,15259,15261
20817,3,232,89,170.67,3614.89,15260,15263
20818,1,512,512,512.00,0.00,15262,15263
20819,1,512,512,512.00,0.00,15262,15263
20820,1,512,512,512.00,0.00,15262,15263
20821,1,512,512,512.00,0.00,15262,15263
20822,1,512,512,512.00,0.00,15262,15263
20823,2,363,149,256.00,11449.00,15262,15264
20824,1,512,512,512.00,0.00,15263,15264
20825,1,512,512,512.00,0.00,15263,15264
20826,3,304,12,170.67,14531.56,15263,15266
20827,1,512,512,512.00,0.00,15265,15266
20828,1,512,512,512.00,0.00,15265,15266
20829,2,258,254,256.00,4.00,15265,15267
20830,1,512,512,512.00,0.00,15266,15267
20831,2,439,73,256.00,33489.00,15266,15268
20832,1,512,512,512.00,0.00,15267,15268
20833,1,512,512,512.00,0.00,15267,15268
20834,1,512,512,512.00,0.00,15267,15268
20835,4,321,29,128.00,13925.00,15267,15271
20836,1,512,512,512.00,0.00,15270,15271
20837,2,345,167,256.00,7921.00,15270,15272
20838,1,512,512,512.00,0.00,15271,15272
20839,3,422,40,170.67,31600.89,15271,15274
20840,1,512,512,512.00,0.00,15273,15274
20841,1,512,512,512.00,0.00,15273,15274
20842,5,258,5,102.40,13189.84,15273,15278
20843,1,512,512,512.00,0.00,15277,15278
20844,1,512,512,512.00,0.00,15277,15278
20845,3,309,23,170.67,13676.22,15277,15280
20846,1,512,512,512.00,0.00,15279,15280
20847,3,277,64,170.67,7561.56,15279,15282
20848,1,512,512,512.00,0.00,15281,15282
20849,1,512,512,512.00,0.00,15281,15282
20850,2,329,183,256.00,5329.00,15281,15283
20851,1,512,512,512.00,0.00,15282,15283
20852,2,485,27,256.00,52441.00,15282,15284
20853,3,291,2,170.67,15088.22,15283,15286
20854,2,461,51,256.00,42025.00,15285,15287
20855,1,512,512,512.00,0.00,15286,15287
20856,1,512,512,512.00,0.00,15286,15287
20857,1,512,512,512.00,0.00,15286,15287
20858,2,321,191,256.00,4225.00,15286,15288
20859,1,512,512,512.00,0.00,15287,15288
20860,3,392,32,170.67,25016.89,15287,15290
20861,1,512,512,512.00,0.00,15289,15290
20862,2,394,118,256.00,19044.00,15289,15291
20863,1,512,512,512.00,0.00,15290,15291
20864,3,363,49,170.67,18929.56,15290,15293
20865,1,512,512,512.00,0.00,15292,15293
20866,1,512,512,512.00,0.00,15292,15293
20867,2,360,152,256.00,10816.00,15292,15294
20868,3,281,108,170.67,6124.22,15293,15296
20869,3,440,12,170.67,36654.22,15295,15298
20870,2,291,221,256.00,1225.00,15297,15299
20871,1,512,512,512.00,0.00,15298,15299
20872,1,512,512,512.00,0.00,15298,15299
20873,3,304,13,170.67,14409.56,15298,15301
20874,2,466,46,256.00,44100.00,15300,15302
20875,1,512,512,512.00,0.00,15301,15302
20876,2,430,82,256.00,30276.00,15301,15303
20877,4,331,27,128.00,14953.00,15302,15306
20878,5,261,2,102.40,14115.44,15305,15310
20879,2,499,13,256.00,59049.00,15309,15311
20880,2,494,18,256.00,56644.00,15310,15312
20881,1,512,512,512.00,0.00,15311,15312
20882,2,363,149,256.00,11449.00,15311,15313
20883,1,512,512,512.00,0.00,15312,15313
20884,2,315,197,256.00,3481.00,15312,15314
20885,1,512,512,512.00,0.00,15313,15314
20886,1,512,512,512.00,0.00,15313,15314
20887,1,512,512,512.00,0.00,15313,15314
20888,1,512,512,512.00,0.00,15313,15314
20889,4,337,11,128.00,16858.50,15313,15317
20890,1,512,512,512.00,0.00,15316,15317
20891,1,512,512,512.00,0.00,15316,15317
20892,4,226,5,128.00,8091.50,15316,15320
20893,1,512,512,512.00,0.00,15319,15320
20894,3,267,88,170.67,5433.56,15319,15322
20895,5,430,1,102.40,27712.24,15322,15327
20896,1,512,512,512.00,0.00,15326,15327
20897,1,512,512,512.00,0.00,15326,15327
20898,4,346,4,128.00,19642.00,15326,15330
20899,2,482,30,256.00,51076.00,15329,15331
20900,4,307,31,128.00,12127.50,15330,15334
20901,3,256,3,170.67,14057.56,15333,15336
20902,1,512,512,512.00,0.00,15335,15336
20903,2,303,209,256.00,2209.00,15335,15337
20904,1,512,512,512.00,0.00,15336,15337
20905,1,512,512,512.00,0.00,15336,15337
20906,1,512,512,512.00,0.00,15336,15337
20907,2,424,88,256.00,28224.00,15336,15338
20908,1,512,512,512.00,0.00,15337,15338
20909,3,299,3,170.67,15376.22,15337,15340
20910,1,512,512,512.00,0.00,15339,15340
20911,1,512,512,512.00,0.00,15339,15340
20912,1,512,512,512.00,0.00,15339,15340
20913,1,512,512,512.00,0.00,15339,15340
20914,1,512,512,512.00,0.00,15339,15340
20915,2,385,127,256.00,16641.00,15339,15341
20916,2,427,85,256.00,29241.00,15340,15342
20917,1,512,512,512.00,0.00,15341,15342
20918,3,289,19,170.67,12705.56,15341,15344
20919,2,411,101,256.00,24025.00,15343,15345
20920,3,362,21,170.67,20248.22,15344,15347
20921,1,512,512,512.00,0.00,15346,15347
20922,1,512,512,512.00,0.00,15346,15347
20923,1,512,512,512.00,0.00,15346,15347
20924,2,311,201,256.00,3025.00,15346,15348
20925,1,512,512,512.00,0.00,15347,15348
20926,1,512,512,512.00,0.00,15347,15348
20927,1,512,512,512.00,0.00,15347,15348
20928,2,364,148,256.00,11664.00,15347,15349
20929,1,512,512,512.00,0.00,15348,15349
20930,1,512,512,512.00,0.00,15348,15349
20931,1,512,512,512.00,0.00,15348,15349
20932,4,247,38,128.00,7048.50,15348,15352
20933,1,512,512,512.00,0.00,15351,15352
20934,1,512,512,512.00,0.00,15351,15352
20935,1,512,512,512.00,0.00,15351,15352
20936,1,512,512,512.00,0.00,15351,15352
20937,1,512,512,512.00,0.00,15351,15352
20938,4,366,3,128.00,19853.50,15351,15355
20939,1,512,512,512.00,0.00,15354,15355
20940,2,313,199,256.00,3249.00,15354,15356
20941,3,375,14,170.67,22856.22,15355,15358
20942,1,512,512,512.00,0.00,15357,15358
20943,2,340,172,256.00,7056.00,15357,15359
20944,2,433,79,256.00,31329.00,15358,15360
20945,1,512,512,512.00,0.00,15359,15360
20946,2,343,169,256.00,7569.00,15359,15361
20947,1,512,512,512.00,0.00,15360,15361
20948,6,298,3,85.33,10624.56,15360,15366
20949,1,512,512,512.00,0.00,15365,15366
20950,1,512,512,512.00,0.00,15365,15366
20951,1,512,512,512.00,0.00,15365,15366
20952,1,512,512,512.00,0.00,15365,15366
20953,2,364,148,256.00,11664.00,15365,15367
20954,1,512,512,512.00,0.00,15366,15367
20955,5,425,2,102.40,26619.44,15366,15371
20956,1,512,512,512.00,0.00,15370,15371
20957,1,512,512,512.00,0.00,15370,15371
20958,4,301,17,128.00,11621.00,15370,15374
20959,1,512,512,512.00,0.00,15373,15374
20960,2,332,180,256.00,5776.00,15373,15375
20961,1,512,512,512.00,0.00,15374,15375
20962,1,512,512,512.00,0.00,15374,15375
20963,1,512,512,512.00,0.00,15374,15375
20964,1,512,512,512.00,0.00,15374,15375
20965,3,430,2,170.67,34640.89,15374,15377
20966,1,512,512,512.00,0.00,15376,15377
20967,2,270,242,256.00,196.00,15376,15378
20968,1,512,512,512.00,0.00,15377,15378
20969,1,512,512,512.00,0.00,15377,15378
20970,2,362,150,256.00,11236.00,15377,15379
20971,1,512,512,512.00,0.00,15378,15379
20972,1,512,512,512.00,0.00,15378,15379
20973,1,512,512,512.00,0.00,15378,15379
20974,3,368,4,170.67,22552.89,15378,15381
20975,1,512,512,512.00,0.00,15380,15381
20976,2,270,242,256.00,196.00,15380,15382
20977,2,329,183,256.00,5329.00,15381,15383
20978,1,512,512,512.00,0.00,15382,15383
20979,3,338,20,170.67,16992.89,15382,15385
20980,1,512,512,512.00,0.00,15384,15385
20981,2,449,63,256.00,37249.00,15384,15386
20982,2,509,3,256.00,64009.00,15385,15387
20983,1,512,512,512.00,0.00,15386,15387
20984,2,479,33,256.00,49729.00,15386,15388
20985,3,282,48,170.67,9190.22,15387,15390
20986,2,383,129,256.00,16129.00,15389,15391
20987,1,512,512,512.00,0.00,15390,15391
20988,2,351,161,256.00,9025.00,15390,15392
20989,1,512,512,512.00,0.00,15391,15392
20990,3,376,19,170.67,22681.56,15391,15394
20991,1,512,512,512.00,0.00,15393,15394
20992,2,466,46,256.00,44100.00,15393,15395
20993,1,512,512,512.00,0.00,15394,15395
20994,1,512,512,512.00,0.00,15394,15395
20995,1,512,512,512.00,0.00,15394,15395
20996,1,512,512,512.00,0.00,15394,15395
20997,2,256,256,256.00,0.00,15394,15396
20998,1,512,512,512.00,0.00,15395,15396
20999,5,157,7,102.40,3056.64,15395,15400
21000,1,512,512,512.00,0.00,15399,15400
21001,3,267,36,170.67,9628.22,15399,15402
21002,1,512,512,512.00,0.00,15401,15402
21003,1,512,512,512.00,0.00,15401,15402
21004,1,512,512,512.00,0.00,15401,15402
21005,2,324,188,256.00,4624.00,15401,15403
21006,1,512,512,512.00,0.00,15402,15403
21007,2,282,230,256.00,676.00,15402,15404
21008,3,362,36,170.67,19318.22,15403,15406
21009,1,512,512,512.00,0.00,15405,15406
21010,1,512,512,512.00,0.00,15405,15406
21011,2,370,142,256.00,12996.00,15405,15407
21012,2,347,165,256.00,8281.00,15406,15408
21013,2,436,76,256.00,32400.00,15407,15409
21014,1,512,512,512.00,0.00,15408,15409
21015,1,512,512,512.00,0.00,15408,15409
21016,2,277,235,256.00,441.00,15408,15410
21017,2,305,207,256.00,2401.00,15409,15411
21018,3,322,71,170.67,11834.89,15410,15413
21019,5,156,2,102.40,2847.44,15412,15417
21020,1,512,512,512.00,0.00,15416,15417
21021,1,512,512,512.00,0.00,15416,15417
21022,1,512,512,512.00,0.00,15416,15417
21023,1,512,512,512.00,0.00,15416,15417
21024,2,496,16,256.00,57600.00,15416,15418
21025,1,512,512,512.00,0.00,15417,15418
21026,2,458,54,256.00,40804.00,15417,15419
21027,1,512,512,512.00,0.00,15418,15419
21028,1,512,512,512.00,0.00,15418,15419
21029,1,512,512,512.00,0.00,15418,15419
21030,2,271,241,256.00,225.00,15418,15420
21031,1,512,512,512.00,0.00,15419,15420
21032,3,403,32,170.67,27326.89,15419,15422
21033,1,512,512,512.00,0.00,15421,15422
21034,1,512,512,512.00,0.00,15421,15422
21035,1,512,512,512.00,0.00,15421,15422
21036,2,345,167,256.00,7921.00,15421,15423
21037,1,512,512,512.00,0.00,15422,15423
21038,3,484,7,170.67,49121.56,15422,15425
21039,1,512,512,512.00,0.00,15424,15425
21040,1,512,512,512.00,0.00,15424,15425
21041,1,512,512,512.00,0.00,15424,15425
21042,2,495,17,256.00,57121.00,15424,15426
21043,1,512,512,512.00,0.00,15425,15426
21044,1,512,512,512.00,0.00,15425,15426
21045,2,415,97,256.00,25281.00,15425,15427
21046,3,487,8,170.67,50046.89,15426,15429
21047,4,464,4,128.00,37726.50,15428,15432
21048,1,512,512,512.00,0.00,15431,15432
21049,1,512,512,512.00,0.00,15431,15432
21050,2,309,203,256.00,2809.00,15431,15433
21051,1,512,512,512.00,0.00,15432,15433
21052,1,512,512,512.00,0.00,15432,15433
21053,1,512,512,512.00,0.00,15432,15433
21054,3,367,58,170.67,19413.56,15432,15435
21055,1,512,512,512.00,0.00,15434,15435
21056,1,512,512,512.00,0.00,15434,15435
21057,1,512,512,512.00,0.00,15434,15435
21058,1,512,512,512.00,0.00,15434,15435
21059,2,489,23,256.00,54289.00,15434,15436
21060,1,512,512,512.00,0.00,15435,15436
21061,1,512,512,512.00,0.00,15435,15436
21062,1,512,512,512.00,0.00,15435,15436
21063,1,512,512,512.00,0.00,15435,15436
21064,2,322,190,256.00,4356.00,15435,15437
21065,1,512,512,512.00,0.00,15436,15437
21066,1,512,512,512.00,0.00,15436,15437
21067,1,512,512,512.00,0.00,15436,15437
21068,1,512,512,512.00,0.00,15436,15437
21069,1,512,512,512.00,0.00,15436,15437
21070,7,144,9,73.14,1628.69,15436,15443
21071,1,512,512,512.00,0.00,15442,15443
21072,3,272,106,170.67,5264.89,15442,15445
21073,3,354,65,170.67,16936.22,15444,15447
21074,2,284,228,256.00,784.00,15446,15448
21075,1,512,512,512.00,0.00,15447,15448
21076,2,370,142,256.00,12996.00,15447,15449
21077,3,453,3,170.67,40324.22,15448,15451
21078,1,512,512,512.00,0.00,15450,15451
21079,3,348,68,170.67,15854.22,15450,15453
21080,3,277,23,170.67,11606.89,15452,15455
21081,3,388,55,170.67,23649.56,15454,15457
21082,2,367,145,256.00,12321.00,15456,15458
21083,1,512,512,512.00,0.00,15457,15458
21084,1,512,512,512.00,0.00,15457,15458
21085,2,480,32,256.00,50176.00,15457,15459
21086,1,512,512,512.00,0.00,15458,15459
21087,1,512,512,512.00,0.00,15458,15459
21088,1,512,512,512.00,0.00,15458,15459
21089,1,512,512,512.00,0.00,15458,15459
21090,3,436,2,170.67,36064.89,15458,15461
21091,1,512,512,512.00,0.00,15460,15461
21092,3,218,130,170.67,1312.89,15460,15463
21093,1,512,512,512.00,0.00,15462,15463
21094,2,439,73,256.00,33489.00,15462,15464
21095,1,512,512,512.00,0.00,15463,15464
21096,2,423,89,256.00,27889.00,15463,15465
21097,1,512,512,512.00,0.00,15464,15465
21098,1,512,512,512.00,0.00,15464,15465
21099,1,512,512,512.00,0.00,15464,15465
21100,1,512,512,512.00,0.00,15464,15465
21101,1,512,512,512.00,0.00,15464,15465
21102,2,417,95,256.00,25921.00,15464,15466
21103,2,300,212,256.00,1936.00,15465,15467
21104,2,327,185,256.00,5041.00,15466,15468
21105,1,512,512,512.00,0.00,15467,15468
21106,1,512,512,512.00,0.00,15467,15468
21107,2,369,143,256.00,12769.00,15467,15469
21108,1,512,512,512.00,0.00,15468,15469
21109,1,512,512,512.00,0.00,15468,15469
21110,2,426,86,256.00,28900.00,15468,15470
21111,2,378,134,256.00,14884.00,15469,15471
21112,2,444,68,256.00,35344.00,15470,15472
21113,2,296,216,256.00,1600.00,15471,15473
21114,2,485,27,256.00,52441.00,15472,15474
21115,1,512,512,512.00,0.00,15473,15474
21116,1,512,512,512.00,0.00,15473,15474
21117,1,512,512,512.00,0.00,15473,15474
21118,2,278,234,256.00,484.00,15473,15475
21119,1,512,512,512.00,0.00,15474,15475
21120,1,512,512,512.00,0.00,15474,15475
21121,2,260,252,256.00,16.00,15474,15476
21122,1,512,512,512.00,0.00,15475,15476
21123,1,512,512,512.00,0.00,15475,15476
21124,4,404,28,128.00,25418.00,15475,15479
21125,6,166,5,85.33,3525.22,15478,15484
21126,1,512,512,512.00,0.00,15483,15484
21127,2,429,83,256.00,29929.00,15483,15485
21128,1,512,512,512.00,0.00,15484,15485
21129,3,337,1,170.67,18821.56,15484,15487
21130,2,337,175,256.00,6561.00,15486,15488
21131,1,512,512,512.00,0.00,15487,15488
21132,2,372,140,256.00,13456.00,15487,15489
21133,2,461,51,256.00,42025.00,15488,15490
21134,1,512,512,512.00,0.00,15489,15490
21135,4,326,1,128.00,16608.50,15489,15493
21136,1,512,512,512.00,0.00,15492,15493
21137,2,405,107,256.00,22201.00,15492,15494
21138,1,512,512,512.00,0.00,15493,15494
21139,2,508,4,256.00,63504.00,15493,15495
21140,3,285,15,170.67,13004.22,15494,15497
21141,1,512,512,512.00,0.00,15496,15497
21142,1,512,512,512.00,0.00,15496,15497
21143,2,450,62,256.00,37636.00,15496,15498
21144,1,512,512,512.00,0.00,15497,15498
21145,1,512,512,512.00,0.00,15497,15498
21146,1,512,512,512.00,0.00,15497,15498
21147,1,512,512,512.00,0.00,15497,15498
21148,3,335,85,170.67,13510.89,15497,15500
21149,1,512,512,512.00,0.00,15499,15500
21150,2,365,147,256.00,11881.00,15499,15501
21151,1,512,512,512.00,0.00,15500,15501
21152,2,337,175,256.00,6561.00,15500,15502
21153,1,512,512,512.00,0.00,15501,15502
21154,3,479,3,170.67,47656.22,15501,15504
21155,1,512,512,512.00,0.00,15503,15504
21156,1,512,512,512.00,0.00,15503,15504
21157,1,512,512,512.00,0.00,15503,15504
21158,1,512,512,512.00,0.00,15503,15504
21159,5,163,51,102.40,2453.04,15503,15508
21160,2,360,152,256.00,10816.00,15507,15509
21161,1,512,512,512.00,0.00,15508,15509
21162,1,512,512,512.00,0.00,15508,15509
21163,1,512,512,512.00,0.00,15508,15509
21164,1,512,512,512.00,0.00,15508,15509
21165,2,343,169,256.00,7569.00,15508,15510
21166,1,512,512,512.00,0.00,15509,15510
21167,1,512,512,512.00,0.00,15509,15510
21168,1,512,512,512.00,0.00,15509,15510
21169,1,512,512,512.00,0.00,15509,15510
21170,3,402,2,170.67,28630.22,15509,15512
21171,1,512,512,512.00,0.00,15511,15512
21172,1,512,512,512.00,0.00,15511,15512
21173,1,512,512,512.00,0.00,15511,15512
21174,2,406,106,256.00,22500.00,15511,15513
21175,3,434,5,170.67,35442.89,15512,15515
21176,1,512,512,512.00,0.00,15514,15515
21177,1,512,512,512.00,0.00,15514,15515
21178,1,512,512,512.00,0.00,15514,15515
21179,1,512,512,512.00,0.00,15514,15515
21180,3,328,71,170.67,12670.89,15514,15517
21181,1,512,512,512.00,0.00,15516,15517
21182,2,274,238,256.00,324.00,15516,15518
21183,1,512,512,512.00,0.00,15517,15518
21184,3,250,53,170.67,7202.89,15517,15520
21185,1,512,512,512.00,0.00,15519,15520
21186,2,471,41,256.00,46225.00,15519,15521
21187,1,512,512,512.00,0.00,15520,15521
21188,3,314,81,170.67,10488.22,15520,15523
21189,3,241,56,170.67,6686.89,15522,15525
21190,1,512,512,512.00,0.00,15524,15525
21191,2,510,2,256.00,64516.00,15524,15526
21192,1,512,512,512.00,0.00,15525,15526
21193,1,512,512,512.00,0.00,15525,15526
21194,2,283,229,256.00,729.00,15525,15527
21195,1,512,512,512.00,0.00,15526,15527
21196,2,337,175,256.00,6561.00,15526,15528
21197,1,512,512,512.00,0.00,15527,15528
21198,1,512,512,512.00,0.00,15527,15528
21199,1,512,512,512.00,0.00,15527,15528
21200,1,512,512,512.00,0.00,15527,15528
21201,1,512,512,512.00,0.00,15527,15528
21202,2,391,121,256.00,18225.00,15527,15529
21203,3,253,44,170.67,8262.89,15528,15531
21204,6,410,4,85.33,21344.56,15530,15536
21205,1,512,512,512.00,0.00,15535,15536
21206,1,512,512,512.00,0.00,15535,15536
21207,2,270,242,256.00,196.00,15535,15537
21208,2,414,98,256.00,24964.00,15536,15538
21209,3,330,13,170.67,16749.56,15537,15540
21210,1,512,512,512.00,0.00,15539,15540
21211,1,512,512,512.00,0.00,15539,15540
21212,1,512,512,512.00,0.00,15539,15540
21213,2,405,107,256.00,22201.00,15539,15541
21214,1,512,512,512.00,0.00,15540,15541
21215,3,257,83,170.67,5046.89,15540,15543
21216,1,512,512,512.00,0.00,15542,15543
21217,1,512,512,512.00,0.00,15542,15543
21218,2,301,211,256.00,2025.00,15542,15544
21219,2,266,246,256.00,100.00,15543,15545
21220,1,512,512,512.00,0.00,15544,15545
21221,1,512,512,512.00,0.00,15544,15545
21222,1,512,512,512.00,0.00,15544,15545
21223,2,500,12,256.00,59536.00,15544,15546
21224,1,512,512,512.00,0.00,15545,15546
21225,1,512,512,512.00,0.00,15545,15546
21226,3,437,2,170.67,36306.89,15545,15548
21227,4,400,8,128.00,25632.00,15547,15551
21228,1,512,512,512.00,0.00,15550,15551
21229,3,212,111,170.67,1868.22,15550,15553
21230,1,512,512,512.00,0.00,15552,15553
21231,2,349,163,256.00,8649.00,15552,15554
21232,1,512,512,512.00,0.00,15553,15554
21233,4,307,1,128.00,14972.50,15553,15557
21234,1,512,512,512.00,0.00,15556,15557
21235,1,512,512,512.00,0.00,15556,15557
21236,2,323,189,256.00,4489.00,15556,15558
21237,1,512,512,512.00,0.00,15557,15558
21238,1,512,512,512.00,0.00,15557,15558
21239,2,372,140,256.00,13456.00,15557,15559
21240,1,512,512,512.00,0.00,15558,15559
21241,1,512,512,512.00,0.00,15558,15559
21242,1,512,512,512.00,0.00,15558,15559
21243,2,461,51,256.00,42025.00,15558,15560
21244,1,512,512,512.00,0.00,15559,15560
21245,2,310,202,256.00,2916.00,15559,15561
21246,2,402,110,256.00,21316.00,15560,15562
21247,1,512,512,512.00,0.00,15561,15562
21248,2,421,91,256.00,27225.00,15561,15563
21249,1,512,512,512.00,0.00,15562,15563
21250,4,444,20,128.00,33288.50,15562,15566
21251,1,512,512,512.00,0.00,15565,15566
21252,1,512,512,512.00,0.00,15565,15566
21253,2,443,69,256.00,34969.00,15565,15567
21254,1,512,512,512.00,0.00,15566,15567
21255,3,356,5,170.67,20726.89,15566,15569
21256,1,512,512,512.00,0.00,15568,15569
21257,3,238,43,170.67,8157.56,15568,15571
21258,2,333,179,256.00,5929.00,15570,15572
21259,1,512,512,512.00,0.00,15571,15572
21260,1,512,512,512.00,0.00,15571,15572
21261,2,413,99,256.00,24649.00,15571,15573
21262,1,512,512,512.00,0.00,15572,15573
21263,1,512,512,512.00,0.00,15572,15573
21264,1,512,512,512.00,0.00,15572,15573
21265,3,396,29,170.67,25948.22,15572,15575
21266,1,512,512,512.00,0.00,15574,15575
21267,2,363,149,256.00,11449.00,15574,15576
21268,5,321,5,102.40,15391.04,15575,15580
21269,2,362,150,256.00,11236.00,15579,15581
21270,1,512,512,512.00,0.00,15580,15581
21271,3,318,43,170.67,12797.56,15580,15583
21272,1,512,512,512.00,0.00,15582,15583
21273,1,512,512,512.00,0.00,15582,15583
21274,1,512,512,512.00,0.00,15582,15583
21275,1,512,512,512.00,0.00,15582,15583
21276,4,352,3,128.00,18000.50,15582,15586
21277,4,272,4,128.00,11000.00,15585,15589
21278,2,388,124,256.00,17424.00,15588,15590
21279,1,512,512,512.00,0.00,15589,15590
21280,3,292,76,170.67,8131.56,15589,15592
21281,1,512,512,512.00,0.00,15591,15592
21282,1,512,512,512.00,0.00,15591,15592
21283,2,383,129,256.00,16129.00,15591,15593
21284,1,512,512,512.00,0.00,15592,15593
21285,1,512,512,512.00,0.00,15592,15593
21286,2,285,227,256.00,841.00,15592,15594
21287,2,348,164,256.00,8464.00,15593,15595
21288,1,512,512,512.00,0.00,15594,15595
21289,1,512,512,512.00,0.00,15594,15595
21290,1,512,512,512.00,0.00,15594,15595
21291,1,512,512,512.00,0.00,15594,15595
21292,4,369,5,128.00,21195.00,15594,15598
21293,3,323,16,170.67,15710.89,15597,15600
21294,1,512,512,512.00,0.00,15599,15600
21295,1,512,512,512.00,0.00,15599,15600
21296,1,512,512,512.00,0.00,15599,15600
21297,2,495,17,256.00,57121.00,15599,15601
21298,2,385,127,256.00,16641.00,15600,15602
21299,2,339,173,256.00,6889.00,15601,15603
21300,1,512,512,512.00,0.00,15602,15603
21301,1,512,512,512.00,0.00,15602,15603
21302,2,341,171,256.00,7225.00,15602,15604
21303,2,487,25,256.00,53361.00,15603,15605
21304,1,512,512,512.00,0.00,15604,15605
21305,4,297,5,128.00,11551.50,15604,15608
21306,3,408,2,170.67,29830.22,15607,15610
21307,1,512,512,512.00,0.00,15609,15610
21308,1,512,512,512.00,0.00,15609,15610
21309,1,512,512,512.00,0.00,15609,15610
21310,2,410,102,256.00,23716.00,15609,15611
21311,1,512,512,512.00,0.00,15610,15611
21312,2,404,108,256.00,21904.00,15610,15612
21313,2,441,71,256.00,34225.00,15611,15613
21314,2,349,163,256.00,8649.00,15612,15614
21315,1,512,512,512.00,0.00,15613,15614
21316,1,512,512,512.00,0.00,15613,15614
21317,1,512,512,512.00,0.00,15613,15614
21318,1,512,512,512.00,0.00,15613,15614
21319,2,332,180,256.00,5776.00,15613,15615
21320,1,512,512,512.00,0.00,15614,15615
21321,1,512,512,512.00,0.00,15614,15615
21322,2,319,193,256.00,3969.00,15614,15616
21323,1,512,512,512.00,0.00,15615,15616
21324,1,512,512,512.00,0.00,15615,15616
21325,1,512,512,512.00,0.00,15615,15616
21326,2,402,110,256.00,21316.00,15615,15617
21327,1,512,512,512.00,0.00,15616,15617
21328,1,512,512,512.00,0.00,15616,15617
21329,1,512,512,512.00,0.00,15616,15617
21330,1,512,512,512.00,0.00,15616,15617
21331,1,512,512,512.00,0.00,15616,15617
21332,2,475,37,256.00,47961.00,15616,15618
21333,2,488,24,256.00,53824.00,15617,15619
21334,1,512,512,512.00,0.00,15618,15619
21335,1,512,512,512.00,0.00,15618,15619
21336,2,392,120,256.00,18496.00,15618,15620
21337,5,387,3,102.40,21591.04,15619,15624
21338,3,462,8,170.67,42630.22,15623,15626
21339,2,502,10,256.00,60516.00,15625,15627
21340,2,345,167,256.00,7921.00,15626,15628
21341,1,512,512,512.00,0.00,15627,15628
21342,1,512,512,512.00,0.00,15627,15628
21343,1,512,512,512.00,0.00,15627,15628
21344,1,512,512,512.00,0.00,15627,15628
21345,3,268,2,170.67,14336.89,15627,15630
21346,1,512,512,512.00,0.00,15629,15630
21347,4,389,10,128.00,23070.50,15629,15633
21348,2,430,82,256.00,30276.00,15632,15634
21349,1,512,512,512.00,0.00,15633,15634
21350,3,273,94,170.67,5669.56,15633,15636
21351,2,464,48,256.00,43264.00,15635,15637
21352,1,512,512,512.00,0.00,15636,15637
21353,1,512,512,512.00,0.00,15636,15637
21354,1,512,512,512.00,0.00,15636,15637
21355,3,339,67,170.67,14421.56,15636,15639
21356,2,471,41,256.00,46225.00,15638,15640
21357,1,512,512,512.00,0.00,15639,15640
21358,1,512,512,512.00,0.00,15639,15640
21359,2,287,225,256.00,961.00,15639,15641
21360,1,512,512,512.00,0.00,15640,15641
21361,1,512,512,512.00,0.00,15640,15641
21362,3,272,85,170.67,5950.89,15640,15643
21363,1,512,512,512.00,0.00,15642,15643
21364,2,314,198,256.00,3364.00,15642,15644
21365,1,512,512,512.00,0.00,15643,15644
21366,2,501,11,256.00,60025.00,15643,15645
21367,1,512,512,512.00,0.00,15644,15645
21368,1,512,512,512.00,0.00,15644,15645
21369,1,512,512,512.00,0.00,15644,15645
21370,1,512,512,512.00,0.00,15644,15645
21371,2,367,145,256.00,12321.00,15644,15646
21372,3,283,5,170.67,14302.89,15645,15648
21373,1,512,512,512.00,0.00,15647,15648
21374,3,347,34,170.67,17114.89,15647,15650
21375,2,323,189,256.00,4489.00,15649,15651
21376,1,512,512,512.00,0.00,15650,15651
21377,1,512,512,512.00,0.00,15650,15651
21378,1,512,512,512.00,0.00,15650,15651
21379,2,268,244,256.00,144.00,15650,15652
21380,1,512,512,512.00,0.00,15651,15652
21381,1,512,512,512.00,0.00,15651,15652
21382,4,265,39,128.00,7760.50,15651,15655
21383,1,512,512,512.00,0.00,15654,15655
21384,2,489,23,256.00,54289.00,15654,15656
21385,1,512,512,512.00,0.00,15655,15656
21386,3,484,9,170.67,49105.56,15655,15658
21387,1,512,512,512.00,0.00,15657,15658
21388,1,512,512,512.00,0.00,15657,15658
21389,2,343,169,256.00,7569.00,15657,15659
21390,1,512,512,512.00,0.00,15658,15659
21391,2,278,234,256.00,484.00,15658,15660
21392,1,512,512,512.00,0.00,15659,15660
21393,2,349,163,256.00,8649.00,15659,15661
21394,1,512,512,512.00,0.00,15660,15661
21395,1,512,512,512.00,0.00,15660,15661
21396,2,277,235,256.00,441.00,15660,15662
21397,1,512,512,512.00,0.00,15661,15662
21398,1,512,512,512.00,0.00,15661,15662
21399,2,482,30,256.00,51076.00,15661,15663
21400,2,276,236,256.00,400.00,15662,15664
21401,2,442,70,256.00,34596.00,15663,15665
21402,1,512,512,512.00,0.00,15664,15665
21403,1,512,512,512.00,0.00,15664,15665
21404,2,463,49,256.00,42849.00,15664,15666
21405,1,512,512,512.00,0.00,15665,15666
21406,1,512,512,512.00,0.00,15665,15666
21407,2,315,197,256.00,3481.00,15665,15667
21408,1,512,512,512.00,0.00,15666,15667
21409,1,512,512,512.00,0.00,15666,15667
21410,1,512,512,512.00,0.00,15666,15667
21411,1,512,512,512.00,0.00,15666,15667
21412,2,428,84,256.00,29584.00,15666,15668
21413,3,234,131,170.67,2048.22,15667,15670
21414,3,375,19,170.67,22509.56,15669,15672
21415,1,512,512,512.00,0.00,15671,15672
21416,1,512,512,512.00,0.00,15671,15672
21417,2,490,22,256.00,54756.00,15671,15673
21418,1,512,512,512.00,0.00,15672,15673
21419,1,512,512,512.00,0.00,15672,15673
21420,3,354,65,170.67,16936.22,15672,15675
21421,2,303,209,256.00,2209.00,15674,15676
21422,1,512,512,512.00,0.00,15675,15676
21423,1,512,512,512.00,0.00,15675,15676
21424,1,512,512,512.00,0.00,15675,15676
21425,1,512,512,512.00,0.00,15675,15676
21426,3,462,1,170.67,42821.56,15675,15678
21427,1,512,512,512.00,0.00,15677,15678
21428,1,512,512,512.00,0.00,15677,15678
21429,3,382,9,170.67,24421.56,15677,15680
21430,2,413,99,256.00,24649.00,15679,15681
21431,1,512,512,512.00,0.00,15680,15681
21432,2,329,183,256.00,5329.00,15680,15682
21433,1,512,512,512.00,0.00,15681,15682
21434,3,267,16,170.67,12201.56,15681,15684
21435,1,512,512,512.00,0.00,15683,15684
21436,1,512,512,512.00,0.00,15683,15684
21437,1,512,512,512.00,0.00,15683,15684
21438,5,213,3,102.40,6775.84,15683,15688
21439,1,512,512,512.00,0.00,15687,15688
21440,1,512,512,512.00,0.00,15687,15688
21441,3,245,49,170.67,7522.89,15687,15690
21442,1,512,512,512.00,0.00,15689,15690
21443,1,512,512,512.00,0.00,15689,15690
21444,3,483,5,170.67,48836.22,15689,15692
21445,1,512,512,512.00,0.00,15691,15692
21446,1,512,512,512.00,0.00,15691,15692
21447,1,512,512,512.00,0.00,15691,15692
21448,1,512,512,512.00,0.00,15691,15692
21449,4,490,1,128.00,43697.50,15691,15695
21450,1,512,512,512.00,0.00,15694,15695
21451,4,219,16,128.00,7676.50,15694,15698
21452,2,509,3,256.00,64009.00,15697,15699
21453,1,512,512,512.00,0.00,15698,15699
21454,2,405,107,256.00,22201.00,15698,15700
21455,1,512,512,512.00,0.00,15699,15700
21456,1,512,512,512.00,0.00,15699,15700
21457,2,376,136,256.00,14400.00,15699,15701
21458,2,286,226,256.00,900.00,15700,15702
21459,1,512,512,512.00,0.00,15701,15702
21460,2,321,191,256.00,4225.00,15701,15703
21461,1,512,512,512.00,0.00,15702,15703
21462,1,512,512,512.00,0.00,15702,15703
21463,1,512,512,512.00,0.00,15702,15703
21464,1,512,512,512.00,0.00,15702,15703
21465,1,512,512,512.00,0.00,15702,15703
21466,1,512,512,512.00,0.00,15702,15703
21467,1,512,512,512.00,0.00,15702,15703
21468,5,190,5,102.40,5854.64,15702,15707
21469,1,512,512,512.00,0.00,15706,15707
21470,1,512,512,512.00,0.00,15706,15707
21471,1,512,512,512.00,0.00,15706,15707
21472,1,512,512,512.00,0.00,15706,15707
21473,2,341,171,256.00,7225.00,15706,15708
21474,2,441,71,256.00,34225.00,15707,15709
21475,1,512,512,512.00,0.00,15708,15709
21476,4,479,1,128.00,41122.50,15708,15712
21477,1,512,512,512.00,0.00,15711,15712
21478,1,512,512,512.00,0.00,15711,15712
21479,3,482,1,170.67,48594.89,15711,15714
21480,1,512,512,512.00,0.00,15713,15714
21481,4,379,1,128.00,21712.50,15713,15717
21482,1,512,512,512.00,0.00,15716,15717
21483,2,418,94,256.00,26244.00,15716,15718
21484,3,367,13,170.67,21633.56,15717,15720
21485,1,512,512,512.00,0.00,15719,15720
21486,1,512,512,512.00,0.00,15719,15720
21487,2,353,159,256.00,9409.00,15719,15721
21488,1,512,512,512.00,0.00,15720,15721
21489,1,512,512,512.00,0.00,15720,15721
21490,1,512,512,512.00,0.00,15720,15721
21491,1,512,512,512.00,0.00,15720,15721
21492,1,512,512,512.00,0.00,15720,15721
21493,1,512,512,512.00,0.00,15720,15721
21494,2,467,45,256.00,44521.00,15720,15722
21495,2,366,146,256.00,12100.00,15721,15723
21496,1,512,512,512.00,0.00,15722,15723
21497,5,345,2,102.40,15248.24,15722,15727
21498,1,512,512,512.00,0.00,15726,15727
21499,2,304,208,256.00,2304.00,15726,15728
21500,1,512,512,512.00,0.00,15727,15728
21501,4,304,10,128.00,12095.50,15727,15731
21502,4,399,5,128.00,25392.50,15730,15734
21503,1,512,512,512.00,0.00,15733,15734
21504,1,512,512,512.00,0.00,15733,15734
21505,1,512,512,512.00,0.00,15733,15734
21506,2,411,101,256.00,24025.00,15733,15735
21507,1,512,512,512.00,0.00,15734,15735
21508,1,512,512,512.00,0.00,15734,15735
21509,1,512,512,512.00,0.00,15734,15735
21510,6,193,28,85.33,2981.89,15734,15740
21511,1,512,512,512.00,0.00,15739,15740
21512,2,428,84,256.00,29584.00,15739,15741
21513,4,465,2,128.00,38079.50,15740,15744
21514,1,512,512,512.00,0.00,15743,15744
21515,2,471,41,256.00,46225.00,15743,15745
21516,1,512,512,512.00,0.00,15744,15745
21517,1,512,512,512.00,0.00,15744,15745
21518,1,512,512,512.00,0.00,15744,15745
21519,1,512,512,512.00,0.00,15744,15745
21520,2,319,193,256.00,3969.00,15744,15746
21521,1,512,512,512.00,0.00,15745,15746
21522,1,512,512,512.00,0.00,15745,15746
21523,3,288,1,170.67,15097.56,15745,15748
21524,2,456,56,256.00,40000.00,15747,15749
21525,6,215,5,85.33,4954.22,15748,15754
21526,1,512,512,512.00,0.00,15753,15754
21527,1,512,512,512.00,0.00,15753,15754
21528,1,512,512,512.00,0.00,15753,15754
21529,1,512,512,512.00,0.00,15753,15754
21530,2,366,146,256.00,12100.00,15753,15755
21531,1,512,512,512.00,0.00,15754,15755
21532,2,293,219,256.00,1369.00,15754,15756
21533,1,512,512,512.00,0.00,15755,15756
21534,1,512,512,512.00,0.00,15755,15756
21535,2,456,56,256.00,40000.00,15755,15757
21536,1,512,512,512.00,0.00,15756,15757
21537,2,479,33,256.00,49729.00,15756,15758
21538,1,512,512,512.00,0.00,15757,15758
21539,1,512,512,512.00,0.00,15757,15758
21540,1,512,512,512.00,0.00,15757,15758
21541,1,512,512,512.00,0.00,15757,15758
21542,2,295,217,256.00,1521.00,15757,15759
21543,1,512,512,512.00,0.00,15758,15759
21544,1,512,512,512.00,0.00,15758,15759
21545,2,495,17,256.00,57121.00,15758,15760
21546,5,287,11,102.40,11163.84,15759,15764
21547,1,512,512,512.00,0.00,15763,15764
21548,1,512,512,512.00,0.00,15763,15764
21549,5,459,4,102.40,31857.04,15763,15768
21550,1,512,512,512.00,0.00,15767,15768
21551,1,512,512,512.00,0.00,15767,15768
21552,1,512,512,512.00,0.00,15767,15768
21553,2,362,150,256.00,11236.00,15767,15769
21554,1,512,512,512.00,0.00,15768,15769
21555,2,308,204,256.00,2704.00,15768,15770
21556,1,512,512,512.00,0.00,15769,15770
21557,1,512,512,512.00,0.00,15769,15770
21558,1,512,512,512.00,0.00,15769,15770
21559,2,489,23,256.00,54289.00,15769,15771
21560,1,512,512,512.00,0.00,15770,15771
21561,3,380,1,170.67,24726.89,15770,15773
21562,1,512,512,512.00,0.00,15772,15773
21563,2,450,62,256.00,37636.00,15772,15774
21564,2,333,179,256.00,5929.00,15773,15775
21565,2,262,250,256.00,36.00,15774,15776
21566,1,512,512,512.00,0.00,15775,15776
21567,1,512,512,512.00,0.00,15775,15776
21568,2,477,35,256.00,48841.00,15775,15777
21569,2,262,250,256.00,36.00,15776,15778
21570,1,512,512,512.00,0.00,15777,15778
21571,1,512,512,512.00,0.00,15777,15778
21572,1,512,512,512.00,0.00,15777,15778
21573,1,512,512,512.00,0.00,15777,15778
21574,1,512,512,512.00,0.00,15777,15778
21575,4,322,35,128.00,12901.50,15777,15781
21576,2,452,60,256.00,38416.00,15780,15782
21577,3,252,120,170.67,3374.22,15781,15784
21578,2,299,213,256.00,1849.00,15783,15785
21579,2,466,46,256.00,44100.00,15784,15786
21580,1,512,512,512.00,0.00,15785,15786
21581,1,512,512,512.00,0.00,15785,15786
21582,1,512,512,512.00,0.00,15785,15786
21583,2,504,8,256.00,61504.00,15785,15787
21584,2,485,27,256.00,52441.00,15786,15788
21585,4,372,38,128.00,19923.50,15787,15791
21586,1,512,512,512.00,0.00,15790,15791
21587,1,512,512,512.00,0.00,15790,15791
21588,1,512,512,512.00,0.00,15790,15791
21589,5,263,9,102.40,7941.44,15790,15795
21590,1,512,512,512.00,0.00,15794,15795
21591,1,512,512,512.00,0.00,15794,15795
21592,2,273,239,256.00,289.00,15794,15796
21593,1,512,512,512.00,0.00,15795,15796
21594,1,512,512,512.00,0.00,15795,15796
21595,1,512,512,512.00,0.00,15795,15796
21596,1,512,512,512.00,0.00,15795,15796
21597,1,512,512,512.00,0.00,15795,15796
21598,5,300,9,102.40,10544.24,15795,15800
21599,2,267,245,256.00,121.00,15799,15801
21600,1,512,512,512.00,0.00,15800,15801
21601,1,512,512,512.00,0.00,15800,15801
21602,1,512,512,512.00,0.00,15800,15801
21603,2,336,176,256.00,6400.00,15800,15802
21604,1,512,512,512.00,0.00,15801,15802
21605,1,512,512,512.00,0.00,15801,15802
21606,2,393,119,256.00,18769.00,15801,15803
21607,3,418,28,170.67,30827.56,15802,15805
21608,1,512,512,512.00,0.00,15804,15805
21609,2,488,24,256.00,53824.00,15804,15806
21610,1,512,512,512.00,0.00,15805,15806
21611,2,374,138,256.00,13924.00,15805,15807
21612,1,512,512,512.00,0.00,15806,15807
21613,2,360,152,256.00,10816.00,15806,15808
21614,1,512,512,512.00,0.00,15807,15808
21615,1,512,512,512.00,0.00,15807,15808
21616,1,512,512,512.00,0.00,15807,15808
21617,3,250,48,170.67,7739.56,15807,15810
21618,3,196,145,170.67,433.56,15809,15812
21619,1,512,512,512.00,0.00,15811,15812
21620,1,512,512,512.00,0.00,15811,15812
21621,3,404,31,170.67,27574.89,15811,15814
21622,1,512,512,512.00,0.00,15813,15814
21623,1,512,512,512.00,0.00,15813,15814
21624,2,490,22,256.00,54756.00,15813,15815
21625,1,512,512,512.00,0.00,15814,15815
21626,5,375,4,102.40,19004.24,15814,15819
21627,2,317,195,256.00,3721.00,15818,15820
21628,3,276,42,170.67,9398.22,15819,15822
21629,2,392,120,256.00,18496.00,15821,15823
21630,1,512,512,512.00,0.00,15822,15823
21631,4,252,4,128.00,10652.50,15822,15826
21632,1,512,512,512.00,0.00,15825,15826
21633,1,512,512,512.00,0.00,15825,15826
21634,2,351,161,256.00,9025.00,15825,15827
21635,3,282,111,170.67,6208.22,15826,15829
21636,6,200,2,85.33,5126.22,15828,15834
21637,3,246,89,170.67,4128.22,15833,15836
21638,1,512,512,512.00,0.00,15835,15836
21639,1,512,512,512.00,0.00,15835,15836
21640,2,382,130,256.00,15876.00,15835,15837
21641,1,512,512,512.00,0.00,15836,15837
21642,2,319,193,256.00,3969.00,15836,15838
21643,1,512,512,512.00,0.00,15837,15838
21644,1,512,512,512.00,0.00,15837,15838
21645,1,512,512,512.00,0.00,15837,15838
21646,2,318,194,256.00,3844.00,15837,15839
21647,1,512,512,512.00,0.00,15838,15839
21648,1,512,512,512.00,0.00,15838,15839
21649,2,306,206,256.00,2500.00,15838,15840
21650,1,512,512,512.00,0.00,15839,15840
21651,1,512,512,512.00,0.00,15839,15840
21652,3,208,107,170.67,2046.89,15839,15842
21653,1,512,512,512.00,0.00,15841,15842
21654,2,290,222,256.00,1156.00,15841,15843
21655,1,512,512,512.00,0.00,15842,15843
21656,1,512,512,512.00,0.00,15842,15843
21657,3,406,27,170.67,28141.56,15842,15845
21658,4,471,1,128.00,39374.50,15844,15848
21659,2,477,35,256.00,48841.00,15847,15849
21660,1,512,512,512.00,0.00,15848,15849
21661,3,352,31,170.67,18041.56,15848,15851
21662,1,512,512,512.00,0.00,15850,15851
21663,2,331,181,256.00,5625.00,15850,15852
21664,3,330,76,170.67,12843.56,15851,15854
21665,1,512,512,512.00,0.00,15853,15854
21666,3,259,5,170.67,13742.89,15853,15856
21667,2,276,236,256.00,400.00,15855,15857
21668,1,512,512,512.00,0.00,15856,15857
21669,3,481,1,170.67,48293.56,15856,15859
21670,2,380,132,256.00,15376.00,15858,15860
21671,1,512,512,512.00,0.00,15859,15860
21672,1,512,512,512.00,0.00,15859,15860
21673,2,391,121,256.00,18225.00,15859,15861
21674,2,430,82,256.00,30276.00,15860,15862
21675,3,390,51,170.67,24120.22,15861,15864
21676,2,501,11,256.00,60025.00,15863,15865
21677,1,512,512,512.00,0.00,15864,15865
21678,1,512,512,512.00,0.00,15864,15865
21679,2,440,72,256.00,33856.00,15864,15866
21680,1,512,512,512.00,0.00,15865,15866
21681,1,512,512,512.00,0.00,15865,15866
21682,2,323,189,256.00,4489.00,15865,15867
21683,1,512,512,512.00,0.00,15866,15867
21684,1,512,512,512.00,0.00,15866,15867
21685,1,512,512,512.00,0.00,15866,15867
21686,1,512,512,512.00,0.00,15866,15867
21687,2,287,225,256.00,961.00,15866,15868
21688,2,393,119,256.00,18769.00,15867,15869
21689,1,512,512,512.00,0.00,15868,15869
21690,6,238,3,85.33,6520.89,15868,15874
21691,1,512,512,512.00,0.00,15873,15874
21692,1,512,512,512.00,0.00,15873,15874
21693,2,473,39,256.00,47089.00,15873,15875
21694,1,512,512,512.00,0.00,15874,15875
21695,1,512,512,512.00,0.00,15874,15875
21696,1,512,512,512.00,0.00,15874,15875
21697,2,442,70,256.00,34596.00,15874,15876
21698,3,338,3,170.67,18704.22,15875,15878
21699,1,512,512,512.00,0.00,15877,15878
21700,1,512,512,512.00,0.00,15877,15878
21701,2,476,36,256.00,48400.00,15877,15879
21702,3,261,69,170.67,6208.22,15878,15881
21703,1,512,512,512.00,0.00,15880,15881
21704,1,512,512,512.00,0.00,15880,15881
21705,2,263,249,256.00,49.00,15880,15882
21706,1,512,512,512.00,0.00,15881,15882
21707,2,410,102,256.00,23716.00,15881,15883
21708,5,350,3,102.40,16222.64,15882,15887
21709,1,512,512,512.00,0.00,15886,15887
21710,2,465,47,256.00,43681.00,15886,15888
21711,2,277,235,256.00,441.00,15887,15889
21712,1,512,512,512.00,0.00,15888,15889
21713,1,512,512,512.00,0.00,15888,15889
21714,1,512,512,512.00,0.00,15888,15889
21715,1,512,512,512.00,0.00,15888,15889
21716,1,512,512,512.00,0.00,15888,15889
21717,2,479,33,256.00,49729.00,15888,15890
21718,1,512,512,512.00,0.00,15889,15890
21719,2,310,202,256.00,2916.00,15889,15891
21720,1,512,512,512.00,0.00,15890,15891
21721,1,512,512,512.00,0.00,15890,15891
21722,1,512,512,512.00,0.00,15890,15891
21723,1,512,512,512.00,0.00,15890,15891
21724,2,471,41,256.00,46225.00,15890,15892
21725,1,512,512,512.00,0.00,15891,15892
21726,1,512,512,512.00,0.00,15891,15892
21727,1,512,512,512.00,0.00,15891,15892
21728,2,419,93,256.00,26569.00,15891,15893
21729,1,512,512,512.00,0.00,15892,15893
21730,1,512,512,512.00,0.00,15892,15893
21731,1,512,512,512.00,0.00,15892,15893
21732,1,512,512,512.00,0.00,15892,15893
21733,2,366,146,256.00,12100.00,15892,15894
21734,1,512,512,512.00,0.00,15893,15894
21735,1,512,512,512.00,0.00,15893,15894
21736,1,512,512,512.00,0.00,15893,15894
21737,1,512,512,512.00,0.00,15893,15894
21738,3,286,58,170.67,8667.56,15893,15896
21739,1,512,512,512.00,0.00,15895,15896
21740,1,512,512,512.00,0.00,15895,15896
21741,1,512,512,512.00,0.00,15895,15896
21742,1,512,512,512.00,0.00,15895,15896
21743,2,489,23,256.00,54289.00,15895,15897
21744,1,512,512,512.00,0.00,15896,15897
21745,1,512,512,512.00,0.00,15896,15897
21746,1,512,512,512.00,0.00,15896,15897
21747,1,512,512,512.00,0.00,15896,15897
21748,1,512,512,512.00,0.00,15896,15897
21749,6,251,4,85.33,6116.56,15896,15902
21750,3,370,3,170.67,22949.56,15901,15904
21751,1,512,512,512.00,0.00,15903,15904
21752,3,293,79,170.67,8102.89,15903,15906
21753,1,512,512,512.00,0.00,15905,15906
21754,1,512,512,512.00,0.00,15905,15906
21755,1,512,512,512.00,0.00,15905,15906
21756,1,512,512,512.00,0.00,15905,15906
21757,2,426,86,256.00,28900.00,15905,15907
21758,4,318,8,128.00,13365.50,15906,15910
21759,2,461,51,256.00,42025.00,15909,15911
21760,2,362,150,256.00,11236.00,15910,15912
21761,1,512,512,512.00,0.00,15911,15912
21762,3,383,2,170.67,25146.89,15911,15914
21763,1,512,512,512.00,0.00,15913,15914
21764,2,370,142,256.00,12996.00,15913,15915
21765,2,432,80,256.00,30976.00,15914,15916
21766,1,512,512,512.00,0.00,15915,15916
21767,2,413,99,256.00,24649.00,15915,15917
21768,1,512,512,512.00,0.00,15916,15917
21769,1,512,512,512.00,0.00,15916,15917
21770,4,329,26,128.00,14062.50,15916,15920
21771,6,249,3,85.33,9939.89,15919,15925
21772,3,316,18,170.67,14827.56,15924,15927
21773,3,278,47,170.67,9026.89,15926,15929
21774,1,512,512,512.00,0.00,15928,15929
21775,2,275,237,256.00,361.00,15928,15930
21776,1,512,512,512.00,0.00,15929,15930
21777,2,452,60,256.00,38416.00,15929,15931
21778,4,246,6,128.00,9448.50,15930,15934
21779,1,512,512,512.00,0.00,15933,15934
21780,1,512,512,512.00,0.00,15933,15934
21781,1,512,512,512.00,0.00,15933,15934
21782,2,463,49,256.00,42849.00,15933,15935
21783,1,512,512,512.00,0.00,15934,15935
21784,1,512,512,512.00,0.00,15934,15935
21785,1,512,512,512.00,0.00,15934,15935
21786,1,512,512,512.00,0.00,15934,15935
21787,2,358,154,256.00,10404.00,15934,15936
21788,1,512,512,512.00,0.00,15935,15936
21789,2,487,25,256.00,53361.00,15935,15937
21790,4,205,38,128.00,4194.50,15936,15940
21791,2,362,150,256.00,11236.00,15939,15941
21792,1,512,512,512.00,0.00,15940,15941
21793,2,441,71,256.00,34225.00,15940,15942
21794,1,512,512,512.00,0.00,15941,15942
21795,1,512,512,512.00,0.00,15941,15942
21796,2,456,56,256.00,40000.00,15941,15943
21797,1,512,512,512.00,0.00,15942,15943
21798,1,512,512,512.00,0.00,15942,15943
21799,2,414,98,256.00,24964.00,15942,15944
21800,1,512,512,512.00,0.00,15943,15944
21801,3,446,9,170.67,38288.22,15943,15946
21802,1,512,512,512.00,0.00,15945,15946
21803,2,331,181,256.00,5625.00,15945,15947
21804,1,512,512,512.00,0.00,15946,15947
21805,1,512,512,512.00,0.00,15946,15947
21806,2,336,176,256.00,6400.00,15946,15948
21807,1,512,512,512.00,0.00,15947,15948
21808,1,512,512,512.00,0.00,15947,15948
21809,3,260,74,170.67,5792.89,15947,15950
21810,2,444,68,256.00,35344.00,15949,15951
21811,1,512,512,512.00,0.00,15950,15951
21812,4,260,2,128.00,8750.00,15950,15954
21813,1,512,512,512.00,0.00,15953,15954
21814,1,512,512,512.00,0.00,15953,15954
21815,1,512,512,512.00,0.00,15953,15954
21816,2,401,111,256.00,21025.00,15953,15955
21817,2,289,223,256.00,1089.00,15954,15956
21818,2,331,181,256.00,5625.00,15955,15957
21819,1,512,512,512.00,0.00,15956,15957
21820,1,512,512,512.00,0.00,15956,15957
21821,1,512,512,512.00,0.00,15956,15957
21822,2,325,187,256.00,4761.00,15956,15958
21823,1,512,512,512.00,0.00,15957,15958
21824,1,512,512,512.00,0.00,15957,15958
21825,1,512,512,512.00,0.00,15957,15958
21826,2,425,87,256.00,28561.00,15957,15959
21827,1,512,512,512.00,0.00,15958,15959
21828,1,512,512,512.00,0.00,15958,15959
21829,1,512,512,512.00,0.00,15958,15959
21830,1,512,512,512.00,0.00,15958,15959
21831,1,512,512,512.00,0.00,15958,15959
21832,2,459,53,256.00,41209.00,15958,15960
21833,1,512,512,512.00,0.00,15959,15960
21834,1,512,512,512.00,0.00,15959,15960
21835,2,445,67,256.00,35721.00,15959,15961
21836,1,512,512,512.00,0.00,15960,15961
21837,2,287,225,256.00,961.00,15960,15962
21838,1,512,512,512.00,0.00,15961,15962
21839,1,512,512,512.00,0.00,15961,15962
21840,2,369,143,256.00,12769.00,15961,15963
21841,1,512,512,512.00,0.00,15962,15963
21842,2,444,68,256.00,35344.00,15962,15964
21843,1,512,512,512.00,0.00,15963,15964
21844,3,477,2,170.67,47080.22,15963,15966
21845,1,512,512,512.00,0.00,15965,15966
21846,2,289,223,256.00,1089.00,15965,15967
21847,1,512,512,512.00,0.00,15966,15967
21848,2,285,227,256.00,841.00,15966,15968
21849,1,512,512,512.00,0.00,15967,15968
21850,3,236,86,170.67,3936.89,15967,15970
21851,2,293,219,256.00,1369.00,15969,15971
21852,1,512,512,512.00,0.00,15970,15971
21853,1,512,512,512.00,0.00,15970,15971
21854,2,333,179,256.00,5929.00,15970,15972
21855,1,512,512,512.00,0.00,15971,15972
21856,2,497,15,256.00,58081.00,15971,15973
21857,1,512,512,512.00,0.00,15972,15973
21858,1,512,512,512.00,0.00,15972,15973
21859,1,512,512,512.00,0.00,15972,15973
21860,2,448,64,256.00,36864.00,15972,15974
21861,3,275,3,170.67,14336.22,15973,15976
21862,2,479,33,256.00,49729.00,15975,15977
21863,2,282,230,256.00,676.00,15976,15978
21864,2,359,153,256.00,10609.00,15977,15979
21865,2,291,221,256.00,1225.00,15978,15980
21866,1,512,512,512.00,0.00,15979,15980
21867,2,353,159,256.00,9409.00,15979,15981
21868,1,512,512,512.00,0.00,15980,15981
21869,1,512,512,512.00,0.00,15980,15981
21870,2,461,51,256.00,42025.00,15980,15982
21871,1,512,512,512.00,0.00,15981,15982
21872,1,512,512,512.00,0.00,15981,15982
21873,1,512,512,512.00,0.00,15981,15982
21874,1,512,512,512.00,0.00,15981,15982
21875,2,488,24,256.00,53824.00,15981,15983
21876,2,498,14,256.00,58564.00,15982,15984
21877,1,512,512,512.00,0.00,15983,15984
21878,1,512,512,512.00,0.00,15983,15984
21879,1,512,512,512.00,0.00,15983,15984
21880,4,418,16,128.00,28146.00,15983,15987
21881,4,397,1,128.00,26155.50,15986,15990
21882,1,512,512,512.00,0.00,15989,15990
21883,1,512,512,512.00,0.00,15989,15990
21884,4,341,7,128.00,16638.50,15989,15993
21885,1,512,512,512.00,0.00,15992,15993
21886,1,512,512,512.00,0.00,15992,15993
21887,1,512,512,512.00,0.00,15992,15993
21888,2,375,137,256.00,14161.00,15992,15994
21889,1,512,512,512.00,0.00,15993,15994
21890,1,512,512,512.00,0.00,15993,15994
21891,2,470,42,256.00,45796.00,15993,15995
21892,1,512,512,512.00,0.00,15994,15995
21893,1,512,512,512.00,0.00,15994,15995
21894,6,357,5,85.33,15674.89,15994,16000
21895,3,396,17,170.67,26508.22,15999,16002
21896,3,483,1,170.67,48897.56,16001,16004
21897,1,512,512,512.00,0.00,16004,16005
21898,7,295,1,73.14,9272.98,16004,16011
21899,2,476,36,256.00,48400.00,16010,16012
21900,4,348,4,128.00,17608.00,16011,16015
21901,1,512,512,512.00,0.00,16014,16015
21902,1,512,512,512.00,0.00,16014,16015
21903,1,512,512,512.00,0.00,16014,16015
21904,1,512,512,512.00,0.00,16014,16015
21905,2,369,143,256.00,12769.00,16014,16016
21906,1,512,512,512.00,0.00,16015,16016
21907,7,394,1,73.14,17857.27,16015,16022
21908,2,404,108,256.00,21904.00,16021,16023
21909,1,512,512,512.00,0.00,16022,16023
21910,2,332,180,256.00,5776.00,16022,16024
21911,1,512,512,512.00,0.00,16023,16024
21912,2,431,81,256.00,30625.00,16023,16025
21913,1,512,512,512.00,0.00,16024,16025
21914,1,512,512,512.00,0.00,16024,16025
21915,1,512,512,512.00,0.00,16024,16025
21916,4,363,6,128.00,20663.50,16024,16028
21917,1,512,512,512.00,0.00,16027,16028
21918,1,512,512,512.00,0.00,16027,16028
21919,1,512,512,512.00,0.00,16027,16028
21920,8,214,2,64.00,5074.25,16027,16035
21921,1,512,512,512.00,0.00,16034,16035
21922,1,512,512,512.00,0.00,16034,16035
21923,1,512,512,512.00,0.00,16034,16035
21924,1,512,512,512.00,0.00,16034,16035
21925,3,389,3,170.67,26116.22,16034,16037
21926,2,492,20,256.00,55696.00,16036,16038
21927,1,512,512,512.00,0.00,16037,16038
21928,1,512,512,512.00,0.00,16037,16038
21929,1,512,512,512.00,0.00,16037,16038
21930,4,284,7,128.00,15253.50,16037,16041
21931,3,395,29,170.67,25742.89,16040,16043
21932,1,512,512,512.00,0.00,16042,16043
21933,1,512,512,512.00,0.00,16042,16043
21934,1,512,512,512.00,0.00,16042,16043
21935,1,512,512,512.00,0.00,16042,16043
21936,2,421,91,256.00,27225.00,16042,16044
21937,1,512,512,512.00,0.00,16043,16044
21938,5,337,18,102.40,14520.24,16043,16048
21939,4,377,6,128.00,21247.50,16047,16051
21940,1,512,512,512.00,0.00,16050,16051
21941,1,512,512,512.00,0.00,16050,16051
21942,6,360,1,85.33,17777.89,16050,16056
21943,1,512,512,512.00,0.00,16055,16056
21944,1,512,512,512.00,0.00,16055,16056
21945,1,512,512,512.00,0.00,16055,16056
21946,2,409,103,256.00,23409.00,16055,16057
21947,1,512,512,512.00,0.00,16056,16057
21948,1,512,512,512.00,0.00,16056,16057
21949,2,435,77,256.00,32041.00,16056,16058
21950,1,512,512,512.00,0.00,16057,16058
21951,2,471,41,256.00,46225.00,16057,16059
21952,1,512,512,512.00,0.00,16058,16059
21953,1,512,512,512.00,0.00,16058,16059
21954,5,320,4,102.40,14539.44,16058,16063
21955,6,340,1,85.33,13885.89,16062,16068
21956,1,512,512,512.00,0.00,16067,16068
21957,1,512,512,512.00,0.00,16067,16068
21958,2,473,39,256.00,47089.00,16067,16069
21959,1,512,512,512.00,0.00,16068,16069
21960,1,512,512,512.00,0.00,16068,16069
21961,2,467,45,256.00,44521.00,16068,16070
21962,1,512,512,512.00,0.00,16069,16070
21963,1,512,512,512.00,0.00,16069,16070
21964,1,512,512,512.00,0.00,16069,16070
21965,2,490,22,256.00,54756.00,16069,16071
21966,1,512,512,512.00,0.00,16070,16071
21967,1,512,512,512.00,0.00,16070,16071
21968,1,512,512,512.00,0.00,16070,16071
21969,1,512,512,512.00,0.00,16070,16071
21970,1,512,512,512.00,0.00,16070,16071
21971,2,357,155,256.00,10201.00,16070,16072
21972,1,512,512,512.00,0.00,16071,16072
21973,1,512,512,512.00,0.00,16071,16072
21974,1,512,512,512.00,0.00,16071,16072
21975,1,512,512,512.00,0.00,16071,16072
21976,4,290,2,128.00,16310.00,16071,16075
21977,1,512,512,512.00,0.00,16074,16075
21978,1,512,512,512.00,0.00,16074,16075
21979,2,478,34,256.00,49284.00,16074,16076
21980,5,254,4,102.40,10179.44,16075,16080
21981,1,512,512,512.00,0.00,16079,16080
21982,1,512,512,512.00,0.00,16079,16080
21983,1,512,512,512.00,0.00,16079,16080
21984,1,512,512,512.00,0.00,16079,16080
21985,1,512,512,512.00,0.00,16079,16080
21986,5,166,26,102.40,3601.04,16079,16084
21987,4,340,1,128.00,19097.50,16083,16087
21988,1,512,512,512.00,0.00,16086,16087
21989,1,512,512,512.00,0.00,16086,16087
21990,1,512,512,512.00,0.00,16086,16087
21991,1,512,512,512.00,0.00,16086,16087
21992,1,512,512,512.00,0.00,16086,16087
21993,1,512,512,512.00,0.00,16086,16087
21994,1,512,512,512.00,0.00,16086,16087
21995,2,341,171,256.00,7225.00,16086,16088
21996,1,512,512,512.00,0.00,16087,16088
21997,1,512,512,512.00,0.00,16087,16088
21998,1,512,512,512.00,0.00,16087,16088
21999,1,512,512,512.00,0.00,16087,16088
22000,1,512,512,512.00,0.00,16087,16088
22001,2,435,77,256.00,32041.00,16087,16089
22002,1,512,512,512.00,0.00,16088,16089
22003,1,512,512,512.00,0.00,16088,16089
22004,1,512,512,512.00,0.00,16088,16089
22005,1,512,512,512.00,0.00,16088,16089
22006,1,512,512,512.00,0.00,16088,16089
22007,1,512,512,512.00,0.00,16088,16089
22008,2,320,192,256.00,4096.00,16088,16090
22009,2,448,64,256.00,36864.00,16089,16091
22010,6,238,3,85.33,6728.56,16090,16096
22011,4,196,35,128.00,3831.50,16095,16099
22012,3,389,23,170.67,24822.89,16098,16101
22013,4,293,13,128.00,12347.00,16100,16104
22014,2,314,198,256.00,3364.00,16103,16105
22015,1,512,512,512.00,0.00,16104,16105
22016,4,253,4,128.00,9580.50,16104,16108
22017,1,512,512,512.00,0.00,16107,16108
22018,1,512,512,512.00,0.00,16107,16108
22019,1,512,512,512.00,0.00,16107,16108
22020,1,512,512,512.00,0.00,16107,16108
22021,2,489,23,256.00,54289.00,16107,16109
22022,5,197,20,102.40,4997.84,16108,16113
22023,1,512,512,512.00,0.00,16112,16113
22024,1,512,512,512.00,0.00,16112,16113
22025,1,512,512,512.00,0.00,16112,16113
22026,1,512,512,512.00,0.00,16112,16113
22027,2,418,94,256.00,26244.00,16112,16114
22028,3,407,22,170.67,28546.89,16113,16116
22029,2,354,158,256.00,9604.00,16115,16117
22030,4,372,37,128.00,19886.50,16116,16120
22031,1,512,512,512.00,0.00,16119,16120
22032,1,512,512,512.00,0.00,16119,16120
22033,1,512,512,512.00,0.00,16119,16120
22034,1,512,512,512.00,0.00,16119,16120
22035,1,512,512,512.00,0.00,16119,16120
22036,1,512,512,512.00,0.00,16119,16120
22037,3,362,5,170.67,21570.89,16119,16122
22038,1,512,512,512.00,0.00,16121,16122
22039,1,512,512,512.00,0.00,16121,16122
22040,2,424,88,256.00,28224.00,16121,16123
22041,1,512,512,512.00,0.00,16122,16123
22042,4,257,15,128.00,10997.00,16122,16126
22043,1,512,512,512.00,0.00,16125,16126
22044,1,512,512,512.00,0.00,16125,16126
22045,2,278,234,256.00,484.00,16125,16127
22046,1,512,512,512.00,0.00,16126,16127
22047,4,428,1,128.00,30273.50,16126,16130
22048,1,512,512,512.00,0.00,16129,16130
22049,1,512,512,512.00,0.00,16129,16130
22050,2,443,69,256.00,34969.00,16129,16131
22051,2,287,225,256.00,961.00,16130,16132
22052,2,437,75,256.00,32761.00,16131,16133
22053,1,512,512,512.00,0.00,16132,16133
22054,1,512,512,512.00,0.00,16132,16133
22055,4,253,4,128.00,8696.50,16132,16136
22056,1,512,512,512.00,0.00,16135,16136
22057,1,512,512,512.00,0.00,16135,16136
22058,1,512,512,512.00,0.00,16135,16136
22059,2,296,216,256.00,1600.00,16135,16137
22060,1,512,512,512.00,0.00,16136,16137
22061,1,512,512,512.00,0.00,16136,16137
22062,1,512,512,512.00,0.00,16136,16137
22063,1,512,512,512.00,0.00,16136,16137
22064,3,220,138,170.67,1259.56,16136,16139
22065,2,482,30,256.00,51076.00,16138,16140
22066,2,477,35,256.00,48841.00,16139,16141
22067,1,512,512,512.00,0.00,16140,16141
22068,1,512,512,512.00,0.00,16140,16141
22069,1,512,512,512.00,0.00,16140,16141
22070,4,357,5,128.00,18909.50,16140,16144
22071,1,512,512,512.00,0.00,16143,16144
22072,3,390,51,170.67,24120.22,16143,16146
22073,1,512,512,512.00,0.00,16145,16146
22074,1,512,512,512.00,0.00,16145,16146
22075,2,284,228,256.00,784.00,16145,16147
22076,1,512,512,512.00,0.00,16146,16147
22077,1,512,512,512.00,0.00,16146,16147
22078,1,512,512,512.00,0.00,16146,16147
22079,1,512,512,512.00,0.00,16146,16147
22080,1,512,512,512.00,0.00,16146,16147
22081,5,246,4,102.40,6213.44,16146,16151
22082,5,315,3,102.40,15083.44,16150,16155
22083,4,463,5,128.00,37481.00,16154,16158
22084,1,512,512,512.00,0.00,16157,16158
22085,1,512,512,512.00,0.00,16157,16158
22086,1,512,512,512.00,0.00,16157,16158
22087,1,512,512,512.00,0.00,16157,16158
22088,1,512,512,512.00,0.00,16157,16158
22089,1,512,512,512.00,0.00,16157,16158
22090,1,512,512,512.00,0.00,16157,16158
22091,1,512,512,512.00,0.00,16157,16158
22092,1,512,512,512.00,0.00,16157,16158
22093,2,355,157,256.00,9801.00,16157,16159
22094,1,512,512,512.00,0.00,16158,16159
22095,2,343,169,256.00,7569.00,16158,16160
22096,5,461,1,102.40,32378.24,16159,16164
22097,1,512,512,512.00,0.00,16163,16164
22098,1,512,512,512.00,0.00,16163,16164
22099,1,512,512,512.00,0.00,16163,16164
22100,2,510,2,256.00,64516.00,16163,16165
22101,1,512,512,512.00,0.00,16164,16165
22102,1,512,512,512.00,0.00,16164,16165
22103,1,512,512,512.00,0.00,16164,16165
22104,3,385,17,170.67,24410.89,16164,16167
22105,4,408,3,128.00,27370.50,16166,16170
22106,1,512,512,512.00,0.00,16169,16170
22107,1,512,512,512.00,0.00,16169,16170
22108,1,512,512,512.00,0.00,16169,16170
22109,2,341,171,256.00,7225.00,16169,16171
22110,1,512,512,512.00,0.00,16170,16171
22111,1,512,512,512.00,0.00,16170,16171
22112,2,335,177,256.00,6241.00,16170,16172
22113,1,512,512,512.00,0.00,16171,16172
22114,3,288,39,170.67,10436.22,16171,16174
22115,1,512,512,512.00,0.00,16173,16174
22116,1,512,512,512.00,0.00,16173,16174
22117,1,512,512,512.00,0.00,16173,16174
22118,1,512,512,512.00,0.00,16173,16174
22119,3,388,34,170.67,24139.56,16173,16176
22120,1,512,512,512.00,0.00,16175,16176
22121,1,512,512,512.00,0.00,16175,16176
22122,1,512,512,512.00,0.00,16175,16176
22123,4,285,1,128.00,16467.50,16175,16179
22124,1,512,512,512.00,0.00,16178,16179
22125,1,512,512,512.00,0.00,16178,16179
22126,1,512,512,512.00,0.00,16178,16179
22127,1,512,512,512.00,0.00,16178,16179
22128,1,512,512,512.00,0.00,16178,16179
22129,1,512,512,512.00,0.00,16178,16179
22130,4,323,2,128.00,17151.50,16178,16182
22131,1,512,512,512.00,0.00,16182,16183
22132,1,512,512,512.00,0.00,16182,16183
22133,1,512,512,512.00,0.00,16182,16183
22134,5,261,6,102.40,13060.24,16182,16187
22135,1,512,512,512.00,0.00,16186,16187
22136,1,512,512,512.00,0.00,16186,16187
22137,1,512,512,512.00,0.00,16186,16187
22138,1,512,512,512.00,0.00,16186,16187
22139,1,512,512,512.00,0.00,16186,16187
22140,4,280,1,128.00,12371.50,16186,16190
22141,1,512,512,512.00,0.00,16189,16190
22142,1,512,512,512.00,0.00,16189,16190
22143,1,512,512,512.00,0.00,16189,16190
22144,3,453,3,170.67,40324.22,16189,16192
22145,1,512,512,512.00,0.00,16191,16192
22146,1,512,512,512.00,0.00,16191,16192
22147,1,512,512,512.00,0.00,16191,16192
22148,4,280,28,128.00,10182.00,16191,16195
22149,1,512,512,512.00,0.00,16194,16195
22150,3,216,126,170.67,1350.22,16194,16197
22151,1,512,512,512.00,0.00,16196,16197
22152,1,512,512,512.00,0.00,16196,16197
22153,1,512,512,512.00,0.00,16196,16197
22154,2,469,43,256.00,45369.00,16196,16198
22155,1,512,512,512.00,0.00,16197,16198
22156,8,194,1,64.00,6148.50,16197,16205
22157,1,512,512,512.00,0.00,16204,16205
22158,1,512,512,512.00,0.00,16204,16205
22159,1,512,512,512.00,0.00,16204,16205
22160,1,512,512,512.00,0.00,16204,16205
22161,1,512,512,512.00,0.00,16204,16205
22162,1,512,512,512.00,0.00,16204,16205
22163,1,512,512,512.00,0.00,16204,16205
22164,1,512,512,512.00,0.00,16204,16205
22165,2,447,65,256.00,36481.00,16204,16206
22166,1,512,512,512.00,0.00,16205,16206
22167,1,512,512,512.00,0.00,16205,16206
22168,1,512,512,512.00,0.00,16205,16206
22169,1,512,512,512.00,0.00,16205,16206
22170,1,512,512,512.00,0.00,16205,16206
22171,1,512,512,512.00,0.00,16205,16206
22172,1,512,512,512.00,0.00,16205,16206
22173,1,512,512,512.00,0.00,16205,16206
22174,1,512,512,512.00,0.00,16205,16206
22175,3,336,63,170.67,14084.22,16205,16208
22176,2,289,223,256.00,1089.00,16207,16209
22177,6,267,4,85.33,8000.56,16208,16214
22178,1,512,512,512.00,0.00,16213,16214
22179,1,512,512,512.00,0.00,16213,16214
22180,2,416,96,256.00,25600.00,16213,16215
22181,1,512,512,512.00,0.00,16214,16215
22182,2,380,132,256.00,15376.00,16214,16216
22183,1,512,512,512.00,0.00,16215,16216
22184,2,508,4,256.00,63504.00,16215,16217
22185,2,432,80,256.00,30976.00,16216,16218
22186,1,512,512,512.00,0.00,16217,16218
22187,1,512,512,512.00,0.00,16217,16218
22188,1,512,512,512.00,0.00,16217,16218
22189,3,250,41,170.67,8546.89,16217,16220
22190,6,241,6,85.33,9867.22,16219,16225
22191,3,474,4,170.67,46155.56,16224,16227
22192,5,472,5,102.40,34185.44,16226,16231
22193,4,487,1,128.00,42981.00,16230,16234
22194,1,512,512,512.00,0.00,16233,16234
22195,2,329,183,256.00,5329.00,16233,16235
22196,6,251,1,85.33,11941.56,16234,16240
22197,5,227,1,102.40,9301.44,16239,16244
22198,1,512,512,512.00,0.00,16243,16244
22199,2,297,215,256.00,1681.00,16243,16245
22200,1,512,512,512.00,0.00,16244,16245
22201,1,512,512,512.00,0.00,16244,16245
22202,1,512,512,512.00,0.00,16244,16245
22203,6,173,1,85.33,6062.89,16244,16250
22204,4,213,1,128.00,6157.00,16249,16253
22205,1,512,512,512.00,0.00,16252,16253
22206,1,512,512,512.00,0.00,16252,16253
22207,9,318,1,56.89,9722.99,16252,16261
22208,1,512,512,512.00,0.00,16260,16261
22209,2,494,18,256.00,56644.00,16260,16262
22210,1,512,512,512.00,0.00,16261,16262
22211,1,512,512,512.00,0.00,16261,16262
22212,1,512,512,512.00,0.00,16261,16262
22213,3,231,76,170.67,4593.56,16261,16264
22214,5,357,12,102.40,16463.84,16263,16268
22215,1,512,512,512.00,0.00,16267,16268
22216,1,512,512,512.00,0.00,16267,16268
22217,1,512,512,512.00,0.00,16267,16268
22218,1,512,512,512.00,0.00,16267,16268
22219,1,512,512,512.00,0.00,16267,16268
22220,1,512,512,512.00,0.00,16267,16268
22221,9,217,1,56.89,5038.54,16267,16276
22222,2,396,116,256.00,19600.00,16275,16277
22223,1,512,512,512.00,0.00,16276,16277
22224,1,512,512,512.00,0.00,16276,16277
22225,1,512,512,512.00,0.00,16276,16277
22226,1,512,512,512.00,0.00,16276,16277
22227,2,410,102,256.00,23716.00,16276,16278
22228,1,512,512,512.00,0.00,16277,16278
22229,1,512,512,512.00,0.00,16277,16278
22230,1,512,512,512.00,0.00,16277,16278
22231,1,512,512,512.00,0.00,16277,16278
22232,2,440,72,256.00,33856.00,16277,16279
22233,1,512,512,512.00,0.00,16278,16279
22234,1,512,512,512.00,0.00,16278,16279
22235,1,512,512,512.00,0.00,16278,16279
22236,2,397,115,256.00,19881.00,16278,16280
22237,1,512,512,512.00,0.00,16279,16280
22238,1,512,512,512.00,0.00,16279,16280
22239,3,236,123,170.67,2284.22,16279,16282
22240,3,481,3,170.67,48257.56,16281,16284
22241,1,512,512,512.00,0.00,16283,16284
22242,1,512,512,512.00,0.00,16283,16284
22243,1,512,512,512.00,0.00,16283,16284
22244,2,302,210,256.00,2116.00,16283,16285
22245,1,512,512,512.00,0.00,16284,16285
22246,3,351,37,170.67,17521.56,16284,16287
22247,1,512,512,512.00,0.00,16286,16287
22248,2,510,2,256.00,64516.00,16286,16288
22249,1,512,512,512.00,0.00,16287,16288
22250,2,330,182,256.00,5476.00,16287,16289
22251,1,512,512,512.00,0.00,16288,16289
22252,2,408,104,256.00,23104.00,16288,16290
22253,1,512,512,512.00,0.00,16289,16290
22254,1,512,512,512.00,0.00,16289,16290
22255,1,512,512,512.00,0.00,16289,16290
22256,2,314,198,256.00,3364.00,16289,16291
22257,1,512,512,512.00,0.00,16290,16291
22258,1,512,512,512.00,0.00,16290,16291
22259,2,473,39,256.00,47089.00,16290,16292
22260,1,512,512,512.00,0.00,16291,16292
22261,1,512,512,512.00,0.00,16291,16292
22262,1,512,512,512.00,0.00,16291,16292
22263,3,273,119,170.67,5236.22,16291,16294
22264,1,512,512,512.00,0.00,16293,16294
22265,1,512,512,512.00,0.00,16293,16294
22266,1,512,512,512.00,0.00,16294,16295
22267,2,424,88,256.00,28224.00,16294,16296
22268,1,512,512,512.00,0.00,16295,16296
22269,2,347,165,256.00,8281.00,16295,16297
22270,1,512,512,512.00,0.00,16296,16297
22271,2,370,142,256.00,12996.00,16296,16298
22272,1,512,512,512.00,0.00,16297,16298
22273,1,512,512,512.00,0.00,16297,16298
22274,1,512,512,512.00,0.00,16297,16298
22275,1,512,512,512.00,0.00,16297,16298
22276,1,512,512,512.00,0.00,16297,16298
22277,3,292,17,170.67,13126.89,16297,16300
22278,1,512,512,512.00,0.00,16299,16300
22279,1,512,512,512.00,0.00,16299,16300
22280,3,253,48,170.67,7817.56,16299,16302
22281,1,512,512,512.00,0.00,16301,16302
22282,2,331,181,256.00,5625.00,16301,16303
22283,1,512,512,512.00,0.00,16302,16303
22284,1,512,512,512.00,0.00,16302,16303
22285,1,512,512,512.00,0.00,16302,16303
22286,2,494,18,256.00,56644.00,16302,16304
22287,1,512,512,512.00,0.00,16303,16304
22288,1,512,512,512.00,0.00,16303,16304
22289,1,512,512,512.00,0.00,16303,16304
22290,2,483,29,256.00,51529.00,16303,16305
22291,2,425,87,256.00,28561.00,16304,16306
22292,2,367,145,256.00,12321.00,16305,16307
22293,3,214,110,170.67,1952.89,16306,16309
22294,1,512,512,512.00,0.00,16308,16309
22295,1,512,512,512.00,0.00,16308,16309
22296,1,512,512,512.00,0.00,16308,16309
22297,1,512,512,512.00,0.00,16308,16309
22298,3,308,6,170.67,15574.22,16308,16311
22299,4,270,1,128.00,14772.50,16310,16314
22300,1,512,512,512.00,0.00,16313,16314
22301,1,512,512,512.00,0.00,16313,16314
22302,3,231,78,170.67,4424.22,16313,16316
22303,1,512,512,512.00,0.00,16315,16316
22304,1,512,512,512.00,0.00,16315,16316
22305,2,405,107,256.00,22201.00,16315,16317
22306,1,512,512,512.00,0.00,16316,16317
22307,1,512,512,512.00,0.00,16316,16317
22308,1,512,512,512.00,0.00,16316,16317
22309,2,402,110,256.00,21316.00,16316,16318
22310,1,512,512,512.00,0.00,16317,16318
22311,2,435,77,256.00,32041.00,16317,16319
22312,2,312,200,256.00,3136.00,16318,16320
22313,1,512,512,512.00,0.00,16319,16320
22314,1,512,512,512.00,0.00,16319,16320
22315,1,512,512,512.00,0.00,16319,16320
22316,1,512,512,512.00,0.00,16319,16320
22317,1,512,512,512.00,0.00,16319,16320
22318,2,465,47,256.00,43681.00,16319,16321
22319,4,194,3,128.00,5433.50,16320,16324
22320,1,512,512,512.00,0.00,16323,16324
22321,2,292,220,256.00,1296.00,16323,16325
22322,1,512,512,512.00,0.00,16324,16325
22323,3,458,1,170.67,41730.89,16324,16327
22324,1,512,512,512.00,0.00,16326,16327
22325,1,512,512,512.00,0.00,16326,16327
22326,1,512,512,512.00,0.00,16326,16327
22327,3,465,5,170.67,43544.22,16326,16329
22328,1,512,512,512.00,0.00,16328,16329
22329,1,512,512,512.00,0.00,16328,16329
22330,3,381,34,170.67,22781.56,16328,16331
22331,1,512,512,512.00,0.00,16330,16331
22332,2,442,70,256.00,34596.00,16330,16332
22333,1,512,512,512.00,0.00,16331,16332
22334,1,512,512,512.00,0.00,16331,16332
22335,1,512,512,512.00,0.00,16331,16332
22336,1,512,512,512.00,0.00,16331,16332
22337,1,512,512,512.00,0.00,16331,16332
22338,1,512,512,512.00,0.00,16331,16332
22339,1,512,512,512.00,0.00,16331,16332
22340,2,330,182,256.00,5476.00,16331,16333
22341,1,512,512,512.00,0.00,16332,16333
22342,3,326,3,170.67,17464.22,16332,16335
22343,1,512,512,512.00,0.00,16334,16335
22344,1,512,512,512.00,0.00,16334,16335
22345,1,512,512,512.00,0.00,16334,16335
22346,3,278,54,170.67,8406.22,16334,16337
22347,3,279,52,170.67,8641.56,16336,16339
22348,3,330,9,170.67,17176.22,16338,16341
22349,1,512,512,512.00,0.00,16340,16341
22350,1,512,512,512.00,0.00,16340,16341
22351,2,403,109,256.00,21609.00,16340,16342
22352,1,512,512,512.00,0.00,16341,16342
22353,1,512,512,512.00,0.00,16341,16342
22354,1,512,512,512.00,0.00,16341,16342
22355,1,512,512,512.00,0.00,16341,16342
22356,6,255,13,85.33,7222.22,16341,16347
22357,2,482,30,256.00,51076.00,16346,16348
22358,1,512,512,512.00,0.00,16347,16348
22359,2,280,232,256.00,576.00,16347,16349
22360,2,339,173,256.00,6889.00,16348,16350
22361,1,512,512,512.00,0.00,16349,16350
22362,1,512,512,512.00,0.00,16349,16350
22363,1,512,512,512.00,0.00,16349,16350
22364,2,387,125,256.00,17161.00,16349,16351
22365,2,338,174,256.00,6724.00,16350,16352
22366,1,512,512,512.00,0.00,16351,16352
22367,1,512,512,512.00,0.00,16351,16352
22368,1,512,512,512.00,0.00,16351,16352
22369,3,415,18,170.67,30469.56,16351,16354
22370,1,512,512,512.00,0.00,16353,16354
22371,1,512,512,512.00,0.00,16353,16354
22372,1,512,512,512.00,0.00,16353,16354
22373,1,512,512,512.00,0.00,16353,16354
22374,2,296,216,256.00,1600.00,16353,16355
22375,1,512,512,512.00,0.00,16354,16355
22376,2,339,173,256.00,6889.00,16354,16356
22377,1,512,512,512.00,0.00,16355,16356
22378,1,512,512,512.00,0.00,16355,16356
22379,4,247,20,128.00,8301.50,16355,16359
22380,1,512,512,512.00,0.00,16358,16359
22381,1,512,512,512.00,0.00,16358,16359
22382,2,262,250,256.00,36.00,16358,16360
22383,1,512,512,512.00,0.00,16359,16360
22384,2,364,148,256.00,11664.00,16359,16361
22385,3,450,3,170.67,39536.22,16360,16363
22386,1,512,512,512.00,0.00,16362,16363
22387,1,512,512,512.00,0.00,16362,16363
22388,3,371,16,170.67,22046.89,16362,16365
22389,1,512,512,512.00,0.00,16364,16365
22390,1,512,512,512.00,0.00,16364,16365
22391,1,512,512,512.00,0.00,16364,16365
22392,2,407,105,256.00,22801.00,16364,16366
22393,1,512,512,512.00,0.00,16365,16366
22394,2,338,174,256.00,6724.00,16365,16367
22395,1,512,512,512.00,0.00,16366,16367
22396,2,487,25,256.00,53361.00,16366,16368
22397,1,512,512,512.00,0.00,16367,16368
22398,1,512,512,512.00,0.00,16367,16368
22399,1,512,512,512.00,0.00,16367,16368
22400,1,512,512,512.00,0.00,16367,16368
22401,1,512,512,512.00,0.00,16367,16368
22402,2,464,48,256.00,43264.00,16367,16369
22403,3,300,8,170.67,14766.22,16368,16371
22404,1,512,512,512.00,0.00,16370,16371
22405,1,512,512,512.00,0.00,16370,16371
22406,2,499,13,256.00,59049.00,16370,16372
22407,1,512,512,512.00,0.00,16371,16372
22408,1,512,512,512.00,0.00,16371,16372
22409,3,336,22,170.67,16571.56,16371,16374
22410,1,512,512,512.00,0.00,16373,16374
22411,1,512,512,512.00,0.00,16373,16374
22412,2,361,151,256.00,11025.00,16373,16375
22413,1,512,512,512.00,0.00,16374,16375
22414,1,512,512,512.00,0.00,16374,16375
22415,2,375,137,256.00,14161.00,16374,16376
22416,3,378,36,170.67,22134.22,16375,16378
22417,1,512,512,512.00,0.00,16377,16378
22418,1,512,512,512.00,0.00,16377,16378
22419,1,512,512,512.00,0.00,16377,16378
22420,2,384,128,256.00,16384.00,16377,16379
22421,1,512,512,512.00,0.00,16378,16379
22422,1,512,512,512.00,0.00,16378,16379
22423,3,257,44,170.67,8374.89,16378,16381
22424,1,512,512,512.00,0.00,16380,16381
22425,1,512,512,512.00,0.00,16380,16381
22426,2,297,215,256.00,1681.00,16380,16382
22427,1,512,512,512.00,0.00,16381,16382
22428,1,512,512,512.00,0.00,16381,16382
22429,1,512,512,512.00,0.00,16381,16382
22430,1,512,512,512.00,0.00,16381,16382
22431,1,512,512,512.00,0.00,16381,16382
22432,2,477,35,256.00,48841.00,16381,16383
22433,1,512,512,512.00,0.00,16382,16383
22434,2,462,50,256.00,42436.00,16382,16384
22435,1,512,512,512.00,0.00,16383,16384
22436,2,277,235,256.00,441.00,16383,16385
22437,2,422,90,256.00,27556.00,16384,16386
22438,1,512,512,512.00,0.00,16385,16386
22439,1,512,512,512.00,0.00,16385,16386
22440,1,512,512,512.00,0.00,16385,16386
22441,3,246,120,170.67,2950.22,16385,16388
22442,1,512,512,512.00,0.00,16387,16388
22443,1,512,512,512.00,0.00,16387,16388
22444,1,512,512,512.00,0.00,16387,16388
22445,1,512,512,512.00,0.00,16387,16388
22446,1,512,512,512.00,0.00,16387,16388
22447,1,512,512,512.00,0.00,16387,16388
22448,4,330,31,128.00,14282.50,16387,16391
22449,1,512,512,512.00,0.00,16390,16391
22450,1,512,512,512.00,0.00,16390,16391
22451,2,436,76,256.00,32400.00,16390,16392
22452,2,279,233,256.00,529.00,16391,16393
22453,1,512,512,512.00,0.00,16392,16393
22454,1,512,512,512.00,0.00,16392,16393
22455,2,433,79,256.00,31329.00,16392,16394
22456,1,512,512,512.00,0.00,16393,16394
22457,1,512,512,512.00,0.00,16393,16394
22458,2,386,126,256.00,16900.00,16393,16395
22459,1,512,512,512.00,0.00,16394,16395
22460,2,501,11,256.00,60025.00,16394,16396
22461,1,512,512,512.00,0.00,16395,16396
22462,2,366,146,256.00,12100.00,16395,16397
22463,1,512,512,512.00,0.00,16396,16397
22464,1,512,512,512.00,0.00,16396,16397
22465,1,512,512,512.00,0.00,16396,16397
22466,1,512,512,512.00,0.00,16396,16397
22467,1,512,512,512.00,0.00,16396,16397
22468,2,451,61,256.00,38025.00,16396,16398
22469,1,512,512,512.00,0.00,16397,16398
22470,2,270,242,256.00,196.00,16397,16399
22471,1,512,512,512.00,0.00,16398,16399
22472,2,469,43,256.00,45369.00,16398,16400
22473,1,512,512,512.00,0.00,16399,16400
22474,1,512,512,512.00,0.00,16399,16400
22475,1,512,512,512.00,0.00,16399,16400
22476,1,512,512,512.00,0.00,16399,16400
22477,2,443,69,256.00,34969.00,16399,16401
22478,1,512,512,512.00,0.00,16400,16401
22479,2,487,25,256.00,53361.00,16400,16402
22480,1,512,512,512.00,0.00,16401,16402
22481,1,512,512,512.00,0.00,16401,16402
22482,5,219,23,102.40,5355.04,16401,16406
22483,1,512,512,512.00,0.00,16405,16406
22484,1,512,512,512.00,0.00,16405,16406
22485,1,512,512,512.00,0.00,16405,16406
22486,2,365,147,256.00,11881.00,16405,16407
22487,2,313,199,256.00,3249.00,16406,16408
22488,2,264,248,256.00,64.00,16407,16409
22489,2,345,167,256.00,7921.00,16408,16410
22490,1,512,512,512.00,0.00,16409,16410
22491,1,512,512,512.00,0.00,16409,16410
22492,2,487,25,256.00,53361.00,16409,16411
22493,1,512,512,512.00,0.00,16410,16411
22494,2,447,65,256.00,36481.00,16410,16412
22495,1,512,512,512.00,0.00,16411,16412
22496,1,512,512,512.00,0.00,16411,16412
22497,1,512,512,512.00,0.00,16411,16412
22498,3,221,88,170.67,3470.89,16411,16414
22499,1,512,512,512.00,0.00,16413,16414
22500,1,512,512,512.00,0.00,16413,16414
22501,1,512,512,512.00,0.00,16413,16414
22502,3,391,17,170.67,25534.89,16413,16416
22503,1,512,512,512.00,0.00,16415,16416
22504,1,512,512,512.00,0.00,16415,16416
22505,1,512,512,512.00,0.00,16415,16416
22506,3,271,60,170.67,7473.56,16415,16418
22507,1,512,512,512.00,0.00,16417,16418
22508,1,512,512,512.00,0.00,16417,16418
22509,2,347,165,256.00,8281.00,16417,16419
22510,1,512,512,512.00,0.00,16418,16419
22511,2,401,111,256.00,21025.00,16418,16420
22512,1,512,512,512.00,0.00,16419,16420
22513,1,512,512,512.00,0.00,16419,16420
22514,1,512,512,512.00,0.00,16419,16420
22515,2,471,41,256.00,46225.00,16419,16421
22516,1,512,512,512.00,0.00,16420,16421
22517,1,512,512,512.00,0.00,16420,16421
22518,2,341,171,256.00,7225.00,16420,16422
22519,1,512,512,512.00,0.00,16421,16422
22520,1,512,512,512.00,0.00,16421,16422
22521,2,432,80,256.00,30976.00,16421,16423
22522,1,512,512,512.00,0.00,16422,16423
22523,2,501,11,256.00,60025.00,16422,16424
22524,1,512,512,512.00,0.00,16423,16424
22525,1,512,512,512.00,0.00,16423,16424
22526,1,512,512,512.00,0.00,16423,16424
22527,5,286,23,102.40,9454.64,16423,16428
22528,1,512,512,512.00,0.00,16427,16428
22529,1,512,512,512.00,0.00,16427,16428
22530,2,414,98,256.00,24964.00,16427,16429
22531,3,299,87,170.67,8488.22,16428,16431
22532,1,512,512,512.00,0.00,16430,16431
22533,2,330,182,256.00,5476.00,16430,16432
22534,3,488,7,170.67,50366.89,16431,16434
22535,1,512,512,512.00,0.00,16433,16434
22536,1,512,512,512.00,0.00,16433,16434
22537,1,512,512,512.00,0.00,16433,16434
22538,2,380,132,256.00,15376.00,16433,16435
22539,4,316,35,128.00,12162.50,16434,16438
22540,1,512,512,512.00,0.00,16437,16438
22541,1,512,512,512.00,0.00,16437,16438
22542,1,512,512,512.00,0.00,16437,16438
22543,2,331,181,256.00,5625.00,16437,16439
22544,1,512,512,512.00,0.00,16438,16439
22545,2,283,229,256.00,729.00,16438,16440
22546,1,512,512,512.00,0.00,16439,16440
22547,1,512,512,512.00,0.00,16439,16440
22548,1,512,512,512.00,0.00,16439,16440
22549,3,303,13,170.67,14337.56,16439,16442
22550,1,512,512,512.00,0.00,16441,16442
22551,1,512,512,512.00,0.00,16441,16442
22552,1,512,512,512.00,0.00,16441,16442
22553,3,328,10,170.67,16859.56,16441,16444
22554,2,478,34,256.00,49284.00,16443,16445
22555,2,357,155,256.00,10201.00,16444,16446
22556,1,512,512,512.00,0.00,16445,16446
22557,1,512,512,512.00,0.00,16445,16446
22558,1,512,512,512.00,0.00,16445,16446
22559,1,512,512,512.00,0.00,16445,16446
22560,2,314,198,256.00,3364.00,16445,16447
22561,1,512,512,512.00,0.00,16446,16447
22562,1,512,512,512.00,0.00,16446,16447
22563,1,512,512,512.00,0.00,16446,16447
22564,4,276,31,128.00,8429.50,16446,16450
22565,1,512,512,512.00,0.00,16449,16450
22566,1,512,512,512.00,0.00,16449,16450
22567,1,512,512,512.00,0.00,16449,16450
22568,1,512,512,512.00,0.00,16449,16450
22569,1,512,512,512.00,0.00,16449,16450
22570,1,512,512,512.00,0.00,16449,16450
22571,2,295,217,256.00,1521.00,16449,16451
22572,2,299,213,256.00,1849.00,16450,16452
22573,2,277,235,256.00,441.00,16451,16453
22574,1,512,512,512.00,0.00,16452,16453
22575,1,512,512,512.00,0.00,16452,16453
22576,1,512,512,512.00,0.00,16452,16453
22577,1,512,512,512.00,0.00,16452,16453
22578,1,512,512,512.00,0.00,16452,16453
22579,2,466,46,256.00,44100.00,16452,16454
22580,1,512,512,512.00,0.00,16453,16454
22581,1,512,512,512.00,0.00,16453,16454
22582,2,342,170,256.00,7396.00,16453,16455
22583,1,512,512,512.00,0.00,16454,16455
22584,2,390,122,256.00,17956.00,16454,16456
22585,3,400,22,170.67,27067.56,16455,16458
22586,1,512,512,512.00,0.00,16457,16458
22587,1,512,512,512.00,0.00,16457,16458
22588,1,512,512,512.00,0.00,16457,16458
22589,1,512,512,512.00,0.00,16457,16458
22590,2,475,37,256.00,47961.00,16457,16459
22591,1,512,512,512.00,0.00,16458,16459
22592,1,512,512,512.00,0.00,16458,16459
22593,1,512,512,512.00,0.00,16458,16459
22594,1,512,512,512.00,0.00,16458,16459
22595,1,512,512,512.00,0.00,16458,16459
22596,1,512,512,512.00,0.00,16458,16459
22597,2,423,89,256.00,27889.00,16458,16460
22598,1,512,512,512.00,0.00,16459,16460
22599,3,421,44,170.67,31334.89,16459,16462
22600,1,512,512,512.00,0.00,16461,16462
22601,1,512,512,512.00,0.00,16461,16462
22602,1,512,512,512.00,0.00,16461,16462
22603,2,469,43,256.00,45369.00,16461,16463
22604,1,512,512,512.00,0.00,16462,16463
22605,1,512,512,512.00,0.00,16462,16463
22606,1,512,512,512.00,0.00,16462,16463
22607,3,340,10,170.67,18187.56,16462,16465
22608,4,326,3,128.00,14379.50,16464,16468
22609,1,512,512,512.00,0.00,16467,16468
22610,1,512,512,512.00,0.00,16467,16468
22611,4,375,4,128.00,21107.50,16467,16471
22612,1,512,512,512.00,0.00,16470,16471
22613,1,512,512,512.00,0.00,16470,16471
22614,4,195,32,128.00,4351.50,16470,16474
22615,3,305,17,170.67,14010.89,16473,16476
22616,3,369,2,170.67,22888.22,16475,16478
22617,1,512,512,512.00,0.00,16477,16478
22618,3,269,15,170.67,12396.22,16477,16480
22619,2,505,7,256.00,62001.00,16479,16481
22620,1,512,512,512.00,0.00,16480,16481
22621,1,512,512,512.00,0.00,16480,16481
22622,2,465,47,256.00,43681.00,16480,16482
22623,2,392,120,256.00,18496.00,16481,16483
22624,1,512,512,512.00,0.00,16482,16483
22625,1,512,512,512.00,0.00,16482,16483
22626,1,512,512,512.00,0.00,16482,16483
22627,1,512,512,512.00,0.00,16482,16483
22628,2,259,253,256.00,9.00,16482,16484
22629,1,512,512,512.00,0.00,16483,16484
22630,2,430,82,256.00,30276.00,16483,16485
22631,1,512,512,512.00,0.00,16484,16485
22632,1,512,512,512.00,0.00,16484,16485
22633,1,512,512,512.00,0.00,16484,16485
22634,3,361,31,170.67,19433.56,16484,16487
22635,1,512,512,512.00,0.00,16486,16487
22636,1,512,512,512.00,0.00,16486,16487
22637,3,312,82,170.67,10203.56,16486,16489
22638,1,512,512,512.00,0.00,16488,16489
22639,2,472,40,256.00,46656.00,16488,16490
22640,1,512,512,512.00,0.00,16489,16490
22641,1,512,512,512.00,0.00,16489,16490
22642,2,409,103,256.00,23409.00,16489,16491
22643,1,512,512,512.00,0.00,16490,16491
22644,1,512,512,512.00,0.00,16490,16491
22645,2,305,207,256.00,2401.00,16490,16492
22646,2,319,193,256.00,3969.00,16491,16493
22647,1,512,512,512.00,0.00,16492,16493
22648,1,512,512,512.00,0.00,16492,16493
22649,3,206,106,170.67,2096.89,16492,16495
22650,1,512,512,512.00,0.00,16494,16495
22651,1,512,512,512.00,0.00,16494,16495
22652,4,326,2,128.00,18202.50,16494,16498
22653,1,512,512,512.00,0.00,16497,16498
22654,1,512,512,512.00,0.00,16497,16498
22655,1,512,512,512.00,0.00,16497,16498
22656,2,380,132,256.00,15376.00,16497,16499
22657,2,427,85,256.00,29241.00,16498,16500
22658,1,512,512,512.00,0.00,16499,16500
22659,1,512,512,512.00,0.00,16499,16500
22660,1,512,512,512.00,0.00,16499,16500
22661,1,512,512,512.00,0.00,16499,16500
22662,1,512,512,512.00,0.00,16499,16500
22663,7,169,2,73.14,2672.98,16499,16506
22664,2,301,211,256.00,2025.00,16505,16507
22665,1,512,512,512.00,0.00,16506,16507
22666,1,512,512,512.00,0.00,16506,16507
22667,1,512,512,512.00,0.00,16506,16507
22668,2,260,252,256.00,16.00,16506,16508
22669,1,512,512,512.00,0.00,16507,16508
22670,1,512,512,512.00,0.00,16507,16508
22671,1,512,512,512.00,0.00,16507,16508
22672,2,408,104,256.00,23104.00,16507,16509
22673,2,271,241,256.00,225.00,16508,16510
22674,1,512,512,512.00,0.00,16509,16510
22675,1,512,512,512.00,0.00,16509,16510
22676,2,291,221,256.00,1225.00,16509,16511
22677,1,512,512,512.00,0.00,16510,16511
22678,2,298,214,256.00,1764.00,16510,16512
22679,1,512,512,512.00,0.00,16511,16512
22680,1,512,512,512.00,0.00,16511,16512
22681,1,512,512,512.00,0.00,16511,16512
22682,1,512,512,512.00,0.00,16511,16512
22683,1,512,512,512.00,0.00,16511,16512
22684,2,475,37,256.00,47961.00,16511,16513
22685,1,512,512,512.00,0.00,16512,16513
22686,3,489,1,170.67,50741.56,16512,16515
22687,1,512,512,512.00,0.00,16514,16515
22688,2,258,254,256.00,4.00,16514,16516
22689,1,512,512,512.00,0.00,16515,16516
22690,2,388,124,256.00,17424.00,16515,16517
22691,3,285,67,170.67,7977.56,16516,16519
22692,1,512,512,512.00,0.00,16518,16519
22693,1,512,512,512.00,0.00,16518,16519
22694,2,442,70,256.00,34596.00,16518,16520
22695,1,512,512,512.00,0.00,16519,16520
22696,2,480,32,256.00,50176.00,16519,16521
22697,2,483,29,256.00,51529.00,16520,16522
22698,1,512,512,512.00,0.00,16521,16522
22699,1,512,512,512.00,0.00,16521,16522
22700,1,512,512,512.00,0.00,16521,16522
22701,2,299,213,256.00,1849.00,16521,16523
22702,1,512,512,512.00,0.00,16522,16523
22703,1,512,512,512.00,0.00,16522,16523
22704,1,512,512,512.00,0.00,16522,16523
22705,2,332,180,256.00,5776.00,16522,16524
22706,1,512,512,512.00,0.00,16523,16524
22707,1,512,512,512.00,0.00,16523,16524
22708,1,512,512,512.00,0.00,16523,16524
22709,3,486,2,170.67,49798.22,16523,16526
22710,2,460,52,256.00,41616.00,16525,16527
22711,1,512,512,512.00,0.00,16526,16527
22712,1,512,512,512.00,0.00,16526,16527
22713,2,361,151,256.00,11025.00,16526,16528
22714,2,256,256,256.00,0.00,16527,16529
22715,1,512,512,512.00,0.00,16528,16529
22716,1,512,512,512.00,0.00,16528,16529
22717,1,512,512,512.00,0.00,16528,16529
22718,2,400,112,256.00,20736.00,16528,16530
22719,3,188,148,170.67,280.89,16529,16532
22720,1,512,512,512.00,0.00,16531,16532
22721,1,512,512,512.00,0.00,16531,16532
22722,2,426,86,256.00,28900.00,16531,16533
22723,1,512,512,512.00,0.00,16532,16533
22724,1,512,512,512.00,0.00,16532,16533
22725,1,512,512,512.00,0.00,16532,16533
22726,1,512,512,512.00,0.00,16532,16533
22727,2,281,231,256.00,625.00,16532,16534
22728,1,512,512,512.00,0.00,16533,16534
22729,1,512,512,512.00,0.00,16533,16534
22730,1,512,512,512.00,0.00,16533,16534
22731,1,512,512,512.00,0.00,16533,16534
22732,1,512,512,512.00,0.00,16533,16534
22733,3,466,18,170.67,43627.56,16533,16536
22734,1,512,512,512.00,0.00,16535,16536
22735,2,331,181,256.00,5625.00,16535,16537
22736,1,512,512,512.00,0.00,16536,16537
22737,1,512,512,512.00,0.00,16536,16537
22738,2,279,233,256.00,529.00,16536,16538
22739,1,512,512,512.00,0.00,16537,16538
22740,3,360,14,170.67,20486.22,16537,16540
22741,1,512,512,512.00,0.00,16539,16540
22742,2,402,110,256.00,21316.00,16539,16541
22743,1,512,512,512.00,0.00,16540,16541
22744,1,512,512,512.00,0.00,16540,16541
22745,1,512,512,512.00,0.00,16540,16541
22746,1,512,512,512.00,0.00,16540,16541
22747,1,512,512,512.00,0.00,16540,16541
22748,4,198,56,128.00,4203.50,16540,16544
22749,1,512,512,512.00,0.00,16543,16544
22750,2,302,210,256.00,2116.00,16543,16545
22751,1,512,512,512.00,0.00,16544,16545
22752,1,512,512,512.00,0.00,16544,16545
22753,2,345,167,256.00,7921.00,16544,16546
22754,1,512,512,512.00,0.00,16545,16546
22755,3,497,3,170.67,53260.22,16545,16548
22756,1,512,512,512.00,0.00,16547,16548
22757,1,512,512,512.00,0.00,16547,16548
22758,2,288,224,256.00,1024.00,16547,16549
22759,1,512,512,512.00,0.00,16548,16549
22760,1,512,512,512.00,0.00,16548,16549
22761,1,512,512,512.00,0.00,16548,16549
22762,1,512,512,512.00,0.00,16548,16549
22763,1,512,512,512.00,0.00,16548,16549
22764,3,358,48,170.67,18107.56,16548,16551
22765,1,512,512,512.00,0.00,16550,16551
22766,2,285,227,256.00,841.00,16550,16552
22767,1,512,512,512.00,0.00,16551,16552
22768,3,324,74,170.67,12022.22,16551,16554
22769,2,453,59,256.00,38809.00,16553,16555
22770,1,512,512,512.00,0.00,16554,16555
22771,2,370,142,256.00,12996.00,16554,16556
22772,3,364,4,170.67,21955.56,16555,16558
22773,3,265,122,170.67,4450.89,16557,16560
22774,1,512,512,512.00,0.00,16559,16560
22775,3,385,28,170.67,23809.56,16559,16562
22776,1,512,512,512.00,0.00,16561,16562
22777,1,512,512,512.00,0.00,16561,16562
22778,1,512,512,512.00,0.00,16561,16562
22779,1,512,512,512.00,0.00,16561,16562
22780,1,512,512,512.00,0.00,16561,16562
22781,2,308,204,256.00,2704.00,16561,16563
22782,1,512,512,512.00,0.00,16562,16563
22783,1,512,512,512.00,0.00,16562,16563
22784,1,512,512,512.00,0.00,16562,16563
22785,1,512,512,512.00,0.00,16562,16563
22786,2,260,252,256.00,16.00,16562,16564
22787,1,512,512,512.00,0.00,16563,16564
22788,1,512,512,512.00,0.00,16563,16564
22789,2,492,20,256.00,55696.00,16563,16565
22790,1,512,512,512.00,0.00,16564,16565
22791,1,512,512,512.00,0.00,16564,16565
22792,1,512,512,512.00,0.00,16564,16565
22793,3,190,143,170.67,402.89,16564,16567
22794,2,457,55,256.00,40401.00,16566,16568
22795,5,436,6,102.40,27941.04,16567,16572
22796,1,512,512,512.00,0.00,16571,16572
22797,3,291,2,170.67,15088.22,16571,16574
22798,1,512,512,512.00,0.00,16573,16574
22799,2,363,149,256.00,11449.00,16573,16575
22800,2,409,103,256.00,23409.00,16574,16576
22801,1,512,512,512.00,0.00,16575,16576
22802,2,325,187,256.00,4761.00,16575,16577
22803,2,293,219,256.00,1369.00,16576,16578
22804,2,413,99,256.00,24649.00,16577,16579
22805,1,512,512,512.00,0.00,16578,16579
22806,1,512,512,512.00,0.00,16578,16579
22807,1,512,512,512.00,0.00,16578,16579
22808,2,378,134,256.00,14884.00,16578,16580
22809,2,352,160,256.00,9216.00,16579,16581
22810,1,512,512,512.00,0.00,16580,16581
22811,1,512,512,512.00,0.00,16580,16581
22812,2,463,49,256.00,42849.00,16580,16582
22813,5,175,19,102.40,2587.44,16581,16586
22814,1,512,512,512.00,0.00,16585,16586
22815,3,220,83,170.67,3862.89,16585,16588
22816,2,344,168,256.00,7744.00,16587,16589
22817,1,512,512,512.00,0.00,16588,16589
22818,1,512,512,512.00,0.00,16588,16589
22819,2,342,170,256.00,7396.00,16588,16590
22820,1,512,512,512.00,0.00,16589,16590
22821,1,512,512,512.00,0.00,16589,16590
22822,1,512,512,512.00,0.00,16589,16590
22823,4,239,18,128.00,6336.50,16589,16593
22824,2,456,56,256.00,40000.00,16592,16594
22825,1,512,512,512.00,0.00,16593,16594
22826,2,501,11,256.00,60025.00,16593,16595
22827,1,512,512,512.00,0.00,16594,16595
22828,2,365,147,256.00,11881.00,16594,16596
22829,2,449,63,256.00,37249.00,16595,16597
22830,2,449,63,256.00,37249.00,16596,16598
22831,2,460,52,256.00,41616.00,16597,16599
22832,3,473,3,170.67,45884.22,16598,16601
22833,1,512,512,512.00,0.00,16600,16601
22834,1,512,512,512.00,0.00,16600,16601
22835,1,512,512,512.00,0.00,16600,16601
22836,3,304,22,170.67,13371.56,16600,16603
22837,1,512,512,512.00,0.00,16602,16603
22838,1,512,512,512.00,0.00,16602,16603
22839,3,294,73,170.67,8469.56,16602,16605
22840,2,294,218,256.00,1444.00,16604,16606
22841,1,512,512,512.00,0.00,16605,16606
22842,1,512,512,512.00,0.00,16605,16606
22843,1,512,512,512.00,0.00,16605,16606
22844,2,468,44,256.00,44944.00,16605,16607
22845,4,365,5,128.00,20961.50,16606,16610
22846,1,512,512,512.00,0.00,16609,16610
22847,1,512,512,512.00,0.00,16609,16610
22848,2,427,85,256.00,29241.00,16609,16611
22849,1,512,512,512.00,0.00,16610,16611
22850,2,504,8,256.00,61504.00,16610,16612
22851,3,326,37,170.67,14154.89,16611,16614
22852,1,512,512,512.00,0.00,16613,16614
22853,1,512,512,512.00,0.00,16613,16614
22854,2,490,22,256.00,54756.00,16613,16615
22855,2,391,121,256.00,18225.00,16614,16616
22856,2,279,233,256.00,529.00,16615,16617
22857,1,512,512,512.00,0.00,16616,16617
22858,1,512,512,512.00,0.00,16616,16617
22859,1,512,512,512.00,0.00,16616,16617
22860,1,512,512,512.00,0.00,16616,16617
22861,2,324,188,256.00,4624.00,16616,16618
22862,1,512,512,512.00,0.00,16617,16618
22863,1,512,512,512.00,0.00,16617,16618
22864,1,512,512,512.00,0.00,16617,16618
22865,1,512,512,512.00,0.00,16617,16618
22866,5,240,1,102.40,10592.24,16617,16622
22867,1,512,512,512.00,0.00,16621,16622
22868,1,512,512,512.00,0.00,16621,16622
22869,2,456,56,256.00,40000.00,16621,16623
22870,1,512,512,512.00,0.00,16622,16623
22871,1,512,512,512.00,0.00,16622,16623
22872,2,388,124,256.00,17424.00,16622,16624
22873,2,493,19,256.00,56169.00,16623,16625
22874,2,399,113,256.00,20449.00,16624,16626
22875,2,313,199,256.00,3249.00,16625,16627
22876,1,512,512,512.00,0.00,16626,16627
22877,4,278,68,128.00,7545.50,16626,16630
22878,1,512,512,512.00,0.00,16629,16630
22879,1,512,512,512.00,0.00,16629,16630
22880,1,512,512,512.00,0.00,16629,16630
22881,1,512,512,512.00,0.00,16629,16630
22882,1,512,512,512.00,0.00,16629,16630
22883,3,365,15,170.67,21164.22,16629,16632
22884,2,429,83,256.00,29929.00,16631,16633
22885,1,512,512,512.00,0.00,16632,16633
22886,2,496,16,256.00,57600.00,16632,16634
22887,1,512,512,512.00,0.00,16633,16634
22888,1,512,512,512.00,0.00,16633,16634
22889,2,413,99,256.00,24649.00,16633,16635
22890,2,482,30,256.00,51076.00,16634,16636
22891,2,449,63,256.00,37249.00,16635,16637
22892,1,512,512,512.00,0.00,16636,16637
22893,1,512,512,512.00,0.00,16636,16637
22894,1,512,512,512.00,0.00,16636,16637
22895,1,512,512,512.00,0.00,16636,16637
22896,2,404,108,256.00,21904.00,16636,16638
22897,1,512,512,512.00,0.00,16637,16638
22898,1,512,512,512.00,0.00,16637,16638
22899,1,512,512,512.00,0.00,16637,16638
22900,2,295,217,256.00,1521.00,16637,16639
22901,1,512,512,512.00,0.00,16638,16639
22902,2,382,130,256.00,15876.00,16638,16640
22903,1,512,512,512.00,0.00,16639,16640
22904,1,512,512,512.00,0.00,16639,16640
22905,3,248,54,170.67,7046.22,16639,16642
22906,1,512,512,512.00,0.00,16641,16642
22907,1,512,512,512.00,0.00,16641,16642
22908,5,184,20,102.40,4343.04,16641,16646
22909,3,297,76,170.67,8641.56,16645,16648
22910,1,512,512,512.00,0.00,16647,16648
22911,1,512,512,512.00,0.00,16647,16648
22912,2,460,52,256.00,41616.00,16647,16649
22913,1,512,512,512.00,0.00,16648,16649
22914,1,512,512,512.00,0.00,16648,16649
22915,2,301,211,256.00,2025.00,16648,16650
22916,2,431,81,256.00,30625.00,16649,16651
22917,2,279,233,256.00,529.00,16650,16652
22918,1,512,512,512.00,0.00,16651,16652
22919,1,512,512,512.00,0.00,16651,16652
22920,1,512,512,512.00,0.00,16651,16652
22921,1,512,512,512.00,0.00,16651,16652
22922,3,214,116,170.67,1664.89,16651,16654
22923,1,512,512,512.00,0.00,16653,16654
22924,2,454,58,256.00,39204.00,16653,16655
22925,1,512,512,512.00,0.00,16654,16655
22926,1,512,512,512.00,0.00,16654,16655
22927,1,512,512,512.00,0.00,16654,16655
22928,2,357,155,256.00,10201.00,16654,16656
22929,1,512,512,512.00,0.00,16655,16656
22930,1,512,512,512.00,0.00,16655,16656
22931,1,512,512,512.00,0.00,16655,16656
22932,1,512,512,512.00,0.00,16655,16656
22933,1,512,512,512.00,0.00,16655,16656
22934,3,472,2,170.67,45616.89,16655,16658
22935,2,422,90,256.00,27556.00,16657,16659
22936,1,512,512,512.00,0.00,16658,16659
22937,1,512,512,512.00,0.00,16658,16659
22938,2,269,243,256.00,169.00,16658,16660
22939,1,512,512,512.00,0.00,16659,16660
22940,1,512,512,512.00,0.00,16659,16660
22941,1,512,512,512.00,0.00,16659,16660
22942,3,317,1,170.67,16914.89,16659,16662
22943,3,236,106,170.67,2816.89,16661,16664
22944,1,512,512,512.00,0.00,16663,16664
22945,1,512,512,512.00,0.00,16663,16664
22946,1,512,512,512.00,0.00,16663,16664
22947,3,446,26,170.67,37936.89,16663,16666
22948,2,314,198,256.00,3364.00,16665,16667
22949,1,512,512,512.00,0.00,16666,16667
22950,1,512,512,512.00,0.00,16666,16667
22951,2,457,55,256.00,40401.00,16666,16668
22952,1,512,512,512.00,0.00,16667,16668
22953,1,512,512,512.00,0.00,16667,16668
22954,1,512,512,512.00,0.00,16667,16668
22955,1,512,512,512.00,0.00,16667,16668
22956,2,409,103,256.00,23409.00,16667,16669
22957,1,512,512,512.00,0.00,16668,16669
22958,1,512,512,512.00,0.00,16668,16669
22959,2,451,61,256.00,38025.00,16668,16670
22960,2,431,81,256.00,30625.00,16669,16671
22961,1,512,512,512.00,0.00,16670,16671
22962,1,512,512,512.00,0.00,16670,16671
22963,2,390,122,256.00,17956.00,16670,16672
22964,2,288,224,256.00,1024.00,16671,16673
22965,1,512,512,512.00,0.00,16672,16673
22966,1,512,512,512.00,0.00,16672,16673
22967,2,424,88,256.00,28224.00,16672,16674
22968,1,512,512,512.00,0.00,16673,16674
22969,3,245,128,170.67,2782.89,16673,16676
22970,2,260,252,256.00,16.00,16675,16677
22971,3,495,3,170.67,52616.22,16676,16679
22972,2,395,117,256.00,19321.00,16678,16680
22973,1,512,512,512.00,0.00,16679,16680
22974,1,512,512,512.00,0.00,16679,16680
22975,2,285,227,256.00,841.00,16679,16681
22976,1,512,512,512.00,0.00,16680,16681
22977,1,512,512,512.00,0.00,16680,16681
22978,1,512,512,512.00,0.00,16680,16681
22979,1,512,512,512.00,0.00,16680,16681
22980,6,390,2,85.33,18861.22,16680,16686
22981,3,374,21,170.67,22208.22,16685,16688
22982,1,512,512,512.00,0.00,16687,16688
22983,2,470,42,256.00,45796.00,16687,16689
22984,1,512,512,512.00,0.00,16688,16689
22985,3,340,3,170.67,18929.56,16688,16691
22986,1,512,512,512.00,0.00,16690,16691
22987,1,512,512,512.00,0.00,16690,16691
22988,1,512,512,512.00,0.00,16690,16691
22989,2,328,184,256.00,5184.00,16690,16692
22990,1,512,512,512.00,0.00,16691,16692
22991,2,423,89,256.00,27889.00,16691,16693
22992,1,512,512,512.00,0.00,16692,16693
22993,1,512,512,512.00,0.00,16692,16693
22994,1,512,512,512.00,0.00,16692,16693
22995,5,192,8,102.40,5199.44,16692,16697
22996,1,512,512,512.00,0.00,16696,16697
22997,1,512,512,512.00,0.00,16696,16697
22998,1,512,512,512.00,0.00,16696,16697
22999,4,219,40,128.00,4472.50,16696,16700
23000,1,512,512,512.00,0.00,16699,16700
23001,1,512,512,512.00,0.00,16699,16700
23002,1,512,512,512.00,0.00,16699,16700
23003,2,264,248,256.00,64.00,16699,16701
23004,1,512,512,512.00,0.00,16700,16701
23005,2,264,248,256.00,64.00,16700,16702
23006,1,512,512,512.00,0.00,16701,16702
23007,1,512,512,512.00,0.00,16701,16702
23008,1,512,512,512.00,0.00,16701,16702
23009,1,512,512,512.00,0.00,16701,16702
23010,1,512,512,512.00,0.00,16701,16702
23011,2,270,242,256.00,196.00,16701,16703
23012,1,512,512,512.00,0.00,16702,16703
23013,1,512,512,512.00,0.00,16702,16703
23014,1,512,512,512.00,0.00,16702,16703
23015,2,342,170,256.00,7396.00,16702,16704
23016,3,362,34,170.67,19424.89,16703,16706
23017,2,433,79,256.00,31329.00,16705,16707
23018,1,512,512,512.00,0.00,16706,16707
23019,2,458,54,256.00,40804.00,16706,16708
23020,2,459,53,256.00,41209.00,16707,16709
23021,1,512,512,512.00,0.00,16708,16709
23022,1,512,512,512.00,0.00,16708,16709
23023,1,512,512,512.00,0.00,16708,16709
23024,2,295,217,256.00,1521.00,16708,16710
23025,2,315,197,256.00,3481.00,16709,16711
23026,1,512,512,512.00,0.00,16710,16711
23027,2,421,91,256.00,27225.00,16710,16712
23028,1,512,512,512.00,0.00,16711,16712
23029,1,512,512,512.00,0.00,16711,16712
23030,1,512,512,512.00,0.00,16711,16712
23031,1,512,512,512.00,0.00,16711,16712
23032,2,302,210,256.00,2116.00,16711,16713
23033,1,512,512,512.00,0.00,16712,16713
23034,1,512,512,512.00,0.00,16712,16713
23035,2,354,158,256.00,9604.00,16712,16714
23036,1,512,512,512.00,0.00,16713,16714
23037,3,371,53,170.67,20270.89,16713,16716
23038,1,512,512,512.00,0.00,16715,16716
23039,1,512,512,512.00,0.00,16715,16716
23040,1,512,512,512.00,0.00,16715,16716
23041,2,478,34,256.00,49284.00,16715,16717
23042,1,512,512,512.00,0.00,16716,16717
23043,2,383,129,256.00,16129.00,16716,16718
23044,1,512,512,512.00,0.00,16717,16718
23045,1,512,512,512.00,0.00,16717,16718
23046,1,512,512,512.00,0.00,16717,16718
23047,1,512,512,512.00,0.00,16717,16718
23048,2,355,157,256.00,9801.00,16717,16719
23049,1,512,512,512.00,0.00,16718,16719
23050,1,512,512,512.00,0.00,16718,16719
23051,1,512,512,512.00,0.00,16718,16719
23052,3,284,34,170.67,10688.89,16718,16721
23053,4,457,5,128.00,36147.50,16720,16724
23054,1,512,512,512.00,0.00,16723,16724
23055,2,395,117,256.00,19321.00,16723,16725
23056,3,401,43,170.67,26630.89,16724,16727
23057,5,283,4,102.40,10931.44,16726,16731
23058,1,512,512,512.00,0.00,16730,16731
23059,1,512,512,512.00,0.00,16730,16731
23060,1,512,512,512.00,0.00,16730,16731
23061,3,260,5,170.67,13750.89,16730,16733
23062,3,190,152,170.67,240.89,16732,16735
23063,1,512,512,512.00,0.00,16734,16735
23064,5,201,2,102.40,6535.04,16734,16739
23065,1,512,512,512.00,0.00,16738,16739
23066,1,512,512,512.00,0.00,16738,16739
23067,1,512,512,512.00,0.00,16738,16739
23068,1,512,512,512.00,0.00,16738,16739
23069,2,466,46,256.00,44100.00,16738,16740
23070,1,512,512,512.00,0.00,16739,16740
23071,2,343,169,256.00,7569.00,16739,16741
23072,1,512,512,512.00,0.00,16740,16741
23073,1,512,512,512.00,0.00,16740,16741
23074,3,422,36,170.67,31638.22,16740,16743
23075,1,512,512,512.00,0.00,16742,16743
23076,2,270,242,256.00,196.00,16742,16744
23077,2,315,197,256.00,3481.00,16743,16745
23078,2,374,138,256.00,13924.00,16744,16746
23079,1,512,512,512.00,0.00,16745,16746
23080,1,512,512,512.00,0.00,16745,16746
23081,1,512,512,512.00,0.00,16745,16746
23082,1,512,512,512.00,0.00,16745,16746
23083,2,303,209,256.00,2209.00,16745,16747
23084,1,512,512,512.00,0.00,16746,16747
23085,1,512,512,512.00,0.00,16746,16747
23086,2,258,254,256.00,4.00,16746,16748
23087,1,512,512,512.00,0.00,16747,16748
23088,3,351,2,170.67,20368.22,16747,16750
23089,1,512,512,512.00,0.00,16749,16750
23090,2,393,119,256.00,18769.00,16749,16751
23091,3,423,24,170.67,32116.22,16750,16753
23092,2,445,67,256.00,35721.00,16752,16754
23093,1,512,512,512.00,0.00,16753,16754
23094,1,512,512,512.00,0.00,16753,16754
23095,2,404,108,256.00,21904.00,16753,16755
23096,1,512,512,512.00,0.00,16754,16755
23097,3,339,75,170.67,14256.22,16754,16757
23098,2,323,189,256.00,4489.00,16756,16758
23099,1,512,512,512.00,0.00,16757,16758
23100,1,512,512,512.00,0.00,16757,16758
23101,1,512,512,512.00,0.00,16757,16758
23102,3,253,76,170.67,5297.56,16757,16760
23103,1,512,512,512.00,0.00,16759,16760
23104,1,512,512,512.00,0.00,16759,16760
23105,1,512,512,512.00,0.00,16759,16760
23106,2,381,131,256.00,15625.00,16759,16761
23107,1,512,512,512.00,0.00,16760,16761
23108,1,512,512,512.00,0.00,16760,16761
23109,1,512,512,512.00,0.00,16760,16761
23110,1,512,512,512.00,0.00,16760,16761
23111,1,512,512,512.00,0.00,16760,16761
23112,2,374,138,256.00,13924.00,16760,16762
23113,1,512,512,512.00,0.00,16761,16762
23114,1,512,512,512.00,0.00,16761,16762
23115,1,512,512,512.00,0.00,16761,16762
23116,1,512,512,512.00,0.00,16761,16762
23117,1,512,512,512.00,0.00,16761,16762
23118,4,269,39,128.00,7601.00,16761,16765
23119,1,512,512,512.00,0.00,16764,16765
23120,1,512,512,512.00,0.00,16764,16765
23121,1,512,512,512.00,0.00,16764,16765
23122,2,413,99,256.00,24649.00,16764,16766
23123,2,355,157,256.00,9801.00,16765,16767
23124,2,281,231,256.00,625.00,16766,16768
23125,1,512,512,512.00,0.00,16767,16768
23126,3,379,38,170.67,22242.89,16767,16770
23127,4,274,59,128.00,7270.50,16769,16773
23128,1,512,512,512.00,0.00,16772,16773
23129,1,512,512,512.00,0.00,16772,16773
23130,1,512,512,512.00,0.00,16772,16773
23131,1,512,512,512.00,0.00,16772,16773
23132,5,153,13,102.40,2867.44,16772,16777
23133,3,358,30,170.67,19019.56,16776,16779
23134,1,512,512,512.00,0.00,16778,16779
23135,2,467,45,256.00,44521.00,16778,16780
23136,1,512,512,512.00,0.00,16779,16780
23137,1,512,512,512.00,0.00,16779,16780
23138,1,512,512,512.00,0.00,16779,16780
23139,2,310,202,256.00,2916.00,16779,16781
23140,1,512,512,512.00,0.00,16780,16781
23141,3,346,10,170.67,18923.56,16780,16783
23142,2,450,62,256.00,37636.00,16782,16784
23143,1,512,512,512.00,0.00,16783,16784
23144,1,512,512,512.00,0.00,16783,16784
23145,3,347,17,170.67,18406.89,16783,16786
23146,1,512,512,512.00,0.00,16785,16786
23147,4,194,15,128.00,4935.50,16785,16789
23148,3,193,150,170.67,309.56,16788,16791
23149,1,512,512,512.00,0.00,16790,16791
23150,1,512,512,512.00,0.00,16790,16791
23151,2,508,4,256.00,63504.00,16790,16792
23152,3,383,34,170.67,23162.89,16791,16794
23153,3,216,135,170.67,1140.22,16793,16796
23154,2,389,123,256.00,17689.00,16795,16797
23155,1,512,512,512.00,0.00,16796,16797
23156,2,380,132,256.00,15376.00,16796,16798
23157,1,512,512,512.00,0.00,16797,16798
23158,1,512,512,512.00,0.00,16797,16798
23159,1,512,512,512.00,0.00,16797,16798
23160,1,512,512,512.00,0.00,16797,16798
23161,1,512,512,512.00,0.00,16797,16798
23162,2,281,231,256.00,625.00,16797,16799
23163,1,512,512,512.00,0.00,16798,16799
23164,1,512,512,512.00,0.00,16798,16799
23165,2,345,167,256.00,7921.00,16798,16800
23166,1,512,512,512.00,0.00,16799,16800
23167,1,512,512,512.00,0.00,16799,16800
23168,1,512,512,512.00,0.00,16799,16800
23169,2,411,101,256.00,24025.00,16799,16801
23170,1,512,512,512.00,0.00,16800,16801
23171,2,348,164,256.00,8464.00,16800,16802
23172,2,297,215,256.00,1681.00,16801,16803
23173,1,512,512,512.00,0.00,16802,16803
23174,1,512,512,512.00,0.00,16802,16803
23175,3,309,43,170.67,11849.56,16802,16805
23176,2,287,225,256.00,961.00,16804,16806
23177,1,512,512,512.00,0.00,16805,16806
23178,1,512,512,512.00,0.00,16805,16806
23179,3,278,71,170.67,7170.89,16805,16808
23180,1,512,512,512.00,0.00,16807,16808
23181,2,410,102,256.00,23716.00,16807,16809
23182,1,512,512,512.00,0.00,16808,16809
23183,1,512,512,512.00,0.00,16808,16809
23184,1,512,512,512.00,0.00,16808,16809
23185,1,512,512,512.00,0.00,16808,16809
23186,3,489,8,170.67,50676.22,16808,16811
23187,1,512,512,512.00,0.00,16810,16811
23188,1,512,512,512.00,0.00,16810,16811
23189,1,512,512,512.00,0.00,16810,16811
23190,1,512,512,512.00,0.00,16810,16811
23191,1,512,512,512.00,0.00,16810,16811
23192,3,282,13,170.67,13133.56,16810,16813
23193,2,333,179,256.00,5929.00,16812,16814
23194,1,512,512,512.00,0.00,16813,16814
23195,1,512,512,512.00,0.00,16813,16814
23196,2,290,222,256.00,1156.00,16813,16815
23197,3,438,2,170.67,36550.22,16814,16817
23198,1,512,512,512.00,0.00,16816,16817
23199,1,512,512,512.00,0.00,16816,16817
23200,2,305,207,256.00,2401.00,16816,16818
23201,1,512,512,512.00,0.00,16817,16818
23202,1,512,512,512.00,0.00,16817,16818
23203,1,512,512,512.00,0.00,16817,16818
23204,2,359,153,256.00,10609.00,16817,16819
23205,1,512,512,512.00,0.00,16818,16819
23206,1,512,512,512.00,0.00,16818,16819
23207,1,512,512,512.00,0.00,16818,16819
23208,1,512,512,512.00,0.00,16818,16819
23209,2,434,78,256.00,31684.00,16818,16820
23210,1,512,512,512.00,0.00,16819,16820
23211,1,512,512,512.00,0.00,16819,16820
23212,2,456,56,256.00,40000.00,16819,16821
23213,1,512,512,512.00,0.00,16820,16821
23214,1,512,512,512.00,0.00,16820,16821
23215,1,512,512,512.00,0.00,16820,16821
23216,1,512,512,512.00,0.00,16820,16821
23217,2,338,174,256.00,6724.00,16820,16822
23218,1,512,512,512.00,0.00,16821,16822
23219,1,512,512,512.00,0.00,16821,16822
23220,1,512,512,512.00,0.00,16821,16822
23221,1,512,512,512.00,0.00,16821,16822
23222,2,429,83,256.00,29929.00,16821,16823
23223,4,228,24,128.00,6130.50,16822,16826
23224,1,512,512,512.00,0.00,16825,16826
23225,1,512,512,512.00,0.00,16825,16826
23226,2,293,219,256.00,1369.00,16825,16827
23227,1,512,512,512.00,0.00,16826,16827
23228,1,512,512,512.00,0.00,16826,16827
23229,1,512,512,512.00,0.00,16826,16827
23230,1,512,512,512.00,0.00,16826,16827
23231,3,341,32,170.67,16414.89,16826,16829
23232,1,512,512,512.00,0.00,16828,16829
23233,1,512,512,512.00,0.00,16828,16829
23234,1,512,512,512.00,0.00,16828,16829
23235,1,512,512,512.00,0.00,16828,16829
23236,1,512,512,512.00,0.00,16828,16829
23237,1,512,512,512.00,0.00,16828,16829
23238,2,348,164,256.00,8464.00,16828,16830
23239,1,512,512,512.00,0.00,16829,16830
23240,2,431,81,256.00,30625.00,16829,16831
23241,2,387,125,256.00,17161.00,16830,16832
23242,2,258,254,256.00,4.00,16831,16833
23243,1,512,512,512.00,0.00,16833,16834
23244,1,512,512,512.00,0.00,16833,16834
23245,6,280,4,85.33,8872.22,16833,16839
23246,3,308,97,170.67,9446.89,16838,16841
23247,1,512,512,512.00,0.00,16840,16841
23248,2,435,77,256.00,32041.00,16840,16842
23249,3,434,28,170.67,34752.89,16841,16844
23250,1,512,512,512.00,0.00,16843,16844
23251,3,299,40,170.67,11182.89,16843,16846
23252,1,512,512,512.00,0.00,16845,16846
23253,3,459,12,170.67,41708.22,16845,16848
23254,1,512,512,512.00,0.00,16847,16848
23255,1,512,512,512.00,0.00,16847,16848
23256,3,403,28,170.67,27457.56,16847,16850
23257,4,270,4,128.00,15197.50,16849,16853
23258,1,512,512,512.00,0.00,16852,16853
23259,1,512,512,512.00,0.00,16852,16853
23260,1,512,512,512.00,0.00,16852,16853
23261,1,512,512,512.00,0.00,16852,16853
23262,1,512,512,512.00,0.00,16852,16853
23263,4,413,3,128.00,27540.50,16852,16856
23264,1,512,512,512.00,0.00,16855,16856
23265,3,365,9,170.67,21656.22,16855,16858
23266,1,512,512,512.00,0.00,16857,16858
23267,1,512,512,512.00,0.00,16857,16858
23268,1,512,512,512.00,0.00,16857,16858
23269,2,355,157,256.00,9801.00,16857,16859
23270,2,415,97,256.00,25281.00,16858,16860
23271,1,512,512,512.00,0.00,16859,16860
23272,2,447,65,256.00,36481.00,16859,16861
23273,1,512,512,512.00,0.00,16860,16861
23274,1,512,512,512.00,0.00,16860,16861
23275,5,386,8,102.40,20261.04,16860,16865
23276,3,421,10,170.67,32173.56,16864,16867
23277,1,512,512,512.00,0.00,16866,16867
23278,2,343,169,256.00,7569.00,16866,16868
23279,1,512,512,512.00,0.00,16867,16868
23280,4,355,30,128.00,17769.50,16867,16871
23281,1,512,512,512.00,0.00,16870,16871
23282,1,512,512,512.00,0.00,16870,16871
23283,3,430,36,170.67,33643.56,16870,16873
23284,1,512,512,512.00,0.00,16872,16873
23285,1,512,512,512.00,0.00,16872,16873
23286,1,512,512,512.00,0.00,16872,16873
23287,1,512,512,512.00,0.00,16872,16873
23288,3,375,64,170.67,20889.56,16872,16875
23289,1,512,512,512.00,0.00,16874,16875
23290,1,512,512,512.00,0.00,16874,16875
23291,3,357,13,170.67,20133.56,16874,16877
23292,1,512,512,512.00,0.00,16876,16877
23293,1,512,512,512.00,0.00,16876,16877
23294,1,512,512,512.00,0.00,16876,16877
23295,1,512,512,512.00,0.00,16876,16877
23296,1,512,512,512.00,0.00,16876,16877
23297,2,444,68,256.00,35344.00,16876,16878
23298,2,351,161,256.00,9025.00,16877,16879
23299,1,512,512,512.00,0.00,16878,16879
23300,1,512,512,512.00,0.00,16878,16879
23301,1,512,512,512.00,0.00,16878,16879
23302,1,512,512,512.00,0.00,16878,16879
23303,2,469,43,256.00,45369.00,16878,16880
23304,1,512,512,512.00,0.00,16879,16880
23305,2,458,54,256.00,40804.00,16879,16881
23306,1,512,512,512.00,0.00,16880,16881
23307,2,485,27,256.00,52441.00,16880,16882
23308,1,512,512,512.00,0.00,16881,16882
23309,1,512,512,512.00,0.00,16881,16882
23310,2,399,113,256.00,20449.00,16881,16883
23311,1,512,512,512.00,0.00,16882,16883
23312,2,444,68,256.00,35344.00,16882,16884
23313,1,512,512,512.00,0.00,16883,16884
23314,1,512,512,512.00,0.00,16883,16884
23315,2,286,226,256.00,900.00,16883,16885
23316,1,512,512,512.00,0.00,16884,16885
23317,1,512,512,512.00,0.00,16884,16885
23318,3,272,5,170.67,13950.89,16884,16887
23319,1,512,512,512.00,0.00,16886,16887
23320,1,512,512,512.00,0.00,16886,16887
23321,2,383,129,256.00,16129.00,16886,16888
23322,5,271,20,102.40,8693.04,16887,16892
23323,2,457,55,256.00,40401.00,16891,16893
23324,2,294,218,256.00,1444.00,16892,16894
23325,1,512,512,512.00,0.00,16893,16894
23326,3,389,14,170.67,25338.89,16893,16896
23327,1,512,512,512.00,0.00,16895,16896
23328,1,512,512,512.00,0.00,16895,16896
23329,1,512,512,512.00,0.00,16895,16896
23330,1,512,512,512.00,0.00,16895,16896
23331,1,512,512,512.00,0.00,16895,16896
23332,2,441,71,256.00,34225.00,16895,16897
23333,2,315,197,256.00,3481.00,16896,16898
23334,4,349,8,128.00,17788.50,16897,16901
23335,1,512,512,512.00,0.00,16900,16901
23336,1,512,512,512.00,0.00,16900,16901
23337,1,512,512,512.00,0.00,16900,16901
23338,1,512,512,512.00,0.00,16900,16901
23339,2,275,237,256.00,361.00,16900,16902
23340,6,413,3,85.33,21606.89,16901,16907
23341,2,442,70,256.00,34596.00,16906,16908
23342,1,512,512,512.00,0.00,16907,16908
23343,1,512,512,512.00,0.00,16907,16908
23344,2,416,96,256.00,25600.00,16907,16909
23345,1,512,512,512.00,0.00,16908,16909
23346,1,512,512,512.00,0.00,16908,16909
23347,1,512,512,512.00,0.00,16908,16909
23348,2,463,49,256.00,42849.00,16908,16910
23349,3,379,62,170.67,21714.89,16909,16912
23350,1,512,512,512.00,0.00,16911,16912
23351,1,512,512,512.00,0.00,16911,16912
23352,1,512,512,512.00,0.00,16911,16912
23353,4,234,16,128.00,5949.50,16911,16915
23354,1,512,512,512.00,0.00,16914,16915
23355,1,512,512,512.00,0.00,16914,16915
23356,2,446,66,256.00,36100.00,16914,16916
23357,1,512,512,512.00,0.00,16915,16916
23358,1,512,512,512.00,0.00,16915,16916
23359,1,512,512,512.00,0.00,16915,16916
23360,4,254,6,128.00,10734.00,16915,16919
23361,4,273,2,128.00,9648.50,16918,16922
23362,1,512,512,512.00,0.00,16921,16922
23363,1,512,512,512.00,0.00,16921,16922
23364,2,495,17,256.00,57121.00,16921,16923
23365,3,232,125,170.67,2030.89,16922,16925
23366,4,323,11,128.00,14489.00,16925,16929
23367,1,512,512,512.00,0.00,16928,16929
23368,1,512,512,512.00,0.00,16928,16929
23369,5,161,33,102.40,3153.44,16928,16933
23370,2,458,54,256.00,40804.00,16932,16934
23371,1,512,512,512.00,0.00,16933,16934
23372,3,311,61,170.67,10886.89,16933,16936
23373,1,512,512,512.00,0.00,16935,16936
23374,1,512,512,512.00,0.00,16935,16936
23375,2,411,101,256.00,24025.00,16935,16937
23376,2,257,255,256.00,1.00,16936,16938
23377,1,512,512,512.00,0.00,16937,16938
23378,1,512,512,512.00,0.00,16937,16938
23379,1,512,512,512.00,0.00,16937,16938
23380,1,512,512,512.00,0.00,16937,16938
23381,2,295,217,256.00,1521.00,16937,16939
23382,1,512,512,512.00,0.00,16938,16939
23383,1,512,512,512.00,0.00,16938,16939
23384,1,512,512,512.00,0.00,16938,16939
23385,3,308,31,170.67,12790.89,16938,16941
23386,5,362,4,102.40,17729.04,16940,16945
23387,1,512,512,512.00,0.00,16944,16945
23388,2,376,136,256.00,14400.00,16944,16946
23389,1,512,512,512.00,0.00,16945,16946
23390,1,512,512,512.00,0.00,16945,16946
23391,2,373,139,256.00,13689.00,16945,16947
23392,2,470,42,256.00,45796.00,16946,16948
23393,1,512,512,512.00,0.00,16947,16948
23394,1,512,512,512.00,0.00,16947,16948
23395,1,512,512,512.00,0.00,16947,16948
23396,3,243,112,170.67,2953.56,16947,16950
23397,1,512,512,512.00,0.00,16949,16950
23398,1,512,512,512.00,0.00,16949,16950
23399,1,512,512,512.00,0.00,16949,16950
23400,1,512,512,512.00,0.00,16949,16950
23401,1,512,512,512.00,0.00,16949,16950
23402,2,493,19,256.00,56169.00,16949,16951
23403,3,263,1,170.67,14430.89,16950,16953
23404,1,512,512,512.00,0.00,16952,16953
23405,1,512,512,512.00,0.00,16952,16953
23406,1,512,512,512.00,0.00,16952,16953
23407,1,512,512,512.00,0.00,16952,16953
23408,2,467,45,256.00,44521.00,16952,16954
23409,1,512,512,512.00,0.00,16953,16954
23410,2,455,57,256.00,39601.00,16953,16955
23411,1,512,512,512.00,0.00,16954,16955
23412,1,512,512,512.00,0.00,16954,16955
23413,2,390,122,256.00,17956.00,16954,16956
23414,2,269,243,256.00,169.00,16955,16957
23415,2,281,231,256.00,625.00,16956,16958
23416,2,468,44,256.00,44944.00,16957,16959
23417,2,414,98,256.00,24964.00,16958,16960
23418,1,512,512,512.00,0.00,16959,16960
23419,1,512,512,512.00,0.00,16959,16960
23420,1,512,512,512.00,0.00,16959,16960
23421,1,512,512,512.00,0.00,16959,16960
23422,4,257,27,128.00,7913.00,16959,16963
23423,1,512,512,512.00,0.00,16962,16963
23424,5,443,3,102.40,29123.84,16962,16967
23425,1,512,512,512.00,0.00,16966,16967
23426,1,512,512,512.00,0.00,16966,16967
23427,1,512,512,512.00,0.00,16966,16967
23428,3,462,11,170.67,42568.22,16966,16969
23429,2,453,59,256.00,38809.00,16968,16970
23430,1,512,512,512.00,0.00,16969,16970
23431,1,512,512,512.00,0.00,16969,16970
23432,2,500,12,256.00,59536.00,16969,16971
23433,1,512,512,512.00,0.00,16970,16971
23434,1,512,512,512.00,0.00,16970,16971
23435,1,512,512,512.00,0.00,16970,16971
23436,2,410,102,256.00,23716.00,16970,16972
23437,1,512,512,512.00,0.00,16971,16972
23438,2,409,103,256.00,23409.00,16971,16973
23439,2,336,176,256.00,6400.00,16972,16974
23440,1,512,512,512.00,0.00,16973,16974
23441,2,426,86,256.00,28900.00,16973,16975
23442,1,512,512,512.00,0.00,16974,16975
23443,1,512,512,512.00,0.00,16974,16975
23444,1,512,512,512.00,0.00,16974,16975
23445,1,512,512,512.00,0.00,16974,16975
23446,3,402,49,170.67,26781.56,16974,16977
23447,2,480,32,256.00,50176.00,16976,16978
23448,1,512,512,512.00,0.00,16977,16978
23449,1,512,512,512.00,0.00,16977,16978
23450,1,512,512,512.00,0.00,16977,16978
23451,2,304,208,256.00,2304.00,16977,16979
23452,1,512,512,512.00,0.00,16978,16979
23453,5,273,15,102.40,8423.04,16978,16983
23454,1,512,512,512.00,0.00,16982,16983
23455,2,309,203,256.00,2809.00,16982,16984
23456,1,512,512,512.00,0.00,16983,16984
23457,1,512,512,512.00,0.00,16983,16984
23458,1,512,512,512.00,0.00,16983,16984
23459,2,259,253,256.00,9.00,16983,16985
23460,1,512,512,512.00,0.00,16984,16985
23461,1,512,512,512.00,0.00,16984,16985
23462,1,512,512,512.00,0.00,16984,16985
23463,1,512,512,512.00,0.00,16984,16985
23464,1,512,512,512.00,0.00,16984,16985
23465,1,512,512,512.00,0.00,16984,16985
23466,2,372,140,256.00,13456.00,16984,16986
23467,2,407,105,256.00,22801.00,16985,16987
23468,1,512,512,512.00,0.00,16986,16987
23469,1,512,512,512.00,0.00,16986,16987
23470,1,512,512,512.00,0.00,16986,16987
23471,2,420,92,256.00,26896.00,16986,16988
23472,3,314,63,170.67,11136.22,16987,16990
23473,6,174,3,85.33,2867.56,16989,16995
23474,1,512,512,512.00,0.00,16994,16995
23475,2,331,181,256.00,5625.00,16994,16996
23476,1,512,512,512.00,0.00,16995,16996
23477,2,283,229,256.00,729.00,16995,16997
23478,1,512,512,512.00,0.00,16996,16997
23479,1,512,512,512.00,0.00,16996,16997
23480,1,512,512,512.00,0.00,16996,16997
23481,1,512,512,512.00,0.00,16996,16997
23482,1,512,512,512.00,0.00,16996,16997
23483,1,512,512,512.00,0.00,16996,16997
23484,2,265,247,256.00,81.00,16996,16998
23485,1,512,512,512.00,0.00,16997,16998
23486,1,512,512,512.00,0.00,16997,16998
23487,1,512,512,512.00,0.00,16997,16998
23488,1,512,512,512.00,0.00,16997,16998
23489,3,232,139,170.67,1881.56,16997,17000
23490,1,512,512,512.00,0.00,16999,17000
23491,2,400,112,256.00,20736.00,16999,17001
23492,4,264,9,128.00,13660.50,17000,17004
23493,1,512,512,512.00,0.00,17003,17004
23494,1,512,512,512.00,0.00,17003,17004
23495,2,363,149,256.00,11449.00,17003,17005
23496,1,512,512,512.00,0.00,17004,17005
23497,1,512,512,512.00,0.00,17004,17005
23498,5,231,1,102.40,5765.44,17004,17009
23499,2,438,74,256.00,33124.00,17008,17010
23500,1,512,512,512.00,0.00,17009,17010
23501,2,360,152,256.00,10816.00,17009,17011
23502,2,258,254,256.00,4.00,17010,17012
23503,3,332,1,170.67,18294.89,17011,17014
23504,1,512,512,512.00,0.00,17013,17014
23505,1,512,512,512.00,0.00,17013,17014
23506,1,512,512,512.00,0.00,17013,17014
23507,4,283,40,128.00,8756.50,17013,17017
23508,1,512,512,512.00,0.00,17016,17017
23509,1,512,512,512.00,0.00,17016,17017
23510,1,512,512,512.00,0.00,17016,17017
23511,1,512,512,512.00,0.00,17016,17017
23512,3,262,33,170.67,9813.56,17016,17019
23513,2,503,9,256.00,61009.00,17018,17020
23514,1,512,512,512.00,0.00,17019,17020
23515,1,512,512,512.00,0.00,17019,17020
23516,1,512,512,512.00,0.00,17019,17020
23517,3,327,1,170.67,17801.56,17019,17022
23518,1,512,512,512.00,0.00,17021,17022
23519,1,512,512,512.00,0.00,17021,17022
23520,1,512,512,512.00,0.00,17021,17022
23521,2,461,51,256.00,42025.00,17021,17023
23522,2,333,179,256.00,5929.00,17022,17024
23523,2,431,81,256.00,30625.00,17023,17025
23524,1,512,512,512.00,0.00,17024,17025
23525,1,512,512,512.00,0.00,17024,17025
23526,1,512,512,512.00,0.00,17024,17025
23527,1,512,512,512.00,0.00,17024,17025
23528,2,355,157,256.00,9801.00,17024,17026
23529,2,380,132,256.00,15376.00,17025,17027
23530,1,512,512,512.00,0.00,17026,17027
23531,1,512,512,512.00,0.00,17026,17027
23532,3,451,19,170.67,39381.56,17026,17029
23533,1,512,512,512.00,0.00,17028,17029
23534,4,333,10,128.00,15038.50,17028,17032
23535,3,280,23,170.67,11742.89,17031,17034
23536,6,172,4,85.33,4411.22,17033,17039
23537,1,512,512,512.00,0.00,17038,17039
23538,2,365,147,256.00,11881.00,17038,17040
23539,1,512,512,512.00,0.00,17039,17040
23540,1,512,512,512.00,0.00,17039,17040
23541,3,388,5,170.67,25782.89,17039,17042
23542,2,390,122,256.00,17956.00,17041,17043
23543,1,512,512,512.00,0.00,17042,17043
23544,2,504,8,256.00,61504.00,17042,17044
23545,1,512,512,512.00,0.00,17043,17044
23546,2,402,110,256.00,21316.00,17043,17045
23547,1,512,512,512.00,0.00,17044,17045
23548,1,512,512,512.00,0.00,17044,17045
23549,1,512,512,512.00,0.00,17044,17045
23550,1,512,512,512.00,0.00,17044,17045
23551,6,164,3,85.33,3538.22,17044,17050
23552,1,512,512,512.00,0.00,17049,17050
23553,2,314,198,256.00,3364.00,17049,17051
23554,1,512,512,512.00,0.00,17050,17051
23555,1,512,512,512.00,0.00,17050,17051
23556,4,346,2,128.00,17128.50,17050,17054
23557,2,291,221,256.00,1225.00,17053,17055
23558,1,512,512,512.00,0.00,17054,17055
23559,1,512,512,512.00,0.00,17054,17055
23560,1,512,512,512.00,0.00,17054,17055
23561,1,512,512,512.00,0.00,17054,17055
23562,2,465,47,256.00,43681.00,17054,17056
23563,1,512,512,512.00,0.00,17055,17056
23564,3,382,43,170.67,22653.56,17055,17058
23565,1,512,512,512.00,0.00,17057,17058
23566,1,512,512,512.00,0.00,17057,17058
23567,2,397,115,256.00,19881.00,17057,17059
23568,1,512,512,512.00,0.00,17058,17059
23569,2,510,2,256.00,64516.00,17058,17060
23570,1,512,512,512.00,0.00,17059,17060
23571,1,512,512,512.00,0.00,17059,17060
23572,1,512,512,512.00,0.00,17059,17060
23573,1,512,512,512.00,0.00,17059,17060
23574,2,391,121,256.00,18225.00,17059,17061
23575,3,385,1,170.67,25573.56,17060,17063
23576,1,512,512,512.00,0.00,17062,17063
23577,1,512,512,512.00,0.00,17062,17063
23578,1,512,512,512.00,0.00,17062,17063
23579,2,335,177,256.00,6241.00,17062,17064
23580,1,512,512,512.00,0.00,17063,17064
23581,1,512,512,512.00,0.00,17063,17064
23582,1,512,512,512.00,0.00,17063,17064
23583,5,332,2,102.40,14813.04,17063,17068
23584,1,512,512,512.00,0.00,17067,17068
23585,2,290,222,256.00,1156.00,17067,17069
23586,1,512,512,512.00,0.00,17068,17069
23587,2,484,28,256.00,51984.00,17068,17070
23588,3,324,51,170.67,12988.22,17069,17072
23589,1,512,512,512.00,0.00,17071,17072
23590,1,512,512,512.00,0.00,17071,17072
23591,2,352,160,256.00,9216.00,17071,17073
23592,1,512,512,512.00,0.00,17072,17073
23593,3,184,145,170.67,329.56,17072,17075
23594,1,512,512,512.00,0.00,17074,17075
23595,1,512,512,512.00,0.00,17074,17075
23596,1,512,512,512.00,0.00,17074,17075
23597,3,400,42,170.67,26427.56,17074,17077
23598,3,498,2,170.67,53590.22,17076,17079
23599,1,512,512,512.00,0.00,17078,17079
23600,1,512,512,512.00,0.00,17078,17079
23601,2,387,125,256.00,17161.00,17078,17080
23602,2,359,153,256.00,10609.00,17079,17081
23603,3,362,3,170.67,21760.22,17080,17083
23604,1,512,512,512.00,0.00,17082,17083
23605,1,512,512,512.00,0.00,17082,17083
23606,1,512,512,512.00,0.00,17082,17083
23607,3,202,116,170.67,1504.89,17082,17085
23608,1,512,512,512.00,0.00,17084,17085
23609,1,512,512,512.00,0.00,17084,17085
23610,2,360,152,256.00,10816.00,17084,17086
23611,2,509,3,256.00,64009.00,17085,17087
23612,1,512,512,512.00,0.00,17086,17087
23613,3,315,2,170.67,16624.22,17086,17089
23614,4,180,39,128.00,2837.50,17088,17092
23615,2,488,24,256.00,53824.00,17091,17093
23616,1,512,512,512.00,0.00,17092,17093
23617,1,512,512,512.00,0.00,17092,17093
23618,5,246,10,102.40,7379.44,17092,17097
23619,1,512,512,512.00,0.00,17096,17097
23620,1,512,512,512.00,0.00,17096,17097
23621,2,475,37,256.00,47961.00,17096,17098
23622,1,512,512,512.00,0.00,17097,17098
23623,2,433,79,256.00,31329.00,17097,17099
23624,6,272,2,85.33,9751.22,17098,17104
23625,1,512,512,512.00,0.00,17103,17104
23626,1,512,512,512.00,0.00,17103,17104
23627,6,375,2,85.33,17267.22,17103,17109
23628,2,414,98,256.00,24964.00,17108,17110
23629,1,512,512,512.00,0.00,17109,17110
23630,1,512,512,512.00,0.00,17109,17110
23631,3,308,60,170.67,10606.22,17109,17112
23632,1,512,512,512.00,0.00,17111,17112
23633,1,512,512,512.00,0.00,17111,17112
23634,2,283,229,256.00,729.00,17111,17113
23635,2,374,138,256.00,13924.00,17112,17114
23636,1,512,512,512.00,0.00,17113,17114
23637,1,512,512,512.00,0.00,17113,17114
23638,1,512,512,512.00,0.00,17113,17114
23639,1,512,512,512.00,0.00,17113,17114
23640,2,322,190,256.00,4356.00,17113,17115
23641,1,512,512,512.00,0.00,17114,17115
23642,3,343,2,170.67,19386.89,17114,17117
23643,3,194,143,170.67,442.89,17116,17119
23644,5,203,11,102.40,4816.24,17118,17123
23645,1,512,512,512.00,0.00,17122,17123
23646,1,512,512,512.00,0.00,17122,17123
23647,1,512,512,512.00,0.00,17122,17123
23648,1,512,512,512.00,0.00,17122,17123
23649,7,415,2,73.14,19529.27,17122,17129
23650,1,512,512,512.00,0.00,17128,17129
23651,1,512,512,512.00,0.00,17128,17129
23652,4,342,19,128.00,16427.50,17128,17132
23653,2,277,235,256.00,441.00,17131,17133
23654,2,295,217,256.00,1521.00,17132,17134
23655,1,512,512,512.00,0.00,17133,17134
23656,1,512,512,512.00,0.00,17133,17134
23657,2,367,145,256.00,12321.00,17133,17135
23658,1,512,512,512.00,0.00,17134,17135
23659,1,512,512,512.00,0.00,17134,17135
23660,5,291,15,102.40,10048.64,17134,17139
23661,1,512,512,512.00,0.00,17138,17139
23662,1,512,512,512.00,0.00,17138,17139
23663,3,278,11,170.67,13250.89,17138,17141
23664,2,480,32,256.00,50176.00,17140,17142
23665,2,400,112,256.00,20736.00,17141,17143
23666,1,512,512,512.00,0.00,17142,17143
23667,2,394,118,256.00,19044.00,17142,17144
23668,1,512,512,512.00,0.00,17143,17144
23669,1,512,512,512.00,0.00,17143,17144
23670,1,512,512,512.00,0.00,17143,17144
23671,3,232,65,170.67,5630.89,17143,17146
23672,1,512,512,512.00,0.00,17145,17146
23673,1,512,512,512.00,0.00,17145,17146
23674,1,512,512,512.00,0.00,17145,17146
23675,5,301,12,102.40,10926.24,17145,17150
23676,3,377,4,170.67,23974.89,17149,17152
23677,1,512,512,512.00,0.00,17151,17152
23678,4,253,4,128.00,13421.50,17151,17155
23679,1,512,512,512.00,0.00,17154,17155
23680,3,326,26,170.67,15056.89,17154,17157
23681,1,512,512,512.00,0.00,17156,17157
23682,1,512,512,512.00,0.00,17156,17157
23683,1,512,512,512.00,0.00,17156,17157
23684,1,512,512,512.00,0.00,17156,17157
23685,1,512,512,512.00,0.00,17156,17157
23686,1,512,512,512.00,0.00,17156,17157
23687,3,464,24,170.67,43022.22,17156,17159
23688,1,512,512,512.00,0.00,17158,17159
23689,1,512,512,512.00,0.00,17158,17159
23690,4,304,4,128.00,16344.00,17158,17162
23691,2,419,93,256.00,26569.00,17161,17163
23692,1,512,512,512.00,0.00,17162,17163
23693,5,190,16,102.40,4948.24,17162,17167
23694,3,285,78,170.67,7376.22,17166,17169
23695,1,512,512,512.00,0.00,17168,17169
23696,2,451,61,256.00,38025.00,17168,17170
23697,2,507,5,256.00,63001.00,17169,17171
23698,3,452,1,170.67,40134.89,17170,17173
23699,2,493,19,256.00,56169.00,17172,17174
23700,1,512,512,512.00,0.00,17173,17174
23701,1,512,512,512.00,0.00,17173,17174
23702,3,262,100,170.67,4587.56,17173,17176
23703,1,512,512,512.00,0.00,17175,17176
23704,3,396,29,170.67,25948.22,17175,17178
23705,2,308,204,256.00,2704.00,17177,17179
23706,1,512,512,512.00,0.00,17178,17179
23707,2,399,113,256.00,20449.00,17178,17180
23708,1,512,512,512.00,0.00,17179,17180
23709,1,512,512,512.00,0.00,17179,17180
23710,1,512,512,512.00,0.00,17179,17180
23711,1,512,512,512.00,0.00,17179,17180
23712,6,176,4,85.33,4766.56,17179,17185
23713,3,242,30,170.67,9894.22,17184,17187
23714,6,269,3,85.33,8859.56,17186,17192
23715,1,512,512,512.00,0.00,17191,17192
23716,1,512,512,512.00,0.00,17191,17192
23717,1,512,512,512.00,0.00,17191,17192
23718,2,481,31,256.00,50625.00,17191,17193
23719,2,332,180,256.00,5776.00,17192,17194
23720,1,512,512,512.00,0.00,17193,17194
23721,1,512,512,512.00,0.00,17193,17194
23722,3,230,79,170.67,4322.89,17193,17196
23723,1,512,512,512.00,0.00,17195,17196
23724,2,466,46,256.00,44100.00,17195,17197
23725,1,512,512,512.00,0.00,17196,17197
23726,3,497,1,170.67,53274.89,17196,17199
23727,2,382,130,256.00,15876.00,17198,17200
23728,1,512,512,512.00,0.00,17199,17200
23729,3,259,119,170.67,3938.89,17199,17202
23730,4,447,12,128.00,33991.50,17201,17205
23731,7,381,2,73.14,15956.41,17204,17211
23732,5,182,11,102.40,4616.24,17210,17215
23733,1,512,512,512.00,0.00,17214,17215
23734,1,512,512,512.00,0.00,17214,17215
23735,1,512,512,512.00,0.00,17214,17215
23736,2,323,189,256.00,4489.00,17214,17216
23737,3,240,66,170.67,5670.22,17215,17218
23738,1,512,512,512.00,0.00,17217,17218
23739,2,333,179,256.00,5929.00,17217,17219
23740,2,337,175,256.00,6561.00,17218,17220
23741,1,512,512,512.00,0.00,17219,17220
23742,1,512,512,512.00,0.00,17219,17220
23743,1,512,512,512.00,0.00,17219,17220
23744,1,512,512,512.00,0.00,17219,17220
23745,1,512,512,512.00,0.00,17219,17220
23746,2,257,255,256.00,1.00,17219,17221
23747,1,512,512,512.00,0.00,17220,17221
23748,2,315,197,256.00,3481.00,17220,17222
23749,1,512,512,512.00,0.00,17221,17222
23750,2,330,182,256.00,5476.00,17221,17223
23751,3,216,82,170.67,3931.56,17222,17225
23752,2,441,71,256.00,34225.00,17224,17226
23753,1,512,512,512.00,0.00,17225,17226
23754,1,512,512,512.00,0.00,17225,17226
23755,3,322,10,170.67,16267.56,17225,17228
23756,1,512,512,512.00,0.00,17228,17229
23757,2,260,252,256.00,16.00,17228,17230
23758,2,335,177,256.00,6241.00,17229,17231
23759,2,456,56,256.00,40000.00,17230,17232
23760,1,512,512,512.00,0.00,17231,17232
23761,2,457,55,256.00,40401.00,17231,17233
23762,4,268,12,128.00,13640.50,17232,17236
23763,1,512,512,512.00,0.00,17235,17236
23764,2,319,193,256.00,3969.00,17235,17237
23765,1,512,512,512.00,0.00,17236,17237
23766,1,512,512,512.00,0.00,17236,17237
23767,1,512,512,512.00,0.00,17236,17237
23768,3,337,73,170.67,13973.56,17236,17239
23769,1,512,512,512.00,0.00,17238,17239
23770,2,479,33,256.00,49729.00,17238,17240
23771,3,369,10,170.67,22189.56,17239,17242
23772,3,276,62,170.67,7638.22,17241,17244
23773,1,512,512,512.00,0.00,17243,17244
23774,1,512,512,512.00,0.00,17243,17244
23775,1,512,512,512.00,0.00,17243,17244
23776,2,259,253,256.00,9.00,17243,17245
23777,1,512,512,512.00,0.00,17244,17245
23778,1,512,512,512.00,0.00,17244,17245
23779,4,439,1,128.00,32809.00,17244,17248
23780,1,512,512,512.00,0.00,17247,17248
23781,1,512,512,512.00,0.00,17247,17248
23782,5,279,9,102.40,8928.64,17247,17252
23783,5,398,4,102.40,22728.24,17251,17256
23784,1,512,512,512.00,0.00,17255,17256
23785,1,512,512,512.00,0.00,17255,17256
23786,1,512,512,512.00,0.00,17255,17256
23787,1,512,512,512.00,0.00,17255,17256
23788,1,512,512,512.00,0.00,17255,17256
23789,4,200,48,128.00,2988.50,17255,17259
23790,3,215,95,170.67,2890.89,17258,17261
23791,1,512,512,512.00,0.00,17260,17261
23792,1,512,512,512.00,0.00,17260,17261
23793,2,491,21,256.00,55225.00,17260,17262
23794,2,487,25,256.00,53361.00,17261,17263
23795,1,512,512,512.00,0.00,17262,17263
23796,1,512,512,512.00,0.00,17262,17263
23797,3,417,7,170.67,31433.56,17262,17265
23798,2,258,254,256.00,4.00,17264,17266
23799,1,512,512,512.00,0.00,17265,17266
23800,6,202,6,85.33,5827.22,17265,17271
23801,1,512,512,512.00,0.00,17270,17271
23802,2,437,75,256.00,32761.00,17270,17272
23803,1,512,512,512.00,0.00,17271,17272
23804,2,298,214,256.00,1764.00,17271,17273
23805,4,357,20,128.00,18066.50,17272,17276
23806,4,322,5,128.00,17649.50,17275,17279
23807,1,512,512,512.00,0.00,17278,17279
23808,5,207,20,102.40,5582.24,17278,17283
23809,2,280,232,256.00,576.00,17282,17284
23810,3,409,7,170.67,29721.56,17283,17286
23811,2,405,107,256.00,22201.00,17285,17287
23812,1,512,512,512.00,0.00,17286,17287
23813,2,357,155,256.00,10201.00,17286,17288
23814,1,512,512,512.00,0.00,17287,17288
23815,3,331,35,170.67,14906.89,17287,17290
23816,1,512,512,512.00,0.00,17289,17290
23817,1,512,512,512.00,0.00,17289,17290
23818,2,280,232,256.00,576.00,17289,17291
23819,1,512,512,512.00,0.00,17290,17291
23820,1,512,512,512.00,0.00,17290,17291
23821,1,512,512,512.00,0.00,17290,17291
23822,2,452,60,256.00,38416.00,17290,17292
23823,1,512,512,512.00,0.00,17291,17292
23824,1,512,512,512.00,0.00,17291,17292
23825,1,512,512,512.00,0.00,17291,17292
23826,1,512,512,512.00,0.00,17291,17292
23827,1,512,512,512.00,0.00,17291,17292
23828,1,512,512,512.00,0.00,17291,17292
23829,3,295,89,170.67,7982.89,17291,17294
23830,2,390,122,256.00,17956.00,17293,17295
23831,1,512,512,512.00,0.00,17294,17295
23832,2,349,163,256.00,8649.00,17294,17296
23833,1,512,512,512.00,0.00,17295,17296
23834,2,468,44,256.00,44944.00,17295,17297
23835,1,512,512,512.00,0.00,17296,17297
23836,1,512,512,512.00,0.00,17296,17297
23837,2,455,57,256.00,39601.00,17296,17298
23838,1,512,512,512.00,0.00,17297,17298
23839,1,512,512,512.00,0.00,17297,17298
23840,5,340,4,102.40,16568.64,17297,17302
23841,3,210,97,170.67,2717.56,17301,17304
23842,1,512,512,512.00,0.00,17303,17304
23843,1,512,512,512.00,0.00,17303,17304
23844,6,182,15,85.33,3776.56,17303,17309
23845,5,283,4,102.40,11015.44,17308,17313
23846,1,512,512,512.00,0.00,17312,17313
23847,1,512,512,512.00,0.00,17312,17313
23848,1,512,512,512.00,0.00,17312,17313
23849,2,392,120,256.00,18496.00,17312,17314
23850,1,512,512,512.00,0.00,17313,17314
23851,1,512,512,512.00,0.00,17313,17314
23852,1,512,512,512.00,0.00,17313,17314
23853,2,405,107,256.00,22201.00,17313,17315
23854,1,512,512,512.00,0.00,17314,17315
23855,1,512,512,512.00,0.00,17314,17315
23856,1,512,512,512.00,0.00,17314,17315
23857,1,512,512,512.00,0.00,17314,17315
23858,2,326,186,256.00,4900.00,17314,17316
23859,1,512,512,512.00,0.00,17315,17316
23860,1,512,512,512.00,0.00,17315,17316
23861,1,512,512,512.00,0.00,17315,17316
23862,1,512,512,512.00,0.00,17315,17316
23863,1,512,512,512.00,0.00,17315,17316
23864,3,480,14,170.67,47846.22,17315,17318
23865,3,331,68,170.67,13190.89,17317,17320
23866,2,474,38,256.00,47524.00,17319,17321
23867,4,312,15,128.00,14701.50,17320,17324
23868,3,338,2,170.67,18816.89,17323,17326
23869,7,201,1,73.14,4540.41,17325,17332
23870,4,439,6,128.00,32619.50,17331,17335
23871,3,374,1,170.67,23754.89,17334,17337
23872,1,512,512,512.00,0.00,17336,17337
23873,2,472,40,256.00,46656.00,17336,17338
23874,1,512,512,512.00,0.00,17337,17338
23875,1,512,512,512.00,0.00,17337,17338
23876,2,508,4,256.00,63504.00,17337,17339
23877,6,344,1,85.33,14664.22,17338,17344
23878,4,384,2,128.00,24265.50,17343,17347
23879,1,512,512,512.00,0.00,17346,17347
23880,3,417,35,170.67,30444.22,17346,17349
23881,4,229,1,128.00,6739.00,17348,17352
23882,1,512,512,512.00,0.00,17351,17352
23883,1,512,512,512.00,0.00,17351,17352
23884,5,407,3,102.40,23515.84,17351,17356
23885,2,389,123,256.00,17689.00,17355,17357
23886,2,348,164,256.00,8464.00,17356,17358
23887,2,309,203,256.00,2809.00,17357,17359
23888,3,478,4,170.67,47339.56,17358,17361
23889,1,512,512,512.00,0.00,17360,17361
23890,1,512,512,512.00,0.00,17360,17361
23891,1,512,512,512.00,0.00,17360,17361
23892,1,512,512,512.00,0.00,17360,17361
23893,1,512,512,512.00,0.00,17360,17361
23894,1,512,512,512.00,0.00,17360,17361
23895,1,512,512,512.00,0.00,17360,17361
23896,2,412,100,256.00,24336.00,17360,17362
23897,1,512,512,512.00,0.00,17361,17362
23898,4,215,53,128.00,3497.00,17361,17365
23899,1,512,512,512.00,0.00,17364,17365
23900,1,512,512,512.00,0.00,17364,17365
23901,3,272,3,170.67,14260.22,17364,17367
23902,4,219,34,128.00,6425.50,17366,17370
23903,1,512,512,512.00,0.00,17369,17370
23904,1,512,512,512.00,0.00,17369,17370
23905,1,512,512,512.00,0.00,17369,17370
23906,1,512,512,512.00,0.00,17369,17370
23907,2,462,50,256.00,42436.00,17369,17371
23908,2,396,116,256.00,19600.00,17370,17372
23909,1,512,512,512.00,0.00,17371,17372
23910,2,384,128,256.00,16384.00,17371,17373
23911,4,357,3,128.00,20818.50,17372,17376
23912,1,512,512,512.00,0.00,17375,17376
23913,1,512,512,512.00,0.00,17375,17376
23914,1,512,512,512.00,0.00,17375,17376
23915,1,512,512,512.00,0.00,17375,17376
23916,7,256,1,73.14,7336.69,17375,17382
23917,1,512,512,512.00,0.00,17381,17382
23918,2,347,165,256.00,8281.00,17381,17383
23919,1,512,512,512.00,0.00,17382,17383
23920,1,512,512,512.00,0.00,17382,17383
23921,2,449,63,256.00,37249.00,17382,17384
23922,1,512,512,512.00,0.00,17383,17384
23923,1,512,512,512.00,0.00,17383,17384
23924,1,512,512,512.00,0.00,17383,17384
23925,2,497,15,256.00,58081.00,17383,17385
23926,1,512,512,512.00,0.00,17384,17385
23927,3,469,5,170.67,44682.89,17384,17387
23928,1,512,512,512.00,0.00,17386,17387
23929,1,512,512,512.00,0.00,17386,17387
23930,3,438,24,170.67,35846.22,17386,17389
23931,1,512,512,512.00,0.00,17388,17389
23932,2,426,86,256.00,28900.00,17388,17390
23933,1,512,512,512.00,0.00,17389,17390
23934,1,512,512,512.00,0.00,17389,17390
23935,1,512,512,512.00,0.00,17389,17390
23936,4,374,1,128.00,23076.50,17389,17393
23937,1,512,512,512.00,0.00,17392,17393
23938,1,512,512,512.00,0.00,17392,17393
23939,1,512,512,512.00,0.00,17392,17393
23940,1,512,512,512.00,0.00,17392,17393
23941,1,512,512,512.00,0.00,17392,17393
23942,4,385,11,128.00,22697.00,17392,17396
23943,4,147,111,128.00,163.00,17395,17399
23944,1,512,512,512.00,0.00,17398,17399
23945,1,512,512,512.00,0.00,17398,17399
23946,1,512,512,512.00,0.00,17398,17399
23947,1,512,512,512.00,0.00,17398,17399
23948,1,512,512,512.00,0.00,17398,17399
23949,1,512,512,512.00,0.00,17398,17399
23950,1,512,512,512.00,0.00,17398,17399
23951,1,512,512,512.00,0.00,17398,17399
23952,1,512,512,512.00,0.00,17398,17399
23953,3,313,75,170.67,10529.56,17398,17401
23954,5,276,25,102.40,8346.64,17400,17405
23955,4,285,11,128.00,13146.50,17404,17408
23956,6,299,1,85.33,10353.89,17407,17413
23957,1,512,512,512.00,0.00,17412,17413
23958,1,512,512,512.00,0.00,17412,17413
23959,1,512,512,512.00,0.00,17412,17413
23960,1,512,512,512.00,0.00,17412,17413
23961,1,512,512,512.00,0.00,17412,17413
23962,6,184,2,85.33,5372.89,17412,17418
23963,1,512,512,512.00,0.00,17417,17418
23964,1,512,512,512.00,0.00,17417,17418
23965,2,339,173,256.00,6889.00,17417,17419
23966,1,512,512,512.00,0.00,17418,17419
23967,1,512,512,512.00,0.00,17418,17419
23968,8,145,10,64.00,2813.50,17418,17426
23969,6,233,7,85.33,5652.22,17425,17431
23970,1,512,512,512.00,0.00,17430,17431
23971,1,512,512,512.00,0.00,17430,17431
23972,1,512,512,512.00,0.00,17430,17431
23973,2,498,14,256.00,58564.00,17430,17432
23974,1,512,512,512.00,0.00,17431,17432
23975,3,381,50,170.67,22280.22,17431,17434
23976,3,351,20,170.67,18700.22,17433,17436
23977,3,378,13,170.67,23437.56,17435,17438
23978,1,512,512,512.00,0.00,17437,17438
23979,1,512,512,512.00,0.00,17437,17438
23980,2,471,41,256.00,46225.00,17437,17439
23981,2,345,167,256.00,7921.00,17438,17440
23982,4,261,1,128.00,8639.50,17439,17443
23983,1,512,512,512.00,0.00,17442,17443
23984,7,258,2,73.14,8155.55,17442,17449
23985,3,457,13,170.67,41133.56,17448,17451
23986,4,221,1,128.00,7539.50,17450,17454
23987,1,512,512,512.00,0.00,17453,17454
23988,7,247,1,73.14,9822.41,17453,17460
23989,4,419,6,128.00,28761.50,17459,17463
23990,1,512,512,512.00,0.00,17462,17463
23991,1,512,512,512.00,0.00,17462,17463
23992,3,326,77,170.67,12234.89,17462,17465
23993,4,324,2,128.00,17970.00,17464,17468
23994,1,512,512,512.00,0.00,17467,17468
23995,2,346,166,256.00,8100.00,17467,17469
23996,1,512,512,512.00,0.00,17468,17469
23997,1,512,512,512.00,0.00,17468,17469
23998,2,388,124,256.00,17424.00,17468,17470
23999,1,512,512,512.00,0.00,17469,17470
24000,1,512,512,512.00,0.00,17469,17470
24001,1,512,512,512.00,0.00,17469,17470
24002,2,279,233,256.00,529.00,17469,17471
24003,1,512,512,512.00,0.00,17470,17471
24004,2,429,83,256.00,29929.00,17470,17472
24005,5,214,1,102.40,7885.84,17471,17476
24006,2,283,229,256.00,729.00,17475,17477
24007,3,379,47,170.67,21954.89,17476,17479
24008,1,512,512,512.00,0.00,17478,17479
24009,5,228,1,102.40,8293.04,17478,17483
24010,3,411,25,170.67,29313.56,17482,17485
24011,1,512,512,512.00,0.00,17484,17485
24012,3,414,4,170.67,30955.56,17484,17487
24013,3,366,68,170.67,19094.22,17486,17489
24014,9,308,2,56.89,8534.10,17488,17497
24015,2,443,69,256.00,34969.00,17496,17498
24016,1,512,512,512.00,0.00,17497,17498
24017,2,260,252,256.00,16.00,17497,17499
24018,1,512,512,512.00,0.00,17498,17499
24019,1,512,512,512.00,0.00,17498,17499
24020,3,418,6,170.67,31707.56,17498,17501
24021,1,512,512,512.00,0.00,17500,17501
24022,4,324,2,128.00,17798.00,17500,17504
24023,6,384,3,85.33,19160.89,17503,17509
24024,1,512,512,512.00,0.00,17508,17509
24025,1,512,512,512.00,0.00,17508,17509
24026,1,512,512,512.00,0.00,17508,17509
24027,1,512,512,512.00,0.00,17508,17509
24028,4,230,68,128.00,3806.00,17508,17512
24029,1,512,512,512.00,0.00,17511,17512
24030,2,438,74,256.00,33124.00,17511,17513
24031,1,512,512,512.00,0.00,17512,17513
24032,2,265,247,256.00,81.00,17512,17514
24033,1,512,512,512.00,0.00,17513,17514
24034,1,512,512,512.00,0.00,17513,17514
24035,1,512,512,512.00,0.00,17513,17514
24036,1,512,512,512.00,0.00,17513,17514
24037,4,479,2,128.00,41097.50,17513,17517
24038,3,364,43,170.67,19329.56,17516,17519
24039,1,512,512,512.00,0.00,17518,17519
24040,1,512,512,512.00,0.00,17518,17519
24041,2,384,128,256.00,16384.00,17518,17520
24042,2,428,84,256.00,29584.00,17519,17521
24043,1,512,512,512.00,0.00,17520,17521
24044,1,512,512,512.00,0.00,17520,17521
24045,1,512,512,512.00,0.00,17520,17521
24046,2,422,90,256.00,27556.00,17520,17522
24047,1,512,512,512.00,0.00,17521,17522
24048,1,512,512,512.00,0.00,17521,17522
24049,3,431,8,170.67,34590.89,17521,17524
24050,1,512,512,512.00,0.00,17523,17524
24051,2,415,97,256.00,25281.00,17523,17525
24052,1,512,512,512.00,0.00,17524,17525
24053,1,512,512,512.00,0.00,17524,17525
24054,2,511,1,256.00,65025.00,17524,17526
24055,4,455,15,128.00,35653.50,17525,17529
24056,3,250,23,170.67,10922.89,17528,17531
24057,1,512,512,512.00,0.00,17530,17531
24058,7,225,3,73.14,8405.55,17530,17537
24059,4,300,6,128.00,13414.00,17536,17540
24060,3,453,2,170.67,40360.22,17539,17542
24061,2,484,28,256.00,51984.00,17541,17543
24062,1,512,512,512.00,0.00,17542,17543
24063,2,417,95,256.00,25921.00,17542,17544
24064,4,280,17,128.00,11767.50,17543,17547
24065,3,460,13,170.67,41969.56,17546,17549
24066,1,512,512,512.00,0.00,17548,17549
24067,3,251,87,170.67,4488.22,17548,17551
24068,3,483,1,170.67,48897.56,17550,17553
24069,1,512,512,512.00,0.00,17552,17553
24070,8,174,24,64.00,2102.00,17552,17560
24071,3,351,46,170.67,17053.56,17559,17562
24072,1,512,512,512.00,0.00,17561,17562
24073,1,512,512,512.00,0.00,17561,17562
24074,1,512,512,512.00,0.00,17561,17562
24075,1,512,512,512.00,0.00,17561,17562
24076,2,480,32,256.00,50176.00,17561,17563
24077,8,321,1,64.00,10275.75,17562,17570
24078,7,201,12,73.14,4394.12,17569,17576
24079,5,290,1,102.40,15840.24,17575,17580
24080,1,512,512,512.00,0.00,17579,17580
24081,3,437,28,170.67,35526.89,17579,17582
24082,5,423,3,102.40,26153.44,17581,17586
24083,1,512,512,512.00,0.00,17585,17586
24084,3,311,45,170.67,11900.22,17585,17588
24085,1,512,512,512.00,0.00,17587,17588
24086,1,512,512,512.00,0.00,17587,17588
24087,3,398,54,170.67,25846.22,17587,17590
24088,1,512,512,512.00,0.00,17589,17590
24089,2,325,187,256.00,4761.00,17589,17591
24090,1,512,512,512.00,0.00,17590,17591
24091,1,512,512,512.00,0.00,17590,17591
24092,3,349,2,170.67,20114.89,17590,17593
24093,1,512,512,512.00,0.00,17592,17593
24094,1,512,512,512.00,0.00,17592,17593
24095,1,512,512,512.00,0.00,17592,17593
24096,1,512,512,512.00,0.00,17592,17593
24097,7,225,2,73.14,7795.84,17592,17599
24098,5,414,1,102.40,25007.04,17598,17603
24099,1,512,512,512.00,0.00,17602,17603
24100,1,512,512,512.00,0.00,17602,17603
24101,10,153,1,51.20,2271.36,17602,17612
24102,2,448,64,256.00,36864.00,17611,17613
24103,1,512,512,512.00,0.00,17612,17613
24104,2,396,116,256.00,19600.00,17612,17614
24105,1,512,512,512.00,0.00,17613,17614
24106,1,512,512,512.00,0.00,17613,17614
24107,2,292,220,256.00,1296.00,17613,17615
24108,1,512,512,512.00,0.00,17614,17615
24109,3,398,1,170.67,27930.89,17614,17617
24110,2,450,62,256.00,37636.00,17616,17618
24111,3,268,2,170.67,14336.89,17617,17620
24112,1,512,512,512.00,0.00,17619,17620
24113,1,512,512,512.00,0.00,17619,17620
24114,2,283,229,256.00,729.00,17619,17621
24115,1,512,512,512.00,0.00,17620,17621
24116,1,512,512,512.00,0.00,17620,17621
24117,2,474,38,256.00,47524.00,17620,17622
24118,2,280,232,256.00,576.00,17621,17623
24119,2,458,54,256.00,40804.00,17622,17624
24120,1,512,512,512.00,0.00,17623,17624
24121,1,512,512,512.00,0.00,17623,17624
24122,1,512,512,512.00,0.00,17623,17624
24123,4,378,4,128.00,23135.50,17623,17627
24124,1,512,512,512.00,0.00,17626,17627
24125,1,512,512,512.00,0.00,17626,17627
24126,1,512,512,512.00,0.00,17626,17627
24127,1,512,512,512.00,0.00,17626,17627
24128,5,271,31,102.40,8451.04,17626,17631
24129,3,423,20,170.67,32236.22,17630,17633
24130,2,326,186,256.00,4900.00,17632,17634
24131,1,512,512,512.00,0.00,17633,17634
24132,2,433,79,256.00,31329.00,17633,17635
24133,1,512,512,512.00,0.00,17634,17635
24134,9,247,1,56.89,6479.65,17634,17643
24135,1,512,512,512.00,0.00,17642,17643
24136,1,512,512,512.00,0.00,17642,17643
24137,1,512,512,512.00,0.00,17642,17643
24138,6,223,2,85.33,7252.56,17642,17648
24139,1,512,512,512.00,0.00,17647,17648
24140,3,270,26,170.67,10950.22,17647,17650
24141,3,249,19,170.67,11505.56,17649,17652
24142,4,293,46,128.00,9363.50,17651,17655
24143,1,512,512,512.00,0.00,17654,17655
24144,3,283,76,170.67,7297.56,17654,17657
24145,7,172,3,73.14,4376.41,17656,17663
24146,1,512,512,512.00,0.00,17662,17663
24147,3,247,26,170.67,10474.89,17662,17665
24148,2,446,66,256.00,36100.00,17664,17666
24149,3,334,36,170.67,15211.56,17665,17668
24150,2,408,104,256.00,23104.00,17667,17669
24151,1,512,512,512.00,0.00,17668,17669
24152,4,274,62,128.00,7278.50,17668,17672
24153,1,512,512,512.00,0.00,17671,17672
24154,1,512,512,512.00,0.00,17671,17672
24155,5,284,9,102.40,10295.44,17671,17676
24156,4,302,4,128.00,12117.50,17675,17679
24157,1,512,512,512.00,0.00,17678,17679
24158,1,512,512,512.00,0.00,17678,17679
24159,1,512,512,512.00,0.00,17678,17679
24160,2,374,138,256.00,13924.00,17678,17680
24161,1,512,512,512.00,0.00,17679,17680
24162,1,512,512,512.00,0.00,17679,17680
24163,1,512,512,512.00,0.00,17679,17680
24164,2,397,115,256.00,19881.00,17679,17681
24165,2,302,210,256.00,2116.00,17680,17682
24166,1,512,512,512.00,0.00,17681,17682
24167,1,512,512,512.00,0.00,17681,17682
24168,1,512,512,512.00,0.00,17681,17682
24169,1,512,512,512.00,0.00,17681,17682
24170,2,351,161,256.00,9025.00,17681,17683
24171,5,292,8,102.40,11628.24,17682,17687
24172,1,512,512,512.00,0.00,17686,17687
24173,3,365,67,170.67,18910.89,17686,17689
24174,3,398,25,170.67,26522.89,17688,17691
24175,1,512,512,512.00,0.00,17690,17691
24176,1,512,512,512.00,0.00,17690,17691
24177,1,512,512,512.00,0.00,17690,17691
24178,2,319,193,256.00,3969.00,17690,17692
24179,5,254,3,102.40,11902.64,17691,17696
24180,4,227,63,128.00,4043.00,17695,17699
24181,1,512,512,512.00,0.00,17698,17699
24182,8,181,1,64.00,4786.25,17698,17706
24183,3,305,90,170.67,9144.22,17705,17708
24184,4,250,4,128.00,14765.50,17707,17711
24185,1,512,512,512.00,0.00,17710,17711
24186,9,189,2,56.89,5436.54,17710,17719
24187,1,512,512,512.00,0.00,17718,17719
24188,4,356,2,128.00,19147.50,17718,17722
24189,1,512,512,512.00,0.00,17721,17722
24190,1,512,512,512.00,0.00,17721,17722
24191,6,294,2,85.33,10355.22,17721,17727
24192,1,512,512,512.00,0.00,17726,17727
24193,1,512,512,512.00,0.00,17726,17727
24194,2,261,251,256.00,25.00,17726,17728
24195,1,512,512,512.00,0.00,17727,17728
24196,5,248,9,102.40,7571.44,17727,17732
24197,2,407,105,256.00,22801.00,17731,17733
24198,4,379,1,128.00,23752.50,17732,17736
24199,1,512,512,512.00,0.00,17735,17736
24200,1,512,512,512.00,0.00,17735,17736
24201,1,512,512,512.00,0.00,17735,17736
24202,3,302,1,170.67,15834.89,17735,17738
24203,1,512,512,512.00,0.00,17737,17738
24204,1,512,512,512.00,0.00,17737,17738
24205,4,315,17,128.00,13385.00,17737,17741
24206,2,293,219,256.00,1369.00,17740,17742
24207,1,512,512,512.00,0.00,17741,17742
24208,1,512,512,512.00,0.00,17741,17742
24209,2,291,221,256.00,1225.00,17741,17743
24210,1,512,512,512.00,0.00,17742,17743
24211,3,461,24,170.67,42148.22,17742,17745
24212,5,210,46,102.40,3466.24,17744,17749
24213,2,398,114,256.00,20164.00,17748,17750
24214,1,512,512,512.00,0.00,17749,17750
24215,1,512,512,512.00,0.00,17749,17750
24216,1,512,512,512.00,0.00,17749,17750
24217,2,315,197,256.00,3481.00,17749,17751
24218,1,512,512,512.00,0.00,17750,17751
24219,2,353,159,256.00,9409.00,17750,17752
24220,1,512,512,512.00,0.00,17751,17752
24221,1,512,512,512.00,0.00,17751,17752
24222,1,512,512,512.00,0.00,17751,17752
24223,3,380,58,170.67,21952.89,17751,17754
24224,1,512,512,512.00,0.00,17753,17754
24225,1,512,512,512.00,0.00,17753,17754
24226,9,153,1,56.89,2663.21,17753,17762
24227,4,320,1,128.00,14637.50,17761,17765
24228,1,512,512,512.00,0.00,17764,17765
24229,5,302,4,102.40,13050.64,17764,17769
24230,1,512,512,512.00,0.00,17768,17769
24231,3,492,1,170.67,51681.56,17768,17771
24232,1,512,512,512.00,0.00,17770,17771
24233,1,512,512,512.00,0.00,17770,17771
24234,1,512,512,512.00,0.00,17770,17771
24235,1,512,512,512.00,0.00,17770,17771
24236,2,260,252,256.00,16.00,17770,17772
24237,4,335,8,128.00,17673.50,17771,17775
24238,4,481,1,128.00,41653.50,17774,17778
24239,3,264,24,170.67,11022.22,17777,17780
24240,1,512,512,512.00,0.00,17779,17780
24241,1,512,512,512.00,0.00,17779,17780
24242,1,512,512,512.00,0.00,17779,17780
24243,1,512,512,512.00,0.00,17779,17780
24244,1,512,512,512.00,0.00,17779,17780
24245,1,512,512,512.00,0.00,17779,17780
24246,1,512,512,512.00,0.00,17779,17780
24247,1,512,512,512.00,0.00,17779,17780
24248,2,478,34,256.00,49284.00,17779,17781
24249,1,512,512,512.00,0.00,17780,17781
24250,1,512,512,512.00,0.00,17780,17781
24251,2,491,21,256.00,55225.00,17780,17782
24252,1,512,512,512.00,0.00,17781,17782
24253,2,472,40,256.00,46656.00,17781,17783
24254,1,512,512,512.00,0.00,17782,17783
24255,1,512,512,512.00,0.00,17782,17783
24256,3,476,17,170.67,46614.89,17782,17785
24257,1,512,512,512.00,0.00,17784,17785
24258,3,323,74,170.67,11882.89,17784,17787
24259,3,389,2,170.67,26194.89,17786,17789
24260,1,512,512,512.00,0.00,17788,17789
24261,3,458,17,170.67,41346.89,17788,17791
24262,1,512,512,512.00,0.00,17790,17791
24263,3,409,21,170.67,29021.56,17790,17793
24264,1,512,512,512.00,0.00,17792,17793
24265,2,404,108,256.00,21904.00,17792,17794
24266,3,389,26,170.67,24674.89,17793,17796
24267,1,512,512,512.00,0.00,17795,17796
24268,1,512,512,512.00,0.00,17795,17796
24269,1,512,512,512.00,0.00,17795,17796
24270,2,257,255,256.00,1.00,17795,17797
24271,2,427,85,256.00,29241.00,17796,17798
24272,1,512,512,512.00,0.00,17797,17798
24273,1,512,512,512.00,0.00,17797,17798
24274,2,264,248,256.00,64.00,17797,17799
24275,1,512,512,512.00,0.00,17798,17799
24276,1,512,512,512.00,0.00,17798,17799
24277,1,512,512,512.00,0.00,17798,17799
24278,8,242,1,64.00,8464.50,17798,17806
24279,1,512,512,512.00,0.00,17805,17806
24280,1,512,512,512.00,0.00,17805,17806
24281,1,512,512,512.00,0.00,17805,17806
24282,1,512,512,512.00,0.00,17805,17806
24283,1,512,512,512.00,0.00,17805,17806
24284,2,461,51,256.00,42025.00,17805,17807
24285,2,423,89,256.00,27889.00,17806,17808
24286,1,512,512,512.00,0.00,17807,17808
24287,1,512,512,512.00,0.00,17807,17808
24288,1,512,512,512.00,0.00,17807,17808
24289,1,512,512,512.00,0.00,17807,17808
24290,1,512,512,512.00,0.00,17807,17808
24291,1,512,512,512.00,0.00,17807,17808
24292,2,427,85,256.00,29241.00,17807,17809
24293,1,512,512,512.00,0.00,17808,17809
24294,2,463,49,256.00,42849.00,17808,17810
24295,2,481,31,256.00,50625.00,17809,17811
24296,1,512,512,512.00,0.00,17810,17811
24297,1,512,512,512.00,0.00,17810,17811
24298,1,512,512,512.00,0.00,17810,17811
24299,7,401,3,73.14,18043.27,17810,17817
24300,3,241,95,170.67,3566.89,17816,17819
24301,3,469,18,170.67,44509.56,17818,17821
24302,1,512,512,512.00,0.00,17820,17821
24303,2,282,230,256.00,676.00,17820,17822
24304,1,512,512,512.00,0.00,17821,17822
24305,1,512,512,512.00,0.00,17821,17822
24306,1,512,512,512.00,0.00,17821,17822
24307,4,346,1,128.00,17383.50,17821,17825
24308,2,482,30,256.00,51076.00,17824,17826
24309,1,512,512,512.00,0.00,17825,17826
24310,1,512,512,512.00,0.00,17825,17826
24311,2,510,2,256.00,64516.00,17825,17827
24312,1,512,512,512.00,0.00,17826,17827
24313,1,512,512,512.00,0.00,17826,17827
24314,1,512,512,512.00,0.00,17826,17827
24315,1,512,512,512.00,0.00,17826,17827
24316,1,512,512,512.00,0.00,17826,17827
24317,1,512,512,512.00,0.00,17826,17827
24318,1,512,512,512.00,0.00,17826,17827
24319,1,512,512,512.00,0.00,17826,17827
24320,4,294,6,128.00,14052.00,17826,17830
24321,4,495,1,128.00,44912.50,17829,17833
24322,2,281,231,256.00,625.00,17832,17834
24323,5,280,25,102.40,8676.24,17833,17838
24324,1,512,512,512.00,0.00,17837,17838
24325,2,343,169,256.00,7569.00,17837,17839
24326,1,512,512,512.00,0.00,17838,17839
24327,1,512,512,512.00,0.00,17838,17839
24328,1,512,512,512.00,0.00,17838,17839
24329,1,512,512,512.00,0.00,17838,17839
24330,1,512,512,512.00,0.00,17838,17839
24331,2,508,4,256.00,63504.00,17838,17840
24332,6,336,1,85.33,14789.22,17839,17845
24333,1,512,512,512.00,0.00,17844,17845
24334,1,512,512,512.00,0.00,17844,17845
24335,2,259,253,256.00,9.00,17844,17846
24336,4,354,1,128.00,20304.50,17845,17849
24337,1,512,512,512.00,0.00,17848,17849
24338,2,486,26,256.00,52900.00,17848,17850
24339,4,329,4,128.00,16011.50,17849,17853
24340,1,512,512,512.00,0.00,17852,17853
24341,2,329,183,256.00,5329.00,17852,17854
24342,3,341,44,170.67,15654.89,17853,17856
24343,1,512,512,512.00,0.00,17855,17856
24344,1,512,512,512.00,0.00,17855,17856
24345,1,512,512,512.00,0.00,17855,17856
24346,6,217,6,85.33,4152.89,17855,17861
24347,2,335,177,256.00,6241.00,17860,17862
24348,1,512,512,512.00,0.00,17861,17862
24349,1,512,512,512.00,0.00,17861,17862
24350,1,512,512,512.00,0.00,17861,17862
24351,4,409,15,128.00,26605.00,17861,17865
24352,1,512,512,512.00,0.00,17864,17865
24353,1,512,512,512.00,0.00,17864,17865
24354,2,315,197,256.00,3481.00,17864,17866
24355,1,512,512,512.00,0.00,17865,17866
24356,1,512,512,512.00,0.00,17865,17866
24357,3,418,6,170.67,31707.56,17865,17868
24358,1,512,512,512.00,0.00,17867,17868
24359,2,459,53,256.00,41209.00,17867,17869
24360,1,512,512,512.00,0.00,17868,17869
24361,1,512,512,512.00,0.00,17868,17869
24362,5,397,5,102.40,22219.84,17868,17873
24363,1,512,512,512.00,0.00,17872,17873
24364,2,412,100,256.00,24336.00,17872,17874
24365,4,400,3,128.00,25923.50,17873,17877
24366,2,457,55,256.00,40401.00,17876,17878
24367,1,512,512,512.00,0.00,17877,17878
24368,1,512,512,512.00,0.00,17877,17878
24369,2,297,215,256.00,1681.00,17877,17879
24370,1,512,512,512.00,0.00,17878,17879
24371,3,401,40,170.67,26686.89,17878,17881
24372,1,512,512,512.00,0.00,17880,17881
24373,1,512,512,512.00,0.00,17880,17881
24374,5,304,1,102.40,14573.04,17880,17885
24375,2,503,9,256.00,61009.00,17884,17886
24376,2,270,242,256.00,196.00,17885,17887
24377,1,512,512,512.00,0.00,17886,17887
24378,3,306,34,170.67,12331.56,17886,17889
24379,1,512,512,512.00,0.00,17888,17889
24380,1,512,512,512.00,0.00,17888,17889
24381,1,512,512,512.00,0.00,17888,17889
24382,6,406,5,85.33,20693.56,17888,17894
24383,2,297,215,256.00,1681.00,17893,17895
24384,1,512,512,512.00,0.00,17894,17895
24385,1,512,512,512.00,0.00,17894,17895
24386,1,512,512,512.00,0.00,17894,17895
24387,1,512,512,512.00,0.00,17894,17895
24388,1,512,512,512.00,0.00,17894,17895
24389,1,512,512,512.00,0.00,17894,17895
24390,1,512,512,512.00,0.00,17894,17895
24391,1,512,512,512.00,0.00,17894,17895
24392,3,402,1,170.67,28701.56,17894,17897
24393,2,393,119,256.00,18769.00,17896,17898
24394,1,512,512,512.00,0.00,17897,17898
24395,2,266,246,256.00,100.00,17897,17899
24396,1,512,512,512.00,0.00,17898,17899
24397,1,512,512,512.00,0.00,17898,17899
24398,1,512,512,512.00,0.00,17898,17899
24399,3,478,1,170.67,47397.56,17898,17901
24400,4,340,1,128.00,16174.50,17900,17904
24401,1,512,512,512.00,0.00,17903,17904
24402,1,512,512,512.00,0.00,17903,17904
24403,4,305,3,128.00,16401.00,17903,17907
24404,1,512,512,512.00,0.00,17906,17907
24405,2,302,210,256.00,2116.00,17906,17908
24406,4,339,10,128.00,16433.50,17907,17911
24407,2,330,182,256.00,5476.00,17910,17912
24408,1,512,512,512.00,0.00,17911,17912
24409,1,512,512,512.00,0.00,17911,17912
24410,3,277,11,170.67,13214.89,17911,17914
24411,1,512,512,512.00,0.00,17913,17914
24412,1,512,512,512.00,0.00,17913,17914
24413,1,512,512,512.00,0.00,17913,17914
24414,2,502,10,256.00,60516.00,17913,17915
24415,6,173,14,85.33,4418.56,17914,17920
24416,3,421,33,170.67,31437.56,17919,17922
24417,1,512,512,512.00,0.00,17921,17922
24418,2,392,120,256.00,18496.00,17921,17923
24419,4,266,2,128.00,14366.00,17922,17926
24420,1,512,512,512.00,0.00,17925,17926
24421,1,512,512,512.00,0.00,17925,17926
24422,1,512,512,512.00,0.00,17925,17926
24423,1,512,512,512.00,0.00,17925,17926
24424,3,454,1,170.67,40661.56,17925,17928
24425,1,512,512,512.00,0.00,17927,17928
24426,1,512,512,512.00,0.00,17927,17928
24427,1,512,512,512.00,0.00,17927,17928
24428,1,512,512,512.00,0.00,17927,17928
24429,3,241,34,170.67,9341.56,17927,17930
24430,1,512,512,512.00,0.00,17929,17930
24431,1,512,512,512.00,0.00,17929,17930
24432,1,512,512,512.00,0.00,17929,17930
24433,2,511,1,256.00,65025.00,17929,17931
24434,1,512,512,512.00,0.00,17930,17931
24435,5,299,3,102.40,10891.84,17930,17935
24436,3,248,48,170.67,7694.22,17934,17937
24437,1,512,512,512.00,0.00,17936,17937
24438,1,512,512,512.00,0.00,17936,17937
24439,2,370,142,256.00,12996.00,17936,17938
24440,5,330,1,102.40,15229.44,17937,17942
24441,3,352,64,170.67,16611.56,17941,17944
24442,4,371,11,128.00,20349.50,17943,17947
24443,1,512,512,512.00,0.00,17946,17947
24444,1,512,512,512.00,0.00,17946,17947
24445,2,400,112,256.00,20736.00,17946,17948
24446,1,512,512,512.00,0.00,17947,17948
24447,1,512,512,512.00,0.00,17947,17948
24448,2,386,126,256.00,16900.00,17947,17949
24449,1,512,512,512.00,0.00,17948,17949
24450,1,512,512,512.00,0.00,17948,17949
24451,1,512,512,512.00,0.00,17948,17949
24452,1,512,512,512.00,0.00,17948,17949
24453,1,512,512,512.00,0.00,17948,17949
24454,8,214,1,64.00,5093.00,17948,17956
24455,11,176,1,46.55,3324.61,17955,17966
24456,4,266,10,128.00,9542.00,17965,17969
24457,1,512,512,512.00,0.00,17968,17969
24458,4,347,22,128.00,16626.50,17968,17972
24459,3,387,35,170.67,23904.22,17971,17974
24460,3,386,3,170.67,25584.22,17973,17976
24461,1,512,512,512.00,0.00,17975,17976
24462,3,393,31,170.67,25257.56,17975,17978
24463,5,201,4,102.40,4731.44,17977,17982
24464,1,512,512,512.00,0.00,17981,17982
24465,1,512,512,512.00,0.00,17981,17982
24466,1,512,512,512.00,0.00,17981,17982
24467,1,512,512,512.00,0.00,17981,17982
24468,1,512,512,512.00,0.00,17981,17982
24469,3,249,49,170.67,7605.56,17981,17984
24470,1,512,512,512.00,0.00,17983,17984
24471,1,512,512,512.00,0.00,17983,17984
24472,5,270,5,102.40,8847.44,17983,17988
24473,2,284,228,256.00,784.00,17987,17989
24474,3,275,29,170.67,10782.89,17988,17991
24475,3,407,23,170.67,28506.89,17990,17993
24476,5,163,1,102.40,3023.44,17992,17997
24477,6,285,3,85.33,10275.22,17996,18002
24478,3,395,29,170.67,25742.89,18001,18004
24479,1,512,512,512.00,0.00,18003,18004
24480,2,504,8,256.00,61504.00,18003,18005
24481,2,510,2,256.00,64516.00,18004,18006
24482,3,470,9,170.67,44896.22,18005,18008
24483,1,512,512,512.00,0.00,18007,18008
24484,1,512,512,512.00,0.00,18007,18008
24485,1,512,512,512.00,0.00,18007,18008
24486,3,475,17,170.67,46310.89,18007,18010
24487,1,512,512,512.00,0.00,18009,18010
24488,4,233,1,128.00,10899.00,18009,18013
24489,1,512,512,512.00,0.00,18012,18013
24490,1,512,512,512.00,0.00,18012,18013
24491,1,512,512,512.00,0.00,18012,18013
24492,4,244,4,128.00,12520.50,18012,18016
24493,3,385,28,170.67,23809.56,18015,18018
24494,4,417,9,128.00,28545.00,18017,18021
24495,2,323,189,256.00,4489.00,18020,18022
24496,1,512,512,512.00,0.00,18021,18022
24497,1,512,512,512.00,0.00,18021,18022
24498,1,512,512,512.00,0.00,18021,18022
24499,1,512,512,512.00,0.00,18021,18022
24500,1,512,512,512.00,0.00,18021,18022
24501,1,512,512,512.00,0.00,18021,18022
24502,1,512,512,512.00,0.00,18021,18022
24503,3,453,11,170.67,40084.22,18021,18024
24504,2,271,241,256.00,225.00,18023,18025
24505,1,512,512,512.00,0.00,18024,18025
24506,3,422,1,170.67,32874.89,18024,18027
24507,3,282,3,170.67,14560.22,18026,18029
24508,1,512,512,512.00,0.00,18028,18029
24509,1,512,512,512.00,0.00,18028,18029
24510,1,512,512,512.00,0.00,18028,18029
24511,1,512,512,512.00,0.00,18028,18029
24512,1,512,512,512.00,0.00,18028,18029
24513,3,376,2,170.67,23984.89,18028,18031
24514,5,186,3,102.40,3898.64,18030,18035
24515,5,285,2,102.40,10232.24,18034,18039
24516,6,329,1,85.33,13330.22,18038,18044
24517,1,512,512,512.00,0.00,18043,18044
24518,1,512,512,512.00,0.00,18043,18044
24519,2,387,125,256.00,17161.00,18043,18045
24520,2,508,4,256.00,63504.00,18044,18046
24521,3,304,101,170.67,8894.89,18045,18048
24522,3,425,25,170.67,32570.89,18047,18050
24523,1,512,512,512.00,0.00,18049,18050
24524,1,512,512,512.00,0.00,18049,18050
24525,1,512,512,512.00,0.00,18049,18050
24526,2,278,234,256.00,484.00,18049,18051
24527,1,512,512,512.00,0.00,18050,18051
24528,1,512,512,512.00,0.00,18050,18051
24529,3,292,92,170.67,7576.89,18050,18053
24530,2,446,66,256.00,36100.00,18052,18054
24531,2,284,228,256.00,784.00,18053,18055
24532,1,512,512,512.00,0.00,18054,18055
24533,1,512,512,512.00,0.00,18054,18055
24534,2,445,67,256.00,35721.00,18054,18056
24535,1,512,512,512.00,0.00,18055,18056
24536,1,512,512,512.00,0.00,18055,18056
24537,2,400,112,256.00,20736.00,18055,18057
24538,1,512,512,512.00,0.00,18056,18057
24539,1,512,512,512.00,0.00,18056,18057
24540,1,512,512,512.00,0.00,18056,18057
24541,2,386,126,256.00,16900.00,18056,18058
24542,1,512,512,512.00,0.00,18057,18058
24543,2,297,215,256.00,1681.00,18057,18059
24544,1,512,512,512.00,0.00,18058,18059
24545,1,512,512,512.00,0.00,18058,18059
24546,2,309,203,256.00,2809.00,18058,18060
24547,1,512,512,512.00,0.00,18059,18060
24548,1,512,512,512.00,0.00,18059,18060
24549,1,512,512,512.00,0.00,18059,18060
24550,1,512,512,512.00,0.00,18059,18060
24551,2,413,99,256.00,24649.00,18059,18061
24552,2,363,149,256.00,11449.00,18060,18062
24553,1,512,512,512.00,0.00,18061,18062
24554,1,512,512,512.00,0.00,18061,18062
24555,6,244,2,85.33,7670.56,18061,18067
24556,1,512,512,512.00,0.00,18066,18067
24557,1,512,512,512.00,0.00,18066,18067
24558,1,512,512,512.00,0.00,18066,18067
24559,3,381,8,170.67,24324.22,18066,18069
24560,1,512,512,512.00,0.00,18068,18069
24561,1,512,512,512.00,0.00,18068,18069
24562,3,248,104,170.67,3512.89,18068,18071
24563,1,512,512,512.00,0.00,18070,18071
24564,4,388,12,128.00,23144.00,18070,18074
24565,4,397,3,128.00,25889.00,18073,18077
24566,3,382,11,170.67,24274.89,18076,18079
24567,4,474,1,128.00,40061.50,18078,18082
24568,1,512,512,512.00,0.00,18081,18082
24569,1,512,512,512.00,0.00,18081,18082
24570,3,417,20,170.67,30844.22,18081,18084
24571,2,320,192,256.00,4096.00,18083,18085
24572,1,512,512,512.00,0.00,18084,18085
24573,2,446,66,256.00,36100.00,18084,18086
24574,3,391,43,170.67,24477.56,18085,18088
24575,6,264,5,85.33,10194.22,18087,18093
24576,1,512,512,512.00,0.00,18092,18093
24577,3,328,27,170.67,15193.56,18092,18095
24578,1,512,512,512.00,0.00,18094,18095
24579,4,314,8,128.00,14198.00,18094,18098
24580,2,294,218,256.00,1444.00,18097,18099
24581,1,512,512,512.00,0.00,18098,18099
24582,1,512,512,512.00,0.00,18098,18099
24583,3,465,12,170.67,43404.22,18098,18101
24584,1,512,512,512.00,0.00,18100,18101
24585,1,512,512,512.00,0.00,18100,18101
24586,4,353,1,128.00,19629.50,18100,18104
24587,7,149,1,73.14,3002.69,18103,18110
24588,3,244,40,170.67,8579.56,18109,18112
24589,2,469,43,256.00,45369.00,18111,18113
24590,4,368,29,128.00,19488.50,18112,18116
24591,1,512,512,512.00,0.00,18115,18116
24592,6,212,3,85.33,7013.89,18115,18121
24593,1,512,512,512.00,0.00,18120,18121
24594,2,356,156,256.00,10000.00,18120,18122
24595,1,512,512,512.00,0.00,18121,18122
24596,1,512,512,512.00,0.00,18121,18122
24597,8,166,2,64.00,3529.75,18121,18129
24598,1,512,512,512.00,0.00,18128,18129
24599,2,505,7,256.00,62001.00,18128,18130
24600,1,512,512,512.00,0.00,18129,18130
24601,1,512,512,512.00,0.00,18129,18130
24602,1,512,512,512.00,0.00,18129,18130
24603,1,512,512,512.00,0.00,18129,18130
24604,1,512,512,512.00,0.00,18129,18130
24605,4,266,1,128.00,10761.50,18129,18133
24606,1,512,512,512.00,0.00,18132,18133
24607,1,512,512,512.00,0.00,18132,18133
24608,2,260,252,256.00,16.00,18132,18134
24609,1,512,512,512.00,0.00,18133,18134
24610,1,512,512,512.00,0.00,18133,18134
24611,2,320,192,256.00,4096.00,18133,18135
24612,1,512,512,512.00,0.00,18134,18135
24613,1,512,512,512.00,0.00,18134,18135
24614,1,512,512,512.00,0.00,18134,18135
24615,3,361,15,170.67,20553.56,18134,18137
24616,1,512,512,512.00,0.00,18136,18137
24617,1,512,512,512.00,0.00,18136,18137
24618,1,512,512,512.00,0.00,18136,18137
24619,2,266,246,256.00,100.00,18136,18138
24620,1,512,512,512.00,0.00,18137,18138
24621,2,292,220,256.00,1296.00,18137,18139
24622,1,512,512,512.00,0.00,18138,18139
24623,4,339,4,128.00,18198.50,18138,18142
24624,1,512,512,512.00,0.00,18141,18142
24625,2,391,121,256.00,18225.00,18141,18143
24626,1,512,512,512.00,0.00,18142,18143
24627,1,512,512,512.00,0.00,18142,18143
24628,2,504,8,256.00,61504.00,18142,18144
24629,1,512,512,512.00,0.00,18143,18144
24630,5,253,6,102.40,7908.24,18143,18148
24631,1,512,512,512.00,0.00,18147,18148
24632,1,512,512,512.00,0.00,18147,18148
24633,1,512,512,512.00,0.00,18147,18148
24634,2,418,94,256.00,26244.00,18147,18149
24635,2,358,154,256.00,10404.00,18148,18150
24636,1,512,512,512.00,0.00,18149,18150
24637,2,388,124,256.00,17424.00,18149,18151
24638,3,412,26,170.67,29504.89,18150,18153
24639,3,361,4,170.67,21521.56,18152,18155
24640,1,512,512,512.00,0.00,18154,18155
24641,3,317,3,170.67,16660.22,18154,18157
24642,1,512,512,512.00,0.00,18156,18157
24643,2,368,144,256.00,12544.00,18156,18158
24644,1,512,512,512.00,0.00,18157,18158
24645,1,512,512,512.00,0.00,18157,18158
24646,1,512,512,512.00,0.00,18157,18158
24647,1,512,512,512.00,0.00,18157,18158
24648,3,377,8,170.67,23646.89,18157,18160
24649,3,360,46,170.67,18523.56,18159,18162
24650,1,512,512,512.00,0.00,18161,18162
24651,3,395,6,170.67,27000.22,18161,18164
24652,1,512,512,512.00,0.00,18163,18164
24653,1,512,512,512.00,0.00,18163,18164
24654,1,512,512,512.00,0.00,18163,18164
24655,2,423,89,256.00,27889.00,18163,18165
24656,1,512,512,512.00,0.00,18164,18165
24657,2,378,134,256.00,14884.00,18164,18166
24658,1,512,512,512.00,0.00,18165,18166
24659,1,512,512,512.00,0.00,18165,18166
24660,2,415,97,256.00,25281.00,18165,18167
24661,2,438,74,256.00,33124.00,18166,18168
24662,5,316,3,102.40,13739.04,18167,18172
24663,1,512,512,512.00,0.00,18171,18172
24664,1,512,512,512.00,0.00,18171,18172
24665,1,512,512,512.00,0.00,18171,18172
24666,1,512,512,512.00,0.00,18171,18172
24667,2,477,35,256.00,48841.00,18171,18173
24668,1,512,512,512.00,0.00,18172,18173
24669,1,512,512,512.00,0.00,18172,18173
24670,1,512,512,512.00,0.00,18172,18173
24671,1,512,512,512.00,0.00,18172,18173
24672,3,264,58,170.67,7259.56,18172,18175
24673,1,512,512,512.00,0.00,18174,18175
24674,4,224,45,128.00,5587.50,18174,18178
24675,1,512,512,512.00,0.00,18177,18178
24676,2,491,21,256.00,55225.00,18177,18179
24677,1,512,512,512.00,0.00,18178,18179
24678,1,512,512,512.00,0.00,18178,18179
24679,1,512,512,512.00,0.00,18178,18179
24680,2,307,205,256.00,2601.00,18178,18180
24681,1,512,512,512.00,0.00,18179,18180
24682,1,512,512,512.00,0.00,18179,18180
24683,1,512,512,512.00,0.00,18179,18180
24684,2,277,235,256.00,441.00,18179,18181
24685,1,512,512,512.00,0.00,18180,18181
24686,1,512,512,512.00,0.00,18180,18181
24687,3,387,60,170.67,23404.22,18180,18183
24688,1,512,512,512.00,0.00,18182,18183
24689,2,499,13,256.00,59049.00,18182,18184
24690,6,223,9,85.33,5842.56,18183,18189
24691,1,512,512,512.00,0.00,18188,18189
24692,4,291,41,128.00,9269.00,18188,18192
24693,2,382,130,256.00,15876.00,18191,18193
24694,1,512,512,512.00,0.00,18192,18193
24695,1,512,512,512.00,0.00,18192,18193
24696,1,512,512,512.00,0.00,18192,18193
24697,1,512,512,512.00,0.00,18192,18193
24698,2,292,220,256.00,1296.00,18192,18194
24699,1,512,512,512.00,0.00,18193,18194
24700,1,512,512,512.00,0.00,18193,18194
24701,1,512,512,512.00,0.00,18193,18194
24702,2,305,207,256.00,2401.00,18193,18195
24703,2,365,147,256.00,11881.00,18194,18196
24704,3,368,13,170.67,21790.89,18195,18198
24705,1,512,512,512.00,0.00,18197,18198
24706,1,512,512,512.00,0.00,18197,18198
24707,1,512,512,512.00,0.00,18197,18198
24708,2,336,176,256.00,6400.00,18197,18199
24709,1,512,512,512.00,0.00,18198,18199
24710,1,512,512,512.00,0.00,18198,18199
24711,1,512,512,512.00,0.00,18198,18199
24712,1,512,512,512.00,0.00,18198,18199
24713,1,512,512,512.00,0.00,18198,18199
24714,2,334,178,256.00,6084.00,18198,18200
24715,1,512,512,512.00,0.00,18199,18200
24716,2,409,103,256.00,23409.00,18199,18201
24717,1,512,512,512.00,0.00,18200,18201
24718,3,311,32,170.67,12974.89,18200,18203
24719,1,512,512,512.00,0.00,18202,18203
24720,2,260,252,256.00,16.00,18202,18204
24721,5,215,3,102.40,7913.84,18203,18208
24722,1,512,512,512.00,0.00,18207,18208
24723,1,512,512,512.00,0.00,18207,18208
24724,2,265,247,256.00,81.00,18207,18209
24725,2,390,122,256.00,17956.00,18208,18210
24726,2,301,211,256.00,2025.00,18209,18211
24727,1,512,512,512.00,0.00,18210,18211
24728,1,512,512,512.00,0.00,18210,18211
24729,4,217,69,128.00,2963.50,18210,18214
24730,1,512,512,512.00,0.00,18213,18214
24731,1,512,512,512.00,0.00,18213,18214
24732,1,512,512,512.00,0.00,18213,18214
24733,1,512,512,512.00,0.00,18213,18214
24734,3,316,98,170.67,10560.89,18213,18216
24735,1,512,512,512.00,0.00,18215,18216
24736,1,512,512,512.00,0.00,18215,18216
24737,1,512,512,512.00,0.00,18215,18216
24738,2,371,141,256.00,13225.00,18215,18217
24739,1,512,512,512.00,0.00,18216,18217
24740,1,512,512,512.00,0.00,18216,18217
24741,1,512,512,512.00,0.00,18216,18217
24742,2,455,57,256.00,39601.00,18216,18218
24743,1,512,512,512.00,0.00,18217,18218
24744,1,512,512,512.00,0.00,18217,18218
24745,5,258,2,102.40,9488.24,18217,18222
24746,1,512,512,512.00,0.00,18221,18222
24747,3,466,20,170.67,43616.89,18221,18224
24748,1,512,512,512.00,0.00,18223,18224
24749,1,512,512,512.00,0.00,18223,18224
24750,3,267,9,170.67,13228.22,18223,18226
24751,1,512,512,512.00,0.00,18225,18226
24752,2,283,229,256.00,729.00,18225,18227
24753,1,512,512,512.00,0.00,18226,18227
24754,3,398,40,170.67,26032.89,18226,18229
24755,2,316,196,256.00,3600.00,18228,18230
24756,1,512,512,512.00,0.00,18229,18230
24757,2,260,252,256.00,16.00,18229,18231
24758,1,512,512,512.00,0.00,18230,18231
24759,1,512,512,512.00,0.00,18230,18231
24760,2,475,37,256.00,47961.00,18230,18232
24761,1,512,512,512.00,0.00,18231,18232
24762,1,512,512,512.00,0.00,18231,18232
24763,1,512,512,512.00,0.00,18231,18232
24764,1,512,512,512.00,0.00,18231,18232
24765,3,251,26,170.67,10506.89,18231,18234
24766,5,167,16,102.40,3489.04,18233,18238
24767,1,512,512,512.00,0.00,18237,18238
24768,3,324,78,170.67,11926.22,18237,18240
24769,1,512,512,512.00,0.00,18239,18240
24770,3,292,81,170.67,7921.56,18239,18242
24771,2,309,203,256.00,2809.00,18241,18243
24772,1,512,512,512.00,0.00,18242,18243
24773,1,512,512,512.00,0.00,18242,18243
24774,1,512,512,512.00,0.00,18242,18243
24775,7,201,2,73.14,3558.98,18242,18249
24776,6,262,2,85.33,9953.89,18248,18254
24777,2,350,162,256.00,8836.00,18253,18255
24778,1,512,512,512.00,0.00,18254,18255
24779,1,512,512,512.00,0.00,18254,18255
24780,1,512,512,512.00,0.00,18254,18255
24781,2,376,136,256.00,14400.00,18254,18256
24782,1,512,512,512.00,0.00,18255,18256
24783,1,512,512,512.00,0.00,18255,18256
24784,2,334,178,256.00,6084.00,18255,18257
24785,1,512,512,512.00,0.00,18256,18257
24786,1,512,512,512.00,0.00,18256,18257
24787,4,461,4,128.00,37071.50,18256,18260
24788,6,227,3,85.33,5147.22,18259,18265
24789,2,401,111,256.00,21025.00,18264,18266
24790,4,201,30,128.00,4591.50,18265,18269
24791,4,268,20,128.00,10256.00,18268,18272
24792,1,512,512,512.00,0.00,18271,18272
24793,1,512,512,512.00,0.00,18271,18272
24794,3,292,45,170.67,10177.56,18271,18274
24795,1,512,512,512.00,0.00,18273,18274
24796,1,512,512,512.00,0.00,18273,18274
24797,1,512,512,512.00,0.00,18273,18274
24798,3,350,22,170.67,18400.89,18273,18276
24799,1,512,512,512.00,0.00,18275,18276
24800,1,512,512,512.00,0.00,18275,18276
24801,2,369,143,256.00,12769.00,18275,18277
24802,1,512,512,512.00,0.00,18276,18277
24803,1,512,512,512.00,0.00,18276,18277
24804,1,512,512,512.00,0.00,18276,18277
24805,4,210,65,128.00,3894.50,18276,18280
24806,1,512,512,512.00,0.00,18279,18280
24807,1,512,512,512.00,0.00,18279,18280
24808,4,286,2,128.00,16062.50,18279,18283
24809,1,512,512,512.00,0.00,18282,18283
24810,2,412,100,256.00,24336.00,18282,18284
24811,4,440,3,128.00,33078.50,18283,18287
24812,2,419,93,256.00,26569.00,18286,18288
24813,1,512,512,512.00,0.00,18287,18288
24814,3,303,3,170.67,15624.22,18287,18290
24815,4,301,12,128.00,13667.50,18289,18293
24816,1,512,512,512.00,0.00,18292,18293
24817,6,226,1,85.33,8447.56,18292,18298
24818,2,510,2,256.00,64516.00,18297,18299
24819,3,322,34,170.67,13931.56,18298,18301
24820,1,512,512,512.00,0.00,18300,18301
24821,3,426,8,170.67,33414.22,18300,18303
24822,1,512,512,512.00,0.00,18302,18303
24823,1,512,512,512.00,0.00,18302,18303
24824,1,512,512,512.00,0.00,18302,18303
24825,7,307,1,73.14,11275.84,18302,18309
24826,1,512,512,512.00,0.00,18308,18309
24827,1,512,512,512.00,0.00,18308,18309
24828,1,512,512,512.00,0.00,18308,18309
24829,2,506,6,256.00,62500.00,18308,18310
24830,2,492,20,256.00,55696.00,18309,18311
24831,1,512,512,512.00,0.00,18310,18311
24832,3,356,3,170.67,20924.22,18310,18313
24833,1,512,512,512.00,0.00,18312,18313
24834,2,315,197,256.00,3481.00,18312,18314
24835,4,401,2,128.00,26082.50,18313,18317
24836,6,327,8,85.33,12616.22,18316,18322
24837,1,512,512,512.00,0.00,18321,18322
24838,1,512,512,512.00,0.00,18321,18322
24839,1,512,512,512.00,0.00,18321,18322
24840,1,512,512,512.00,0.00,18321,18322
24841,1,512,512,512.00,0.00,18321,18322
24842,1,512,512,512.00,0.00,18321,18322
24843,3,302,51,170.67,10568.22,18321,18324
24844,2,341,171,256.00,7225.00,18323,18325
24845,1,512,512,512.00,0.00,18324,18325
24846,5,284,32,102.40,8907.44,18324,18329
24847,3,372,62,170.67,20310.22,18328,18331
24848,1,512,512,512.00,0.00,18330,18331
24849,1,512,512,512.00,0.00,18330,18331
24850,2,393,119,256.00,18769.00,18330,18332
24851,6,317,1,85.33,14509.56,18331,18337
24852,1,512,512,512.00,0.00,18336,18337
24853,9,175,1,56.89,3213.43,18336,18345
24854,2,424,88,256.00,28224.00,18344,18346
24855,1,512,512,512.00,0.00,18345,18346
24856,1,512,512,512.00,0.00,18345,18346
24857,1,512,512,512.00,0.00,18345,18346
24858,1,512,512,512.00,0.00,18345,18346
24859,3,263,118,170.67,4290.89,18345,18348
24860,3,412,3,170.67,30593.56,18347,18350
24861,3,261,49,170.67,7981.56,18349,18352
24862,1,512,512,512.00,0.00,18351,18352
24863,1,512,512,512.00,0.00,18351,18352
24864,1,512,512,512.00,0.00,18351,18352
24865,1,512,512,512.00,0.00,18351,18352
24866,1,512,512,512.00,0.00,18351,18352
24867,1,512,512,512.00,0.00,18351,18352
24868,1,512,512,512.00,0.00,18351,18352
24869,4,226,24,128.00,5991.50,18351,18355
24870,4,278,35,128.00,9571.50,18354,18358
24871,1,512,512,512.00,0.00,18357,18358
24872,3,326,26,170.67,15056.89,18357,18360
24873,2,490,22,256.00,54756.00,18359,18361
24874,2,401,111,256.00,21025.00,18360,18362
24875,7,200,1,73.14,6513.55,18361,18368
24876,2,468,44,256.00,44944.00,18367,18369
24877,6,200,2,85.33,5595.22,18368,18374
24878,3,333,2,170.67,18280.22,18373,18376
24879,2,268,244,256.00,144.00,18375,18377
24880,4,224,2,128.00,7146.00,18376,18380
24881,1,512,512,512.00,0.00,18379,18380
24882,1,512,512,512.00,0.00,18379,18380
24883,3,404,1,170.67,29094.89,18379,18382
24884,5,191,21,102.40,4613.84,18381,18386
24885,2,423,89,256.00,27889.00,18385,18387
24886,1,512,512,512.00,0.00,18386,18387
24887,1,512,512,512.00,0.00,18386,18387
24888,1,512,512,512.00,0.00,18386,18387
24889,1,512,512,512.00,0.00,18386,18387
24890,1,512,512,512.00,0.00,18386,18387
24891,2,411,101,256.00,24025.00,18386,18388
24892,1,512,512,512.00,0.00,18387,18388
24893,2,443,69,256.00,34969.00,18387,18389
24894,4,186,32,128.00,3638.00,18388,18392
24895,5,221,6,102.40,5378.24,18391,18396
24896,2,478,34,256.00,49284.00,18395,18397
24897,5,249,1,102.40,10339.84,18396,18401
24898,1,512,512,512.00,0.00,18400,18401
24899,1,512,512,512.00,0.00,18400,18401
24900,2,416,96,256.00,25600.00,18400,18402
24901,3,477,3,170.67,47060.22,18401,18404
24902,1,512,512,512.00,0.00,18403,18404
24903,1,512,512,512.00,0.00,18403,18404
24904,1,512,512,512.00,0.00,18403,18404
24905,3,235,74,170.67,4842.89,18403,18406
24906,4,409,4,128.00,26918.50,18405,18409
24907,1,512,512,512.00,0.00,18408,18409
24908,1,512,512,512.00,0.00,18408,18409
24909,1,512,512,512.00,0.00,18408,18409
24910,1,512,512,512.00,0.00,18408,18409
24911,7,202,1,73.14,6501.55,18408,18415
24912,1,512,512,512.00,0.00,18415,18416
24913,2,362,150,256.00,11236.00,18415,18417
24914,1,512,512,512.00,0.00,18416,18417
24915,1,512,512,512.00,0.00,18416,18417
24916,2,322,190,256.00,4356.00,18416,18418
24917,4,299,7,128.00,11315.00,18417,18421
24918,1,512,512,512.00,0.00,18420,18421
24919,2,310,202,256.00,2916.00,18420,18422
24920,6,277,1,85.33,12016.89,18421,18427
24921,3,389,1,170.67,26274.89,18426,18429
24922,1,512,512,512.00,0.00,18428,18429
24923,1,512,512,512.00,0.00,18428,18429
24924,1,512,512,512.00,0.00,18428,18429
24925,1,512,512,512.00,0.00,18428,18429
24926,1,512,512,512.00,0.00,18428,18429
24927,1,512,512,512.00,0.00,18428,18429
24928,2,399,113,256.00,20449.00,18428,18430
24929,2,494,18,256.00,56644.00,18429,18431
24930,2,438,74,256.00,33124.00,18430,18432
24931,1,512,512,512.00,0.00,18431,18432
24932,1,512,512,512.00,0.00,18431,18432
24933,2,318,194,256.00,3844.00,18431,18433
24934,1,512,512,512.00,0.00,18432,18433
24935,3,467,22,170.67,43906.89,18432,18435
24936,3,287,1,170.67,15054.89,18434,18437
24937,2,287,225,256.00,961.00,18436,18438
24938,3,292,90,170.67,7627.56,18437,18440
24939,1,512,512,512.00,0.00,18439,18440
24940,1,512,512,512.00,0.00,18439,18440
24941,1,512,512,512.00,0.00,18439,18440
24942,1,512,512,512.00,0.00,18439,18440
24943,1,512,512,512.00,0.00,18439,18440
24944,3,297,49,170.67,10261.56,18439,18442
24945,1,512,512,512.00,0.00,18441,18442
24946,1,512,512,512.00,0.00,18441,18442
24947,1,512,512,512.00,0.00,18441,18442
24948,1,512,512,512.00,0.00,18441,18442
24949,1,512,512,512.00,0.00,18441,18442
24950,1,512,512,512.00,0.00,18441,18442
24951,5,290,1,102.40,11277.04,18441,18446
24952,1,512,512,512.00,0.00,18445,18446
24953,1,512,512,512.00,0.00,18445,18446
24954,1,512,512,512.00,0.00,18445,18446
24955,1,512,512,512.00,0.00,18445,18446
24956,2,355,157,256.00,9801.00,18445,18447
24957,3,388,15,170.67,25089.56,18446,18449
24958,2,486,26,256.00,52900.00,18448,18450
24959,3,501,3,170.67,54564.22,18449,18452
24960,6,255,1,85.33,7788.89,18451,18457
24961,3,461,7,170.67,42374.89,18456,18459
24962,5,424,3,102.40,26253.04,18458,18463
24963,1,512,512,512.00,0.00,18462,18463
24964,5,368,2,102.40,19804.24,18462,18467
24965,1,512,512,512.00,0.00,18466,18467
24966,1,512,512,512.00,0.00,18466,18467
24967,2,340,172,256.00,7056.00,18466,18468
24968,5,234,2,102.40,9176.24,18467,18472
24969,1,512,512,512.00,0.00,18471,18472
24970,2,321,191,256.00,4225.00,18471,18473
24971,1,512,512,512.00,0.00,18472,18473
24972,1,512,512,512.00,0.00,18472,18473
24973,1,512,512,512.00,0.00,18472,18473
24974,2,428,84,256.00,29584.00,18472,18474
24975,1,512,512,512.00,0.00,18473,18474
24976,1,512,512,512.00,0.00,18473,18474
24977,1,512,512,512.00,0.00,18473,18474
24978,1,512,512,512.00,0.00,18473,18474
24979,1,512,512,512.00,0.00,18473,18474
24980,6,199,5,85.33,5910.22,18473,18479
24981,2,344,168,256.00,7744.00,18478,18480
24982,1,512,512,512.00,0.00,18479,18480
24983,2,302,210,256.00,2116.00,18479,18481
24984,1,512,512,512.00,0.00,18480,18481
24985,2,326,186,256.00,4900.00,18480,18482
24986,2,306,206,256.00,2500.00,18481,18483
24987,1,512,512,512.00,0.00,18482,18483
24988,2,489,23,256.00,54289.00,18482,18484
24989,2,257,255,256.00,1.00,18483,18485
24990,1,512,512,512.00,0.00,18484,18485
24991,1,512,512,512.00,0.00,18484,18485
24992,2,256,256,256.00,0.00,18484,18486
24993,1,512,512,512.00,0.00,18485,18486
24994,2,490,22,256.00,54756.00,18485,18487
24995,1,512,512,512.00,0.00,18486,18487
24996,1,512,512,512.00,0.00,18486,18487
24997,2,294,218,256.00,1444.00,18486,18488
24998,1,512,512,512.00,0.00,18487,18488
24999,3,365,12,170.67,21404.22,18487,18490
25000,1,512,512,512.00,0.00,18489,18490
25001,3,503,2,170.67,55226.89,18489,18492
25002,2,400,112,256.00,20736.00,18491,18493
25003,1,512,512,512.00,0.00,18492,18493
25004,1,512,512,512.00,0.00,18492,18493
25005,1,512,512,512.00,0.00,18492,18493
25006,3,476,14,170.67,46624.89,18492,18495
25007,1,512,512,512.00,0.00,18494,18495
25008,1,512,512,512.00,0.00,18494,18495
25009,2,289,223,256.00,1089.00,18494,18496
25010,3,304,87,170.67,9081.56,18495,18498
25011,1,512,512,512.00,0.00,18497,18498
25012,1,512,512,512.00,0.00,18497,18498
25013,1,512,512,512.00,0.00,18497,18498
25014,2,441,71,256.00,34225.00,18497,18499
25015,1,512,512,512.00,0.00,18498,18499
25016,1,512,512,512.00,0.00,18498,18499
25017,1,512,512,512.00,0.00,18498,18499
25018,3,219,85,170.67,3689.56,18498,18501
25019,1,512,512,512.00,0.00,18500,18501
25020,1,512,512,512.00,0.00,18500,18501
25021,1,512,512,512.00,0.00,18500,18501
25022,2,303,209,256.00,2209.00,18500,18502
25023,1,512,512,512.00,0.00,18501,18502
25024,1,512,512,512.00,0.00,18501,18502
25025,1,512,512,512.00,0.00,18501,18502
25026,1,512,512,512.00,0.00,18501,18502
25027,1,512,512,512.00,0.00,18501,18502
25028,3,239,49,170.67,7438.89,18501,18504
25029,2,402,110,256.00,21316.00,18503,18505
25030,1,512,512,512.00,0.00,18504,18505
25031,2,268,244,256.00,144.00,18504,18506
25032,1,512,512,512.00,0.00,18505,18506
25033,1,512,512,512.00,0.00,18505,18506
25034,2,495,17,256.00,57121.00,18505,18507
25035,3,339,63,170.67,14536.22,18506,18509
25036,2,274,238,256.00,324.00,18508,18510
25037,2,302,210,256.00,2116.00,18509,18511
25038,2,280,232,256.00,576.00,18510,18512
25039,1,512,512,512.00,0.00,18511,18512
25040,1,512,512,512.00,0.00,18511,18512
25041,1,512,512,512.00,0.00,18511,18512
25042,2,372,140,256.00,13456.00,18511,18513
25043,1,512,512,512.00,0.00,18512,18513
25044,1,512,512,512.00,0.00,18512,18513
25045,1,512,512,512.00,0.00,18512,18513
25046,2,511,1,256.00,65025.00,18512,18514
25047,4,481,3,128.00,41606.50,18513,18517
25048,3,430,6,170.67,34443.56,18516,18519
25049,2,310,202,256.00,2916.00,18518,18520
25050,1,512,512,512.00,0.00,18519,18520
25051,1,512,512,512.00,0.00,18519,18520
25052,1,512,512,512.00,0.00,18519,18520
25053,2,432,80,256.00,30976.00,18519,18521
25054,1,512,512,512.00,0.00,18520,18521
25055,1,512,512,512.00,0.00,18520,18521
25056,3,281,106,170.67,6146.89,18520,18523
25057,1,512,512,512.00,0.00,18522,18523
25058,1,512,512,512.00,0.00,18522,18523
25059,1,512,512,512.00,0.00,18522,18523
25060,4,230,2,128.00,8210.00,18522,18526
25061,1,512,512,512.00,0.00,18525,18526
25062,1,512,512,512.00,0.00,18525,18526
25063,1,512,512,512.00,0.00,18525,18526
25064,2,396,116,256.00,19600.00,18525,18527
25065,1,512,512,512.00,0.00,18526,18527
25066,2,364,148,256.00,11664.00,18526,18528
25067,1,512,512,512.00,0.00,18527,18528
25068,2,457,55,256.00,40401.00,18527,18529
25069,2,511,1,256.00,65025.00,18528,18530
25070,3,340,17,170.67,17510.89,18529,18532
25071,1,512,512,512.00,0.00,18531,18532
25072,1,512,512,512.00,0.00,18531,18532
25073,1,512,512,512.00,0.00,18531,18532
25074,1,512,512,512.00,0.00,18531,18532
25075,1,512,512,512.00,0.00,18531,18532
25076,4,254,80,128.00,5330.00,18531,18535
25077,2,489,23,256.00,54289.00,18534,18536
25078,1,512,512,512.00,0.00,18535,18536
25079,2,307,205,256.00,2601.00,18535,18537
25080,3,461,2,170.67,42514.89,18536,18539
25081,5,377,5,102.40,19291.44,18538,18543
25082,1,512,512,512.00,0.00,18542,18543
25083,2,276,236,256.00,400.00,18542,18544
25084,2,468,44,256.00,44944.00,18543,18545
25085,1,512,512,512.00,0.00,18544,18545
25086,1,512,512,512.00,0.00,18544,18545
25087,3,182,163,170.67,66.89,18544,18547
25088,1,512,512,512.00,0.00,18546,18547
25089,1,512,512,512.00,0.00,18546,18547
25090,1,512,512,512.00,0.00,18546,18547
25091,2,387,125,256.00,17161.00,18546,18548
25092,1,512,512,512.00,0.00,18547,18548
25093,2,271,241,256.00,225.00,18547,18549
25094,1,512,512,512.00,0.00,18548,18549
25095,2,492,20,256.00,55696.00,18548,18550
25096,1,512,512,512.00,0.00,18549,18550
25097,1,512,512,512.00,0.00,18549,18550
25098,1,512,512,512.00,0.00,18549,18550
25099,1,512,512,512.00,0.00,18549,18550
25100,1,512,512,512.00,0.00,18549,18550
25101,5,183,63,102.40,1767.84,18549,18554
25102,5,360,4,102.40,18118.64,18553,18558
25103,1,512,512,512.00,0.00,18557,18558
25104,2,388,124,256.00,17424.00,18557,18559
25105,2,277,235,256.00,441.00,18558,18560
25106,1,512,512,512.00,0.00,18559,18560
25107,1,512,512,512.00,0.00,18559,18560
25108,1,512,512,512.00,0.00,18559,18560
25109,1,512,512,512.00,0.00,18559,18560
25110,1,512,512,512.00,0.00,18559,18560
25111,1,512,512,512.00,0.00,18559,18560
25112,1,512,512,512.00,0.00,18559,18560
25113,3,438,16,170.67,36027.56,18559,18562
25114,5,443,9,102.40,29107.04,18561,18566
25115,1,512,512,512.00,0.00,18565,18566
25116,1,512,512,512.00,0.00,18565,18566
25117,3,441,6,170.67,37120.22,18565,18568
25118,2,449,63,256.00,37249.00,18567,18569
25119,1,512,512,512.00,0.00,18568,18569
25120,4,316,4,128.00,14442.00,18568,18572
25121,1,512,512,512.00,0.00,18571,18572
25122,1,512,512,512.00,0.00,18571,18572
25123,3,367,3,170.67,22493.56,18571,18574
25124,2,507,5,256.00,63001.00,18573,18575
25125,5,230,4,102.40,6601.84,18574,18579
25126,6,179,18,85.33,3729.89,18578,18584
25127,2,264,248,256.00,64.00,18583,18585
25128,2,351,161,256.00,9025.00,18584,18586
25129,4,289,2,128.00,16062.50,18585,18589
25130,1,512,512,512.00,0.00,18588,18589
25131,2,366,146,256.00,12100.00,18588,18590
25132,1,512,512,512.00,0.00,18589,18590
25133,1,512,512,512.00,0.00,18589,18590
25134,1,512,512,512.00,0.00,18589,18590
25135,1,512,512,512.00,0.00,18589,18590
25136,2,278,234,256.00,484.00,18589,18591
25137,2,413,99,256.00,24649.00,18590,18592
25138,5,312,7,102.40,12512.24,18591,18596
25139,1,512,512,512.00,0.00,18595,18596
25140,3,387,2,170.67,25840.22,18595,18598
25141,2,387,125,256.00,17161.00,18597,18599
25142,2,486,26,256.00,52900.00,18598,18600
25143,5,320,5,102.40,14447.44,18599,18604
25144,1,512,512,512.00,0.00,18603,18604
25145,2,368,144,256.00,12544.00,18603,18605
25146,1,512,512,512.00,0.00,18604,18605
25147,2,262,250,256.00,36.00,18604,18606
25148,1,512,512,512.00,0.00,18605,18606
25149,2,391,121,256.00,18225.00,18605,18607
25150,1,512,512,512.00,0.00,18606,18607
25151,4,212,2,128.00,6403.50,18606,18610
25152,4,226,9,128.00,6149.50,18609,18613
25153,1,512,512,512.00,0.00,18612,18613
25154,1,512,512,512.00,0.00,18612,18613
25155,2,360,152,256.00,10816.00,18612,18614
25156,2,261,251,256.00,25.00,18613,18615
25157,3,343,16,170.67,17977.56,18614,18617
25158,2,486,26,256.00,52900.00,18616,18618
25159,1,512,512,512.00,0.00,18617,18618
25160,1,512,512,512.00,0.00,18617,18618
25161,1,512,512,512.00,0.00,18617,18618
25162,1,512,512,512.00,0.00,18617,18618
25163,3,268,82,170.67,5803.56,18617,18620
25164,4,286,16,128.00,9666.00,18619,18623
25165,1,512,512,512.00,0.00,18622,18623
25166,2,459,53,256.00,41209.00,18622,18624
25167,1,512,512,512.00,0.00,18623,18624
25168,4,299,42,128.00,10765.50,18623,18627
25169,1,512,512,512.00,0.00,18626,18627
25170,2,398,114,256.00,20164.00,18626,18628
25171,4,234,42,128.00,6756.00,18627,18631
25172,3,457,3,170.67,41393.56,18630,18633
25173,1,512,512,512.00,0.00,18632,18633
25174,1,512,512,512.00,0.00,18632,18633
25175,2,468,44,256.00,44944.00,18632,18634
25176,1,512,512,512.00,0.00,18633,18634
25177,1,512,512,512.00,0.00,18633,18634
25178,1,512,512,512.00,0.00,18633,18634
25179,2,312,200,256.00,3136.00,18633,18635
25180,1,512,512,512.00,0.00,18634,18635
25181,6,408,2,85.33,21208.89,18634,18640
25182,7,149,4,73.14,3205.27,18639,18646
25183,1,512,512,512.00,0.00,18645,18646
25184,4,268,11,128.00,9613.50,18645,18649
25185,2,418,94,256.00,26244.00,18648,18650
25186,3,215,122,170.67,1450.89,18649,18652
25187,9,168,3,56.89,3080.10,18651,18660
25188,2,297,215,256.00,1681.00,18660,18662
25189,1,512,512,512.00,0.00,18661,18662
25190,1,512,512,512.00,0.00,18661,18662
25191,1,512,512,512.00,0.00,18661,18662
25192,1,512,512,512.00,0.00,18661,18662
25193,1,512,512,512.00,0.00,18661,18662
25194,1,512,512,512.00,0.00,18661,18662
25195,1,512,512,512.00,0.00,18661,18662
25196,2,390,122,256.00,17956.00,18661,18663
25197,4,190,91,128.00,1417.50,18662,18666
25198,2,297,215,256.00,1681.00,18665,18667
25199,2,333,179,256.00,5929.00,18666,18668
25200,1,512,512,512.00,0.00,18667,18668
25201,2,313,199,256.00,3249.00,18667,18669
25202,3,436,35,170.67,35206.89,18668,18671
25203,1,512,512,512.00,0.00,18670,18671
25204,5,297,1,102.40,14019.04,18670,18675
25205,2,507,5,256.00,63001.00,18674,18676
25206,1,512,512,512.00,0.00,18675,18676
25207,4,321,21,128.00,13243.50,18675,18679
25208,1,512,512,512.00,0.00,18678,18679
25209,2,444,68,256.00,35344.00,18678,18680
25210,4,285,7,128.00,10097.00,18679,18683
25211,3,270,43,170.67,8989.56,18682,18685
25212,2,481,31,256.00,50625.00,18684,18686
25213,2,360,152,256.00,10816.00,18685,18687
25214,1,512,512,512.00,0.00,18686,18687
25215,1,512,512,512.00,0.00,18686,18687
25216,2,426,86,256.00,28900.00,18686,18688
25217,1,512,512,512.00,0.00,18687,18688
25218,1,512,512,512.00,0.00,18687,18688
25219,4,297,21,128.00,10495.50,18687,18691
25220,1,512,512,512.00,0.00,18690,18691
25221,2,286,226,256.00,900.00,18690,18692
25222,1,512,512,512.00,0.00,18691,18692
25223,2,268,244,256.00,144.00,18691,18693
25224,1,512,512,512.00,0.00,18692,18693
25225,3,499,2,170.67,53914.89,18692,18695
25226,2,305,207,256.00,2401.00,18694,18696
25227,1,512,512,512.00,0.00,18695,18696
25228,1,512,512,512.00,0.00,18695,18696
25229,2,498,14,256.00,58564.00,18695,18697
25230,3,413,2,170.67,30866.89,18696,18699
25231,2,314,198,256.00,3364.00,18698,18700
25232,2,472,40,256.00,46656.00,18699,18701
25233,1,512,512,512.00,0.00,18700,18701
25234,1,512,512,512.00,0.00,18700,18701
25235,1,512,512,512.00,0.00,18700,18701
25236,1,512,512,512.00,0.00,18700,18701
25237,2,317,195,256.00,3721.00,18700,18702
25238,1,512,512,512.00,0.00,18701,18702
25239,1,512,512,512.00,0.00,18701,18702
25240,3,433,17,170.67,34746.89,18701,18704
25241,4,432,3,128.00,31120.50,18703,18707
25242,1,512,512,512.00,0.00,18706,18707
25243,1,512,512,512.00,0.00,18706,18707
25244,1,512,512,512.00,0.00,18706,18707
25245,1,512,512,512.00,0.00,18706,18707
25246,1,512,512,512.00,0.00,18706,18707
25247,2,406,106,256.00,22500.00,18706,18708
25248,1,512,512,512.00,0.00,18707,18708
25249,3,346,67,170.67,15541.56,18707,18710
25250,3,444,12,170.67,37678.22,18709,18712
25251,2,447,65,256.00,36481.00,18711,18713
25252,1,512,512,512.00,0.00,18712,18713
25253,2,296,216,256.00,1600.00,18712,18714
25254,1,512,512,512.00,0.00,18713,18714
25255,2,301,211,256.00,2025.00,18713,18715
25256,1,512,512,512.00,0.00,18714,18715
25257,2,434,78,256.00,31684.00,18714,18716
25258,2,459,53,256.00,41209.00,18715,18717
25259,2,403,109,256.00,21609.00,18716,18718
25260,3,241,43,170.67,8177.56,18717,18720
25261,2,350,162,256.00,8836.00,18719,18721
25262,2,264,248,256.00,64.00,18720,18722
25263,1,512,512,512.00,0.00,18721,18722
25264,2,362,150,256.00,11236.00,18721,18723
25265,1,512,512,512.00,0.00,18722,18723
25266,1,512,512,512.00,0.00,18722,18723
25267,1,512,512,512.00,0.00,18722,18723
25268,1,512,512,512.00,0.00,18722,18723
25269,1,512,512,512.00,0.00,18722,18723
25270,2,331,181,256.00,5625.00,18722,18724
25271,1,512,512,512.00,0.00,18723,18724
25272,1,512,512,512.00,0.00,18723,18724
25273,3,299,93,170.67,8356.22,18723,18726
25274,2,344,168,256.00,7744.00,18725,18727
25275,1,512,512,512.00,0.00,18726,18727
25276,1,512,512,512.00,0.00,18726,18727
25277,2,381,131,256.00,15625.00,18726,18728
25278,4,224,12,128.00,9246.00,18727,18731
25279,1,512,512,512.00,0.00,18730,18731
25280,1,512,512,512.00,0.00,18730,18731
25281,2,398,114,256.00,20164.00,18730,18732
25282,1,512,512,512.00,0.00,18731,18732
25283,2,398,114,256.00,20164.00,18731,18733
25284,3,409,12,170.67,29441.56,18732,18735
25285,2,450,62,256.00,37636.00,18734,18736
25286,1,512,512,512.00,0.00,18735,18736
25287,2,467,45,256.00,44521.00,18735,18737
25288,4,252,38,128.00,6045.50,18736,18740
25289,1,512,512,512.00,0.00,18739,18740
25290,1,512,512,512.00,0.00,18739,18740
25291,3,234,67,170.67,5461.56,18739,18742
25292,4,268,31,128.00,9023.50,18741,18745
25293,1,512,512,512.00,0.00,18744,18745
25294,2,350,162,256.00,8836.00,18744,18746
25295,1,512,512,512.00,0.00,18745,18746
25296,1,512,512,512.00,0.00,18745,18746
25297,1,512,512,512.00,0.00,18745,18746
25298,1,512,512,512.00,0.00,18745,18746
25299,1,512,512,512.00,0.00,18745,18746
25300,1,512,512,512.00,0.00,18745,18746
25301,1,512,512,512.00,0.00,18745,18746
25302,1,512,512,512.00,0.00,18745,18746
25303,1,512,512,512.00,0.00,18745,18746
25304,1,512,512,512.00,0.00,18745,18746
25305,1,512,512,512.00,0.00,18745,18746
25306,2,392,120,256.00,18496.00,18745,18747
25307,1,512,512,512.00,0.00,18746,18747
25308,1,512,512,512.00,0.00,18746,18747
25309,3,306,45,170.67,11400.22,18746,18749
25310,2,498,14,256.00,58564.00,18748,18750
25311,1,512,512,512.00,0.00,18749,18750
25312,1,512,512,512.00,0.00,18749,18750
25313,1,512,512,512.00,0.00,18749,18750
25314,3,269,32,170.67,10174.89,18749,18752
25315,2,364,148,256.00,11664.00,18751,18753
25316,4,231,51,128.00,6141.00,18752,18756
25317,2,406,106,256.00,22500.00,18755,18757
25318,1,512,512,512.00,0.00,18756,18757
25319,1,512,512,512.00,0.00,18756,18757
25320,3,299,90,170.67,8416.22,18756,18759
25321,1,512,512,512.00,0.00,18758,18759
25322,1,512,512,512.00,0.00,18758,18759
25323,3,350,78,170.67,16086.22,18758,18761
25324,1,512,512,512.00,0.00,18760,18761
25325,2,265,247,256.00,81.00,18760,18762
25326,1,512,512,512.00,0.00,18761,18762
25327,1,512,512,512.00,0.00,18761,18762
25328,1,512,512,512.00,0.00,18761,18762
25329,1,512,512,512.00,0.00,18761,18762
25330,2,309,203,256.00,2809.00,18761,18763
25331,3,228,80,170.67,4206.22,18762,18765
25332,1,512,512,512.00,0.00,18764,18765
25333,1,512,512,512.00,0.00,18764,18765
25334,1,512,512,512.00,0.00,18764,18765
25335,1,512,512,512.00,0.00,18764,18765
25336,3,282,73,170.67,7373.56,18764,18767
25337,1,512,512,512.00,0.00,18766,18767
25338,1,512,512,512.00,0.00,18766,18767
25339,2,390,122,256.00,17956.00,18766,18768
25340,2,347,165,256.00,8281.00,18767,18769
25341,1,512,512,512.00,0.00,18768,18769
25342,1,512,512,512.00,0.00,18768,18769
25343,1,512,512,512.00,0.00,18768,18769
25344,3,262,96,170.67,4731.56,18768,18771
25345,4,256,1,128.00,8281.50,18770,18774
25346,1,512,512,512.00,0.00,18773,18774
25347,3,262,94,170.67,4811.56,18773,18776
25348,1,512,512,512.00,0.00,18775,18776
25349,2,365,147,256.00,11881.00,18775,18777
25350,2,446,66,256.00,36100.00,18776,18778
25351,3,387,40,170.67,23737.56,18777,18780
25352,2,311,201,256.00,3025.00,18779,18781
25353,1,512,512,512.00,0.00,18780,18781
25354,2,304,208,256.00,2304.00,18780,18782
25355,1,512,512,512.00,0.00,18781,18782
25356,2,344,168,256.00,7744.00,18781,18783
25357,1,512,512,512.00,0.00,18782,18783
25358,2,426,86,256.00,28900.00,18782,18784
25359,1,512,512,512.00,0.00,18783,18784
25360,4,201,62,128.00,2805.50,18783,18787
25361,3,344,28,170.67,17112.89,18786,18789
25362,1,512,512,512.00,0.00,18788,18789
25363,3,253,87,170.67,4593.56,18788,18791
25364,1,512,512,512.00,0.00,18790,18791
25365,1,512,512,512.00,0.00,18790,18791
25366,1,512,512,512.00,0.00,18790,18791
25367,1,512,512,512.00,0.00,18790,18791
25368,2,464,48,256.00,43264.00,18790,18792
25369,1,512,512,512.00,0.00,18791,18792
25370,1,512,512,512.00,0.00,18791,18792
25371,1,512,512,512.00,0.00,18791,18792
25372,3,437,29,170.67,35514.89,18791,18794
25373,1,512,512,512.00,0.00,18793,18794
25374,2,402,110,256.00,21316.00,18793,18795
25375,1,512,512,512.00,0.00,18794,18795
25376,1,512,512,512.00,0.00,18794,18795
25377,1,512,512,512.00,0.00,18794,18795
25378,2,260,252,256.00,16.00,18794,18796
25379,2,469,43,256.00,45369.00,18795,18797
25380,1,512,512,512.00,0.00,18796,18797
25381,1,512,512,512.00,0.00,18796,18797
25382,1,512,512,512.00,0.00,18796,18797
25383,3,272,83,170.67,6046.89,18796,18799
25384,3,419,2,170.67,32154.89,18798,18801
25385,1,512,512,512.00,0.00,18800,18801
25386,1,512,512,512.00,0.00,18800,18801
25387,2,375,137,256.00,14161.00,18800,18802
25388,2,505,7,256.00,62001.00,18801,18803
25389,2,497,15,256.00,58081.00,18802,18804
25390,1,512,512,512.00,0.00,18803,18804
25391,1,512,512,512.00,0.00,18803,18804
25392,2,458,54,256.00,40804.00,18803,18805
25393,2,349,163,256.00,8649.00,18804,18806
25394,1,512,512,512.00,0.00,18805,18806
25395,1,512,512,512.00,0.00,18805,18806
25396,3,374,1,170.67,23754.89,18805,18808
25397,5,382,1,102.40,19933.84,18807,18812
25398,1,512,512,512.00,0.00,18811,18812
25399,1,512,512,512.00,0.00,18811,18812
25400,4,324,8,128.00,14264.00,18811,18815
25401,1,512,512,512.00,0.00,18814,18815
25402,3,419,6,170.67,31928.22,18814,18817
25403,1,512,512,512.00,0.00,18816,18817
25404,1,512,512,512.00,0.00,18816,18817
25405,1,512,512,512.00,0.00,18816,18817
25406,2,430,82,256.00,30276.00,18816,18818
25407,2,497,15,256.00,58081.00,18817,18819
25408,3,276,18,170.67,12214.22,18818,18821
25409,1,512,512,512.00,0.00,18820,18821
25410,3,272,72,170.67,6670.22,18820,18823
25411,2,346,166,256.00,8100.00,18822,18824
25412,4,250,60,128.00,5249.50,18823,18827
25413,2,494,18,256.00,56644.00,18826,18828
25414,1,512,512,512.00,0.00,18827,18828
25415,1,512,512,512.00,0.00,18827,18828
25416,1,512,512,512.00,0.00,18827,18828
25417,4,363,3,128.00,21537.00,18827,18831
25418,1,512,512,512.00,0.00,18830,18831
25419,2,486,26,256.00,52900.00,18830,18832
25420,1,512,512,512.00,0.00,18831,18832
25421,1,512,512,512.00,0.00,18831,18832
25422,1,512,512,512.00,0.00,18831,18832
25423,1,512,512,512.00,0.00,18831,18832
25424,2,262,250,256.00,36.00,18831,18833
25425,5,389,1,102.40,21541.04,18832,18837
25426,2,326,186,256.00,4900.00,18836,18838
25427,1,512,512,512.00,0.00,18837,18838
25428,3,283,39,170.67,10109.56,18837,18840
25429,2,414,98,256.00,24964.00,18839,18841
25430,1,512,512,512.00,0.00,18840,18841
25431,1,512,512,512.00,0.00,18840,18841
25432,6,207,2,85.33,4719.89,18840,18846
25433,1,512,512,512.00,0.00,18845,18846
25434,1,512,512,512.00,0.00,18845,18846
25435,1,512,512,512.00,0.00,18845,18846
25436,1,512,512,512.00,0.00,18845,18846
25437,2,452,60,256.00,38416.00,18845,18847
25438,1,512,512,512.00,0.00,18846,18847
25439,1,512,512,512.00,0.00,18846,18847
25440,2,267,245,256.00,121.00,18846,18848
25441,1,512,512,512.00,0.00,18847,18848
25442,1,512,512,512.00,0.00,18847,18848
25443,1,512,512,512.00,0.00,18847,18848
25444,2,484,28,256.00,51984.00,18847,18849
25445,1,512,512,512.00,0.00,18848,18849
25446,1,512,512,512.00,0.00,18848,18849
25447,1,512,512,512.00,0.00,18848,18849
25448,1,512,512,512.00,0.00,18848,18849
25449,3,338,12,170.67,17750.22,18848,18851
25450,3,294,3,170.67,15096.22,18851,18854
25451,1,512,512,512.00,0.00,18853,18854
25452,1,512,512,512.00,0.00,18853,18854
25453,1,512,512,512.00,0.00,18853,18854
25454,3,398,4,170.67,27712.89,18853,18856
25455,1,512,512,512.00,0.00,18855,18856
25456,2,359,153,256.00,10609.00,18855,18857
25457,3,444,20,170.67,37486.22,18856,18859
25458,2,366,146,256.00,12100.00,18858,18860
25459,3,420,13,170.67,31809.56,18859,18862
25460,1,512,512,512.00,0.00,18861,18862
25461,1,512,512,512.00,0.00,18861,18862
25462,1,512,512,512.00,0.00,18861,18862
25463,1,512,512,512.00,0.00,18861,18862
25464,1,512,512,512.00,0.00,18861,18862
25465,5,252,46,102.40,5803.84,18861,18866
25466,2,347,165,256.00,8281.00,18865,18867
25467,1,512,512,512.00,0.00,18866,18867
25468,3,403,37,170.67,27193.56,18866,18869
25469,1,512,512,512.00,0.00,18868,18869
25470,1,512,512,512.00,0.00,18868,18869
25471,2,303,209,256.00,2209.00,18868,18870
25472,1,512,512,512.00,0.00,18869,18870
25473,1,512,512,512.00,0.00,18869,18870
25474,1,512,512,512.00,0.00,18869,18870
25475,1,512,512,512.00,0.00,18869,18870
25476,2,468,44,256.00,44944.00,18869,18871
25477,1,512,512,512.00,0.00,18870,18871
25478,3,280,20,170.67,12120.89,18870,18873
25479,2,353,159,256.00,9409.00,18872,18874
25480,1,512,512,512.00,0.00,18873,18874
25481,7,447,3,73.14,23379.84,18873,18880
25482,3,472,2,170.67,45616.89,18879,18882
25483,1,512,512,512.00,0.00,18881,18882
25484,2,392,120,256.00,18496.00,18881,18883
25485,1,512,512,512.00,0.00,18882,18883
25486,1,512,512,512.00,0.00,18882,18883
25487,1,512,512,512.00,0.00,18882,18883
25488,2,492,20,256.00,55696.00,18882,18884
25489,4,455,4,128.00,35937.50,18883,18887
25490,1,512,512,512.00,0.00,18886,18887
25491,3,371,61,170.67,20126.89,18886,18889
25492,1,512,512,512.00,0.00,18888,18889
25493,7,223,1,73.14,7324.69,18888,18895
25494,1,512,512,512.00,0.00,18894,18895
25495,1,512,512,512.00,0.00,18894,18895
25496,9,249,1,56.89,5954.54,18894,18903
25497,2,455,57,256.00,39601.00,18902,18904
25498,1,512,512,512.00,0.00,18903,18904
25499,1,512,512,512.00,0.00,18903,18904
25500,1,512,512,512.00,0.00,18903,18904
25501,1,512,512,512.00,0.00,18903,18904
25502,2,390,122,256.00,17956.00,18903,18905
25503,1,512,512,512.00,0.00,18904,18905
25504,1,512,512,512.00,0.00,18904,18905
25505,1,512,512,512.00,0.00,18904,18905
25506,6,237,1,85.33,9572.89,18904,18910
25507,4,394,1,128.00,24514.50,18909,18913
25508,1,512,512,512.00,0.00,18912,18913
25509,6,371,8,85.33,16985.56,18912,18918
25510,2,365,147,256.00,11881.00,18917,18919
25511,2,485,27,256.00,52441.00,18918,18920
25512,2,437,75,256.00,32761.00,18919,18921
25513,2,367,145,256.00,12321.00,18920,18922
25514,1,512,512,512.00,0.00,18921,18922
25515,5,338,5,102.40,14301.04,18921,18926
25516,1,512,512,512.00,0.00,18925,18926
25517,1,512,512,512.00,0.00,18925,18926
25518,3,308,75,170.67,9916.22,18925,18928
25519,1,512,512,512.00,0.00,18927,18928
25520,4,242,2,128.00,7276.50,18927,18931
25521,3,476,6,170.67,46710.22,18930,18933
25522,5,335,3,102.40,14152.24,18932,18937
25523,1,512,512,512.00,0.00,18936,18937
25524,1,512,512,512.00,0.00,18936,18937
25525,1,512,512,512.00,0.00,18936,18937
25526,1,512,512,512.00,0.00,18936,18937
25527,1,512,512,512.00,0.00,18936,18937
25528,1,512,512,512.00,0.00,18936,18937
25529,5,232,2,102.40,6886.64,18936,18941
25530,1,512,512,512.00,0.00,18940,18941
25531,1,512,512,512.00,0.00,18940,18941
25532,1,512,512,512.00,0.00,18940,18941
25533,2,286,226,256.00,900.00,18940,18942
25534,1,512,512,512.00,0.00,18941,18942
25535,1,512,512,512.00,0.00,18941,18942
25536,2,346,166,256.00,8100.00,18941,18943
25537,3,430,11,170.67,34226.89,18942,18945
25538,1,512,512,512.00,0.00,18944,18945
25539,4,425,23,128.00,29424.50,18944,18948
25540,3,327,29,170.67,14908.22,18947,18950
25541,1,512,512,512.00,0.00,18949,18950
25542,1,512,512,512.00,0.00,18949,18950
25543,5,254,25,102.40,6277.44,18949,18954
25544,7,225,13,73.14,5530.12,18953,18960
25545,1,512,512,512.00,0.00,18959,18960
25546,2,436,76,256.00,32400.00,18959,18961
25547,3,326,1,170.67,17706.89,18960,18963
25548,2,307,205,256.00,2601.00,18962,18964
25549,1,512,512,512.00,0.00,18963,18964
25550,1,512,512,512.00,0.00,18963,18964
25551,1,512,512,512.00,0.00,18963,18964
25552,1,512,512,512.00,0.00,18963,18964
25553,3,388,59,170.67,23622.89,18963,18966
25554,2,424,88,256.00,28224.00,18965,18967
25555,2,383,129,256.00,16129.00,18966,18968
25556,1,512,512,512.00,0.00,18967,18968
25557,1,512,512,512.00,0.00,18967,18968
25558,2,308,204,256.00,2704.00,18967,18969
25559,1,512,512,512.00,0.00,18968,18969
25560,1,512,512,512.00,0.00,18968,18969
25561,2,396,116,256.00,19600.00,18968,18970
25562,3,288,40,170.67,10339.56,18969,18972
25563,1,512,512,512.00,0.00,18971,18972
25564,1,512,512,512.00,0.00,18971,18972
25565,1,512,512,512.00,0.00,18971,18972
25566,1,512,512,512.00,0.00,18971,18972
25567,2,480,32,256.00,50176.00,18971,18973
25568,1,512,512,512.00,0.00,18972,18973
25569,1,512,512,512.00,0.00,18972,18973
25570,1,512,512,512.00,0.00,18972,18973
25571,1,512,512,512.00,0.00,18972,18973
25572,2,374,138,256.00,13924.00,18972,18974
25573,1,512,512,512.00,0.00,18973,18974
25574,1,512,512,512.00,0.00,18973,18974
25575,1,512,512,512.00,0.00,18973,18974
25576,1,512,512,512.00,0.00,18973,18974
25577,1,512,512,512.00,0.00,18973,18974
25578,2,473,39,256.00,47089.00,18973,18975
25579,1,512,512,512.00,0.00,18974,18975
25580,1,512,512,512.00,0.00,18974,18975
25581,1,512,512,512.00,0.00,18974,18975
25582,2,475,37,256.00,47961.00,18974,18976
25583,1,512,512,512.00,0.00,18975,18976
25584,1,512,512,512.00,0.00,18975,18976
25585,3,181,164,170.67,54.89,18975,18978
25586,1,512,512,512.00,0.00,18977,18978
25587,1,512,512,512.00,0.00,18977,18978
25588,3,194,148,170.67,352.89,18977,18980
25589,1,512,512,512.00,0.00,18979,18980
25590,2,323,189,256.00,4489.00,18979,18981
25591,1,512,512,512.00,0.00,18980,18981
25592,1,512,512,512.00,0.00,18980,18981
25593,3,259,17,170.67,11894.89,18980,18983
25594,2,272,240,256.00,256.00,18982,18984
25595,2,319,193,256.00,3969.00,18983,18985
25596,1,512,512,512.00,0.00,18984,18985
25597,1,512,512,512.00,0.00,18984,18985
25598,2,381,131,256.00,15625.00,18984,18986
25599,1,512,512,512.00,0.00,18985,18986
25600,1,512,512,512.00,0.00,18985,18986
25601,1,512,512,512.00,0.00,18985,18986
25602,2,415,97,256.00,25281.00,18985,18987
25603,1,512,512,512.00,0.00,18986,18987
25604,1,512,512,512.00,0.00,18986,18987
25605,3,415,4,170.67,31169.56,18986,18989
25606,1,512,512,512.00,0.00,18988,18989
25607,1,512,512,512.00,0.00,18988,18989
25608,3,246,100,170.67,3563.56,18988,18991
25609,1,512,512,512.00,0.00,18990,18991
25610,2,411,101,256.00,24025.00,18990,18992
25611,1,512,512,512.00,0.00,18991,18992
25612,1,512,512,512.00,0.00,18991,18992
25613,1,512,512,512.00,0.00,18991,18992
25614,2,348,164,256.00,8464.00,18991,18993
25615,1,512,512,512.00,0.00,18992,18993
25616,1,512,512,512.00,0.00,18992,18993
25617,1,512,512,512.00,0.00,18992,18993
25618,1,512,512,512.00,0.00,18992,18993
25619,2,327,185,256.00,5041.00,18992,18994
25620,1,512,512,512.00,0.00,18993,18994
25621,4,388,33,128.00,22560.50,18993,18997
25622,1,512,512,512.00,0.00,18996,18997
25623,1,512,512,512.00,0.00,18996,18997
25624,4,385,27,128.00,22249.00,18996,19000
25625,1,512,512,512.00,0.00,18999,19000
25626,1,512,512,512.00,0.00,18999,19000
25627,1,512,512,512.00,0.00,18999,19000
25628,1,512,512,512.00,0.00,18999,19000
25629,1,512,512,512.00,0.00,18999,19000
25630,2,278,234,256.00,484.00,18999,19001
25631,1,512,512,512.00,0.00,19000,19001
25632,1,512,512,512.00,0.00,19000,19001
25633,1,512,512,512.00,0.00,19000,19001
25634,1,512,512,512.00,0.00,19000,19001
25635,1,512,512,512.00,0.00,19000,19001
25636,4,184,28,128.00,3726.00,19000,19004
25637,1,512,512,512.00,0.00,19003,19004
25638,2,476,36,256.00,48400.00,19003,19005
25639,1,512,512,512.00,0.00,19004,19005
25640,1,512,512,512.00,0.00,19004,19005
25641,2,286,226,256.00,900.00,19004,19006
25642,1,512,512,512.00,0.00,19005,19006
25643,2,339,173,256.00,6889.00,19005,19007
25644,1,512,512,512.00,0.00,19006,19007
25645,1,512,512,512.00,0.00,19006,19007
25646,1,512,512,512.00,0.00,19006,19007
25647,3,381,1,170.67,24893.56,19006,19009
25648,5,259,16,102.40,7739.04,19008,19013
25649,1,512,512,512.00,0.00,19012,19013
25650,2,403,109,256.00,21609.00,19012,19014
25651,1,512,512,512.00,0.00,19013,19014
25652,1,512,512,512.00,0.00,19013,19014
25653,1,512,512,512.00,0.00,19013,19014
25654,1,512,512,512.00,0.00,19013,19014
25655,3,412,35,170.67,29270.89,19013,19016
25656,1,512,512,512.00,0.00,19015,19016
25657,1,512,512,512.00,0.00,19015,19016
25658,1,512,512,512.00,0.00,19015,19016
25659,2,312,200,256.00,3136.00,19015,19017
25660,1,512,512,512.00,0.00,19016,19017
25661,1,512,512,512.00,0.00,19016,19017
25662,1,512,512,512.00,0.00,19016,19017
25663,2,316,196,256.00,3600.00,19016,19018
25664,1,512,512,512.00,0.00,19017,19018
25665,1,512,512,512.00,0.00,19017,19018
25666,1,512,512,512.00,0.00,19017,19018
25667,2,419,93,256.00,26569.00,19017,19019
25668,1,512,512,512.00,0.00,19018,19019
25669,2,375,137,256.00,14161.00,19018,19020
25670,2,462,50,256.00,42436.00,19019,19021
25671,1,512,512,512.00,0.00,19020,19021
25672,1,512,512,512.00,0.00,19020,19021
25673,2,357,155,256.00,10201.00,19020,19022
25674,1,512,512,512.00,0.00,19021,19022
25675,2,484,28,256.00,51984.00,19021,19023
25676,1,512,512,512.00,0.00,19022,19023
25677,1,512,512,512.00,0.00,19022,19023
25678,2,417,95,256.00,25921.00,19022,19024
25679,1,512,512,512.00,0.00,19023,19024
25680,1,512,512,512.00,0.00,19023,19024
25681,1,512,512,512.00,0.00,19023,19024
25682,2,465,47,256.00,43681.00,19023,19025
25683,1,512,512,512.00,0.00,19024,19025
25684,1,512,512,512.00,0.00,19024,19025
25685,1,512,512,512.00,0.00,19024,19025
25686,2,501,11,256.00,60025.00,19024,19026
25687,1,512,512,512.00,0.00,19025,19026
25688,1,512,512,512.00,0.00,19025,19026
25689,2,489,23,256.00,54289.00,19025,19027
25690,1,512,512,512.00,0.00,19026,19027
25691,1,512,512,512.00,0.00,19026,19027
25692,1,512,512,512.00,0.00,19026,19027
25693,2,504,8,256.00,61504.00,19026,19028
25694,1,512,512,512.00,0.00,19027,19028
25695,2,294,218,256.00,1444.00,19027,19029
25696,3,402,18,170.67,27670.22,19028,19031
25697,1,512,512,512.00,0.00,19030,19031
25698,1,512,512,512.00,0.00,19030,19031
25699,4,467,1,128.00,38412.50,19030,19034
25700,1,512,512,512.00,0.00,19033,19034
25701,1,512,512,512.00,0.00,19033,19034
25702,1,512,512,512.00,0.00,19033,19034
25703,2,343,169,256.00,7569.00,19033,19035
25704,1,512,512,512.00,0.00,19034,19035
25705,1,512,512,512.00,0.00,19034,19035
25706,1,512,512,512.00,0.00,19034,19035
25707,1,512,512,512.00,0.00,19034,19035
25708,1,512,512,512.00,0.00,19034,19035
25709,2,317,195,256.00,3721.00,19034,19036
25710,3,346,22,170.67,17851.56,19035,19038
25711,1,512,512,512.00,0.00,19037,19038
25712,1,512,512,512.00,0.00,19037,19038
25713,4,291,19,128.00,12569.00,19037,19041
25714,1,512,512,512.00,0.00,19040,19041
25715,1,512,512,512.00,0.00,19040,19041
25716,1,512,512,512.00,0.00,19040,19041
25717,1,512,512,512.00,0.00,19040,19041
25718,1,512,512,512.00,0.00,19040,19041
25719,2,491,21,256.00,55225.00,19040,19042
25720,1,512,512,512.00,0.00,19041,19042
25721,4,359,4,128.00,18720.50,19041,19045
25722,3,253,85,170.67,4709.56,19044,19047
25723,1,512,512,512.00,0.00,19046,19047
25724,2,511,1,256.00,65025.00,19046,19048
25725,1,512,512,512.00,0.00,19047,19048
25726,5,140,37,102.40,1254.64,19047,19052
25727,1,512,512,512.00,0.00,19051,19052
25728,1,512,512,512.00,0.00,19051,19052
25729,1,512,512,512.00,0.00,19051,19052
25730,3,447,1,170.67,38841.56,19051,19054
25731,1,512,512,512.00,0.00,19053,19054
25732,1,512,512,512.00,0.00,19053,19054
25733,2,441,71,256.00,34225.00,19053,19055
25734,4,295,4,128.00,12643.50,19054,19058
25735,2,272,240,256.00,256.00,19057,19059
25736,2,299,213,256.00,1849.00,19058,19060
25737,2,457,55,256.00,40401.00,19059,19061
25738,1,512,512,512.00,0.00,19060,19061
25739,1,512,512,512.00,0.00,19060,19061
25740,4,272,1,128.00,9882.50,19060,19064
25741,1,512,512,512.00,0.00,19063,19064
25742,1,512,512,512.00,0.00,19063,19064
25743,1,512,512,512.00,0.00,19063,19064
25744,1,512,512,512.00,0.00,19063,19064
25745,2,445,67,256.00,35721.00,19063,19065
25746,1,512,512,512.00,0.00,19064,19065
25747,1,512,512,512.00,0.00,19064,19065
25748,1,512,512,512.00,0.00,19064,19065
25749,1,512,512,512.00,0.00,19064,19065
25750,1,512,512,512.00,0.00,19064,19065
25751,1,512,512,512.00,0.00,19064,19065
25752,4,359,4,128.00,20211.50,19064,19068
25753,1,512,512,512.00,0.00,19067,19068
25754,2,483,29,256.00,51529.00,19067,19069
25755,2,475,37,256.00,47961.00,19068,19070
25756,1,512,512,512.00,0.00,19069,19070
25757,1,512,512,512.00,0.00,19069,19070
25758,1,512,512,512.00,0.00,19069,19070
25759,4,352,5,128.00,18826.50,19069,19073
25760,3,417,40,170.67,30377.56,19072,19075
25761,1,512,512,512.00,0.00,19074,19075
25762,2,278,234,256.00,484.00,19074,19076
25763,1,512,512,512.00,0.00,19075,19076
25764,1,512,512,512.00,0.00,19075,19076
25765,2,348,164,256.00,8464.00,19075,19077
25766,1,512,512,512.00,0.00,19076,19077
25767,1,512,512,512.00,0.00,19076,19077
25768,1,512,512,512.00,0.00,19076,19077
25769,1,512,512,512.00,0.00,19076,19077
25770,2,510,2,256.00,64516.00,19076,19078
25771,3,313,10,170.67,15469.56,19077,19080
25772,1,512,512,512.00,0.00,19079,19080
25773,1,512,512,512.00,0.00,19079,19080
25774,1,512,512,512.00,0.00,19080,19081
25775,1,512,512,512.00,0.00,19080,19081
25776,2,408,104,256.00,23104.00,19080,19082
25777,3,474,16,170.67,46011.56,19081,19084
25778,1,512,512,512.00,0.00,19083,19084
25779,3,281,36,170.67,10300.22,19083,19086
25780,4,258,20,128.00,11251.50,19085,19089
25781,2,430,82,256.00,30276.00,19088,19090
25782,1,512,512,512.00,0.00,19089,19090
25783,1,512,512,512.00,0.00,19089,19090
25784,1,512,512,512.00,0.00,19089,19090
25785,1,512,512,512.00,0.00,19089,19090
25786,1,512,512,512.00,0.00,19089,19090
25787,2,273,239,256.00,289.00,19089,19091
25788,2,319,193,256.00,3969.00,19090,19092
25789,1,512,512,512.00,0.00,19091,19092
25790,2,263,249,256.00,49.00,19091,19093
25791,1,512,512,512.00,0.00,19092,19093
25792,3,219,113,170.67,1916.22,19092,19095
25793,1,512,512,512.00,0.00,19094,19095
25794,1,512,512,512.00,0.00,19094,19095
25795,2,319,193,256.00,3969.00,19094,19096
25796,1,512,512,512.00,0.00,19095,19096
25797,2,259,253,256.00,9.00,19095,19097
25798,1,512,512,512.00,0.00,19096,19097
25799,3,452,20,170.67,39640.89,19096,19099
25800,1,512,512,512.00,0.00,19098,19099
25801,4,325,13,128.00,16513.50,19098,19102
25802,4,257,36,128.00,6600.50,19101,19105
25803,3,354,11,170.67,19888.22,19104,19107
25804,2,320,192,256.00,4096.00,19106,19108
25805,3,244,119,170.67,2838.89,19107,19110
25806,1,512,512,512.00,0.00,19109,19110
25807,1,512,512,512.00,0.00,19109,19110
25808,1,512,512,512.00,0.00,19109,19110
25809,4,238,34,128.00,6234.00,19109,19113
25810,1,512,512,512.00,0.00,19112,19113
25811,1,512,512,512.00,0.00,19112,19113
25812,1,512,512,512.00,0.00,19112,19113
25813,1,512,512,512.00,0.00,19112,19113
25814,2,471,41,256.00,46225.00,19112,19114
25815,5,390,1,102.40,21684.24,19113,19118
25816,3,306,9,170.67,15048.22,19117,19120
25817,2,322,190,256.00,4356.00,19119,19121
25818,1,512,512,512.00,0.00,19120,19121
25819,1,512,512,512.00,0.00,19120,19121
25820,1,512,512,512.00,0.00,19120,19121
25821,3,316,11,170.67,15606.89,19120,19123
25822,2,377,135,256.00,14641.00,19122,19124
25823,2,448,64,256.00,36864.00,19123,19125
25824,1,512,512,512.00,0.00,19124,19125
25825,2,421,91,256.00,27225.00,19124,19126
25826,1,512,512,512.00,0.00,19125,19126
25827,1,512,512,512.00,0.00,19125,19126
25828,1,512,512,512.00,0.00,19125,19126
25829,1,512,512,512.00,0.00,19125,19126
25830,2,389,123,256.00,17689.00,19125,19127
25831,1,512,512,512.00,0.00,19126,19127
25832,1,512,512,512.00,0.00,19126,19127
25833,1,512,512,512.00,0.00,19126,19127
25834,3,363,51,170.67,18864.22,19126,19129
25835,1,512,512,512.00,0.00,19128,19129
25836,1,512,512,512.00,0.00,19128,19129
25837,2,301,211,256.00,2025.00,19128,19130
25838,1,512,512,512.00,0.00,19129,19130
25839,3,380,11,170.67,23926.89,19129,19132
25840,1,512,512,512.00,0.00,19131,19132
25841,1,512,512,512.00,0.00,19131,19132
25842,1,512,512,512.00,0.00,19131,19132
25843,4,218,64,128.00,3231.50,19131,19135
25844,2,499,13,256.00,59049.00,19134,19136
25845,2,295,217,256.00,1521.00,19135,19137
25846,1,512,512,512.00,0.00,19136,19137
25847,1,512,512,512.00,0.00,19136,19137
25848,1,512,512,512.00,0.00,19136,19137
25849,3,287,45,170.67,9804.22,19136,19139
25850,1,512,512,512.00,0.00,19138,19139
25851,3,301,6,170.67,15093.56,19138,19141
25852,1,512,512,512.00,0.00,19140,19141
25853,2,361,151,256.00,11025.00,19140,19142
25854,1,512,512,512.00,0.00,19141,19142
25855,1,512,512,512.00,0.00,19141,19142
25856,2,304,208,256.00,2304.00,19141,19143
25857,1,512,512,512.00,0.00,19142,19143
25858,1,512,512,512.00,0.00,19142,19143
25859,2,442,70,256.00,34596.00,19142,19144
25860,1,512,512,512.00,0.00,19143,19144
25861,1,512,512,512.00,0.00,19143,19144
25862,2,497,15,256.00,58081.00,19143,19145
25863,1,512,512,512.00,0.00,19144,19145
25864,2,478,34,256.00,49284.00,19144,19146
25865,2,304,208,256.00,2304.00,19145,19147
25866,3,341,5,170.67,18826.89,19146,19149
25867,3,346,16,170.67,18363.56,19148,19151
25868,2,397,115,256.00,19881.00,19150,19152
25869,1,512,512,512.00,0.00,19151,19152
25870,1,512,512,512.00,0.00,19151,19152
25871,1,512,512,512.00,0.00,19151,19152
25872,2,288,224,256.00,1024.00,19151,19153
25873,1,512,512,512.00,0.00,19152,19153
25874,1,512,512,512.00,0.00,19152,19153
25875,1,512,512,512.00,0.00,19152,19153
25876,1,512,512,512.00,0.00,19152,19153
25877,5,327,2,102.40,16830.64,19152,19157
25878,2,405,107,256.00,22201.00,19156,19158
25879,4,287,2,128.00,16203.50,19157,19161
25880,2,390,122,256.00,17956.00,19160,19162
25881,1,512,512,512.00,0.00,19161,19162
25882,1,512,512,512.00,0.00,19161,19162
25883,1,512,512,512.00,0.00,19161,19162
25884,2,345,167,256.00,7921.00,19161,19163
25885,1,512,512,512.00,0.00,19162,19163
25886,1,512,512,512.00,0.00,19162,19163
25887,2,368,144,256.00,12544.00,19162,19164
25888,3,287,109,170.67,6774.89,19163,19166
25889,1,512,512,512.00,0.00,19165,19166
25890,1,512,512,512.00,0.00,19165,19166
25891,1,512,512,512.00,0.00,19165,19166
25892,1,512,512,512.00,0.00,19165,19166
25893,2,348,164,256.00,8464.00,19165,19167
25894,2,331,181,256.00,5625.00,19166,19168
25895,1,512,512,512.00,0.00,19167,19168
25896,2,457,55,256.00,40401.00,19167,19169
25897,1,512,512,512.00,0.00,19168,19169
25898,1,512,512,512.00,0.00,19168,19169
25899,3,326,2,170.67,17584.89,19168,19171
25900,1,512,512,512.00,0.00,19170,19171
25901,1,512,512,512.00,0.00,19170,19171
25902,1,512,512,512.00,0.00,19170,19171
25903,5,193,28,102.40,2927.44,19170,19175
25904,2,419,93,256.00,26569.00,19174,19176
25905,1,512,512,512.00,0.00,19175,19176
25906,1,512,512,512.00,0.00,19175,19176
25907,2,281,231,256.00,625.00,19175,19177
25908,2,375,137,256.00,14161.00,19176,19178
25909,2,386,126,256.00,16900.00,19177,19179
25910,1,512,512,512.00,0.00,19178,19179
25911,1,512,512,512.00,0.00,19178,19179
25912,2,487,25,256.00,53361.00,19178,19180
25913,1,512,512,512.00,0.00,19179,19180
25914,3,323,15,170.67,15816.22,19179,19182
25915,1,512,512,512.00,0.00,19181,19182
25916,1,512,512,512.00,0.00,19181,19182
25917,1,512,512,512.00,0.00,19181,19182
25918,1,512,512,512.00,0.00,19181,19182
25919,1,512,512,512.00,0.00,19181,19182
25920,2,452,60,256.00,38416.00,19181,19183
25921,1,512,512,512.00,0.00,19182,19183
25922,1,512,512,512.00,0.00,19182,19183
25923,1,512,512,512.00,0.00,19182,19183
25924,1,512,512,512.00,0.00,19182,19183
25925,2,346,166,256.00,8100.00,19182,19184
25926,1,512,512,512.00,0.00,19183,19184
25927,2,332,180,256.00,5776.00,19183,19185
25928,3,277,2,170.67,14546.89,19184,19187
25929,3,454,25,170.67,40149.56,19186,19189
25930,3,328,13,170.67,16537.56,19188,19191
25931,1,512,512,512.00,0.00,19190,19191
25932,1,512,512,512.00,0.00,19190,19191
25933,2,367,145,256.00,12321.00,19190,19192
25934,1,512,512,512.00,0.00,19191,19192
25935,1,512,512,512.00,0.00,19191,19192
25936,1,512,512,512.00,0.00,19191,19192
25937,1,512,512,512.00,0.00,19191,19192
25938,1,512,512,512.00,0.00,19191,19192
25939,2,440,72,256.00,33856.00,19191,19193
25940,2,441,71,256.00,34225.00,19192,19194
25941,1,512,512,512.00,0.00,19193,19194
25942,1,512,512,512.00,0.00,19193,19194
25943,1,512,512,512.00,0.00,19193,19194
25944,2,422,90,256.00,27556.00,19193,19195
25945,1,512,512,512.00,0.00,19194,19195
25946,3,250,79,170.67,4949.56,19194,19197
25947,1,512,512,512.00,0.00,19196,19197
25948,3,220,105,170.67,2337.56,19196,19199
25949,1,512,512,512.00,0.00,19198,19199
25950,1,512,512,512.00,0.00,19198,19199
25951,1,512,512,512.00,0.00,19198,19199
25952,1,512,512,512.00,0.00,19198,19199
25953,2,315,197,256.00,3481.00,19198,19200
25954,2,354,158,256.00,9604.00,19199,19201
25955,1,512,512,512.00,0.00,19200,19201
25956,1,512,512,512.00,0.00,19200,19201
25957,2,443,69,256.00,34969.00,19200,19202
25958,1,512,512,512.00,0.00,19201,19202
25959,1,512,512,512.00,0.00,19201,19202
25960,2,483,29,256.00,51529.00,19201,19203
25961,1,512,512,512.00,0.00,19202,19203
25962,1,512,512,512.00,0.00,19202,19203
25963,1,512,512,512.00,0.00,19202,19203
25964,1,512,512,512.00,0.00,19202,19203
25965,1,512,512,512.00,0.00,19202,19203
25966,2,504,8,256.00,61504.00,19202,19204
25967,1,512,512,512.00,0.00,19203,19204
25968,1,512,512,512.00,0.00,19203,19204
25969,1,512,512,512.00,0.00,19203,19204
25970,2,288,224,256.00,1024.00,19203,19205
25971,3,450,20,170.67,39094.22,19204,19207
25972,1,512,512,512.00,0.00,19206,19207
25973,1,512,512,512.00,0.00,19206,19207
25974,1,512,512,512.00,0.00,19206,19207
25975,1,512,512,512.00,0.00,19206,19207
25976,1,512,512,512.00,0.00,19206,19207
25977,2,442,70,256.00,34596.00,19206,19208
25978,1,512,512,512.00,0.00,19207,19208
25979,2,370,142,256.00,12996.00,19207,19209
25980,1,512,512,512.00,0.00,19208,19209
25981,1,512,512,512.00,0.00,19208,19209
25982,2,442,70,256.00,34596.00,19208,19210
25983,1,512,512,512.00,0.00,19209,19210
25984,2,325,187,256.00,4761.00,19209,19211
25985,1,512,512,512.00,0.00,19210,19211
25986,3,306,59,170.67,10448.22,19210,19213
25987,1,512,512,512.00,0.00,19212,19213
25988,1,512,512,512.00,0.00,19212,19213
25989,2,328,184,256.00,5184.00,19212,19214
25990,1,512,512,512.00,0.00,19213,19214
25991,1,512,512,512.00,0.00,19213,19214
25992,2,381,131,256.00,15625.00,19213,19215
25993,2,427,85,256.00,29241.00,19214,19216
25994,1,512,512,512.00,0.00,19215,19216
25995,2,485,27,256.00,52441.00,19215,19217
25996,1,512,512,512.00,0.00,19216,19217
25997,1,512,512,512.00,0.00,19216,19217
25998,1,512,512,512.00,0.00,19216,19217
25999,2,344,168,256.00,7744.00,19216,19218
26000,2,269,243,256.00,169.00,19217,19219
26001,1,512,512,512.00,0.00,19218,19219
26002,1,512,512,512.00,0.00,19218,19219
26003,1,512,512,512.00,0.00,19218,19219
26004,2,287,225,256.00,961.00,19218,19220
26005,1,512,512,512.00,0.00,19219,19220
26006,1,512,512,512.00,0.00,19219,19220
26007,1,512,512,512.00,0.00,19219,19220
26008,1,512,512,512.00,0.00,19219,19220
26009,1,512,512,512.00,0.00,19219,19220
26010,3,305,61,170.67,10226.89,19219,19222
26011,2,309,203,256.00,2809.00,19221,19223
26012,1,512,512,512.00,0.00,19222,19223
26013,1,512,512,512.00,0.00,19222,19223
26014,2,309,203,256.00,2809.00,19222,19224
26015,2,269,243,256.00,169.00,19223,19225
26016,1,512,512,512.00,0.00,19224,19225
26017,1,512,512,512.00,0.00,19224,19225
26018,2,320,192,256.00,4096.00,19224,19226
26019,2,406,106,256.00,22500.00,19225,19227
26020,2,366,146,256.00,12100.00,19226,19228
26021,2,430,82,256.00,30276.00,19227,19229
26022,1,512,512,512.00,0.00,19228,19229
26023,2,258,254,256.00,4.00,19228,19230
26024,1,512,512,512.00,0.00,19229,19230
26025,2,428,84,256.00,29584.00,19229,19231
26026,1,512,512,512.00,0.00,19230,19231
26027,1,512,512,512.00,0.00,19230,19231
26028,3,354,2,170.67,20758.22,19230,19233
26029,4,354,8,128.00,18974.00,19232,19236
26030,1,512,512,512.00,0.00,19235,19236
26031,1,512,512,512.00,0.00,19235,19236
26032,1,512,512,512.00,0.00,19235,19236
26033,3,200,122,170.67,1200.89,19235,19238
26034,1,512,512,512.00,0.00,19237,19238
26035,1,512,512,512.00,0.00,19237,19238
26036,1,512,512,512.00,0.00,19237,19238
26037,1,512,512,512.00,0.00,19237,19238
26038,2,416,96,256.00,25600.00,19237,19239
26039,1,512,512,512.00,0.00,19238,19239
26040,2,498,14,256.00,58564.00,19238,19240
26041,1,512,512,512.00,0.00,19239,19240
26042,1,512,512,512.00,0.00,19239,19240
26043,1,512,512,512.00,0.00,19239,19240
26044,2,467,45,256.00,44521.00,19239,19241
26045,2,296,216,256.00,1600.00,19240,19242
26046,2,350,162,256.00,8836.00,19241,19243
26047,3,484,1,170.67,49201.56,19242,19245
26048,3,276,84,170.67,6318.22,19244,19247
26049,1,512,512,512.00,0.00,19246,19247
26050,1,512,512,512.00,0.00,19246,19247
26051,1,512,512,512.00,0.00,19246,19247
26052,2,434,78,256.00,31684.00,19246,19248
26053,1,512,512,512.00,0.00,19247,19248
26054,2,477,35,256.00,48841.00,19247,19249
26055,3,381,1,170.67,24893.56,19248,19251
26056,2,335,177,256.00,6241.00,19250,19252
26057,1,512,512,512.00,0.00,19251,19252
26058,2,287,225,256.00,961.00,19251,19253
26059,1,512,512,512.00,0.00,19252,19253
26060,2,508,4,256.00,63504.00,19252,19254
26061,1,512,512,512.00,0.00,19253,19254
26062,2,434,78,256.00,31684.00,19253,19255
26063,1,512,512,512.00,0.00,19254,19255
26064,1,512,512,512.00,0.00,19254,19255
26065,3,212,125,170.67,1270.89,19254,19257
26066,1,512,512,512.00,0.00,19256,19257
26067,1,512,512,512.00,0.00,19256,19257
26068,2,373,139,256.00,13689.00,19256,19258
26069,2,495,17,256.00,57121.00,19257,19259
26070,1,512,512,512.00,0.00,19258,19259
26071,2,263,249,256.00,49.00,19258,19260
26072,1,512,512,512.00,0.00,19259,19260
26073,1,512,512,512.00,0.00,19259,19260
26074,2,402,110,256.00,21316.00,19259,19261
26075,2,392,120,256.00,18496.00,19260,19262
26076,1,512,512,512.00,0.00,19261,19262
26077,2,279,233,256.00,529.00,19261,19263
26078,2,502,10,256.00,60516.00,19262,19264
26079,1,512,512,512.00,0.00,19263,19264
26080,1,512,512,512.00,0.00,19263,19264
26081,1,512,512,512.00,0.00,19263,19264
26082,1,512,512,512.00,0.00,19263,19264
26083,5,234,6,102.40,6323.44,19263,19268
26084,2,459,53,256.00,41209.00,19267,19269
26085,1,512,512,512.00,0.00,19268,19269
26086,1,512,512,512.00,0.00,19268,19269
26087,2,304,208,256.00,2304.00,19268,19270
26088,2,343,169,256.00,7569.00,19269,19271
26089,1,512,512,512.00,0.00,19270,19271
26090,1,512,512,512.00,0.00,19270,19271
26091,1,512,512,512.00,0.00,19270,19271
26092,1,512,512,512.00,0.00,19270,19271
26093,1,512,512,512.00,0.00,19270,19271
26094,2,281,231,256.00,625.00,19270,19272
26095,1,512,512,512.00,0.00,19271,19272
26096,1,512,512,512.00,0.00,19271,19272
26097,2,334,178,256.00,6084.00,19271,19273
26098,3,317,7,170.67,16166.89,19272,19275
26099,1,512,512,512.00,0.00,19274,19275
26100,2,443,69,256.00,34969.00,19274,19276
26101,3,241,35,170.67,9206.89,19275,19278
26102,1,512,512,512.00,0.00,19277,19278
26103,1,512,512,512.00,0.00,19277,19278
26104,3,415,16,170.67,30553.56,19277,19280
26105,2,458,54,256.00,40804.00,19279,19281
26106,1,512,512,512.00,0.00,19280,19281
26107,4,483,2,128.00,42058.50,19280,19284
26108,2,364,148,256.00,11664.00,19283,19285
26109,1,512,512,512.00,0.00,19284,19285
26110,1,512,512,512.00,0.00,19284,19285
26111,2,263,249,256.00,49.00,19284,19286
26112,3,265,36,170.67,9553.56,19285,19288
26113,2,408,104,256.00,23104.00,19287,19289
26114,1,512,512,512.00,0.00,19288,19289
26115,1,512,512,512.00,0.00,19288,19289
26116,2,491,21,256.00,55225.00,19288,19290
26117,1,512,512,512.00,0.00,19289,19290
26118,1,512,512,512.00,0.00,19289,19290
26119,1,512,512,512.00,0.00,19289,19290
26120,2,500,12,256.00,59536.00,19289,19291
26121,1,512,512,512.00,0.00,19290,19291
26122,1,512,512,512.00,0.00,19290,19291
26123,1,512,512,512.00,0.00,19290,19291
26124,3,404,1,170.67,29094.89,19290,19293
26125,1,512,512,512.00,0.00,19292,19293
26126,1,512,512,512.00,0.00,19292,19293
26127,2,484,28,256.00,51984.00,19292,19294
26128,1,512,512,512.00,0.00,19293,19294
26129,1,512,512,512.00,0.00,19293,19294
26130,1,512,512,512.00,0.00,19293,19294
26131,2,351,161,256.00,9025.00,19293,19295
26132,1,512,512,512.00,0.00,19294,19295
26133,1,512,512,512.00,0.00,19294,19295
26134,2,476,36,256.00,48400.00,19294,19296
26135,1,512,512,512.00,0.00,19295,19296
26136,1,512,512,512.00,0.00,19295,19296
26137,2,401,111,256.00,21025.00,19295,19297
26138,2,372,140,256.00,13456.00,19296,19298
26139,2,268,244,256.00,144.00,19297,19299
26140,1,512,512,512.00,0.00,19298,19299
26141,3,454,15,170.67,40269.56,19298,19301
26142,2,317,195,256.00,3721.00,19300,19302
26143,1,512,512,512.00,0.00,19301,19302
26144,1,512,512,512.00,0.00,19301,19302
26145,3,352,74,170.67,16464.89,19301,19304
26146,2,342,170,256.00,7396.00,19303,19305
26147,1,512,512,512.00,0.00,19304,19305
26148,1,512,512,512.00,0.00,19304,19305
26149,1,512,512,512.00,0.00,19304,19305
26150,2,429,83,256.00,29929.00,19304,19306
26151,1,512,512,512.00,0.00,19305,19306
26152,1,512,512,512.00,0.00,19305,19306
26153,1,512,512,512.00,0.00,19305,19306
26154,2,399,113,256.00,20449.00,19305,19307
26155,1,512,512,512.00,0.00,19306,19307
26156,3,256,4,170.67,13891.56,19306,19309
26157,1,512,512,512.00,0.00,19308,19309
26158,1,512,512,512.00,0.00,19308,19309
26159,3,434,19,170.67,34938.89,19308,19311
26160,1,512,512,512.00,0.00,19310,19311
26161,1,512,512,512.00,0.00,19310,19311
26162,1,512,512,512.00,0.00,19310,19311
26163,1,512,512,512.00,0.00,19310,19311
26164,1,512,512,512.00,0.00,19310,19311
26165,2,494,18,256.00,56644.00,19310,19312
26166,1,512,512,512.00,0.00,19311,19312
26167,1,512,512,512.00,0.00,19311,19312
26168,1,512,512,512.00,0.00,19311,19312
26169,1,512,512,512.00,0.00,19311,19312
26170,3,345,5,170.67,19304.22,19311,19314
26171,2,459,53,256.00,41209.00,19313,19315
26172,2,308,204,256.00,2704.00,19314,19316
26173,1,512,512,512.00,0.00,19315,19316
26174,2,420,92,256.00,26896.00,19315,19317
26175,3,456,2,170.67,41158.22,19316,19319
26176,1,512,512,512.00,0.00,19318,19319
26177,1,512,512,512.00,0.00,19318,19319
26178,2,284,228,256.00,784.00,19318,19320
26179,1,512,512,512.00,0.00,19319,19320
26180,1,512,512,512.00,0.00,19319,19320
26181,3,365,60,170.67,19004.22,19319,19322
26182,1,512,512,512.00,0.00,19321,19322
26183,1,512,512,512.00,0.00,19321,19322
26184,2,291,221,256.00,1225.00,19321,19323
26185,2,411,101,256.00,24025.00,19322,19324
26186,1,512,512,512.00,0.00,19323,19324
26187,3,365,59,170.67,19022.89,19323,19326
26188,1,512,512,512.00,0.00,19325,19326
26189,1,512,512,512.00,0.00,19325,19326
26190,1,512,512,512.00,0.00,19325,19326
26191,1,512,512,512.00,0.00,19325,19326
26192,2,262,250,256.00,36.00,19325,19327
26193,2,288,224,256.00,1024.00,19326,19328
26194,1,512,512,512.00,0.00,19327,19328
26195,1,512,512,512.00,0.00,19327,19328
26196,2,429,83,256.00,29929.00,19327,19329
26197,1,512,512,512.00,0.00,19328,19329
26198,4,417,7,128.00,28433.00,19328,19332
26199,1,512,512,512.00,0.00,19331,19332
26200,1,512,512,512.00,0.00,19331,19332
26201,1,512,512,512.00,0.00,19331,19332
26202,1,512,512,512.00,0.00,19331,19332
26203,1,512,512,512.00,0.00,19331,19332
26204,3,221,95,170.67,2966.89,19331,19334
26205,2,303,209,256.00,2209.00,19333,19335
26206,1,512,512,512.00,0.00,19334,19335
26207,1,512,512,512.00,0.00,19334,19335
26208,1,512,512,512.00,0.00,19334,19335
26209,2,423,89,256.00,27889.00,19334,19336
26210,2,488,24,256.00,53824.00,19335,19337
26211,2,339,173,256.00,6889.00,19336,19338
26212,1,512,512,512.00,0.00,19337,19338
26213,1,512,512,512.00,0.00,19337,19338
26214,2,503,9,256.00,61009.00,19337,19339
26215,3,454,5,170.67,40522.89,19338,19341
26216,1,512,512,512.00,0.00,19340,19341
26217,1,512,512,512.00,0.00,19340,19341
26218,3,408,27,170.67,28580.22,19340,19343
26219,1,512,512,512.00,0.00,19342,19343
26220,1,512,512,512.00,0.00,19342,19343
26221,1,512,512,512.00,0.00,19342,19343
26222,1,512,512,512.00,0.00,19342,19343
26223,2,263,249,256.00,49.00,19342,19344
26224,1,512,512,512.00,0.00,19343,19344
26225,1,512,512,512.00,0.00,19343,19344
26226,3,258,65,170.67,6376.22,19343,19346
26227,1,512,512,512.00,0.00,19345,19346
26228,1,512,512,512.00,0.00,19345,19346
26229,1,512,512,512.00,0.00,19345,19346
26230,2,316,196,256.00,3600.00,19345,19347
26231,1,512,512,512.00,0.00,19346,19347
26232,1,512,512,512.00,0.00,19346,19347
26233,1,512,512,512.00,0.00,19346,19347
26234,2,473,39,256.00,47089.00,19346,19348
26235,1,512,512,512.00,0.00,19347,19348
26236,1,512,512,512.00,0.00,19347,19348
26237,1,512,512,512.00,0.00,19347,19348
26238,1,512,512,512.00,0.00,19347,19348
26239,2,419,93,256.00,26569.00,19347,19349
26240,1,512,512,512.00,0.00,19348,19349
26241,1,512,512,512.00,0.00,19348,19349
26242,1,512,512,512.00,0.00,19348,19349
26243,2,473,39,256.00,47089.00,19348,19350
26244,1,512,512,512.00,0.00,19349,19350
26245,1,512,512,512.00,0.00,19349,19350
26246,1,512,512,512.00,0.00,19349,19350
26247,1,512,512,512.00,0.00,19349,19350
26248,3,299,99,170.67,8272.22,19349,19352
26249,1,512,512,512.00,0.00,19351,19352
26250,2,270,242,256.00,196.00,19351,19353
26251,2,495,17,256.00,57121.00,19352,19354
26252,3,261,67,170.67,6361.56,19353,19356
26253,2,400,112,256.00,20736.00,19355,19357
26254,2,384,128,256.00,16384.00,19356,19358
26255,1,512,512,512.00,0.00,19357,19358
26256,1,512,512,512.00,0.00,19357,19358
26257,1,512,512,512.00,0.00,19357,19358
26258,2,330,182,256.00,5476.00,19357,19359
26259,3,224,97,170.67,2894.89,19358,19361
26260,1,512,512,512.00,0.00,19360,19361
26261,1,512,512,512.00,0.00,19360,19361
26262,4,233,1,128.00,6889.50,19360,19364
26263,1,512,512,512.00,0.00,19363,19364
26264,1,512,512,512.00,0.00,19363,19364
26265,1,512,512,512.00,0.00,19363,19364
26266,1,512,512,512.00,0.00,19363,19364
26267,4,295,14,128.00,10593.50,19363,19367
26268,1,512,512,512.00,0.00,19366,19367
26269,3,311,52,170.67,11414.89,19366,19369
26270,1,512,512,512.00,0.00,19368,19369
26271,1,512,512,512.00,0.00,19368,19369
26272,3,296,62,170.67,9264.89,19368,19371
26273,1,512,512,512.00,0.00,19370,19371
26274,3,321,62,170.67,12048.22,19370,19373
26275,1,512,512,512.00,0.00,19372,19373
26276,1,512,512,512.00,0.00,19372,19373
26277,3,302,8,170.67,14896.89,19372,19375
26278,1,512,512,512.00,0.00,19374,19375
26279,1,512,512,512.00,0.00,19374,19375
26280,1,512,512,512.00,0.00,19374,19375
26281,1,512,512,512.00,0.00,19374,19375
26282,2,269,243,256.00,169.00,19374,19376
26283,1,512,512,512.00,0.00,19375,19376
26284,1,512,512,512.00,0.00,19375,19376
26285,2,302,210,256.00,2116.00,19375,19377
26286,1,512,512,512.00,0.00,19376,19377
26287,2,312,200,256.00,3136.00,19376,19378
26288,1,512,512,512.00,0.00,19377,19378
26289,2,425,87,256.00,28561.00,19377,19379
26290,2,380,132,256.00,15376.00,19378,19380
26291,2,259,253,256.00,9.00,19379,19381
26292,1,512,512,512.00,0.00,19380,19381
26293,1,512,512,512.00,0.00,19380,19381
26294,1,512,512,512.00,0.00,19380,19381
26295,1,512,512,512.00,0.00,19380,19381
26296,5,364,4,102.40,18314.64,19380,19385
26297,2,289,223,256.00,1089.00,19384,19386
26298,1,512,512,512.00,0.00,19385,19386
26299,1,512,512,512.00,0.00,19385,19386
26300,4,277,1,128.00,15367.50,19385,19389
26301,1,512,512,512.00,0.00,19388,19389
26302,1,512,512,512.00,0.00,19388,19389
26303,1,512,512,512.00,0.00,19388,19389
26304,1,512,512,512.00,0.00,19388,19389
26305,3,314,16,170.67,14864.89,19388,19391
26306,2,434,78,256.00,31684.00,19390,19392
26307,1,512,512,512.00,0.00,19391,19392
26308,2,500,12,256.00,59536.00,19391,19393
26309,1,512,512,512.00,0.00,19392,19393
26310,1,512,512,512.00,0.00,19392,19393
26311,1,512,512,512.00,0.00,19392,19393
26312,1,512,512,512.00,0.00,19392,19393
26313,2,440,72,256.00,33856.00,19392,19394
26314,1,512,512,512.00,0.00,19393,19394
26315,1,512,512,512.00,0.00,19393,19394
26316,3,353,75,170.67,16636.22,19393,19396
26317,1,512,512,512.00,0.00,19395,19396
26318,1,512,512,512.00,0.00,19395,19396
26319,3,373,2,170.67,23506.89,19395,19398
26320,1,512,512,512.00,0.00,19397,19398
26321,2,495,17,256.00,57121.00,19397,19399
26322,1,512,512,512.00,0.00,19398,19399
26323,2,382,130,256.00,15876.00,19398,19400
26324,2,328,184,256.00,5184.00,19399,19401
26325,1,512,512,512.00,0.00,19400,19401
26326,2,397,115,256.00,19881.00,19400,19402
26327,3,314,1,170.67,16674.89,19401,19404
26328,2,509,3,256.00,64009.00,19403,19405
26329,1,512,512,512.00,0.00,19404,19405
26330,1,512,512,512.00,0.00,19404,19405
26331,1,512,512,512.00,0.00,19404,19405
26332,1,512,512,512.00,0.00,19404,19405
26333,4,276,3,128.00,9568.50,19404,19408
26334,1,512,512,512.00,0.00,19407,19408
26335,4,354,8,128.00,19886.00,19407,19411
26336,1,512,512,512.00,0.00,19410,19411
26337,2,371,141,256.00,13225.00,19410,19412
26338,1,512,512,512.00,0.00,19411,19412
26339,1,512,512,512.00,0.00,19411,19412
26340,2,281,231,256.00,625.00,19411,19413
26341,1,512,512,512.00,0.00,19412,19413
26342,1,512,512,512.00,0.00,19412,19413
26343,4,339,2,128.00,17487.50,19412,19416
26344,2,457,55,256.00,40401.00,19415,19417
26345,2,418,94,256.00,26244.00,19416,19418
26346,1,512,512,512.00,0.00,19417,19418
26347,2,369,143,256.00,12769.00,19417,19419
26348,2,483,29,256.00,51529.00,19418,19420
26349,1,512,512,512.00,0.00,19419,19420
26350,2,489,23,256.00,54289.00,19419,19421
26351,1,512,512,512.00,0.00,19420,19421
26352,1,512,512,512.00,0.00,19420,19421
26353,1,512,512,512.00,0.00,19420,19421
26354,1,512,512,512.00,0.00,19420,19421
26355,2,434,78,256.00,31684.00,19420,19422
26356,2,442,70,256.00,34596.00,19421,19423
26357,1,512,512,512.00,0.00,19422,19423
26358,1,512,512,512.00,0.00,19422,19423
26359,5,414,4,102.40,24568.64,19422,19427
26360,1,512,512,512.00,0.00,19426,19427
26361,3,452,3,170.67,40060.22,19426,19429
26362,1,512,512,512.00,0.00,19428,19429
26363,2,485,27,256.00,52441.00,19428,19430
26364,1,512,512,512.00,0.00,19429,19430
26365,3,373,2,170.67,23506.89,19429,19432
26366,2,295,217,256.00,1521.00,19431,19433
26367,2,275,237,256.00,361.00,19432,19434
26368,1,512,512,512.00,0.00,19433,19434
26369,2,500,12,256.00,59536.00,19433,19435
26370,2,511,1,256.00,65025.00,19434,19436
26371,1,512,512,512.00,0.00,19435,19436
26372,1,512,512,512.00,0.00,19435,19436
26373,2,442,70,256.00,34596.00,19435,19437
26374,2,497,15,256.00,58081.00,19436,19438
26375,2,477,35,256.00,48841.00,19437,19439
26376,1,512,512,512.00,0.00,19438,19439
26377,1,512,512,512.00,0.00,19438,19439
26378,1,512,512,512.00,0.00,19438,19439
26379,2,317,195,256.00,3721.00,19438,19440
26380,1,512,512,512.00,0.00,19439,19440
26381,3,427,8,170.67,33646.89,19439,19442
26382,2,390,122,256.00,17956.00,19441,19443
26383,1,512,512,512.00,0.00,19442,19443
26384,1,512,512,512.00,0.00,19442,19443
26385,2,478,34,256.00,49284.00,19442,19444
26386,1,512,512,512.00,0.00,19443,19444
26387,1,512,512,512.00,0.00,19443,19444
26388,1,512,512,512.00,0.00,19443,19444
26389,2,461,51,256.00,42025.00,19443,19445
26390,2,284,228,256.00,784.00,19444,19446
26391,3,278,2,170.67,14576.89,19445,19448
26392,4,192,48,128.00,3304.00,19447,19451
26393,1,512,512,512.00,0.00,19450,19451
26394,1,512,512,512.00,0.00,19450,19451
26395,1,512,512,512.00,0.00,19450,19451
26396,2,328,184,256.00,5184.00,19450,19452
26397,2,426,86,256.00,28900.00,19451,19453
26398,2,312,200,256.00,3136.00,19452,19454
26399,2,367,145,256.00,12321.00,19453,19455
26400,1,512,512,512.00,0.00,19454,19455
26401,1,512,512,512.00,0.00,19454,19455
26402,3,267,52,170.67,7953.56,19454,19457
26403,5,300,2,102.40,12010.24,19456,19461
26404,1,512,512,512.00,0.00,19460,19461
26405,1,512,512,512.00,0.00,19460,19461
26406,1,512,512,512.00,0.00,19460,19461
26407,4,205,6,128.00,5781.50,19460,19464
26408,1,512,512,512.00,0.00,19463,19464
26409,1,512,512,512.00,0.00,19463,19464
26410,7,135,22,73.14,1758.98,19463,19470
26411,1,512,512,512.00,0.00,19469,19470
26412,1,512,512,512.00,0.00,19469,19470
26413,2,502,10,256.00,60516.00,19469,19471
26414,2,390,122,256.00,17956.00,19470,19472
26415,1,512,512,512.00,0.00,19471,19472
26416,1,512,512,512.00,0.00,19471,19472
26417,1,512,512,512.00,0.00,19471,19472
26418,2,479,33,256.00,49729.00,19471,19473
26419,1,512,512,512.00,0.00,19472,19473
26420,1,512,512,512.00,0.00,19472,19473
26421,1,512,512,512.00,0.00,19472,19473
26422,1,512,512,512.00,0.00,19472,19473
26423,2,306,206,256.00,2500.00,19472,19474
26424,1,512,512,512.00,0.00,19473,19474
26425,1,512,512,512.00,0.00,19473,19474
26426,3,300,68,170.67,9326.22,19473,19476
26427,2,472,40,256.00,46656.00,19475,19477
26428,1,512,512,512.00,0.00,19476,19477
26429,2,351,161,256.00,9025.00,19476,19478
26430,4,304,44,128.00,10598.00,19477,19481
26431,3,335,16,170.67,17006.89,19480,19483
26432,1,512,512,512.00,0.00,19482,19483
26433,1,512,512,512.00,0.00,19482,19483
26434,1,512,512,512.00,0.00,19482,19483
26435,2,494,18,256.00,56644.00,19482,19484
26436,2,445,67,256.00,35721.00,19483,19485
26437,1,512,512,512.00,0.00,19484,19485
26438,1,512,512,512.00,0.00,19484,19485
26439,2,420,92,256.00,26896.00,19484,19486
26440,2,273,239,256.00,289.00,19485,19487
26441,3,190,143,170.67,402.89,19486,19489
26442,3,308,3,170.67,15964.22,19488,19491
26443,2,399,113,256.00,20449.00,19490,19492
26444,1,512,512,512.00,0.00,19491,19492
26445,1,512,512,512.00,0.00,19491,19492
26446,2,393,119,256.00,18769.00,19491,19493
26447,1,512,512,512.00,0.00,19492,19493
26448,1,512,512,512.00,0.00,19492,19493
26449,1,512,512,512.00,0.00,19492,19493
26450,1,512,512,512.00,0.00,19492,19493
26451,1,512,512,512.00,0.00,19492,19493
26452,3,456,4,170.67,41091.56,19492,19495
26453,2,266,246,256.00,100.00,19494,19496
26454,2,476,36,256.00,48400.00,19495,19497
26455,5,213,9,102.40,6399.04,19496,19501
26456,4,247,6,128.00,7272.50,19500,19504
26457,1,512,512,512.00,0.00,19503,19504
26458,1,512,512,512.00,0.00,19503,19504
26459,1,512,512,512.00,0.00,19503,19504
26460,1,512,512,512.00,0.00,19503,19504
26461,2,458,54,256.00,40804.00,19503,19505
26462,1,512,512,512.00,0.00,19504,19505
26463,1,512,512,512.00,0.00,19504,19505
26464,2,393,119,256.00,18769.00,19504,19506
26465,3,291,9,170.67,14108.22,19505,19508
26466,1,512,512,512.00,0.00,19507,19508
26467,3,401,23,170.67,27230.89,19507,19510
26468,1,512,512,512.00,0.00,19509,19510
26469,3,225,90,170.67,3384.22,19509,19512
26470,1,512,512,512.00,0.00,19511,19512
26471,1,512,512,512.00,0.00,19511,19512
26472,2,424,88,256.00,28224.00,19511,19513
26473,2,305,207,256.00,2401.00,19512,19514
26474,1,512,512,512.00,0.00,19513,19514
26475,1,512,512,512.00,0.00,19513,19514
26476,1,512,512,512.00,0.00,19513,19514
26477,2,398,114,256.00,20164.00,19513,19515
26478,2,491,21,256.00,55225.00,19514,19516
26479,1,512,512,512.00,0.00,19515,19516
26480,3,262,72,170.67,6043.56,19515,19518
26481,1,512,512,512.00,0.00,19517,19518
26482,3,328,42,170.67,14043.56,19517,19520
26483,2,343,169,256.00,7569.00,19519,19521
26484,2,320,192,256.00,4096.00,19520,19522
26485,2,418,94,256.00,26244.00,19521,19523
26486,1,512,512,512.00,0.00,19522,19523
26487,1,512,512,512.00,0.00,19522,19523
26488,2,508,4,256.00,63504.00,19522,19524
26489,1,512,512,512.00,0.00,19523,19524
26490,2,478,34,256.00,49284.00,19523,19525
26491,1,512,512,512.00,0.00,19524,19525
26492,2,412,100,256.00,24336.00,19524,19526
26493,1,512,512,512.00,0.00,19525,19526
26494,2,367,145,256.00,12321.00,19525,19527
26495,3,206,111,170.67,1800.22,19526,19529
26496,1,512,512,512.00,0.00,19528,19529
26497,1,512,512,512.00,0.00,19528,19529
26498,4,349,22,128.00,16687.50,19528,19532
26499,4,436,2,128.00,32370.00,19531,19535
26500,2,333,179,256.00,5929.00,19534,19536
26501,5,309,1,102.40,13571.84,19535,19540
26502,1,512,512,512.00,0.00,19539,19540
26503,5,251,2,102.40,14337.84,19539,19544
26504,1,512,512,512.00,0.00,19543,19544
26505,4,301,2,128.00,16980.50,19543,19547
26506,1,512,512,512.00,0.00,19546,19547
26507,1,512,512,512.00,0.00,19546,19547
26508,3,299,10,170.67,14442.89,19546,19549
26509,3,503,1,170.67,55230.89,19548,19551
26510,1,512,512,512.00,0.00,19550,19551
26511,1,512,512,512.00,0.00,19550,19551
26512,3,259,106,170.67,4181.56,19550,19553
26513,8,182,10,64.00,3375.25,19552,19560
26514,2,408,104,256.00,23104.00,19559,19561
26515,1,512,512,512.00,0.00,19560,19561
26516,1,512,512,512.00,0.00,19560,19561
26517,1,512,512,512.00,0.00,19560,19561
26518,3,311,86,170.67,9986.89,19560,19563
26519,1,512,512,512.00,0.00,19562,19563
26520,1,512,512,512.00,0.00,19562,19563
26521,2,340,172,256.00,7056.00,19562,19564
26522,1,512,512,512.00,0.00,19563,19564
26523,1,512,512,512.00,0.00,19563,19564
26524,1,512,512,512.00,0.00,19563,19564
26525,1,512,512,512.00,0.00,19563,19564
26526,3,492,3,170.67,51660.22,19563,19566
26527,1,512,512,512.00,0.00,19565,19566
26528,1,512,512,512.00,0.00,19565,19566
26529,3,471,2,170.67,45328.22,19565,19568
26530,2,315,197,256.00,3481.00,19567,19569
26531,1,512,512,512.00,0.00,19568,19569
26532,4,361,5,128.00,20219.00,19568,19572
26533,2,337,175,256.00,6561.00,19571,19573
26534,3,306,15,170.67,14320.22,19572,19575
26535,2,398,114,256.00,20164.00,19574,19576
26536,8,408,1,64.00,17065.00,19575,19583
26537,2,462,50,256.00,42436.00,19582,19584
26538,3,252,50,170.67,7574.22,19583,19586
26539,1,512,512,512.00,0.00,19585,19586
26540,1,512,512,512.00,0.00,19585,19586
26541,1,512,512,512.00,0.00,19585,19586
26542,1,512,512,512.00,0.00,19585,19586
26543,4,238,40,128.00,6589.50,19585,19589
26544,3,435,1,170.67,35873.56,19588,19591
26545,2,390,122,256.00,17956.00,19590,19592
26546,1,512,512,512.00,0.00,19591,19592
26547,4,210,8,128.00,6866.00,19591,19595
26548,1,512,512,512.00,0.00,19594,19595
26549,1,512,512,512.00,0.00,19594,19595
26550,1,512,512,512.00,0.00,19594,19595
26551,3,216,114,170.67,1798.22,19594,19597
26552,1,512,512,512.00,0.00,19596,19597
26553,1,512,512,512.00,0.00,19596,19597
26554,1,512,512,512.00,0.00,19596,19597
26555,4,254,1,128.00,9036.50,19596,19600
26556,4,151,67,128.00,1243.50,19599,19603
26557,4,488,3,128.00,43224.50,19602,19606
26558,3,327,45,170.67,13724.22,19605,19608
26559,1,512,512,512.00,0.00,19607,19608
26560,1,512,512,512.00,0.00,19607,19608
26561,4,416,1,128.00,28036.50,19607,19611
26562,2,332,180,256.00,5776.00,19610,19612
26563,1,512,512,512.00,0.00,19611,19612
26564,1,512,512,512.00,0.00,19611,19612
26565,3,298,79,170.67,8629.56,19611,19614
26566,1,512,512,512.00,0.00,19613,19614
26567,2,507,5,256.00,63001.00,19613,19615
26568,5,277,1,102.40,8614.24,19614,19619
26569,2,394,118,256.00,19044.00,19618,19620
26570,1,512,512,512.00,0.00,19619,19620
26571,2,384,128,256.00,16384.00,19619,19621
26572,1,512,512,512.00,0.00,19620,19621
26573,1,512,512,512.00,0.00,19620,19621
26574,1,512,512,512.00,0.00,19620,19621
26575,2,444,68,256.00,35344.00,19620,19622
26576,1,512,512,512.00,0.00,19621,19622
26577,1,512,512,512.00,0.00,19621,19622
26578,1,512,512,512.00,0.00,19621,19622
26579,1,512,512,512.00,0.00,19621,19622
26580,3,301,7,170.67,14961.56,19621,19624
26581,6,174,22,85.33,3742.89,19623,19629
26582,1,512,512,512.00,0.00,19628,19629
26583,1,512,512,512.00,0.00,19628,19629
26584,3,439,26,170.67,36074.89,19628,19631
26585,1,512,512,512.00,0.00,19630,19631
26586,1,512,512,512.00,0.00,19630,19631
26587,2,441,71,256.00,34225.00,19630,19632
26588,1,512,512,512.00,0.00,19631,19632
26589,5,305,6,102.40,11087.44,19631,19636
26590,1,512,512,512.00,0.00,19635,19636
26591,1,512,512,512.00,0.00,19635,19636
26592,1,512,512,512.00,0.00,19635,19636
26593,3,285,3,170.67,14676.22,19635,19638
26594,2,336,176,256.00,6400.00,19637,19639
26595,1,512,512,512.00,0.00,19638,19639
26596,7,166,2,73.14,2915.84,19638,19645
26597,2,262,250,256.00,36.00,19644,19646
26598,1,512,512,512.00,0.00,19645,19646
26599,1,512,512,512.00,0.00,19645,19646
26600,1,512,512,512.00,0.00,19645,19646
26601,1,512,512,512.00,0.00,19645,19646
26602,3,264,59,170.67,7172.22,19645,19648
26603,1,512,512,512.00,0.00,19647,19648
26604,1,512,512,512.00,0.00,19647,19648
26605,1,512,512,512.00,0.00,19647,19648
26606,1,512,512,512.00,0.00,19647,19648
26607,2,363,149,256.00,11449.00,19647,19649
26608,1,512,512,512.00,0.00,19648,19649
26609,4,344,7,128.00,17937.50,19648,19652
26610,1,512,512,512.00,0.00,19651,19652
26611,1,512,512,512.00,0.00,19651,19652
26612,2,296,216,256.00,1600.00,19651,19653
26613,6,186,2,85.33,4464.56,19652,19658
26614,1,512,512,512.00,0.00,19657,19658
26615,2,501,11,256.00,60025.00,19657,19659
26616,3,488,7,170.67,50366.89,19658,19661
26617,2,444,68,256.00,35344.00,19660,19662
26618,2,413,99,256.00,24649.00,19661,19663
26619,1,512,512,512.00,0.00,19662,19663
26620,1,512,512,512.00,0.00,19662,19663
26621,5,317,1,102.40,16759.04,19662,19667
26622,1,512,512,512.00,0.00,19666,19667
26623,2,302,210,256.00,2116.00,19666,19668
26624,1,512,512,512.00,0.00,19667,19668
26625,1,512,512,512.00,0.00,19667,19668
26626,2,307,205,256.00,2601.00,19667,19669
26627,1,512,512,512.00,0.00,19668,19669
26628,2,288,224,256.00,1024.00,19668,19670
26629,3,305,2,170.67,15890.89,19669,19672
26630,1,512,512,512.00,0.00,19671,19672
26631,1,512,512,512.00,0.00,19671,19672
26632,5,242,3,102.40,11483.84,19671,19676
26633,1,512,512,512.00,0.00,19675,19676
26634,1,512,512,512.00,0.00,19675,19676
26635,3,428,13,170.67,33670.89,19675,19678
26636,1,512,512,512.00,0.00,19677,19678
26637,1,512,512,512.00,0.00,19677,19678
26638,6,226,9,85.33,5528.89,19677,19683
26639,1,512,512,512.00,0.00,19682,19683
26640,1,512,512,512.00,0.00,19682,19683
26641,2,427,85,256.00,29241.00,19682,19684
26642,2,501,11,256.00,60025.00,19683,19685
26643,2,509,3,256.00,64009.00,19684,19686
26644,5,236,12,102.40,5689.84,19685,19690
26645,3,423,16,170.67,32377.56,19689,19692
26646,1,512,512,512.00,0.00,19691,19692
26647,2,408,104,256.00,23104.00,19691,19693
26648,4,246,7,128.00,7467.50,19692,19696
26649,1,512,512,512.00,0.00,19695,19696
26650,2,486,26,256.00,52900.00,19695,19697
26651,1,512,512,512.00,0.00,19696,19697
26652,1,512,512,512.00,0.00,19696,19697
26653,3,390,27,170.67,24824.22,19696,19699
26654,1,512,512,512.00,0.00,19698,19699
26655,2,450,62,256.00,37636.00,19698,19700
26656,1,512,512,512.00,0.00,19699,19700
26657,2,316,196,256.00,3600.00,19699,19701
26658,2,498,14,256.00,58564.00,19700,19702
26659,2,483,29,256.00,51529.00,19701,19703
26660,1,512,512,512.00,0.00,19702,19703
26661,2,475,37,256.00,47961.00,19702,19704
26662,2,509,3,256.00,64009.00,19703,19705
26663,2,484,28,256.00,51984.00,19704,19706
26664,5,435,1,102.40,28013.44,19705,19710
26665,4,223,12,128.00,8835.50,19709,19713
26666,1,512,512,512.00,0.00,19712,19713
26667,2,414,98,256.00,24964.00,19712,19714
26668,1,512,512,512.00,0.00,19713,19714
26669,1,512,512,512.00,0.00,19713,19714
26670,1,512,512,512.00,0.00,19713,19714
26671,1,512,512,512.00,0.00,19713,19714
26672,6,178,7,85.33,5706.89,19713,19719
26673,2,469,43,256.00,45369.00,19718,19720
26674,6,222,16,85.33,5244.56,19719,19725
26675,6,198,4,85.33,6719.89,19724,19730
26676,1,512,512,512.00,0.00,19729,19730
26677,1,512,512,512.00,0.00,19729,19730
26678,5,464,1,102.40,32727.84,19729,19734
26679,1,512,512,512.00,0.00,19733,19734
26680,4,256,4,128.00,15022.50,19733,19737
26681,1,512,512,512.00,0.00,19736,19737
26682,5,353,1,102.40,17237.44,19736,19741
26683,2,417,95,256.00,25921.00,19740,19742
26684,1,512,512,512.00,0.00,19741,19742
26685,1,512,512,512.00,0.00,19741,19742
26686,3,288,46,170.67,9787.56,19741,19744
26687,1,512,512,512.00,0.00,19743,19744
26688,1,512,512,512.00,0.00,19743,19744
26689,1,512,512,512.00,0.00,19743,19744
26690,1,512,512,512.00,0.00,19743,19744
26691,2,511,1,256.00,65025.00,19743,19745
26692,1,512,512,512.00,0.00,19744,19745
26693,1,512,512,512.00,0.00,19744,19745
26694,1,512,512,512.00,0.00,19744,19745
26695,1,512,512,512.00,0.00,19744,19745
26696,1,512,512,512.00,0.00,19744,19745
26697,1,512,512,512.00,0.00,19744,19745
26698,1,512,512,512.00,0.00,19744,19745
26699,1,512,512,512.00,0.00,19744,19745
26700,1,512,512,512.00,0.00,19744,19745
26701,1,512,512,512.00,0.00,19744,19745
26702,2,456,56,256.00,40000.00,19744,19746
26703,1,512,512,512.00,0.00,19745,19746
26704,1,512,512,512.00,0.00,19745,19746
26705,3,476,12,170.67,46638.22,19745,19748
26706,2,313,199,256.00,3249.00,19747,19749
26707,10,265,4,51.20,5738.76,19748,19758
26708,1,512,512,512.00,0.00,19757,19758
26709,2,447,65,256.00,36481.00,19757,19759
26710,3,361,57,170.67,18341.56,19758,19761
26711,3,343,2,170.67,19386.89,19760,19763
26712,1,512,512,512.00,0.00,19762,19763
26713,1,512,512,512.00,0.00,19762,19763
26714,1,512,512,512.00,0.00,19762,19763
26715,3,217,108,170.67,2113.56,19762,19765
26716,1,512,512,512.00,0.00,19764,19765
26717,1,512,512,512.00,0.00,19764,19765
26718,1,512,512,512.00,0.00,19764,19765
26719,3,464,23,170.67,43022.89,19764,19767
26720,1,512,512,512.00,0.00,19766,19767
26721,1,512,512,512.00,0.00,19766,19767
26722,1,512,512,512.00,0.00,19766,19767
26723,2,389,123,256.00,17689.00,19766,19768
26724,1,512,512,512.00,0.00,19767,19768
26725,1,512,512,512.00,0.00,19767,19768
26726,1,512,512,512.00,0.00,19767,19768
26727,1,512,512,512.00,0.00,19767,19768
26728,3,267,35,170.67,9744.22,19767,19770
26729,1,512,512,512.00,0.00,19769,19770
26730,1,512,512,512.00,0.00,19769,19770
26731,3,327,56,170.67,13108.22,19769,19772
26732,2,299,213,256.00,1849.00,19771,19773
26733,4,302,14,128.00,11952.50,19772,19776
26734,1,512,512,512.00,0.00,19775,19776
26735,1,512,512,512.00,0.00,19775,19776
26736,1,512,512,512.00,0.00,19775,19776
26737,1,512,512,512.00,0.00,19775,19776
26738,1,512,512,512.00,0.00,19775,19776
26739,3,299,6,170.67,14968.22,19775,19778
26740,2,383,129,256.00,16129.00,19777,19779
26741,1,512,512,512.00,0.00,19778,19779
26742,1,512,512,512.00,0.00,19778,19779
26743,1,512,512,512.00,0.00,19778,19779
26744,4,386,1,128.00,24471.50,19778,19782
26745,4,263,4,128.00,15436.50,19781,19785
26746,1,512,512,512.00,0.00,19784,19785
26747,1,512,512,512.00,0.00,19784,19785
26748,1,512,512,512.00,0.00,19784,19785
26749,4,261,1,128.00,15421.00,19784,19788
26750,1,512,512,512.00,0.00,19787,19788
26751,2,410,102,256.00,23716.00,19787,19789
26752,1,512,512,512.00,0.00,19788,19789
26753,2,306,206,256.00,2500.00,19788,19790
26754,1,512,512,512.00,0.00,19789,19790
26755,3,502,1,170.67,54901.56,19789,19792
26756,1,512,512,512.00,0.00,19791,19792
26757,2,357,155,256.00,10201.00,19791,19793
26758,2,285,227,256.00,841.00,19792,19794
26759,1,512,512,512.00,0.00,19793,19794
26760,2,372,140,256.00,13456.00,19793,19795
26761,2,323,189,256.00,4489.00,19794,19796
26762,2,399,113,256.00,20449.00,19795,19797
26763,1,512,512,512.00,0.00,19796,19797
26764,1,512,512,512.00,0.00,19796,19797
26765,2,338,174,256.00,6724.00,19796,19798
26766,2,304,208,256.00,2304.00,19797,19799
26767,1,512,512,512.00,0.00,19798,19799
26768,1,512,512,512.00,0.00,19798,19799
26769,5,353,30,102.40,15776.24,19798,19803
26770,1,512,512,512.00,0.00,19802,19803
26771,1,512,512,512.00,0.00,19802,19803
26772,3,314,3,170.67,16416.22,19802,19805
26773,3,387,55,170.67,23437.56,19804,19807
26774,4,317,54,128.00,12030.50,19806,19810
26775,3,354,7,170.67,20261.56,19809,19812
26776,1,512,512,512.00,0.00,19811,19812
26777,2,280,232,256.00,576.00,19811,19813
26778,1,512,512,512.00,0.00,19812,19813
26779,1,512,512,512.00,0.00,19812,19813
26780,3,424,20,170.67,32472.89,19812,19815
26781,2,459,53,256.00,41209.00,19814,19816
26782,6,226,2,85.33,7264.56,19815,19821
26783,2,481,31,256.00,50625.00,19820,19822
26784,1,512,512,512.00,0.00,19821,19822
26785,1,512,512,512.00,0.00,19821,19822
26786,4,496,2,128.00,45158.00,19821,19825
26787,2,401,111,256.00,21025.00,19824,19826
26788,2,471,41,256.00,46225.00,19825,19827
26789,1,512,512,512.00,0.00,19826,19827
26790,1,512,512,512.00,0.00,19826,19827
26791,1,512,512,512.00,0.00,19826,19827
26792,1,512,512,512.00,0.00,19826,19827
26793,4,408,24,128.00,26178.00,19826,19830
26794,1,512,512,512.00,0.00,19829,19830
26795,1,512,512,512.00,0.00,19829,19830
26796,1,512,512,512.00,0.00,19829,19830
26797,4,342,2,128.00,17354.00,19829,19833
26798,1,512,512,512.00,0.00,19832,19833
26799,3,494,5,170.67,52282.89,19832,19835
26800,1,512,512,512.00,0.00,19834,19835
26801,1,512,512,512.00,0.00,19834,19835
26802,1,512,512,512.00,0.00,19834,19835
26803,2,441,71,256.00,34225.00,19834,19836
26804,2,348,164,256.00,8464.00,19835,19837
26805,1,512,512,512.00,0.00,19836,19837
26806,3,406,26,170.67,28176.89,19836,19839
26807,3,442,22,170.67,36923.56,19838,19841
26808,4,405,2,128.00,26277.50,19840,19844
26809,1,512,512,512.00,0.00,19843,19844
26810,1,512,512,512.00,0.00,19843,19844
26811,1,512,512,512.00,0.00,19843,19844
26812,4,350,17,128.00,18166.50,19843,19847
26813,2,466,46,256.00,44100.00,19846,19848
26814,2,446,66,256.00,36100.00,19847,19849
26815,1,512,512,512.00,0.00,19848,19849
26816,1,512,512,512.00,0.00,19848,19849
26817,2,327,185,256.00,5041.00,19848,19850
26818,4,232,23,128.00,8386.50,19849,19853
26819,1,512,512,512.00,0.00,19852,19853
26820,1,512,512,512.00,0.00,19852,19853
26821,1,512,512,512.00,0.00,19852,19853
26822,2,436,76,256.00,32400.00,19852,19854
26823,1,512,512,512.00,0.00,19853,19854
26824,1,512,512,512.00,0.00,19853,19854
26825,2,427,85,256.00,29241.00,19853,19855
26826,1,512,512,512.00,0.00,19854,19855
26827,3,260,45,170.67,8364.22,19854,19857
26828,1,512,512,512.00,0.00,19856,19857
26829,1,512,512,512.00,0.00,19856,19857
26830,2,266,246,256.00,100.00,19856,19858
26831,2,362,150,256.00,11236.00,19857,19859
26832,5,183,30,102.40,4334.64,19858,19863
26833,1,512,512,512.00,0.00,19862,19863
26834,2,482,30,256.00,51076.00,19862,19864
26835,2,479,33,256.00,49729.00,19863,19865
26836,1,512,512,512.00,0.00,19864,19865
26837,1,512,512,512.00,0.00,19864,19865
26838,3,190,151,170.67,253.56,19864,19867
26839,1,512,512,512.00,0.00,19866,19867
26840,1,512,512,512.00,0.00,19866,19867
26841,2,371,141,256.00,13225.00,19866,19868
26842,1,512,512,512.00,0.00,19867,19868
26843,1,512,512,512.00,0.00,19867,19868
26844,1,512,512,512.00,0.00,19867,19868
26845,1,512,512,512.00,0.00,19867,19868
26846,2,316,196,256.00,3600.00,19867,19869
26847,1,512,512,512.00,0.00,19868,19869
26848,2,275,237,256.00,361.00,19868,19870
26849,1,512,512,512.00,0.00,19869,19870
26850,2,428,84,256.00,29584.00,19869,19871
26851,1,512,512,512.00,0.00,19870,19871
26852,2,382,130,256.00,15876.00,19870,19872
26853,1,512,512,512.00,0.00,19871,19872
26854,1,512,512,512.00,0.00,19871,19872
26855,2,305,207,256.00,2401.00,19871,19873
26856,1,512,512,512.00,0.00,19872,19873
26857,2,408,104,256.00,23104.00,19872,19874
26858,1,512,512,512.00,0.00,19873,19874
26859,4,316,40,128.00,12634.50,19873,19877
26860,3,484,3,170.67,49169.56,19876,19879
26861,3,309,7,170.67,15521.56,19878,19881
26862,2,308,204,256.00,2704.00,19880,19882
26863,3,473,19,170.67,45702.89,19881,19884
26864,1,512,512,512.00,0.00,19883,19884
26865,6,343,3,85.33,14135.22,19883,19889
26866,6,240,27,85.33,5931.22,19888,19894
26867,2,410,102,256.00,23716.00,19893,19895
26868,3,453,27,170.67,39860.22,19894,19897
26869,1,512,512,512.00,0.00,19896,19897
26870,1,512,512,512.00,0.00,19896,19897
26871,1,512,512,512.00,0.00,19896,19897
26872,1,512,512,512.00,0.00,19896,19897
26873,4,240,21,128.00,7276.50,19896,19900
26874,1,512,512,512.00,0.00,19899,19900
26875,1,512,512,512.00,0.00,19899,19900
26876,2,480,32,256.00,50176.00,19899,19901
26877,1,512,512,512.00,0.00,19900,19901
26878,1,512,512,512.00,0.00,19900,19901
26879,1,512,512,512.00,0.00,19900,19901
26880,2,435,77,256.00,32041.00,19900,19902
26881,8,246,2,64.00,6893.00,19901,19909
26882,2,483,29,256.00,51529.00,19908,19910
26883,1,512,512,512.00,0.00,19909,19910
26884,1,512,512,512.00,0.00,19909,19910
26885,1,512,512,512.00,0.00,19909,19910
26886,2,395,117,256.00,19321.00,19909,19911
26887,3,331,2,170.67,18074.89,19910,19913
26888,1,512,512,512.00,0.00,19912,19913
26889,1,512,512,512.00,0.00,19912,19913
26890,1,512,512,512.00,0.00,19912,19913
26891,1,512,512,512.00,0.00,19912,19913
26892,1,512,512,512.00,0.00,19912,19913
26893,7,176,10,73.14,3658.12,19912,19919
26894,1,512,512,512.00,0.00,19918,19919
26895,2,424,88,256.00,28224.00,19918,19920
26896,1,512,512,512.00,0.00,19919,19920
26897,3,266,54,170.67,7718.22,19919,19922
26898,1,512,512,512.00,0.00,19921,19922
26899,3,463,6,170.67,42957.56,19921,19924
26900,4,289,58,128.00,8971.50,19923,19927
26901,1,512,512,512.00,0.00,19926,19927
26902,3,436,16,170.67,35523.56,19926,19929
26903,2,437,75,256.00,32761.00,19928,19930
26904,3,294,29,170.67,11872.22,19929,19932
26905,1,512,512,512.00,0.00,19931,19932
26906,3,344,1,170.67,19614.89,19931,19934
26907,3,399,15,170.67,27216.22,19933,19936
26908,5,244,27,102.40,6153.44,19935,19940
26909,1,512,512,512.00,0.00,19939,19940
26910,1,512,512,512.00,0.00,19939,19940
26911,1,512,512,512.00,0.00,19939,19940
26912,2,405,107,256.00,22201.00,19939,19941
26913,3,239,86,170.67,4034.89,19940,19943
26914,2,302,210,256.00,2116.00,19942,19944
26915,2,356,156,256.00,10000.00,19943,19945
26916,4,249,6,128.00,13376.50,19944,19948
26917,5,339,5,102.40,14674.64,19947,19952
26918,1,512,512,512.00,0.00,19951,19952
26919,1,512,512,512.00,0.00,19951,19952
26920,2,353,159,256.00,9409.00,19951,19953
26921,1,512,512,512.00,0.00,19952,19953
26922,3,383,2,170.67,25146.89,19952,19955
26923,2,399,113,256.00,20449.00,19954,19956
26924,3,388,27,170.67,24433.56,19955,19958
26925,3,297,33,170.67,11680.22,19957,19960
26926,1,512,512,512.00,0.00,19959,19960
26927,1,512,512,512.00,0.00,19959,19960
26928,7,256,4,73.14,6646.41,19959,19966
26929,1,512,512,512.00,0.00,19965,19966
26930,3,296,100,170.67,7896.89,19965,19968
26931,2,383,129,256.00,16129.00,19967,19969
26932,3,235,112,170.67,2537.56,19968,19971
26933,2,429,83,256.00,29929.00,19970,19972
26934,1,512,512,512.00,0.00,19971,19972
26935,1,512,512,512.00,0.00,19971,19972
26936,1,512,512,512.00,0.00,19971,19972
26937,1,512,512,512.00,0.00,19971,19972
26938,3,311,24,170.67,13748.22,19971,19974
26939,3,416,3,170.67,31444.22,19973,19976
26940,1,512,512,512.00,0.00,19975,19976
26941,3,300,51,170.67,10380.22,19975,19978
26942,1,512,512,512.00,0.00,19977,19978
26943,6,398,1,85.33,20412.56,19977,19983
26944,1,512,512,512.00,0.00,19982,19983
26945,1,512,512,512.00,0.00,19982,19983
26946,1,512,512,512.00,0.00,19982,19983
26947,3,208,134,170.67,912.89,19982,19985
26948,2,500,12,256.00,59536.00,19984,19986
26949,1,512,512,512.00,0.00,19985,19986
26950,1,512,512,512.00,0.00,19985,19986
26951,1,512,512,512.00,0.00,19985,19986
26952,1,512,512,512.00,0.00,19985,19986
26953,2,256,256,256.00,0.00,19985,19987
26954,2,268,244,256.00,144.00,19986,19988
26955,2,266,246,256.00,100.00,19987,19989
26956,4,265,38,128.00,7659.50,19988,19992
26957,3,477,7,170.67,46993.56,19991,19994
26958,2,501,11,256.00,60025.00,19993,19995
26959,5,203,24,102.40,5317.04,19994,19999
26960,2,447,65,256.00,36481.00,19998,20000
26961,2,403,109,256.00,21609.00,19999,20001
26962,6,277,2,85.33,9198.22,20000,20006
26963,1,512,512,512.00,0.00,20005,20006
26964,1,512,512,512.00,0.00,20005,20006
26965,1,512,512,512.00,0.00,20005,20006
26966,4,307,1,128.00,12958.50,20005,20009
26967,3,395,13,170.67,26542.89,20008,20011
26968,1,512,512,512.00,0.00,20010,20011
26969,1,512,512,512.00,0.00,20010,20011
26970,1,512,512,512.00,0.00,20010,20011
26971,1,512,512,512.00,0.00,20010,20011
26972,2,437,75,256.00,32761.00,20010,20012
26973,1,512,512,512.00,0.00,20011,20012
26974,3,310,87,170.67,9837.56,20011,20014
26975,1,512,512,512.00,0.00,20013,20014
26976,1,512,512,512.00,0.00,20013,20014
26977,3,340,10,170.67,18187.56,20013,20016
26978,1,512,512,512.00,0.00,20015,20016
26979,1,512,512,512.00,0.00,20015,20016
26980,1,512,512,512.00,0.00,20015,20016
26981,1,512,512,512.00,0.00,20015,20016
26982,4,383,8,128.00,22365.50,20015,20019
26983,1,512,512,512.00,0.00,20018,20019
26984,4,270,4,128.00,12975.50,20018,20022
26985,2,323,189,256.00,4489.00,20021,20023
26986,1,512,512,512.00,0.00,20022,20023
26987,1,512,512,512.00,0.00,20022,20023
26988,2,416,96,256.00,25600.00,20022,20024
26989,1,512,512,512.00,0.00,20023,20024
26990,1,512,512,512.00,0.00,20023,20024
26991,1,512,512,512.00,0.00,20023,20024
26992,2,450,62,256.00,37636.00,20023,20025
26993,1,512,512,512.00,0.00,20024,20025
26994,1,512,512,512.00,0.00,20024,20025
26995,1,512,512,512.00,0.00,20024,20025
26996,2,286,226,256.00,900.00,20024,20026
26997,2,267,245,256.00,121.00,20025,20027
26998,1,512,512,512.00,0.00,20026,20027
26999,1,512,512,512.00,0.00,20026,20027
27000,1,512,512,512.00,0.00,20026,20027
27001,1,512,512,512.00,0.00,20026,20027
27002,1,512,512,512.00,0.00,20026,20027
27003,1,512,512,512.00,0.00,20026,20027
27004,1,512,512,512.00,0.00,20026,20027
27005,2,333,179,256.00,5929.00,20026,20028
27006,1,512,512,512.00,0.00,20027,20028
27007,2,413,99,256.00,24649.00,20027,20029
27008,1,512,512,512.00,0.00,20028,20029
27009,1,512,512,512.00,0.00,20028,20029
27010,3,348,40,170.67,16899.56,20028,20031
27011,4,264,20,128.00,10450.50,20030,20034
27012,1,512,512,512.00,0.00,20033,20034
27013,1,512,512,512.00,0.00,20033,20034
27014,3,423,32,170.67,31940.22,20033,20036
27015,1,512,512,512.00,0.00,20035,20036
27016,1,512,512,512.00,0.00,20035,20036
27017,1,512,512,512.00,0.00,20035,20036
27018,2,488,24,256.00,53824.00,20035,20037
27019,4,320,15,128.00,14178.50,20036,20040
27020,6,278,1,85.33,9821.89,20039,20045
27021,2,438,74,256.00,33124.00,20044,20046
27022,1,512,512,512.00,0.00,20045,20046
27023,1,512,512,512.00,0.00,20045,20046
27024,1,512,512,512.00,0.00,20045,20046
27025,1,512,512,512.00,0.00,20045,20046
27026,1,512,512,512.00,0.00,20045,20046
27027,1,512,512,512.00,0.00,20045,20046
27028,2,511,1,256.00,65025.00,20045,20047
27029,1,512,512,512.00,0.00,20046,20047
27030,3,380,13,170.67,23782.89,20046,20049
27031,4,335,1,128.00,18586.50,20048,20052
27032,1,512,512,512.00,0.00,20051,20052
27033,1,512,512,512.00,0.00,20051,20052
27034,2,344,168,256.00,7744.00,20051,20053
27035,2,455,57,256.00,39601.00,20052,20054
27036,1,512,512,512.00,0.00,20053,20054
27037,1,512,512,512.00,0.00,20053,20054
27038,2,508,4,256.00,63504.00,20053,20055
27039,1,512,512,512.00,0.00,20054,20055
27040,1,512,512,512.00,0.00,20054,20055
27041,1,512,512,512.00,0.00,20054,20055
27042,3,376,33,170.67,21897.56,20054,20057
27043,1,512,512,512.00,0.00,20056,20057
27044,3,441,25,170.67,36613.56,20056,20059
27045,3,319,22,170.67,14701.56,20058,20061
27046,3,234,97,170.67,3181.56,20060,20063
27047,2,448,64,256.00,36864.00,20062,20064
27048,1,512,512,512.00,0.00,20063,20064
27049,3,366,70,170.67,19083.56,20063,20066
27050,5,278,6,102.40,11134.64,20065,20070
27051,1,512,512,512.00,0.00,20069,20070
27052,1,512,512,512.00,0.00,20069,20070
27053,7,203,1,73.14,6340.69,20069,20076
27054,5,410,5,102.40,23965.44,20075,20080
27055,1,512,512,512.00,0.00,20079,20080
27056,1,512,512,512.00,0.00,20079,20080
27057,1,512,512,512.00,0.00,20079,20080
27058,1,512,512,512.00,0.00,20079,20080
27059,4,262,11,128.00,9075.50,20079,20083
27060,1,512,512,512.00,0.00,20082,20083
27061,1,512,512,512.00,0.00,20082,20083
27062,2,448,64,256.00,36864.00,20082,20084
27063,2,406,106,256.00,22500.00,20083,20085
27064,2,289,223,256.00,1089.00,20084,20086
27065,2,474,38,256.00,47524.00,20085,20087
27066,1,512,512,512.00,0.00,20086,20087
27067,1,512,512,512.00,0.00,20086,20087
27068,1,512,512,512.00,0.00,20086,20087
27069,6,157,33,85.33,2562.89,20086,20092
27070,1,512,512,512.00,0.00,20091,20092
27071,1,512,512,512.00,0.00,20091,20092
27072,1,512,512,512.00,0.00,20091,20092
27073,3,258,55,170.67,7269.56,20091,20094
27074,1,512,512,512.00,0.00,20093,20094
27075,1,512,512,512.00,0.00,20093,20094
27076,1,512,512,512.00,0.00,20093,20094
27077,2,510,2,256.00,64516.00,20093,20095
27078,1,512,512,512.00,0.00,20094,20095
27079,4,341,5,128.00,18517.50,20094,20098
27080,1,512,512,512.00,0.00,20097,20098
27081,1,512,512,512.00,0.00,20097,20098
27082,2,390,122,256.00,17956.00,20097,20099
27083,3,366,42,170.67,19718.22,20098,20101
27084,1,512,512,512.00,0.00,20100,20101
27085,4,245,35,128.00,8469.00,20100,20104
27086,2,385,127,256.00,16641.00,20103,20105
27087,2,314,198,256.00,3364.00,20104,20106
27088,1,512,512,512.00,0.00,20105,20106
27089,1,512,512,512.00,0.00,20105,20106
27090,2,360,152,256.00,10816.00,20105,20107
27091,1,512,512,512.00,0.00,20106,20107
27092,1,512,512,512.00,0.00,20106,20107
27093,1,512,512,512.00,0.00,20106,20107
27094,1,512,512,512.00,0.00,20106,20107
27095,2,476,36,256.00,48400.00,20106,20108
27096,1,512,512,512.00,0.00,20107,20108
27097,1,512,512,512.00,0.00,20107,20108
27098,2,476,36,256.00,48400.00,20107,20109
27099,1,512,512,512.00,0.00,20108,20109
27100,2,415,97,256.00,25281.00,20108,20110
27101,2,349,163,256.00,8649.00,20109,20111
27102,4,165,68,128.00,1608.50,20110,20114
27103,2,361,151,256.00,11025.00,20113,20115
27104,1,512,512,512.00,0.00,20114,20115
27105,2,503,9,256.00,61009.00,20114,20116
27106,1,512,512,512.00,0.00,20115,20116
27107,2,274,238,256.00,324.00,20115,20117
27108,3,244,102,170.67,3371.56,20116,20119
27109,1,512,512,512.00,0.00,20118,20119
27110,3,206,150,170.67,630.22,20118,20121
27111,1,512,512,512.00,0.00,20120,20121
27112,2,267,245,256.00,121.00,20120,20122
27113,1,512,512,512.00,0.00,20121,20122
27114,3,290,76,170.67,7936.89,20121,20124
27115,2,506,6,256.00,62500.00,20123,20125
27116,1,512,512,512.00,0.00,20124,20125
27117,1,512,512,512.00,0.00,20124,20125
27118,1,512,512,512.00,0.00,20124,20125
27119,3,303,35,170.67,11976.22,20124,20127
27120,1,512,512,512.00,0.00,20126,20127
27121,1,512,512,512.00,0.00,20126,20127
27122,1,512,512,512.00,0.00,20126,20127
27123,4,429,15,128.00,30301.00,20126,20130
27124,3,417,1,170.67,31781.56,20129,20132
27125,3,482,2,170.67,48576.89,20131,20134
27126,1,512,512,512.00,0.00,20133,20134
27127,1,512,512,512.00,0.00,20133,20134
27128,1,512,512,512.00,0.00,20133,20134
27129,5,239,2,102.40,7823.04,20133,20138
27130,1,512,512,512.00,0.00,20137,20138
27131,2,448,64,256.00,36864.00,20137,20139
27132,1,512,512,512.00,0.00,20138,20139
27133,1,512,512,512.00,0.00,20138,20139
27134,1,512,512,512.00,0.00,20138,20139
27135,1,512,512,512.00,0.00,20138,20139
27136,7,353,3,73.14,13489.55,20138,20145
27137,1,512,512,512.00,0.00,20144,20145
27138,1,512,512,512.00,0.00,20144,20145
27139,3,337,26,170.67,16354.89,20144,20147
27140,1,512,512,512.00,0.00,20146,20147
27141,1,512,512,512.00,0.00,20146,20147
27142,1,512,512,512.00,0.00,20146,20147
27143,4,286,3,128.00,10286.50,20146,20150
27144,1,512,512,512.00,0.00,20149,20150
27145,1,512,512,512.00,0.00,20149,20150
27146,1,512,512,512.00,0.00,20149,20150
27147,1,512,512,512.00,0.00,20149,20150
27148,1,512,512,512.00,0.00,20149,20150
27149,1,512,512,512.00,0.00,20149,20150
27150,1,512,512,512.00,0.00,20149,20150
27151,2,401,111,256.00,21025.00,20149,20151
27152,1,512,512,512.00,0.00,20150,20151
27153,1,512,512,512.00,0.00,20150,20151
27154,3,277,57,170.67,8093.56,20150,20153
27155,5,470,1,102.40,33844.24,20152,20157
27156,1,512,512,512.00,0.00,20156,20157
27157,1,512,512,512.00,0.00,20156,20157
27158,1,512,512,512.00,0.00,20156,20157
27159,3,379,4,170.67,24305.56,20156,20159
27160,1,512,512,512.00,0.00,20158,20159
27161,1,512,512,512.00,0.00,20158,20159
27162,2,453,59,256.00,38809.00,20158,20160
27163,1,512,512,512.00,0.00,20159,20160
27164,1,512,512,512.00,0.00,20159,20160
27165,2,438,74,256.00,33124.00,20159,20161
27166,1,512,512,512.00,0.00,20160,20161
27167,2,467,45,256.00,44521.00,20160,20162
27168,2,333,179,256.00,5929.00,20161,20163
27169,1,512,512,512.00,0.00,20162,20163
27170,1,512,512,512.00,0.00,20162,20163
27171,1,512,512,512.00,0.00,20162,20163
27172,1,512,512,512.00,0.00,20162,20163
27173,2,289,223,256.00,1089.00,20162,20164
27174,1,512,512,512.00,0.00,20163,20164
27175,1,512,512,512.00,0.00,20163,20164
27176,2,437,75,256.00,32761.00,20163,20165
27177,1,512,512,512.00,0.00,20164,20165
27178,1,512,512,512.00,0.00,20164,20165
27179,1,512,512,512.00,0.00,20164,20165
27180,2,304,208,256.00,2304.00,20164,20166
27181,1,512,512,512.00,0.00,20165,20166
27182,1,512,512,512.00,0.00,20165,20166
27183,2,321,191,256.00,4225.00,20165,20167
27184,1,512,512,512.00,0.00,20166,20167
27185,2,272,240,256.00,256.00,20166,20168
27186,3,407,52,170.67,27926.89,20167,20170
27187,1,512,512,512.00,0.00,20169,20170
27188,2,372,140,256.00,13456.00,20169,20171
27189,1,512,512,512.00,0.00,20170,20171
27190,1,512,512,512.00,0.00,20170,20171
27191,2,301,211,256.00,2025.00,20170,20172
27192,1,512,512,512.00,0.00,20171,20172
27193,2,306,206,256.00,2500.00,20171,20173
27194,1,512,512,512.00,0.00,20172,20173
27195,1,512,512,512.00,0.00,20172,20173
27196,1,512,512,512.00,0.00,20172,20173
27197,1,512,512,512.00,0.00,20172,20173
27198,2,282,230,256.00,676.00,20172,20174
27199,1,512,512,512.00,0.00,20173,20174
27200,1,512,512,512.00,0.00,20173,20174
27201,1,512,512,512.00,0.00,20173,20174
27202,1,512,512,512.00,0.00,20173,20174
27203,2,461,51,256.00,42025.00,20173,20175
27204,1,512,512,512.00,0.00,20174,20175
27205,1,512,512,512.00,0.00,20174,20175
27206,1,512,512,512.00,0.00,20174,20175
27207,1,512,512,512.00,0.00,20174,20175
27208,2,382,130,256.00,15876.00,20174,20176
27209,1,512,512,512.00,0.00,20175,20176
27210,1,512,512,512.00,0.00,20175,20176
27211,1,512,512,512.00,0.00,20175,20176
27212,1,512,512,512.00,0.00,20175,20176
27213,1,512,512,512.00,0.00,20175,20176
27214,3,365,64,170.67,18942.89,20175,20178
27215,1,512,512,512.00,0.00,20177,20178
27216,1,512,512,512.00,0.00,20177,20178
27217,2,391,121,256.00,18225.00,20177,20179
27218,1,512,512,512.00,0.00,20178,20179
27219,1,512,512,512.00,0.00,20178,20179
27220,1,512,512,512.00,0.00,20178,20179
27221,1,512,512,512.00,0.00,20178,20179
27222,1,512,512,512.00,0.00,20178,20179
27223,2,357,155,256.00,10201.00,20178,20180
27224,1,512,512,512.00,0.00,20179,20180
27225,1,512,512,512.00,0.00,20179,20180
27226,2,499,13,256.00,59049.00,20179,20181
27227,1,512,512,512.00,0.00,20180,20181
27228,2,317,195,256.00,3721.00,20180,20182
27229,1,512,512,512.00,0.00,20181,20182
27230,2,280,232,256.00,576.00,20181,20183
27231,1,512,512,512.00,0.00,20182,20183
27232,2,277,235,256.00,441.00,20182,20184
27233,1,512,512,512.00,0.00,20183,20184
27234,1,512,512,512.00,0.00,20183,20184
27235,2,321,191,256.00,4225.00,20183,20185
27236,3,390,13,170.67,25589.56,20184,20187
27237,2,337,175,256.00,6561.00,20186,20188
27238,1,512,512,512.00,0.00,20187,20188
27239,1,512,512,512.00,0.00,20187,20188
27240,2,422,90,256.00,27556.00,20187,20189
27241,1,512,512,512.00,0.00,20188,20189
27242,3,395,2,170.67,27290.89,20188,20191
27243,1,512,512,512.00,0.00,20190,20191
27244,1,512,512,512.00,0.00,20190,20191
27245,1,512,512,512.00,0.00,20190,20191
27246,2,417,95,256.00,25921.00,20190,20192
27247,2,506,6,256.00,62500.00,20191,20193
27248,4,430,2,128.00,30714.00,20192,20196
27249,5,400,12,102.40,22355.44,20195,20200
27250,1,512,512,512.00,0.00,20199,20200
27251,3,463,20,170.67,42742.89,20199,20202
27252,1,512,512,512.00,0.00,20201,20202
27253,2,483,29,256.00,51529.00,20201,20203
27254,3,459,16,170.67,41641.56,20202,20205
27255,2,285,227,256.00,841.00,20204,20206
27256,1,512,512,512.00,0.00,20205,20206
27257,1,512,512,512.00,0.00,20205,20206
27258,2,276,236,256.00,400.00,20205,20207
27259,1,512,512,512.00,0.00,20206,20207
27260,1,512,512,512.00,0.00,20206,20207
27261,1,512,512,512.00,0.00,20206,20207
27262,4,252,16,128.00,7610.50,20206,20210
27263,1,512,512,512.00,0.00,20209,20210
27264,1,512,512,512.00,0.00,20209,20210
27265,2,474,38,256.00,47524.00,20209,20211
27266,1,512,512,512.00,0.00,20210,20211
27267,1,512,512,512.00,0.00,20210,20211
27268,3,245,89,170.67,4082.89,20210,20213
27269,1,512,512,512.00,0.00,20212,20213
27270,1,512,512,512.00,0.00,20212,20213
27271,2,339,173,256.00,6889.00,20212,20214
27272,5,316,31,102.40,11803.44,20213,20218
27273,3,270,28,170.67,10699.56,20217,20220
27274,1,512,512,512.00,0.00,20219,20220
27275,3,302,14,170.67,14144.89,20219,20222
27276,4,279,45,128.00,8061.00,20221,20225
27277,1,512,512,512.00,0.00,20224,20225
27278,2,384,128,256.00,16384.00,20224,20226
27279,1,512,512,512.00,0.00,20225,20226
27280,1,512,512,512.00,0.00,20225,20226
27281,2,301,211,256.00,2025.00,20225,20227
27282,1,512,512,512.00,0.00,20226,20227
27283,1,512,512,512.00,0.00,20226,20227
27284,2,339,173,256.00,6889.00,20226,20228
27285,1,512,512,512.00,0.00,20227,20228
27286,1,512,512,512.00,0.00,20227,20228
27287,1,512,512,512.00,0.00,20227,20228
27288,2,402,110,256.00,21316.00,20227,20229
27289,1,512,512,512.00,0.00,20228,20229
27290,1,512,512,512.00,0.00,20228,20229
27291,1,512,512,512.00,0.00,20228,20229
27292,2,303,209,256.00,2209.00,20228,20230
27293,3,420,1,170.67,32433.56,20229,20232
27294,1,512,512,512.00,0.00,20231,20232
27295,5,352,2,102.40,17994.64,20231,20236
27296,1,512,512,512.00,0.00,20235,20236
27297,2,507,5,256.00,63001.00,20235,20237
27298,1,512,512,512.00,0.00,20236,20237
27299,1,512,512,512.00,0.00,20236,20237
27300,2,393,119,256.00,18769.00,20236,20238
27301,1,512,512,512.00,0.00,20237,20238
27302,1,512,512,512.00,0.00,20237,20238
27303,1,512,512,512.00,0.00,20237,20238
27304,3,236,99,170.67,3148.22,20237,20240
27305,3,387,14,170.67,24968.22,20239,20242
27306,1,512,512,512.00,0.00,20241,20242
27307,2,496,16,256.00,57600.00,20241,20243
27308,1,512,512,512.00,0.00,20242,20243
27309,1,512,512,512.00,0.00,20242,20243
27310,1,512,512,512.00,0.00,20242,20243
27311,1,512,512,512.00,0.00,20242,20243
27312,1,512,512,512.00,0.00,20242,20243
27313,3,280,80,170.67,6840.89,20242,20245
27314,2,346,166,256.00,8100.00,20244,20246
27315,1,512,512,512.00,0.00,20245,20246
27316,2,373,139,256.00,13689.00,20245,20247
27317,1,512,512,512.00,0.00,20246,20247
27318,1,512,512,512.00,0.00,20246,20247
27319,3,335,1,170.67,18606.89,20246,20249
27320,4,274,26,128.00,10094.00,20248,20252
27321,1,512,512,512.00,0.00,20251,20252
27322,1,512,512,512.00,0.00,20251,20252
27323,1,512,512,512.00,0.00,20251,20252
27324,1,512,512,512.00,0.00,20251,20252
27325,1,512,512,512.00,0.00,20251,20252
27326,2,414,98,256.00,24964.00,20251,20253
27327,1,512,512,512.00,0.00,20252,20253
27328,1,512,512,512.00,0.00,20252,20253
27329,1,512,512,512.00,0.00,20252,20253
27330,3,491,10,170.67,51306.89,20252,20255
27331,1,512,512,512.00,0.00,20254,20255
27332,1,512,512,512.00,0.00,20254,20255
27333,1,512,512,512.00,0.00,20254,20255
27334,2,360,152,256.00,10816.00,20254,20256
27335,2,449,63,256.00,37249.00,20255,20257
27336,1,512,512,512.00,0.00,20256,20257
27337,1,512,512,512.00,0.00,20256,20257
27338,3,454,1,170.67,40661.56,20256,20259
27339,2,473,39,256.00,47089.00,20258,20260
27340,1,512,512,512.00,0.00,20259,20260
27341,2,347,165,256.00,8281.00,20259,20261
27342,3,209,104,170.67,2238.89,20260,20263
27343,2,498,14,256.00,58564.00,20262,20264
27344,1,512,512,512.00,0.00,20263,20264
27345,1,512,512,512.00,0.00,20263,20264
27346,3,500,4,170.67,54232.89,20263,20266
27347,2,349,163,256.00,8649.00,20265,20267
27348,2,311,201,256.00,3025.00,20266,20268
27349,3,263,29,170.67,10342.89,20267,20270
27350,1,512,512,512.00,0.00,20269,20270
27351,2,307,205,256.00,2601.00,20269,20271
27352,2,474,38,256.00,47524.00,20270,20272
27353,2,457,55,256.00,40401.00,20271,20273
27354,1,512,512,512.00,0.00,20272,20273
27355,2,330,182,256.00,5476.00,20272,20274
27356,1,512,512,512.00,0.00,20273,20274
27357,1,512,512,512.00,0.00,20273,20274
27358,2,480,32,256.00,50176.00,20273,20275
27359,2,290,222,256.00,1156.00,20274,20276
27360,1,512,512,512.00,0.00,20275,20276
27361,2,350,162,256.00,8836.00,20275,20277
27362,3,218,80,170.67,4112.89,20276,20279
27363,1,512,512,512.00,0.00,20278,20279
27364,1,512,512,512.00,0.00,20278,20279
27365,1,512,512,512.00,0.00,20278,20279
27366,1,512,512,512.00,0.00,20278,20279
27367,2,404,108,256.00,21904.00,20278,20280
27368,2,364,148,256.00,11664.00,20279,20281
27369,1,512,512,512.00,0.00,20280,20281
27370,1,512,512,512.00,0.00,20280,20281
27371,1,512,512,512.00,0.00,20280,20281
27372,1,512,512,512.00,0.00,20280,20281
27373,2,368,144,256.00,12544.00,20280,20282
27374,1,512,512,512.00,0.00,20281,20282
27375,1,512,512,512.00,0.00,20281,20282
27376,2,431,81,256.00,30625.00,20281,20283
27377,1,512,512,512.00,0.00,20282,20283
27378,1,512,512,512.00,0.00,20282,20283
27379,2,374,138,256.00,13924.00,20282,20284
27380,1,512,512,512.00,0.00,20283,20284
27381,1,512,512,512.00,0.00,20283,20284
27382,1,512,512,512.00,0.00,20283,20284
27383,2,363,149,256.00,11449.00,20283,20285
27384,1,512,512,512.00,0.00,20284,20285
27385,1,512,512,512.00,0.00,20284,20285
27386,2,341,171,256.00,7225.00,20284,20286
27387,3,224,99,170.67,2772.22,20285,20288
27388,2,340,172,256.00,7056.00,20287,20289
27389,1,512,512,512.00,0.00,20288,20289
27390,1,512,512,512.00,0.00,20288,20289
27391,1,512,512,512.00,0.00,20288,20289
27392,2,350,162,256.00,8836.00,20288,20290
27393,2,260,252,256.00,16.00,20289,20291
27394,1,512,512,512.00,0.00,20290,20291
27395,4,308,17,128.00,12210.50,20290,20294
27396,1,512,512,512.00,0.00,20293,20294
27397,1,512,512,512.00,0.00,20293,20294
27398,2,331,181,256.00,5625.00,20293,20295
27399,1,512,512,512.00,0.00,20294,20295
27400,1,512,512,512.00,0.00,20294,20295
27401,1,512,512,512.00,0.00,20294,20295
27402,1,512,512,512.00,0.00,20294,20295
27403,1,512,512,512.00,0.00,20294,20295
27404,2,317,195,256.00,3721.00,20294,20296
27405,2,309,203,256.00,2809.00,20295,20297
27406,2,447,65,256.00,36481.00,20296,20298
27407,1,512,512,512.00,0.00,20297,20298
27408,1,512,512,512.00,0.00,20297,20298
27409,1,512,512,512.00,0.00,20297,20298
27410,1,512,512,512.00,0.00,20297,20298
27411,2,436,76,256.00,32400.00,20297,20299
27412,1,512,512,512.00,0.00,20298,20299
27413,1,512,512,512.00,0.00,20298,20299
27414,1,512,512,512.00,0.00,20298,20299
27415,1,512,512,512.00,0.00,20298,20299
27416,2,425,87,256.00,28561.00,20298,20300
27417,2,464,48,256.00,43264.00,20299,20301
27418,1,512,512,512.00,0.00,20300,20301
27419,2,423,89,256.00,27889.00,20300,20302
27420,1,512,512,512.00,0.00,20301,20302
27421,2,455,57,256.00,39601.00,20301,20303
27422,1,512,512,512.00,0.00,20302,20303
27423,1,512,512,512.00,0.00,20302,20303
27424,1,512,512,512.00,0.00,20302,20303
27425,1,512,512,512.00,0.00,20302,20303
27426,1,512,512,512.00,0.00,20302,20303
27427,3,487,5,170.67,50070.89,20302,20305
27428,2,411,101,256.00,24025.00,20304,20306
27429,1,512,512,512.00,0.00,20305,20306
27430,4,222,15,128.00,8002.50,20305,20309
27431,3,421,14,170.67,31994.89,20308,20311
27432,1,512,512,512.00,0.00,20310,20311
27433,1,512,512,512.00,0.00,20310,20311
27434,2,406,106,256.00,22500.00,20310,20312
27435,1,512,512,512.00,0.00,20311,20312
27436,2,466,46,256.00,44100.00,20311,20313
27437,1,512,512,512.00,0.00,20312,20313
27438,1,512,512,512.00,0.00,20312,20313
27439,1,512,512,512.00,0.00,20312,20313
27440,1,512,512,512.00,0.00,20312,20313
27441,2,299,213,256.00,1849.00,20312,20314
27442,1,512,512,512.00,0.00,20313,20314
27443,1,512,512,512.00,0.00,20313,20314
27444,3,266,28,170.67,10560.89,20313,20316
27445,1,512,512,512.00,0.00,20315,20316
27446,1,512,512,512.00,0.00,20315,20316
27447,3,285,17,170.67,12744.22,20315,20318
27448,2,328,184,256.00,5184.00,20317,20319
27449,1,512,512,512.00,0.00,20318,20319
27450,1,512,512,512.00,0.00,20318,20319
27451,1,512,512,512.00,0.00,20318,20319
27452,2,431,81,256.00,30625.00,20318,20320
27453,1,512,512,512.00,0.00,20319,20320
27454,1,512,512,512.00,0.00,20319,20320
27455,2,500,12,256.00,59536.00,20319,20321
27456,1,512,512,512.00,0.00,20320,20321
27457,1,512,512,512.00,0.00,20320,20321
27458,1,512,512,512.00,0.00,20320,20321
27459,3,396,21,170.67,26300.22,20320,20323
27460,2,310,202,256.00,2916.00,20322,20324
27461,1,512,512,512.00,0.00,20323,20324
27462,1,512,512,512.00,0.00,20323,20324
27463,1,512,512,512.00,0.00,20323,20324
27464,2,358,154,256.00,10404.00,20323,20325
27465,1,512,512,512.00,0.00,20324,20325
27466,1,512,512,512.00,0.00,20324,20325
27467,2,386,126,256.00,16900.00,20324,20326
27468,1,512,512,512.00,0.00,20325,20326
27469,1,512,512,512.00,0.00,20325,20326
27470,2,328,184,256.00,5184.00,20325,20327
27471,1,512,512,512.00,0.00,20326,20327
27472,1,512,512,512.00,0.00,20326,20327
27473,5,264,25,102.40,7905.84,20326,20331
27474,3,317,59,170.67,11694.89,20330,20333
27475,1,512,512,512.00,0.00,20332,20333
27476,2,509,3,256.00,64009.00,20332,20334
27477,2,427,85,256.00,29241.00,20333,20335
27478,1,512,512,512.00,0.00,20334,20335
27479,3,341,76,170.67,14566.89,20334,20337
27480,1,512,512,512.00,0.00,20336,20337
27481,1,512,512,512.00,0.00,20336,20337
27482,2,469,43,256.00,45369.00,20336,20338
27483,1,512,512,512.00,0.00,20337,20338
27484,3,246,117,170.67,3008.22,20337,20340
27485,2,261,251,256.00,25.00,20339,20341
27486,2,317,195,256.00,3721.00,20340,20342
27487,1,512,512,512.00,0.00,20341,20342
27488,1,512,512,512.00,0.00,20341,20342
27489,2,304,208,256.00,2304.00,20341,20343
27490,1,512,512,512.00,0.00,20342,20343
27491,2,379,133,256.00,15129.00,20342,20344
27492,2,471,41,256.00,46225.00,20343,20345
27493,2,480,32,256.00,50176.00,20344,20346
27494,3,239,119,170.67,2538.89,20345,20348
27495,1,512,512,512.00,0.00,20347,20348
27496,1,512,512,512.00,0.00,20347,20348
27497,2,340,172,256.00,7056.00,20347,20349
27498,1,512,512,512.00,0.00,20348,20349
27499,2,430,82,256.00,30276.00,20348,20350
27500,1,512,512,512.00,0.00,20349,20350
27501,2,499,13,256.00,59049.00,20349,20351
27502,1,512,512,512.00,0.00,20350,20351
27503,1,512,512,512.00,0.00,20350,20351
27504,1,512,512,512.00,0.00,20350,20351
27505,1,512,512,512.00,0.00,20350,20351
27506,1,512,512,512.00,0.00,20350,20351
27507,2,410,102,256.00,23716.00,20350,20352
27508,1,512,512,512.00,0.00,20351,20352
27509,2,332,180,256.00,5776.00,20351,20353
27510,1,512,512,512.00,0.00,20352,20353
27511,1,512,512,512.00,0.00,20352,20353
27512,1,512,512,512.00,0.00,20352,20353
27513,1,512,512,512.00,0.00,20352,20353
27514,3,300,1,170.67,15713.56,20352,20355
27515,1,512,512,512.00,0.00,20354,20355
27516,1,512,512,512.00,0.00,20354,20355
27517,2,269,243,256.00,169.00,20354,20356
27518,1,512,512,512.00,0.00,20355,20356
27519,1,512,512,512.00,0.00,20355,20356
27520,1,512,512,512.00,0.00,20355,20356
27521,1,512,512,512.00,0.00,20355,20356
27522,1,512,512,512.00,0.00,20355,20356
27523,1,512,512,512.00,0.00,20355,20356
27524,1,512,512,512.00,0.00,20355,20356
27525,2,506,6,256.00,62500.00,20355,20357
27526,1,512,512,512.00,0.00,20356,20357
27527,2,470,42,256.00,45796.00,20356,20358
27528,2,292,220,256.00,1296.00,20357,20359
27529,1,512,512,512.00,0.00,20358,20359
27530,1,512,512,512.00,0.00,20358,20359
27531,4,293,50,128.00,9679.50,20358,20362
27532,2,376,136,256.00,14400.00,20361,20363
27533,2,374,138,256.00,13924.00,20362,20364
27534,1,512,512,512.00,0.00,20363,20364
27535,1,512,512,512.00,0.00,20363,20364
27536,1,512,512,512.00,0.00,20363,20364
27537,3,252,85,170.67,4657.56,20363,20366
27538,1,512,512,512.00,0.00,20365,20366
27539,1,512,512,512.00,0.00,20365,20366
27540,1,512,512,512.00,0.00,20365,20366
27541,2,437,75,256.00,32761.00,20365,20367
27542,2,496,16,256.00,57600.00,20366,20368
27543,1,512,512,512.00,0.00,20367,20368
27544,1,512,512,512.00,0.00,20367,20368
27545,1,512,512,512.00,0.00,20367,20368
27546,1,512,512,512.00,0.00,20367,20368
27547,1,512,512,512.00,0.00,20367,20368
27548,2,267,245,256.00,121.00,20367,20369
27549,1,512,512,512.00,0.00,20368,20369
27550,5,453,2,102.40,30872.24,20368,20373
27551,1,512,512,512.00,0.00,20372,20373
27552,2,485,27,256.00,52441.00,20372,20374
27553,1,512,512,512.00,0.00,20373,20374
27554,1,512,512,512.00,0.00,20373,20374
27555,3,255,110,170.67,3784.22,20373,20376
27556,3,371,38,170.67,20770.89,20375,20378
27557,1,512,512,512.00,0.00,20377,20378
27558,2,366,146,256.00,12100.00,20377,20379
27559,1,512,512,512.00,0.00,20378,20379
27560,1,512,512,512.00,0.00,20378,20379
27561,1,512,512,512.00,0.00,20378,20379
27562,2,295,217,256.00,1521.00,20378,20380
27563,2,501,11,256.00,60025.00,20379,20381
27564,2,486,26,256.00,52900.00,20380,20382
27565,2,329,183,256.00,5329.00,20381,20383
27566,1,512,512,512.00,0.00,20382,20383
27567,3,215,118,170.67,1602.89,20382,20385
27568,4,269,10,128.00,13567.50,20384,20388
27569,1,512,512,512.00,0.00,20387,20388
27570,1,512,512,512.00,0.00,20387,20388
27571,1,512,512,512.00,0.00,20387,20388
27572,1,512,512,512.00,0.00,20387,20388
27573,1,512,512,512.00,0.00,20387,20388
27574,4,237,16,128.00,6317.50,20387,20391
27575,2,263,249,256.00,49.00,20390,20392
27576,2,486,26,256.00,52900.00,20391,20393
27577,1,512,512,512.00,0.00,20392,20393
27578,1,512,512,512.00,0.00,20392,20393
27579,1,512,512,512.00,0.00,20392,20393
27580,3,243,100,170.67,3409.56,20392,20395
27581,1,512,512,512.00,0.00,20394,20395
27582,1,512,512,512.00,0.00,20394,20395
27583,1,512,512,512.00,0.00,20394,20395
27584,1,512,512,512.00,0.00,20394,20395
27585,1,512,512,512.00,0.00,20394,20395
27586,2,316,196,256.00,3600.00,20394,20396
27587,1,512,512,512.00,0.00,20395,20396
27588,4,216,3,128.00,6016.50,20395,20399
27589,1,512,512,512.00,0.00,20398,20399
27590,2,476,36,256.00,48400.00,20398,20400
27591,4,341,1,128.00,19187.00,20399,20403
27592,1,512,512,512.00,0.00,20402,20403
27593,1,512,512,512.00,0.00,20402,20403
27594,1,512,512,512.00,0.00,20402,20403
27595,1,512,512,512.00,0.00,20402,20403
27596,1,512,512,512.00,0.00,20402,20403
27597,3,295,4,170.67,15009.56,20402,20405
27598,1,512,512,512.00,0.00,20404,20405
27599,4,163,84,128.00,990.50,20404,20408
27600,1,512,512,512.00,0.00,20407,20408
27601,1,512,512,512.00,0.00,20407,20408
27602,1,512,512,512.00,0.00,20407,20408
27603,1,512,512,512.00,0.00,20407,20408
27604,2,373,139,256.00,13689.00,20407,20409
27605,4,238,23,128.00,8710.50,20408,20412
27606,1,512,512,512.00,0.00,20411,20412
27607,1,512,512,512.00,0.00,20411,20412
27608,2,447,65,256.00,36481.00,20411,20413
27609,1,512,512,512.00,0.00,20412,20413
27610,5,205,5,102.40,5135.04,20412,20417
27611,1,512,512,512.00,0.00,20416,20417
27612,3,246,49,170.67,7541.56,20416,20419
27613,6,342,5,85.33,14382.22,20418,20424
27614,3,385,7,170.67,25097.56,20423,20426
27615,6,373,4,85.33,17378.89,20425,20431
27616,2,448,64,256.00,36864.00,20430,20432
27617,1,512,512,512.00,0.00,20431,20432
27618,1,512,512,512.00,0.00,20431,20432
27619,2,487,25,256.00,53361.00,20431,20433
27620,2,313,199,256.00,3249.00,20432,20434
27621,4,343,13,128.00,16477.00,20433,20437
27622,1,512,512,512.00,0.00,20436,20437
27623,1,512,512,512.00,0.00,20436,20437
27624,3,287,94,170.67,6994.89,20436,20439
27625,2,435,77,256.00,32041.00,20438,20440
27626,1,512,512,512.00,0.00,20439,20440
27627,1,512,512,512.00,0.00,20439,20440
27628,2,361,151,256.00,11025.00,20439,20441
27629,1,512,512,512.00,0.00,20440,20441
27630,2,458,54,256.00,40804.00,20440,20442
27631,1,512,512,512.00,0.00,20441,20442
27632,1,512,512,512.00,0.00,20441,20442
27633,2,416,96,256.00,25600.00,20441,20443
27634,1,512,512,512.00,0.00,20442,20443
27635,6,319,1,85.33,11783.89,20442,20448
27636,1,512,512,512.00,0.00,20447,20448
27637,1,512,512,512.00,0.00,20447,20448
27638,1,512,512,512.00,0.00,20447,20448
27639,1,512,512,512.00,0.00,20447,20448
27640,3,298,63,170.67,9397.56,20447,20450
27641,5,317,1,102.40,12653.04,20449,20454
27642,1,512,512,512.00,0.00,20453,20454
27643,1,512,512,512.00,0.00,20453,20454
27644,2,435,77,256.00,32041.00,20453,20455
27645,1,512,512,512.00,0.00,20454,20455
27646,1,512,512,512.00,0.00,20454,20455
27647,2,262,250,256.00,36.00,20454,20456
27648,2,299,213,256.00,1849.00,20455,20457
27649,2,295,217,256.00,1521.00,20456,20458
27650,1,512,512,512.00,0.00,20457,20458
27651,1,512,512,512.00,0.00,20457,20458
27652,4,233,55,128.00,4234.50,20457,20461
27653,1,512,512,512.00,0.00,20460,20461
27654,1,512,512,512.00,0.00,20460,20461
27655,4,246,2,128.00,8002.50,20460,20464
27656,2,480,32,256.00,50176.00,20463,20465
27657,4,337,1,128.00,18993.00,20464,20468
27658,1,512,512,512.00,0.00,20467,20468
27659,1,512,512,512.00,0.00,20467,20468
27660,1,512,512,512.00,0.00,20467,20468
27661,2,289,223,256.00,1089.00,20467,20469
27662,5,288,2,102.40,11737.84,20468,20473
27663,2,275,237,256.00,361.00,20472,20474
27664,1,512,512,512.00,0.00,20473,20474
27665,3,336,46,170.67,14843.56,20473,20476
27666,2,265,247,256.00,81.00,20475,20477
27667,1,512,512,512.00,0.00,20476,20477
27668,1,512,512,512.00,0.00,20476,20477
27669,1,512,512,512.00,0.00,20476,20477
27670,1,512,512,512.00,0.00,20476,20477
27671,3,297,6,170.67,14848.22,20476,20479
27672,4,187,53,128.00,2700.50,20478,20482
27673,3,297,98,170.67,8040.22,20481,20484
27674,4,250,22,128.00,8674.50,20483,20487
27675,1,512,512,512.00,0.00,20486,20487
27676,2,469,43,256.00,45369.00,20486,20488
27677,1,512,512,512.00,0.00,20487,20488
27678,4,297,7,128.00,15049.00,20487,20491
27679,1,512,512,512.00,0.00,20490,20491
27680,1,512,512,512.00,0.00,20490,20491
27681,1,512,512,512.00,0.00,20490,20491
27682,1,512,512,512.00,0.00,20490,20491
27683,1,512,512,512.00,0.00,20490,20491
27684,7,245,2,73.14,7807.27,20490,20497
27685,2,362,150,256.00,11236.00,20496,20498
27686,1,512,512,512.00,0.00,20497,20498
27687,1,512,512,512.00,0.00,20497,20498
27688,1,512,512,512.00,0.00,20497,20498
27689,1,512,512,512.00,0.00,20497,20498
27690,2,434,78,256.00,31684.00,20497,20499
27691,2,376,136,256.00,14400.00,20498,20500
27692,2,473,39,256.00,47089.00,20499,20501
27693,1,512,512,512.00,0.00,20500,20501
27694,1,512,512,512.00,0.00,20500,20501
27695,1,512,512,512.00,0.00,20500,20501
27696,2,390,122,256.00,17956.00,20500,20502
27697,3,260,48,170.67,8046.22,20501,20504
27698,1,512,512,512.00,0.00,20503,20504
27699,1,512,512,512.00,0.00,20503,20504
27700,1,512,512,512.00,0.00,20503,20504
27701,1,512,512,512.00,0.00,20503,20504
27702,2,320,192,256.00,4096.00,20503,20505
27703,1,512,512,512.00,0.00,20504,20505
27704,3,385,51,170.67,23073.56,20504,20507
27705,3,407,18,170.67,28720.22,20506,20509
27706,2,369,143,256.00,12769.00,20508,20510
27707,3,403,8,170.67,28430.89,20509,20512
27708,1,512,512,512.00,0.00,20511,20512
27709,9,188,7,56.89,3390.32,20511,20520
27710,2,460,52,256.00,41616.00,20519,20521
27711,1,512,512,512.00,0.00,20520,20521
27712,2,448,64,256.00,36864.00,20520,20522
27713,1,512,512,512.00,0.00,20521,20522
27714,1,512,512,512.00,0.00,20521,20522
27715,1,512,512,512.00,0.00,20521,20522
27716,3,236,41,170.67,8406.89,20521,20524
27717,5,433,4,102.40,27535.84,20523,20528
27718,2,467,45,256.00,44521.00,20527,20529
27719,1,512,512,512.00,0.00,20528,20529
27720,1,512,512,512.00,0.00,20528,20529
27721,1,512,512,512.00,0.00,20528,20529
27722,1,512,512,512.00,0.00,20528,20529
27723,5,334,4,102.40,15408.64,20528,20533
27724,9,197,1,56.89,4582.10,20532,20541
27725,1,512,512,512.00,0.00,20540,20541
27726,1,512,512,512.00,0.00,20540,20541
27727,6,179,32,85.33,2779.89,20540,20546
27728,2,490,22,256.00,54756.00,20545,20547
27729,1,512,512,512.00,0.00,20546,20547
27730,1,512,512,512.00,0.00,20546,20547
27731,1,512,512,512.00,0.00,20546,20547
27732,1,512,512,512.00,0.00,20546,20547
27733,3,301,6,170.67,15093.56,20546,20549
27734,1,512,512,512.00,0.00,20548,20549
27735,1,512,512,512.00,0.00,20548,20549
27736,1,512,512,512.00,0.00,20548,20549
27737,1,512,512,512.00,0.00,20548,20549
27738,1,512,512,512.00,0.00,20548,20549
27739,2,411,101,256.00,24025.00,20548,20550
27740,5,408,3,102.40,24407.84,20549,20554
27741,1,512,512,512.00,0.00,20553,20554
27742,1,512,512,512.00,0.00,20553,20554
27743,2,452,60,256.00,38416.00,20553,20555
27744,1,512,512,512.00,0.00,20554,20555
27745,2,438,74,256.00,33124.00,20554,20556
27746,1,512,512,512.00,0.00,20555,20556
27747,1,512,512,512.00,0.00,20555,20556
27748,1,512,512,512.00,0.00,20555,20556
27749,2,472,40,256.00,46656.00,20555,20557
27750,1,512,512,512.00,0.00,20556,20557
27751,1,512,512,512.00,0.00,20556,20557
27752,1,512,512,512.00,0.00,20556,20557
27753,1,512,512,512.00,0.00,20556,20557
27754,2,437,75,256.00,32761.00,20556,20558
27755,3,410,41,170.67,28706.89,20557,20560
27756,2,499,13,256.00,59049.00,20559,20561
27757,1,512,512,512.00,0.00,20560,20561
27758,5,199,2,102.40,6606.64,20560,20565
27759,1,512,512,512.00,0.00,20564,20565
27760,1,512,512,512.00,0.00,20564,20565
27761,1,512,512,512.00,0.00,20564,20565
27762,1,512,512,512.00,0.00,20564,20565
27763,2,395,117,256.00,19321.00,20564,20566
27764,1,512,512,512.00,0.00,20565,20566
27765,1,512,512,512.00,0.00,20565,20566
27766,1,512,512,512.00,0.00,20565,20566
27767,3,256,103,170.67,4057.56,20565,20568
27768,3,291,67,170.67,8501.56,20567,20570
27769,2,482,30,256.00,51076.00,20569,20571
27770,3,333,16,170.67,16777.56,20570,20573
27771,2,446,66,256.00,36100.00,20572,20574
27772,2,360,152,256.00,10816.00,20573,20575
27773,1,512,512,512.00,0.00,20574,20575
27774,1,512,512,512.00,0.00,20574,20575
27775,3,300,13,170.67,14129.56,20574,20577
27776,2,466,46,256.00,44100.00,20576,20578
27777,2,406,106,256.00,22500.00,20577,20579
27778,3,257,43,170.67,8486.89,20578,20581
27779,1,512,512,512.00,0.00,20580,20581
27780,2,437,75,256.00,32761.00,20580,20582
27781,3,306,14,170.67,14438.22,20581,20584
27782,1,512,512,512.00,0.00,20583,20584
27783,2,492,20,256.00,55696.00,20583,20585
27784,1,512,512,512.00,0.00,20584,20585
27785,2,432,80,256.00,30976.00,20584,20586
27786,3,482,6,170.67,48518.22,20585,20588
27787,1,512,512,512.00,0.00,20587,20588
27788,3,381,32,170.67,22868.22,20587,20590
27789,3,451,7,170.67,39661.56,20589,20592
27790,1,512,512,512.00,0.00,20591,20592
27791,3,395,32,170.67,25630.89,20591,20594
27792,3,189,158,170.67,176.22,20593,20596
27793,3,365,72,170.67,18884.22,20595,20598
27794,1,512,512,512.00,0.00,20597,20598
27795,5,265,1,102.40,14991.04,20597,20602
27796,1,512,512,512.00,0.00,20601,20602
27797,3,445,10,170.67,37997.56,20601,20604
27798,7,150,1,73.14,3110.69,20603,20610
27799,4,340,10,128.00,16789.50,20609,20613
27800,3,359,42,170.67,18528.22,20612,20615
27801,3,339,82,170.67,14181.56,20614,20617
27802,1,512,512,512.00,0.00,20616,20617
27803,1,512,512,512.00,0.00,20616,20617
27804,6,422,6,85.33,22739.56,20616,20622
27805,1,512,512,512.00,0.00,20621,20622
27806,1,512,512,512.00,0.00,20621,20622
27807,1,512,512,512.00,0.00,20621,20622
27808,1,512,512,512.00,0.00,20621,20622
27809,2,436,76,256.00,32400.00,20621,20623
27810,1,512,512,512.00,0.00,20622,20623
27811,2,311,201,256.00,3025.00,20622,20624
27812,1,512,512,512.00,0.00,20623,20624
27813,3,334,26,170.67,15984.89,20623,20626
27814,1,512,512,512.00,0.00,20625,20626
27815,1,512,512,512.00,0.00,20625,20626
27816,2,481,31,256.00,50625.00,20625,20627
27817,1,512,512,512.00,0.00,20626,20627
27818,1,512,512,512.00,0.00,20626,20627
27819,1,512,512,512.00,0.00,20626,20627
27820,1,512,512,512.00,0.00,20626,20627
27821,2,452,60,256.00,38416.00,20626,20628
27822,1,512,512,512.00,0.00,20627,20628
27823,1,512,512,512.00,0.00,20627,20628
27824,1,512,512,512.00,0.00,20627,20628
27825,1,512,512,512.00,0.00,20627,20628
27826,1,512,512,512.00,0.00,20627,20628
27827,4,390,31,128.00,22916.50,20627,20631
27828,3,307,90,170.67,9397.56,20630,20633
27829,1,512,512,512.00,0.00,20632,20633
27830,1,512,512,512.00,0.00,20632,20633
27831,1,512,512,512.00,0.00,20632,20633
27832,4,368,22,128.00,19818.00,20632,20636
27833,2,430,82,256.00,30276.00,20635,20637
27834,1,512,512,512.00,0.00,20636,20637
27835,2,472,40,256.00,46656.00,20636,20638
27836,1,512,512,512.00,0.00,20637,20638
27837,1,512,512,512.00,0.00,20637,20638
27838,8,298,3,64.00,8870.25,20637,20645
27839,2,452,60,256.00,38416.00,20644,20646
27840,2,433,79,256.00,31329.00,20645,20647
27841,1,512,512,512.00,0.00,20646,20647
27842,3,374,11,170.67,22914.89,20646,20649
27843,1,512,512,512.00,0.00,20648,20649
27844,3,411,1,170.67,30513.56,20648,20651
27845,4,466,6,128.00,38154.50,20650,20654
27846,1,512,512,512.00,0.00,20653,20654
27847,3,307,21,170.67,13721.56,20653,20656
27848,3,296,39,170.67,11028.22,20655,20658
27849,1,512,512,512.00,0.00,20657,20658
27850,1,512,512,512.00,0.00,20657,20658
27851,4,275,10,128.00,10758.50,20657,20661
27852,1,512,512,512.00,0.00,20660,20661
27853,1,512,512,512.00,0.00,20660,20661
27854,1,512,512,512.00,0.00,20660,20661
27855,3,442,4,170.67,37451.56,20660,20663
27856,2,363,149,256.00,11449.00,20662,20664
27857,4,355,2,128.00,18192.50,20663,20667
27858,6,237,2,85.33,6351.22,20666,20672
27859,1,512,512,512.00,0.00,20671,20672
27860,1,512,512,512.00,0.00,20671,20672
27861,3,252,124,170.67,3331.56,20671,20674
27862,1,512,512,512.00,0.00,20673,20674
27863,1,512,512,512.00,0.00,20673,20674
27864,2,388,124,256.00,17424.00,20673,20675
27865,1,512,512,512.00,0.00,20674,20675
27866,1,512,512,512.00,0.00,20674,20675
27867,1,512,512,512.00,0.00,20674,20675
27868,1,512,512,512.00,0.00,20674,20675
27869,3,403,32,170.67,27326.89,20674,20677
27870,1,512,512,512.00,0.00,20676,20677
27871,4,274,21,128.00,10211.50,20676,20680
27872,2,494,18,256.00,56644.00,20679,20681
27873,1,512,512,512.00,0.00,20680,20681
27874,1,512,512,512.00,0.00,20680,20681
27875,1,512,512,512.00,0.00,20680,20681
27876,3,399,28,170.67,26609.56,20680,20683
27877,2,319,193,256.00,3969.00,20682,20684
27878,1,512,512,512.00,0.00,20683,20684
27879,3,331,56,170.67,13646.89,20683,20686
27880,2,340,172,256.00,7056.00,20685,20687
27881,1,512,512,512.00,0.00,20686,20687
27882,1,512,512,512.00,0.00,20686,20687
27883,2,412,100,256.00,24336.00,20686,20688
27884,1,512,512,512.00,0.00,20687,20688
27885,1,512,512,512.00,0.00,20687,20688
27886,2,288,224,256.00,1024.00,20687,20689
27887,1,512,512,512.00,0.00,20688,20689
27888,1,512,512,512.00,0.00,20688,20689
27889,5,256,12,102.40,7959.44,20688,20693
27890,2,498,14,256.00,58564.00,20692,20694
27891,1,512,512,512.00,0.00,20693,20694
27892,3,274,101,170.67,5554.89,20693,20696
27893,2,287,225,256.00,961.00,20695,20697
27894,1,512,512,512.00,0.00,20696,20697
27895,1,512,512,512.00,0.00,20696,20697
27896,3,284,68,170.67,7832.89,20696,20699
27897,1,512,512,512.00,0.00,20698,20699
27898,1,512,512,512.00,0.00,20698,20699
27899,2,354,158,256.00,9604.00,20698,20700
27900,3,204,126,170.67,1078.22,20699,20702
27901,1,512,512,512.00,0.00,20701,20702
27902,5,225,12,102.40,5131.44,20701,20706
27903,1,512,512,512.00,0.00,20705,20706
27904,1,512,512,512.00,0.00,20705,20706
27905,2,417,95,256.00,25921.00,20705,20707
27906,1,512,512,512.00,0.00,20706,20707
27907,1,512,512,512.00,0.00,20706,20707
27908,1,512,512,512.00,0.00,20706,20707
27909,2,324,188,256.00,4624.00,20706,20708
27910,1,512,512,512.00,0.00,20707,20708
27911,4,197,66,128.00,2535.50,20707,20711
27912,1,512,512,512.00,0.00,20710,20711
27913,1,512,512,512.00,0.00,20710,20711
27914,1,512,512,512.00,0.00,20710,20711
27915,2,384,128,256.00,16384.00,20710,20712
27916,1,512,512,512.00,0.00,20711,20712
27917,1,512,512,512.00,0.00,20711,20712
27918,1,512,512,512.00,0.00,20711,20712
27919,2,502,10,256.00,60516.00,20711,20713
27920,1,512,512,512.00,0.00,20712,20713
27921,1,512,512,512.00,0.00,20712,20713
27922,2,457,55,256.00,40401.00,20712,20714
27923,1,512,512,512.00,0.00,20713,20714
27924,5,244,6,102.40,7443.44,20713,20718
27925,1,512,512,512.00,0.00,20717,20718
27926,1,512,512,512.00,0.00,20717,20718
27927,2,509,3,256.00,64009.00,20717,20719
27928,1,512,512,512.00,0.00,20719,20720
27929,1,512,512,512.00,0.00,20719,20720
27930,2,404,108,256.00,21904.00,20719,20721
27931,3,303,13,170.67,14337.56,20720,20723
27932,1,512,512,512.00,0.00,20722,20723
27933,1,512,512,512.00,0.00,20722,20723
27934,2,345,167,256.00,7921.00,20722,20724
27935,1,512,512,512.00,0.00,20723,20724
27936,1,512,512,512.00,0.00,20723,20724
27937,2,350,162,256.00,8836.00,20723,20725
27938,1,512,512,512.00,0.00,20724,20725
27939,1,512,512,512.00,0.00,20724,20725
27940,2,445,67,256.00,35721.00,20724,20726
27941,1,512,512,512.00,0.00,20725,20726
27942,2,287,225,256.00,961.00,20725,20727
27943,2,498,14,256.00,58564.00,20726,20728
27944,1,512,512,512.00,0.00,20727,20728
27945,1,512,512,512.00,0.00,20727,20728
27946,3,299,8,170.67,14702.89,20727,20730
27947,1,512,512,512.00,0.00,20729,20730
27948,3,481,11,170.67,48166.89,20729,20732
27949,3,371,29,170.67,21214.89,20731,20734
27950,1,512,512,512.00,0.00,20733,20734
27951,1,512,512,512.00,0.00,20733,20734
27952,2,374,138,256.00,13924.00,20733,20735
27953,5,291,1,102.40,11450.24,20734,20739
27954,1,512,512,512.00,0.00,20738,20739
27955,1,512,512,512.00,0.00,20738,20739
27956,1,512,512,512.00,0.00,20738,20739
27957,2,406,106,256.00,22500.00,20738,20740
27958,4,402,3,128.00,25450.50,20739,20743
27959,1,512,512,512.00,0.00,20742,20743
27960,1,512,512,512.00,0.00,20742,20743
27961,1,512,512,512.00,0.00,20742,20743
27962,1,512,512,512.00,0.00,20742,20743
27963,1,512,512,512.00,0.00,20742,20743
27964,1,512,512,512.00,0.00,20742,20743
27965,3,269,11,170.67,12974.89,20742,20745
27966,4,387,5,128.00,23969.00,20744,20748
27967,1,512,512,512.00,0.00,20747,20748
27968,2,345,167,256.00,7921.00,20747,20749
27969,4,244,43,128.00,7435.50,20748,20752
27970,1,512,512,512.00,0.00,20751,20752
27971,2,261,251,256.00,25.00,20751,20753
27972,2,267,245,256.00,121.00,20752,20754
27973,1,512,512,512.00,0.00,20753,20754
27974,1,512,512,512.00,0.00,20753,20754
27975,1,512,512,512.00,0.00,20753,20754
27976,2,387,125,256.00,17161.00,20753,20755
27977,1,512,512,512.00,0.00,20754,20755
27978,1,512,512,512.00,0.00,20754,20755
27979,2,307,205,256.00,2601.00,20754,20756
27980,1,512,512,512.00,0.00,20755,20756
27981,2,261,251,256.00,25.00,20755,20757
27982,1,512,512,512.00,0.00,20756,20757
27983,1,512,512,512.00,0.00,20756,20757
27984,4,267,7,128.00,9075.50,20756,20760
27985,3,263,46,170.67,8370.89,20759,20762
27986,1,512,512,512.00,0.00,20761,20762
27987,1,512,512,512.00,0.00,20761,20762
27988,3,424,2,170.67,33264.89,20761,20764
27989,1,512,512,512.00,0.00,20763,20764
27990,1,512,512,512.00,0.00,20763,20764
27991,2,474,38,256.00,47524.00,20763,20765
27992,1,512,512,512.00,0.00,20764,20765
27993,1,512,512,512.00,0.00,20764,20765
27994,1,512,512,512.00,0.00,20764,20765
27995,5,393,2,102.40,22066.24,20764,20769
27996,1,512,512,512.00,0.00,20768,20769
27997,1,512,512,512.00,0.00,20768,20769
27998,2,434,78,256.00,31684.00,20768,20770
27999,1,512,512,512.00,0.00,20769,20770
28000,5,336,13,102.40,15710.64,20769,20774
28001,1,512,512,512.00,0.00,20773,20774
28002,2,443,69,256.00,34969.00,20773,20775
28003,1,512,512,512.00,0.00,20774,20775
28004,2,273,239,256.00,289.00,20774,20776
28005,1,512,512,512.00,0.00,20775,20776
28006,8,137,17,64.00,1988.75,20775,20783
28007,3,255,5,170.67,13724.22,20782,20785
28008,1,512,512,512.00,0.00,20784,20785
28009,1,512,512,512.00,0.00,20784,20785
28010,1,512,512,512.00,0.00,20784,20785
28011,1,512,512,512.00,0.00,20784,20785
28012,2,421,91,256.00,27225.00,20784,20786
28013,1,512,512,512.00,0.00,20785,20786
28014,1,512,512,512.00,0.00,20785,20786
28015,1,512,512,512.00,0.00,20785,20786
28016,1,512,512,512.00,0.00,20785,20786
28017,2,408,104,256.00,23104.00,20785,20787
28018,1,512,512,512.00,0.00,20786,20787
28019,1,512,512,512.00,0.00,20786,20787
28020,2,272,240,256.00,256.00,20786,20788
28021,2,341,171,256.00,7225.00,20787,20789
28022,1,512,512,512.00,0.00,20788,20789
28023,1,512,512,512.00,0.00,20788,20789
28024,1,512,512,512.00,0.00,20788,20789
28025,1,512,512,512.00,0.00,20788,20789
28026,1,512,512,512.00,0.00,20788,20789
28027,1,512,512,512.00,0.00,20788,20789
28028,2,346,166,256.00,8100.00,20788,20790
28029,2,491,21,256.00,55225.00,20789,20791
28030,2,295,217,256.00,1521.00,20790,20792
28031,1,512,512,512.00,0.00,20791,20792
28032,1,512,512,512.00,0.00,20791,20792
28033,1,512,512,512.00,0.00,20791,20792
28034,3,301,35,170.67,11806.89,20791,20794
28035,1,512,512,512.00,0.00,20793,20794
28036,2,343,169,256.00,7569.00,20793,20795
28037,2,402,110,256.00,21316.00,20794,20796
28038,1,512,512,512.00,0.00,20795,20796
28039,3,277,51,170.67,8601.56,20795,20798
28040,1,512,512,512.00,0.00,20797,20798
28041,2,427,85,256.00,29241.00,20797,20799
28042,1,512,512,512.00,0.00,20798,20799
28043,1,512,512,512.00,0.00,20798,20799
28044,1,512,512,512.00,0.00,20798,20799
28045,2,509,3,256.00,64009.00,20798,20800
28046,1,512,512,512.00,0.00,20799,20800
28047,1,512,512,512.00,0.00,20799,20800
28048,1,512,512,512.00,0.00,20799,20800
28049,2,422,90,256.00,27556.00,20799,20801
28050,1,512,512,512.00,0.00,20800,20801
28051,1,512,512,512.00,0.00,20800,20801
28052,1,512,512,512.00,0.00,20800,20801
28053,2,303,209,256.00,2209.00,20800,20802
28054,1,512,512,512.00,0.00,20801,20802
28055,1,512,512,512.00,0.00,20801,20802
28056,1,512,512,512.00,0.00,20801,20802
28057,4,290,1,128.00,14574.50,20801,20805
28058,1,512,512,512.00,0.00,20804,20805
28059,1,512,512,512.00,0.00,20804,20805
28060,1,512,512,512.00,0.00,20804,20805
28061,1,512,512,512.00,0.00,20804,20805
28062,1,512,512,512.00,0.00,20804,20805
28063,2,347,165,256.00,8281.00,20804,20806
28064,1,512,512,512.00,0.00,20805,20806
28065,1,512,512,512.00,0.00,20805,20806
28066,1,512,512,512.00,0.00,20805,20806
28067,1,512,512,512.00,0.00,20805,20806
28068,2,480,32,256.00,50176.00,20805,20807
28069,1,512,512,512.00,0.00,20806,20807
28070,1,512,512,512.00,0.00,20806,20807
28071,3,299,28,170.67,12342.89,20806,20809
28072,1,512,512,512.00,0.00,20808,20809
28073,1,512,512,512.00,0.00,20808,20809
28074,2,458,54,256.00,40804.00,20808,20810
28075,1,512,512,512.00,0.00,20809,20810
28076,2,355,157,256.00,9801.00,20809,20811
28077,1,512,512,512.00,0.00,20810,20811
28078,1,512,512,512.00,0.00,20810,20811
28079,1,512,512,512.00,0.00,20810,20811
28080,1,512,512,512.00,0.00,20810,20811
28081,2,478,34,256.00,49284.00,20810,20812
28082,1,512,512,512.00,0.00,20811,20812
28083,1,512,512,512.00,0.00,20811,20812
28084,2,359,153,256.00,10609.00,20811,20813
28085,1,512,512,512.00,0.00,20812,20813
28086,1,512,512,512.00,0.00,20812,20813
28087,1,512,512,512.00,0.00,20812,20813
28088,2,402,110,256.00,21316.00,20812,20814
28089,1,512,512,512.00,0.00,20813,20814
28090,3,220,136,170.67,1283.56,20813,20816
28091,1,512,512,512.00,0.00,20815,20816
28092,1,512,512,512.00,0.00,20815,20816
28093,3,264,71,170.67,6228.22,20815,20818
28094,3,268,98,170.67,5120.89,20817,20820
28095,1,512,512,512.00,0.00,20819,20820
28096,1,512,512,512.00,0.00,20819,20820
28097,2,495,17,256.00,57121.00,20819,20821
28098,1,512,512,512.00,0.00,20820,20821
28099,2,310,202,256.00,2916.00,20820,20822
28100,1,512,512,512.00,0.00,20821,20822
28101,2,462,50,256.00,42436.00,20821,20823
28102,1,512,512,512.00,0.00,20822,20823
28103,1,512,512,512.00,0.00,20822,20823
28104,1,512,512,512.00,0.00,20822,20823
28105,1,512,512,512.00,0.00,20822,20823
28106,2,458,54,256.00,40804.00,20822,20824
28107,1,512,512,512.00,0.00,20823,20824
28108,1,512,512,512.00,0.00,20823,20824
28109,1,512,512,512.00,0.00,20823,20824
28110,2,281,231,256.00,625.00,20823,20825
28111,2,395,117,256.00,19321.00,20824,20826
28112,1,512,512,512.00,0.00,20825,20826
28113,2,461,51,256.00,42025.00,20825,20827
28114,2,408,104,256.00,23104.00,20826,20828
28115,2,376,136,256.00,14400.00,20827,20829
28116,1,512,512,512.00,0.00,20828,20829
28117,1,512,512,512.00,0.00,20828,20829
28118,2,358,154,256.00,10404.00,20828,20830
28119,1,512,512,512.00,0.00,20829,20830
28120,1,512,512,512.00,0.00,20829,20830
28121,2,319,193,256.00,3969.00,20829,20831
28122,1,512,512,512.00,0.00,20830,20831
28123,1,512,512,512.00,0.00,20830,20831
28124,1,512,512,512.00,0.00,20830,20831
28125,2,425,87,256.00,28561.00,20830,20832
28126,1,512,512,512.00,0.00,20831,20832
28127,1,512,512,512.00,0.00,20831,20832
28128,2,484,28,256.00,51984.00,20831,20833
28129,4,206,59,128.00,2892.50,20832,20836
28130,1,512,512,512.00,0.00,20835,20836
28131,2,279,233,256.00,529.00,20835,20837
28132,2,491,21,256.00,55225.00,20836,20838
28133,1,512,512,512.00,0.00,20837,20838
28134,2,276,236,256.00,400.00,20837,20839
28135,1,512,512,512.00,0.00,20838,20839
28136,2,435,77,256.00,32041.00,20838,20840
28137,1,512,512,512.00,0.00,20839,20840
28138,1,512,512,512.00,0.00,20839,20840
28139,3,275,28,170.67,10902.89,20839,20842
28140,2,270,242,256.00,196.00,20841,20843
28141,3,443,11,170.67,37450.89,20842,20845
28142,2,452,60,256.00,38416.00,20844,20846
28143,1,512,512,512.00,0.00,20845,20846
28144,2,353,159,256.00,9409.00,20845,20847
28145,2,501,11,256.00,60025.00,20846,20848
28146,2,499,13,256.00,59049.00,20847,20849
28147,1,512,512,512.00,0.00,20848,20849
28148,3,252,82,170.67,4843.56,20848,20851
28149,2,283,229,256.00,729.00,20850,20852
28150,2,351,161,256.00,9025.00,20851,20853
28151,2,472,40,256.00,46656.00,20852,20854
28152,1,512,512,512.00,0.00,20853,20854
28153,2,462,50,256.00,42436.00,20853,20855
28154,1,512,512,512.00,0.00,20854,20855
28155,2,273,239,256.00,289.00,20854,20856
28156,1,512,512,512.00,0.00,20855,20856
28157,1,512,512,512.00,0.00,20855,20856
28158,2,340,172,256.00,7056.00,20855,20857
28159,1,512,512,512.00,0.00,20856,20857
28160,2,422,90,256.00,27556.00,20856,20858
28161,1,512,512,512.00,0.00,20857,20858
28162,1,512,512,512.00,0.00,20857,20858
28163,1,512,512,512.00,0.00,20857,20858
28164,1,512,512,512.00,0.00,20857,20858
28165,1,512,512,512.00,0.00,20857,20858
28166,3,240,107,170.67,2964.22,20857,20860
28167,2,463,49,256.00,42849.00,20859,20861
28168,1,512,512,512.00,0.00,20860,20861
28169,1,512,512,512.00,0.00,20860,20861
28170,1,512,512,512.00,0.00,20860,20861
28171,1,512,512,512.00,0.00,20860,20861
28172,2,392,120,256.00,18496.00,20860,20862
28173,1,512,512,512.00,0.00,20861,20862
28174,1,512,512,512.00,0.00,20861,20862
28175,2,471,41,256.00,46225.00,20861,20863
28176,1,512,512,512.00,0.00,20862,20863
28177,1,512,512,512.00,0.00,20862,20863
28178,2,476,36,256.00,48400.00,20862,20864
28179,1,512,512,512.00,0.00,20863,20864
28180,1,512,512,512.00,0.00,20863,20864
28181,2,393,119,256.00,18769.00,20863,20865
28182,2,429,83,256.00,29929.00,20864,20866
28183,1,512,512,512.00,0.00,20865,20866
28184,1,512,512,512.00,0.00,20865,20866
28185,1,512,512,512.00,0.00,20865,20866
28186,1,512,512,512.00,0.00,20865,20866
28187,1,512,512,512.00,0.00,20865,20866
28188,2,263,249,256.00,49.00,20865,20867
28189,1,512,512,512.00,0.00,20866,20867
28190,1,512,512,512.00,0.00,20866,20867
28191,5,360,2,102.40,17065.04,20866,20871
28192,1,512,512,512.00,0.00,20870,20871
28193,3,290,33,170.67,11176.22,20870,20873
28194,2,363,149,256.00,11449.00,20872,20874
28195,3,334,19,170.67,16605.56,20873,20876
28196,2,269,243,256.00,169.00,20875,20877
28197,2,261,251,256.00,25.00,20876,20878
28198,1,512,512,512.00,0.00,20877,20878
28199,1,512,512,512.00,0.00,20877,20878
28200,1,512,512,512.00,0.00,20877,20878
28201,2,506,6,256.00,62500.00,20877,20879
28202,1,512,512,512.00,0.00,20878,20879
28203,1,512,512,512.00,0.00,20878,20879
28204,2,264,248,256.00,64.00,20878,20880
28205,1,512,512,512.00,0.00,20879,20880
28206,1,512,512,512.00,0.00,20879,20880
28207,2,498,14,256.00,58564.00,20879,20881
28208,3,323,34,170.67,14042.89,20880,20883
28209,2,480,32,256.00,50176.00,20882,20884
28210,1,512,512,512.00,0.00,20883,20884
28211,1,512,512,512.00,0.00,20883,20884
28212,1,512,512,512.00,0.00,20883,20884
28213,2,379,133,256.00,15129.00,20883,20885
28214,1,512,512,512.00,0.00,20884,20885
28215,1,512,512,512.00,0.00,20884,20885
28216,1,512,512,512.00,0.00,20884,20885
28217,1,512,512,512.00,0.00,20884,20885
28218,2,414,98,256.00,24964.00,20885,20887
28219,2,328,184,256.00,5184.00,20886,20888
28220,4,216,29,128.00,5529.50,20887,20891
28221,1,512,512,512.00,0.00,20890,20891
28222,2,357,155,256.00,10201.00,20890,20892
28223,1,512,512,512.00,0.00,20891,20892
28224,1,512,512,512.00,0.00,20891,20892
28225,1,512,512,512.00,0.00,20891,20892
28226,1,512,512,512.00,0.00,20891,20892
28227,1,512,512,512.00,0.00,20891,20892
28228,2,361,151,256.00,11025.00,20891,20893
28229,1,512,512,512.00,0.00,20892,20893
28230,2,384,128,256.00,16384.00,20892,20894
28231,1,512,512,512.00,0.00,20893,20894
28232,1,512,512,512.00,0.00,20893,20894
28233,1,512,512,512.00,0.00,20893,20894
28234,1,512,512,512.00,0.00,20893,20894
28235,3,314,9,170.67,15672.22,20893,20896
28236,1,512,512,512.00,0.00,20895,20896
28237,1,512,512,512.00,0.00,20895,20896
28238,1,512,512,512.00,0.00,20895,20896
28239,1,512,512,512.00,0.00,20895,20896
28240,3,231,74,170.67,4768.22,20895,20898
28241,1,512,512,512.00,0.00,20897,20898
28242,1,512,512,512.00,0.00,20897,20898
28243,1,512,512,512.00,0.00,20897,20898
28244,2,506,6,256.00,62500.00,20897,20899
28245,1,512,512,512.00,0.00,20898,20899
28246,4,299,13,128.00,11808.50,20898,20902
28247,1,512,512,512.00,0.00,20901,20902
28248,2,301,211,256.00,2025.00,20901,20903
28249,1,512,512,512.00,0.00,20902,20903
28250,1,512,512,512.00,0.00,20902,20903
28251,3,267,22,170.67,11373.56,20902,20905
28252,1,512,512,512.00,0.00,20904,20905
28253,4,474,11,128.00,39906.50,20904,20908
28254,1,512,512,512.00,0.00,20907,20908
28255,1,512,512,512.00,0.00,20907,20908
28256,1,512,512,512.00,0.00,20907,20908
28257,2,275,237,256.00,361.00,20907,20909
28258,1,512,512,512.00,0.00,20908,20909
28259,1,512,512,512.00,0.00,20908,20909
28260,2,382,130,256.00,15876.00,20908,20910
28261,1,512,512,512.00,0.00,20909,20910
28262,1,512,512,512.00,0.00,20909,20910
28263,1,512,512,512.00,0.00,20909,20910
28264,2,402,110,256.00,21316.00,20909,20911
28265,1,512,512,512.00,0.00,20910,20911
28266,2,387,125,256.00,17161.00,20910,20912
28267,1,512,512,512.00,0.00,20911,20912
28268,2,326,186,256.00,4900.00,20911,20913
28269,5,266,8,102.40,7671.44,20912,20917
28270,1,512,512,512.00,0.00,20916,20917
28271,3,359,4,170.67,21238.89,20916,20919
28272,1,512,512,512.00,0.00,20918,20919
28273,3,477,10,170.67,46957.56,20918,20921
28274,4,243,67,128.00,5051.00,20920,20924
28275,4,343,1,128.00,18356.50,20923,20927
28276,1,512,512,512.00,0.00,20926,20927
28277,2,332,180,256.00,5776.00,20926,20928
28278,1,512,512,512.00,0.00,20927,20928
28279,1,512,512,512.00,0.00,20927,20928
28280,1,512,512,512.00,0.00,20927,20928
28281,1,512,512,512.00,0.00,20927,20928
28282,4,207,17,128.00,4949.00,20927,20931
28283,1,512,512,512.00,0.00,20930,20931
28284,1,512,512,512.00,0.00,20930,20931
28285,2,307,205,256.00,2601.00,20930,20932
28286,1,512,512,512.00,0.00,20931,20932
28287,1,512,512,512.00,0.00,20931,20932
28288,2,373,139,256.00,13689.00,20931,20933
28289,2,511,1,256.00,65025.00,20932,20934
28290,2,333,179,256.00,5929.00,20933,20935
28291,1,512,512,512.00,0.00,20934,20935
28292,2,293,219,256.00,1369.00,20934,20936
28293,4,229,18,128.00,6713.50,20935,20939
28294,1,512,512,512.00,0.00,20938,20939
28295,1,512,512,512.00,0.00,20938,20939
28296,3,489,1,170.67,50741.56,20938,20941
28297,4,244,17,128.00,8725.50,20940,20944
28298,2,421,91,256.00,27225.00,20943,20945
28299,1,512,512,512.00,0.00,20944,20945
28300,1,512,512,512.00,0.00,20944,20945
28301,1,512,512,512.00,0.00,20944,20945
28302,1,512,512,512.00,0.00,20944,20945
28303,3,487,1,170.67,50121.56,20944,20947
28304,1,512,512,512.00,0.00,20946,20947
28305,1,512,512,512.00,0.00,20946,20947
28306,1,512,512,512.00,0.00,20946,20947
28307,4,324,1,128.00,18417.50,20946,20950
28308,4,233,1,128.00,7817.00,20949,20953
28309,2,377,135,256.00,14641.00,20952,20954
28310,1,512,512,512.00,0.00,20953,20954
28311,1,512,512,512.00,0.00,20953,20954
28312,1,512,512,512.00,0.00,20953,20954
28313,2,296,216,256.00,1600.00,20953,20955
28314,2,398,114,256.00,20164.00,20954,20956
28315,1,512,512,512.00,0.00,20955,20956
28316,2,477,35,256.00,48841.00,20955,20957
28317,1,512,512,512.00,0.00,20956,20957
28318,1,512,512,512.00,0.00,20956,20957
28319,2,263,249,256.00,49.00,20956,20958
28320,2,470,42,256.00,45796.00,20957,20959
28321,1,512,512,512.00,0.00,20958,20959
28322,1,512,512,512.00,0.00,20958,20959
28323,2,409,103,256.00,23409.00,20958,20960
28324,1,512,512,512.00,0.00,20959,20960
28325,2,335,177,256.00,6241.00,20959,20961
28326,1,512,512,512.00,0.00,20960,20961
28327,1,512,512,512.00,0.00,20960,20961
28328,2,436,76,256.00,32400.00,20960,20962
28329,1,512,512,512.00,0.00,20961,20962
28330,1,512,512,512.00,0.00,20961,20962
28331,3,219,98,170.67,2736.22,20961,20964
28332,2,419,93,256.00,26569.00,20963,20965
28333,1,512,512,512.00,0.00,20964,20965
28334,5,233,1,102.40,8363.04,20964,20969
28335,1,512,512,512.00,0.00,20968,20969
28336,2,279,233,256.00,529.00,20968,20970
28337,1,512,512,512.00,0.00,20969,20970
28338,2,324,188,256.00,4624.00,20969,20971
28339,2,484,28,256.00,51984.00,20970,20972
28340,3,320,32,170.67,13880.89,20971,20974
28341,2,422,90,256.00,27556.00,20973,20975
28342,1,512,512,512.00,0.00,20974,20975
28343,1,512,512,512.00,0.00,20974,20975
28344,1,512,512,512.00,0.00,20974,20975
28345,3,445,12,170.67,37937.56,20974,20977
28346,3,288,4,170.67,14659.56,20976,20979
28347,2,284,228,256.00,784.00,20978,20980
28348,1,512,512,512.00,0.00,20979,20980
28349,2,425,87,256.00,28561.00,20979,20981
28350,1,512,512,512.00,0.00,20980,20981
28351,2,334,178,256.00,6084.00,20980,20982
28352,1,512,512,512.00,0.00,20981,20982
28353,1,512,512,512.00,0.00,20981,20982
28354,2,491,21,256.00,55225.00,20981,20983
28355,2,336,176,256.00,6400.00,20982,20984
28356,1,512,512,512.00,0.00,20983,20984
28357,7,184,2,73.14,4965.84,20983,20990
28358,1,512,512,512.00,0.00,20989,20990
28359,1,512,512,512.00,0.00,20989,20990
28360,1,512,512,512.00,0.00,20989,20990
28361,2,326,186,256.00,4900.00,20989,20991
28362,2,427,85,256.00,29241.00,20990,20992
28363,1,512,512,512.00,0.00,20991,20992
28364,1,512,512,512.00,0.00,20991,20992
28365,2,493,19,256.00,56169.00,20991,20993
28366,2,456,56,256.00,40000.00,20992,20994
28367,1,512,512,512.00,0.00,20993,20994
28368,1,512,512,512.00,0.00,20993,20994
28369,4,401,1,128.00,26529.50,20993,20997
28370,2,463,49,256.00,42849.00,20996,20998
28371,4,287,1,128.00,16530.50,20997,21001
28372,3,300,8,170.67,14766.22,21000,21003
28373,1,512,512,512.00,0.00,21002,21003
28374,1,512,512,512.00,0.00,21002,21003
28375,1,512,512,512.00,0.00,21002,21003
28376,2,291,221,256.00,1225.00,21002,21004
28377,1,512,512,512.00,0.00,21003,21004
28378,1,512,512,512.00,0.00,21003,21004
28379,6,364,1,85.33,15946.89,21003,21009
28380,3,295,22,170.67,12717.56,21008,21011
28381,2,377,135,256.00,14641.00,21010,21012
28382,1,512,512,512.00,0.00,21011,21012
28383,2,491,21,256.00,55225.00,21011,21013
28384,1,512,512,512.00,0.00,21012,21013
28385,2,395,117,256.00,19321.00,21012,21014
28386,1,512,512,512.00,0.00,21013,21014
28387,1,512,512,512.00,0.00,21013,21014
28388,1,512,512,512.00,0.00,21013,21014
28389,5,220,35,102.40,5203.04,21013,21018
28390,1,512,512,512.00,0.00,21017,21018
28391,3,363,4,170.67,21809.56,21017,21020
28392,1,512,512,512.00,0.00,21019,21020
28393,2,511,1,256.00,65025.00,21019,21021
28394,4,351,11,128.00,17271.50,21020,21024
28395,1,512,512,512.00,0.00,21023,21024
28396,1,512,512,512.00,0.00,21023,21024
28397,4,339,1,128.00,19086.50,21023,21027
28398,1,512,512,512.00,0.00,21026,21027
28399,2,373,139,256.00,13689.00,21026,21028
28400,1,512,512,512.00,0.00,21027,21028
28401,2,307,205,256.00,2601.00,21027,21029
28402,2,473,39,256.00,47089.00,21028,21030
28403,2,474,38,256.00,47524.00,21029,21031
28404,1,512,512,512.00,0.00,21030,21031
28405,4,377,1,128.00,23377.50,21030,21034
28406,1,512,512,512.00,0.00,21033,21034
28407,3,387,50,170.67,23504.22,21033,21036
28408,1,512,512,512.00,0.00,21035,21036
28409,3,363,61,170.67,18617.56,21035,21038
28410,4,398,2,128.00,25178.00,21037,21041
28411,1,512,512,512.00,0.00,21040,21041
28412,1,512,512,512.00,0.00,21040,21041
28413,1,512,512,512.00,0.00,21040,21041
28414,1,512,512,512.00,0.00,21040,21041
28415,1,512,512,512.00,0.00,21040,21041
28416,2,505,7,256.00,62001.00,21040,21042
28417,1,512,512,512.00,0.00,21041,21042
28418,1,512,512,512.00,0.00,21041,21042
28419,1,512,512,512.00,0.00,21041,21042
28420,3,324,36,170.67,13998.22,21041,21044
28421,1,512,512,512.00,0.00,21043,21044
28422,1,512,512,512.00,0.00,21043,21044
28423,2,377,135,256.00,14641.00,21043,21045
28424,1,512,512,512.00,0.00,21044,21045
28425,2,460,52,256.00,41616.00,21044,21046
28426,1,512,512,512.00,0.00,21045,21046
28427,2,416,96,256.00,25600.00,21045,21047
28428,2,295,217,256.00,1521.00,21046,21048
28429,1,512,512,512.00,0.00,21047,21048
28430,1,512,512,512.00,0.00,21047,21048
28431,3,259,85,170.67,5049.56,21047,21050
28432,1,512,512,512.00,0.00,21049,21050
28433,4,276,17,128.00,9903.50,21049,21053
28434,1,512,512,512.00,0.00,21052,21053
28435,3,427,6,170.67,33741.56,21052,21055
28436,1,512,512,512.00,0.00,21054,21055
28437,2,282,230,256.00,676.00,21054,21056
28438,1,512,512,512.00,0.00,21055,21056
28439,1,512,512,512.00,0.00,21055,21056
28440,1,512,512,512.00,0.00,21055,21056
28441,3,465,2,170.67,43624.22,21055,21058
28442,1,512,512,512.00,0.00,21057,21058
28443,1,512,512,512.00,0.00,21057,21058
28444,3,419,3,170.67,32096.22,21057,21060
28445,1,512,512,512.00,0.00,21059,21060
28446,1,512,512,512.00,0.00,21059,21060
28447,1,512,512,512.00,0.00,21059,21060
28448,3,224,112,170.67,2104.89,21059,21062
28449,5,400,1,102.40,23805.84,21061,21066
28450,1,512,512,512.00,0.00,21065,21066
28451,4,341,1,128.00,19743.50,21065,21069
28452,1,512,512,512.00,0.00,21068,21069
28453,1,512,512,512.00,0.00,21068,21069
28454,4,225,1,128.00,9017.50,21068,21072
28455,1,512,512,512.00,0.00,21071,21072
28456,3,321,6,170.67,16640.22,21071,21074
28457,1,512,512,512.00,0.00,21073,21074
28458,5,356,2,102.40,18856.24,21073,21078
28459,4,252,2,128.00,14775.50,21077,21081
28460,1,512,512,512.00,0.00,21080,21081
28461,3,289,103,170.67,7049.56,21080,21083
28462,2,438,74,256.00,33124.00,21082,21084
28463,1,512,512,512.00,0.00,21083,21084
28464,1,512,512,512.00,0.00,21083,21084
28465,1,512,512,512.00,0.00,21083,21084
28466,1,512,512,512.00,0.00,21083,21084
28467,1,512,512,512.00,0.00,21083,21084
28468,2,399,113,256.00,20449.00,21083,21085
28469,3,209,135,170.67,916.22,21084,21087
28470,1,512,512,512.00,0.00,21086,21087
28471,1,512,512,512.00,0.00,21086,21087
28472,1,512,512,512.00,0.00,21086,21087
28473,1,512,512,512.00,0.00,21086,21087
28474,2,261,251,256.00,25.00,21086,21088
28475,1,512,512,512.00,0.00,21087,21088
28476,1,512,512,512.00,0.00,21087,21088
28477,1,512,512,512.00,0.00,21087,21088
28478,1,512,512,512.00,0.00,21087,21088
28479,1,512,512,512.00,0.00,21087,21088
28480,2,378,134,256.00,14884.00,21087,21089
28481,1,512,512,512.00,0.00,21088,21089
28482,2,259,253,256.00,9.00,21088,21090
28483,1,512,512,512.00,0.00,21089,21090
28484,2,357,155,256.00,10201.00,21089,21091
28485,2,440,72,256.00,33856.00,21090,21092
28486,1,512,512,512.00,0.00,21091,21092
28487,1,512,512,512.00,0.00,21091,21092
28488,2,257,255,256.00,1.00,21091,21093
28489,1,512,512,512.00,0.00,21092,21093
28490,2,464,48,256.00,43264.00,21092,21094
28491,1,512,512,512.00,0.00,21093,21094
28492,1,512,512,512.00,0.00,21093,21094
28493,2,510,2,256.00,64516.00,21093,21095
28494,3,277,24,170.67,11481.56,21094,21097
28495,1,512,512,512.00,0.00,21096,21097
28496,2,305,207,256.00,2401.00,21096,21098
28497,3,305,49,170.67,11002.89,21097,21100
28498,1,512,512,512.00,0.00,21099,21100
28499,5,255,40,102.40,6123.04,21099,21104
28500,1,512,512,512.00,0.00,21103,21104
28501,1,512,512,512.00,0.00,21103,21104
28502,1,512,512,512.00,0.00,21103,21104
28503,2,365,147,256.00,11881.00,21103,21105
28504,1,512,512,512.00,0.00,21104,21105
28505,3,429,2,170.67,34408.22,21104,21107
28506,1,512,512,512.00,0.00,21106,21107
28507,1,512,512,512.00,0.00,21106,21107
28508,1,512,512,512.00,0.00,21106,21107
28509,2,305,207,256.00,2401.00,21106,21108
28510,1,512,512,512.00,0.00,21107,21108
28511,1,512,512,512.00,0.00,21107,21108
28512,1,512,512,512.00,0.00,21107,21108
28513,1,512,512,512.00,0.00,21107,21108
28514,4,272,5,128.00,10399.50,21107,21111
28515,2,320,192,256.00,4096.00,21110,21112
28516,2,486,26,256.00,52900.00,21111,21113
28517,5,272,1,102.40,10822.64,21112,21117
28518,1,512,512,512.00,0.00,21116,21117
28519,1,512,512,512.00,0.00,21116,21117
28520,4,254,5,128.00,11668.50,21116,21120
28521,3,368,62,170.67,19536.89,21119,21122
28522,1,512,512,512.00,0.00,21121,21122
28523,1,512,512,512.00,0.00,21121,21122
28524,1,512,512,512.00,0.00,21121,21122
28525,1,512,512,512.00,0.00,21121,21122
28526,1,512,512,512.00,0.00,21121,21122
28527,1,512,512,512.00,0.00,21121,21122
28528,1,512,512,512.00,0.00,21121,21122
28529,5,229,14,102.40,6572.24,21121,21126
28530,1,512,512,512.00,0.00,21125,21126
28531,2,430,82,256.00,30276.00,21125,21127
28532,1,512,512,512.00,0.00,21126,21127
28533,5,304,21,102.40,11669.04,21126,21131
28534,1,512,512,512.00,0.00,21130,21131
28535,1,512,512,512.00,0.00,21130,21131
28536,1,512,512,512.00,0.00,21130,21131
28537,1,512,512,512.00,0.00,21130,21131
28538,1,512,512,512.00,0.00,21130,21131
28539,1,512,512,512.00,0.00,21130,21131
28540,1,512,512,512.00,0.00,21130,21131
28541,1,512,512,512.00,0.00,21130,21131
28542,7,252,2,73.14,6152.69,21130,21137
28543,1,512,512,512.00,0.00,21136,21137
28544,3,354,18,170.67,19286.22,21136,21139
28545,1,512,512,512.00,0.00,21138,21139
28546,2,257,255,256.00,1.00,21138,21140
28547,2,313,199,256.00,3249.00,21139,21141
28548,1,512,512,512.00,0.00,21140,21141
28549,3,314,17,170.67,14754.89,21140,21143
28550,1,512,512,512.00,0.00,21142,21143
28551,1,512,512,512.00,0.00,21142,21143
28552,1,512,512,512.00,0.00,21142,21143
28553,1,512,512,512.00,0.00,21142,21143
28554,2,481,31,256.00,50625.00,21142,21144
28555,3,398,5,170.67,27642.89,21143,21146
28556,3,331,73,170.67,13057.56,21145,21148
28557,1,512,512,512.00,0.00,21147,21148
28558,4,326,9,128.00,14982.50,21147,21151
28559,1,512,512,512.00,0.00,21150,21151
28560,1,512,512,512.00,0.00,21150,21151
28561,1,512,512,512.00,0.00,21150,21151
28562,2,402,110,256.00,21316.00,21150,21152
28563,7,411,1,73.14,19489.55,21151,21158
28564,1,512,512,512.00,0.00,21157,21158
28565,1,512,512,512.00,0.00,21157,21158
28566,3,228,116,170.67,2094.22,21157,21160
28567,2,461,51,256.00,42025.00,21159,21161
28568,1,512,512,512.00,0.00,21160,21161
28569,1,512,512,512.00,0.00,21160,21161
28570,2,418,94,256.00,26244.00,21160,21162
28571,1,512,512,512.00,0.00,21161,21162
28572,1,512,512,512.00,0.00,21161,21162
28573,4,396,2,128.00,24666.00,21161,21165
28574,1,512,512,512.00,0.00,21164,21165
28575,2,431,81,256.00,30625.00,21164,21166
28576,2,475,37,256.00,47961.00,21165,21167
28577,4,401,2,128.00,26680.50,21166,21170
28578,1,512,512,512.00,0.00,21169,21170
28579,1,512,512,512.00,0.00,21169,21170
28580,1,512,512,512.00,0.00,21169,21170
28581,1,512,512,512.00,0.00,21169,21170
28582,4,295,16,128.00,11432.50,21169,21173
28583,3,272,90,170.67,5734.22,21172,21175
28584,1,512,512,512.00,0.00,21174,21175
28585,1,512,512,512.00,0.00,21174,21175
28586,1,512,512,512.00,0.00,21174,21175
28587,1,512,512,512.00,0.00,21174,21175
28588,3,265,42,170.67,8877.56,21174,21177
28589,3,280,8,170.67,13752.89,21176,21179
28590,1,512,512,512.00,0.00,21178,21179
28591,1,512,512,512.00,0.00,21178,21179
28592,2,381,131,256.00,15625.00,21178,21180
28593,1,512,512,512.00,0.00,21179,21180
28594,2,329,183,256.00,5329.00,21179,21181
28595,1,512,512,512.00,0.00,21180,21181
28596,1,512,512,512.00,0.00,21180,21181
28597,1,512,512,512.00,0.00,21180,21181
28598,4,344,25,128.00,16347.50,21180,21184
28599,1,512,512,512.00,0.00,21183,21184
28600,3,412,46,170.67,29131.56,21183,21186
28601,1,512,512,512.00,0.00,21185,21186
28602,2,273,239,256.00,289.00,21185,21187
28603,1,512,512,512.00,0.00,21186,21187
28604,2,310,202,256.00,2916.00,21186,21188
28605,1,512,512,512.00,0.00,21187,21188
28606,2,472,40,256.00,46656.00,21187,21189
28607,1,512,512,512.00,0.00,21188,21189
28608,3,396,1,170.67,27553.56,21188,21191
28609,1,512,512,512.00,0.00,21190,21191
28610,1,512,512,512.00,0.00,21190,21191
28611,2,410,102,256.00,23716.00,21190,21192
28612,1,512,512,512.00,0.00,21191,21192
28613,1,512,512,512.00,0.00,21191,21192
28614,1,512,512,512.00,0.00,21191,21192
28615,2,393,119,256.00,18769.00,21191,21193
28616,1,512,512,512.00,0.00,21192,21193
28617,1,512,512,512.00,0.00,21192,21193
28618,1,512,512,512.00,0.00,21192,21193
28619,1,512,512,512.00,0.00,21192,21193
28620,3,205,122,170.67,1250.89,21192,21195
28621,3,389,7,170.67,25814.89,21194,21197
28622,1,512,512,512.00,0.00,21196,21197
28623,1,512,512,512.00,0.00,21196,21197
28624,1,512,512,512.00,0.00,21196,21197
28625,1,512,512,512.00,0.00,21196,21197
28626,4,384,4,128.00,22856.00,21196,21200
28627,3,467,13,170.67,43966.89,21199,21202
28628,1,512,512,512.00,0.00,21201,21202
28629,2,467,45,256.00,44521.00,21201,21203
28630,1,512,512,512.00,0.00,21202,21203
28631,2,506,6,256.00,62500.00,21202,21204
28632,1,512,512,512.00,0.00,21203,21204
28633,1,512,512,512.00,0.00,21203,21204
28634,2,408,104,256.00,23104.00,21203,21205
28635,1,512,512,512.00,0.00,21204,21205
28636,3,266,2,170.67,14304.89,21204,21207
28637,1,512,512,512.00,0.00,21206,21207
28638,1,512,512,512.00,0.00,21206,21207
28639,1,512,512,512.00,0.00,21206,21207
28640,1,512,512,512.00,0.00,21206,21207
28641,3,308,1,170.67,16230.89,21206,21209
28642,1,512,512,512.00,0.00,21208,21209
28643,1,512,512,512.00,0.00,21208,21209
28644,2,302,210,256.00,2116.00,21208,21210
28645,1,512,512,512.00,0.00,21209,21210
28646,1,512,512,512.00,0.00,21209,21210
28647,1,512,512,512.00,0.00,21209,21210
28648,3,252,9,170.67,13068.22,21209,21212
28649,1,512,512,512.00,0.00,21211,21212
28650,1,512,512,512.00,0.00,21211,21212
28651,1,512,512,512.00,0.00,21211,21212
28652,1,512,512,512.00,0.00,21211,21212
28653,2,357,155,256.00,10201.00,21211,21213
28654,2,407,105,256.00,22801.00,21212,21214
28655,1,512,512,512.00,0.00,21213,21214
28656,2,350,162,256.00,8836.00,21213,21215
28657,1,512,512,512.00,0.00,21214,21215
28658,1,512,512,512.00,0.00,21214,21215
28659,5,460,1,102.40,32169.04,21214,21219
28660,1,512,512,512.00,0.00,21218,21219
28661,3,223,99,170.67,2749.56,21218,21221
28662,1,512,512,512.00,0.00,21220,21221
28663,1,512,512,512.00,0.00,21220,21221
28664,3,240,120,170.67,2574.22,21220,21223
28665,1,512,512,512.00,0.00,21222,21223
28666,1,512,512,512.00,0.00,21222,21223
28667,1,512,512,512.00,0.00,21222,21223
28668,4,402,15,128.00,25204.50,21222,21226
28669,1,512,512,512.00,0.00,21225,21226
28670,2,418,94,256.00,26244.00,21225,21227
28671,1,512,512,512.00,0.00,21226,21227
28672,1,512,512,512.00,0.00,21226,21227
28673,2,423,89,256.00,27889.00,21226,21228
28674,1,512,512,512.00,0.00,21227,21228
28675,4,289,4,128.00,10600.50,21227,21231
28676,2,481,31,256.00,50625.00,21230,21232
28677,2,451,61,256.00,38025.00,21231,21233
28678,3,394,3,170.67,27029.56,21232,21235
28679,2,370,142,256.00,12996.00,21234,21236
28680,3,373,17,170.67,22306.89,21235,21238
28681,1,512,512,512.00,0.00,21237,21238
28682,4,299,45,128.00,10032.50,21237,21241
28683,1,512,512,512.00,0.00,21240,21241
28684,3,303,1,170.67,15897.56,21240,21243
28685,1,512,512,512.00,0.00,21242,21243
28686,2,381,131,256.00,15625.00,21242,21244
28687,1,512,512,512.00,0.00,21243,21244
28688,2,367,145,256.00,12321.00,21243,21245
28689,1,512,512,512.00,0.00,21244,21245
28690,1,512,512,512.00,0.00,21244,21245
28691,2,451,61,256.00,38025.00,21244,21246
28692,2,376,136,256.00,14400.00,21245,21247
28693,1,512,512,512.00,0.00,21246,21247
28694,4,224,36,128.00,4506.50,21246,21250
28695,1,512,512,512.00,0.00,21249,21250
28696,1,512,512,512.00,0.00,21249,21250
28697,1,512,512,512.00,0.00,21249,21250
28698,1,512,512,512.00,0.00,21249,21250
28699,1,512,512,512.00,0.00,21249,21250
28700,1,512,512,512.00,0.00,21249,21250
28701,3,320,73,170.67,11502.89,21249,21252
28702,1,512,512,512.00,0.00,21251,21252
28703,2,489,23,256.00,54289.00,21251,21253
28704,1,512,512,512.00,0.00,21252,21253
28705,1,512,512,512.00,0.00,21252,21253
28706,1,512,512,512.00,0.00,21252,21253
28707,2,423,89,256.00,27889.00,21252,21254
28708,1,512,512,512.00,0.00,21253,21254
28709,1,512,512,512.00,0.00,21253,21254
28710,1,512,512,512.00,0.00,21253,21254
28711,3,304,98,170.67,8912.89,21253,21256
28712,2,336,176,256.00,6400.00,21255,21257
28713,2,392,120,256.00,18496.00,21256,21258
28714,1,512,512,512.00,0.00,21257,21258
28715,1,512,512,512.00,0.00,21257,21258
28716,3,448,23,170.67,38510.89,21257,21260
28717,1,512,512,512.00,0.00,21259,21260
28718,1,512,512,512.00,0.00,21259,21260
28719,1,512,512,512.00,0.00,21259,21260
28720,2,290,222,256.00,1156.00,21259,21261
28721,2,504,8,256.00,61504.00,21260,21262
28722,2,319,193,256.00,3969.00,21261,21263
28723,1,512,512,512.00,0.00,21262,21263
28724,1,512,512,512.00,0.00,21262,21263
28725,2,265,247,256.00,81.00,21262,21264
28726,1,512,512,512.00,0.00,21263,21264
28727,2,416,96,256.00,25600.00,21263,21265
28728,1,512,512,512.00,0.00,21264,21265
28729,1,512,512,512.00,0.00,21264,21265
28730,1,512,512,512.00,0.00,21264,21265
28731,1,512,512,512.00,0.00,21264,21265
28732,2,276,236,256.00,400.00,21264,21266
28733,1,512,512,512.00,0.00,21265,21266
28734,1,512,512,512.00,0.00,21265,21266
28735,5,333,2,102.40,17089.04,21265,21270
28736,1,512,512,512.00,0.00,21269,21270
28737,1,512,512,512.00,0.00,21269,21270
28738,2,469,43,256.00,45369.00,21269,21271
28739,1,512,512,512.00,0.00,21270,21271
28740,1,512,512,512.00,0.00,21270,21271
28741,2,462,50,256.00,42436.00,21270,21272
28742,1,512,512,512.00,0.00,21271,21272
28743,3,450,10,170.67,39307.56,21271,21274
28744,1,512,512,512.00,0.00,21273,21274
28745,1,512,512,512.00,0.00,21273,21274
28746,2,501,11,256.00,60025.00,21273,21275
28747,2,449,63,256.00,37249.00,21274,21276
28748,1,512,512,512.00,0.00,21275,21276
28749,2,435,77,256.00,32041.00,21275,21277
28750,1,512,512,512.00,0.00,21276,21277
28751,1,512,512,512.00,0.00,21276,21277
28752,2,364,148,256.00,11664.00,21276,21278
28753,1,512,512,512.00,0.00,21277,21278
28754,1,512,512,512.00,0.00,21277,21278
28755,3,258,74,170.67,5686.22,21277,21280
28756,2,336,176,256.00,6400.00,21279,21281
28757,1,512,512,512.00,0.00,21280,21281
28758,2,426,86,256.00,28900.00,21280,21282
28759,1,512,512,512.00,0.00,21281,21282
28760,1,512,512,512.00,0.00,21281,21282
28761,1,512,512,512.00,0.00,21281,21282
28762,2,289,223,256.00,1089.00,21281,21283
28763,1,512,512,512.00,0.00,21282,21283
28764,1,512,512,512.00,0.00,21282,21283
28765,2,259,253,256.00,9.00,21282,21284
28766,2,333,179,256.00,5929.00,21283,21285
28767,1,512,512,512.00,0.00,21284,21285
28768,3,489,10,170.67,50669.56,21284,21287
28769,1,512,512,512.00,0.00,21286,21287
28770,1,512,512,512.00,0.00,21286,21287
28771,1,512,512,512.00,0.00,21286,21287
28772,1,512,512,512.00,0.00,21286,21287
28773,1,512,512,512.00,0.00,21286,21287
28774,3,391,4,170.67,26401.56,21286,21289
28775,1,512,512,512.00,0.00,21288,21289
28776,1,512,512,512.00,0.00,21288,21289
28777,2,355,157,256.00,9801.00,21288,21290
28778,1,512,512,512.00,0.00,21289,21290
28779,1,512,512,512.00,0.00,21289,21290
28780,2,474,38,256.00,47524.00,21289,21291
28781,1,512,512,512.00,0.00,21290,21291
28782,1,512,512,512.00,0.00,21290,21291
28783,1,512,512,512.00,0.00,21290,21291
28784,2,320,192,256.00,4096.00,21290,21292
28785,2,376,136,256.00,14400.00,21291,21293
28786,1,512,512,512.00,0.00,21292,21293
28787,1,512,512,512.00,0.00,21292,21293
28788,2,372,140,256.00,13456.00,21292,21294
28789,1,512,512,512.00,0.00,21293,21294
28790,1,512,512,512.00,0.00,21293,21294
28791,2,300,212,256.00,1936.00,21293,21295
28792,1,512,512,512.00,0.00,21294,21295
28793,1,512,512,512.00,0.00,21294,21295
28794,2,302,210,256.00,2116.00,21294,21296
28795,1,512,512,512.00,0.00,21295,21296
28796,3,429,22,170.67,33621.56,21295,21298
28797,2,345,167,256.00,7921.00,21297,21299
28798,1,512,512,512.00,0.00,21298,21299
28799,2,344,168,256.00,7744.00,21298,21300
28800,3,419,11,170.67,31674.89,21299,21302
28801,1,512,512,512.00,0.00,21301,21302
28802,1,512,512,512.00,0.00,21301,21302
28803,1,512,512,512.00,0.00,21301,21302
28804,2,327,185,256.00,5041.00,21301,21303
28805,1,512,512,512.00,0.00,21302,21303
28806,2,500,12,256.00,59536.00,21302,21304
28807,1,512,512,512.00,0.00,21303,21304
28808,2,471,41,256.00,46225.00,21303,21305
28809,1,512,512,512.00,0.00,21304,21305
28810,1,512,512,512.00,0.00,21304,21305
28811,1,512,512,512.00,0.00,21304,21305
28812,3,474,11,170.67,46048.22,21304,21307
28813,2,480,32,256.00,50176.00,21306,21308
28814,1,512,512,512.00,0.00,21307,21308
28815,1,512,512,512.00,0.00,21307,21308
28816,1,512,512,512.00,0.00,21307,21308
28817,3,227,101,170.67,2734.89,21307,21310
28818,1,512,512,512.00,0.00,21309,21310
28819,2,264,248,256.00,64.00,21309,21311
28820,2,282,230,256.00,676.00,21310,21312
28821,1,512,512,512.00,0.00,21311,21312
28822,2,401,111,256.00,21025.00,21311,21313
28823,1,512,512,512.00,0.00,21312,21313
28824,2,471,41,256.00,46225.00,21312,21314
28825,1,512,512,512.00,0.00,21313,21314
28826,2,459,53,256.00,41209.00,21313,21315
28827,1,512,512,512.00,0.00,21314,21315
28828,1,512,512,512.00,0.00,21314,21315
28829,2,277,235,256.00,441.00,21314,21316
28830,3,336,31,170.67,15833.56,21315,21318
28831,4,202,2,128.00,5964.00,21317,21321
28832,2,434,78,256.00,31684.00,21320,21322
28833,1,512,512,512.00,0.00,21321,21322
28834,1,512,512,512.00,0.00,21321,21322
28835,3,364,36,170.67,19651.56,21321,21324
28836,1,512,512,512.00,0.00,21323,21324
28837,1,512,512,512.00,0.00,21323,21324
28838,2,490,22,256.00,54756.00,21323,21325
28839,1,512,512,512.00,0.00,21324,21325
28840,1,512,512,512.00,0.00,21324,21325
28841,1,512,512,512.00,0.00,21324,21325
28842,1,512,512,512.00,0.00,21324,21325
28843,2,421,91,256.00,27225.00,21324,21326
28844,1,512,512,512.00,0.00,21325,21326
28845,2,291,221,256.00,1225.00,21325,21327
28846,1,512,512,512.00,0.00,21326,21327
28847,2,488,24,256.00,53824.00,21326,21328
28848,3,406,7,170.67,29101.56,21327,21330
28849,2,340,172,256.00,7056.00,21329,21331
28850,2,346,166,256.00,8100.00,21330,21332
28851,1,512,512,512.00,0.00,21331,21332
28852,2,478,34,256.00,49284.00,21331,21333
28853,1,512,512,512.00,0.00,21332,21333
28854,1,512,512,512.00,0.00,21332,21333
28855,2,447,65,256.00,36481.00,21332,21334
28856,1,512,512,512.00,0.00,21333,21334
28857,1,512,512,512.00,0.00,21333,21334
28858,3,293,48,170.67,10004.22,21333,21336
28859,1,512,512,512.00,0.00,21335,21336
28860,2,408,104,256.00,23104.00,21335,21337
28861,1,512,512,512.00,0.00,21336,21337
28862,1,512,512,512.00,0.00,21336,21337
28863,1,512,512,512.00,0.00,21336,21337
28864,2,395,117,256.00,19321.00,21336,21338
28865,1,512,512,512.00,0.00,21337,21338
28866,1,512,512,512.00,0.00,21337,21338
28867,1,512,512,512.00,0.00,21337,21338
28868,2,383,129,256.00,16129.00,21337,21339
28869,1,512,512,512.00,0.00,21338,21339
28870,2,360,152,256.00,10816.00,21338,21340
28871,2,300,212,256.00,1936.00,21339,21341
28872,2,496,16,256.00,57600.00,21340,21342
28873,2,345,167,256.00,7921.00,21341,21343
28874,2,413,99,256.00,24649.00,21342,21344
28875,3,299,85,170.67,8542.89,21343,21346
28876,1,512,512,512.00,0.00,21345,21346
28877,1,512,512,512.00,0.00,21345,21346
28878,3,273,115,170.67,5249.56,21345,21348
28879,2,462,50,256.00,42436.00,21347,21349
28880,2,307,205,256.00,2601.00,21348,21350
28881,1,512,512,512.00,0.00,21349,21350
28882,2,465,47,256.00,43681.00,21349,21351
28883,1,512,512,512.00,0.00,21350,21351
28884,1,512,512,512.00,0.00,21350,21351
28885,2,389,123,256.00,17689.00,21350,21352
28886,1,512,512,512.00,0.00,21351,21352
28887,1,512,512,512.00,0.00,21351,21352
28888,1,512,512,512.00,0.00,21351,21352
28889,1,512,512,512.00,0.00,21351,21352
28890,2,501,11,256.00,60025.00,21351,21353
28891,4,341,29,128.00,15995.00,21352,21356
28892,1,512,512,512.00,0.00,21355,21356
28893,3,292,69,170.67,8481.56,21355,21358
28894,1,512,512,512.00,0.00,21357,21358
28895,2,405,107,256.00,22201.00,21357,21359
28896,1,512,512,512.00,0.00,21358,21359
28897,1,512,512,512.00,0.00,21358,21359
28898,1,512,512,512.00,0.00,21358,21359
28899,2,422,90,256.00,27556.00,21358,21360
28900,1,512,512,512.00,0.00,21359,21360
28901,2,424,88,256.00,28224.00,21359,21361
28902,1,512,512,512.00,0.00,21360,21361
28903,1,512,512,512.00,0.00,21360,21361
28904,1,512,512,512.00,0.00,21360,21361
28905,2,332,180,256.00,5776.00,21360,21362
28906,1,512,512,512.00,0.00,21361,21362
28907,2,372,140,256.00,13456.00,21361,21363
28908,1,512,512,512.00,0.00,21362,21363
28909,1,512,512,512.00,0.00,21362,21363
28910,1,512,512,512.00,0.00,21362,21363
28911,1,512,512,512.00,0.00,21362,21363
28912,2,368,144,256.00,12544.00,21362,21364
28913,2,305,207,256.00,2401.00,21363,21365
28914,1,512,512,512.00,0.00,21364,21365
28915,1,512,512,512.00,0.00,21364,21365
28916,1,512,512,512.00,0.00,21364,21365
28917,1,512,512,512.00,0.00,21364,21365
28918,4,373,17,128.00,20811.50,21364,21368
28919,1,512,512,512.00,0.00,21367,21368
28920,1,512,512,512.00,0.00,21367,21368
28921,2,469,43,256.00,45369.00,21367,21369
28922,2,449,63,256.00,37249.00,21368,21370
28923,4,235,9,128.00,6758.50,21369,21373
28924,1,512,512,512.00,0.00,21372,21373
28925,1,512,512,512.00,0.00,21372,21373
28926,1,512,512,512.00,0.00,21372,21373
28927,3,366,70,170.67,19083.56,21372,21375
28928,1,512,512,512.00,0.00,21374,21375
28929,1,512,512,512.00,0.00,21374,21375
28930,2,332,180,256.00,5776.00,21374,21376
28931,2,482,30,256.00,51076.00,21375,21377
28932,2,404,108,256.00,21904.00,21376,21378
28933,1,512,512,512.00,0.00,21377,21378
28934,1,512,512,512.00,0.00,21377,21378
28935,2,278,234,256.00,484.00,21377,21379
28936,3,326,49,170.67,13354.89,21378,21381
28937,2,489,23,256.00,54289.00,21380,21382
28938,1,512,512,512.00,0.00,21381,21382
28939,1,512,512,512.00,0.00,21381,21382
28940,1,512,512,512.00,0.00,21381,21382
28941,1,512,512,512.00,0.00,21381,21382
28942,1,512,512,512.00,0.00,21381,21382
28943,2,396,116,256.00,19600.00,21381,21383
28944,1,512,512,512.00,0.00,21382,21383
28945,1,512,512,512.00,0.00,21382,21383
28946,1,512,512,512.00,0.00,21382,21383
28947,2,491,21,256.00,55225.00,21382,21384
28948,1,512,512,512.00,0.00,21383,21384
28949,1,512,512,512.00,0.00,21383,21384
28950,4,420,8,128.00,29192.00,21383,21387
28951,1,512,512,512.00,0.00,21386,21387
28952,1,512,512,512.00,0.00,21386,21387
28953,2,339,173,256.00,6889.00,21386,21388
28954,4,215,52,128.00,5629.50,21387,21391
28955,2,467,45,256.00,44521.00,21390,21392
28956,2,313,199,256.00,3249.00,21391,21393
28957,3,396,1,170.67,27553.56,21392,21395
28958,2,287,225,256.00,961.00,21394,21396
28959,1,512,512,512.00,0.00,21395,21396
28960,3,415,10,170.67,30837.56,21395,21398
28961,4,419,6,128.00,29164.50,21397,21401
28962,1,512,512,512.00,0.00,21400,21401
28963,1,512,512,512.00,0.00,21400,21401
28964,1,512,512,512.00,0.00,21400,21401
28965,1,512,512,512.00,0.00,21400,21401
28966,2,289,223,256.00,1089.00,21400,21402
28967,1,512,512,512.00,0.00,21401,21402
28968,2,394,118,256.00,19044.00,21401,21403
28969,1,512,512,512.00,0.00,21402,21403
28970,2,435,77,256.00,32041.00,21402,21404
28971,1,512,512,512.00,0.00,21403,21404
28972,2,359,153,256.00,10609.00,21403,21405
28973,3,263,105,170.67,4516.22,21404,21407
28974,3,371,2,170.67,23194.89,21406,21409
28975,2,294,218,256.00,1444.00,21408,21410
28976,1,512,512,512.00,0.00,21409,21410
28977,2,382,130,256.00,15876.00,21409,21411
28978,2,424,88,256.00,28224.00,21410,21412
28979,1,512,512,512.00,0.00,21411,21412
28980,2,487,25,256.00,53361.00,21411,21413
28981,3,467,20,170.67,43910.89,21412,21415
28982,1,512,512,512.00,0.00,21414,21415
28983,1,512,512,512.00,0.00,21414,21415
28984,1,512,512,512.00,0.00,21414,21415
28985,1,512,512,512.00,0.00,21414,21415
28986,3,289,55,170.67,9129.56,21414,21417
28987,1,512,512,512.00,0.00,21416,21417
28988,1,512,512,512.00,0.00,21416,21417
28989,1,512,512,512.00,0.00,21416,21417
28990,1,512,512,512.00,0.00,21416,21417
28991,2,315,197,256.00,3481.00,21416,21418
28992,2,342,170,256.00,7396.00,21417,21419
28993,1,512,512,512.00,0.00,21418,21419
28994,1,512,512,512.00,0.00,21418,21419
28995,6,273,5,85.33,8442.22,21418,21424
28996,3,233,130,170.67,2002.89,21423,21426
28997,2,379,133,256.00,15129.00,21425,21427
28998,1,512,512,512.00,0.00,21426,21427
28999,3,258,96,170.67,4454.22,21426,21429
29000,1,512,512,512.00,0.00,21428,21429
29001,1,512,512,512.00,0.00,21428,21429
29002,1,512,512,512.00,0.00,21428,21429
29003,1,512,512,512.00,0.00,21428,21429
29004,1,512,512,512.00,0.00,21428,21429
29005,1,512,512,512.00,0.00,21428,21429
29006,2,317,195,256.00,3721.00,21428,21430
29007,1,512,512,512.00,0.00,21429,21430
29008,2,482,30,256.00,51076.00,21429,21431
29009,1,512,512,512.00,0.00,21430,21431
29010,2,498,14,256.00,58564.00,21430,21432
29011,2,432,80,256.00,30976.00,21431,21433
29012,1,512,512,512.00,0.00,21432,21433
29013,1,512,512,512.00,0.00,21432,21433
29014,2,458,54,256.00,40804.00,21432,21434
29015,1,512,512,512.00,0.00,21433,21434
29016,1,512,512,512.00,0.00,21433,21434
29017,3,444,18,170.67,37526.22,21433,21436
29018,2,333,179,256.00,5929.00,21435,21437
29019,1,512,512,512.00,0.00,21436,21437
29020,2,420,92,256.00,26896.00,21436,21438
29021,1,512,512,512.00,0.00,21437,21438
29022,1,512,512,512.00,0.00,21437,21438
29023,2,295,217,256.00,1521.00,21437,21439
29024,4,273,37,128.00,9613.00,21438,21442
29025,2,279,233,256.00,529.00,21441,21443
29026,2,472,40,256.00,46656.00,21442,21444
29027,2,454,58,256.00,39204.00,21443,21445
29028,1,512,512,512.00,0.00,21444,21445
29029,1,512,512,512.00,0.00,21444,21445
29030,1,512,512,512.00,0.00,21444,21445
29031,1,512,512,512.00,0.00,21444,21445
29032,2,267,245,256.00,121.00,21444,21446
29033,1,512,512,512.00,0.00,21445,21446
29034,1,512,512,512.00,0.00,21445,21446
29035,2,491,21,256.00,55225.00,21445,21447
29036,1,512,512,512.00,0.00,21446,21447
29037,1,512,512,512.00,0.00,21446,21447
29038,4,473,3,128.00,39797.00,21446,21450
29039,2,348,164,256.00,8464.00,21449,21451
29040,2,442,70,256.00,34596.00,21450,21452
29041,2,265,247,256.00,81.00,21451,21453
29042,1,512,512,512.00,0.00,21452,21453
29043,2,371,141,256.00,13225.00,21452,21454
29044,1,512,512,512.00,0.00,21453,21454
29045,1,512,512,512.00,0.00,21453,21454
29046,1,512,512,512.00,0.00,21453,21454
29047,3,364,67,170.67,18721.56,21453,21456
29048,1,512,512,512.00,0.00,21455,21456
29049,1,512,512,512.00,0.00,21455,21456
29050,2,384,128,256.00,16384.00,21455,21457
29051,1,512,512,512.00,0.00,21456,21457
29052,2,390,122,256.00,17956.00,21456,21458
29053,1,512,512,512.00,0.00,21457,21458
29054,2,397,115,256.00,19881.00,21457,21459
29055,2,372,140,256.00,13456.00,21458,21460
29056,2,436,76,256.00,32400.00,21459,21461
29057,1,512,512,512.00,0.00,21460,21461
29058,1,512,512,512.00,0.00,21460,21461
29059,3,339,74,170.67,14272.22,21460,21463
29060,1,512,512,512.00,0.00,21462,21463
29061,1,512,512,512.00,0.00,21462,21463
29062,1,512,512,512.00,0.00,21462,21463
29063,2,350,162,256.00,8836.00,21462,21464
29064,1,512,512,512.00,0.00,21463,21464
29065,2,508,4,256.00,63504.00,21463,21465
29066,1,512,512,512.00,0.00,21464,21465
29067,1,512,512,512.00,0.00,21464,21465
29068,2,492,20,256.00,55696.00,21464,21466
29069,2,257,255,256.00,1.00,21465,21467
29070,1,512,512,512.00,0.00,21466,21467
29071,1,512,512,512.00,0.00,21466,21467
29072,2,464,48,256.00,43264.00,21466,21468
29073,3,222,108,170.67,2230.22,21467,21470
29074,1,512,512,512.00,0.00,21469,21470
29075,1,512,512,512.00,0.00,21469,21470
29076,1,512,512,512.00,0.00,21469,21470
29077,1,512,512,512.00,0.00,21469,21470
29078,6,277,1,85.33,9467.56,21469,21475
29079,1,512,512,512.00,0.00,21474,21475
29080,1,512,512,512.00,0.00,21474,21475
29081,2,298,214,256.00,1764.00,21474,21476
29082,2,474,38,256.00,47524.00,21475,21477
29083,3,255,14,170.67,12296.22,21476,21479
29084,1,512,512,512.00,0.00,21478,21479
29085,1,512,512,512.00,0.00,21478,21479
29086,1,512,512,512.00,0.00,21478,21479
29087,2,445,67,256.00,35721.00,21478,21480
29088,1,512,512,512.00,0.00,21479,21480
29089,1,512,512,512.00,0.00,21479,21480
29090,1,512,512,512.00,0.00,21479,21480
29091,2,429,83,256.00,29929.00,21479,21481
29092,3,216,123,170.67,1444.22,21480,21483
29093,1,512,512,512.00,0.00,21482,21483
29094,3,251,11,170.67,12746.89,21482,21485
29095,1,512,512,512.00,0.00,21484,21485
29096,2,322,190,256.00,4356.00,21484,21486
29097,1,512,512,512.00,0.00,21485,21486
29098,1,512,512,512.00,0.00,21485,21486
29099,1,512,512,512.00,0.00,21485,21486
29100,1,512,512,512.00,0.00,21485,21486
29101,2,332,180,256.00,5776.00,21485,21487
29102,2,421,91,256.00,27225.00,21486,21488
29103,2,424,88,256.00,28224.00,21487,21489
29104,1,512,512,512.00,0.00,21488,21489
29105,1,512,512,512.00,0.00,21488,21489
29106,2,361,151,256.00,11025.00,21488,21490
29107,1,512,512,512.00,0.00,21489,21490
29108,2,382,130,256.00,15876.00,21489,21491
29109,2,290,222,256.00,1156.00,21490,21492
29110,1,512,512,512.00,0.00,21491,21492
29111,3,412,24,170.67,29571.56,21491,21494
29112,1,512,512,512.00,0.00,21493,21494
29113,1,512,512,512.00,0.00,21493,21494
29114,1,512,512,512.00,0.00,21493,21494
29115,1,512,512,512.00,0.00,21493,21494
29116,1,512,512,512.00,0.00,21493,21494
29117,1,512,512,512.00,0.00,21493,21494
29118,1,512,512,512.00,0.00,21493,21494
29119,1,512,512,512.00,0.00,21493,21494
29120,1,512,512,512.00,0.00,21493,21494
29121,2,338,174,256.00,6724.00,21493,21495
29122,1,512,512,512.00,0.00,21494,21495
29123,1,512,512,512.00,0.00,21494,21495
29124,2,374,138,256.00,13924.00,21494,21496
29125,1,512,512,512.00,0.00,21495,21496
29126,4,217,56,128.00,4638.50,21495,21499
29127,5,231,1,102.40,6985.44,21498,21503
29128,1,512,512,512.00,0.00,21502,21503
29129,2,426,86,256.00,28900.00,21502,21504
29130,2,452,60,256.00,38416.00,21503,21505
29131,1,512,512,512.00,0.00,21504,21505
29132,2,287,225,256.00,961.00,21504,21506
29133,4,264,58,128.00,6706.00,21505,21509
29134,2,410,102,256.00,23716.00,21508,21510
29135,2,306,206,256.00,2500.00,21509,21511
29136,1,512,512,512.00,0.00,21510,21511
29137,1,512,512,512.00,0.00,21510,21511
29138,2,377,135,256.00,14641.00,21510,21512
29139,1,512,512,512.00,0.00,21511,21512
29140,1,512,512,512.00,0.00,21511,21512
29141,3,194,128,170.67,912.89,21511,21514
29142,1,512,512,512.00,0.00,21513,21514
29143,1,512,512,512.00,0.00,21513,21514
29144,1,512,512,512.00,0.00,21513,21514
29145,1,512,512,512.00,0.00,21513,21514
29146,1,512,512,512.00,0.00,21513,21514
29147,4,336,1,128.00,16571.50,21513,21517
29148,1,512,512,512.00,0.00,21516,21517
29149,1,512,512,512.00,0.00,21516,21517
29150,2,500,12,256.00,59536.00,21516,21518
29151,1,512,512,512.00,0.00,21517,21518
29152,1,512,512,512.00,0.00,21517,21518
29153,6,183,14,85.33,3669.89,21517,21523
29154,1,512,512,512.00,0.00,21522,21523
29155,1,512,512,512.00,0.00,21522,21523
29156,4,254,1,128.00,14787.50,21522,21526
29157,2,448,64,256.00,36864.00,21525,21527
29158,1,512,512,512.00,0.00,21526,21527
29159,1,512,512,512.00,0.00,21526,21527
29160,2,313,199,256.00,3249.00,21526,21528
29161,1,512,512,512.00,0.00,21527,21528
29162,1,512,512,512.00,0.00,21527,21528
29163,3,361,28,170.67,19617.56,21527,21530
29164,2,338,174,256.00,6724.00,21529,21531
29165,1,512,512,512.00,0.00,21530,21531
29166,10,220,1,51.20,4728.36,21530,21540
29167,1,512,512,512.00,0.00,21539,21540
29168,1,512,512,512.00,0.00,21539,21540
29169,1,512,512,512.00,0.00,21539,21540
29170,3,249,85,170.67,4509.56,21539,21542
29171,2,373,139,256.00,13689.00,21541,21543
29172,1,512,512,512.00,0.00,21542,21543
29173,1,512,512,512.00,0.00,21542,21543
29174,1,512,512,512.00,0.00,21542,21543
29175,4,243,36,128.00,6763.50,21542,21546
29176,1,512,512,512.00,0.00,21545,21546
29177,4,287,1,128.00,16205.00,21545,21549
29178,1,512,512,512.00,0.00,21548,21549
29179,1,512,512,512.00,0.00,21548,21549
29180,2,335,177,256.00,6241.00,21548,21550
29181,4,187,80,128.00,1476.50,21549,21553
29182,1,512,512,512.00,0.00,21552,21553
29183,1,512,512,512.00,0.00,21552,21553
29184,3,266,59,170.67,7274.89,21552,21555
29185,4,309,1,128.00,12699.50,21554,21558
29186,1,512,512,512.00,0.00,21557,21558
29187,4,428,1,128.00,31053.50,21557,21561
29188,1,512,512,512.00,0.00,21560,21561
29189,1,512,512,512.00,0.00,21560,21561
29190,2,465,47,256.00,43681.00,21560,21562
29191,1,512,512,512.00,0.00,21561,21562
29192,1,512,512,512.00,0.00,21561,21562
29193,4,265,63,128.00,6437.00,21561,21565
29194,1,512,512,512.00,0.00,21564,21565
29195,1,512,512,512.00,0.00,21564,21565
29196,1,512,512,512.00,0.00,21564,21565
29197,1,512,512,512.00,0.00,21564,21565
29198,3,440,26,170.67,36336.89,21564,21567
29199,1,512,512,512.00,0.00,21566,21567
29200,1,512,512,512.00,0.00,21566,21567
29201,1,512,512,512.00,0.00,21566,21567
29202,7,194,1,73.14,6022.12,21566,21573
29203,1,512,512,512.00,0.00,21572,21573
29204,1,512,512,512.00,0.00,21572,21573
29205,1,512,512,512.00,0.00,21572,21573
29206,3,381,65,170.67,22120.22,21572,21575
29207,1,512,512,512.00,0.00,21574,21575
29208,5,290,2,102.40,11062.64,21574,21579
29209,1,512,512,512.00,0.00,21578,21579
29210,7,438,2,73.14,22315.55,21578,21585
29211,1,512,512,512.00,0.00,21584,21585
29212,1,512,512,512.00,0.00,21584,21585
29213,1,512,512,512.00,0.00,21584,21585
29214,2,291,221,256.00,1225.00,21584,21586
29215,1,512,512,512.00,0.00,21585,21586
29216,1,512,512,512.00,0.00,21585,21586
29217,1,512,512,512.00,0.00,21585,21586
29218,3,297,2,170.67,15400.22,21585,21588
29219,1,512,512,512.00,0.00,21587,21588
29220,3,314,96,170.67,10278.22,21587,21590
29221,3,346,37,170.67,16781.56,21589,21592
29222,1,512,512,512.00,0.00,21591,21592
29223,1,512,512,512.00,0.00,21591,21592
29224,1,512,512,512.00,0.00,21591,21592
29225,1,512,512,512.00,0.00,21591,21592
29226,2,423,89,256.00,27889.00,21591,21593
29227,1,512,512,512.00,0.00,21592,21593
29228,1,512,512,512.00,0.00,21592,21593
29229,2,401,111,256.00,21025.00,21592,21594
29230,4,174,4,128.00,5158.00,21593,21597
29231,2,510,2,256.00,64516.00,21596,21598
29232,4,454,9,128.00,35501.50,21597,21601
29233,1,512,512,512.00,0.00,21600,21601
29234,1,512,512,512.00,0.00,21600,21601
29235,2,429,83,256.00,29929.00,21600,21602
29236,1,512,512,512.00,0.00,21601,21602
29237,1,512,512,512.00,0.00,21601,21602
29238,1,512,512,512.00,0.00,21601,21602
29239,2,371,141,256.00,13225.00,21601,21603
29240,1,512,512,512.00,0.00,21602,21603
29241,3,307,101,170.67,9294.89,21602,21605
29242,1,512,512,512.00,0.00,21604,21605
29243,2,373,139,256.00,13689.00,21604,21606
29244,1,512,512,512.00,0.00,21605,21606
29245,1,512,512,512.00,0.00,21605,21606
29246,1,512,512,512.00,0.00,21605,21606
29247,2,384,128,256.00,16384.00,21605,21607
29248,1,512,512,512.00,0.00,21606,21607
29249,1,512,512,512.00,0.00,21606,21607
29250,1,512,512,512.00,0.00,21606,21607
29251,1,512,512,512.00,0.00,21606,21607
29252,3,298,40,170.67,11099.56,21606,21609
29253,1,512,512,512.00,0.00,21608,21609
29254,1,512,512,512.00,0.00,21608,21609
29255,3,215,97,170.67,2750.89,21608,21611
29256,2,398,114,256.00,20164.00,21610,21612
29257,5,371,4,102.40,18425.84,21611,21616
29258,4,279,2,128.00,14025.50,21615,21619
29259,1,512,512,512.00,0.00,21618,21619
29260,2,509,3,256.00,64009.00,21618,21620
29261,2,380,132,256.00,15376.00,21619,21621
29262,1,512,512,512.00,0.00,21620,21621
29263,1,512,512,512.00,0.00,21620,21621
29264,2,495,17,256.00,57121.00,21620,21622
29265,1,512,512,512.00,0.00,21621,21622
29266,2,341,171,256.00,7225.00,21621,21623
29267,1,512,512,512.00,0.00,21622,21623
29268,3,295,71,170.67,8666.89,21622,21625
29269,3,471,18,170.67,45104.22,21624,21627
29270,1,512,512,512.00,0.00,21626,21627
29271,1,512,512,512.00,0.00,21626,21627
29272,2,456,56,256.00,40000.00,21626,21628
29273,1,512,512,512.00,0.00,21627,21628
29274,2,261,251,256.00,25.00,21627,21629
29275,2,432,80,256.00,30976.00,21628,21630
29276,1,512,512,512.00,0.00,21629,21630
29277,1,512,512,512.00,0.00,21629,21630
29278,2,307,205,256.00,2601.00,21629,21631
29279,1,512,512,512.00,0.00,21630,21631
29280,1,512,512,512.00,0.00,21630,21631
29281,1,512,512,512.00,0.00,21630,21631
29282,1,512,512,512.00,0.00,21630,21631
29283,1,512,512,512.00,0.00,21630,21631
29284,1,512,512,512.00,0.00,21630,21631
29285,2,485,27,256.00,52441.00,21630,21632
29286,2,286,226,256.00,900.00,21631,21633
29287,1,512,512,512.00,0.00,21632,21633
29288,3,462,18,170.67,42470.22,21632,21635
29289,6,189,3,85.33,4211.89,21634,21640
29290,1,512,512,512.00,0.00,21639,21640
29291,2,444,68,256.00,35344.00,21639,21641
29292,2,290,222,256.00,1156.00,21640,21642
29293,1,512,512,512.00,0.00,21641,21642
29294,1,512,512,512.00,0.00,21641,21642
29295,9,221,2,56.89,5488.10,21641,21650
29296,2,426,86,256.00,28900.00,21649,21651
29297,1,512,512,512.00,0.00,21650,21651
29298,2,269,243,256.00,169.00,21650,21652
29299,1,512,512,512.00,0.00,21651,21652
29300,1,512,512,512.00,0.00,21651,21652
29301,1,512,512,512.00,0.00,21651,21652
29302,1,512,512,512.00,0.00,21651,21652
29303,1,512,512,512.00,0.00,21651,21652
29304,2,312,200,256.00,3136.00,21651,21653
29305,5,285,33,102.40,8698.24,21652,21657
29306,1,512,512,512.00,0.00,21656,21657
29307,1,512,512,512.00,0.00,21656,21657
29308,1,512,512,512.00,0.00,21656,21657
29309,1,512,512,512.00,0.00,21656,21657
29310,1,512,512,512.00,0.00,21656,21657
29311,1,512,512,512.00,0.00,21656,21657
29312,2,303,209,256.00,2209.00,21656,21658
29313,1,512,512,512.00,0.00,21657,21658
29314,1,512,512,512.00,0.00,21657,21658
29315,2,435,77,256.00,32041.00,21657,21659
29316,2,338,174,256.00,6724.00,21658,21660
29317,6,374,2,85.33,17363.89,21659,21665
29318,3,293,69,170.67,8576.22,21664,21667
29319,1,512,512,512.00,0.00,21666,21667
29320,3,318,54,170.67,12086.22,21666,21669
29321,1,512,512,512.00,0.00,21668,21669
29322,1,512,512,512.00,0.00,21668,21669
29323,1,512,512,512.00,0.00,21668,21669
29324,1,512,512,512.00,0.00,21668,21669
29325,1,512,512,512.00,0.00,21668,21669
29326,2,365,147,256.00,11881.00,21668,21670
29327,1,512,512,512.00,0.00,21669,21670
29328,1,512,512,512.00,0.00,21669,21670
29329,4,314,6,128.00,15546.50,21669,21673
29330,1,512,512,512.00,0.00,21672,21673
29331,1,512,512,512.00,0.00,21672,21673
29332,1,512,512,512.00,0.00,21672,21673
29333,1,512,512,512.00,0.00,21672,21673
29334,3,350,7,170.67,19730.89,21672,21675
29335,2,371,141,256.00,13225.00,21674,21676
29336,1,512,512,512.00,0.00,21675,21676
29337,2,403,109,256.00,21609.00,21675,21677
29338,1,512,512,512.00,0.00,21676,21677
29339,2,463,49,256.00,42849.00,21676,21678
29340,1,512,512,512.00,0.00,21677,21678
29341,3,364,43,170.67,19329.56,21677,21680
29342,2,488,24,256.00,53824.00,21679,21681
29343,3,272,13,170.67,12766.89,21680,21683
29344,2,450,62,256.00,37636.00,21682,21684
29345,1,512,512,512.00,0.00,21683,21684
29346,4,301,3,128.00,16284.50,21683,21687
29347,1,512,512,512.00,0.00,21686,21687
29348,2,397,115,256.00,19881.00,21686,21688
29349,1,512,512,512.00,0.00,21687,21688
29350,2,468,44,256.00,44944.00,21687,21689
29351,2,484,28,256.00,51984.00,21688,21690
29352,3,403,48,170.67,27017.56,21689,21692
29353,1,512,512,512.00,0.00,21691,21692
29354,1,512,512,512.00,0.00,21691,21692
29355,2,302,210,256.00,2116.00,21691,21693
29356,2,385,127,256.00,16641.00,21692,21694
29357,1,512,512,512.00,0.00,21693,21694
29358,1,512,512,512.00,0.00,21693,21694
29359,3,273,99,170.67,5516.22,21693,21696
29360,1,512,512,512.00,0.00,21695,21696
29361,2,431,81,256.00,30625.00,21695,21697
29362,2,293,219,256.00,1369.00,21696,21698
29363,1,512,512,512.00,0.00,21697,21698
29364,5,186,12,102.40,5585.04,21697,21702
29365,2,363,149,256.00,11449.00,21701,21703
29366,1,512,512,512.00,0.00,21702,21703
29367,2,298,214,256.00,1764.00,21702,21704
29368,1,512,512,512.00,0.00,21703,21704
29369,1,512,512,512.00,0.00,21703,21704
29370,2,313,199,256.00,3249.00,21703,21705
29371,4,327,1,128.00,14893.00,21704,21708
29372,1,512,512,512.00,0.00,21707,21708
29373,2,495,17,256.00,57121.00,21707,21709
29374,1,512,512,512.00,0.00,21708,21709
29375,1,512,512,512.00,0.00,21708,21709
29376,3,282,11,170.67,13408.22,21708,21711
29377,1,512,512,512.00,0.00,21710,21711
29378,4,401,6,128.00,25528.50,21710,21714
29379,3,295,52,170.67,9857.56,21713,21716
29380,1,512,512,512.00,0.00,21715,21716
29381,1,512,512,512.00,0.00,21715,21716
29382,1,512,512,512.00,0.00,21715,21716
29383,1,512,512,512.00,0.00,21715,21716
29384,1,512,512,512.00,0.00,21715,21716
29385,2,402,110,256.00,21316.00,21715,21717
29386,1,512,512,512.00,0.00,21716,21717
29387,2,506,6,256.00,62500.00,21716,21718
29388,3,254,72,170.67,5638.22,21717,21720
29389,1,512,512,512.00,0.00,21719,21720
29390,1,512,512,512.00,0.00,21719,21720
29391,1,512,512,512.00,0.00,21719,21720
29392,1,512,512,512.00,0.00,21719,21720
29393,2,460,52,256.00,41616.00,21719,21721
29394,2,273,239,256.00,289.00,21720,21722
29395,1,512,512,512.00,0.00,21721,21722
29396,1,512,512,512.00,0.00,21721,21722
29397,3,281,14,170.67,12954.89,21721,21724
29398,1,512,512,512.00,0.00,21723,21724
29399,2,408,104,256.00,23104.00,21723,21725
29400,1,512,512,512.00,0.00,21724,21725
29401,2,344,168,256.00,7744.00,21724,21726
29402,1,512,512,512.00,0.00,21725,21726
29403,1,512,512,512.00,0.00,21725,21726
29404,2,371,141,256.00,13225.00,21725,21727
29405,1,512,512,512.00,0.00,21726,21727
29406,1,512,512,512.00,0.00,21726,21727
29407,1,512,512,512.00,0.00,21726,21727
29408,1,512,512,512.00,0.00,21726,21727
29409,2,291,221,256.00,1225.00,21726,21728
29410,1,512,512,512.00,0.00,21727,21728
29411,1,512,512,512.00,0.00,21727,21728
29412,1,512,512,512.00,0.00,21727,21728
29413,2,436,76,256.00,32400.00,21727,21729
29414,2,484,28,256.00,51984.00,21728,21730
29415,1,512,512,512.00,0.00,21729,21730
29416,1,512,512,512.00,0.00,21729,21730
29417,1,512,512,512.00,0.00,21729,21730
29418,2,338,174,256.00,6724.00,21729,21731
29419,1,512,512,512.00,0.00,21730,21731
29420,1,512,512,512.00,0.00,21730,21731
29421,1,512,512,512.00,0.00,21730,21731
29422,3,373,3,170.67,23417.56,21730,21733
29423,2,319,193,256.00,3969.00,21732,21734
29424,1,512,512,512.00,0.00,21733,21734
29425,1,512,512,512.00,0.00,21733,21734
29426,1,512,512,512.00,0.00,21733,21734
29427,1,512,512,512.00,0.00,21733,21734
29428,2,506,6,256.00,62500.00,21733,21735
29429,3,485,1,170.67,49506.89,21734,21737
29430,1,512,512,512.00,0.00,21736,21737
29431,4,351,17,128.00,18138.50,21736,21740
29432,1,512,512,512.00,0.00,21739,21740
29433,1,512,512,512.00,0.00,21739,21740
29434,1,512,512,512.00,0.00,21739,21740
29435,3,392,4,170.67,26584.89,21739,21742
29436,2,507,5,256.00,63001.00,21741,21743
29437,3,471,3,170.67,45304.22,21742,21745
29438,1,512,512,512.00,0.00,21744,21745
29439,1,512,512,512.00,0.00,21744,21745
29440,3,373,2,170.67,23506.89,21744,21747
29441,1,512,512,512.00,0.00,21746,21747
29442,1,512,512,512.00,0.00,21746,21747
29443,3,302,23,170.67,13106.89,21746,21749
29444,1,512,512,512.00,0.00,21748,21749
29445,5,184,24,102.40,4664.24,21748,21753
29446,4,343,10,128.00,16808.50,21752,21756
29447,1,512,512,512.00,0.00,21755,21756
29448,1,512,512,512.00,0.00,21755,21756
29449,1,512,512,512.00,0.00,21755,21756
29450,5,185,11,102.40,3921.04,21755,21760
29451,1,512,512,512.00,0.00,21759,21760
29452,2,364,148,256.00,11664.00,21759,21761
29453,1,512,512,512.00,0.00,21760,21761
29454,1,512,512,512.00,0.00,21760,21761
29455,2,501,11,256.00,60025.00,21760,21762
29456,2,416,96,256.00,25600.00,21761,21763
29457,1,512,512,512.00,0.00,21762,21763
29458,2,317,195,256.00,3721.00,21762,21764
29459,2,361,151,256.00,11025.00,21763,21765
29460,1,512,512,512.00,0.00,21764,21765
29461,1,512,512,512.00,0.00,21764,21765
29462,4,323,15,128.00,13539.50,21764,21768
29463,3,257,3,170.67,14060.22,21767,21770
29464,1,512,512,512.00,0.00,21769,21770
29465,1,512,512,512.00,0.00,21769,21770
29466,2,385,127,256.00,16641.00,21769,21771
29467,1,512,512,512.00,0.00,21770,21771
29468,1,512,512,512.00,0.00,21770,21771
29469,2,464,48,256.00,43264.00,21770,21772
29470,1,512,512,512.00,0.00,21771,21772
29471,4,296,5,128.00,15007.50,21771,21775
29472,1,512,512,512.00,0.00,21774,21775
29473,2,347,165,256.00,8281.00,21774,21776
29474,1,512,512,512.00,0.00,21775,21776
29475,3,468,13,170.67,44257.56,21775,21778
29476,1,512,512,512.00,0.00,21777,21778
29477,1,512,512,512.00,0.00,21777,21778
29478,1,512,512,512.00,0.00,21777,21778
29479,1,512,512,512.00,0.00,21777,21778
29480,2,416,96,256.00,25600.00,21777,21779
29481,1,512,512,512.00,0.00,21778,21779
29482,1,512,512,512.00,0.00,21778,21779
29483,2,454,58,256.00,39204.00,21778,21780
29484,1,512,512,512.00,0.00,21779,21780
29485,1,512,512,512.00,0.00,21779,21780
29486,2,312,200,256.00,3136.00,21779,21781
29487,3,468,4,170.67,44419.56,21780,21783
29488,1,512,512,512.00,0.00,21782,21783
29489,1,512,512,512.00,0.00,21782,21783
29490,2,373,139,256.00,13689.00,21782,21784
29491,1,512,512,512.00,0.00,21783,21784
29492,1,512,512,512.00,0.00,21783,21784
29493,4,434,7,128.00,31483.50,21783,21787
29494,1,512,512,512.00,0.00,21786,21787
29495,1,512,512,512.00,0.00,21786,21787
29496,4,345,30,128.00,16096.50,21786,21790
29497,3,426,16,170.67,33083.56,21789,21792
29498,3,505,3,170.67,55889.56,21791,21794
29499,2,400,112,256.00,20736.00,21793,21795
29500,1,512,512,512.00,0.00,21794,21795
29501,2,309,203,256.00,2809.00,21794,21796
29502,1,512,512,512.00,0.00,21795,21796
29503,2,448,64,256.00,36864.00,21795,21797
29504,2,302,210,256.00,2116.00,21796,21798
29505,3,339,8,170.67,18276.22,21797,21800
29506,2,310,202,256.00,2916.00,21799,21801
29507,4,165,76,128.00,1346.50,21800,21804
29508,1,512,512,512.00,0.00,21803,21804
29509,1,512,512,512.00,0.00,21803,21804
29510,2,378,134,256.00,14884.00,21803,21805
29511,1,512,512,512.00,0.00,21804,21805
29512,1,512,512,512.00,0.00,21804,21805
29513,1,512,512,512.00,0.00,21804,21805
29514,1,512,512,512.00,0.00,21804,21805
29515,1,512,512,512.00,0.00,21804,21805
29516,1,512,512,512.00,0.00,21804,21805
29517,3,283,75,170.67,7349.56,21804,21807
29518,2,460,52,256.00,41616.00,21806,21808
29519,3,393,23,170.67,25604.22,21807,21810
29520,2,457,55,256.00,40401.00,21809,21811
29521,2,417,95,256.00,25921.00,21810,21812
29522,1,512,512,512.00,0.00,21811,21812
29523,9,346,2,56.89,10669.88,21811,21820
29524,1,512,512,512.00,0.00,21819,21820
29525,1,512,512,512.00,0.00,21819,21820
29526,1,512,512,512.00,0.00,21819,21820
29527,1,512,512,512.00,0.00,21819,21820
29528,1,512,512,512.00,0.00,21819,21820
29529,1,512,512,512.00,0.00,21819,21820
29530,1,512,512,512.00,0.00,21819,21820
29531,1,512,512,512.00,0.00,21819,21820
29532,5,172,2,102.40,3820.24,21819,21824
29533,1,512,512,512.00,0.00,21823,21824
29534,2,278,234,256.00,484.00,21823,21825
29535,1,512,512,512.00,0.00,21824,21825
29536,1,512,512,512.00,0.00,21824,21825
29537,1,512,512,512.00,0.00,21824,21825
29538,2,367,145,256.00,12321.00,21824,21826
29539,2,329,183,256.00,5329.00,21825,21827
29540,1,512,512,512.00,0.00,21826,21827
29541,2,503,9,256.00,61009.00,21826,21828
29542,3,191,139,170.67,514.89,21827,21830
29543,1,512,512,512.00,0.00,21829,21830
29544,2,445,67,256.00,35721.00,21829,21831
29545,3,339,81,170.67,14188.22,21830,21833
29546,1,512,512,512.00,0.00,21832,21833
29547,1,512,512,512.00,0.00,21832,21833
29548,2,366,146,256.00,12100.00,21832,21834
29549,1,512,512,512.00,0.00,21833,21834
29550,1,512,512,512.00,0.00,21833,21834
29551,1,512,512,512.00,0.00,21833,21834
29552,2,290,222,256.00,1156.00,21833,21835
29553,2,417,95,256.00,25921.00,21834,21836
29554,1,512,512,512.00,0.00,21835,21836
29555,2,375,137,256.00,14161.00,21835,21837
29556,1,512,512,512.00,0.00,21836,21837
29557,1,512,512,512.00,0.00,21836,21837
29558,2,453,59,256.00,38809.00,21836,21838
29559,1,512,512,512.00,0.00,21837,21838
29560,1,512,512,512.00,0.00,21837,21838
29561,1,512,512,512.00,0.00,21837,21838
29562,1,512,512,512.00,0.00,21837,21838
29563,2,482,30,256.00,51076.00,21837,21839
29564,1,512,512,512.00,0.00,21838,21839
29565,1,512,512,512.00,0.00,21838,21839
29566,1,512,512,512.00,0.00,21838,21839
29567,2,410,102,256.00,23716.00,21838,21840
29568,1,512,512,512.00,0.00,21839,21840
29569,1,512,512,512.00,0.00,21839,21840
29570,4,231,58,128.00,4049.50,21839,21843
29571,1,512,512,512.00,0.00,21842,21843
29572,1,512,512,512.00,0.00,21842,21843
29573,1,512,512,512.00,0.00,21842,21843
29574,2,415,97,256.00,25281.00,21842,21844
29575,1,512,512,512.00,0.00,21843,21844
29576,1,512,512,512.00,0.00,21843,21844
29577,2,337,175,256.00,6561.00,21843,21845
29578,1,512,512,512.00,0.00,21844,21845
29579,2,298,214,256.00,1764.00,21844,21846
29580,1,512,512,512.00,0.00,21845,21846
29581,5,413,3,102.40,24287.44,21845,21850
29582,3,300,43,170.67,11009.56,21849,21852
29583,1,512,512,512.00,0.00,21851,21852
29584,1,512,512,512.00,0.00,21851,21852
29585,2,364,148,256.00,11664.00,21851,21853
29586,3,246,90,170.67,4070.22,21852,21855
29587,1,512,512,512.00,0.00,21854,21855
29588,1,512,512,512.00,0.00,21854,21855
29589,1,512,512,512.00,0.00,21854,21855
29590,1,512,512,512.00,0.00,21854,21855
29591,2,274,238,256.00,324.00,21854,21856
29592,1,512,512,512.00,0.00,21855,21856
29593,1,512,512,512.00,0.00,21855,21856
29594,3,254,100,170.67,4032.89,21855,21858
29595,2,464,48,256.00,43264.00,21857,21859
29596,1,512,512,512.00,0.00,21858,21859
29597,1,512,512,512.00,0.00,21858,21859
29598,1,512,512,512.00,0.00,21858,21859
29599,1,512,512,512.00,0.00,21858,21859
29600,3,359,74,170.67,17738.89,21858,21861
29601,2,309,203,256.00,2809.00,21860,21862
29602,1,512,512,512.00,0.00,21861,21862
29603,1,512,512,512.00,0.00,21861,21862
29604,2,289,223,256.00,1089.00,21861,21863
29605,1,512,512,512.00,0.00,21862,21863
29606,1,512,512,512.00,0.00,21862,21863
29607,4,213,1,128.00,6259.00,21862,21866
29608,1,512,512,512.00,0.00,21865,21866
29609,2,378,134,256.00,14884.00,21865,21867
29610,1,512,512,512.00,0.00,21866,21867
29611,2,316,196,256.00,3600.00,21866,21868
29612,1,512,512,512.00,0.00,21867,21868
29613,5,166,8,102.40,3402.64,21867,21872
29614,1,512,512,512.00,0.00,21871,21872
29615,1,512,512,512.00,0.00,21871,21872
29616,3,211,96,170.67,2793.56,21871,21874
29617,1,512,512,512.00,0.00,21873,21874
29618,1,512,512,512.00,0.00,21873,21874
29619,1,512,512,512.00,0.00,21873,21874
29620,2,395,117,256.00,19321.00,21873,21875
29621,1,512,512,512.00,0.00,21874,21875
29622,1,512,512,512.00,0.00,21874,21875
29623,3,377,28,170.67,22326.89,21874,21877
29624,1,512,512,512.00,0.00,21876,21877
29625,1,512,512,512.00,0.00,21876,21877
29626,2,361,151,256.00,11025.00,21876,21878
29627,2,377,135,256.00,14641.00,21877,21879
29628,2,340,172,256.00,7056.00,21878,21880
29629,1,512,512,512.00,0.00,21879,21880
29630,1,512,512,512.00,0.00,21879,21880
29631,5,214,8,102.40,7025.84,21879,21884
29632,3,258,64,170.67,6459.56,21883,21886
29633,4,207,5,128.00,6936.50,21885,21889
29634,4,462,1,128.00,37430.50,21888,21892
29635,1,512,512,512.00,0.00,21891,21892
29636,2,361,151,256.00,11025.00,21891,21893
29637,3,368,2,170.67,22736.89,21892,21895
29638,2,508,4,256.00,63504.00,21894,21896
29639,1,512,512,512.00,0.00,21895,21896
29640,1,512,512,512.00,0.00,21895,21896
29641,1,512,512,512.00,0.00,21895,21896
29642,1,512,512,512.00,0.00,21895,21896
29643,1,512,512,512.00,0.00,21895,21896
29644,3,367,48,170.67,19673.56,21895,21898
29645,1,512,512,512.00,0.00,21897,21898
29646,2,427,85,256.00,29241.00,21897,21899
29647,1,512,512,512.00,0.00,21898,21899
29648,2,498,14,256.00,58564.00,21898,21900
29649,3,482,3,170.67,48560.22,21899,21902
29650,1,512,512,512.00,0.00,21901,21902
29651,2,270,242,256.00,196.00,21901,21903
29652,1,512,512,512.00,0.00,21902,21903
29653,1,512,512,512.00,0.00,21902,21903
29654,1,512,512,512.00,0.00,21902,21903
29655,2,385,127,256.00,16641.00,21902,21904
29656,1,512,512,512.00,0.00,21903,21904
29657,2,450,62,256.00,37636.00,21903,21905
29658,1,512,512,512.00,0.00,21904,21905
29659,1,512,512,512.00,0.00,21904,21905
29660,1,512,512,512.00,0.00,21904,21905
29661,2,475,37,256.00,47961.00,21904,21906
29662,2,397,115,256.00,19881.00,21905,21907
29663,1,512,512,512.00,0.00,21906,21907
29664,1,512,512,512.00,0.00,21906,21907
29665,2,510,2,256.00,64516.00,21906,21908
29666,1,512,512,512.00,0.00,21907,21908
29667,2,453,59,256.00,38809.00,21907,21909
29668,1,512,512,512.00,0.00,21908,21909
29669,1,512,512,512.00,0.00,21908,21909
29670,1,512,512,512.00,0.00,21908,21909
29671,2,443,69,256.00,34969.00,21908,21910
29672,3,402,42,170.67,26870.22,21909,21912
29673,5,378,1,102.40,20100.24,21911,21916
29674,2,296,216,256.00,1600.00,21915,21917
29675,1,512,512,512.00,0.00,21916,21917
29676,1,512,512,512.00,0.00,21916,21917
29677,1,512,512,512.00,0.00,21916,21917
29678,1,512,512,512.00,0.00,21916,21917
29679,3,442,12,170.67,37163.56,21916,21919
29680,1,512,512,512.00,0.00,21918,21919
29681,3,406,3,170.67,29357.56,21918,21921
29682,1,512,512,512.00,0.00,21920,21921
29683,2,409,103,256.00,23409.00,21920,21922
29684,1,512,512,512.00,0.00,21921,21922
29685,2,377,135,256.00,14641.00,21921,21923
29686,1,512,512,512.00,0.00,21922,21923
29687,2,476,36,256.00,48400.00,21922,21924
29688,1,512,512,512.00,0.00,21923,21924
29689,1,512,512,512.00,0.00,21923,21924
29690,1,512,512,512.00,0.00,21923,21924
29691,3,282,9,170.67,13688.22,21923,21926
29692,3,445,3,170.67,38249.56,21925,21928
29693,1,512,512,512.00,0.00,21927,21928
29694,1,512,512,512.00,0.00,21927,21928
29695,2,314,198,256.00,3364.00,21927,21929
29696,2,445,67,256.00,35721.00,21928,21930
29697,3,336,56,170.67,14350.22,21929,21932
29698,1,512,512,512.00,0.00,21931,21932
29699,1,512,512,512.00,0.00,21931,21932
29700,1,512,512,512.00,0.00,21931,21932
29701,2,326,186,256.00,4900.00,21931,21933
29702,1,512,512,512.00,0.00,21932,21933
29703,1,512,512,512.00,0.00,21932,21933
29704,1,512,512,512.00,0.00,21932,21933
29705,2,506,6,256.00,62500.00,21932,21934
29706,5,335,5,102.40,14729.44,21933,21938
29707,2,474,38,256.00,47524.00,21937,21939
29708,1,512,512,512.00,0.00,21938,21939
29709,4,244,65,128.00,4827.50,21938,21942
29710,2,493,19,256.00,56169.00,21941,21943
29711,2,437,75,256.00,32761.00,21942,21944
29712,1,512,512,512.00,0.00,21943,21944
29713,1,512,512,512.00,0.00,21943,21944
29714,1,512,512,512.00,0.00,21943,21944
29715,1,512,512,512.00,0.00,21943,21944
29716,5,174,43,102.40,1767.04,21943,21948
29717,3,246,72,170.67,5318.22,21947,21950
29718,1,512,512,512.00,0.00,21949,21950
29719,1,512,512,512.00,0.00,21949,21950
29720,3,236,43,170.67,8150.89,21949,21952
29721,2,380,132,256.00,15376.00,21951,21953
29722,1,512,512,512.00,0.00,21952,21953
29723,1,512,512,512.00,0.00,21952,21953
29724,1,512,512,512.00,0.00,21952,21953
29725,2,426,86,256.00,28900.00,21952,21954
29726,2,357,155,256.00,10201.00,21953,21955
29727,1,512,512,512.00,0.00,21954,21955
29728,8,209,3,64.00,5192.25,21954,21962
29729,3,260,87,170.67,5004.22,21961,21964
29730,2,337,175,256.00,6561.00,21963,21965
29731,1,512,512,512.00,0.00,21964,21965
29732,1,512,512,512.00,0.00,21964,21965
29733,1,512,512,512.00,0.00,21964,21965
29734,2,329,183,256.00,5329.00,21964,21966
29735,1,512,512,512.00,0.00,21965,21966
29736,1,512,512,512.00,0.00,21965,21966
29737,1,512,512,512.00,0.00,21965,21966
29738,1,512,512,512.00,0.00,21965,21966
29739,5,209,7,102.40,5383.84,21965,21970
29740,3,453,8,170.67,40164.22,21969,21972
29741,1,512,512,512.00,0.00,21971,21972
29742,2,406,106,256.00,22500.00,21971,21973
29743,1,512,512,512.00,0.00,21972,21973
29744,1,512,512,512.00,0.00,21972,21973
29745,1,512,512,512.00,0.00,21972,21973
29746,2,289,223,256.00,1089.00,21972,21974
29747,1,512,512,512.00,0.00,21973,21974
29748,1,512,512,512.00,0.00,21973,21974
29749,2,376,136,256.00,14400.00,21973,21975
29750,4,278,37,128.00,8383.50,21974,21978
29751,1,512,512,512.00,0.00,21977,21978
29752,1,512,512,512.00,0.00,21977,21978
29753,2,509,3,256.00,64009.00,21977,21979
29754,1,512,512,512.00,0.00,21978,21979
29755,1,512,512,512.00,0.00,21978,21979
29756,1,512,512,512.00,0.00,21978,21979
29757,1,512,512,512.00,0.00,21978,21979
29758,1,512,512,512.00,0.00,21978,21979
29759,3,239,94,170.67,3538.89,21978,21981
29760,1,512,512,512.00,0.00,21980,21981
29761,1,512,512,512.00,0.00,21980,21981
29762,1,512,512,512.00,0.00,21980,21981
29763,2,381,131,256.00,15625.00,21980,21982
29764,2,454,58,256.00,39204.00,21981,21983
29765,1,512,512,512.00,0.00,21982,21983
29766,2,399,113,256.00,20449.00,21982,21984
29767,3,374,10,170.67,22992.89,21983,21986
29768,2,485,27,256.00,52441.00,21985,21987
29769,1,512,512,512.00,0.00,21986,21987
29770,2,493,19,256.00,56169.00,21986,21988
29771,1,512,512,512.00,0.00,21987,21988
29772,1,512,512,512.00,0.00,21987,21988
29773,1,512,512,512.00,0.00,21987,21988
29774,1,512,512,512.00,0.00,21987,21988
29775,3,270,35,170.67,9864.22,21987,21990
29776,2,308,204,256.00,2704.00,21989,21991
29777,3,340,78,170.67,14379.56,21990,21993
29778,1,512,512,512.00,0.00,21992,21993
29779,1,512,512,512.00,0.00,21992,21993
29780,1,512,512,512.00,0.00,21992,21993
29781,1,512,512,512.00,0.00,21992,21993
29782,1,512,512,512.00,0.00,21992,21993
29783,2,334,178,256.00,6084.00,21992,21994
29784,1,512,512,512.00,0.00,21993,21994
29785,1,512,512,512.00,0.00,21993,21994
29786,1,512,512,512.00,0.00,21993,21994
29787,1,512,512,512.00,0.00,21993,21994
29788,2,442,70,256.00,34596.00,21993,21995
29789,1,512,512,512.00,0.00,21994,21995
29790,1,512,512,512.00,0.00,21994,21995
29791,1,512,512,512.00,0.00,21994,21995
29792,1,512,512,512.00,0.00,21994,21995
29793,1,512,512,512.00,0.00,21994,21995
29794,1,512,512,512.00,0.00,21994,21995
29795,1,512,512,512.00,0.00,21994,21995
29796,2,493,19,256.00,56169.00,21994,21996
29797,3,359,5,170.67,21142.89,21995,21998
29798,1,512,512,512.00,0.00,21997,21998
29799,3,337,35,170.67,15670.89,21997,22000
29800,1,512,512,512.00,0.00,21999,22000
29801,1,512,512,512.00,0.00,21999,22000
29802,2,329,183,256.00,5329.00,21999,22001
29803,10,205,1,51.20,4269.16,22000,22010
29804,1,512,512,512.00,0.00,22009,22010
29805,2,481,31,256.00,50625.00,22009,22011
29806,2,485,27,256.00,52441.00,22010,22012
29807,1,512,512,512.00,0.00,22011,22012
29808,1,512,512,512.00,0.00,22011,22012
29809,1,512,512,512.00,0.00,22011,22012
29810,1,512,512,512.00,0.00,22011,22012
29811,2,324,188,256.00,4624.00,22011,22013
29812,2,323,189,256.00,4489.00,22012,22014
29813,1,512,512,512.00,0.00,22013,22014
29814,1,512,512,512.00,0.00,22013,22014
29815,1,512,512,512.00,0.00,22013,22014
29816,1,512,512,512.00,0.00,22013,22014
29817,1,512,512,512.00,0.00,22013,22014
29818,2,504,8,256.00,61504.00,22013,22015
29819,1,512,512,512.00,0.00,22014,22015
29820,3,415,25,170.67,30217.56,22014,22017
29821,1,512,512,512.00,0.00,22016,22017
29822,1,512,512,512.00,0.00,22016,22017
29823,2,398,114,256.00,20164.00,22016,22018
29824,1,512,512,512.00,0.00,22017,22018
29825,1,512,512,512.00,0.00,22017,22018
29826,1,512,512,512.00,0.00,22017,22018
29827,1,512,512,512.00,0.00,22017,22018
29828,3,310,1,170.67,16373.56,22017,22020
29829,2,266,246,256.00,100.00,22019,22021
29830,2,276,236,256.00,400.00,22020,22022
29831,1,512,512,512.00,0.00,22021,22022
29832,2,477,35,256.00,48841.00,22021,22023
29833,1,512,512,512.00,0.00,22022,22023
29834,1,512,512,512.00,0.00,22022,22023
29835,1,512,512,512.00,0.00,22022,22023
29836,1,512,512,512.00,0.00,22022,22023
29837,5,363,3,102.40,17532.64,22022,22027
29838,1,512,512,512.00,0.00,22026,22027
29839,1,512,512,512.00,0.00,22026,22027
29840,1,512,512,512.00,0.00,22026,22027
29841,5,413,1,102.40,24779.04,22026,22031
29842,1,512,512,512.00,0.00,22030,22031
29843,3,249,50,170.67,7496.22,22030,22033
29844,2,370,142,256.00,12996.00,22032,22034
29845,1,512,512,512.00,0.00,22033,22034
29846,1,512,512,512.00,0.00,22033,22034
29847,1,512,512,512.00,0.00,22033,22034
29848,3,263,106,170.67,4490.89,22033,22036
29849,1,512,512,512.00,0.00,22035,22036
29850,2,359,153,256.00,10609.00,22035,22037
29851,1,512,512,512.00,0.00,22036,22037
29852,2,277,235,256.00,441.00,22036,22038
29853,1,512,512,512.00,0.00,22037,22038
29854,1,512,512,512.00,0.00,22037,22038
29855,2,443,69,256.00,34969.00,22037,22039
29856,1,512,512,512.00,0.00,22038,22039
29857,1,512,512,512.00,0.00,22038,22039
29858,1,512,512,512.00,0.00,22038,22039
29859,2,355,157,256.00,9801.00,22038,22040
29860,1,512,512,512.00,0.00,22039,22040
29861,1,512,512,512.00,0.00,22039,22040
29862,1,512,512,512.00,0.00,22039,22040
29863,3,449,1,170.67,39354.89,22039,22042
29864,3,261,6,170.67,13600.22,22041,22044
29865,1,512,512,512.00,0.00,22043,22044
29866,1,512,512,512.00,0.00,22043,22044
29867,1,512,512,512.00,0.00,22043,22044
29868,2,286,226,256.00,900.00,22043,22045
29869,2,396,116,256.00,19600.00,22044,22046
29870,3,494,9,170.67,52272.22,22045,22048
29871,2,327,185,256.00,5041.00,22047,22049
29872,2,292,220,256.00,1296.00,22048,22050
29873,1,512,512,512.00,0.00,22049,22050
29874,2,269,243,256.00,169.00,22049,22051
29875,1,512,512,512.00,0.00,22050,22051
29876,1,512,512,512.00,0.00,22050,22051
29877,1,512,512,512.00,0.00,22050,22051
29878,2,429,83,256.00,29929.00,22050,22052
29879,1,512,512,512.00,0.00,22051,22052
29880,1,512,512,512.00,0.00,22051,22052
29881,1,512,512,512.00,0.00,22051,22052
29882,1,512,512,512.00,0.00,22051,22052
29883,2,264,248,256.00,64.00,22051,22053
29884,1,512,512,512.00,0.00,22052,22053
29885,1,512,512,512.00,0.00,22052,22053
29886,2,292,220,256.00,1296.00,22052,22054
29887,1,512,512,512.00,0.00,22053,22054
29888,1,512,512,512.00,0.00,22053,22054
29889,3,453,13,170.67,40037.56,22053,22056
29890,1,512,512,512.00,0.00,22055,22056
29891,1,512,512,512.00,0.00,22055,22056
29892,1,512,512,512.00,0.00,22055,22056
29893,2,489,23,256.00,54289.00,22055,22057
29894,1,512,512,512.00,0.00,22056,22057
29895,1,512,512,512.00,0.00,22056,22057
29896,2,427,85,256.00,29241.00,22056,22058
29897,4,236,39,128.00,7021.50,22057,22061
29898,1,512,512,512.00,0.00,22060,22061
29899,1,512,512,512.00,0.00,22060,22061
29900,2,355,157,256.00,9801.00,22060,22062
29901,1,512,512,512.00,0.00,22061,22062
29902,1,512,512,512.00,0.00,22061,22062
29903,2,411,101,256.00,24025.00,22061,22063
29904,1,512,512,512.00,0.00,22062,22063
29905,3,362,29,170.67,19714.89,22062,22065
29906,2,431,81,256.00,30625.00,22064,22066
29907,1,512,512,512.00,0.00,22065,22066
29908,4,363,3,128.00,21469.50,22065,22069
29909,1,512,512,512.00,0.00,22068,22069
29910,4,258,8,128.00,12938.00,22068,22072
29911,4,388,11,128.00,23508.50,22071,22075
29912,1,512,512,512.00,0.00,22074,22075
29913,1,512,512,512.00,0.00,22074,22075
29914,1,512,512,512.00,0.00,22074,22075
29915,1,512,512,512.00,0.00,22074,22075
29916,1,512,512,512.00,0.00,22074,22075
29917,2,275,237,256.00,361.00,22074,22076
29918,1,512,512,512.00,0.00,22075,22076
29919,1,512,512,512.00,0.00,22075,22076
29920,2,434,78,256.00,31684.00,22075,22077
29921,1,512,512,512.00,0.00,22076,22077
29922,1,512,512,512.00,0.00,22076,22077
29923,1,512,512,512.00,0.00,22076,22077
29924,3,277,98,170.67,5906.89,22076,22079
29925,1,512,512,512.00,0.00,22078,22079
29926,3,212,112,170.67,1816.89,22078,22081
29927,3,469,5,170.67,44682.89,22080,22083
29928,1,512,512,512.00,0.00,22082,22083
29929,1,512,512,512.00,0.00,22082,22083
29930,1,512,512,512.00,0.00,22082,22083
29931,1,512,512,512.00,0.00,22082,22083
29932,1,512,512,512.00,0.00,22082,22083
29933,3,394,40,170.67,25179.56,22082,22085
29934,1,512,512,512.00,0.00,22084,22085
29935,3,306,34,170.67,12331.56,22084,22087
29936,1,512,512,512.00,0.00,22086,22087
29937,5,276,13,102.40,8183.44,22086,22091
29938,4,326,3,128.00,15319.50,22090,22094
29939,1,512,512,512.00,0.00,22093,22094
29940,1,512,512,512.00,0.00,22093,22094
29941,3,492,1,170.67,51681.56,22093,22096
29942,1,512,512,512.00,0.00,22095,22096
29943,2,508,4,256.00,63504.00,22095,22097
29944,1,512,512,512.00,0.00,22096,22097
29945,1,512,512,512.00,0.00,22096,22097
29946,2,358,154,256.00,10404.00,22096,22098
29947,3,255,89,170.67,4596.22,22097,22100
29948,3,244,127,170.67,2721.56,22099,22102
29949,1,512,512,512.00,0.00,22101,22102
29950,1,512,512,512.00,0.00,22101,22102
29951,2,474,38,256.00,47524.00,22101,22103
29952,1,512,512,512.00,0.00,22102,22103
29953,2,349,163,256.00,8649.00,22102,22104
29954,1,512,512,512.00,0.00,22103,22104
29955,1,512,512,512.00,0.00,22103,22104
29956,1,512,512,512.00,0.00,22103,22104
29957,1,512,512,512.00,0.00,22103,22104
29958,2,349,163,256.00,8649.00,22103,22105
29959,1,512,512,512.00,0.00,22104,22105
29960,1,512,512,512.00,0.00,22104,22105
29961,3,280,4,170.67,14339.56,22104,22107
29962,1,512,512,512.00,0.00,22106,22107
29963,2,404,108,256.00,21904.00,22106,22108
29964,1,512,512,512.00,0.00,22107,22108
29965,1,512,512,512.00,0.00,22107,22108
29966,2,347,165,256.00,8281.00,22107,22109
29967,5,305,1,102.40,12363.04,22108,22113
29968,1,512,512,512.00,0.00,22112,22113
29969,2,359,153,256.00,10609.00,22112,22114
29970,1,512,512,512.00,0.00,22113,22114
29971,3,231,51,170.67,7160.22,22113,22116
29972,1,512,512,512.00,0.00,22115,22116
29973,1,512,512,512.00,0.00,22115,22116
29974,2,355,157,256.00,9801.00,22115,22117
29975,1,512,512,512.00,0.00,22116,22117
29976,1,512,512,512.00,0.00,22116,22117
29977,1,512,512,512.00,0.00,22116,22117
29978,1,512,512,512.00,0.00,22116,22117
29979,4,243,1,128.00,7397.00,22116,22120
29980,2,457,55,256.00,40401.00,22119,22121
29981,1,512,512,512.00,0.00,22120,22121
29982,1,512,512,512.00,0.00,22120,22121
29983,1,512,512,512.00,0.00,22120,22121
29984,2,435,77,256.00,32041.00,22120,22122
29985,1,512,512,512.00,0.00,22121,22122
29986,1,512,512,512.00,0.00,22121,22122
29987,3,207,121,170.67,1321.56,22121,22124
29988,1,512,512,512.00,0.00,22123,22124
29989,1,512,512,512.00,0.00,22123,22124
29990,4,234,3,128.00,10946.50,22123,22127
29991,1,512,512,512.00,0.00,22126,22127
29992,1,512,512,512.00,0.00,22126,22127
29993,3,203,150,170.67,536.22,22126,22129
29994,4,439,3,128.00,32653.00,22128,22132
29995,2,443,69,256.00,34969.00,22131,22133
29996,3,361,2,170.67,21714.89,22132,22135
29997,3,236,137,170.67,2134.89,22134,22137
29998,3,331,61,170.67,13433.56,22136,22139
29999,1,512,512,512.00,0.00,22138,22139
30000,1,512,512,512.00,0.00,22138,22139
30001,2,416,96,256.00,25600.00,22138,22140
30002,3,334,87,170.67,13341.56,22139,22142
30003,1,512,512,512.00,0.00,22141,22142
30004,2,387,125,256.00,17161.00,22141,22143
30005,1,512,512,512.00,0.00,22142,22143
30006,1,512,512,512.00,0.00,22142,22143
30007,5,274,1,102.40,8949.04,22142,22147
30008,2,439,73,256.00,33489.00,22146,22148
30009,1,512,512,512.00,0.00,22147,22148
30010,1,512,512,512.00,0.00,22147,22148
30011,1,512,512,512.00,0.00,22147,22148
30012,3,441,16,170.67,36793.56,22147,22150
30013,3,471,15,170.67,45120.22,22149,22152
30014,1,512,512,512.00,0.00,22151,22152
30015,1,512,512,512.00,0.00,22151,22152
30016,2,447,65,256.00,36481.00,22151,22153
30017,1,512,512,512.00,0.00,22152,22153
30018,1,512,512,512.00,0.00,22152,22153
30019,2,323,189,256.00,4489.00,22152,22154
30020,2,495,17,256.00,57121.00,22153,22155
30021,8,385,1,64.00,15137.25,22154,22162
30022,1,512,512,512.00,0.00,22161,22162
30023,4,274,3,128.00,12065.50,22161,22165
30024,2,506,6,256.00,62500.00,22164,22166
30025,1,512,512,512.00,0.00,22165,22166
30026,2,497,15,256.00,58081.00,22165,22167
30027,1,512,512,512.00,0.00,22166,22167
30028,1,512,512,512.00,0.00,22166,22167
30029,1,512,512,512.00,0.00,22166,22167
30030,1,512,512,512.00,0.00,22166,22167
30031,1,512,512,512.00,0.00,22166,22167
30032,1,512,512,512.00,0.00,22166,22167
30033,1,512,512,512.00,0.00,22166,22167
30034,1,512,512,512.00,0.00,22166,22167
30035,3,453,1,170.67,40397.56,22166,22169
30036,1,512,512,512.00,0.00,22168,22169
30037,1,512,512,512.00,0.00,22168,22169
30038,1,512,512,512.00,0.00,22168,22169
30039,1,512,512,512.00,0.00,22168,22169
30040,1,512,512,512.00,0.00,22168,22169
30041,4,316,2,128.00,16250.00,22168,22172
30042,2,369,143,256.00,12769.00,22171,22173
30043,5,325,1,102.40,14940.64,22172,22177
30044,3,435,3,170.67,35776.22,22176,22179
30045,1,512,512,512.00,0.00,22178,22179
30046,1,512,512,512.00,0.00,22178,22179
30047,1,512,512,512.00,0.00,22178,22179
30048,1,512,512,512.00,0.00,22178,22179
30049,2,458,54,256.00,40804.00,22178,22180
30050,2,354,158,256.00,9604.00,22179,22181
30051,3,247,22,170.67,11053.56,22180,22183
30052,4,274,2,128.00,9380.00,22182,22186
30053,1,512,512,512.00,0.00,22185,22186
30054,1,512,512,512.00,0.00,22185,22186
30055,1,512,512,512.00,0.00,22185,22186
30056,1,512,512,512.00,0.00,22185,22186
30057,1,512,512,512.00,0.00,22185,22186
30058,4,229,31,128.00,8776.50,22185,22189
30059,1,512,512,512.00,0.00,22188,22189
30060,1,512,512,512.00,0.00,22188,22189
30061,1,512,512,512.00,0.00,22188,22189
30062,1,512,512,512.00,0.00,22188,22189
30063,1,512,512,512.00,0.00,22188,22189
30064,1,512,512,512.00,0.00,22188,22189
30065,1,512,512,512.00,0.00,22188,22189
30066,2,320,192,256.00,4096.00,22188,22190
30067,6,301,1,85.33,11877.56,22189,22195
30068,1,512,512,512.00,0.00,22194,22195
30069,3,263,108,170.67,4444.22,22194,22197
30070,1,512,512,512.00,0.00,22196,22197
30071,1,512,512,512.00,0.00,22196,22197
30072,1,512,512,512.00,0.00,22196,22197
30073,4,293,5,128.00,13401.00,22196,22200
30074,2,422,90,256.00,27556.00,22199,22201
30075,3,278,108,170.67,5814.22,22200,22203
30076,1,512,512,512.00,0.00,22202,22203
30077,4,391,15,128.00,23425.00,22202,22206
30078,4,286,40,128.00,9181.50,22205,22209
30079,1,512,512,512.00,0.00,22208,22209
30080,9,307,3,56.89,8428.99,22208,22217
30081,1,512,512,512.00,0.00,22216,22217
30082,1,512,512,512.00,0.00,22216,22217
30083,1,512,512,512.00,0.00,22216,22217
30084,2,261,251,256.00,25.00,22216,22218
30085,4,273,35,128.00,7797.00,22217,22221
30086,3,262,2,170.67,14256.89,22220,22223
30087,1,512,512,512.00,0.00,22222,22223
30088,1,512,512,512.00,0.00,22222,22223
30089,1,512,512,512.00,0.00,22222,22223
30090,1,512,512,512.00,0.00,22222,22223
30091,2,363,149,256.00,11449.00,22222,22224
30092,4,240,7,128.00,7059.50,22223,22227
30093,6,355,2,85.33,15035.56,22226,22232
30094,2,353,159,256.00,9409.00,22231,22233
30095,1,512,512,512.00,0.00,22232,22233
30096,1,512,512,512.00,0.00,22232,22233
30097,3,437,27,170.67,35540.22,22232,22235
30098,3,399,49,170.67,26105.56,22234,22237
30099,1,512,512,512.00,0.00,22236,22237
30100,1,512,512,512.00,0.00,22236,22237
30101,1,512,512,512.00,0.00,22236,22237
30102,1,512,512,512.00,0.00,22236,22237
30103,2,333,179,256.00,5929.00,22236,22238
30104,1,512,512,512.00,0.00,22237,22238
30105,2,446,66,256.00,36100.00,22237,22239
30106,1,512,512,512.00,0.00,22238,22239
30107,1,512,512,512.00,0.00,22238,22239
30108,1,512,512,512.00,0.00,22238,22239
30109,1,512,512,512.00,0.00,22238,22239
30110,1,512,512,512.00,0.00,22238,22239
30111,2,327,185,256.00,5041.00,22238,22240
30112,1,512,512,512.00,0.00,22239,22240
30113,1,512,512,512.00,0.00,22239,22240
30114,1,512,512,512.00,0.00,22239,22240
30115,1,512,512,512.00,0.00,22239,22240
30116,1,512,512,512.00,0.00,22239,22240
30117,1,512,512,512.00,0.00,22239,22240
30118,1,512,512,512.00,0.00,22239,22240
30119,5,272,2,102.40,12909.84,22239,22244
30120,2,473,39,256.00,47089.00,22243,22245
30121,1,512,512,512.00,0.00,22244,22245
30122,3,399,1,170.67,28121.56,22244,22247
30123,1,512,512,512.00,0.00,22246,22247
30124,5,226,7,102.40,4957.84,22246,22251
30125,4,362,3,128.00,21495.50,22250,22254
30126,1,512,512,512.00,0.00,22253,22254
30127,1,512,512,512.00,0.00,22253,22254
30128,2,265,247,256.00,81.00,22253,22255
30129,1,512,512,512.00,0.00,22254,22255
30130,1,512,512,512.00,0.00,22254,22255
30131,1,512,512,512.00,0.00,22254,22255
30132,1,512,512,512.00,0.00,22254,22255
30133,3,348,53,170.67,16284.22,22254,22257
30134,2,442,70,256.00,34596.00,22256,22258
30135,1,512,512,512.00,0.00,22257,22258
30136,1,512,512,512.00,0.00,22257,22258
30137,1,512,512,512.00,0.00,22257,22258
30138,1,512,512,512.00,0.00,22257,22258
30139,1,512,512,512.00,0.00,22257,22258
30140,2,320,192,256.00,4096.00,22257,22259
30141,1,512,512,512.00,0.00,22258,22259
30142,2,337,175,256.00,6561.00,22258,22260
30143,2,348,164,256.00,8464.00,22259,22261
30144,1,512,512,512.00,0.00,22260,22261
30145,1,512,512,512.00,0.00,22260,22261
30146,1,512,512,512.00,0.00,22260,22261
30147,1,512,512,512.00,0.00,22260,22261
30148,1,512,512,512.00,0.00,22260,22261
30149,2,292,220,256.00,1296.00,22260,22262
30150,2,359,153,256.00,10609.00,22261,22263
30151,1,512,512,512.00,0.00,22262,22263
30152,2,284,228,256.00,784.00,22262,22264
30153,2,429,83,256.00,29929.00,22263,22265
30154,1,512,512,512.00,0.00,22264,22265
30155,3,309,17,170.67,14328.22,22264,22267
30156,1,512,512,512.00,0.00,22266,22267
30157,1,512,512,512.00,0.00,22266,22267
30158,2,421,91,256.00,27225.00,22266,22268
30159,2,430,82,256.00,30276.00,22267,22269
30160,1,512,512,512.00,0.00,22268,22269
30161,2,465,47,256.00,43681.00,22268,22270
30162,3,438,1,170.67,36597.56,22269,22272
30163,1,512,512,512.00,0.00,22271,22272
30164,1,512,512,512.00,0.00,22271,22272
30165,3,286,21,170.67,12293.56,22271,22274
30166,1,512,512,512.00,0.00,22273,22274
30167,3,377,29,170.67,22274.89,22273,22276
30168,1,512,512,512.00,0.00,22275,22276
30169,1,512,512,512.00,0.00,22275,22276
30170,1,512,512,512.00,0.00,22275,22276
30171,1,512,512,512.00,0.00,22275,22276
30172,4,260,5,128.00,13504.50,22275,22279
30173,1,512,512,512.00,0.00,22278,22279
30174,1,512,512,512.00,0.00,22278,22279
30175,3,476,15,170.67,46620.22,22278,22281
30176,1,512,512,512.00,0.00,22280,22281
30177,1,512,512,512.00,0.00,22280,22281
30178,2,303,209,256.00,2209.00,22280,22282
30179,2,457,55,256.00,40401.00,22281,22283
30180,1,512,512,512.00,0.00,22282,22283
30181,1,512,512,512.00,0.00,22282,22283
30182,1,512,512,512.00,0.00,22282,22283
30183,2,277,235,256.00,441.00,22282,22284
30184,2,321,191,256.00,4225.00,22283,22285
30185,1,512,512,512.00,0.00,22284,22285
30186,1,512,512,512.00,0.00,22284,22285
30187,1,512,512,512.00,0.00,22284,22285
30188,2,338,174,256.00,6724.00,22284,22286
30189,1,512,512,512.00,0.00,22285,22286
30190,3,257,47,170.67,8046.89,22285,22288
30191,1,512,512,512.00,0.00,22287,22288
30192,1,512,512,512.00,0.00,22287,22288
30193,1,512,512,512.00,0.00,22287,22288
30194,2,503,9,256.00,61009.00,22287,22289
30195,1,512,512,512.00,0.00,22288,22289
30196,2,269,243,256.00,169.00,22288,22290
30197,2,420,92,256.00,26896.00,22289,22291
30198,1,512,512,512.00,0.00,22290,22291
30199,1,512,512,512.00,0.00,22290,22291
30200,2,329,183,256.00,5329.00,22290,22292
30201,1,512,512,512.00,0.00,22291,22292
30202,2,362,150,256.00,11236.00,22291,22293
30203,1,512,512,512.00,0.00,22292,22293
30204,3,486,11,170.67,49720.22,22292,22295
30205,3,387,3,170.67,25760.22,22294,22297
30206,2,295,217,256.00,1521.00,22296,22298
30207,2,378,134,256.00,14884.00,22297,22299
30208,1,512,512,512.00,0.00,22298,22299
30209,1,512,512,512.00,0.00,22298,22299
30210,1,512,512,512.00,0.00,22298,22299
30211,2,410,102,256.00,23716.00,22298,22300
30212,1,512,512,512.00,0.00,22299,22300
30213,2,502,10,256.00,60516.00,22299,22301
30214,1,512,512,512.00,0.00,22300,22301
30215,3,396,45,170.67,25500.22,22300,22303
30216,1,512,512,512.00,0.00,22302,22303
30217,1,512,512,512.00,0.00,22302,22303
30218,4,327,3,128.00,14653.00,22302,22306
30219,3,353,7,170.67,20126.89,22305,22308
30220,4,293,2,128.00,11826.50,22307,22311
30221,1,512,512,512.00,0.00,22310,22311
30222,1,512,512,512.00,0.00,22310,22311
30223,2,474,38,256.00,47524.00,22310,22312
30224,3,302,46,170.67,10944.89,22311,22314
30225,1,512,512,512.00,0.00,22313,22314
30226,1,512,512,512.00,0.00,22313,22314
30227,1,512,512,512.00,0.00,22313,22314
30228,4,456,8,128.00,36032.00,22313,22317
30229,4,239,1,128.00,7866.50,22316,22320
30230,5,247,25,102.40,8691.04,22319,22324
30231,2,265,247,256.00,81.00,22323,22325
30232,3,376,1,170.67,24073.56,22324,22327
30233,4,407,5,128.00,26356.50,22326,22330
30234,1,512,512,512.00,0.00,22329,22330
30235,1,512,512,512.00,0.00,22329,22330
30236,1,512,512,512.00,0.00,22329,22330
30237,6,311,4,85.33,11712.89,22329,22335
30238,2,476,36,256.00,48400.00,22334,22336
30239,1,512,512,512.00,0.00,22335,22336
30240,2,428,84,256.00,29584.00,22335,22337
30241,1,512,512,512.00,0.00,22336,22337
30242,1,512,512,512.00,0.00,22336,22337
30243,1,512,512,512.00,0.00,22336,22337
30244,7,313,2,73.14,11590.69,22336,22343
30245,2,303,209,256.00,2209.00,22342,22344
30246,4,282,3,128.00,14693.50,22343,22347
30247,4,358,1,128.00,20861.50,22346,22350
30248,1,512,512,512.00,0.00,22349,22350
30249,1,512,512,512.00,0.00,22349,22350
30250,5,215,9,102.40,6245.84,22349,22354
30251,3,309,10,170.67,15149.56,22353,22356
30252,1,512,512,512.00,0.00,22355,22356
30253,1,512,512,512.00,0.00,22355,22356
30254,3,278,3,170.67,14424.22,22355,22358
30255,2,265,247,256.00,81.00,22357,22359
30256,1,512,512,512.00,0.00,22358,22359
30257,2,378,134,256.00,14884.00,22358,22360
30258,1,512,512,512.00,0.00,22359,22360
30259,1,512,512,512.00,0.00,22359,22360
30260,1,512,512,512.00,0.00,22359,22360
30261,1,512,512,512.00,0.00,22359,22360
30262,1,512,512,512.00,0.00,22359,22360
30263,1,512,512,512.00,0.00,22359,22360
30264,1,512,512,512.00,0.00,22359,22360
30265,3,236,101,170.67,3046.89,22359,22362
30266,1,512,512,512.00,0.00,22361,22362
30267,2,416,96,256.00,25600.00,22361,22363
30268,2,369,143,256.00,12769.00,22362,22364
30269,2,359,153,256.00,10609.00,22363,22365
30270,1,512,512,512.00,0.00,22364,22365
30271,1,512,512,512.00,0.00,22364,22365
30272,2,429,83,256.00,29929.00,22364,22366
30273,2,276,236,256.00,400.00,22365,22367
30274,1,512,512,512.00,0.00,22366,22367
30275,1,512,512,512.00,0.00,22366,22367
30276,3,360,1,170.67,21673.56,22366,22369
30277,3,352,61,170.67,16681.56,22368,22371
30278,1,512,512,512.00,0.00,22370,22371
30279,2,372,140,256.00,13456.00,22370,22372
30280,4,407,4,128.00,26307.50,22371,22375
30281,2,360,152,256.00,10816.00,22374,22376
30282,1,512,512,512.00,0.00,22375,22376
30283,1,512,512,512.00,0.00,22375,22376
30284,1,512,512,512.00,0.00,22375,22376
30285,1,512,512,512.00,0.00,22375,22376
30286,5,252,7,102.40,6566.64,22375,22380
30287,4,397,3,128.00,24596.50,22379,22383
30288,1,512,512,512.00,0.00,22382,22383
30289,2,417,95,256.00,25921.00,22382,22384
30290,1,512,512,512.00,0.00,22383,22384
30291,2,279,233,256.00,529.00,22383,22385
30292,2,390,122,256.00,17956.00,22384,22386
30293,5,270,1,102.40,8269.84,22385,22390
30294,2,440,72,256.00,33856.00,22389,22391
30295,1,512,512,512.00,0.00,22390,22391
30296,2,468,44,256.00,44944.00,22390,22392
30297,1,512,512,512.00,0.00,22391,22392
30298,1,512,512,512.00,0.00,22391,22392
30299,3,247,25,170.67,10617.56,22391,22394
30300,2,354,158,256.00,9604.00,22393,22395
30301,2,501,11,256.00,60025.00,22394,22396
30302,1,512,512,512.00,0.00,22395,22396
30303,1,512,512,512.00,0.00,22395,22396
30304,1,512,512,512.00,0.00,22395,22396
30305,1,512,512,512.00,0.00,22395,22396
30306,5,280,6,102.40,9909.44,22395,22400
30307,4,180,83,128.00,1818.50,22399,22403
30308,1,512,512,512.00,0.00,22402,22403
30309,1,512,512,512.00,0.00,22402,22403
30310,1,512,512,512.00,0.00,22402,22403
30311,3,400,21,170.67,27113.56,22402,22405
30312,1,512,512,512.00,0.00,22404,22405
30313,4,226,14,128.00,8132.00,22404,22408
30314,1,512,512,512.00,0.00,22407,22408
30315,1,512,512,512.00,0.00,22407,22408
30316,1,512,512,512.00,0.00,22407,22408
30317,2,300,212,256.00,1936.00,22407,22409
30318,3,228,140,170.67,1646.22,22408,22411
30319,1,512,512,512.00,0.00,22410,22411
30320,1,512,512,512.00,0.00,22410,22411
30321,1,512,512,512.00,0.00,22410,22411
30322,1,512,512,512.00,0.00,22410,22411
30323,2,392,120,256.00,18496.00,22410,22412
30324,1,512,512,512.00,0.00,22411,22412
30325,2,470,42,256.00,45796.00,22411,22413
30326,1,512,512,512.00,0.00,22412,22413
30327,1,512,512,512.00,0.00,22412,22413
30328,2,466,46,256.00,44100.00,22412,22414
30329,1,512,512,512.00,0.00,22413,22414
30330,1,512,512,512.00,0.00,22413,22414
30331,2,372,140,256.00,13456.00,22413,22415
30332,1,512,512,512.00,0.00,22414,22415
30333,1,512,512,512.00,0.00,22414,22415
30334,1,512,512,512.00,0.00,22414,22415
30335,1,512,512,512.00,0.00,22414,22415
30336,2,345,167,256.00,7921.00,22414,22416
30337,3,283,97,170.67,6513.56,22415,22418
30338,2,378,134,256.00,14884.00,22417,22419
30339,1,512,512,512.00,0.00,22418,22419
30340,1,512,512,512.00,0.00,22418,22419
30341,3,447,3,170.67,38760.22,22418,22421
30342,2,436,76,256.00,32400.00,22420,22422
30343,1,512,512,512.00,0.00,22421,22422
30344,1,512,512,512.00,0.00,22421,22422
30345,2,267,245,256.00,121.00,22421,22423
30346,1,512,512,512.00,0.00,22422,22423
30347,4,351,24,128.00,16984.50,22422,22426
30348,2,310,202,256.00,2916.00,22425,22427
30349,1,512,512,512.00,0.00,22426,22427
30350,1,512,512,512.00,0.00,22426,22427
30351,1,512,512,512.00,0.00,22426,22427
30352,2,446,66,256.00,36100.00,22426,22428
30353,1,512,512,512.00,0.00,22427,22428
30354,2,328,184,256.00,5184.00,22427,22429
30355,2,449,63,256.00,37249.00,22428,22430
30356,1,512,512,512.00,0.00,22429,22430
30357,3,344,62,170.67,15344.89,22429,22432
30358,2,369,143,256.00,12769.00,22431,22433
30359,1,512,512,512.00,0.00,22433,22434
30360,3,310,70,170.67,10347.56,22433,22436
30361,2,280,232,256.00,576.00,22435,22437
30362,3,256,104,170.67,4024.89,22436,22439
30363,1,512,512,512.00,0.00,22438,22439
30364,2,462,50,256.00,42436.00,22438,22440
30365,1,512,512,512.00,0.00,22439,22440
30366,2,372,140,256.00,13456.00,22439,22441
30367,1,512,512,512.00,0.00,22440,22441
30368,1,512,512,512.00,0.00,22440,22441
30369,1,512,512,512.00,0.00,22440,22441
30370,2,401,111,256.00,21025.00,22440,22442
30371,1,512,512,512.00,0.00,22441,22442
30372,1,512,512,512.00,0.00,22441,22442
30373,1,512,512,512.00,0.00,22441,22442
30374,2,291,221,256.00,1225.00,22441,22443
30375,3,365,48,170.67,19316.22,22442,22445
30376,1,512,512,512.00,0.00,22444,22445
30377,1,512,512,512.00,0.00,22444,22445
30378,1,512,512,512.00,0.00,22444,22445
30379,2,298,214,256.00,1764.00,22444,22446
30380,2,433,79,256.00,31329.00,22445,22447
30381,1,512,512,512.00,0.00,22446,22447
30382,1,512,512,512.00,0.00,22446,22447
30383,3,389,45,170.67,24016.22,22446,22449
30384,1,512,512,512.00,0.00,22448,22449
30385,2,435,77,256.00,32041.00,22448,22450
30386,1,512,512,512.00,0.00,22449,22450
30387,1,512,512,512.00,0.00,22449,22450
30388,2,333,179,256.00,5929.00,22449,22451
30389,1,512,512,512.00,0.00,22450,22451
30390,1,512,512,512.00,0.00,22450,22451
30391,4,272,5,128.00,11232.50,22450,22454
30392,1,512,512,512.00,0.00,22453,22454
30393,2,344,168,256.00,7744.00,22453,22455
30394,1,512,512,512.00,0.00,22454,22455
30395,3,349,1,170.67,20221.56,22454,22457
30396,2,368,144,256.00,12544.00,22456,22458
30397,5,277,10,102.40,11499.84,22457,22462
30398,2,497,15,256.00,58081.00,22461,22463
30399,2,493,19,256.00,56169.00,22462,22464
30400,1,512,512,512.00,0.00,22463,22464
30401,7,384,1,73.14,16316.41,22463,22470
30402,2,491,21,256.00,55225.00,22469,22471
30403,2,281,231,256.00,625.00,22470,22472
30404,1,512,512,512.00,0.00,22471,22472
30405,2,287,225,256.00,961.00,22471,22473
30406,4,233,38,128.00,5305.50,22472,22476
30407,1,512,512,512.00,0.00,22475,22476
30408,1,512,512,512.00,0.00,22475,22476
30409,1,512,512,512.00,0.00,22475,22476
30410,2,299,213,256.00,1849.00,22475,22477
30411,1,512,512,512.00,0.00,22476,22477
30412,1,512,512,512.00,0.00,22476,22477
30413,3,475,3,170.67,46469.56,22476,22479
30414,1,512,512,512.00,0.00,22478,22479
30415,1,512,512,512.00,0.00,22478,22479
30416,2,472,40,256.00,46656.00,22478,22480
30417,1,512,512,512.00,0.00,22479,22480
30418,1,512,512,512.00,0.00,22479,22480
30419,1,512,512,512.00,0.00,22479,22480
30420,2,449,63,256.00,37249.00,22479,22481
30421,3,249,114,170.67,3272.22,22480,22483
30422,1,512,512,512.00,0.00,22482,22483
30423,1,512,512,512.00,0.00,22482,22483
30424,2,397,115,256.00,19881.00,22482,22484
30425,1,512,512,512.00,0.00,22483,22484
30426,1,512,512,512.00,0.00,22483,22484
30427,1,512,512,512.00,0.00,22483,22484
30428,2,372,140,256.00,13456.00,22483,22485
30429,1,512,512,512.00,0.00,22484,22485
30430,2,349,163,256.00,8649.00,22484,22486
30431,2,507,5,256.00,63001.00,22485,22487
30432,2,265,247,256.00,81.00,22486,22488
30433,2,278,234,256.00,484.00,22487,22489
30434,1,512,512,512.00,0.00,22488,22489
30435,1,512,512,512.00,0.00,22488,22489
30436,1,512,512,512.00,0.00,22488,22489
30437,1,512,512,512.00,0.00,22488,22489
30438,2,389,123,256.00,17689.00,22488,22490
30439,2,451,61,256.00,38025.00,22489,22491
30440,1,512,512,512.00,0.00,22490,22491
30441,1,512,512,512.00,0.00,22490,22491
30442,1,512,512,512.00,0.00,22490,22491
30443,1,512,512,512.00,0.00,22490,22491
30444,3,322,8,170.67,16496.89,22490,22493
30445,10,267,1,51.20,6557.96,22492,22502
30446,7,138,16,73.14,2072.69,22501,22508
30447,1,512,512,512.00,0.00,22507,22508
30448,2,429,83,256.00,29929.00,22507,22509
30449,1,512,512,512.00,0.00,22508,22509
30450,1,512,512,512.00,0.00,22508,22509
30451,1,512,512,512.00,0.00,22508,22509
30452,1,512,512,512.00,0.00,22508,22509
30453,1,512,512,512.00,0.00,22508,22509
30454,1,512,512,512.00,0.00,22508,22509
30455,1,512,512,512.00,0.00,22508,22509
30456,1,512,512,512.00,0.00,22508,22509
30457,1,512,512,512.00,0.00,22508,22509
30458,1,512,512,512.00,0.00,22508,22509
30459,1,512,512,512.00,0.00,22508,22509
30460,1,512,512,512.00,0.00,22508,22509
30461,1,512,512,512.00,0.00,22508,22509
30462,2,500,12,256.00,59536.00,22508,22510
30463,1,512,512,512.00,0.00,22509,22510
30464,1,512,512,512.00,0.00,22509,22510
30465,1,512,512,512.00,0.00,22509,22510
30466,3,371,41,170.67,20646.89,22509,22512
30467,1,512,512,512.00,0.00,22511,22512
30468,2,312,200,256.00,3136.00,22511,22513
30469,1,512,512,512.00,0.00,22512,22513
30470,1,512,512,512.00,0.00,22512,22513
30471,1,512,512,512.00,0.00,22512,22513
30472,1,512,512,512.00,0.00,22512,22513
30473,1,512,512,512.00,0.00,22512,22513
30474,2,292,220,256.00,1296.00,22512,22514
30475,3,282,9,170.67,13688.22,22513,22516
30476,2,425,87,256.00,28561.00,22515,22517
30477,1,512,512,512.00,0.00,22516,22517
30478,1,512,512,512.00,0.00,22516,22517
30479,1,512,512,512.00,0.00,22516,22517
30480,1,512,512,512.00,0.00,22516,22517
30481,1,512,512,512.00,0.00,22516,22517
30482,2,299,213,256.00,1849.00,22516,22518
30483,1,512,512,512.00,0.00,22517,22518
30484,1,512,512,512.00,0.00,22517,22518
30485,2,466,46,256.00,44100.00,22517,22519
30486,1,512,512,512.00,0.00,22518,22519
30487,1,512,512,512.00,0.00,22518,22519
30488,3,310,54,170.67,11179.56,22518,22521
30489,1,512,512,512.00,0.00,22520,22521
30490,5,313,1,102.40,13493.44,22520,22525
30491,1,512,512,512.00,0.00,22524,22525
30492,2,440,72,256.00,33856.00,22524,22526
30493,1,512,512,512.00,0.00,22525,22526
30494,1,512,512,512.00,0.00,22525,22526
30495,2,473,39,256.00,47089.00,22525,22527
30496,2,384,128,256.00,16384.00,22526,22528
30497,1,512,512,512.00,0.00,22527,22528
30498,1,512,512,512.00,0.00,22527,22528
30499,1,512,512,512.00,0.00,22527,22528
30500,2,349,163,256.00,8649.00,22527,22529
30501,1,512,512,512.00,0.00,22528,22529
30502,1,512,512,512.00,0.00,22528,22529
30503,1,512,512,512.00,0.00,22528,22529
30504,2,470,42,256.00,45796.00,22528,22530
30505,3,500,3,170.67,54236.22,22529,22532
30506,1,512,512,512.00,0.00,22531,22532
30507,1,512,512,512.00,0.00,22531,22532
30508,1,512,512,512.00,0.00,22531,22532
30509,1,512,512,512.00,0.00,22531,22532
30510,1,512,512,512.00,0.00,22531,22532
30511,1,512,512,512.00,0.00,22531,22532
30512,1,512,512,512.00,0.00,22531,22532
30513,3,400,6,170.67,27963.56,22531,22534
30514,1,512,512,512.00,0.00,22533,22534
30515,3,340,2,170.67,19040.89,22533,22536
30516,1,512,512,512.00,0.00,22535,22536
30517,1,512,512,512.00,0.00,22535,22536
30518,2,474,38,256.00,47524.00,22535,22537
30519,1,512,512,512.00,0.00,22536,22537
30520,1,512,512,512.00,0.00,22536,22537
30521,5,246,4,102.40,12921.84,22536,22541
30522,4,200,72,128.00,3036.50,22540,22544
30523,1,512,512,512.00,0.00,22543,22544
30524,1,512,512,512.00,0.00,22543,22544
30525,1,512,512,512.00,0.00,22543,22544
30526,2,437,75,256.00,32761.00,22543,22545
30527,2,306,206,256.00,2500.00,22544,22546
30528,1,512,512,512.00,0.00,22545,22546
30529,2,358,154,256.00,10404.00,22545,22547
30530,1,512,512,512.00,0.00,22546,22547
30531,1,512,512,512.00,0.00,22546,22547
30532,1,512,512,512.00,0.00,22546,22547
30533,2,283,229,256.00,729.00,22546,22548
30534,1,512,512,512.00,0.00,22547,22548
30535,2,314,198,256.00,3364.00,22547,22549
30536,1,512,512,512.00,0.00,22548,22549
30537,1,512,512,512.00,0.00,22548,22549
30538,2,303,209,256.00,2209.00,22548,22550
30539,1,512,512,512.00,0.00,22549,22550
30540,1,512,512,512.00,0.00,22549,22550
30541,1,512,512,512.00,0.00,22549,22550
30542,2,276,236,256.00,400.00,22549,22551
30543,1,512,512,512.00,0.00,22550,22551
30544,1,512,512,512.00,0.00,22550,22551
30545,1,512,512,512.00,0.00,22550,22551
30546,2,300,212,256.00,1936.00,22550,22552
30547,1,512,512,512.00,0.00,22551,22552
30548,2,307,205,256.00,2601.00,22551,22553
30549,1,512,512,512.00,0.00,22552,22553
30550,1,512,512,512.00,0.00,22552,22553
30551,1,512,512,512.00,0.00,22552,22553
30552,1,512,512,512.00,0.00,22552,22553
30553,2,299,213,256.00,1849.00,22552,22554
30554,1,512,512,512.00,0.00,22553,22554
30555,1,512,512,512.00,0.00,22553,22554
30556,1,512,512,512.00,0.00,22553,22554
30557,1,512,512,512.00,0.00,22553,22554
30558,3,292,67,170.67,8593.56,22553,22556
30559,1,512,512,512.00,0.00,22555,22556
30560,1,512,512,512.00,0.00,22555,22556
30561,1,512,512,512.00,0.00,22555,22556
30562,2,319,193,256.00,3969.00,22555,22557
30563,2,303,209,256.00,2209.00,22556,22558
30564,2,450,62,256.00,37636.00,22557,22559
30565,4,236,29,128.00,8457.50,22558,22562
30566,1,512,512,512.00,0.00,22561,22562
30567,3,299,77,170.67,8814.89,22561,22564
30568,1,512,512,512.00,0.00,22563,22564
30569,2,439,73,256.00,33489.00,22563,22565
30570,2,457,55,256.00,40401.00,22564,22566
30571,1,512,512,512.00,0.00,22565,22566
30572,1,512,512,512.00,0.00,22565,22566
30573,1,512,512,512.00,0.00,22565,22566
30574,3,418,6,170.67,31707.56,22565,22568
30575,1,512,512,512.00,0.00,22567,22568
30576,5,252,3,102.40,10293.04,22567,22572
30577,3,415,3,170.67,31229.56,22571,22574
30578,1,512,512,512.00,0.00,22573,22574
30579,1,512,512,512.00,0.00,22573,22574
30580,1,512,512,512.00,0.00,22573,22574
30581,4,483,2,128.00,42045.50,22573,22577
30582,1,512,512,512.00,0.00,22576,22577
30583,1,512,512,512.00,0.00,22576,22577
30584,1,512,512,512.00,0.00,22576,22577
30585,1,512,512,512.00,0.00,22576,22577
30586,2,267,245,256.00,121.00,22576,22578
30587,1,512,512,512.00,0.00,22577,22578
30588,1,512,512,512.00,0.00,22577,22578
30589,3,243,64,170.67,5929.56,22577,22580
30590,1,512,512,512.00,0.00,22579,22580
30591,3,383,16,170.67,24110.89,22579,22582
30592,1,512,512,512.00,0.00,22581,22582
30593,2,344,168,256.00,7744.00,22581,22583
30594,1,512,512,512.00,0.00,22582,22583
30595,1,512,512,512.00,0.00,22582,22583
30596,2,340,172,256.00,7056.00,22582,22584
30597,1,512,512,512.00,0.00,22583,22584
30598,1,512,512,512.00,0.00,22583,22584
30599,3,346,20,170.67,18016.89,22583,22586
30600,1,512,512,512.00,0.00,22585,22586
30601,3,289,10,170.67,13869.56,22585,22588
30602,2,348,164,256.00,8464.00,22587,22589
30603,1,512,512,512.00,0.00,22588,22589
30604,1,512,512,512.00,0.00,22588,22589
30605,2,314,198,256.00,3364.00,22588,22590
30606,1,512,512,512.00,0.00,22589,22590
30607,1,512,512,512.00,0.00,22589,22590
30608,2,332,180,256.00,5776.00,22589,22591
30609,3,244,112,170.67,3011.56,22590,22593
30610,1,512,512,512.00,0.00,22592,22593
30611,3,242,126,170.67,2598.22,22592,22595
30612,1,512,512,512.00,0.00,22594,22595
30613,2,495,17,256.00,57121.00,22594,22596
30614,4,209,33,128.00,6233.00,22595,22599
30615,1,512,512,512.00,0.00,22598,22599
30616,1,512,512,512.00,0.00,22598,22599
30617,2,379,133,256.00,15129.00,22598,22600
30618,1,512,512,512.00,0.00,22599,22600
30619,1,512,512,512.00,0.00,22599,22600
30620,2,271,241,256.00,225.00,22599,22601
30621,3,354,28,170.67,18539.56,22600,22603
30622,3,266,18,170.67,11894.22,22602,22605
30623,1,512,512,512.00,0.00,22604,22605
30624,4,206,62,128.00,3878.00,22604,22608
30625,1,512,512,512.00,0.00,22607,22608
30626,1,512,512,512.00,0.00,22607,22608
30627,2,451,61,256.00,38025.00,22607,22609
30628,1,512,512,512.00,0.00,22608,22609
30629,1,512,512,512.00,0.00,22608,22609
30630,1,512,512,512.00,0.00,22608,22609
30631,1,512,512,512.00,0.00,22608,22609
30632,2,276,236,256.00,400.00,22608,22610
30633,1,512,512,512.00,0.00,22609,22610
30634,1,512,512,512.00,0.00,22609,22610
30635,1,512,512,512.00,0.00,22609,22610
30636,3,380,46,170.67,22176.89,22609,22612
30637,1,512,512,512.00,0.00,22611,22612
30638,3,277,3,170.67,14393.56,22611,22614
30639,1,512,512,512.00,0.00,22613,22614
30640,1,512,512,512.00,0.00,22613,22614
30641,1,512,512,512.00,0.00,22613,22614
30642,2,347,165,256.00,8281.00,22613,22615
30643,2,367,145,256.00,12321.00,22614,22616
30644,1,512,512,512.00,0.00,22615,22616
30645,2,288,224,256.00,1024.00,22615,22617
30646,1,512,512,512.00,0.00,22616,22617
30647,1,512,512,512.00,0.00,22616,22617
30648,3,260,50,170.67,7840.89,22616,22619
30649,2,438,74,256.00,33124.00,22618,22620
30650,2,382,130,256.00,15876.00,22619,22621
30651,3,297,76,170.67,8641.56,22620,22623
30652,1,512,512,512.00,0.00,22622,22623
30653,1,512,512,512.00,0.00,22622,22623
30654,2,351,161,256.00,9025.00,22622,22624
30655,2,357,155,256.00,10201.00,22623,22625
30656,1,512,512,512.00,0.00,22624,22625
30657,6,200,13,85.33,5523.89,22624,22630
30658,1,512,512,512.00,0.00,22629,22630
30659,1,512,512,512.00,0.00,22629,22630
30660,1,512,512,512.00,0.00,22629,22630
30661,5,208,6,102.40,5266.24,22629,22634
30662,2,309,203,256.00,2809.00,22633,22635
30663,1,512,512,512.00,0.00,22634,22635
30664,2,422,90,256.00,27556.00,22634,22636
30665,1,512,512,512.00,0.00,22635,22636
30666,2,263,249,256.00,49.00,22635,22637
30667,1,512,512,512.00,0.00,22636,22637
30668,1,512,512,512.00,0.00,22636,22637
30669,1,512,512,512.00,0.00,22636,22637
30670,3,350,2,170.67,20240.89,22636,22639
30671,4,331,6,128.00,15546.50,22638,22642
30672,1,512,512,512.00,0.00,22641,22642
30673,1,512,512,512.00,0.00,22641,22642
30674,2,426,86,256.00,28900.00,22641,22643
30675,1,512,512,512.00,0.00,22642,22643
30676,3,242,80,170.67,4560.89,22642,22645
30677,2,324,188,256.00,4624.00,22644,22646
30678,1,512,512,512.00,0.00,22645,22646
30679,1,512,512,512.00,0.00,22645,22646
30680,2,396,116,256.00,19600.00,22645,22647
30681,2,389,123,256.00,17689.00,22646,22648
30682,2,473,39,256.00,47089.00,22647,22649
30683,1,512,512,512.00,0.00,22648,22649
30684,2,318,194,256.00,3844.00,22648,22650
30685,2,287,225,256.00,961.00,22649,22651
30686,2,286,226,256.00,900.00,22650,22652
30687,1,512,512,512.00,0.00,22651,22652
30688,2,485,27,256.00,52441.00,22651,22653
30689,1,512,512,512.00,0.00,22652,22653
30690,1,512,512,512.00,0.00,22652,22653
30691,2,387,125,256.00,17161.00,22652,22654
30692,3,397,23,170.67,26406.89,22653,22656
30693,1,512,512,512.00,0.00,22655,22656
30694,1,512,512,512.00,0.00,22655,22656
30695,3,421,9,170.67,32221.56,22655,22658
30696,2,489,23,256.00,54289.00,22657,22659
30697,3,227,99,170.67,2848.22,22658,22661
30698,1,512,512,512.00,0.00,22660,22661
30699,1,512,512,512.00,0.00,22660,22661
30700,1,512,512,512.00,0.00,22660,22661
30701,2,377,135,256.00,14641.00,22660,22662
30702,1,512,512,512.00,0.00,22661,22662
30703,1,512,512,512.00,0.00,22661,22662
30704,2,368,144,256.00,12544.00,22661,22663
30705,1,512,512,512.00,0.00,22662,22663
30706,1,512,512,512.00,0.00,22662,22663
30707,1,512,512,512.00,0.00,22662,22663
30708,3,405,27,170.67,27924.22,22662,22665
30709,1,512,512,512.00,0.00,22664,22665
30710,3,351,5,170.67,20060.22,22664,22667
30711,1,512,512,512.00,0.00,22666,22667
30712,1,512,512,512.00,0.00,22666,22667
30713,1,512,512,512.00,0.00,22666,22667
30714,1,512,512,512.00,0.00,22666,22667
30715,1,512,512,512.00,0.00,22666,22667
30716,2,307,205,256.00,2601.00,22666,22668
30717,2,304,208,256.00,2304.00,22667,22669
30718,2,474,38,256.00,47524.00,22668,22670
30719,1,512,512,512.00,0.00,22669,22670
30720,1,512,512,512.00,0.00,22669,22670
30721,1,512,512,512.00,0.00,22669,22670
30722,3,399,46,170.67,26141.56,22669,22672
30723,1,512,512,512.00,0.00,22671,22672
30724,2,281,231,256.00,625.00,22671,22673
30725,2,476,36,256.00,48400.00,22672,22674
30726,1,512,512,512.00,0.00,22673,22674
30727,1,512,512,512.00,0.00,22673,22674
30728,1,512,512,512.00,0.00,22673,22674
30729,1,512,512,512.00,0.00,22673,22674
30730,4,228,2,128.00,6698.00,22673,22677
30731,4,354,1,128.00,20171.50,22676,22680
30732,1,512,512,512.00,0.00,22679,22680
30733,1,512,512,512.00,0.00,22679,22680
30734,2,278,234,256.00,484.00,22679,22681
30735,1,512,512,512.00,0.00,22680,22681
30736,1,512,512,512.00,0.00,22680,22681
30737,3,338,4,170.67,18592.89,22680,22683
30738,1,512,512,512.00,0.00,22682,22683
30739,3,312,17,170.67,14580.22,22682,22685
30740,2,300,212,256.00,1936.00,22684,22686
30741,1,512,512,512.00,0.00,22685,22686
30742,3,412,3,170.67,30593.56,22685,22688
30743,3,261,6,170.67,13600.22,22687,22690
30744,1,512,512,512.00,0.00,22689,22690
30745,1,512,512,512.00,0.00,22689,22690
30746,1,512,512,512.00,0.00,22689,22690
30747,1,512,512,512.00,0.00,22689,22690
30748,1,512,512,512.00,0.00,22689,22690
30749,1,512,512,512.00,0.00,22689,22690
30750,1,512,512,512.00,0.00,22689,22690
30751,4,227,34,128.00,6873.50,22689,22693
30752,1,512,512,512.00,0.00,22692,22693
30753,5,274,2,102.40,11175.44,22692,22697
30754,4,395,2,128.00,25501.50,22696,22700
30755,1,512,512,512.00,0.00,22699,22700
30756,2,454,58,256.00,39204.00,22699,22701
30757,1,512,512,512.00,0.00,22700,22701
30758,3,426,1,170.67,33773.56,22700,22703
30759,1,512,512,512.00,0.00,22702,22703
30760,1,512,512,512.00,0.00,22702,22703
30761,2,385,127,256.00,16641.00,22702,22704
30762,3,255,126,170.67,3560.22,22703,22706
30763,7,214,5,73.14,7228.12,22705,22712
30764,1,512,512,512.00,0.00,22711,22712
30765,2,311,201,256.00,3025.00,22711,22713
30766,1,512,512,512.00,0.00,22712,22713
30767,1,512,512,512.00,0.00,22712,22713
30768,1,512,512,512.00,0.00,22712,22713
30769,1,512,512,512.00,0.00,22712,22713
30770,1,512,512,512.00,0.00,22712,22713
30771,1,512,512,512.00,0.00,22712,22713
30772,1,512,512,512.00,0.00,22712,22713
30773,1,512,512,512.00,0.00,22712,22713
30774,3,471,18,170.67,45104.22,22712,22715
30775,1,512,512,512.00,0.00,22714,22715
30776,2,483,29,256.00,51529.00,22714,22716
30777,1,512,512,512.00,0.00,22715,22716
30778,2,337,175,256.00,6561.00,22715,22717
30779,1,512,512,512.00,0.00,22716,22717
30780,1,512,512,512.00,0.00,22716,22717
30781,1,512,512,512.00,0.00,22716,22717
30782,1,512,512,512.00,0.00,22716,22717
30783,1,512,512,512.00,0.00,22716,22717
30784,3,275,81,170.67,6380.22,22716,22719
30785,1,512,512,512.00,0.00,22718,22719
30786,1,512,512,512.00,0.00,22718,22719
30787,1,512,512,512.00,0.00,22718,22719
30788,1,512,512,512.00,0.00,22718,22719
30789,3,314,75,170.67,10656.22,22718,22721
30790,2,465,47,256.00,43681.00,22720,22722
30791,1,512,512,512.00,0.00,22721,22722
30792,1,512,512,512.00,0.00,22721,22722
30793,3,303,3,170.67,15624.22,22721,22724
30794,6,236,1,85.33,10322.89,22723,22729
30795,3,262,35,170.67,9570.89,22728,22731
30796,1,512,512,512.00,0.00,22730,22731
30797,1,512,512,512.00,0.00,22730,22731
30798,1,512,512,512.00,0.00,22730,22731
30799,1,512,512,512.00,0.00,22730,22731
30800,3,433,37,170.67,34413.56,22730,22733
30801,5,260,1,102.40,14852.24,22732,22737
30802,1,512,512,512.00,0.00,22736,22737
30803,3,315,63,170.67,11256.22,22736,22739
30804,2,316,196,256.00,3600.00,22738,22740
30805,1,512,512,512.00,0.00,22739,22740
30806,1,512,512,512.00,0.00,22739,22740
30807,1,512,512,512.00,0.00,22739,22740
30808,1,512,512,512.00,0.00,22739,22740
30809,4,318,14,128.00,13476.50,22739,22743
30810,2,505,7,256.00,62001.00,22742,22744
30811,1,512,512,512.00,0.00,22743,22744
30812,4,246,15,128.00,9377.50,22743,22747
30813,1,512,512,512.00,0.00,22746,22747
30814,3,268,1,170.67,14497.56,22746,22749
30815,1,512,512,512.00,0.00,22748,22749
30816,1,512,512,512.00,0.00,22748,22749
30817,1,512,512,512.00,0.00,22748,22749
30818,1,512,512,512.00,0.00,22748,22749
30819,1,512,512,512.00,0.00,22748,22749
30820,5,230,3,102.40,5833.84,22748,22753
30821,2,444,68,256.00,35344.00,22752,22754
30822,1,512,512,512.00,0.00,22753,22754
30823,1,512,512,512.00,0.00,22753,22754
30824,1,512,512,512.00,0.00,22753,22754
30825,1,512,512,512.00,0.00,22753,22754
30826,1,512,512,512.00,0.00,22753,22754
30827,2,411,101,256.00,24025.00,22753,22755
30828,1,512,512,512.00,0.00,22754,22755
30829,1,512,512,512.00,0.00,22754,22755
30830,3,364,67,170.67,18721.56,22754,22757
30831,1,512,512,512.00,0.00,22756,22757
30832,1,512,512,512.00,0.00,22756,22757
30833,2,377,135,256.00,14641.00,22756,22758
30834,1,512,512,512.00,0.00,22757,22758
30835,2,368,144,256.00,12544.00,22757,22759
30836,1,512,512,512.00,0.00,22758,22759
30837,1,512,512,512.00,0.00,22758,22759
30838,1,512,512,512.00,0.00,22758,22759
30839,3,295,5,170.67,14870.89,22758,22761
30840,1,512,512,512.00,0.00,22760,22761
30841,1,512,512,512.00,0.00,22760,22761
30842,2,389,123,256.00,17689.00,22760,22762
30843,1,512,512,512.00,0.00,22761,22762
30844,1,512,512,512.00,0.00,22761,22762
30845,1,512,512,512.00,0.00,22761,22762
30846,1,512,512,512.00,0.00,22761,22762
30847,1,512,512,512.00,0.00,22761,22762
30848,1,512,512,512.00,0.00,22761,22762
30849,1,512,512,512.00,0.00,22761,22762
30850,3,297,48,170.67,10340.22,22761,22764
30851,1,512,512,512.00,0.00,22763,22764
30852,1,512,512,512.00,0.00,22763,22764
30853,1,512,512,512.00,0.00,22763,22764
30854,7,173,2,73.14,4160.98,22763,22770
30855,3,396,47,170.67,25468.22,22769,22772
30856,2,498,14,256.00,58564.00,22771,22773
30857,1,512,512,512.00,0.00,22772,22773
30858,6,215,4,85.33,5469.56,22772,22778
30859,1,512,512,512.00,0.00,22777,22778
30860,2,481,31,256.00,50625.00,22777,22779
30861,1,512,512,512.00,0.00,22778,22779
30862,3,415,20,170.67,30390.89,22778,22781
30863,1,512,512,512.00,0.00,22780,22781
30864,2,451,61,256.00,38025.00,22780,22782
30865,2,373,139,256.00,13689.00,22781,22783
30866,1,512,512,512.00,0.00,22782,22783
30867,5,426,2,102.40,26533.04,22782,22787
30868,1,512,512,512.00,0.00,22786,22787
30869,2,367,145,256.00,12321.00,22786,22788
30870,1,512,512,512.00,0.00,22787,22788
30871,6,244,8,85.33,5944.56,22787,22793
30872,1,512,512,512.00,0.00,22792,22793
30873,3,325,1,170.67,17613.56,22792,22795
30874,3,490,7,170.67,50997.56,22794,22797
30875,6,177,3,85.33,5404.89,22796,22802
30876,1,512,512,512.00,0.00,22801,22802
30877,1,512,512,512.00,0.00,22801,22802
30878,1,512,512,512.00,0.00,22801,22802
30879,1,512,512,512.00,0.00,22801,22802
30880,5,228,7,102.40,7005.04,22801,22806
30881,1,512,512,512.00,0.00,22805,22806
30882,4,367,3,128.00,20053.00,22805,22809
30883,2,484,28,256.00,51984.00,22808,22810
30884,2,364,148,256.00,11664.00,22809,22811
30885,1,512,512,512.00,0.00,22810,22811
30886,2,503,9,256.00,61009.00,22810,22812
30887,1,512,512,512.00,0.00,22811,22812
30888,1,512,512,512.00,0.00,22811,22812
30889,1,512,512,512.00,0.00,22811,22812
30890,1,512,512,512.00,0.00,22811,22812
30891,1,512,512,512.00,0.00,22811,22812
30892,2,401,111,256.00,21025.00,22811,22813
30893,3,344,63,170.67,15316.22,22812,22815
30894,2,273,239,256.00,289.00,22814,22816
30895,1,512,512,512.00,0.00,22815,22816
30896,2,261,251,256.00,25.00,22815,22817
30897,1,512,512,512.00,0.00,22816,22817
30898,1,512,512,512.00,0.00,22816,22817
30899,1,512,512,512.00,0.00,22816,22817
30900,2,510,2,256.00,64516.00,22816,22818
30901,2,326,186,256.00,4900.00,22817,22819
30902,1,512,512,512.00,0.00,22818,22819
30903,3,237,40,170.67,8537.56,22818,22821
30904,1,512,512,512.00,0.00,22820,22821
30905,1,512,512,512.00,0.00,22820,22821
30906,4,369,31,128.00,19609.00,22820,22824
30907,1,512,512,512.00,0.00,22823,22824
30908,3,403,24,170.67,27609.56,22823,22826
30909,2,453,59,256.00,38809.00,22825,22827
30910,1,512,512,512.00,0.00,22826,22827
30911,1,512,512,512.00,0.00,22826,22827
30912,1,512,512,512.00,0.00,22826,22827
30913,2,476,36,256.00,48400.00,22826,22828
30914,1,512,512,512.00,0.00,22827,22828
30915,4,286,1,128.00,11428.50,22827,22831
30916,2,269,243,256.00,169.00,22830,22832
30917,2,486,26,256.00,52900.00,22831,22833
30918,2,312,200,256.00,3136.00,22832,22834
30919,1,512,512,512.00,0.00,22833,22834
30920,1,512,512,512.00,0.00,22833,22834
30921,2,303,209,256.00,2209.00,22833,22835
30922,2,336,176,256.00,6400.00,22834,22836
30923,2,499,13,256.00,59049.00,22835,22837
30924,2,468,44,256.00,44944.00,22836,22838
30925,3,223,68,170.67,5270.89,22837,22840
30926,5,189,8,102.40,3905.84,22839,22844
30927,1,512,512,512.00,0.00,22843,22844
30928,1,512,512,512.00,0.00,22843,22844
30929,1,512,512,512.00,0.00,22843,22844
30930,3,295,54,170.67,9709.56,22843,22846
30931,1,512,512,512.00,0.00,22845,22846
30932,1,512,512,512.00,0.00,22845,22846
30933,1,512,512,512.00,0.00,22845,22846
30934,2,486,26,256.00,52900.00,22845,22847
30935,1,512,512,512.00,0.00,22846,22847
30936,5,362,1,102.40,18127.04,22846,22851
30937,1,512,512,512.00,0.00,22850,22851
30938,2,290,222,256.00,1156.00,22850,22852
30939,1,512,512,512.00,0.00,22851,22852
30940,2,298,214,256.00,1764.00,22851,22853
30941,1,512,512,512.00,0.00,22852,22853
30942,1,512,512,512.00,0.00,22852,22853
30943,1,512,512,512.00,0.00,22852,22853
30944,1,512,512,512.00,0.00,22852,22853
30945,1,512,512,512.00,0.00,22852,22853
30946,2,342,170,256.00,7396.00,22852,22854
30947,1,512,512,512.00,0.00,22853,22854
30948,1,512,512,512.00,0.00,22853,22854
30949,1,512,512,512.00,0.00,22853,22854
30950,1,512,512,512.00,0.00,22853,22854
30951,1,512,512,512.00,0.00,22853,22854
30952,2,414,98,256.00,24964.00,22853,22855
30953,1,512,512,512.00,0.00,22854,22855
30954,1,512,512,512.00,0.00,22854,22855
30955,1,512,512,512.00,0.00,22854,22855
30956,1,512,512,512.00,0.00,22854,22855
30957,1,512,512,512.00,0.00,22854,22855
30958,1,512,512,512.00,0.00,22854,22855
30959,2,274,238,256.00,324.00,22854,22856
30960,1,512,512,512.00,0.00,22855,22856
30961,1,512,512,512.00,0.00,22855,22856
30962,1,512,512,512.00,0.00,22855,22856
30963,1,512,512,512.00,0.00,22855,22856
30964,2,320,192,256.00,4096.00,22855,22857
30965,1,512,512,512.00,0.00,22856,22857
30966,1,512,512,512.00,0.00,22856,22857
30967,1,512,512,512.00,0.00,22856,22857
30968,2,314,198,256.00,3364.00,22856,22858
30969,1,512,512,512.00,0.00,22857,22858
30970,1,512,512,512.00,0.00,22857,22858
30971,2,481,31,256.00,50625.00,22857,22859
30972,2,298,214,256.00,1764.00,22858,22860
30973,3,428,12,170.67,33710.22,22859,22862
30974,1,512,512,512.00,0.00,22861,22862
30975,1,512,512,512.00,0.00,22861,22862
30976,1,512,512,512.00,0.00,22861,22862
30977,1,512,512,512.00,0.00,22861,22862
30978,1,512,512,512.00,0.00,22861,22862
30979,1,512,512,512.00,0.00,22861,22862
30980,2,277,235,256.00,441.00,22861,22863
30981,1,512,512,512.00,0.00,22862,22863
30982,1,512,512,512.00,0.00,22862,22863
30983,1,512,512,512.00,0.00,22862,22863
30984,2,316,196,256.00,3600.00,22862,22864
30985,1,512,512,512.00,0.00,22863,22864
30986,2,484,28,256.00,51984.00,22863,22865
30987,1,512,512,512.00,0.00,22864,22865
30988,1,512,512,512.00,0.00,22864,22865
30989,2,447,65,256.00,36481.00,22864,22866
30990,1,512,512,512.00,0.00,22865,22866
30991,2,337,175,256.00,6561.00,22865,22867
30992,2,303,209,256.00,2209.00,22866,22868
30993,1,512,512,512.00,0.00,22867,22868
30994,4,219,42,128.00,7082.50,22867,22871
30995,1,512,512,512.00,0.00,22870,22871
30996,1,512,512,512.00,0.00,22870,22871
30997,2,497,15,256.00,58081.00,22870,22872
30998,1,512,512,512.00,0.00,22871,22872
30999,1,512,512,512.00,0.00,22871,22872
31000,3,326,49,170.67,13354.89,22871,22874
31001,3,275,15,170.67,12584.22,22873,22876
31002,1,512,512,512.00,0.00,22875,22876
31003,4,235,10,128.00,11014.50,22875,22879
31004,1,512,512,512.00,0.00,22878,22879
31005,1,512,512,512.00,0.00,22878,22879
31006,2,509,3,256.00,64009.00,22878,22880
31007,3,484,2,170.67,49184.89,22879,22882
31008,1,512,512,512.00,0.00,22881,22882
31009,1,512,512,512.00,0.00,22881,22882
31010,2,368,144,256.00,12544.00,22881,22883
31011,1,512,512,512.00,0.00,22882,22883
31012,2,346,166,256.00,8100.00,22882,22884
31013,1,512,512,512.00,0.00,22883,22884
31014,1,512,512,512.00,0.00,22883,22884
31015,1,512,512,512.00,0.00,22883,22884
31016,1,512,512,512.00,0.00,22883,22884
31017,1,512,512,512.00,0.00,22883,22884
31018,1,512,512,512.00,0.00,22883,22884
31019,3,217,105,170.67,2277.56,22883,22886
31020,1,512,512,512.00,0.00,22885,22886
31021,4,208,38,128.00,5262.00,22885,22889
31022,1,512,512,512.00,0.00,22888,22889
31023,1,512,512,512.00,0.00,22888,22889
31024,2,405,107,256.00,22201.00,22888,22890
31025,1,512,512,512.00,0.00,22889,22890
31026,3,377,42,170.67,21720.22,22889,22892
31027,1,512,512,512.00,0.00,22891,22892
31028,1,512,512,512.00,0.00,22891,22892
31029,5,277,4,102.40,12360.24,22891,22896
31030,2,399,113,256.00,20449.00,22895,22897
31031,2,347,165,256.00,8281.00,22896,22898
31032,1,512,512,512.00,0.00,22897,22898
31033,3,244,34,170.67,9355.56,22897,22900
31034,1,512,512,512.00,0.00,22899,22900
31035,4,239,5,128.00,11021.00,22899,22903
31036,1,512,512,512.00,0.00,22902,22903
31037,1,512,512,512.00,0.00,22902,22903
31038,1,512,512,512.00,0.00,22902,22903
31039,1,512,512,512.00,0.00,22902,22903
31040,2,372,140,256.00,13456.00,22902,22904
31041,1,512,512,512.00,0.00,22903,22904
31042,1,512,512,512.00,0.00,22903,22904
31043,2,423,89,256.00,27889.00,22903,22905
31044,1,512,512,512.00,0.00,22904,22905
31045,2,418,94,256.00,26244.00,22904,22906
31046,4,184,58,128.00,2034.00,22905,22909
31047,3,387,21,170.67,24548.22,22908,22911
31048,1,512,512,512.00,0.00,22910,22911
31049,1,512,512,512.00,0.00,22910,22911
31050,7,260,3,73.14,6432.69,22910,22917
31051,1,512,512,512.00,0.00,22916,22917
31052,4,295,44,128.00,9598.50,22916,22920
31053,4,346,3,128.00,16889.50,22919,22923
31054,1,512,512,512.00,0.00,22922,22923
31055,2,290,222,256.00,1156.00,22922,22924
31056,1,512,512,512.00,0.00,22923,22924
31057,3,379,4,170.67,24305.56,22923,22926
31058,1,512,512,512.00,0.00,22925,22926
31059,2,437,75,256.00,32761.00,22925,22927
31060,3,472,15,170.67,45417.56,22926,22929
31061,6,259,2,85.33,11649.22,22928,22934
31062,1,512,512,512.00,0.00,22933,22934
31063,6,279,4,85.33,10028.89,22933,22939
31064,1,512,512,512.00,0.00,22938,22939
31065,1,512,512,512.00,0.00,22938,22939
31066,1,512,512,512.00,0.00,22938,22939
31067,1,512,512,512.00,0.00,22938,22939
31068,2,501,11,256.00,60025.00,22938,22940
31069,1,512,512,512.00,0.00,22939,22940
31070,2,418,94,256.00,26244.00,22939,22941
31071,1,512,512,512.00,0.00,22940,22941
31072,1,512,512,512.00,0.00,22940,22941
31073,1,512,512,512.00,0.00,22940,22941
31074,1,512,512,512.00,0.00,22940,22941
31075,1,512,512,512.00,0.00,22940,22941
31076,2,462,50,256.00,42436.00,22940,22942
31077,1,512,512,512.00,0.00,22941,22942
31078,1,512,512,512.00,0.00,22941,22942
31079,1,512,512,512.00,0.00,22941,22942
31080,1,512,512,512.00,0.00,22941,22942
31081,2,487,25,256.00,53361.00,22941,22943
31082,1,512,512,512.00,0.00,22942,22943
31083,1,512,512,512.00,0.00,22942,22943
31084,1,512,512,512.00,0.00,22942,22943
31085,2,452,60,256.00,38416.00,22942,22944
31086,1,512,512,512.00,0.00,22943,22944
31087,4,239,4,128.00,7270.50,22943,22947
31088,2,500,12,256.00,59536.00,22946,22948
31089,1,512,512,512.00,0.00,22947,22948
31090,1,512,512,512.00,0.00,22947,22948
31091,3,238,116,170.67,2560.89,22947,22950
31092,2,376,136,256.00,14400.00,22949,22951
31093,4,270,8,128.00,8702.00,22950,22954
31094,1,512,512,512.00,0.00,22953,22954
31095,3,435,1,170.67,35873.56,22953,22956
31096,2,349,163,256.00,8649.00,22955,22957
31097,1,512,512,512.00,0.00,22956,22957
31098,3,374,9,170.67,23072.22,22956,22959
31099,1,512,512,512.00,0.00,22958,22959
31100,1,512,512,512.00,0.00,22958,22959
31101,4,201,72,128.00,2503.50,22958,22962
31102,3,324,33,170.67,14236.22,22961,22964
31103,3,234,97,170.67,3181.56,22963,22966
31104,2,448,64,256.00,36864.00,22965,22967
31105,1,512,512,512.00,0.00,22966,22967
31106,1,512,512,512.00,0.00,22966,22967
31107,1,512,512,512.00,0.00,22966,22967
31108,1,512,512,512.00,0.00,22966,22967
31109,2,394,118,256.00,19044.00,22966,22968
31110,1,512,512,512.00,0.00,22967,22968
31111,1,512,512,512.00,0.00,22967,22968
31112,1,512,512,512.00,0.00,22967,22968
31113,1,512,512,512.00,0.00,22967,22968
31114,2,288,224,256.00,1024.00,22967,22969
31115,1,512,512,512.00,0.00,22968,22969
31116,1,512,512,512.00,0.00,22968,22969
31117,2,403,109,256.00,21609.00,22968,22970
31118,2,400,112,256.00,20736.00,22969,22971
31119,1,512,512,512.00,0.00,22970,22971
31120,3,366,13,170.67,21477.56,22970,22973
31121,1,512,512,512.00,0.00,22972,22973
31122,1,512,512,512.00,0.00,22972,22973
31123,1,512,512,512.00,0.00,22972,22973
31124,3,221,77,170.67,4394.89,22972,22975
31125,3,409,49,170.67,28405.56,22974,22977
31126,1,512,512,512.00,0.00,22976,22977
31127,1,512,512,512.00,0.00,22976,22977
31128,3,338,21,170.67,16904.22,22976,22979
31129,1,512,512,512.00,0.00,22978,22979
31130,4,280,7,128.00,11096.50,22978,22982
31131,1,512,512,512.00,0.00,22981,22982
31132,3,242,39,170.67,8688.22,22981,22984
31133,1,512,512,512.00,0.00,22983,22984
31134,1,512,512,512.00,0.00,22983,22984
31135,2,509,3,256.00,64009.00,22983,22985
31136,2,298,214,256.00,1764.00,22984,22986
31137,1,512,512,512.00,0.00,22985,22986
31138,2,480,32,256.00,50176.00,22985,22987
31139,2,458,54,256.00,40804.00,22986,22988
31140,1,512,512,512.00,0.00,22987,22988
31141,1,512,512,512.00,0.00,22987,22988
31142,1,512,512,512.00,0.00,22987,22988
31143,2,306,206,256.00,2500.00,22987,22989
31144,1,512,512,512.00,0.00,22988,22989
31145,2,357,155,256.00,10201.00,22988,22990
31146,3,216,122,170.67,1478.22,22989,22992
31147,1,512,512,512.00,0.00,22991,22992
31148,1,512,512,512.00,0.00,22991,22992
31149,2,472,40,256.00,46656.00,22991,22993
31150,1,512,512,512.00,0.00,22992,22993
31151,1,512,512,512.00,0.00,22992,22993
31152,6,153,6,85.33,1920.89,22992,22998
31153,1,512,512,512.00,0.00,22997,22998
31154,1,512,512,512.00,0.00,22997,22998
31155,2,359,153,256.00,10609.00,22997,22999
31156,1,512,512,512.00,0.00,22998,22999
31157,2,320,192,256.00,4096.00,22998,23000
31158,1,512,512,512.00,0.00,22999,23000
31159,3,328,69,170.67,12729.56,22999,23002
31160,1,512,512,512.00,0.00,23001,23002
31161,1,512,512,512.00,0.00,23001,23002
31162,2,438,74,256.00,33124.00,23001,23003
31163,1,512,512,512.00,0.00,23002,23003
31164,2,467,45,256.00,44521.00,23002,23004
31165,2,363,149,256.00,11449.00,23003,23005
31166,1,512,512,512.00,0.00,23004,23005
31167,1,512,512,512.00,0.00,23004,23005
31168,4,484,2,128.00,42315.50,23004,23008
31169,1,512,512,512.00,0.00,23007,23008
31170,1,512,512,512.00,0.00,23007,23008
31171,1,512,512,512.00,0.00,23007,23008
31172,1,512,512,512.00,0.00,23007,23008
31173,2,324,188,256.00,4624.00,23007,23009
31174,3,379,51,170.67,21861.56,23008,23011
31175,1,512,512,512.00,0.00,23010,23011
31176,1,512,512,512.00,0.00,23010,23011
31177,2,450,62,256.00,37636.00,23010,23012
31178,3,312,99,170.67,9988.22,23011,23014
31179,1,512,512,512.00,0.00,23013,23014
31180,1,512,512,512.00,0.00,23013,23014
31181,2,481,31,256.00,50625.00,23013,23015
31182,1,512,512,512.00,0.00,23014,23015
31183,1,512,512,512.00,0.00,23014,23015
31184,2,271,241,256.00,225.00,23014,23016
31185,1,512,512,512.00,0.00,23015,23016
31186,1,512,512,512.00,0.00,23015,23016
31187,2,480,32,256.00,50176.00,23015,23017
31188,1,512,512,512.00,0.00,23016,23017
31189,1,512,512,512.00,0.00,23016,23017
31190,1,512,512,512.00,0.00,23016,23017
31191,2,275,237,256.00,361.00,23016,23018
31192,3,422,9,170.67,32448.22,23017,23020
31193,1,512,512,512.00,0.00,23019,23020
31194,1,512,512,512.00,0.00,23019,23020
31195,1,512,512,512.00,0.00,23019,23020
31196,3,335,19,170.67,16722.89,23019,23022
31197,4,201,13,128.00,4919.50,23021,23025
31198,1,512,512,512.00,0.00,23024,23025
31199,1,512,512,512.00,0.00,23024,23025
31200,1,512,512,512.00,0.00,23024,23025
31201,2,328,184,256.00,5184.00,23024,23026
31202,3,324,47,170.67,13228.22,23025,23028
31203,1,512,512,512.00,0.00,23027,23028
31204,1,512,512,512.00,0.00,23027,23028
31205,1,512,512,512.00,0.00,23027,23028
31206,1,512,512,512.00,0.00,23027,23028
31207,4,185,72,128.00,1687.50,23027,23031
31208,1,512,512,512.00,0.00,23030,23031
31209,1,512,512,512.00,0.00,23030,23031
31210,1,512,512,512.00,0.00,23030,23031
31211,1,512,512,512.00,0.00,23030,23031
31212,2,473,39,256.00,47089.00,23030,23032
31213,2,361,151,256.00,11025.00,23031,23033
31214,1,512,512,512.00,0.00,23032,23033
31215,2,430,82,256.00,30276.00,23032,23034
31216,1,512,512,512.00,0.00,23033,23034
31217,1,512,512,512.00,0.00,23033,23034
31218,1,512,512,512.00,0.00,23033,23034
31219,5,159,2,102.40,3297.04,23033,23038
31220,1,512,512,512.00,0.00,23037,23038
31221,2,511,1,256.00,65025.00,23037,23039
31222,1,512,512,512.00,0.00,23038,23039
31223,1,512,512,512.00,0.00,23038,23039
31224,1,512,512,512.00,0.00,23038,23039
31225,1,512,512,512.00,0.00,23038,23039
31226,2,486,26,256.00,52900.00,23038,23040
31227,1,512,512,512.00,0.00,23039,23040
31228,1,512,512,512.00,0.00,23039,23040
31229,2,432,80,256.00,30976.00,23039,23041
31230,1,512,512,512.00,0.00,23040,23041
31231,1,512,512,512.00,0.00,23040,23041
31232,2,357,155,256.00,10201.00,23040,23042
31233,1,512,512,512.00,0.00,23041,23042
31234,2,304,208,256.00,2304.00,23041,23043
31235,1,512,512,512.00,0.00,23042,23043
31236,1,512,512,512.00,0.00,23042,23043
31237,2,496,16,256.00,57600.00,23042,23044
31238,2,463,49,256.00,42849.00,23043,23045
31239,2,359,153,256.00,10609.00,23044,23046
31240,1,512,512,512.00,0.00,23045,23046
31241,1,512,512,512.00,0.00,23045,23046
31242,1,512,512,512.00,0.00,23045,23046
31243,1,512,512,512.00,0.00,23045,23046
31244,2,274,238,256.00,324.00,23045,23047
31245,1,512,512,512.00,0.00,23046,23047
31246,1,512,512,512.00,0.00,23046,23047
31247,1,512,512,512.00,0.00,23046,23047
31248,2,343,169,256.00,7569.00,23046,23048
31249,2,496,16,256.00,57600.00,23047,23049
31250,2,311,201,256.00,3025.00,23048,23050
31251,3,486,3,170.67,49784.22,23049,23052
31252,4,306,22,128.00,12782.50,23051,23055
31253,4,311,24,128.00,12759.50,23054,23058
31254,1,512,512,512.00,0.00,23057,23058
31255,1,512,512,512.00,0.00,23057,23058
31256,1,512,512,512.00,0.00,23057,23058
31257,2,331,181,256.00,5625.00,23057,23059
31258,1,512,512,512.00,0.00,23058,23059
31259,1,512,512,512.00,0.00,23058,23059
31260,1,512,512,512.00,0.00,23058,23059
31261,2,469,43,256.00,45369.00,23058,23060
31262,1,512,512,512.00,0.00,23059,23060
31263,2,366,146,256.00,12100.00,23059,23061
31264,1,512,512,512.00,0.00,23060,23061
31265,1,512,512,512.00,0.00,23060,23061
31266,1,512,512,512.00,0.00,23060,23061
31267,1,512,512,512.00,0.00,23060,23061
31268,2,307,205,256.00,2601.00,23060,23062
31269,1,512,512,512.00,0.00,23061,23062
31270,1,512,512,512.00,0.00,23061,23062
31271,1,512,512,512.00,0.00,23061,23062
31272,3,343,1,170.67,19497.56,23061,23064
31273,1,512,512,512.00,0.00,23063,23064
31274,1,512,512,512.00,0.00,23063,23064
31275,3,474,15,170.67,46016.22,23063,23066
31276,1,512,512,512.00,0.00,23065,23066
31277,3,437,2,170.67,36306.89,23065,23068
31278,2,457,55,256.00,40401.00,23067,23069
31279,1,512,512,512.00,0.00,23068,23069
31280,3,252,90,170.67,4374.22,23068,23071
31281,1,512,512,512.00,0.00,23070,23071
31282,1,512,512,512.00,0.00,23070,23071
31283,3,465,12,170.67,43404.22,23070,23073
31284,1,512,512,512.00,0.00,23072,23073
31285,1,512,512,512.00,0.00,23072,23073
31286,1,512,512,512.00,0.00,23072,23073
31287,1,512,512,512.00,0.00,23072,23073
31288,2,297,215,256.00,1681.00,23072,23074
31289,2,377,135,256.00,14641.00,23073,23075
31290,1,512,512,512.00,0.00,23074,23075
31291,1,512,512,512.00,0.00,23074,23075
31292,5,320,3,102.40,12850.64,23074,23079
31293,2,344,168,256.00,7744.00,23078,23080
31294,2,415,97,256.00,25281.00,23079,23081
31295,3,402,44,170.67,26838.22,23080,23083
31296,1,512,512,512.00,0.00,23082,23083
31297,4,274,1,128.00,15847.50,23082,23086
31298,1,512,512,512.00,0.00,23085,23086
31299,1,512,512,512.00,0.00,23085,23086
31300,2,396,116,256.00,19600.00,23085,23087
31301,1,512,512,512.00,0.00,23086,23087
31302,2,274,238,256.00,324.00,23086,23088
31303,1,512,512,512.00,0.00,23087,23088
31304,1,512,512,512.00,0.00,23087,23088
31305,1,512,512,512.00,0.00,23087,23088
31306,1,512,512,512.00,0.00,23087,23088
31307,2,330,182,256.00,5476.00,23087,23089
31308,2,384,128,256.00,16384.00,23088,23090
31309,1,512,512,512.00,0.00,23089,23090
31310,3,343,17,170.67,17886.89,23089,23092
31311,1,512,512,512.00,0.00,23091,23092
31312,4,494,1,128.00,44676.50,23091,23095
31313,1,512,512,512.00,0.00,23094,23095
31314,1,512,512,512.00,0.00,23094,23095
31315,1,512,512,512.00,0.00,23094,23095
31316,3,379,2,170.67,24474.89,23094,23097
31317,4,199,45,128.00,3288.50,23096,23100
31318,3,225,67,170.67,5377.56,23099,23102
31319,1,512,512,512.00,0.00,23101,23102
31320,2,266,246,256.00,100.00,23101,23103
31321,1,512,512,512.00,0.00,23102,23103
31322,1,512,512,512.00,0.00,23102,23103
31323,1,512,512,512.00,0.00,23102,23103
31324,1,512,512,512.00,0.00,23102,23103
31325,3,322,59,170.67,12314.89,23102,23105
31326,1,512,512,512.00,0.00,23104,23105
31327,2,443,69,256.00,34969.00,23104,23106
31328,1,512,512,512.00,0.00,23105,23106
31329,1,512,512,512.00,0.00,23105,23106
31330,2,260,252,256.00,16.00,23105,23107
31331,1,512,512,512.00,0.00,23106,23107
31332,1,512,512,512.00,0.00,23106,23107
31333,4,224,32,128.00,7420.50,23106,23110
31334,2,493,19,256.00,56169.00,23109,23111
31335,3,455,3,170.67,40856.22,23110,23113
31336,1,512,512,512.00,0.00,23112,23113
31337,4,488,7,128.00,43200.50,23112,23116
31338,1,512,512,512.00,0.00,23115,23116
31339,1,512,512,512.00,0.00,23115,23116
31340,1,512,512,512.00,0.00,23115,23116
31341,1,512,512,512.00,0.00,23115,23116
31342,1,512,512,512.00,0.00,23115,23116
31343,2,341,171,256.00,7225.00,23115,23117
31344,1,512,512,512.00,0.00,23116,23117
31345,2,360,152,256.00,10816.00,23116,23118
31346,2,406,106,256.00,22500.00,23117,23119
31347,1,512,512,512.00,0.00,23118,23119
31348,2,357,155,256.00,10201.00,23118,23120
31349,1,512,512,512.00,0.00,23119,23120
31350,3,317,10,170.67,15810.89,23119,23122
31351,1,512,512,512.00,0.00,23121,23122
31352,1,512,512,512.00,0.00,23121,23122
31353,1,512,512,512.00,0.00,23121,23122
31354,2,349,163,256.00,8649.00,23121,23123
31355,2,490,22,256.00,54756.00,23122,23124
31356,1,512,512,512.00,0.00,23123,23124
31357,4,385,2,128.00,23187.50,23123,23127
31358,2,361,151,256.00,11025.00,23126,23128
31359,1,512,512,512.00,0.00,23127,23128
31360,1,512,512,512.00,0.00,23127,23128
31361,1,512,512,512.00,0.00,23127,23128
31362,2,454,58,256.00,39204.00,23127,23129
31363,2,370,142,256.00,12996.00,23128,23130
31364,2,410,102,256.00,23716.00,23129,23131
31365,1,512,512,512.00,0.00,23130,23131
31366,1,512,512,512.00,0.00,23130,23131
31367,2,444,68,256.00,35344.00,23130,23132
31368,1,512,512,512.00,0.00,23131,23132
31369,2,366,146,256.00,12100.00,23131,23133
31370,3,385,63,170.67,22969.56,23132,23135
31371,3,392,49,170.67,24574.89,23134,23137
31372,1,512,512,512.00,0.00,23136,23137
31373,1,512,512,512.00,0.00,23136,23137
31374,1,512,512,512.00,0.00,23136,23137
31375,1,512,512,512.00,0.00,23136,23137
31376,1,512,512,512.00,0.00,23136,23137
31377,5,287,1,102.40,14921.44,23136,23141
31378,2,491,21,256.00,55225.00,23140,23142
31379,1,512,512,512.00,0.00,23141,23142
31380,1,512,512,512.00,0.00,23141,23142
31381,2,269,243,256.00,169.00,23141,23143
31382,1,512,512,512.00,0.00,23142,23143
31383,1,512,512,512.00,0.00,23142,23143
31384,5,222,15,102.40,5939.84,23142,23147
31385,3,336,46,170.67,14843.56,23146,23149
31386,1,512,512,512.00,0.00,23148,23149
31387,2,338,174,256.00,6724.00,23148,23150
31388,1,512,512,512.00,0.00,23149,23150
31389,3,302,92,170.67,8736.89,23149,23152
31390,1,512,512,512.00,0.00,23151,23152
31391,1,512,512,512.00,0.00,23151,23152
31392,1,512,512,512.00,0.00,23151,23152
31393,1,512,512,512.00,0.00,23151,23152
31394,3,279,3,170.67,14456.22,23151,23154
31395,1,512,512,512.00,0.00,23153,23154
31396,1,512,512,512.00,0.00,23153,23154
31397,1,512,512,512.00,0.00,23153,23154
31398,2,440,72,256.00,33856.00,23153,23155
31399,1,512,512,512.00,0.00,23154,23155
31400,1,512,512,512.00,0.00,23154,23155
31401,1,512,512,512.00,0.00,23154,23155
31402,1,512,512,512.00,0.00,23154,23155
31403,2,389,123,256.00,17689.00,23154,23156
31404,1,512,512,512.00,0.00,23155,23156
31405,4,448,9,128.00,34190.50,23155,23159
31406,6,279,2,85.33,9777.56,23158,23164
31407,1,512,512,512.00,0.00,23163,23164
31408,2,391,121,256.00,18225.00,23163,23165
31409,1,512,512,512.00,0.00,23164,23165
31410,2,351,161,256.00,9025.00,23164,23166
31411,2,393,119,256.00,18769.00,23165,23167
31412,1,512,512,512.00,0.00,23166,23167
31413,1,512,512,512.00,0.00,23166,23167
31414,1,512,512,512.00,0.00,23166,23167
31415,2,472,40,256.00,46656.00,23166,23168
31416,1,512,512,512.00,0.00,23167,23168
31417,1,512,512,512.00,0.00,23167,23168
31418,1,512,512,512.00,0.00,23167,23168
31419,2,508,4,256.00,63504.00,23167,23169
31420,1,512,512,512.00,0.00,23168,23169
31421,3,362,26,170.67,19904.89,23168,23171
31422,1,512,512,512.00,0.00,23170,23171
31423,1,512,512,512.00,0.00,23170,23171
31424,1,512,512,512.00,0.00,23170,23171
31425,1,512,512,512.00,0.00,23170,23171
31426,2,485,27,256.00,52441.00,23170,23172
31427,1,512,512,512.00,0.00,23171,23172
31428,1,512,512,512.00,0.00,23171,23172
31429,1,512,512,512.00,0.00,23171,23172
31430,1,512,512,512.00,0.00,23171,23172
31431,2,305,207,256.00,2401.00,23171,23173
31432,1,512,512,512.00,0.00,23172,23173
31433,1,512,512,512.00,0.00,23172,23173
31434,1,512,512,512.00,0.00,23172,23173
31435,2,398,114,256.00,20164.00,23172,23174
31436,1,512,512,512.00,0.00,23173,23174
31437,1,512,512,512.00,0.00,23173,23174
31438,1,512,512,512.00,0.00,23173,23174
31439,1,512,512,512.00,0.00,23173,23174
31440,2,336,176,256.00,6400.00,23173,23175
31441,6,150,23,85.33,1534.22,23174,23180
31442,2,386,126,256.00,16900.00,23179,23181
31443,1,512,512,512.00,0.00,23180,23181
31444,1,512,512,512.00,0.00,23180,23181
31445,3,196,131,170.67,806.89,23180,23183
31446,1,512,512,512.00,0.00,23182,23183
31447,1,512,512,512.00,0.00,23182,23183
31448,1,512,512,512.00,0.00,23182,23183
31449,1,512,512,512.00,0.00,23182,23183
31450,1,512,512,512.00,0.00,23182,23183
31451,1,512,512,512.00,0.00,23182,23183
31452,2,469,43,256.00,45369.00,23182,23184
31453,2,287,225,256.00,961.00,23183,23185
31454,3,345,21,170.67,17800.22,23184,23187
31455,4,335,22,128.00,14799.50,23186,23190
31456,1,512,512,512.00,0.00,23189,23190
31457,1,512,512,512.00,0.00,23189,23190
31458,1,512,512,512.00,0.00,23189,23190
31459,3,206,131,170.67,946.89,23189,23192
31460,2,339,173,256.00,6889.00,23191,23193
31461,1,512,512,512.00,0.00,23192,23193
31462,1,512,512,512.00,0.00,23192,23193
31463,5,233,11,102.40,7116.64,23192,23197
31464,1,512,512,512.00,0.00,23196,23197
31465,1,512,512,512.00,0.00,23196,23197
31466,2,474,38,256.00,47524.00,23196,23198
31467,2,277,235,256.00,441.00,23197,23199
31468,1,512,512,512.00,0.00,23198,23199
31469,3,472,16,170.67,45411.56,23198,23201
31470,4,275,15,128.00,8741.00,23200,23204
31471,1,512,512,512.00,0.00,23203,23204
31472,1,512,512,512.00,0.00,23203,23204
31473,2,462,50,256.00,42436.00,23203,23205
31474,2,392,120,256.00,18496.00,23204,23206
31475,5,302,1,102.40,15321.84,23205,23210
31476,2,441,71,256.00,34225.00,23209,23211
31477,3,312,65,170.67,10804.22,23210,23213
31478,5,238,10,102.40,6810.24,23212,23217
31479,1,512,512,512.00,0.00,23216,23217
31480,4,397,5,128.00,25737.50,23216,23220
31481,1,512,512,512.00,0.00,23219,23220
31482,1,512,512,512.00,0.00,23219,23220
31483,3,288,94,170.67,7099.56,23219,23222
31484,1,512,512,512.00,0.00,23221,23222
31485,2,380,132,256.00,15376.00,23221,23223
31486,2,350,162,256.00,8836.00,23222,23224
31487,1,512,512,512.00,0.00,23223,23224
31488,1,512,512,512.00,0.00,23223,23224
31489,2,265,247,256.00,81.00,23223,23225
31490,2,445,67,256.00,35721.00,23224,23226
31491,3,417,23,170.67,30740.22,23225,23228
31492,6,213,2,85.33,6099.22,23227,23233
31493,1,512,512,512.00,0.00,23232,23233
31494,1,512,512,512.00,0.00,23232,23233
31495,1,512,512,512.00,0.00,23232,23233
31496,4,364,1,128.00,20182.50,23232,23236
31497,1,512,512,512.00,0.00,23235,23236
31498,1,512,512,512.00,0.00,23235,23236
31499,2,471,41,256.00,46225.00,23235,23237
31500,2,272,240,256.00,256.00,23236,23238
31501,4,349,14,128.00,16981.50,23237,23241
31502,2,421,91,256.00,27225.00,23240,23242
31503,6,279,4,85.33,10119.56,23241,23247
31504,1,512,512,512.00,0.00,23246,23247
31505,2,356,156,256.00,10000.00,23246,23248
31506,2,320,192,256.00,4096.00,23247,23249
31507,1,512,512,512.00,0.00,23248,23249
31508,1,512,512,512.00,0.00,23248,23249
31509,4,480,4,128.00,41326.00,23248,23252
31510,1,512,512,512.00,0.00,23251,23252
31511,1,512,512,512.00,0.00,23251,23252
31512,2,346,166,256.00,8100.00,23251,23253
31513,2,290,222,256.00,1156.00,23252,23254
31514,2,319,193,256.00,3969.00,23253,23255
31515,1,512,512,512.00,0.00,23254,23255
31516,1,512,512,512.00,0.00,23254,23255
31517,2,476,36,256.00,48400.00,23254,23256
31518,1,512,512,512.00,0.00,23255,23256
31519,1,512,512,512.00,0.00,23255,23256
31520,1,512,512,512.00,0.00,23255,23256
31521,1,512,512,512.00,0.00,23255,23256
31522,1,512,512,512.00,0.00,23255,23256
31523,3,317,22,170.67,14506.89,23255,23258
31524,2,427,85,256.00,29241.00,23257,23259
31525,2,460,52,256.00,41616.00,23258,23260
31526,4,251,61,128.00,5328.50,23259,23263
31527,1,512,512,512.00,0.00,23262,23263
31528,4,252,10,128.00,10142.00,23262,23266
31529,1,512,512,512.00,0.00,23265,23266
31530,2,358,154,256.00,10404.00,23265,23267
31531,1,512,512,512.00,0.00,23266,23267
31532,1,512,512,512.00,0.00,23266,23267
31533,1,512,512,512.00,0.00,23266,23267
31534,3,425,39,170.67,32356.22,23266,23269
31535,2,438,74,256.00,33124.00,23268,23270
31536,1,512,512,512.00,0.00,23269,23270
31537,1,512,512,512.00,0.00,23269,23270
31538,2,327,185,256.00,5041.00,23269,23271
31539,1,512,512,512.00,0.00,23270,23271
31540,1,512,512,512.00,0.00,23270,23271
31541,1,512,512,512.00,0.00,23270,23271
31542,1,512,512,512.00,0.00,23270,23271
31543,1,512,512,512.00,0.00,23270,23271
31544,1,512,512,512.00,0.00,23270,23271
31545,2,334,178,256.00,6084.00,23270,23272
31546,1,512,512,512.00,0.00,23271,23272
31547,1,512,512,512.00,0.00,23271,23272
31548,3,430,17,170.67,34010.89,23271,23274
31549,1,512,512,512.00,0.00,23273,23274
31550,3,445,30,170.67,37637.56,23273,23276
31551,2,358,154,256.00,10404.00,23275,23277
31552,1,512,512,512.00,0.00,23276,23277
31553,1,512,512,512.00,0.00,23276,23277
31554,2,305,207,256.00,2401.00,23276,23278
31555,1,512,512,512.00,0.00,23277,23278
31556,4,380,1,128.00,22989.50,23277,23281
31557,3,442,18,170.67,37003.56,23280,23283
31558,1,512,512,512.00,0.00,23282,23283
31559,2,405,107,256.00,22201.00,23282,23284
31560,2,459,53,256.00,41209.00,23283,23285
31561,1,512,512,512.00,0.00,23284,23285
31562,4,474,3,128.00,39941.50,23284,23288
31563,2,427,85,256.00,29241.00,23287,23289
31564,1,512,512,512.00,0.00,23288,23289
31565,2,369,143,256.00,12769.00,23288,23290
31566,1,512,512,512.00,0.00,23289,23290
31567,2,385,127,256.00,16641.00,23289,23291
31568,1,512,512,512.00,0.00,23290,23291
31569,1,512,512,512.00,0.00,23290,23291
31570,2,485,27,256.00,52441.00,23290,23292
31571,1,512,512,512.00,0.00,23291,23292
31572,1,512,512,512.00,0.00,23291,23292
31573,2,257,255,256.00,1.00,23291,23293
31574,2,363,149,256.00,11449.00,23292,23294
31575,1,512,512,512.00,0.00,23293,23294
31576,1,512,512,512.00,0.00,23293,23294
31577,1,512,512,512.00,0.00,23293,23294
31578,2,320,192,256.00,4096.00,23293,23295
31579,1,512,512,512.00,0.00,23294,23295
31580,1,512,512,512.00,0.00,23294,23295
31581,2,283,229,256.00,729.00,23294,23296
31582,1,512,512,512.00,0.00,23295,23296
31583,1,512,512,512.00,0.00,23295,23296
31584,2,392,120,256.00,18496.00,23295,23297
31585,1,512,512,512.00,0.00,23296,23297
31586,2,502,10,256.00,60516.00,23296,23298
31587,1,512,512,512.00,0.00,23297,23298
31588,3,449,8,170.67,39102.89,23297,23300
31589,1,512,512,512.00,0.00,23299,23300
31590,1,512,512,512.00,0.00,23299,23300
31591,1,512,512,512.00,0.00,23299,23300
31592,2,341,171,256.00,7225.00,23299,23301
31593,1,512,512,512.00,0.00,23300,23301
31594,1,512,512,512.00,0.00,23300,23301
31595,2,470,42,256.00,45796.00,23300,23302
31596,1,512,512,512.00,0.00,23301,23302
31597,1,512,512,512.00,0.00,23301,23302
31598,11,246,1,46.55,6902.79,23301,23312
31599,2,387,125,256.00,17161.00,23311,23313
31600,1,512,512,512.00,0.00,23312,23313
31601,1,512,512,512.00,0.00,23312,23313
31602,2,277,235,256.00,441.00,23312,23314
31603,2,282,230,256.00,676.00,23313,23315
31604,1,512,512,512.00,0.00,23314,23315
31605,1,512,512,512.00,0.00,23314,23315
31606,1,512,512,512.00,0.00,23314,23315
31607,1,512,512,512.00,0.00,23314,23315
31608,2,409,103,256.00,23409.00,23314,23316
31609,1,512,512,512.00,0.00,23315,23316
31610,1,512,512,512.00,0.00,23315,23316
31611,1,512,512,512.00,0.00,23315,23316
31612,2,414,98,256.00,24964.00,23315,23317
31613,1,512,512,512.00,0.00,23316,23317
31614,1,512,512,512.00,0.00,23316,23317
31615,1,512,512,512.00,0.00,23316,23317
31616,1,512,512,512.00,0.00,23316,23317
31617,2,501,11,256.00,60025.00,23316,23318
31618,1,512,512,512.00,0.00,23317,23318
31619,2,482,30,256.00,51076.00,23317,23319
31620,2,334,178,256.00,6084.00,23318,23320
31621,4,209,6,128.00,5649.50,23319,23323
31622,1,512,512,512.00,0.00,23322,23323
31623,1,512,512,512.00,0.00,23322,23323
31624,3,292,1,170.67,15281.56,23322,23325
31625,3,363,60,170.67,18636.22,23324,23327
31626,1,512,512,512.00,0.00,23326,23327
31627,1,512,512,512.00,0.00,23326,23327
31628,1,512,512,512.00,0.00,23326,23327
31629,1,512,512,512.00,0.00,23326,23327
31630,1,512,512,512.00,0.00,23326,23327
31631,1,512,512,512.00,0.00,23326,23327
31632,1,512,512,512.00,0.00,23326,23327
31633,4,205,17,128.00,6059.00,23326,23330
31634,1,512,512,512.00,0.00,23329,23330
31635,1,512,512,512.00,0.00,23329,23330
31636,6,260,1,85.33,7341.89,23329,23335
31637,6,383,2,85.33,17964.56,23334,23340
31638,1,512,512,512.00,0.00,23339,23340
31639,1,512,512,512.00,0.00,23339,23340
31640,1,512,512,512.00,0.00,23339,23340
31641,2,489,23,256.00,54289.00,23339,23341
31642,2,393,119,256.00,18769.00,23340,23342
31643,1,512,512,512.00,0.00,23341,23342
31644,1,512,512,512.00,0.00,23341,23342
31645,1,512,512,512.00,0.00,23341,23342
31646,3,336,20,170.67,16750.22,23341,23344
31647,1,512,512,512.00,0.00,23343,23344
31648,1,512,512,512.00,0.00,23343,23344
31649,1,512,512,512.00,0.00,23343,23344
31650,1,512,512,512.00,0.00,23343,23344
31651,3,410,40,170.67,28720.89,23343,23346
31652,2,361,151,256.00,11025.00,23345,23347
31653,1,512,512,512.00,0.00,23346,23347
31654,1,512,512,512.00,0.00,23346,23347
31655,2,279,233,256.00,529.00,23346,23348
31656,1,512,512,512.00,0.00,23347,23348
31657,1,512,512,512.00,0.00,23347,23348
31658,8,140,3,64.00,1822.50,23347,23355
31659,5,370,1,102.40,18575.44,23354,23359
31660,6,390,1,85.33,20092.56,23358,23364
31661,1,512,512,512.00,0.00,23363,23364
31662,4,415,2,128.00,28791.50,23363,23367
31663,1,512,512,512.00,0.00,23366,23367
31664,1,512,512,512.00,0.00,23366,23367
31665,1,512,512,512.00,0.00,23366,23367
31666,6,184,1,85.33,5626.89,23366,23372
31667,2,382,130,256.00,15876.00,23371,23373
31668,1,512,512,512.00,0.00,23372,23373
31669,2,278,234,256.00,484.00,23372,23374
31670,2,260,252,256.00,16.00,23373,23375
31671,2,462,50,256.00,42436.00,23374,23376
31672,1,512,512,512.00,0.00,23375,23376
31673,1,512,512,512.00,0.00,23375,23376
31674,1,512,512,512.00,0.00,23375,23376
31675,1,512,512,512.00,0.00,23375,23376
31676,2,312,200,256.00,3136.00,23375,23377
31677,1,512,512,512.00,0.00,23376,23377
31678,1,512,512,512.00,0.00,23376,23377
31679,1,512,512,512.00,0.00,23376,23377
31680,5,341,6,102.40,15101.84,23376,23381
31681,3,468,7,170.67,44353.56,23380,23383
31682,2,353,159,256.00,9409.00,23382,23384
31683,1,512,512,512.00,0.00,23383,23384
31684,2,429,83,256.00,29929.00,23383,23385
31685,1,512,512,512.00,0.00,23384,23385
31686,3,294,17,170.67,13248.22,23384,23387
31687,1,512,512,512.00,0.00,23386,23387
31688,2,422,90,256.00,27556.00,23386,23388
31689,2,471,41,256.00,46225.00,23387,23389
31690,1,512,512,512.00,0.00,23388,23389
31691,11,140,1,46.55,3052.43,23388,23399
31692,2,351,161,256.00,9025.00,23398,23400
31693,1,512,512,512.00,0.00,23399,23400
31694,1,512,512,512.00,0.00,23399,23400
31695,2,397,115,256.00,19881.00,23399,23401
31696,1,512,512,512.00,0.00,23400,23401
31697,1,512,512,512.00,0.00,23400,23401
31698,2,397,115,256.00,19881.00,23400,23402
31699,2,493,19,256.00,56169.00,23401,23403
31700,2,411,101,256.00,24025.00,23402,23404
31701,1,512,512,512.00,0.00,23403,23404
31702,2,472,40,256.00,46656.00,23403,23405
31703,1,512,512,512.00,0.00,23404,23405
31704,1,512,512,512.00,0.00,23404,23405
31705,6,150,30,85.33,2233.89,23404,23410
31706,1,512,512,512.00,0.00,23409,23410
31707,1,512,512,512.00,0.00,23409,23410
31708,2,464,48,256.00,43264.00,23409,23411
31709,3,432,3,170.67,35060.22,23410,23413
31710,1,512,512,512.00,0.00,23412,23413
31711,2,439,73,256.00,33489.00,23412,23414
31712,1,512,512,512.00,0.00,23413,23414
31713,1,512,512,512.00,0.00,23413,23414
31714,8,260,1,64.00,7131.50,23413,23421
31715,3,293,29,170.67,11802.89,23420,23423
31716,1,512,512,512.00,0.00,23422,23423
31717,6,288,16,85.33,9334.56,23422,23428
31718,3,369,70,170.67,19669.56,23427,23430
31719,3,444,1,170.67,38081.56,23429,23432
31720,3,405,3,170.67,29156.22,23431,23434
31721,1,512,512,512.00,0.00,23433,23434
31722,3,367,15,170.67,21477.56,23433,23436
31723,3,367,8,170.67,22046.89,23435,23438
31724,1,512,512,512.00,0.00,23437,23438
31725,1,512,512,512.00,0.00,23437,23438
31726,2,398,114,256.00,20164.00,23437,23439
31727,1,512,512,512.00,0.00,23438,23439
31728,1,512,512,512.00,0.00,23438,23439
31729,7,310,1,73.14,10947.84,23438,23445
31730,1,512,512,512.00,0.00,23444,23445
31731,4,328,13,128.00,16837.50,23444,23448
31732,2,260,252,256.00,16.00,23447,23449
31733,1,512,512,512.00,0.00,23448,23449
31734,1,512,512,512.00,0.00,23448,23449
31735,3,271,97,170.67,5401.56,23448,23451
31736,1,512,512,512.00,0.00,23450,23451
31737,1,512,512,512.00,0.00,23450,23451
31738,1,512,512,512.00,0.00,23450,23451
31739,1,512,512,512.00,0.00,23450,23451
31740,1,512,512,512.00,0.00,23450,23451
31741,1,512,512,512.00,0.00,23450,23451
31742,2,418,94,256.00,26244.00,23450,23452
31743,2,387,125,256.00,17161.00,23451,23453
31744,2,265,247,256.00,81.00,23452,23454
31745,1,512,512,512.00,0.00,23453,23454
31746,1,512,512,512.00,0.00,23453,23454
31747,2,366,146,256.00,12100.00,23453,23455
31748,4,492,1,128.00,44213.50,23454,23458
31749,1,512,512,512.00,0.00,23457,23458
31750,1,512,512,512.00,0.00,23457,23458
31751,1,512,512,512.00,0.00,23457,23458
31752,2,279,233,256.00,529.00,23457,23459
31753,1,512,512,512.00,0.00,23458,23459
31754,1,512,512,512.00,0.00,23458,23459
31755,2,317,195,256.00,3721.00,23458,23460
31756,2,409,103,256.00,23409.00,23459,23461
31757,1,512,512,512.00,0.00,23460,23461
31758,1,512,512,512.00,0.00,23460,23461
31759,6,152,17,85.33,1919.56,23460,23466
31760,5,232,5,102.40,8318.64,23465,23470
31761,1,512,512,512.00,0.00,23469,23470
31762,2,389,123,256.00,17689.00,23469,23471
31763,3,281,7,170.67,13934.89,23470,23473
31764,2,484,28,256.00,51984.00,23472,23474
31765,3,451,4,170.67,39761.56,23473,23476
31766,1,512,512,512.00,0.00,23475,23476
31767,1,512,512,512.00,0.00,23475,23476
31768,1,512,512,512.00,0.00,23475,23476
31769,4,284,1,128.00,15892.50,23475,23479
31770,2,508,4,256.00,63504.00,23479,23481
31771,1,512,512,512.00,0.00,23480,23481
31772,1,512,512,512.00,0.00,23480,23481
31773,2,436,76,256.00,32400.00,23480,23482
31774,1,512,512,512.00,0.00,23481,23482
31775,1,512,512,512.00,0.00,23481,23482
31776,4,325,6,128.00,15504.50,23481,23485
31777,1,512,512,512.00,0.00,23484,23485
31778,2,509,3,256.00,64009.00,23484,23486
31779,2,454,58,256.00,39204.00,23485,23487
31780,1,512,512,512.00,0.00,23486,23487
31781,1,512,512,512.00,0.00,23486,23487
31782,2,388,124,256.00,17424.00,23486,23488
31783,4,445,17,128.00,33531.50,23487,23491
31784,1,512,512,512.00,0.00,23490,23491
31785,5,227,2,102.40,7122.24,23490,23495
31786,3,486,3,170.67,49784.22,23494,23497
31787,4,371,2,128.00,22653.50,23496,23500
31788,1,512,512,512.00,0.00,23499,23500
31789,1,512,512,512.00,0.00,23499,23500
31790,4,266,12,128.00,8187.50,23499,23503
31791,7,320,1,73.14,10672.69,23502,23509
31792,2,256,256,256.00,0.00,23508,23510
31793,2,286,226,256.00,900.00,23509,23511
31794,5,183,14,102.40,4890.64,23510,23515
31795,2,379,133,256.00,15129.00,23514,23516
31796,1,512,512,512.00,0.00,23515,23516
31797,1,512,512,512.00,0.00,23515,23516
31798,4,322,2,128.00,17568.50,23515,23519
31799,1,512,512,512.00,0.00,23518,23519
31800,1,512,512,512.00,0.00,23518,23519
31801,2,461,51,256.00,42025.00,23518,23520
31802,2,490,22,256.00,54756.00,23519,23521
31803,2,385,127,256.00,16641.00,23520,23522
31804,1,512,512,512.00,0.00,23521,23522
31805,2,474,38,256.00,47524.00,23521,23523
31806,2,504,8,256.00,61504.00,23522,23524
31807,1,512,512,512.00,0.00,23523,23524
31808,1,512,512,512.00,0.00,23523,23524
31809,2,418,94,256.00,26244.00,23523,23525
31810,2,419,93,256.00,26569.00,23524,23526
31811,2,484,28,256.00,51984.00,23525,23527
31812,1,512,512,512.00,0.00,23526,23527
31813,3,422,6,170.67,32598.22,23526,23529
31814,1,512,512,512.00,0.00,23529,23530
31815,4,280,1,128.00,10117.50,23529,23533
31816,1,512,512,512.00,0.00,23532,23533
31817,3,273,33,170.67,10224.22,23532,23535
31818,4,354,2,128.00,20726.00,23534,23538
31819,4,248,9,128.00,10543.50,23537,23541
31820,5,445,2,102.40,29493.44,23540,23545
31821,5,359,1,102.40,17103.44,23544,23549
31822,1,512,512,512.00,0.00,23548,23549
31823,1,512,512,512.00,0.00,23548,23549
31824,2,392,120,256.00,18496.00,23548,23550
31825,1,512,512,512.00,0.00,23549,23550
31826,3,253,29,170.67,10122.89,23549,23552
31827,1,512,512,512.00,0.00,23551,23552
31828,1,512,512,512.00,0.00,23551,23552
31829,3,311,67,170.67,10594.89,23551,23554
31830,1,512,512,512.00,0.00,23553,23554
31831,6,267,2,85.33,10990.22,23553,23559
31832,1,512,512,512.00,0.00,23558,23559
31833,7,285,1,73.14,11540.69,23558,23565
31834,2,454,58,256.00,39204.00,23564,23566
31835,1,512,512,512.00,0.00,23565,23566
31836,1,512,512,512.00,0.00,23565,23566
31837,1,512,512,512.00,0.00,23565,23566
31838,1,512,512,512.00,0.00,23565,23566
31839,2,466,46,256.00,44100.00,23565,23567
31840,1,512,512,512.00,0.00,23566,23567
31841,2,374,138,256.00,13924.00,23566,23568
31842,1,512,512,512.00,0.00,23567,23568
31843,3,313,3,170.67,16337.56,23567,23570
31844,3,464,15,170.67,43076.22,23569,23572
31845,1,512,512,512.00,0.00,23571,23572
31846,7,292,2,73.14,9115.27,23571,23578
31847,1,512,512,512.00,0.00,23577,23578
31848,6,253,1,85.33,9252.89,23577,23583
31849,1,512,512,512.00,0.00,23582,23583
31850,1,512,512,512.00,0.00,23582,23583
31851,2,266,246,256.00,100.00,23582,23584
31852,1,512,512,512.00,0.00,23583,23584
31853,1,512,512,512.00,0.00,23583,23584
31854,2,278,234,256.00,484.00,23583,23585
31855,3,340,20,170.67,17240.89,23584,23587
31856,1,512,512,512.00,0.00,23586,23587
31857,1,512,512,512.00,0.00,23586,23587
31858,1,512,512,512.00,0.00,23586,23587
31859,2,272,240,256.00,256.00,23586,23588
31860,1,512,512,512.00,0.00,23587,23588
31861,1,512,512,512.00,0.00,23587,23588
31862,4,205,67,128.00,2809.00,23587,23591
31863,1,512,512,512.00,0.00,23590,23591
31864,1,512,512,512.00,0.00,23590,23591
31865,2,504,8,256.00,61504.00,23590,23592
31866,2,351,161,256.00,9025.00,23591,23593
31867,2,460,52,256.00,41616.00,23592,23594
31868,4,393,14,128.00,24120.50,23593,23597
31869,1,512,512,512.00,0.00,23596,23597
31870,4,200,39,128.00,4302.50,23596,23600
31871,1,512,512,512.00,0.00,23599,23600
31872,1,512,512,512.00,0.00,23599,23600
31873,1,512,512,512.00,0.00,23599,23600
31874,1,512,512,512.00,0.00,23599,23600
31875,5,187,4,102.40,5263.44,23599,23604
31876,1,512,512,512.00,0.00,23603,23604
31877,1,512,512,512.00,0.00,23603,23604
31878,2,317,195,256.00,3721.00,23603,23605
31879,2,501,11,256.00,60025.00,23604,23606
31880,5,245,1,102.40,10986.24,23605,23610
31881,2,410,102,256.00,23716.00,23609,23611
31882,1,512,512,512.00,0.00,23610,23611
31883,2,506,6,256.00,62500.00,23610,23612
31884,2,430,82,256.00,30276.00,23611,23613
31885,1,512,512,512.00,0.00,23612,23613
31886,1,512,512,512.00,0.00,23612,23613
31887,2,313,199,256.00,3249.00,23612,23614
31888,1,512,512,512.00,0.00,23613,23614
31889,4,411,3,128.00,28017.00,23613,23617
31890,1,512,512,512.00,0.00,23616,23617
31891,3,461,6,170.67,42400.22,23616,23619
31892,2,392,120,256.00,18496.00,23618,23620
31893,2,450,62,256.00,37636.00,23619,23621
31894,1,512,512,512.00,0.00,23620,23621
31895,2,291,221,256.00,1225.00,23620,23622
31896,1,512,512,512.00,0.00,23621,23622
31897,1,512,512,512.00,0.00,23621,23622
31898,1,512,512,512.00,0.00,23621,23622
31899,1,512,512,512.00,0.00,23621,23622
31900,2,377,135,256.00,14641.00,23621,23623
31901,1,512,512,512.00,0.00,23622,23623
31902,3,336,25,170.67,16313.56,23622,23625
31903,2,320,192,256.00,4096.00,23624,23626
31904,1,512,512,512.00,0.00,23625,23626
31905,1,512,512,512.00,0.00,23625,23626
31906,1,512,512,512.00,0.00,23625,23626
31907,1,512,512,512.00,0.00,23625,23626
31908,1,512,512,512.00,0.00,23625,23626
31909,2,363,149,256.00,11449.00,23625,23627
31910,1,512,512,512.00,0.00,23626,23627
31911,1,512,512,512.00,0.00,23626,23627
31912,2,308,204,256.00,2704.00,23626,23628
31913,1,512,512,512.00,0.00,23627,23628
31914,1,512,512,512.00,0.00,23627,23628
31915,4,429,2,128.00,31008.50,23627,23631
31916,4,295,2,128.00,14001.50,23630,23634
31917,1,512,512,512.00,0.00,23633,23634
31918,1,512,512,512.00,0.00,23633,23634
31919,2,362,150,256.00,11236.00,23634,23636
31920,2,388,124,256.00,17424.00,23635,23637
31921,1,512,512,512.00,0.00,23636,23637
31922,2,311,201,256.00,3025.00,23636,23638
31923,3,356,49,170.67,17734.89,23637,23640
31924,8,345,2,64.00,11802.75,23639,23647
31925,4,424,21,128.00,29267.50,23646,23650
31926,3,467,2,170.67,44186.89,23649,23652
31927,3,311,85,170.67,10006.89,23651,23654
31928,6,288,1,85.33,11697.89,23653,23659
31929,3,435,3,170.67,35776.22,23658,23661
31930,1,512,512,512.00,0.00,23660,23661
31931,3,288,50,170.67,9446.22,23660,23663
31932,1,512,512,512.00,0.00,23662,23663
31933,3,402,27,170.67,27280.22,23662,23665
31934,1,512,512,512.00,0.00,23664,23665
31935,2,423,89,256.00,27889.00,23664,23666
31936,1,512,512,512.00,0.00,23665,23666
31937,2,510,2,256.00,64516.00,23665,23667
31938,1,512,512,512.00,0.00,23666,23667
31939,1,512,512,512.00,0.00,23666,23667
31940,1,512,512,512.00,0.00,23666,23667
31941,1,512,512,512.00,0.00,23666,23667
31942,1,512,512,512.00,0.00,23666,23667
31943,3,391,44,170.67,24454.89,23666,23669
31944,1,512,512,512.00,0.00,23668,23669
31945,1,512,512,512.00,0.00,23668,23669
31946,2,477,35,256.00,48841.00,23668,23670
31947,1,512,512,512.00,0.00,23669,23670
31948,1,512,512,512.00,0.00,23669,23670
31949,1,512,512,512.00,0.00,23669,23670
31950,2,403,109,256.00,21609.00,23669,23671
31951,1,512,512,512.00,0.00,23670,23671
31952,1,512,512,512.00,0.00,23670,23671
31953,1,512,512,512.00,0.00,23670,23671
31954,2,330,182,256.00,5476.00,23670,23672
31955,1,512,512,512.00,0.00,23671,23672
31956,1,512,512,512.00,0.00,23671,23672
31957,1,512,512,512.00,0.00,23671,23672
31958,3,371,64,170.67,20094.89,23671,23674
31959,3,233,113,170.67,2410.89,23673,23676
31960,6,207,1,85.33,5096.89,23675,23681
31961,1,512,512,512.00,0.00,23680,23681
31962,1,512,512,512.00,0.00,23680,23681
31963,1,512,512,512.00,0.00,23680,23681
31964,1,512,512,512.00,0.00,23680,23681
31965,2,486,26,256.00,52900.00,23680,23682
31966,6,333,22,85.33,12322.89,23681,23687
31967,1,512,512,512.00,0.00,23686,23687
31968,1,512,512,512.00,0.00,23686,23687
31969,1,512,512,512.00,0.00,23686,23687
31970,3,305,42,170.67,11544.22,23686,23689
31971,1,512,512,512.00,0.00,23688,23689
31972,1,512,512,512.00,0.00,23688,23689
31973,1,512,512,512.00,0.00,23688,23689
31974,4,344,2,128.00,16706.00,23688,23692
31975,1,512,512,512.00,0.00,23691,23692
31976,1,512,512,512.00,0.00,23691,23692
31977,1,512,512,512.00,0.00,23691,23692
31978,1,512,512,512.00,0.00,23691,23692
31979,8,162,3,64.00,2321.50,23691,23699
31980,1,512,512,512.00,0.00,23698,23699
31981,1,512,512,512.00,0.00,23698,23699
31982,2,281,231,256.00,625.00,23698,23700
31983,1,512,512,512.00,0.00,23699,23700
31984,1,512,512,512.00,0.00,23699,23700
31985,1,512,512,512.00,0.00,23699,23700
31986,4,401,1,128.00,25353.50,23699,23703
31987,3,364,6,170.67,21771.56,23702,23705
31988,1,512,512,512.00,0.00,23704,23705
31989,1,512,512,512.00,0.00,23704,23705
31990,1,512,512,512.00,0.00,23704,23705
31991,1,512,512,512.00,0.00,23704,23705
31992,2,506,6,256.00,62500.00,23704,23706
31993,1,512,512,512.00,0.00,23705,23706
31994,1,512,512,512.00,0.00,23705,23706
31995,2,354,158,256.00,9604.00,23705,23707
31996,1,512,512,512.00,0.00,23706,23707
31997,3,323,53,170.67,12750.89,23706,23709
31998,1,512,512,512.00,0.00,23708,23709
31999,1,512,512,512.00,0.00,23708,23709
32000,6,305,1,85.33,11903.56,23708,23714
32001,1,512,512,512.00,0.00,23713,23714
32002,1,512,512,512.00,0.00,23713,23714
32003,2,457,55,256.00,40401.00,23713,23715
32004,1,512,512,512.00,0.00,23714,23715
32005,1,512,512,512.00,0.00,23714,23715
32006,3,202,131,170.67,874.89,23714,23717
32007,2,385,127,256.00,16641.00,23716,23718
32008,5,418,6,102.40,25082.64,23717,23722
32009,1,512,512,512.00,0.00,23721,23722
32010,1,512,512,512.00,0.00,23721,23722
32011,2,349,163,256.00,8649.00,23721,23723
32012,3,249,112,170.67,3321.56,23722,23725
32013,1,512,512,512.00,0.00,23724,23725
32014,1,512,512,512.00,0.00,23724,23725
32015,3,271,36,170.67,9793.56,23724,23727
32016,1,512,512,512.00,0.00,23726,23727
32017,1,512,512,512.00,0.00,23726,23727
32018,1,512,512,512.00,0.00,23726,23727
32019,2,435,77,256.00,32041.00,23726,23728
32020,1,512,512,512.00,0.00,23727,23728
32021,1,512,512,512.00,0.00,23727,23728
32022,4,407,8,128.00,26265.50,23727,23731
32023,1,512,512,512.00,0.00,23730,23731
32024,5,329,8,102.40,15740.24,23730,23735
32025,2,495,17,256.00,57121.00,23734,23736
32026,1,512,512,512.00,0.00,23735,23736
32027,2,257,255,256.00,1.00,23735,23737
32028,1,512,512,512.00,0.00,23736,23737
32029,1,512,512,512.00,0.00,23736,23737
32030,3,300,2,170.67,15574.22,23736,23739
32031,1,512,512,512.00,0.00,23738,23739
32032,2,413,99,256.00,24649.00,23738,23740
32033,1,512,512,512.00,0.00,23739,23740
32034,1,512,512,512.00,0.00,23739,23740
32035,2,301,211,256.00,2025.00,23739,23741
32036,1,512,512,512.00,0.00,23740,23741
32037,1,512,512,512.00,0.00,23740,23741
32038,1,512,512,512.00,0.00,23740,23741
32039,2,320,192,256.00,4096.00,23740,23742
32040,2,343,169,256.00,7569.00,23741,23743
32041,1,512,512,512.00,0.00,23742,23743
32042,1,512,512,512.00,0.00,23742,23743
32043,1,512,512,512.00,0.00,23742,23743
32044,4,202,2,128.00,6068.00,23742,23746
32045,3,264,28,170.67,10499.56,23745,23748
32046,1,512,512,512.00,0.00,23747,23748
32047,1,512,512,512.00,0.00,23747,23748
32048,2,403,109,256.00,21609.00,23747,23749
32049,1,512,512,512.00,0.00,23748,23749
32050,2,319,193,256.00,3969.00,23748,23750
32051,1,512,512,512.00,0.00,23749,23750
32052,1,512,512,512.00,0.00,23749,23750
32053,1,512,512,512.00,0.00,23749,23750
32054,2,471,41,256.00,46225.00,23749,23751
32055,2,382,130,256.00,15876.00,23750,23752
32056,1,512,512,512.00,0.00,23751,23752
32057,1,512,512,512.00,0.00,23751,23752
32058,1,512,512,512.00,0.00,23751,23752
32059,2,379,133,256.00,15129.00,23751,23753
32060,1,512,512,512.00,0.00,23752,23753
32061,1,512,512,512.00,0.00,23752,23753
32062,3,284,104,170.67,6488.89,23752,23755
32063,1,512,512,512.00,0.00,23754,23755
32064,1,512,512,512.00,0.00,23754,23755
32065,4,316,3,128.00,13799.50,23754,23758
32066,1,512,512,512.00,0.00,23757,23758
32067,1,512,512,512.00,0.00,23757,23758
32068,1,512,512,512.00,0.00,23757,23758
32069,2,482,30,256.00,51076.00,23757,23759
32070,6,199,1,85.33,5631.89,23758,23764
32071,5,280,1,102.40,12870.64,23763,23768
32072,1,512,512,512.00,0.00,23767,23768
32073,1,512,512,512.00,0.00,23767,23768
32074,2,296,216,256.00,1600.00,23767,23769
32075,3,295,53,170.67,9782.89,23768,23771
32076,6,356,1,85.33,16812.56,23770,23776
32077,5,276,3,102.40,9683.44,23775,23780
32078,2,286,226,256.00,900.00,23779,23781
32079,5,194,1,102.40,5091.44,23780,23785
32080,1,512,512,512.00,0.00,23784,23785
32081,1,512,512,512.00,0.00,23784,23785
32082,1,512,512,512.00,0.00,23784,23785
32083,2,430,82,256.00,30276.00,23784,23786
32084,4,228,31,128.00,5448.50,23785,23789
32085,3,255,19,170.67,11549.56,23788,23791
32086,3,290,2,170.67,15040.89,23790,23793
32087,2,442,70,256.00,34596.00,23792,23794
32088,3,371,5,170.67,22926.89,23793,23796
32089,5,281,2,102.40,12788.24,23795,23800
32090,4,476,3,128.00,40413.50,23799,23803
32091,2,387,125,256.00,17161.00,23802,23804
32092,1,512,512,512.00,0.00,23803,23804
32093,4,248,81,128.00,4863.50,23803,23807
32094,3,207,152,170.67,660.22,23806,23809
32095,1,512,512,512.00,0.00,23808,23809
32096,3,259,15,170.67,12189.56,23808,23811
32097,1,512,512,512.00,0.00,23810,23811
32098,1,512,512,512.00,0.00,23810,23811
32099,2,363,149,256.00,11449.00,23810,23812
32100,1,512,512,512.00,0.00,23811,23812
32101,2,486,26,256.00,52900.00,23811,23813
32102,1,512,512,512.00,0.00,23812,23813
32103,4,462,12,128.00,37211.50,23812,23816
32104,1,512,512,512.00,0.00,23815,23816
32105,3,240,81,170.67,4420.22,23815,23818
32106,1,512,512,512.00,0.00,23817,23818
32107,1,512,512,512.00,0.00,23817,23818
32108,6,355,1,85.33,15952.22,23817,23823
32109,1,512,512,512.00,0.00,23822,23823
32110,1,512,512,512.00,0.00,23822,23823
32111,1,512,512,512.00,0.00,23822,23823
32112,2,400,112,256.00,20736.00,23822,23824
32113,1,512,512,512.00,0.00,23823,23824
32114,2,408,104,256.00,23104.00,23823,23825
32115,2,424,88,256.00,28224.00,23824,23826
32116,1,512,512,512.00,0.00,23825,23826
32117,3,359,45,170.67,18396.22,23825,23828
32118,3,224,109,170.67,2238.89,23827,23830
32119,1,512,512,512.00,0.00,23829,23830
32120,1,512,512,512.00,0.00,23829,23830
32121,1,512,512,512.00,0.00,23829,23830
32122,1,512,512,512.00,0.00,23829,23830
32123,6,168,2,85.33,3126.22,23829,23835
32124,2,384,128,256.00,16384.00,23834,23836
32125,1,512,512,512.00,0.00,23835,23836
32126,2,376,136,256.00,14400.00,23835,23837
32127,1,512,512,512.00,0.00,23836,23837
32128,1,512,512,512.00,0.00,23836,23837
32129,3,340,54,170.67,15019.56,23836,23839
32130,1,512,512,512.00,0.00,23838,23839
32131,5,152,3,102.40,2684.24,23838,23843
32132,1,512,512,512.00,0.00,23842,23843
32133,2,289,223,256.00,1089.00,23842,23844
32134,2,309,203,256.00,2809.00,23843,23845
32135,1,512,512,512.00,0.00,23844,23845
32136,6,305,3,85.33,12468.56,23844,23850
32137,1,512,512,512.00,0.00,23849,23850
32138,1,512,512,512.00,0.00,23849,23850
32139,2,467,45,256.00,44521.00,23849,23851
32140,1,512,512,512.00,0.00,23850,23851
32141,1,512,512,512.00,0.00,23850,23851
32142,4,388,25,128.00,22864.50,23850,23854
32143,5,257,6,102.40,8636.24,23853,23858
32144,2,301,211,256.00,2025.00,23857,23859
32145,2,354,158,256.00,9604.00,23858,23860
32146,1,512,512,512.00,0.00,23859,23860
32147,6,352,1,85.33,14996.56,23859,23865
32148,4,218,3,128.00,7462.50,23864,23868
32149,1,512,512,512.00,0.00,23867,23868
32150,3,419,37,170.67,30894.89,23867,23870
32151,4,264,1,128.00,15452.50,23869,23873
32152,1,512,512,512.00,0.00,23872,23873
32153,1,512,512,512.00,0.00,23872,23873
32154,2,348,164,256.00,8464.00,23872,23874
32155,1,512,512,512.00,0.00,23873,23874
32156,4,384,17,128.00,22263.50,23873,23877
32157,1,512,512,512.00,0.00,23876,23877
32158,1,512,512,512.00,0.00,23876,23877
32159,1,512,512,512.00,0.00,23876,23877
32160,2,450,62,256.00,37636.00,23876,23878
32161,1,512,512,512.00,0.00,23877,23878
32162,4,280,20,128.00,8938.50,23877,23881
32163,6,324,3,85.33,12128.89,23880,23886
32164,5,323,18,102.40,12491.84,23885,23890
32165,1,512,512,512.00,0.00,23889,23890
32166,2,261,251,256.00,25.00,23889,23891
32167,6,304,1,85.33,10503.22,23890,23896
32168,2,333,179,256.00,5929.00,23895,23897
32169,1,512,512,512.00,0.00,23896,23897
32170,1,512,512,512.00,0.00,23896,23897
32171,2,500,12,256.00,59536.00,23896,23898
32172,2,349,163,256.00,8649.00,23897,23899
32173,1,512,512,512.00,0.00,23898,23899
32174,1,512,512,512.00,0.00,23898,23899
32175,5,415,3,102.40,25292.64,23898,23903
32176,3,482,6,170.67,48518.22,23902,23905
32177,2,416,96,256.00,25600.00,23904,23906
32178,1,512,512,512.00,0.00,23905,23906
32179,1,512,512,512.00,0.00,23905,23906
32180,1,512,512,512.00,0.00,23905,23906
32181,2,364,148,256.00,11664.00,23905,23907
32182,2,379,133,256.00,15129.00,23906,23908
32183,1,512,512,512.00,0.00,23907,23908
32184,2,478,34,256.00,49284.00,23907,23909
32185,3,360,44,170.67,18606.22,23908,23911
32186,1,512,512,512.00,0.00,23910,23911
32187,1,512,512,512.00,0.00,23910,23911
32188,2,409,103,256.00,23409.00,23910,23912
32189,6,279,1,85.33,13626.89,23911,23917
32190,6,189,1,85.33,6743.56,23916,23922
32191,1,512,512,512.00,0.00,23921,23922
32192,1,512,512,512.00,0.00,23921,23922
32193,1,512,512,512.00,0.00,23921,23922
32194,2,477,35,256.00,48841.00,23921,23923
32195,1,512,512,512.00,0.00,23922,23923
32196,3,371,44,170.67,20534.89,23922,23925
32197,4,296,1,128.00,13644.50,23924,23928
32198,3,498,4,170.67,53579.56,23927,23930
32199,6,292,17,85.33,9449.22,23929,23935
32200,1,512,512,512.00,0.00,23934,23935
32201,3,323,75,170.67,11856.22,23934,23937
32202,1,512,512,512.00,0.00,23936,23937
32203,1,512,512,512.00,0.00,23936,23937
32204,4,275,6,128.00,9579.50,23936,23940
32205,5,163,2,102.40,3544.24,23939,23944
32206,2,440,72,256.00,33856.00,23943,23945
32207,1,512,512,512.00,0.00,23944,23945
32208,1,512,512,512.00,0.00,23944,23945
32209,1,512,512,512.00,0.00,23944,23945
32210,1,512,512,512.00,0.00,23944,23945
32211,1,512,512,512.00,0.00,23944,23945
32212,4,253,3,128.00,9860.50,23944,23948
32213,1,512,512,512.00,0.00,23947,23948
32214,5,299,8,102.40,11441.84,23947,23952
32215,5,418,4,102.40,25223.44,23951,23956
32216,1,512,512,512.00,0.00,23955,23956
32217,1,512,512,512.00,0.00,23955,23956
32218,1,512,512,512.00,0.00,23955,23956
32219,1,512,512,512.00,0.00,23955,23956
32220,1,512,512,512.00,0.00,23955,23956
32221,5,249,1,102.40,10237.44,23955,23960
32222,2,479,33,256.00,49729.00,23959,23961
32223,1,512,512,512.00,0.00,23960,23961
32224,3,288,13,170.67,13417.56,23960,23963
32225,3,451,17,170.67,39414.89,23962,23965
32226,2,488,24,256.00,53824.00,23964,23966
32227,1,512,512,512.00,0.00,23965,23966
32228,1,512,512,512.00,0.00,23965,23966
32229,1,512,512,512.00,0.00,23965,23966
32230,3,401,6,170.67,28160.22,23965,23968
32231,2,284,228,256.00,784.00,23967,23969
32232,1,512,512,512.00,0.00,23968,23969
32233,5,297,3,102.40,11504.64,23968,23973
32234,2,268,244,256.00,144.00,23972,23974
32235,3,249,27,170.67,10348.22,23973,23976
32236,1,512,512,512.00,0.00,23975,23976
32237,2,374,138,256.00,13924.00,23975,23977
32238,1,512,512,512.00,0.00,23976,23977
32239,1,512,512,512.00,0.00,23976,23977
32240,4,404,1,128.00,27027.50,23976,23980
32241,1,512,512,512.00,0.00,23979,23980
32242,1,512,512,512.00,0.00,23979,23980
32243,1,512,512,512.00,0.00,23979,23980
32244,1,512,512,512.00,0.00,23979,23980
32245,2,305,207,256.00,2401.00,23979,23981
32246,1,512,512,512.00,0.00,23980,23981
32247,6,210,3,85.33,4924.22,23980,23986
32248,2,437,75,256.00,32761.00,23985,23987
32249,1,512,512,512.00,0.00,23986,23987
32250,1,512,512,512.00,0.00,23986,23987
32251,3,451,1,170.67,39873.56,23986,23989
32252,1,512,512,512.00,0.00,23988,23989
32253,1,512,512,512.00,0.00,23988,23989
32254,1,512,512,512.00,0.00,23988,23989
32255,1,512,512,512.00,0.00,23988,23989
32256,1,512,512,512.00,0.00,23988,23989
32257,1,512,512,512.00,0.00,23988,23989
32258,1,512,512,512.00,0.00,23988,23989
32259,7,282,1,73.14,8856.98,23988,23995
32260,2,287,225,256.00,961.00,23994,23996
32261,1,512,512,512.00,0.00,23995,23996
32262,1,512,512,512.00,0.00,23995,23996
32263,2,455,57,256.00,39601.00,23995,23997
32264,1,512,512,512.00,0.00,23996,23997
32265,2,411,101,256.00,24025.00,23996,23998
32266,1,512,512,512.00,0.00,23997,23998
32267,1,512,512,512.00,0.00,23997,23998
32268,1,512,512,512.00,0.00,23997,23998
32269,4,335,1,128.00,18432.50,23997,24001
32270,2,416,96,256.00,25600.00,24000,24002
32271,1,512,512,512.00,0.00,24001,24002
32272,3,390,57,170.67,24064.22,24001,24004
32273,2,439,73,256.00,33489.00,24004,24006
32274,2,399,113,256.00,20449.00,24005,24007
32275,1,512,512,512.00,0.00,24006,24007
32276,1,512,512,512.00,0.00,24006,24007
32277,5,254,3,102.40,7270.64,24006,24011
32278,1,512,512,512.00,0.00,24010,24011
32279,4,434,5,128.00,31842.50,24010,24014
32280,2,469,43,256.00,45369.00,24013,24015
32281,1,512,512,512.00,0.00,24014,24015
32282,2,497,15,256.00,58081.00,24014,24016
32283,2,272,240,256.00,256.00,24015,24017
32284,2,382,130,256.00,15876.00,24016,24018
32285,1,512,512,512.00,0.00,24017,24018
32286,3,296,76,170.67,8536.89,24017,24020
32287,2,343,169,256.00,7569.00,24019,24021
32288,6,350,1,85.33,15330.89,24020,24026
32289,2,495,17,256.00,57121.00,24025,24027
32290,1,512,512,512.00,0.00,24026,24027
32291,1,512,512,512.00,0.00,24026,24027
32292,1,512,512,512.00,0.00,24026,24027
32293,1,512,512,512.00,0.00,24026,24027
32294,2,440,72,256.00,33856.00,24026,24028
32295,1,512,512,512.00,0.00,24027,24028
32296,1,512,512,512.00,0.00,24027,24028
32297,3,399,2,170.67,28048.22,24027,24030
32298,1,512,512,512.00,0.00,24029,24030
32299,1,512,512,512.00,0.00,24029,24030
32300,2,438,74,256.00,33124.00,24029,24031
32301,5,259,1,102.40,8897.04,24030,24035
32302,1,512,512,512.00,0.00,24034,24035
32303,1,512,512,512.00,0.00,24034,24035
32304,1,512,512,512.00,0.00,24034,24035
32305,1,512,512,512.00,0.00,24034,24035
32306,1,512,512,512.00,0.00,24034,24035
32307,5,401,8,102.40,22788.24,24034,24039
32308,1,512,512,512.00,0.00,24038,24039
32309,3,319,1,170.67,17081.56,24038,24041
32310,1,512,512,512.00,0.00,24040,24041
32311,1,512,512,512.00,0.00,24040,24041
32312,3,305,32,170.67,12430.89,24040,24043
32313,1,512,512,512.00,0.00,24042,24043
32314,1,512,512,512.00,0.00,24042,24043
32315,1,512,512,512.00,0.00,24042,24043
32316,2,450,62,256.00,37636.00,24042,24044
32317,1,512,512,512.00,0.00,24043,24044
32318,1,512,512,512.00,0.00,24043,24044
32319,1,512,512,512.00,0.00,24043,24044
32320,2,366,146,256.00,12100.00,24043,24045
32321,1,512,512,512.00,0.00,24044,24045
32322,1,512,512,512.00,0.00,24044,24045
32323,1,512,512,512.00,0.00,24044,24045
32324,1,512,512,512.00,0.00,24044,24045
32325,1,512,512,512.00,0.00,24044,24045
32326,1,512,512,512.00,0.00,24044,24045
32327,6,264,3,85.33,8914.22,24044,24050
32328,1,512,512,512.00,0.00,24049,24050
32329,2,302,210,256.00,2116.00,24049,24051
32330,1,512,512,512.00,0.00,24050,24051
32331,1,512,512,512.00,0.00,24050,24051
32332,1,512,512,512.00,0.00,24050,24051
32333,1,512,512,512.00,0.00,24050,24051
32334,2,447,65,256.00,36481.00,24050,24052
32335,1,512,512,512.00,0.00,24051,24052
32336,1,512,512,512.00,0.00,24051,24052
32337,1,512,512,512.00,0.00,24051,24052
32338,1,512,512,512.00,0.00,24051,24052
32339,1,512,512,512.00,0.00,24051,24052
32340,5,327,1,102.40,14438.24,24051,24056
32341,1,512,512,512.00,0.00,24055,24056
32342,1,512,512,512.00,0.00,24055,24056
32343,1,512,512,512.00,0.00,24055,24056
32344,3,439,16,170.67,36281.56,24055,24058
32345,2,299,213,256.00,1849.00,24057,24059
32346,3,338,35,170.67,15802.89,24058,24061
32347,1,512,512,512.00,0.00,24060,24061
32348,1,512,512,512.00,0.00,24060,24061
32349,2,396,116,256.00,19600.00,24060,24062
32350,4,240,3,128.00,8441.50,24061,24065
32351,2,436,76,256.00,32400.00,24064,24066
32352,1,512,512,512.00,0.00,24065,24066
32353,2,414,98,256.00,24964.00,24065,24067
32354,1,512,512,512.00,0.00,24066,24067
32355,10,147,1,51.20,2113.96,24066,24076
32356,2,394,118,256.00,19044.00,24075,24077
32357,1,512,512,512.00,0.00,24076,24077
32358,1,512,512,512.00,0.00,24076,24077
32359,2,257,255,256.00,1.00,24076,24078
32360,2,498,14,256.00,58564.00,24077,24079
32361,1,512,512,512.00,0.00,24078,24079
32362,2,503,9,256.00,61009.00,24078,24080
32363,5,419,5,102.40,25694.24,24079,24084
32364,2,477,35,256.00,48841.00,24083,24085
32365,2,465,47,256.00,43681.00,24084,24086
32366,1,512,512,512.00,0.00,24085,24086
32367,1,512,512,512.00,0.00,24085,24086
32368,2,316,196,256.00,3600.00,24085,24087
32369,3,281,1,170.67,14826.89,24086,24089
32370,2,470,42,256.00,45796.00,24088,24090
32371,2,271,241,256.00,225.00,24089,24091
32372,1,512,512,512.00,0.00,24090,24091
32373,1,512,512,512.00,0.00,24090,24091
32374,1,512,512,512.00,0.00,24090,24091
32375,1,512,512,512.00,0.00,24090,24091
32376,1,512,512,512.00,0.00,24090,24091
32377,1,512,512,512.00,0.00,24090,24091
32378,1,512,512,512.00,0.00,24090,24091
32379,1,512,512,512.00,0.00,24090,24091
32380,1,512,512,512.00,0.00,24090,24091
32381,1,512,512,512.00,0.00,24090,24091
32382,2,465,47,256.00,43681.00,24090,24092
32383,1,512,512,512.00,0.00,24091,24092
32384,2,379,133,256.00,15129.00,24091,24093
32385,2,274,238,256.00,324.00,24092,24094
32386,3,300,22,170.67,13067.56,24093,24096
32387,1,512,512,512.00,0.00,24095,24096
32388,3,269,98,170.67,5202.89,24095,24098
32389,3,302,8,170.67,14896.89,24097,24100
32390,4,368,1,128.00,22443.50,24099,24103
32391,4,389,4,128.00,23655.50,24102,24106
32392,4,401,14,128.00,25419.50,24105,24109
32393,3,313,17,170.67,14666.89,24108,24111
32394,2,372,140,256.00,13456.00,24110,24112
32395,1,512,512,512.00,0.00,24111,24112
32396,1,512,512,512.00,0.00,24111,24112
32397,6,298,1,85.33,11134.89,24111,24117
32398,2,316,196,256.00,3600.00,24116,24118
32399,1,512,512,512.00,0.00,24117,24118
32400,1,512,512,512.00,0.00,24117,24118
32401,5,306,1,102.40,15431.04,24117,24122
32402,1,512,512,512.00,0.00,24121,24122
32403,2,421,91,256.00,27225.00,24121,24123
32404,1,512,512,512.00,0.00,24122,24123
32405,1,512,512,512.00,0.00,24122,24123
32406,2,444,68,256.00,35344.00,24122,24124
32407,2,269,243,256.00,169.00,24123,24125
32408,2,445,67,256.00,35721.00,24124,24126
32409,1,512,512,512.00,0.00,24125,24126
32410,1,512,512,512.00,0.00,24125,24126
32411,3,346,33,170.67,17037.56,24125,24128
32412,5,383,1,102.40,20897.44,24127,24132
32413,3,399,21,170.67,26908.22,24131,24134
32414,1,512,512,512.00,0.00,24133,24134
32415,6,297,2,85.33,10339.56,24133,24139
32416,1,512,512,512.00,0.00,24138,24139
32417,1,512,512,512.00,0.00,24138,24139
32418,1,512,512,512.00,0.00,24138,24139
32419,1,512,512,512.00,0.00,24138,24139
32420,4,242,1,128.00,7323.50,24138,24142
32421,2,451,61,256.00,38025.00,24141,24143
32422,2,317,195,256.00,3721.00,24142,24144
32423,1,512,512,512.00,0.00,24143,24144
32424,2,473,39,256.00,47089.00,24143,24145
32425,2,300,212,256.00,1936.00,24144,24146
32426,1,512,512,512.00,0.00,24145,24146
32427,4,254,2,128.00,13770.00,24145,24149
32428,2,481,31,256.00,50625.00,24148,24150
32429,2,378,134,256.00,14884.00,24149,24151
32430,2,304,208,256.00,2304.00,24150,24152
32431,2,472,40,256.00,46656.00,24151,24153
32432,2,382,130,256.00,15876.00,24152,24154
32433,2,471,41,256.00,46225.00,24153,24155
32434,1,512,512,512.00,0.00,24154,24155
32435,3,370,10,170.67,22347.56,24154,24157
32436,2,388,124,256.00,17424.00,24156,24158
32437,1,512,512,512.00,0.00,24157,24158
32438,2,284,228,256.00,784.00,24157,24159
32439,1,512,512,512.00,0.00,24158,24159
32440,1,512,512,512.00,0.00,24158,24159
32441,2,490,22,256.00,54756.00,24158,24160
32442,4,256,14,128.00,11154.00,24159,24163
32443,3,313,18,170.67,14557.56,24162,24165
32444,3,336,4,170.67,18371.56,24164,24167
32445,1,512,512,512.00,0.00,24166,24167
32446,1,512,512,512.00,0.00,24166,24167
32447,2,338,174,256.00,6724.00,24166,24168
32448,4,195,10,128.00,5424.50,24167,24171
32449,2,341,171,256.00,7225.00,24170,24172
32450,2,384,128,256.00,16384.00,24171,24173
32451,1,512,512,512.00,0.00,24172,24173
32452,1,512,512,512.00,0.00,24172,24173
32453,2,355,157,256.00,9801.00,24172,24174
32454,1,512,512,512.00,0.00,24173,24174
32455,1,512,512,512.00,0.00,24173,24174
32456,1,512,512,512.00,0.00,24173,24174
32457,1,512,512,512.00,0.00,24173,24174
32458,2,266,246,256.00,100.00,24173,24175
32459,3,480,5,170.67,47924.22,24174,24177
32460,1,512,512,512.00,0.00,24176,24177
32461,1,512,512,512.00,0.00,24176,24177
32462,1,512,512,512.00,0.00,24176,24177
32463,1,512,512,512.00,0.00,24176,24177
32464,3,377,1,170.67,24234.89,24176,24179
32465,3,296,10,170.67,14256.89,24178,24181
32466,4,305,2,128.00,14827.50,24180,24184
32467,1,512,512,512.00,0.00,24183,24184
32468,1,512,512,512.00,0.00,24183,24184
32469,1,512,512,512.00,0.00,24183,24184
32470,5,242,2,102.40,10243.84,24183,24188
32471,2,471,41,256.00,46225.00,24187,24189
32472,1,512,512,512.00,0.00,24188,24189
32473,1,512,512,512.00,0.00,24188,24189
32474,1,512,512,512.00,0.00,24188,24189
32475,3,362,5,170.67,21570.89,24188,24191
32476,1,512,512,512.00,0.00,24190,24191
32477,1,512,512,512.00,0.00,24190,24191
32478,1,512,512,512.00,0.00,24190,24191
32479,1,512,512,512.00,0.00,24190,24191
32480,3,375,1,170.67,23913.56,24190,24193
32481,1,512,512,512.00,0.00,24192,24193
32482,2,325,187,256.00,4761.00,24192,24194
32483,2,452,60,256.00,38416.00,24193,24195
32484,1,512,512,512.00,0.00,24194,24195
32485,1,512,512,512.00,0.00,24194,24195
32486,1,512,512,512.00,0.00,24194,24195
32487,1,512,512,512.00,0.00,24194,24195
32488,1,512,512,512.00,0.00,24194,24195
32489,1,512,512,512.00,0.00,24194,24195
32490,2,363,149,256.00,11449.00,24194,24196
32491,5,294,1,102.40,10367.44,24195,24200
32492,1,512,512,512.00,0.00,24199,24200
32493,3,442,27,170.67,36853.56,24199,24202
32494,1,512,512,512.00,0.00,24201,24202
32495,1,512,512,512.00,0.00,24201,24202
32496,1,512,512,512.00,0.00,24201,24202
32497,3,464,1,170.67,43374.89,24201,24204
32498,2,286,226,256.00,900.00,24203,24205
32499,2,309,203,256.00,2809.00,24204,24206
32500,1,512,512,512.00,0.00,24205,24206
32501,1,512,512,512.00,0.00,24205,24206
32502,1,512,512,512.00,0.00,24205,24206
32503,1,512,512,512.00,0.00,24205,24206
32504,2,422,90,256.00,27556.00,24205,24207
32505,1,512,512,512.00,0.00,24206,24207
32506,1,512,512,512.00,0.00,24206,24207
32507,1,512,512,512.00,0.00,24206,24207
32508,1,512,512,512.00,0.00,24206,24207
32509,1,512,512,512.00,0.00,24206,24207
32510,2,422,90,256.00,27556.00,24206,24208
32511,2,511,1,256.00,65025.00,24207,24209
32512,1,512,512,512.00,0.00,24208,24209
32513,6,224,1,85.33,5022.56,24208,24214
32514,1,512,512,512.00,0.00,24213,24214
32515,1,512,512,512.00,0.00,24213,24214
32516,2,349,163,256.00,8649.00,24213,24215
32517,1,512,512,512.00,0.00,24214,24215
32518,1,512,512,512.00,0.00,24214,24215
32519,2,414,98,256.00,24964.00,24214,24216
32520,6,265,1,85.33,8969.89,24215,24221
32521,1,512,512,512.00,0.00,24220,24221
32522,1,512,512,512.00,0.00,24220,24221
32523,1,512,512,512.00,0.00,24220,24221
32524,1,512,512,512.00,0.00,24220,24221
32525,4,428,7,128.00,30630.50,24220,24224
32526,3,368,1,170.67,22830.89,24223,24226
32527,1,512,512,512.00,0.00,24225,24226
32528,1,512,512,512.00,0.00,24225,24226
32529,1,512,512,512.00,0.00,24225,24226
32530,1,512,512,512.00,0.00,24225,24226
32531,1,512,512,512.00,0.00,24225,24226
32532,1,512,512,512.00,0.00,24225,24226
32533,1,512,512,512.00,0.00,24225,24226
32534,1,512,512,512.00,0.00,24225,24226
32535,1,512,512,512.00,0.00,24225,24226
32536,4,481,1,128.00,41641.00,24225,24229
32537,1,512,512,512.00,0.00,24228,24229
32538,1,512,512,512.00,0.00,24228,24229
32539,1,512,512,512.00,0.00,24228,24229
32540,1,512,512,512.00,0.00,24228,24229
32541,2,446,66,256.00,36100.00,24228,24230
32542,2,355,157,256.00,9801.00,24229,24231
32543,4,482,1,128.00,41830.50,24230,24234
32544,1,512,512,512.00,0.00,24233,24234
32545,1,512,512,512.00,0.00,24233,24234
32546,1,512,512,512.00,0.00,24233,24234
32547,2,473,39,256.00,47089.00,24233,24235
32548,2,492,20,256.00,55696.00,24234,24236
32549,1,512,512,512.00,0.00,24235,24236
32550,2,509,3,256.00,64009.00,24235,24237
32551,2,360,152,256.00,10816.00,24236,24238
32552,2,335,177,256.00,6241.00,24237,24239
32553,1,512,512,512.00,0.00,24238,24239
32554,1,512,512,512.00,0.00,24238,24239
32555,1,512,512,512.00,0.00,24238,24239
32556,3,427,1,170.67,34001.56,24238,24241
32557,3,286,5,170.67,14426.89,24240,24243
32558,2,428,84,256.00,29584.00,24242,24244
32559,3,380,20,170.67,23320.89,24243,24246
32560,4,302,2,128.00,12474.00,24245,24249
32561,1,512,512,512.00,0.00,24248,24249
32562,6,333,1,85.33,14512.89,24248,24254
32563,2,493,19,256.00,56169.00,24253,24255
32564,1,512,512,512.00,0.00,24254,24255
32565,1,512,512,512.00,0.00,24254,24255
32566,2,497,15,256.00,58081.00,24254,24256
32567,1,512,512,512.00,0.00,24255,24256
32568,1,512,512,512.00,0.00,24255,24256
32569,1,512,512,512.00,0.00,24255,24256
32570,1,512,512,512.00,0.00,24255,24256
32571,2,320,192,256.00,4096.00,24255,24257
32572,5,345,1,102.40,16023.04,24256,24261
32573,1,512,512,512.00,0.00,24260,24261
32574,4,445,2,128.00,33729.50,24260,24264
32575,2,428,84,256.00,29584.00,24263,24265
32576,1,512,512,512.00,0.00,24264,24265
32577,2,331,181,256.00,5625.00,24264,24266
32578,1,512,512,512.00,0.00,24265,24266
32579,2,361,151,256.00,11025.00,24265,24267
32580,2,486,26,256.00,52900.00,24266,24268
32581,1,512,512,512.00,0.00,24267,24268
32582,1,512,512,512.00,0.00,24267,24268
32583,3,308,1,170.67,16230.89,24267,24270
32584,1,512,512,512.00,0.00,24269,24270
32585,1,512,512,512.00,0.00,24269,24270
32586,1,512,512,512.00,0.00,24269,24270
32587,1,512,512,512.00,0.00,24269,24270
32588,1,512,512,512.00,0.00,24269,24270
32589,1,512,512,512.00,0.00,24269,24270
32590,1,512,512,512.00,0.00,24269,24270
32591,1,512,512,512.00,0.00,24269,24270
32592,6,292,1,85.33,11822.89,24269,24275
32593,2,439,73,256.00,33489.00,24274,24276
32594,3,284,75,170.67,7436.22,24275,24278
32595,1,512,512,512.00,0.00,24277,24278
32596,1,512,512,512.00,0.00,24277,24278
32597,4,324,18,128.00,15414.00,24277,24281
32598,1,512,512,512.00,0.00,24280,24281
32599,1,512,512,512.00,0.00,24280,24281
32600,3,489,8,170.67,50676.22,24280,24283
32601,3,353,7,170.67,20126.89,24282,24285
32602,3,378,5,170.67,24056.22,24284,24287
32603,3,434,8,170.67,35312.89,24286,24289
32604,1,512,512,512.00,0.00,24288,24289
32605,1,512,512,512.00,0.00,24288,24289
32606,1,512,512,512.00,0.00,24288,24289
32607,1,512,512,512.00,0.00,24288,24289
32608,3,438,5,170.67,36416.22,24288,24291
32609,2,300,212,256.00,1936.00,24290,24292
32610,1,512,512,512.00,0.00,24291,24292
32611,2,267,245,256.00,121.00,24291,24293
32612,9,298,1,56.89,8797.21,24292,24301
32613,3,418,32,170.67,30736.89,24300,24303
32614,1,512,512,512.00,0.00,24302,24303
32615,1,512,512,512.00,0.00,24302,24303
32616,4,383,1,128.00,23537.00,24302,24306
32617,3,319,2,170.67,16954.89,24305,24308
32618,3,496,7,170.67,52921.56,24307,24310
32619,2,473,39,256.00,47089.00,24309,24311
32620,4,423,3,128.00,29359.50,24310,24314
32621,1,512,512,512.00,0.00,24313,24314
32622,4,395,1,128.00,25656.50,24313,24317
32623,2,380,132,256.00,15376.00,24316,24318
32624,1,512,512,512.00,0.00,24317,24318
32625,1,512,512,512.00,0.00,24317,24318
32626,1,512,512,512.00,0.00,24317,24318
32627,1,512,512,512.00,0.00,24317,24318
32628,4,264,1,128.00,13817.50,24317,24321
32629,1,512,512,512.00,0.00,24320,24321
32630,1,512,512,512.00,0.00,24320,24321
32631,2,456,56,256.00,40000.00,24320,24322
32632,6,355,1,85.33,15431.56,24321,24327
32633,2,462,50,256.00,42436.00,24326,24328
32634,2,412,100,256.00,24336.00,24327,24329
32635,5,194,8,102.40,4993.04,24328,24333
32636,2,469,43,256.00,45369.00,24332,24334
32637,1,512,512,512.00,0.00,24333,24334
32638,1,512,512,512.00,0.00,24333,24334
32639,1,512,512,512.00,0.00,24333,24334
32640,1,512,512,512.00,0.00,24333,24334
32641,1,512,512,512.00,0.00,24333,24334
32642,7,363,2,73.14,15407.84,24333,24340
32643,1,512,512,512.00,0.00,24339,24340
32644,1,512,512,512.00,0.00,24339,24340
32645,5,394,15,102.40,21566.64,24339,24344
32646,2,359,153,256.00,10609.00,24343,24345
32647,2,504,8,256.00,61504.00,24344,24346
32648,4,245,13,128.00,7093.50,24345,24349
32649,1,512,512,512.00,0.00,24348,24349
32650,3,404,48,170.67,27246.22,24348,24351
32651,2,313,199,256.00,3249.00,24350,24352
32652,1,512,512,512.00,0.00,24351,24352
32653,2,385,127,256.00,16641.00,24351,24353
32654,1,512,512,512.00,0.00,24352,24353
32655,2,429,83,256.00,29929.00,24352,24354
32656,1,512,512,512.00,0.00,24353,24354
32657,1,512,512,512.00,0.00,24353,24354
32658,3,186,140,170.67,470.22,24353,24356
32659,2,321,191,256.00,4225.00,24355,24357
32660,5,345,6,102.40,15864.24,24356,24361
32661,1,512,512,512.00,0.00,24360,24361
32662,1,512,512,512.00,0.00,24360,24361
32663,1,512,512,512.00,0.00,24360,24361
32664,2,390,122,256.00,17956.00,24361,24363
32665,1,512,512,512.00,0.00,24362,24363
32666,1,512,512,512.00,0.00,24362,24363
32667,1,512,512,512.00,0.00,24362,24363
32668,6,229,3,85.33,8093.89,24362,24368
32669,1,512,512,512.00,0.00,24367,24368
32670,1,512,512,512.00,0.00,24367,24368
32671,1,512,512,512.00,0.00,24367,24368
32672,5,301,3,102.40,12473.44,24367,24372
32673,1,512,512,512.00,0.00,24371,24372
32674,2,413,99,256.00,24649.00,24371,24373
32675,2,286,226,256.00,900.00,24372,24374
32676,1,512,512,512.00,0.00,24373,24374
32677,3,243,113,170.67,2924.22,24373,24376
32678,1,512,512,512.00,0.00,24375,24376
32679,1,512,512,512.00,0.00,24375,24376
32680,1,512,512,512.00,0.00,24375,24376
32681,3,309,96,170.67,9588.22,24375,24378
32682,2,449,63,256.00,37249.00,24377,24379
32683,6,220,1,85.33,6909.22,24378,24384
32684,1,512,512,512.00,0.00,24383,24384
32685,1,512,512,512.00,0.00,24383,24384
32686,4,387,4,128.00,24218.50,24383,24387
32687,1,512,512,512.00,0.00,24386,24387
32688,4,373,1,128.00,23023.50,24386,24390
32689,3,282,7,170.67,13973.56,24389,24392
32690,1,512,512,512.00,0.00,24391,24392
32691,1,512,512,512.00,0.00,24391,24392
32692,1,512,512,512.00,0.00,24391,24392
32693,9,229,1,56.89,5693.43,24391,24400
32694,1,512,512,512.00,0.00,24399,24400
32695,2,302,210,256.00,2116.00,24399,24401
32696,1,512,512,512.00,0.00,24400,24401
32697,1,512,512,512.00,0.00,24400,24401
32698,3,275,1,170.67,14646.89,24400,24403
32699,1,512,512,512.00,0.00,24402,24403
32700,1,512,512,512.00,0.00,24402,24403
32701,5,240,3,102.40,8112.24,24402,24407
32702,1,512,512,512.00,0.00,24406,24407
32703,5,408,1,102.40,24059.04,24406,24411
32704,1,512,512,512.00,0.00,24410,24411
32705,1,512,512,512.00,0.00,24410,24411
32706,3,403,25,170.67,27569.56,24410,24413
32707,2,497,15,256.00,58081.00,24412,24414
32708,1,512,512,512.00,0.00,24413,24414
32709,3,258,63,170.67,6544.22,24413,24416
32710,1,512,512,512.00,0.00,24415,24416
32711,2,308,204,256.00,2704.00,24415,24417
32712,1,512,512,512.00,0.00,24416,24417
32713,4,376,8,128.00,22036.50,24416,24420
32714,3,446,5,170.67,38426.89,24419,24422
32715,4,293,5,128.00,12267.00,24421,24425
32716,1,512,512,512.00,0.00,24424,24425
32717,2,427,85,256.00,29241.00,24424,24426
32718,2,394,118,256.00,19044.00,24425,24427
32719,1,512,512,512.00,0.00,24426,24427
32720,1,512,512,512.00,0.00,24426,24427
32721,1,512,512,512.00,0.00,24426,24427
32722,3,296,39,170.67,11028.22,24426,24429
32723,3,348,58,170.67,16107.56,24428,24431
32724,1,512,512,512.00,0.00,24430,24431
32725,2,418,94,256.00,26244.00,24430,24432
32726,1,512,512,512.00,0.00,24431,24432
32727,1,512,512,512.00,0.00,24431,24432
32728,1,512,512,512.00,0.00,24431,24432
32729,4,184,71,128.00,2586.50,24431,24435
32730,2,375,137,256.00,14161.00,24434,24436
32731,1,512,512,512.00,0.00,24435,24436
32732,4,386,2,128.00,23670.00,24435,24439
32733,2,501,11,256.00,60025.00,24438,24440
32734,1,512,512,512.00,0.00,24439,24440
32735,3,258,69,170.67,6056.22,24439,24442
32736,5,431,1,102.40,27794.24,24441,24446
32737,1,512,512,512.00,0.00,24445,24446
32738,1,512,512,512.00,0.00,24445,24446
32739,3,402,55,170.67,26757.56,24445,24448
32740,3,390,1,170.67,26453.56,24447,24450
32741,2,369,143,256.00,12769.00,24449,24451
32742,1,512,512,512.00,0.00,24450,24451
32743,2,303,209,256.00,2209.00,24450,24452
32744,1,512,512,512.00,0.00,24451,24452
32745,1,512,512,512.00,0.00,24451,24452
32746,1,512,512,512.00,0.00,24451,24452
32747,3,494,1,170.67,52314.89,24451,24454
32748,1,512,512,512.00,0.00,24453,24454
32749,1,512,512,512.00,0.00,24453,24454
32750,1,512,512,512.00,0.00,24453,24454
32751,1,512,512,512.00,0.00,24453,24454
32752,2,324,188,256.00,4624.00,24453,24455
32753,1,512,512,512.00,0.00,24454,24455
32754,1,512,512,512.00,0.00,24454,24455
32755,1,512,512,512.00,0.00,24454,24455
32756,1,512,512,512.00,0.00,24454,24455
32757,1,512,512,512.00,0.00,24454,24455
32758,1,512,512,512.00,0.00,24454,24455
32759,1,512,512,512.00,0.00,24454,24455
32760,2,498,14,256.00,58564.00,24454,24456
32761,2,312,200,256.00,3136.00,24455,24457
32762,1,512,512,512.00,0.00,24456,24457
32763,3,462,5,170.67,42704.22,24456,24459
32764,3,235,50,170.67,7290.89,24458,24461
32765,1,512,512,512.00,0.00,24460,24461
32766,1,512,512,512.00,0.00,24460,24461
32767,6,336,2,85.33,13376.56,24460,24466
32768,2,347,165,256.00,8281.00,24465,24467
32769,1,512,512,512.00,0.00,24466,24467
32770,1,512,512,512.00,0.00,24466,24467
32771,1,512,512,512.00,0.00,24466,24467
32772,2,258,254,256.00,4.00,24466,24468
32773,1,512,512,512.00,0.00,24467,24468
32774,1,512,512,512.00,0.00,24467,24468
32775,7,199,5,73.14,5323.27,24467,24474
32776,1,512,512,512.00,0.00,24473,24474
32777,4,219,20,128.00,5043.50,24473,24477
32778,1,512,512,512.00,0.00,24476,24477
32779,1,512,512,512.00,0.00,24476,24477
32780,1,512,512,512.00,0.00,24476,24477
32781,2,492,20,256.00,55696.00,24476,24478
32782,2,300,212,256.00,1936.00,24477,24479
32783,1,512,512,512.00,0.00,24478,24479
32784,1,512,512,512.00,0.00,24478,24479
32785,1,512,512,512.00,0.00,24478,24479
32786,2,407,105,256.00,22801.00,24478,24480
32787,1,512,512,512.00,0.00,24479,24480
32788,2,294,218,256.00,1444.00,24479,24481
32789,1,512,512,512.00,0.00,24480,24481
32790,2,313,199,256.00,3249.00,24480,24482
32791,1,512,512,512.00,0.00,24481,24482
32792,2,292,220,256.00,1296.00,24481,24483
32793,1,512,512,512.00,0.00,24482,24483
32794,4,382,31,128.00,21598.50,24482,24486
32795,1,512,512,512.00,0.00,24485,24486
32796,1,512,512,512.00,0.00,24485,24486
32797,2,327,185,256.00,5041.00,24485,24487
32798,1,512,512,512.00,0.00,24486,24487
32799,1,512,512,512.00,0.00,24486,24487
32800,1,512,512,512.00,0.00,24486,24487
32801,1,512,512,512.00,0.00,24486,24487
32802,1,512,512,512.00,0.00,24486,24487
32803,1,512,512,512.00,0.00,24486,24487
32804,1,512,512,512.00,0.00,24486,24487
32805,1,512,512,512.00,0.00,24486,24487
32806,1,512,512,512.00,0.00,24486,24487
32807,1,512,512,512.00,0.00,24486,24487
32808,4,250,15,128.00,10083.50,24486,24490
32809,1,512,512,512.00,0.00,24489,24490
32810,1,512,512,512.00,0.00,24489,24490
32811,2,505,7,256.00,62001.00,24489,24491
32812,1,512,512,512.00,0.00,24490,24491
32813,1,512,512,512.00,0.00,24490,24491
32814,1,512,512,512.00,0.00,24490,24491
32815,1,512,512,512.00,0.00,24490,24491
32816,2,396,116,256.00,19600.00,24490,24492
32817,4,360,11,128.00,18552.50,24491,24495
32818,1,512,512,512.00,0.00,24494,24495
32819,3,309,3,170.67,16036.22,24494,24497
32820,1,512,512,512.00,0.00,24496,24497
32821,1,512,512,512.00,0.00,24496,24497
32822,1,512,512,512.00,0.00,24496,24497
32823,1,512,512,512.00,0.00,24496,24497
32824,1,512,512,512.00,0.00,24496,24497
32825,1,512,512,512.00,0.00,24496,24497
32826,3,428,22,170.67,33376.89,24496,24499
32827,6,236,1,85.33,7102.22,24498,24504
32828,1,512,512,512.00,0.00,24503,24504
32829,4,414,1,128.00,28769.50,24503,24507
32830,1,512,512,512.00,0.00,24506,24507
32831,1,512,512,512.00,0.00,24506,24507
32832,2,457,55,256.00,40401.00,24506,24508
32833,1,512,512,512.00,0.00,24507,24508
32834,1,512,512,512.00,0.00,24507,24508
32835,1,512,512,512.00,0.00,24507,24508
32836,1,512,512,512.00,0.00,24507,24508
32837,2,373,139,256.00,13689.00,24507,24509
32838,4,215,21,128.00,5196.50,24508,24512
32839,1,512,512,512.00,0.00,24511,24512
32840,1,512,512,512.00,0.00,24511,24512
32841,2,330,182,256.00,5476.00,24511,24513
32842,1,512,512,512.00,0.00,24512,24513
32843,1,512,512,512.00,0.00,24512,24513
32844,1,512,512,512.00,0.00,24512,24513
32845,3,503,1,170.67,55230.89,24512,24515
32846,4,318,1,128.00,18113.50,24514,24518
32847,1,512,512,512.00,0.00,24517,24518
32848,1,512,512,512.00,0.00,24517,24518
32849,1,512,512,512.00,0.00,24517,24518
32850,1,512,512,512.00,0.00,24517,24518
32851,1,512,512,512.00,0.00,24517,24518
32852,1,512,512,512.00,0.00,24517,24518
32853,1,512,512,512.00,0.00,24517,24518
32854,3,433,11,170.67,34950.89,24517,24520
32855,1,512,512,512.00,0.00,24519,24520
32856,1,512,512,512.00,0.00,24519,24520
32857,1,512,512,512.00,0.00,24519,24520
32858,1,512,512,512.00,0.00,24519,24520
32859,1,512,512,512.00,0.00,24519,24520
32860,1,512,512,512.00,0.00,24519,24520
32861,1,512,512,512.00,0.00,24519,24520
32862,1,512,512,512.00,0.00,24519,24520
32863,5,249,1,102.40,11828.64,24519,24524
32864,5,246,2,102.40,8245.04,24523,24528
32865,1,512,512,512.00,0.00,24527,24528
32866,3,395,27,170.67,25824.22,24527,24530
32867,1,512,512,512.00,0.00,24529,24530
32868,1,512,512,512.00,0.00,24529,24530
32869,2,386,126,256.00,16900.00,24529,24531
32870,1,512,512,512.00,0.00,24530,24531
32871,1,512,512,512.00,0.00,24530,24531
32872,1,512,512,512.00,0.00,24530,24531
32873,1,512,512,512.00,0.00,24530,24531
32874,1,512,512,512.00,0.00,24530,24531
32875,1,512,512,512.00,0.00,24530,24531
32876,1,512,512,512.00,0.00,24530,24531
32877,1,512,512,512.00,0.00,24530,24531
32878,1,512,512,512.00,0.00,24530,24531
32879,4,438,2,128.00,32676.00,24530,24534
32880,1,512,512,512.00,0.00,24533,24534
32881,1,512,512,512.00,0.00,24533,24534
32882,1,512,512,512.00,0.00,24533,24534
32883,2,470,42,256.00,45796.00,24533,24535
32884,1,512,512,512.00,0.00,24534,24535
32885,1,512,512,512.00,0.00,24534,24535
32886,1,512,512,512.00,0.00,24534,24535
32887,3,455,1,170.67,40926.89,24534,24537
32888,2,273,239,256.00,289.00,24536,24538
32889,3,414,3,170.67,31016.22,24537,24540
32890,1,512,512,512.00,0.00,24539,24540
32891,3,299,23,170.67,12882.89,24539,24542
32892,2,347,165,256.00,8281.00,24541,24543
32893,1,512,512,512.00,0.00,24542,24543
32894,1,512,512,512.00,0.00,24542,24543
32895,1,512,512,512.00,0.00,24542,24543
32896,2,335,177,256.00,6241.00,24542,24544
32897,1,512,512,512.00,0.00,24543,24544
32898,1,512,512,512.00,0.00,24543,24544
32899,6,270,2,85.33,8344.22,24543,24549
32900,3,212,99,170.67,2588.22,24548,24551
32901,2,451,61,256.00,38025.00,24550,24552
32902,1,512,512,512.00,0.00,24551,24552
32903,2,485,27,256.00,52441.00,24551,24553
32904,4,298,25,128.00,10714.50,24552,24556
32905,1,512,512,512.00,0.00,24555,24556
32906,1,512,512,512.00,0.00,24555,24556
32907,1,512,512,512.00,0.00,24555,24556
32908,1,512,512,512.00,0.00,24555,24556
32909,1,512,512,512.00,0.00,24555,24556
32910,2,336,176,256.00,6400.00,24555,24557
32911,1,512,512,512.00,0.00,24556,24557
32912,1,512,512,512.00,0.00,24556,24557
32913,1,512,512,512.00,0.00,24556,24557
32914,1,512,512,512.00,0.00,24556,24557
32915,1,512,512,512.00,0.00,24556,24557
32916,3,198,132,170.67,790.22,24556,24559
32917,6,212,3,85.33,6182.89,24558,24564
32918,1,512,512,512.00,0.00,24563,24564
32919,1,512,512,512.00,0.00,24563,24564
32920,1,512,512,512.00,0.00,24563,24564
32921,1,512,512,512.00,0.00,24563,24564
32922,3,289,14,170.67,13338.89,24563,24566
32923,1,512,512,512.00,0.00,24565,24566
32924,1,512,512,512.00,0.00,24565,24566
32925,1,512,512,512.00,0.00,24565,24566
32926,2,276,236,256.00,400.00,24565,24567
32927,1,512,512,512.00,0.00,24566,24567
32928,1,512,512,512.00,0.00,24566,24567
32929,2,353,159,256.00,9409.00,24566,24568
32930,1,512,512,512.00,0.00,24567,24568
32931,1,512,512,512.00,0.00,24567,24568
32932,4,299,53,128.00,9868.50,24567,24571
32933,1,512,512,512.00,0.00,24570,24571
32934,2,505,7,256.00,62001.00,24570,24572
32935,2,511,1,256.00,65025.00,24571,24573
32936,3,353,3,170.67,20524.22,24572,24575
32937,2,350,162,256.00,8836.00,24574,24576
32938,1,512,512,512.00,0.00,24575,24576
32939,4,272,6,128.00,9110.00,24575,24579
32940,2,424,88,256.00,28224.00,24578,24580
32941,1,512,512,512.00,0.00,24579,24580
32942,2,294,218,256.00,1444.00,24579,24581
32943,1,512,512,512.00,0.00,24580,24581
32944,1,512,512,512.00,0.00,24580,24581
32945,1,512,512,512.00,0.00,24580,24581
32946,4,445,1,128.00,34179.00,24580,24584
32947,2,372,140,256.00,13456.00,24583,24585
32948,1,512,512,512.00,0.00,24584,24585
32949,1,512,512,512.00,0.00,24584,24585
32950,1,512,512,512.00,0.00,24584,24585
32951,1,512,512,512.00,0.00,24584,24585
32952,1,512,512,512.00,0.00,24584,24585
32953,1,512,512,512.00,0.00,24584,24585
32954,4,470,5,128.00,39063.50,24584,24588
32955,3,344,1,170.67,19614.89,24587,24590
32956,1,512,512,512.00,0.00,24589,24590
32957,3,236,65,170.67,5686.89,24589,24592
32958,1,512,512,512.00,0.00,24591,24592
32959,4,320,5,128.00,17509.50,24591,24595
32960,1,512,512,512.00,0.00,24594,24595
32961,1,512,512,512.00,0.00,24594,24595
32962,1,512,512,512.00,0.00,24594,24595
32963,1,512,512,512.00,0.00,24594,24595
32964,1,512,512,512.00,0.00,24594,24595
32965,2,382,130,256.00,15876.00,24594,24596
32966,1,512,512,512.00,0.00,24595,24596
32967,1,512,512,512.00,0.00,24595,24596
32968,3,328,11,170.67,16750.89,24595,24598
32969,2,489,23,256.00,54289.00,24597,24599
32970,4,421,9,128.00,29267.50,24598,24602
32971,2,291,221,256.00,1225.00,24601,24603
32972,2,416,96,256.00,25600.00,24602,24604
32973,8,211,1,64.00,5594.00,24603,24611
32974,1,512,512,512.00,0.00,24610,24611
32975,1,512,512,512.00,0.00,24610,24611
32976,1,512,512,512.00,0.00,24610,24611
32977,1,512,512,512.00,0.00,24610,24611
32978,2,300,212,256.00,1936.00,24610,24612
32979,1,512,512,512.00,0.00,24611,24612
32980,1,512,512,512.00,0.00,24611,24612
32981,1,512,512,512.00,0.00,24611,24612
32982,1,512,512,512.00,0.00,24611,24612
32983,5,490,1,102.40,37593.84,24611,24616
32984,1,512,512,512.00,0.00,24615,24616
32985,1,512,512,512.00,0.00,24615,24616
32986,2,476,36,256.00,48400.00,24615,24617
32987,3,456,2,170.67,41158.22,24616,24619
32988,2,461,51,256.00,42025.00,24618,24620
32989,4,346,14,128.00,16724.00,24619,24623
32990,2,378,134,256.00,14884.00,24622,24624
32991,2,297,215,256.00,1681.00,24623,24625
32992,4,405,1,128.00,26867.50,24624,24628
32993,1,512,512,512.00,0.00,24627,24628
32994,1,512,512,512.00,0.00,24627,24628
32995,4,267,11,128.00,8677.50,24627,24631
32996,1,512,512,512.00,0.00,24630,24631
32997,1,512,512,512.00,0.00,24630,24631
32998,2,355,157,256.00,9801.00,24630,24632
32999,1,512,512,512.00,0.00,24631,24632
33000,3,372,63,170.67,20300.22,24631,24634
33001,5,263,2,102.40,8380.24,24633,24638
33002,3,487,3,170.67,50093.56,24637,24640
33003,3,294,28,170.67,11979.56,24639,24642
33004,2,344,168,256.00,7744.00,24641,24643
33005,2,393,119,256.00,18769.00,24642,24644
33006,1,512,512,512.00,0.00,24643,24644
33007,3,242,62,170.67,6096.89,24643,24646
33008,3,375,26,170.67,22080.22,24645,24648
33009,1,512,512,512.00,0.00,24647,24648
33010,6,291,1,85.33,14260.56,24647,24653
33011,1,512,512,512.00,0.00,24652,24653
33012,1,512,512,512.00,0.00,24652,24653
33013,3,457,12,170.67,41153.56,24652,24655
33014,4,270,3,128.00,9136.50,24654,24658
33015,1,512,512,512.00,0.00,24657,24658
33016,1,512,512,512.00,0.00,24657,24658
33017,1,512,512,512.00,0.00,24657,24658
33018,2,405,107,256.00,22201.00,24657,24659
33019,2,508,4,256.00,63504.00,24658,24660
33020,1,512,512,512.00,0.00,24659,24660
33021,3,281,1,170.67,14826.89,24659,24662
33022,1,512,512,512.00,0.00,24661,24662
33023,3,224,132,170.67,1518.22,24661,24664
33024,7,239,1,73.14,6494.12,24663,24670
33025,4,248,21,128.00,7263.50,24669,24673
33026,1,512,512,512.00,0.00,24672,24673
33027,1,512,512,512.00,0.00,24672,24673
33028,3,493,1,170.67,51997.56,24672,24675
33029,2,368,144,256.00,12544.00,24674,24676
33030,6,194,1,85.33,3912.56,24675,24681
33031,2,271,241,256.00,225.00,24680,24682
33032,1,512,512,512.00,0.00,24681,24682
33033,4,359,25,128.00,18081.00,24681,24685
33034,1,512,512,512.00,0.00,24684,24685
33035,1,512,512,512.00,0.00,24684,24685
33036,1,512,512,512.00,0.00,24684,24685
33037,1,512,512,512.00,0.00,24684,24685
33038,2,277,235,256.00,441.00,24684,24686
33039,1,512,512,512.00,0.00,24685,24686
33040,4,296,20,128.00,12282.50,24685,24689
33041,2,439,73,256.00,33489.00,24688,24690
33042,1,512,512,512.00,0.00,24689,24690
33043,1,512,512,512.00,0.00,24689,24690
33044,1,512,512,512.00,0.00,24689,24690
33045,1,512,512,512.00,0.00,24689,24690
33046,1,512,512,512.00,0.00,24689,24690
33047,1,512,512,512.00,0.00,24689,24690
33048,4,195,76,128.00,2646.50,24689,24693
33049,1,512,512,512.00,0.00,24692,24693
33050,2,343,169,256.00,7569.00,24692,24694
33051,2,290,222,256.00,1156.00,24693,24695
33052,2,337,175,256.00,6561.00,24694,24696
33053,4,291,36,128.00,9884.50,24695,24699
33054,1,512,512,512.00,0.00,24698,24699
33055,1,512,512,512.00,0.00,24698,24699
33056,6,454,1,85.33,27276.22,24698,24704
33057,1,512,512,512.00,0.00,24703,24704
33058,1,512,512,512.00,0.00,24703,24704
33059,1,512,512,512.00,0.00,24703,24704
33060,1,512,512,512.00,0.00,24703,24704
33061,1,512,512,512.00,0.00,24703,24704
33062,1,512,512,512.00,0.00,24703,24704
33063,5,279,10,102.40,9992.24,24703,24708
33064,2,393,119,256.00,18769.00,24707,24709
33065,1,512,512,512.00,0.00,24708,24709
33066,1,512,512,512.00,0.00,24708,24709
33067,1,512,512,512.00,0.00,24708,24709
33068,1,512,512,512.00,0.00,24708,24709
33069,4,450,8,128.00,34623.50,24708,24712
33070,4,319,40,128.00,12392.50,24711,24715
33071,2,424,88,256.00,28224.00,24714,24716
33072,1,512,512,512.00,0.00,24715,24716
33073,1,512,512,512.00,0.00,24715,24716
33074,3,276,1,170.67,14673.56,24715,24718
33075,1,512,512,512.00,0.00,24717,24718
33076,1,512,512,512.00,0.00,24717,24718
33077,1,512,512,512.00,0.00,24717,24718
33078,1,512,512,512.00,0.00,24717,24718
33079,1,512,512,512.00,0.00,24717,24718
33080,1,512,512,512.00,0.00,24717,24718
33081,4,153,63,128.00,1412.50,24717,24721
33082,1,512,512,512.00,0.00,24720,24721
33083,1,512,512,512.00,0.00,24720,24721
33084,1,512,512,512.00,0.00,24720,24721
33085,1,512,512,512.00,0.00,24720,24721
33086,5,265,38,102.40,6810.64,24720,24725
33087,4,252,1,128.00,14432.50,24724,24728
33088,1,512,512,512.00,0.00,24727,24728
33089,1,512,512,512.00,0.00,24727,24728
33090,1,512,512,512.00,0.00,24727,24728
33091,2,450,62,256.00,37636.00,24727,24729
33092,1,512,512,512.00,0.00,24728,24729
33093,1,512,512,512.00,0.00,24728,24729
33094,1,512,512,512.00,0.00,24728,24729
33095,1,512,512,512.00,0.00,24728,24729
33096,1,512,512,512.00,0.00,24728,24729
33097,1,512,512,512.00,0.00,24728,24729
33098,3,493,3,170.67,51977.56,24728,24731
33099,1,512,512,512.00,0.00,24730,24731
33100,1,512,512,512.00,0.00,24730,24731
33101,1,512,512,512.00,0.00,24730,24731
33102,1,512,512,512.00,0.00,24730,24731
33103,1,512,512,512.00,0.00,24730,24731
33104,4,383,1,128.00,23794.50,24730,24734
33105,1,512,512,512.00,0.00,24733,24734
33106,1,512,512,512.00,0.00,24733,24734
33107,1,512,512,512.00,0.00,24733,24734
33108,1,512,512,512.00,0.00,24733,24734
33109,2,370,142,256.00,12996.00,24733,24735
33110,1,512,512,512.00,0.00,24734,24735
33111,1,512,512,512.00,0.00,24734,24735
33112,2,334,178,256.00,6084.00,24734,24736
33113,1,512,512,512.00,0.00,24735,24736
33114,2,456,56,256.00,40000.00,24735,24737
33115,2,321,191,256.00,4225.00,24736,24738
33116,3,322,11,170.67,16154.89,24737,24740
33117,3,329,91,170.67,12534.89,24739,24742
33118,1,512,512,512.00,0.00,24741,24742
33119,2,372,140,256.00,13456.00,24741,24743
33120,1,512,512,512.00,0.00,24742,24743
33121,1,512,512,512.00,0.00,24742,24743
33122,1,512,512,512.00,0.00,24742,24743
33123,3,370,48,170.67,20219.56,24742,24745
33124,1,512,512,512.00,0.00,24744,24745
33125,4,357,5,128.00,20219.00,24744,24748
33126,2,502,10,256.00,60516.00,24747,24749
33127,1,512,512,512.00,0.00,24748,24749
33128,1,512,512,512.00,0.00,24748,24749
33129,2,261,251,256.00,25.00,24748,24750
33130,1,512,512,512.00,0.00,24749,24750
33131,1,512,512,512.00,0.00,24749,24750
33132,1,512,512,512.00,0.00,24749,24750
33133,4,233,46,128.00,6918.50,24749,24753
33134,1,512,512,512.00,0.00,24752,24753
33135,1,512,512,512.00,0.00,24752,24753
33136,3,324,2,170.67,17398.22,24752,24755
33137,2,259,253,256.00,9.00,24754,24756
33138,7,257,4,73.14,6776.12,24755,24762
33139,3,489,3,170.67,50716.22,24761,24764
33140,1,512,512,512.00,0.00,24763,24764
33141,1,512,512,512.00,0.00,24763,24764
33142,1,512,512,512.00,0.00,24763,24764
33143,1,512,512,512.00,0.00,24763,24764
33144,1,512,512,512.00,0.00,24763,24764
33145,3,476,3,170.67,46764.22,24763,24766
33146,1,512,512,512.00,0.00,24765,24766
33147,6,140,1,85.33,2684.89,24765,24771
33148,1,512,512,512.00,0.00,24770,24771
33149,1,512,512,512.00,0.00,24770,24771
33150,1,512,512,512.00,0.00,24770,24771
33151,5,279,11,102.40,9665.84,24770,24775
33152,3,243,27,170.67,10320.22,24774,24777
33153,6,300,4,85.33,10568.56,24776,24782
33154,1,512,512,512.00,0.00,24781,24782
33155,1,512,512,512.00,0.00,24781,24782
33156,1,512,512,512.00,0.00,24781,24782
33157,2,447,65,256.00,36481.00,24781,24783
33158,1,512,512,512.00,0.00,24782,24783
33159,1,512,512,512.00,0.00,24782,24783
33160,5,209,4,102.40,5723.44,24782,24787
33161,2,502,10,256.00,60516.00,24786,24788
33162,1,512,512,512.00,0.00,24787,24788
33163,1,512,512,512.00,0.00,24787,24788
33164,1,512,512,512.00,0.00,24787,24788
33165,1,512,512,512.00,0.00,24787,24788
33166,1,512,512,512.00,0.00,24787,24788
33167,1,512,512,512.00,0.00,24787,24788
33168,1,512,512,512.00,0.00,24787,24788
33169,1,512,512,512.00,0.00,24787,24788
33170,1,512,512,512.00,0.00,24787,24788
33171,1,512,512,512.00,0.00,24787,24788
33172,1,512,512,512.00,0.00,24787,24788
33173,11,319,1,46.55,7673.16,24787,24798
33174,2,506,6,256.00,62500.00,24797,24799
33175,1,512,512,512.00,0.00,24798,24799
33176,1,512,512,512.00,0.00,24798,24799
33177,5,343,6,102.40,15466.64,24798,24803
33178,1,512,512,512.00,0.00,24802,24803
33179,1,512,512,512.00,0.00,24802,24803
33180,1,512,512,512.00,0.00,24802,24803
33181,1,512,512,512.00,0.00,24802,24803
33182,1,512,512,512.00,0.00,24802,24803
33183,4,164,68,128.00,1328.00,24802,24806
33184,1,512,512,512.00,0.00,24805,24806
33185,1,512,512,512.00,0.00,24805,24806
33186,1,512,512,512.00,0.00,24805,24806
33187,3,335,31,170.67,15706.89,24805,24808
33188,1,512,512,512.00,0.00,24807,24808
33189,1,512,512,512.00,0.00,24807,24808
33190,1,512,512,512.00,0.00,24807,24808
33191,1,512,512,512.00,0.00,24807,24808
33192,2,274,238,256.00,324.00,24807,24809
33193,3,399,41,170.67,26228.22,24808,24811
33194,2,404,108,256.00,21904.00,24810,24812
33195,9,414,1,56.89,16220.10,24811,24820
33196,1,512,512,512.00,0.00,24819,24820
33197,4,182,73,128.00,1590.50,24819,24823
33198,4,275,2,128.00,14679.50,24822,24826
33199,2,262,250,256.00,36.00,24825,24827
33200,1,512,512,512.00,0.00,24826,24827
33201,1,512,512,512.00,0.00,24826,24827
33202,1,512,512,512.00,0.00,24826,24827
33203,1,512,512,512.00,0.00,24826,24827
33204,1,512,512,512.00,0.00,24826,24827
33205,1,512,512,512.00,0.00,24826,24827
33206,3,359,2,170.67,21434.89,24826,24829
33207,3,293,4,170.67,14902.89,24828,24831
33208,1,512,512,512.00,0.00,24830,24831
33209,1,512,512,512.00,0.00,24830,24831
33210,1,512,512,512.00,0.00,24830,24831
33211,1,512,512,512.00,0.00,24830,24831
33212,1,512,512,512.00,0.00,24830,24831
33213,1,512,512,512.00,0.00,24830,24831
33214,1,512,512,512.00,0.00,24830,24831
33215,1,512,512,512.00,0.00,24830,24831
33216,3,342,40,170.67,16027.56,24830,24833
33217,4,440,2,128.00,32967.50,24832,24836
33218,4,391,2,128.00,23743.50,24835,24839
33219,1,512,512,512.00,0.00,24838,24839
33220,1,512,512,512.00,0.00,24838,24839
33221,1,512,512,512.00,0.00,24838,24839
33222,5,404,1,102.40,23370.64,24838,24843
33223,6,246,1,85.33,9471.22,24842,24848
33224,1,512,512,512.00,0.00,24847,24848
33225,1,512,512,512.00,0.00,24847,24848
33226,3,297,4,170.67,15121.56,24847,24850
33227,2,479,33,256.00,49729.00,24849,24851
33228,1,512,512,512.00,0.00,24850,24851
33229,1,512,512,512.00,0.00,24850,24851
33230,1,512,512,512.00,0.00,24850,24851
33231,4,209,47,128.00,6245.00,24850,24854
33232,6,254,1,85.33,7751.56,24853,24859
33233,3,438,34,170.67,35739.56,24858,24861
33234,2,405,107,256.00,22201.00,24860,24862
33235,4,416,2,128.00,28998.00,24861,24865
33236,2,485,27,256.00,52441.00,24864,24866
33237,2,465,47,256.00,43681.00,24865,24867
33238,4,202,20,128.00,4794.00,24866,24870
33239,4,298,22,128.00,10586.50,24869,24873
33240,1,512,512,512.00,0.00,24872,24873
33241,1,512,512,512.00,0.00,24872,24873
33242,2,469,43,256.00,45369.00,24872,24874
33243,1,512,512,512.00,0.00,24873,24874
33244,1,512,512,512.00,0.00,24873,24874
33245,1,512,512,512.00,0.00,24873,24874
33246,2,277,235,256.00,441.00,24873,24875
33247,1,512,512,512.00,0.00,24874,24875
33248,1,512,512,512.00,0.00,24874,24875
33249,1,512,512,512.00,0.00,24874,24875
33250,2,295,217,256.00,1521.00,24874,24876
33251,1,512,512,512.00,0.00,24875,24876
33252,1,512,512,512.00,0.00,24875,24876
33253,1,512,512,512.00,0.00,24875,24876
33254,1,512,512,512.00,0.00,24875,24876
33255,1,512,512,512.00,0.00,24875,24876
33256,2,399,113,256.00,20449.00,24875,24877
33257,2,354,158,256.00,9604.00,24876,24878
33258,1,512,512,512.00,0.00,24877,24878
33259,1,512,512,512.00,0.00,24877,24878
33260,1,512,512,512.00,0.00,24877,24878
33261,1,512,512,512.00,0.00,24877,24878
33262,3,342,1,170.67,19381.56,24877,24880
33263,1,512,512,512.00,0.00,24879,24880
33264,1,512,512,512.00,0.00,24879,24880
33265,2,464,48,256.00,43264.00,24879,24881
33266,1,512,512,512.00,0.00,24880,24881
33267,2,462,50,256.00,42436.00,24880,24882
33268,1,512,512,512.00,0.00,24881,24882
33269,1,512,512,512.00,0.00,24881,24882
33270,2,493,19,256.00,56169.00,24881,24883
33271,1,512,512,512.00,0.00,24882,24883
33272,1,512,512,512.00,0.00,24882,24883
33273,1,512,512,512.00,0.00,24882,24883
33274,3,251,75,170.67,5280.22,24882,24885
33275,2,487,25,256.00,53361.00,24884,24886
33276,1,512,512,512.00,0.00,24885,24886
33277,3,273,98,170.67,5544.22,24885,24888
33278,1,512,512,512.00,0.00,24887,24888
33279,1,512,512,512.00,0.00,24887,24888
33280,1,512,512,512.00,0.00,24887,24888
33281,3,426,26,170.67,32790.22,24887,24890
33282,1,512,512,512.00,0.00,24889,24890
33283,1,512,512,512.00,0.00,24889,24890
33284,2,488,24,256.00,53824.00,24889,24891
33285,1,512,512,512.00,0.00,24890,24891
33286,1,512,512,512.00,0.00,24890,24891
33287,1,512,512,512.00,0.00,24890,24891
33288,1,512,512,512.00,0.00,24890,24891
33289,1,512,512,512.00,0.00,24890,24891
33290,1,512,512,512.00,0.00,24890,24891
33291,1,512,512,512.00,0.00,24890,24891
33292,1,512,512,512.00,0.00,24890,24891
33293,1,512,512,512.00,0.00,24890,24891
33294,1,512,512,512.00,0.00,24890,24891
33295,2,389,123,256.00,17689.00,24890,24892
33296,1,512,512,512.00,0.00,24891,24892
33297,3,384,63,170.67,22756.22,24891,24894
33298,3,299,10,170.67,14442.89,24893,24896
33299,1,512,512,512.00,0.00,24895,24896
33300,1,512,512,512.00,0.00,24895,24896
33301,1,512,512,512.00,0.00,24895,24896
33302,1,512,512,512.00,0.00,24895,24896
33303,1,512,512,512.00,0.00,24895,24896
33304,2,407,105,256.00,22801.00,24895,24897
33305,1,512,512,512.00,0.00,24896,24897
33306,1,512,512,512.00,0.00,24896,24897
33307,1,512,512,512.00,0.00,24896,24897
33308,1,512,512,512.00,0.00,24896,24897
33309,2,279,233,256.00,529.00,24896,24898
33310,1,512,512,512.00,0.00,24897,24898
33311,1,512,512,512.00,0.00,24897,24898
33312,1,512,512,512.00,0.00,24897,24898
33313,1,512,512,512.00,0.00,24897,24898
33314,2,443,69,256.00,34969.00,24897,24899
33315,1,512,512,512.00,0.00,24898,24899
33316,1,512,512,512.00,0.00,24898,24899
33317,5,294,1,102.40,14064.24,24898,24903
33318,2,269,243,256.00,169.00,24902,24904
33319,1,512,512,512.00,0.00,24903,24904
33320,1,512,512,512.00,0.00,24903,24904
33321,1,512,512,512.00,0.00,24903,24904
33322,5,253,1,102.40,9678.24,24903,24908
33323,1,512,512,512.00,0.00,24907,24908
33324,1,512,512,512.00,0.00,24907,24908
33325,1,512,512,512.00,0.00,24907,24908
33326,2,399,113,256.00,20449.00,24907,24909
33327,2,487,25,256.00,53361.00,24908,24910
33328,1,512,512,512.00,0.00,24909,24910
33329,1,512,512,512.00,0.00,24909,24910
33330,3,248,22,170.67,11056.89,24909,24912
33331,1,512,512,512.00,0.00,24911,24912
33332,3,385,22,170.67,24117.56,24911,24914
33333,1,512,512,512.00,0.00,24913,24914
33334,1,512,512,512.00,0.00,24913,24914
33335,1,512,512,512.00,0.00,24913,24914
33336,4,374,4,128.00,21014.00,24913,24917
33337,1,512,512,512.00,0.00,24916,24917
33338,1,512,512,512.00,0.00,24916,24917
33339,2,464,48,256.00,43264.00,24916,24918
33340,2,489,23,256.00,54289.00,24917,24919
33341,1,512,512,512.00,0.00,24918,24919
33342,3,382,52,170.67,22443.56,24918,24921
33343,1,512,512,512.00,0.00,24920,24921
33344,1,512,512,512.00,0.00,24920,24921
33345,4,475,9,128.00,40141.00,24920,24924
33346,5,286,1,102.40,10617.84,24923,24928
33347,1,512,512,512.00,0.00,24927,24928
33348,4,311,1,128.00,14309.00,24927,24931
33349,1,512,512,512.00,0.00,24930,24931
33350,1,512,512,512.00,0.00,24930,24931
33351,3,353,42,170.67,17560.22,24930,24933
33352,6,271,1,85.33,8390.89,24932,24938
33353,2,416,96,256.00,25600.00,24937,24939
33354,1,512,512,512.00,0.00,24938,24939
33355,1,512,512,512.00,0.00,24938,24939
33356,5,367,1,102.40,18547.84,24938,24943
33357,2,456,56,256.00,40000.00,24942,24944
33358,1,512,512,512.00,0.00,24943,24944
33359,1,512,512,512.00,0.00,24943,24944
33360,1,512,512,512.00,0.00,24943,24944
33361,2,488,24,256.00,53824.00,24943,24945
33362,1,512,512,512.00,0.00,24944,24945
33363,1,512,512,512.00,0.00,24944,24945
33364,2,398,114,256.00,20164.00,24944,24946
33365,1,512,512,512.00,0.00,24945,24946
33366,1,512,512,512.00,0.00,24945,24946
33367,2,508,4,256.00,63504.00,24945,24947
33368,3,256,13,170.67,12457.56,24946,24949
33369,1,512,512,512.00,0.00,24948,24949
33370,1,512,512,512.00,0.00,24948,24949
33371,2,486,26,256.00,52900.00,24948,24950
33372,3,271,69,170.67,6801.56,24949,24952
33373,1,512,512,512.00,0.00,24951,24952
33374,2,408,104,256.00,23104.00,24951,24953
33375,1,512,512,512.00,0.00,24952,24953
33376,1,512,512,512.00,0.00,24952,24953
33377,7,161,16,73.14,2302.69,24952,24959
33378,1,512,512,512.00,0.00,24958,24959
33379,1,512,512,512.00,0.00,24958,24959
33380,5,208,2,102.40,4922.24,24958,24963
33381,1,512,512,512.00,0.00,24962,24963
33382,2,299,213,256.00,1849.00,24962,24964
33383,1,512,512,512.00,0.00,24963,24964
33384,2,282,230,256.00,676.00,24963,24965
33385,1,512,512,512.00,0.00,24964,24965
33386,2,432,80,256.00,30976.00,24964,24966
33387,1,512,512,512.00,0.00,24965,24966
33388,1,512,512,512.00,0.00,24965,24966
33389,1,512,512,512.00,0.00,24965,24966
33390,4,192,2,128.00,5481.50,24965,24969
33391,1,512,512,512.00,0.00,24968,24969
33392,1,512,512,512.00,0.00,24968,24969
33393,2,453,59,256.00,38809.00,24968,24970
33394,1,512,512,512.00,0.00,24969,24970
33395,5,142,66,102.40,940.24,24969,24974
33396,3,373,34,170.67,21309.56,24973,24976
33397,1,512,512,512.00,0.00,24975,24976
33398,5,167,19,102.40,4542.64,24975,24980
33399,1,512,512,512.00,0.00,24979,24980
33400,1,512,512,512.00,0.00,24979,24980
33401,6,201,1,85.33,5097.89,24979,24985
33402,1,512,512,512.00,0.00,24984,24985
33403,3,319,93,170.67,11009.56,24984,24987
33404,1,512,512,512.00,0.00,24986,24987
33405,2,329,183,256.00,5329.00,24986,24988
33406,2,372,140,256.00,13456.00,24987,24989
33407,1,512,512,512.00,0.00,24988,24989
33408,1,512,512,512.00,0.00,24988,24989
33409,1,512,512,512.00,0.00,24988,24989
33410,1,512,512,512.00,0.00,24988,24989
33411,2,274,238,256.00,324.00,24988,24990
33412,2,325,187,256.00,4761.00,24989,24991
33413,1,512,512,512.00,0.00,24990,24991
33414,3,293,77,170.67,8186.89,24990,24993
33415,1,512,512,512.00,0.00,24992,24993
33416,1,512,512,512.00,0.00,24992,24993
33417,1,512,512,512.00,0.00,24992,24993
33418,2,437,75,256.00,32761.00,24992,24994
33419,2,496,16,256.00,57600.00,24993,24995
33420,3,267,104,170.67,4868.22,24994,24997
33421,1,512,512,512.00,0.00,24996,24997
33422,6,158,6,85.33,3823.89,24996,25002
33423,1,512,512,512.00,0.00,25001,25002
33424,1,512,512,512.00,0.00,25001,25002
33425,1,512,512,512.00,0.00,25001,25002
33426,1,512,512,512.00,0.00,25001,25002
33427,1,512,512,512.00,0.00,25001,25002
33428,6,280,1,85.33,9488.89,25001,25007
33429,1,512,512,512.00,0.00,25006,25007
33430,1,512,512,512.00,0.00,25006,25007
33431,3,313,76,170.67,10497.56,25006,25009
33432,1,512,512,512.00,0.00,25008,25009
33433,7,190,3,73.14,4550.12,25008,25015
33434,1,512,512,512.00,0.00,25014,25015
33435,1,512,512,512.00,0.00,25014,25015
33436,1,512,512,512.00,0.00,25014,25015
33437,2,454,58,256.00,39204.00,25014,25016
33438,2,402,110,256.00,21316.00,25015,25017
33439,2,314,198,256.00,3364.00,25016,25018
33440,3,256,33,170.67,9657.56,25017,25020
33441,1,512,512,512.00,0.00,25019,25020
33442,3,214,137,170.67,1034.89,25019,25022
33443,1,512,512,512.00,0.00,25021,25022
33444,1,512,512,512.00,0.00,25021,25022
33445,1,512,512,512.00,0.00,25021,25022
33446,1,512,512,512.00,0.00,25021,25022
33447,1,512,512,512.00,0.00,25021,25022
33448,6,332,2,85.33,12701.89,25021,25027
33449,2,408,104,256.00,23104.00,25026,25028
33450,1,512,512,512.00,0.00,25027,25028
33451,1,512,512,512.00,0.00,25027,25028
33452,2,443,69,256.00,34969.00,25027,25029
33453,1,512,512,512.00,0.00,25028,25029
33454,1,512,512,512.00,0.00,25028,25029
33455,1,512,512,512.00,0.00,25028,25029
33456,2,455,57,256.00,39601.00,25028,25030
33457,4,460,6,128.00,36790.00,25029,25033
33458,1,512,512,512.00,0.00,25032,25033
33459,1,512,512,512.00,0.00,25032,25033
33460,4,243,6,128.00,13028.50,25032,25036
33461,2,461,51,256.00,42025.00,25035,25037
33462,1,512,512,512.00,0.00,25036,25037
33463,1,512,512,512.00,0.00,25036,25037
33464,1,512,512,512.00,0.00,25036,25037
33465,1,512,512,512.00,0.00,25036,25037
33466,2,494,18,256.00,56644.00,25036,25038
33467,2,435,77,256.00,32041.00,25037,25039
33468,3,384,2,170.67,25318.22,25038,25041
33469,3,299,1,170.67,15654.89,25040,25043
33470,2,448,64,256.00,36864.00,25042,25044
33471,2,405,107,256.00,22201.00,25043,25045
33472,3,372,30,170.67,21334.22,25044,25047
33473,3,281,1,170.67,14826.89,25046,25049
33474,1,512,512,512.00,0.00,25048,25049
33475,1,512,512,512.00,0.00,25048,25049
33476,1,512,512,512.00,0.00,25048,25049
33477,6,275,2,85.33,8747.22,25048,25054
33478,4,309,7,128.00,12325.00,25053,25057
33479,1,512,512,512.00,0.00,25056,25057
33480,1,512,512,512.00,0.00,25056,25057
33481,3,241,74,170.67,4994.89,25056,25059
33482,3,310,3,170.67,16109.56,25058,25061
33483,1,512,512,512.00,0.00,25060,25061
33484,2,392,120,256.00,18496.00,25060,25062
33485,1,512,512,512.00,0.00,25061,25062
33486,1,512,512,512.00,0.00,25061,25062
33487,1,512,512,512.00,0.00,25061,25062
33488,1,512,512,512.00,0.00,25061,25062
33489,1,512,512,512.00,0.00,25061,25062
33490,2,286,226,256.00,900.00,25061,25063
33491,1,512,512,512.00,0.00,25062,25063
33492,1,512,512,512.00,0.00,25062,25063
33493,2,382,130,256.00,15876.00,25062,25064
33494,1,512,512,512.00,0.00,25063,25064
33495,1,512,512,512.00,0.00,25063,25064
33496,1,512,512,512.00,0.00,25063,25064
33497,1,512,512,512.00,0.00,25063,25064
33498,1,512,512,512.00,0.00,25063,25064
33499,3,474,2,170.67,46198.22,25063,25066
33500,1,512,512,512.00,0.00,25065,25066
33501,1,512,512,512.00,0.00,25065,25066
33502,1,512,512,512.00,0.00,25065,25066
33503,2,428,84,256.00,29584.00,25065,25067
33504,1,512,512,512.00,0.00,25066,25067
33505,1,512,512,512.00,0.00,25066,25067
33506,1,512,512,512.00,0.00,25066,25067
33507,6,174,10,85.33,3679.22,25066,25072
33508,1,512,512,512.00,0.00,25071,25072
33509,1,512,512,512.00,0.00,25071,25072
33510,1,512,512,512.00,0.00,25071,25072
33511,1,512,512,512.00,0.00,25071,25072
33512,1,512,512,512.00,0.00,25071,25072
33513,1,512,512,512.00,0.00,25071,25072
33514,1,512,512,512.00,0.00,25071,25072
33515,1,512,512,512.00,0.00,25071,25072
33516,1,512,512,512.00,0.00,25071,25072
33517,5,361,3,102.40,17120.64,25071,25076
33518,3,258,74,170.67,5686.22,25075,25078
33519,1,512,512,512.00,0.00,25077,25078
33520,1,512,512,512.00,0.00,25077,25078
33521,1,512,512,512.00,0.00,25077,25078
33522,2,260,252,256.00,16.00,25077,25079
33523,1,512,512,512.00,0.00,25078,25079
33524,1,512,512,512.00,0.00,25078,25079
33525,1,512,512,512.00,0.00,25078,25079
33526,1,512,512,512.00,0.00,25078,25079
33527,1,512,512,512.00,0.00,25078,25079
33528,1,512,512,512.00,0.00,25078,25079
33529,1,512,512,512.00,0.00,25078,25079
33530,7,227,3,73.14,6324.98,25078,25085
33531,4,381,3,128.00,22838.50,25084,25088
33532,7,221,2,73.14,4155.84,25087,25094
33533,1,512,512,512.00,0.00,25093,25094
33534,1,512,512,512.00,0.00,25093,25094
33535,1,512,512,512.00,0.00,25093,25094
33536,1,512,512,512.00,0.00,25093,25094
33537,1,512,512,512.00,0.00,25093,25094
33538,1,512,512,512.00,0.00,25093,25094
33539,3,393,45,170.67,24856.22,25093,25096
33540,1,512,512,512.00,0.00,25095,25096
33541,1,512,512,512.00,0.00,25095,25096
33542,2,441,71,256.00,34225.00,25095,25097
33543,1,512,512,512.00,0.00,25096,25097
33544,1,512,512,512.00,0.00,25096,25097
33545,8,250,1,64.00,7321.25,25096,25104
33546,1,512,512,512.00,0.00,25103,25104
33547,1,512,512,512.00,0.00,25103,25104
33548,2,263,249,256.00,49.00,25103,25105
33549,1,512,512,512.00,0.00,25104,25105
33550,1,512,512,512.00,0.00,25104,25105
33551,3,219,110,170.67,2056.22,25104,25107
33552,3,438,4,170.67,36459.56,25106,25109
33553,1,512,512,512.00,0.00,25108,25109
33554,5,274,2,102.40,8791.04,25108,25113
33555,1,512,512,512.00,0.00,25112,25113
33556,1,512,512,512.00,0.00,25112,25113
33557,1,512,512,512.00,0.00,25112,25113
33558,1,512,512,512.00,0.00,25112,25113
33559,8,195,2,64.00,4704.00,25112,25120
33560,5,168,19,102.40,3769.04,25119,25124
33561,1,512,512,512.00,0.00,25123,25124
33562,1,512,512,512.00,0.00,25123,25124
33563,1,512,512,512.00,0.00,25123,25124
33564,1,512,512,512.00,0.00,25123,25124
33565,5,285,15,102.40,10193.44,25123,25128
33566,4,330,5,128.00,17248.50,25127,25131
33567,2,320,192,256.00,4096.00,25130,25132
33568,1,512,512,512.00,0.00,25131,25132
33569,1,512,512,512.00,0.00,25131,25132
33570,2,401,111,256.00,21025.00,25131,25133
33571,1,512,512,512.00,0.00,25132,25133
33572,2,473,39,256.00,47089.00,25133,25135
33573,1,512,512,512.00,0.00,25134,25135
33574,1,512,512,512.00,0.00,25134,25135
33575,1,512,512,512.00,0.00,25134,25135
33576,1,512,512,512.00,0.00,25134,25135
33577,4,255,2,128.00,8154.50,25134,25138
33578,1,512,512,512.00,0.00,25137,25138
33579,1,512,512,512.00,0.00,25137,25138
33580,5,361,3,102.40,17455.04,25137,25142
33581,3,494,9,170.67,52272.22,25141,25144
33582,3,309,19,170.67,14105.56,25143,25146
33583,1,512,512,512.00,0.00,25145,25146
33584,1,512,512,512.00,0.00,25145,25146
33585,1,512,512,512.00,0.00,25145,25146
33586,3,444,9,170.67,37772.22,25145,25148
33587,11,276,1,46.55,6144.43,25147,25158
33588,1,512,512,512.00,0.00,25157,25158
33589,2,257,255,256.00,1.00,25157,25159
33590,1,512,512,512.00,0.00,25158,25159
33591,1,512,512,512.00,0.00,25158,25159
33592,1,512,512,512.00,0.00,25158,25159
33593,1,512,512,512.00,0.00,25158,25159
33594,1,512,512,512.00,0.00,25158,25159
33595,1,512,512,512.00,0.00,25158,25159
33596,1,512,512,512.00,0.00,25158,25159
33597,2,348,164,256.00,8464.00,25158,25160
33598,1,512,512,512.00,0.00,25159,25160
33599,1,512,512,512.00,0.00,25159,25160
33600,1,512,512,512.00,0.00,25159,25160
33601,1,512,512,512.00,0.00,25159,25160
33602,1,512,512,512.00,0.00,25159,25160
33603,1,512,512,512.00,0.00,25159,25160
33604,1,512,512,512.00,0.00,25159,25160
33605,2,298,214,256.00,1764.00,25159,25161
33606,4,308,28,128.00,12912.50,25160,25164
33607,2,310,202,256.00,2916.00,25163,25165
33608,1,512,512,512.00,0.00,25164,25165
33609,1,512,512,512.00,0.00,25164,25165
33610,2,324,188,256.00,4624.00,25164,25166
33611,1,512,512,512.00,0.00,25165,25166
33612,1,512,512,512.00,0.00,25165,25166
33613,2,260,252,256.00,16.00,25165,25167
33614,1,512,512,512.00,0.00,25166,25167
33615,1,512,512,512.00,0.00,25166,25167
33616,1,512,512,512.00,0.00,25166,25167
33617,1,512,512,512.00,0.00,25166,25167
33618,1,512,512,512.00,0.00,25166,25167
33619,1,512,512,512.00,0.00,25166,25167
33620,1,512,512,512.00,0.00,25166,25167
33621,1,512,512,512.00,0.00,25166,25167
33622,2,498,14,256.00,58564.00,25166,25168
33623,1,512,512,512.00,0.00,25167,25168
33624,2,491,21,256.00,55225.00,25167,25169
33625,1,512,512,512.00,0.00,25168,25169
33626,1,512,512,512.00,0.00,25168,25169
33627,3,484,1,170.67,49201.56,25168,25171
33628,7,309,2,73.14,10197.84,25170,25177
33629,2,346,166,256.00,8100.00,25176,25178
33630,3,245,47,170.67,7750.89,25177,25180
33631,1,512,512,512.00,0.00,25179,25180
33632,4,256,2,128.00,15753.50,25179,25183
33633,3,407,1,170.67,29694.89,25182,25185
33634,3,350,21,170.67,18480.22,25184,25187
33635,1,512,512,512.00,0.00,25186,25187
33636,1,512,512,512.00,0.00,25186,25187
33637,1,512,512,512.00,0.00,25186,25187
33638,1,512,512,512.00,0.00,25186,25187
33639,8,406,1,64.00,17042.00,25186,25194
33640,1,512,512,512.00,0.00,25193,25194
33641,4,302,2,128.00,17028.00,25193,25197
33642,1,512,512,512.00,0.00,25196,25197
33643,1,512,512,512.00,0.00,25196,25197
33644,1,512,512,512.00,0.00,25196,25197
33645,3,395,26,170.67,25866.89,25196,25199
33646,5,217,3,102.40,8127.04,25198,25203
33647,1,512,512,512.00,0.00,25202,25203
33648,1,512,512,512.00,0.00,25202,25203
33649,1,512,512,512.00,0.00,25202,25203
33650,1,512,512,512.00,0.00,25202,25203
33651,3,295,34,170.67,11429.56,25202,25205
33652,1,512,512,512.00,0.00,25204,25205
33653,1,512,512,512.00,0.00,25204,25205
33654,1,512,512,512.00,0.00,25204,25205
33655,1,512,512,512.00,0.00,25204,25205
33656,1,512,512,512.00,0.00,25204,25205
33657,1,512,512,512.00,0.00,25204,25205
33658,1,512,512,512.00,0.00,25204,25205
33659,3,276,2,170.67,14518.22,25204,25207
33660,1,512,512,512.00,0.00,25206,25207
33661,1,512,512,512.00,0.00,25206,25207
33662,1,512,512,512.00,0.00,25206,25207
33663,1,512,512,512.00,0.00,25206,25207
33664,2,483,29,256.00,51529.00,25206,25208
33665,5,266,4,102.40,13736.64,25207,25212
33666,1,512,512,512.00,0.00,25211,25212
33667,1,512,512,512.00,0.00,25211,25212
33668,1,512,512,512.00,0.00,25211,25212
33669,1,512,512,512.00,0.00,25211,25212
33670,3,436,6,170.67,35883.56,25211,25214
33671,2,391,121,256.00,18225.00,25213,25215
33672,1,512,512,512.00,0.00,25214,25215
33673,1,512,512,512.00,0.00,25214,25215
33674,5,398,4,102.40,22320.64,25214,25219
33675,2,468,44,256.00,44944.00,25218,25220
33676,2,498,14,256.00,58564.00,25219,25221
33677,3,369,22,170.67,21301.56,25220,25223
33678,1,512,512,512.00,0.00,25222,25223
33679,3,300,22,170.67,13067.56,25222,25225
33680,1,512,512,512.00,0.00,25224,25225
33681,2,313,199,256.00,3249.00,25224,25226
33682,1,512,512,512.00,0.00,25225,25226
33683,3,253,84,170.67,4769.56,25225,25228
33684,1,512,512,512.00,0.00,25227,25228
33685,5,224,9,102.40,8171.44,25227,25232
33686,2,390,122,256.00,17956.00,25231,25233
33687,4,211,24,128.00,6827.50,25232,25236
33688,2,320,192,256.00,4096.00,25235,25237
33689,1,512,512,512.00,0.00,25236,25237
33690,1,512,512,512.00,0.00,25236,25237
33691,1,512,512,512.00,0.00,25236,25237
33692,1,512,512,512.00,0.00,25236,25237
33693,1,512,512,512.00,0.00,25236,25237
33694,1,512,512,512.00,0.00,25236,25237
33695,5,311,2,102.40,12749.04,25236,25241
33696,1,512,512,512.00,0.00,25240,25241
33697,1,512,512,512.00,0.00,25240,25241
33698,1,512,512,512.00,0.00,25240,25241
33699,3,434,31,170.67,34714.89,25240,25243
33700,6,219,3,85.33,8604.89,25242,25248
33701,1,512,512,512.00,0.00,25247,25248
33702,2,394,118,256.00,19044.00,25247,25249
33703,3,310,61,170.67,10773.56,25248,25251
33704,1,512,512,512.00,0.00,25250,25251
33705,1,512,512,512.00,0.00,25250,25251
33706,1,512,512,512.00,0.00,25250,25251
33707,1,512,512,512.00,0.00,25250,25251
33708,3,498,1,170.67,53597.56,25250,25253
33709,3,410,40,170.67,28720.89,25252,25255
33710,5,240,6,102.40,8155.44,25254,25259
33711,1,512,512,512.00,0.00,25258,25259
33712,1,512,512,512.00,0.00,25258,25259
33713,3,231,102,170.67,2808.22,25258,25261
33714,3,394,6,170.67,26811.56,25260,25263
33715,2,458,54,256.00,40804.00,25262,25264
33716,1,512,512,512.00,0.00,25263,25264
33717,4,279,6,128.00,12929.50,25263,25267
33718,1,512,512,512.00,0.00,25266,25267
33719,1,512,512,512.00,0.00,25266,25267
33720,1,512,512,512.00,0.00,25266,25267
33721,1,512,512,512.00,0.00,25266,25267
33722,1,512,512,512.00,0.00,25266,25267
33723,1,512,512,512.00,0.00,25266,25267
33724,1,512,512,512.00,0.00,25266,25267
33725,2,475,37,256.00,47961.00,25266,25268
33726,1,512,512,512.00,0.00,25267,25268
33727,1,512,512,512.00,0.00,25267,25268
33728,1,512,512,512.00,0.00,25267,25268
33729,1,512,512,512.00,0.00,25267,25268
33730,1,512,512,512.00,0.00,25267,25268
33731,1,512,512,512.00,0.00,25267,25268
33732,1,512,512,512.00,0.00,25267,25268
33733,1,512,512,512.00,0.00,25267,25268
33734,1,512,512,512.00,0.00,25267,25268
33735,5,171,3,102.40,4952.24,25267,25272
33736,2,460,52,256.00,41616.00,25271,25273
33737,2,469,43,256.00,45369.00,25272,25274
33738,1,512,512,512.00,0.00,25273,25274
33739,1,512,512,512.00,0.00,25273,25274
33740,1,512,512,512.00,0.00,25273,25274
33741,1,512,512,512.00,0.00,25273,25274
33742,3,441,4,170.67,37201.56,25273,25276
33743,3,264,72,170.67,6158.22,25275,25278
33744,1,512,512,512.00,0.00,25277,25278
33745,1,512,512,512.00,0.00,25277,25278
33746,3,406,6,170.67,29163.56,25277,25280
33747,1,512,512,512.00,0.00,25279,25280
33748,1,512,512,512.00,0.00,25279,25280
33749,1,512,512,512.00,0.00,25279,25280
33750,1,512,512,512.00,0.00,25279,25280
33751,1,512,512,512.00,0.00,25279,25280
33752,1,512,512,512.00,0.00,25279,25280
33753,1,512,512,512.00,0.00,25279,25280
33754,1,512,512,512.00,0.00,25279,25280
33755,1,512,512,512.00,0.00,25279,25280
33756,1,512,512,512.00,0.00,25279,25280
33757,3,333,2,170.67,18280.22,25279,25282
33758,2,304,208,256.00,2304.00,25281,25283
33759,3,291,3,170.67,14944.22,25282,25285
33760,1,512,512,512.00,0.00,25284,25285
33761,1,512,512,512.00,0.00,25284,25285
33762,1,512,512,512.00,0.00,25284,25285
33763,1,512,512,512.00,0.00,25284,25285
33764,1,512,512,512.00,0.00,25284,25285
33765,1,512,512,512.00,0.00,25284,25285
33766,1,512,512,512.00,0.00,25284,25285
33767,3,319,9,170.67,16105.56,25284,25287
33768,1,512,512,512.00,0.00,25286,25287
33769,1,512,512,512.00,0.00,25286,25287
33770,3,430,8,170.67,34352.89,25286,25289
33771,1,512,512,512.00,0.00,25288,25289
33772,1,512,512,512.00,0.00,25288,25289
33773,3,378,15,170.67,23296.22,25288,25291
33774,1,512,512,512.00,0.00,25290,25291
33775,1,512,512,512.00,0.00,25290,25291
33776,2,493,19,256.00,56169.00,25290,25292
33777,1,512,512,512.00,0.00,25291,25292
33778,2,439,73,256.00,33489.00,25291,25293
33779,1,512,512,512.00,0.00,25292,25293
33780,5,314,2,102.40,13797.04,25292,25297
33781,2,458,54,256.00,40804.00,25296,25298
33782,1,512,512,512.00,0.00,25297,25298
33783,1,512,512,512.00,0.00,25297,25298
33784,1,512,512,512.00,0.00,25297,25298
33785,1,512,512,512.00,0.00,25297,25298
33786,2,284,228,256.00,784.00,25297,25299
33787,1,512,512,512.00,0.00,25298,25299
33788,1,512,512,512.00,0.00,25298,25299
33789,1,512,512,512.00,0.00,25298,25299
33790,5,224,2,102.40,8882.24,25298,25303
33791,1,512,512,512.00,0.00,25302,25303
33792,1,512,512,512.00,0.00,25302,25303
33793,2,475,37,256.00,47961.00,25302,25304
33794,1,512,512,512.00,0.00,25303,25304
33795,2,280,232,256.00,576.00,25303,25305
33796,1,512,512,512.00,0.00,25304,25305
33797,1,512,512,512.00,0.00,25304,25305
33798,3,236,121,170.67,2326.89,25304,25307
33799,4,252,6,128.00,7597.50,25306,25310
33800,1,512,512,512.00,0.00,25309,25310
33801,1,512,512,512.00,0.00,25309,25310
33802,1,512,512,512.00,0.00,25309,25310
33803,1,512,512,512.00,0.00,25309,25310
33804,3,393,5,170.67,26696.22,25309,25312
33805,2,295,217,256.00,1521.00,25311,25313
33806,1,512,512,512.00,0.00,25312,25313
33807,4,247,10,128.00,8296.50,25312,25316
33808,3,391,54,170.67,24301.56,25315,25318
33809,1,512,512,512.00,0.00,25317,25318
33810,1,512,512,512.00,0.00,25317,25318
33811,1,512,512,512.00,0.00,25317,25318
33812,1,512,512,512.00,0.00,25317,25318
33813,1,512,512,512.00,0.00,25317,25318
33814,1,512,512,512.00,0.00,25317,25318
33815,1,512,512,512.00,0.00,25317,25318
33816,1,512,512,512.00,0.00,25317,25318
33817,4,345,49,128.00,15725.50,25317,25321
33818,1,512,512,512.00,0.00,25320,25321
33819,3,257,96,170.67,4388.22,25320,25323
33820,1,512,512,512.00,0.00,25322,25323
33821,1,512,512,512.00,0.00,25322,25323
33822,1,512,512,512.00,0.00,25322,25323
33823,2,401,111,256.00,21025.00,25322,25324
33824,1,512,512,512.00,0.00,25323,25324
33825,2,361,151,256.00,11025.00,25323,25325
33826,1,512,512,512.00,0.00,25324,25325
33827,1,512,512,512.00,0.00,25324,25325
33828,2,484,28,256.00,51984.00,25324,25326
33829,1,512,512,512.00,0.00,25325,25326
33830,1,512,512,512.00,0.00,25325,25326
33831,1,512,512,512.00,0.00,25325,25326
33832,3,469,1,170.67,44781.56,25325,25328
33833,1,512,512,512.00,0.00,25327,25328
33834,1,512,512,512.00,0.00,25327,25328
33835,7,148,1,73.14,1944.98,25327,25334
33836,3,232,103,170.67,2793.56,25333,25336
33837,1,512,512,512.00,0.00,25335,25336
33838,1,512,512,512.00,0.00,25335,25336
33839,3,331,77,170.67,12974.89,25335,25338
33840,1,512,512,512.00,0.00,25337,25338
33841,1,512,512,512.00,0.00,25337,25338
33842,1,512,512,512.00,0.00,25337,25338
33843,1,512,512,512.00,0.00,25337,25338
33844,1,512,512,512.00,0.00,25337,25338
33845,1,512,512,512.00,0.00,25337,25338
33846,1,512,512,512.00,0.00,25337,25338
33847,2,286,226,256.00,900.00,25337,25339
33848,2,409,103,256.00,23409.00,25338,25340
33849,1,512,512,512.00,0.00,25339,25340
33850,2,264,248,256.00,64.00,25339,25341
33851,1,512,512,512.00,0.00,25340,25341
33852,1,512,512,512.00,0.00,25340,25341
33853,1,512,512,512.00,0.00,25340,25341
33854,1,512,512,512.00,0.00,25340,25341
33855,1,512,512,512.00,0.00,25340,25341
33856,1,512,512,512.00,0.00,25340,25341
33857,1,512,512,512.00,0.00,25340,25341
33858,2,347,165,256.00,8281.00,25340,25342
33859,2,372,140,256.00,13456.00,25341,25343
33860,3,302,6,170.67,15158.22,25342,25345
33861,1,512,512,512.00,0.00,25344,25345
33862,1,512,512,512.00,0.00,25344,25345
33863,1,512,512,512.00,0.00,25344,25345
33864,1,512,512,512.00,0.00,25344,25345
33865,2,424,88,256.00,28224.00,25344,25346
33866,1,512,512,512.00,0.00,25345,25346
33867,1,512,512,512.00,0.00,25345,25346
33868,1,512,512,512.00,0.00,25345,25346
33869,1,512,512,512.00,0.00,25345,25346
33870,1,512,512,512.00,0.00,25345,25346
33871,2,469,43,256.00,45369.00,25345,25347
33872,1,512,512,512.00,0.00,25346,25347
33873,1,512,512,512.00,0.00,25346,25347
33874,1,512,512,512.00,0.00,25346,25347
33875,1,512,512,512.00,0.00,25346,25347
33876,1,512,512,512.00,0.00,25346,25347
33877,1,512,512,512.00,0.00,25346,25347
33878,1,512,512,512.00,0.00,25346,25347
33879,1,512,512,512.00,0.00,25346,25347
33880,3,263,94,170.67,4882.89,25346,25349
33881,2,345,167,256.00,7921.00,25348,25350
33882,2,286,226,256.00,900.00,25349,25351
33883,1,512,512,512.00,0.00,25350,25351
33884,1,512,512,512.00,0.00,25350,25351
33885,1,512,512,512.00,0.00,25350,25351
33886,1,512,512,512.00,0.00,25350,25351
33887,3,425,40,170.67,32350.89,25350,25353
33888,3,320,2,170.67,17040.89,25352,25355
33889,1,512,512,512.00,0.00,25354,25355
33890,2,502,10,256.00,60516.00,25354,25356
33891,2,279,233,256.00,529.00,25355,25357
33892,1,512,512,512.00,0.00,25356,25357
33893,1,512,512,512.00,0.00,25356,25357
33894,1,512,512,512.00,0.00,25356,25357
33895,1,512,512,512.00,0.00,25356,25357
33896,3,402,1,170.67,28701.56,25356,25359
33897,1,512,512,512.00,0.00,25358,25359
33898,1,512,512,512.00,0.00,25358,25359
33899,3,295,80,170.67,8270.89,25358,25361
33900,1,512,512,512.00,0.00,25360,25361
33901,1,512,512,512.00,0.00,25360,25361
33902,3,488,4,170.67,50392.89,25360,25363
33903,3,483,2,170.67,48880.22,25362,25365
33904,3,293,10,170.67,14082.89,25364,25367
33905,2,290,222,256.00,1156.00,25366,25368
33906,1,512,512,512.00,0.00,25367,25368
33907,1,512,512,512.00,0.00,25367,25368
33908,1,512,512,512.00,0.00,25367,25368
33909,4,313,1,128.00,13347.00,25367,25371
33910,4,418,20,128.00,28106.00,25370,25374
33911,1,512,512,512.00,0.00,25373,25374
33912,1,512,512,512.00,0.00,25373,25374
33913,1,512,512,512.00,0.00,25373,25374
33914,1,512,512,512.00,0.00,25373,25374
33915,1,512,512,512.00,0.00,25373,25374
33916,1,512,512,512.00,0.00,25373,25374
33917,3,303,85,170.67,9009.56,25373,25376
33918,1,512,512,512.00,0.00,25375,25376
33919,1,512,512,512.00,0.00,25375,25376
33920,1,512,512,512.00,0.00,25375,25376
33921,1,512,512,512.00,0.00,25375,25376
33922,2,450,62,256.00,37636.00,25375,25377
33923,2,401,111,256.00,21025.00,25376,25378
33924,1,512,512,512.00,0.00,25377,25378
33925,1,512,512,512.00,0.00,25377,25378
33926,1,512,512,512.00,0.00,25377,25378
33927,2,470,42,256.00,45796.00,25377,25379
33928,1,512,512,512.00,0.00,25378,25379
33929,1,512,512,512.00,0.00,25378,25379
33930,1,512,512,512.00,0.00,25378,25379
33931,4,187,27,128.00,3645.50,25378,25382
33932,2,463,49,256.00,42849.00,25381,25383
33933,2,275,237,256.00,361.00,25382,25384
33934,1,512,512,512.00,0.00,25383,25384
33935,1,512,512,512.00,0.00,25383,25384
33936,3,269,33,170.67,10056.22,25383,25386
33937,3,263,84,170.67,5356.22,25385,25388
33938,1,512,512,512.00,0.00,25387,25388
33939,2,440,72,256.00,33856.00,25387,25389
33940,3,273,116,170.67,5244.22,25388,25391
33941,2,386,126,256.00,16900.00,25390,25392
33942,1,512,512,512.00,0.00,25391,25392
33943,2,464,48,256.00,43264.00,25391,25393
33944,6,179,45,85.33,2423.22,25392,25398
33945,1,512,512,512.00,0.00,25397,25398
33946,1,512,512,512.00,0.00,25397,25398
33947,1,512,512,512.00,0.00,25397,25398
33948,1,512,512,512.00,0.00,25397,25398
33949,1,512,512,512.00,0.00,25397,25398
33950,1,512,512,512.00,0.00,25397,25398
33951,2,267,245,256.00,121.00,25397,25399
33952,1,512,512,512.00,0.00,25398,25399
33953,1,512,512,512.00,0.00,25398,25399
33954,3,218,117,170.67,1720.22,25398,25401
33955,3,306,22,170.67,13531.56,25400,25403
33956,1,512,512,512.00,0.00,25402,25403
33957,1,512,512,512.00,0.00,25402,25403
33958,2,497,15,256.00,58081.00,25402,25404
33959,6,243,2,85.33,9854.56,25403,25409
33960,3,438,20,170.67,35926.22,25408,25411
33961,1,512,512,512.00,0.00,25410,25411
33962,1,512,512,512.00,0.00,25410,25411
33963,3,231,90,170.67,3520.22,25410,25413
33964,2,287,225,256.00,961.00,25412,25414
33965,2,482,30,256.00,51076.00,25413,25415
33966,2,507,5,256.00,63001.00,25414,25416
33967,2,448,64,256.00,36864.00,25415,25417
33968,2,293,219,256.00,1369.00,25416,25418
33969,1,512,512,512.00,0.00,25417,25418
33970,1,512,512,512.00,0.00,25417,25418
33971,1,512,512,512.00,0.00,25417,25418
33972,1,512,512,512.00,0.00,25417,25418
33973,3,464,20,170.67,43032.89,25417,25420
33974,1,512,512,512.00,0.00,25419,25420
33975,1,512,512,512.00,0.00,25419,25420
33976,1,512,512,512.00,0.00,25419,25420
33977,1,512,512,512.00,0.00,25419,25420
33978,1,512,512,512.00,0.00,25419,25420
33979,1,512,512,512.00,0.00,25419,25420
33980,2,485,27,256.00,52441.00,25419,25421
33981,1,512,512,512.00,0.00,25420,25421
33982,1,512,512,512.00,0.00,25420,25421
33983,2,439,73,256.00,33489.00,25420,25422
33984,1,512,512,512.00,0.00,25421,25422
33985,3,392,2,170.67,26736.89,25421,25424
33986,4,291,4,128.00,15626.50,25423,25427
33987,1,512,512,512.00,0.00,25426,25427
33988,1,512,512,512.00,0.00,25426,25427
33989,1,512,512,512.00,0.00,25426,25427
33990,1,512,512,512.00,0.00,25426,25427
33991,1,512,512,512.00,0.00,25426,25427
33992,1,512,512,512.00,0.00,25426,25427
33993,6,282,1,85.33,9249.56,25426,25432
33994,1,512,512,512.00,0.00,25431,25432
33995,9,228,1,56.89,5408.54,25431,25440
33996,1,512,512,512.00,0.00,25439,25440
33997,4,362,42,128.00,18278.00,25439,25443
33998,2,324,188,256.00,4624.00,25442,25444
33999,1,512,512,512.00,0.00,25443,25444
34000,2,377,135,256.00,14641.00,25443,25445
34001,1,512,512,512.00,0.00,25444,25445
34002,1,512,512,512.00,0.00,25444,25445
34003,1,512,512,512.00,0.00,25444,25445
34004,1,512,512,512.00,0.00,25444,25445
34005,3,327,4,170.67,17441.56,25444,25447
34006,2,265,247,256.00,81.00,25446,25448
34007,1,512,512,512.00,0.00,25447,25448
34008,1,512,512,512.00,0.00,25447,25448
34009,2,472,40,256.00,46656.00,25447,25449
34010,1,512,512,512.00,0.00,25448,25449
34011,1,512,512,512.00,0.00,25448,25449
34012,1,512,512,512.00,0.00,25448,25449
34013,1,512,512,512.00,0.00,25448,25449
34014,1,512,512,512.00,0.00,25448,25449
34015,5,293,1,102.40,11603.44,25448,25453
34016,2,436,76,256.00,32400.00,25452,25454
34017,3,186,145,170.67,333.56,25453,25456
34018,1,512,512,512.00,0.00,25455,25456
34019,1,512,512,512.00,0.00,25455,25456
34020,1,512,512,512.00,0.00,25455,25456
34021,1,512,512,512.00,0.00,25455,25456
34022,3,241,135,170.67,2473.56,25455,25458
34023,3,336,85,170.67,13673.56,25457,25460
34024,2,508,4,256.00,63504.00,25459,25461
34025,1,512,512,512.00,0.00,25460,25461
34026,1,512,512,512.00,0.00,25460,25461
34027,1,512,512,512.00,0.00,25460,25461
34028,1,512,512,512.00,0.00,25460,25461
34029,1,512,512,512.00,0.00,25460,25461
34030,1,512,512,512.00,0.00,25460,25461
34031,1,512,512,512.00,0.00,25460,25461
34032,1,512,512,512.00,0.00,25460,25461
34033,1,512,512,512.00,0.00,25460,25461
34034,3,209,123,170.67,1276.22,25460,25463
34035,3,289,10,170.67,13869.56,25462,25465
34036,1,512,512,512.00,0.00,25464,25465
34037,1,512,512,512.00,0.00,25464,25465
34038,5,243,7,102.40,7764.64,25464,25469
34039,3,227,88,170.67,3566.89,25468,25471
34040,1,512,512,512.00,0.00,25470,25471
34041,4,355,2,128.00,18246.50,25470,25474
34042,1,512,512,512.00,0.00,25473,25474
34043,1,512,512,512.00,0.00,25473,25474
34044,1,512,512,512.00,0.00,25473,25474
34045,3,325,6,170.67,17013.56,25473,25476
34046,1,512,512,512.00,0.00,25475,25476
34047,2,491,21,256.00,55225.00,25475,25477
34048,1,512,512,512.00,0.00,25476,25477
34049,2,469,43,256.00,45369.00,25476,25478
34050,2,486,26,256.00,52900.00,25477,25479
34051,2,412,100,256.00,24336.00,25478,25480
34052,3,304,23,170.67,13262.89,25479,25482
34053,1,512,512,512.00,0.00,25481,25482
34054,4,335,6,128.00,15456.50,25481,25485
34055,2,447,65,256.00,36481.00,25484,25486
34056,6,243,6,85.33,6226.56,25485,25491
34057,1,512,512,512.00,0.00,25490,25491
34058,1,512,512,512.00,0.00,25490,25491
34059,1,512,512,512.00,0.00,25490,25491
34060,2,422,90,256.00,27556.00,25490,25492
34061,1,512,512,512.00,0.00,25491,25492
34062,2,257,255,256.00,1.00,25491,25493
34063,2,472,40,256.00,46656.00,25492,25494
34064,5,309,1,102.40,16068.64,25493,25498
34065,2,405,107,256.00,22201.00,25497,25499
34066,1,512,512,512.00,0.00,25498,25499
34067,3,452,16,170.67,39704.89,25498,25501
34068,2,454,58,256.00,39204.00,25500,25502
34069,3,279,40,170.67,9769.56,25501,25504
34070,1,512,512,512.00,0.00,25503,25504
34071,1,512,512,512.00,0.00,25503,25504
34072,1,512,512,512.00,0.00,25503,25504
34073,1,512,512,512.00,0.00,25503,25504
34074,1,512,512,512.00,0.00,25503,25504
34075,1,512,512,512.00,0.00,25503,25504
34076,1,512,512,512.00,0.00,25503,25504
34077,2,442,70,256.00,34596.00,25503,25505
34078,1,512,512,512.00,0.00,25504,25505
34079,1,512,512,512.00,0.00,25504,25505
34080,4,407,4,128.00,26412.50,25504,25508
34081,1,512,512,512.00,0.00,25507,25508
34082,2,388,124,256.00,17424.00,25507,25509
34083,4,330,5,128.00,16141.50,25508,25512
34084,1,512,512,512.00,0.00,25511,25512
34085,1,512,512,512.00,0.00,25511,25512
34086,1,512,512,512.00,0.00,25511,25512
34087,4,462,1,128.00,37298.50,25511,25515
34088,1,512,512,512.00,0.00,25514,25515
34089,1,512,512,512.00,0.00,25514,25515
34090,2,365,147,256.00,11881.00,25514,25516
34091,1,512,512,512.00,0.00,25515,25516
34092,2,275,237,256.00,361.00,25515,25517
34093,1,512,512,512.00,0.00,25516,25517
34094,4,208,44,128.00,3368.00,25516,25520
34095,1,512,512,512.00,0.00,25519,25520
34096,1,512,512,512.00,0.00,25519,25520
34097,2,336,176,256.00,6400.00,25519,25521
34098,2,474,38,256.00,47524.00,25520,25522
34099,2,455,57,256.00,39601.00,25521,25523
34100,2,422,90,256.00,27556.00,25522,25524
34101,1,512,512,512.00,0.00,25523,25524
34102,1,512,512,512.00,0.00,25523,25524
34103,2,410,102,256.00,23716.00,25523,25525
34104,2,381,131,256.00,15625.00,25524,25526
34105,1,512,512,512.00,0.00,25525,25526
34106,2,407,105,256.00,22801.00,25525,25527
34107,3,452,1,170.67,40134.89,25526,25529
34108,1,512,512,512.00,0.00,25528,25529
34109,4,235,4,128.00,9020.50,25528,25532
34110,5,312,8,102.40,11957.84,25531,25536
34111,2,271,241,256.00,225.00,25535,25537
34112,1,512,512,512.00,0.00,25536,25537
34113,1,512,512,512.00,0.00,25536,25537
34114,1,512,512,512.00,0.00,25536,25537
34115,2,370,142,256.00,12996.00,25536,25538
34116,1,512,512,512.00,0.00,25537,25538
34117,3,272,112,170.67,5176.89,25537,25540
34118,2,371,141,256.00,13225.00,25539,25541
34119,1,512,512,512.00,0.00,25540,25541
34120,3,507,1,170.67,56561.56,25540,25543
34121,1,512,512,512.00,0.00,25542,25543
34122,2,299,213,256.00,1849.00,25542,25544
34123,1,512,512,512.00,0.00,25543,25544
34124,1,512,512,512.00,0.00,25543,25544
34125,1,512,512,512.00,0.00,25543,25544
34126,1,512,512,512.00,0.00,25543,25544
34127,1,512,512,512.00,0.00,25543,25544
34128,1,512,512,512.00,0.00,25543,25544
34129,4,339,7,128.00,16381.00,25543,25547
34130,1,512,512,512.00,0.00,25546,25547
34131,1,512,512,512.00,0.00,25546,25547
34132,2,360,152,256.00,10816.00,25546,25548
34133,1,512,512,512.00,0.00,25547,25548
34134,1,512,512,512.00,0.00,25547,25548
34135,1,512,512,512.00,0.00,25547,25548
34136,3,392,15,170.67,25844.22,25547,25550
34137,1,512,512,512.00,0.00,25549,25550
34138,1,512,512,512.00,0.00,25549,25550
34139,1,512,512,512.00,0.00,25549,25550
34140,1,512,512,512.00,0.00,25549,25550
34141,1,512,512,512.00,0.00,25549,25550
34142,1,512,512,512.00,0.00,25549,25550
34143,1,512,512,512.00,0.00,25549,25550
34144,2,315,197,256.00,3481.00,25549,25551
34145,1,512,512,512.00,0.00,25550,25551
34146,1,512,512,512.00,0.00,25550,25551
34147,3,298,66,170.67,9227.56,25550,25553
34148,1,512,512,512.00,0.00,25552,25553
34149,2,370,142,256.00,12996.00,25552,25554
34150,1,512,512,512.00,0.00,25553,25554
34151,1,512,512,512.00,0.00,25553,25554
34152,1,512,512,512.00,0.00,25553,25554
34153,1,512,512,512.00,0.00,25553,25554
34154,3,364,50,170.67,19072.89,25553,25556
34155,1,512,512,512.00,0.00,25555,25556
34156,3,288,2,170.67,14950.22,25555,25558
34157,1,512,512,512.00,0.00,25557,25558
34158,1,512,512,512.00,0.00,25557,25558
34159,1,512,512,512.00,0.00,25557,25558
34160,1,512,512,512.00,0.00,25557,25558
34161,1,512,512,512.00,0.00,25557,25558
34162,1,512,512,512.00,0.00,25557,25558
34163,5,267,8,102.40,10448.24,25557,25562
34164,1,512,512,512.00,0.00,25561,25562
34165,1,512,512,512.00,0.00,25561,25562
34166,2,496,16,256.00,57600.00,25561,25563
34167,6,143,2,85.33,2178.22,25562,25568
34168,1,512,512,512.00,0.00,25567,25568
34169,1,512,512,512.00,0.00,25567,25568
34170,1,512,512,512.00,0.00,25567,25568
34171,3,469,8,170.67,44622.89,25567,25570
34172,1,512,512,512.00,0.00,25569,25570
34173,2,379,133,256.00,15129.00,25569,25571
34174,1,512,512,512.00,0.00,25570,25571
34175,2,258,254,256.00,4.00,25570,25572
34176,1,512,512,512.00,0.00,25571,25572
34177,1,512,512,512.00,0.00,25571,25572
34178,1,512,512,512.00,0.00,25571,25572
34179,1,512,512,512.00,0.00,25571,25572
34180,1,512,512,512.00,0.00,25571,25572
34181,1,512,512,512.00,0.00,25571,25572
34182,2,440,72,256.00,33856.00,25571,25573
34183,1,512,512,512.00,0.00,25572,25573
34184,1,512,512,512.00,0.00,25572,25573
34185,2,337,175,256.00,6561.00,25572,25574
34186,1,512,512,512.00,0.00,25573,25574
34187,2,450,62,256.00,37636.00,25573,25575
34188,3,387,3,170.67,25760.22,25574,25577
34189,2,450,62,256.00,37636.00,25576,25578
34190,1,512,512,512.00,0.00,25577,25578
34191,1,512,512,512.00,0.00,25577,25578
34192,1,512,512,512.00,0.00,25577,25578
34193,1,512,512,512.00,0.00,25577,25578
34194,2,426,86,256.00,28900.00,25577,25579
34195,1,512,512,512.00,0.00,25578,25579
34196,1,512,512,512.00,0.00,25578,25579
34197,1,512,512,512.00,0.00,25578,25579
34198,4,274,24,128.00,10703.50,25578,25582
34199,1,512,512,512.00,0.00,25581,25582
34200,1,512,512,512.00,0.00,25581,25582
34201,1,512,512,512.00,0.00,25581,25582
34202,1,512,512,512.00,0.00,25581,25582
34203,1,512,512,512.00,0.00,25581,25582
34204,1,512,512,512.00,0.00,25581,25582
34205,2,291,221,256.00,1225.00,25581,25583
34206,1,512,512,512.00,0.00,25582,25583
34207,1,512,512,512.00,0.00,25582,25583
34208,1,512,512,512.00,0.00,25582,25583
34209,1,512,512,512.00,0.00,25582,25583
34210,4,402,4,128.00,25450.00,25582,25586
34211,1,512,512,512.00,0.00,25585,25586
34212,4,410,1,128.00,27819.50,25585,25589
34213,1,512,512,512.00,0.00,25588,25589
34214,1,512,512,512.00,0.00,25588,25589
34215,3,252,92,170.67,4270.22,25588,25591
34216,1,512,512,512.00,0.00,25590,25591
34217,2,259,253,256.00,9.00,25590,25592
34218,6,201,24,85.33,3092.89,25591,25597
34219,4,264,1,128.00,12407.50,25596,25600
34220,2,400,112,256.00,20736.00,25599,25601
34221,1,512,512,512.00,0.00,25600,25601
34222,1,512,512,512.00,0.00,25600,25601
34223,1,512,512,512.00,0.00,25600,25601
34224,1,512,512,512.00,0.00,25600,25601
34225,2,435,77,256.00,32041.00,25600,25602
34226,2,346,166,256.00,8100.00,25601,25603
34227,2,376,136,256.00,14400.00,25602,25604
34228,1,512,512,512.00,0.00,25603,25604
34229,1,512,512,512.00,0.00,25603,25604
34230,1,512,512,512.00,0.00,25603,25604
34231,1,512,512,512.00,0.00,25603,25604
34232,1,512,512,512.00,0.00,25603,25604
34233,2,292,220,256.00,1296.00,25603,25605
34234,1,512,512,512.00,0.00,25604,25605
34235,1,512,512,512.00,0.00,25604,25605
34236,1,512,512,512.00,0.00,25604,25605
34237,1,512,512,512.00,0.00,25604,25605
34238,4,272,26,128.00,11126.00,25604,25608
34239,1,512,512,512.00,0.00,25607,25608
34240,1,512,512,512.00,0.00,25607,25608
34241,2,403,109,256.00,21609.00,25607,25609
34242,1,512,512,512.00,0.00,25608,25609
34243,1,512,512,512.00,0.00,25608,25609
34244,1,512,512,512.00,0.00,25608,25609
34245,2,365,147,256.00,11881.00,25608,25610
34246,1,512,512,512.00,0.00,25609,25610
34247,1,512,512,512.00,0.00,25609,25610
34248,5,231,22,102.40,6973.44,25609,25614
34249,2,277,235,256.00,441.00,25613,25615
34250,1,512,512,512.00,0.00,25614,25615
34251,1,512,512,512.00,0.00,25614,25615
34252,1,512,512,512.00,0.00,25614,25615
34253,1,512,512,512.00,0.00,25614,25615
34254,1,512,512,512.00,0.00,25614,25615
34255,3,445,15,170.67,37857.56,25614,25617
34256,1,512,512,512.00,0.00,25616,25617
34257,3,284,68,170.67,7832.89,25616,25619
34258,1,512,512,512.00,0.00,25618,25619
34259,1,512,512,512.00,0.00,25618,25619
34260,1,512,512,512.00,0.00,25618,25619
34261,1,512,512,512.00,0.00,25618,25619
34262,2,290,222,256.00,1156.00,25618,25620
34263,2,410,102,256.00,23716.00,25619,25621
34264,2,444,68,256.00,35344.00,25620,25622
34265,1,512,512,512.00,0.00,25621,25622
34266,2,364,148,256.00,11664.00,25621,25623
34267,2,319,193,256.00,3969.00,25622,25624
34268,1,512,512,512.00,0.00,25623,25624
34269,1,512,512,512.00,0.00,25623,25624
34270,1,512,512,512.00,0.00,25623,25624
34271,1,512,512,512.00,0.00,25623,25624
34272,1,512,512,512.00,0.00,25623,25624
34273,4,262,64,128.00,6346.00,25623,25627
34274,4,392,23,128.00,23341.50,25626,25630
34275,1,512,512,512.00,0.00,25629,25630
34276,1,512,512,512.00,0.00,25629,25630
34277,1,512,512,512.00,0.00,25629,25630
34278,1,512,512,512.00,0.00,25629,25630
34279,4,267,23,128.00,10619.00,25629,25633
34280,1,512,512,512.00,0.00,25632,25633
34281,1,512,512,512.00,0.00,25632,25633
34282,1,512,512,512.00,0.00,25632,25633
34283,1,512,512,512.00,0.00,25632,25633
34284,1,512,512,512.00,0.00,25632,25633
34285,1,512,512,512.00,0.00,25632,25633
34286,3,253,69,170.67,5829.56,25632,25635
34287,1,512,512,512.00,0.00,25634,25635
34288,1,512,512,512.00,0.00,25634,25635
34289,1,512,512,512.00,0.00,25634,25635
34290,1,512,512,512.00,0.00,25634,25635
34291,1,512,512,512.00,0.00,25634,25635
34292,1,512,512,512.00,0.00,25634,25635
34293,1,512,512,512.00,0.00,25634,25635
34294,1,512,512,512.00,0.00,25634,25635
34295,3,268,41,170.67,9110.89,25634,25637
34296,1,512,512,512.00,0.00,25636,25637
34297,1,512,512,512.00,0.00,25636,25637
34298,1,512,512,512.00,0.00,25636,25637
34299,1,512,512,512.00,0.00,25636,25637
34300,3,284,1,170.67,14934.89,25636,25639
34301,1,512,512,512.00,0.00,25638,25639
34302,1,512,512,512.00,0.00,25638,25639
34303,1,512,512,512.00,0.00,25638,25639
34304,2,312,200,256.00,3136.00,25638,25640
34305,2,334,178,256.00,6084.00,25639,25641
34306,1,512,512,512.00,0.00,25640,25641
34307,1,512,512,512.00,0.00,25640,25641
34308,1,512,512,512.00,0.00,25640,25641
34309,2,271,241,256.00,225.00,25640,25642
34310,2,442,70,256.00,34596.00,25641,25643
34311,4,192,60,128.00,2206.50,25642,25646
34312,1,512,512,512.00,0.00,25645,25646
34313,1,512,512,512.00,0.00,25645,25646
34314,1,512,512,512.00,0.00,25645,25646
34315,2,319,193,256.00,3969.00,25645,25647
34316,1,512,512,512.00,0.00,25646,25647
34317,1,512,512,512.00,0.00,25646,25647
34318,1,512,512,512.00,0.00,25646,25647
34319,1,512,512,512.00,0.00,25646,25647
34320,1,512,512,512.00,0.00,25646,25647
34321,1,512,512,512.00,0.00,25646,25647
34322,4,188,22,128.00,4173.50,25646,25650
34323,2,449,63,256.00,37249.00,25649,25651
34324,2,300,212,256.00,1936.00,25650,25652
34325,4,267,50,128.00,7557.50,25651,25655
34326,1,512,512,512.00,0.00,25654,25655
34327,1,512,512,512.00,0.00,25654,25655
34328,1,512,512,512.00,0.00,25654,25655
34329,1,512,512,512.00,0.00,25654,25655
34330,1,512,512,512.00,0.00,25654,25655
34331,1,512,512,512.00,0.00,25654,25655
34332,2,278,234,256.00,484.00,25654,25656
34333,4,438,1,128.00,32243.50,25655,25659
34334,1,512,512,512.00,0.00,25658,25659
34335,1,512,512,512.00,0.00,25658,25659
34336,1,512,512,512.00,0.00,25658,25659
34337,1,512,512,512.00,0.00,25658,25659
34338,1,512,512,512.00,0.00,25658,25659
34339,1,512,512,512.00,0.00,25658,25659
34340,2,455,57,256.00,39601.00,25658,25660
34341,1,512,512,512.00,0.00,25659,25660
34342,1,512,512,512.00,0.00,25659,25660
34343,1,512,512,512.00,0.00,25659,25660
34344,1,512,512,512.00,0.00,25659,25660
34345,1,512,512,512.00,0.00,25659,25660
34346,2,338,174,256.00,6724.00,25659,25661
34347,1,512,512,512.00,0.00,25660,25661
34348,2,260,252,256.00,16.00,25660,25662
34349,2,321,191,256.00,4225.00,25661,25663
34350,1,512,512,512.00,0.00,25662,25663
34351,1,512,512,512.00,0.00,25662,25663
34352,1,512,512,512.00,0.00,25662,25663
34353,1,512,512,512.00,0.00,25662,25663
34354,2,450,62,256.00,37636.00,25662,25664
34355,1,512,512,512.00,0.00,25663,25664
34356,1,512,512,512.00,0.00,25663,25664
34357,1,512,512,512.00,0.00,25663,25664
34358,1,512,512,512.00,0.00,25663,25664
34359,2,307,205,256.00,2601.00,25663,25665
34360,2,276,236,256.00,400.00,25664,25666
34361,1,512,512,512.00,0.00,25665,25666
34362,1,512,512,512.00,0.00,25665,25666
34363,2,277,235,256.00,441.00,25665,25667
34364,1,512,512,512.00,0.00,25666,25667
34365,3,179,159,170.67,72.22,25666,25669
34366,1,512,512,512.00,0.00,25668,25669
34367,1,512,512,512.00,0.00,25668,25669
34368,1,512,512,512.00,0.00,25668,25669
34369,3,351,43,170.67,17197.56,25668,25671
34370,1,512,512,512.00,0.00,25670,25671
34371,1,512,512,512.00,0.00,25670,25671
34372,1,512,512,512.00,0.00,25670,25671
34373,2,339,173,256.00,6889.00,25670,25672
34374,1,512,512,512.00,0.00,25671,25672
34375,2,343,169,256.00,7569.00,25671,25673
34376,2,276,236,256.00,400.00,25672,25674
34377,1,512,512,512.00,0.00,25673,25674
34378,1,512,512,512.00,0.00,25673,25674
34379,1,512,512,512.00,0.00,25673,25674
34380,1,512,512,512.00,0.00,25673,25674
34381,3,474,13,170.67,46029.56,25673,25676
34382,1,512,512,512.00,0.00,25675,25676
34383,1,512,512,512.00,0.00,25675,25676
34384,1,512,512,512.00,0.00,25675,25676
34385,1,512,512,512.00,0.00,25675,25676
34386,1,512,512,512.00,0.00,25675,25676
34387,1,512,512,512.00,0.00,25675,25676
34388,1,512,512,512.00,0.00,25675,25676
34389,3,449,1,170.67,39354.89,25675,25678
34390,2,415,97,256.00,25281.00,25677,25679
34391,1,512,512,512.00,0.00,25678,25679
34392,1,512,512,512.00,0.00,25678,25679
34393,1,512,512,512.00,0.00,25678,25679
34394,3,406,11,170.67,28866.89,25678,25681
34395,1,512,512,512.00,0.00,25680,25681
34396,2,289,223,256.00,1089.00,25680,25682
34397,4,197,30,128.00,4824.50,25681,25685
34398,2,321,191,256.00,4225.00,25684,25686
34399,3,343,48,170.67,15737.56,25685,25688
34400,1,512,512,512.00,0.00,25687,25688
34401,1,512,512,512.00,0.00,25687,25688
34402,2,444,68,256.00,35344.00,25687,25689
34403,1,512,512,512.00,0.00,25688,25689
34404,5,329,1,102.40,15043.44,25688,25693
34405,1,512,512,512.00,0.00,25692,25693
34406,1,512,512,512.00,0.00,25692,25693
34407,1,512,512,512.00,0.00,25692,25693
34408,1,512,512,512.00,0.00,25692,25693
34409,2,351,161,256.00,9025.00,25692,25694
34410,3,210,134,170.67,966.22,25693,25696
34411,4,412,1,128.00,27872.50,25695,25699
34412,1,512,512,512.00,0.00,25698,25699
34413,1,512,512,512.00,0.00,25698,25699
34414,1,512,512,512.00,0.00,25698,25699
34415,1,512,512,512.00,0.00,25698,25699
34416,1,512,512,512.00,0.00,25698,25699
34417,1,512,512,512.00,0.00,25698,25699
34418,3,257,123,170.67,3740.22,25698,25701
34419,2,398,114,256.00,20164.00,25700,25702
34420,2,424,88,256.00,28224.00,25701,25703
34421,2,263,249,256.00,49.00,25702,25704
34422,2,400,112,256.00,20736.00,25703,25705
34423,2,283,229,256.00,729.00,25704,25706
34424,4,259,2,128.00,13515.50,25705,25709
34425,1,512,512,512.00,0.00,25708,25709
34426,1,512,512,512.00,0.00,25708,25709
34427,1,512,512,512.00,0.00,25708,25709
34428,2,511,1,256.00,65025.00,25708,25710
34429,2,509,3,256.00,64009.00,25709,25711
34430,1,512,512,512.00,0.00,25710,25711
34431,3,230,73,170.67,4842.89,25710,25713
34432,2,289,223,256.00,1089.00,25712,25714
34433,2,336,176,256.00,6400.00,25713,25715
34434,1,512,512,512.00,0.00,25714,25715
34435,1,512,512,512.00,0.00,25714,25715
34436,1,512,512,512.00,0.00,25714,25715
34437,1,512,512,512.00,0.00,25714,25715
34438,1,512,512,512.00,0.00,25714,25715
34439,1,512,512,512.00,0.00,25714,25715
34440,1,512,512,512.00,0.00,25714,25715
34441,5,399,1,102.40,22467.84,25714,25719
34442,1,512,512,512.00,0.00,25718,25719
34443,2,502,10,256.00,60516.00,25718,25720
34444,3,402,2,170.67,28630.22,25719,25722
34445,1,512,512,512.00,0.00,25721,25722
34446,3,456,19,170.67,40761.56,25721,25724
34447,1,512,512,512.00,0.00,25723,25724
34448,4,347,36,128.00,16528.50,25723,25727
34449,1,512,512,512.00,0.00,25726,25727
34450,1,512,512,512.00,0.00,25726,25727
34451,1,512,512,512.00,0.00,25726,25727
34452,2,370,142,256.00,12996.00,25726,25728
34453,1,512,512,512.00,0.00,25727,25728
34454,1,512,512,512.00,0.00,25727,25728
34455,1,512,512,512.00,0.00,25727,25728
34456,3,315,1,170.67,16753.56,25727,25730
34457,1,512,512,512.00,0.00,25729,25730
34458,1,512,512,512.00,0.00,25729,25730
34459,1,512,512,512.00,0.00,25729,25730
34460,1,512,512,512.00,0.00,25729,25730
34461,6,159,41,85.33,2070.89,25729,25735
34462,1,512,512,512.00,0.00,25734,25735
34463,1,512,512,512.00,0.00,25734,25735
34464,1,512,512,512.00,0.00,25734,25735
34465,1,512,512,512.00,0.00,25734,25735
34466,1,512,512,512.00,0.00,25734,25735
34467,1,512,512,512.00,0.00,25734,25735
34468,2,324,188,256.00,4624.00,25734,25736
34469,1,512,512,512.00,0.00,25735,25736
34470,1,512,512,512.00,0.00,25735,25736
34471,1,512,512,512.00,0.00,25735,25736
34472,1,512,512,512.00,0.00,25735,25736
34473,1,512,512,512.00,0.00,25735,25736
34474,1,512,512,512.00,0.00,25735,25736
34475,1,512,512,512.00,0.00,25735,25736
34476,7,170,1,73.14,4253.55,25735,25742
34477,1,512,512,512.00,0.00,25741,25742
34478,1,512,512,512.00,0.00,25741,25742
34479,1,512,512,512.00,0.00,25741,25742
34480,1,512,512,512.00,0.00,25741,25742
34481,3,238,38,170.67,8800.89,25741,25744
34482,1,512,512,512.00,0.00,25743,25744
34483,1,512,512,512.00,0.00,25743,25744
34484,1,512,512,512.00,0.00,25743,25744
34485,1,512,512,512.00,0.00,25743,25744
34486,1,512,512,512.00,0.00,25743,25744
34487,1,512,512,512.00,0.00,25743,25744
34488,1,512,512,512.00,0.00,25743,25744
34489,2,276,236,256.00,400.00,25743,25745
34490,3,447,1,170.67,38841.56,25744,25747
34491,1,512,512,512.00,0.00,25746,25747
34492,1,512,512,512.00,0.00,25746,25747
34493,1,512,512,512.00,0.00,25746,25747
34494,1,512,512,512.00,0.00,25746,25747
34495,2,340,172,256.00,7056.00,25746,25748
34496,1,512,512,512.00,0.00,25747,25748
34497,1,512,512,512.00,0.00,25747,25748
34498,1,512,512,512.00,0.00,25747,25748
34499,1,512,512,512.00,0.00,25747,25748
34500,3,445,24,170.67,37689.56,25747,25750
34501,3,213,149,170.67,896.22,25749,25752
34502,3,328,12,170.67,16643.56,25751,25754
34503,3,212,116,170.67,1624.89,25753,25756
34504,1,512,512,512.00,0.00,25755,25756
34505,1,512,512,512.00,0.00,25755,25756
34506,1,512,512,512.00,0.00,25755,25756
34507,3,402,34,170.67,27051.56,25755,25758
34508,2,348,164,256.00,8464.00,25757,25759
34509,1,512,512,512.00,0.00,25758,25759
34510,1,512,512,512.00,0.00,25758,25759
34511,2,503,9,256.00,61009.00,25758,25760
34512,3,339,1,170.67,19041.56,25759,25762
34513,6,314,3,85.33,11855.56,25761,25767
34514,1,512,512,512.00,0.00,25766,25767
34515,1,512,512,512.00,0.00,25766,25767
34516,1,512,512,512.00,0.00,25766,25767
34517,1,512,512,512.00,0.00,25766,25767
34518,2,504,8,256.00,61504.00,25766,25768
34519,2,273,239,256.00,289.00,25767,25769
34520,2,418,94,256.00,26244.00,25768,25770
34521,1,512,512,512.00,0.00,25769,25770
34522,1,512,512,512.00,0.00,25769,25770
34523,1,512,512,512.00,0.00,25769,25770
34524,1,512,512,512.00,0.00,25769,25770
34525,1,512,512,512.00,0.00,25769,25770
34526,1,512,512,512.00,0.00,25769,25770
34527,1,512,512,512.00,0.00,25769,25770
34528,3,241,129,170.67,2501.56,25769,25772
34529,1,512,512,512.00,0.00,25771,25772
34530,1,512,512,512.00,0.00,25771,25772
34531,2,508,4,256.00,63504.00,25771,25773
34532,4,488,1,128.00,43263.50,25772,25776
34533,3,256,126,170.67,3643.56,25775,25778
34534,1,512,512,512.00,0.00,25777,25778
34535,1,512,512,512.00,0.00,25777,25778
34536,2,288,224,256.00,1024.00,25777,25779
34537,1,512,512,512.00,0.00,25778,25779
34538,1,512,512,512.00,0.00,25778,25779
34539,1,512,512,512.00,0.00,25778,25779
34540,1,512,512,512.00,0.00,25778,25779
34541,5,320,2,102.40,13091.44,25778,25783
34542,1,512,512,512.00,0.00,25782,25783
34543,1,512,512,512.00,0.00,25782,25783
34544,2,300,212,256.00,1936.00,25782,25784
34545,1,512,512,512.00,0.00,25783,25784
34546,4,412,1,128.00,27508.50,25783,25787
34547,2,440,72,256.00,33856.00,25786,25788
34548,1,512,512,512.00,0.00,25787,25788
34549,1,512,512,512.00,0.00,25787,25788
34550,1,512,512,512.00,0.00,25787,25788
34551,1,512,512,512.00,0.00,25787,25788
34552,1,512,512,512.00,0.00,25787,25788
34553,4,251,58,128.00,5548.50,25787,25791
34554,2,357,155,256.00,10201.00,25790,25792
34555,1,512,512,512.00,0.00,25791,25792
34556,3,339,69,170.67,14372.22,25791,25794
34557,2,490,22,256.00,54756.00,25793,25795
34558,1,512,512,512.00,0.00,25794,25795
34559,1,512,512,512.00,0.00,25794,25795
34560,1,512,512,512.00,0.00,25794,25795
34561,1,512,512,512.00,0.00,25794,25795
34562,1,512,512,512.00,0.00,25794,25795
34563,1,512,512,512.00,0.00,25794,25795
34564,1,512,512,512.00,0.00,25794,25795
34565,1,512,512,512.00,0.00,25794,25795
34566,1,512,512,512.00,0.00,25794,25795
34567,5,271,21,102.40,8247.04,25794,25799
34568,1,512,512,512.00,0.00,25798,25799
34569,1,512,512,512.00,0.00,25798,25799
34570,1,512,512,512.00,0.00,25798,25799
34571,3,409,13,170.67,29389.56,25798,25801
34572,1,512,512,512.00,0.00,25800,25801
34573,1,512,512,512.00,0.00,25800,25801
34574,1,512,512,512.00,0.00,25800,25801
34575,1,512,512,512.00,0.00,25800,25801
34576,2,279,233,256.00,529.00,25800,25802
34577,1,512,512,512.00,0.00,25801,25802
34578,1,512,512,512.00,0.00,25801,25802
34579,1,512,512,512.00,0.00,25801,25802
34580,3,378,48,170.67,21734.22,25801,25804
34581,3,384,3,170.67,25236.22,25803,25806
34582,1,512,512,512.00,0.00,25805,25806
34583,1,512,512,512.00,0.00,25805,25806
34584,1,512,512,512.00,0.00,25805,25806
34585,2,360,152,256.00,10816.00,25805,25807
34586,1,512,512,512.00,0.00,25806,25807
34587,1,512,512,512.00,0.00,25806,25807
34588,1,512,512,512.00,0.00,25806,25807
34589,1,512,512,512.00,0.00,25806,25807
34590,1,512,512,512.00,0.00,25806,25807
34591,1,512,512,512.00,0.00,25806,25807
34592,1,512,512,512.00,0.00,25806,25807
34593,3,262,27,170.67,10573.56,25806,25809
34594,1,512,512,512.00,0.00,25808,25809
34595,2,423,89,256.00,27889.00,25808,25810
34596,2,266,246,256.00,100.00,25809,25811
34597,1,512,512,512.00,0.00,25810,25811
34598,3,421,2,170.67,32594.89,25810,25813
34599,1,512,512,512.00,0.00,25812,25813
34600,1,512,512,512.00,0.00,25812,25813
34601,2,275,237,256.00,361.00,25812,25814
34602,1,512,512,512.00,0.00,25813,25814
34603,1,512,512,512.00,0.00,25813,25814
34604,1,512,512,512.00,0.00,25813,25814
34605,1,512,512,512.00,0.00,25813,25814
34606,2,352,160,256.00,9216.00,25813,25815
34607,2,329,183,256.00,5329.00,25814,25816
34608,1,512,512,512.00,0.00,25815,25816
34609,1,512,512,512.00,0.00,25815,25816
34610,1,512,512,512.00,0.00,25815,25816
34611,1,512,512,512.00,0.00,25815,25816
34612,1,512,512,512.00,0.00,25815,25816
34613,1,512,512,512.00,0.00,25815,25816
34614,1,512,512,512.00,0.00,25815,25816
34615,1,512,512,512.00,0.00,25815,25816
34616,2,286,226,256.00,900.00,25815,25817
34617,1,512,512,512.00,0.00,25816,25817
34618,1,512,512,512.00,0.00,25816,25817
34619,1,512,512,512.00,0.00,25816,25817
34620,1,512,512,512.00,0.00,25816,25817
34621,1,512,512,512.00,0.00,25816,25817
34622,1,512,512,512.00,0.00,25816,25817
34623,1,512,512,512.00,0.00,25816,25817
34624,1,512,512,512.00,0.00,25816,25817
34625,2,370,142,256.00,12996.00,25816,25818
34626,1,512,512,512.00,0.00,25817,25818
34627,3,355,1,170.67,20993.56,25817,25820
34628,1,512,512,512.00,0.00,25819,25820
34629,1,512,512,512.00,0.00,25819,25820
34630,1,512,512,512.00,0.00,25819,25820
34631,1,512,512,512.00,0.00,25819,25820
34632,4,201,25,128.00,4195.00,25819,25823
34633,1,512,512,512.00,0.00,25822,25823
34634,4,226,71,128.00,3633.50,25822,25826
34635,1,512,512,512.00,0.00,25825,25826
34636,1,512,512,512.00,0.00,25825,25826
34637,1,512,512,512.00,0.00,25825,25826
34638,1,512,512,512.00,0.00,25825,25826
34639,1,512,512,512.00,0.00,25825,25826
34640,4,232,19,128.00,9682.50,25825,25829
34641,1,512,512,512.00,0.00,25828,25829
34642,1,512,512,512.00,0.00,25828,25829
34643,1,512,512,512.00,0.00,25828,25829
34644,1,512,512,512.00,0.00,25828,25829
34645,1,512,512,512.00,0.00,25828,25829
34646,1,512,512,512.00,0.00,25828,25829
34647,2,403,109,256.00,21609.00,25828,25830
34648,2,463,49,256.00,42849.00,25829,25831
34649,1,512,512,512.00,0.00,25830,25831
34650,1,512,512,512.00,0.00,25830,25831
34651,2,260,252,256.00,16.00,25830,25832
34652,1,512,512,512.00,0.00,25831,25832
34653,3,345,35,170.67,16764.22,25831,25834
34654,3,479,9,170.67,47572.22,25833,25836
34655,1,512,512,512.00,0.00,25835,25836
34656,2,359,153,256.00,10609.00,25835,25837
34657,2,274,238,256.00,324.00,25836,25838
34658,1,512,512,512.00,0.00,25837,25838
34659,2,357,155,256.00,10201.00,25837,25839
34660,1,512,512,512.00,0.00,25838,25839
34661,1,512,512,512.00,0.00,25838,25839
34662,1,512,512,512.00,0.00,25838,25839
34663,2,462,50,256.00,42436.00,25838,25840
34664,1,512,512,512.00,0.00,25839,25840
34665,2,366,146,256.00,12100.00,25839,25841
34666,1,512,512,512.00,0.00,25840,25841
34667,1,512,512,512.00,0.00,25840,25841
34668,2,424,88,256.00,28224.00,25840,25842
34669,1,512,512,512.00,0.00,25841,25842
34670,1,512,512,512.00,0.00,25841,25842
34671,1,512,512,512.00,0.00,25841,25842
34672,1,512,512,512.00,0.00,25841,25842
34673,5,238,8,102.40,9483.84,25841,25846
34674,1,512,512,512.00,0.00,25845,25846
34675,1,512,512,512.00,0.00,25845,25846
34676,1,512,512,512.00,0.00,25845,25846
34677,2,434,78,256.00,31684.00,25845,25847
34678,1,512,512,512.00,0.00,25846,25847
34679,2,491,21,256.00,55225.00,25846,25848
34680,1,512,512,512.00,0.00,25847,25848
34681,1,512,512,512.00,0.00,25847,25848
34682,5,288,5,102.40,13993.04,25847,25852
34683,1,512,512,512.00,0.00,25851,25852
34684,1,512,512,512.00,0.00,25851,25852
34685,1,512,512,512.00,0.00,25851,25852
34686,4,294,14,128.00,11054.00,25851,25855
34687,1,512,512,512.00,0.00,25854,25855
34688,1,512,512,512.00,0.00,25854,25855
34689,1,512,512,512.00,0.00,25854,25855
34690,1,512,512,512.00,0.00,25854,25855
34691,2,258,254,256.00,4.00,25854,25856
34692,2,484,28,256.00,51984.00,25855,25857
34693,2,331,181,256.00,5625.00,25856,25858
34694,1,512,512,512.00,0.00,25857,25858
34695,1,512,512,512.00,0.00,25857,25858
34696,1,512,512,512.00,0.00,25857,25858
34697,2,408,104,256.00,23104.00,25857,25859
34698,3,420,23,170.67,31436.22,25858,25861
34699,2,259,253,256.00,9.00,25860,25862
34700,1,512,512,512.00,0.00,25861,25862
34701,6,203,1,85.33,6682.22,25861,25867
34702,1,512,512,512.00,0.00,25866,25867
34703,1,512,512,512.00,0.00,25866,25867
34704,1,512,512,512.00,0.00,25866,25867
34705,2,286,226,256.00,900.00,25866,25868
34706,1,512,512,512.00,0.00,25867,25868
34707,2,443,69,256.00,34969.00,25867,25869
34708,1,512,512,512.00,0.00,25868,25869
34709,1,512,512,512.00,0.00,25868,25869
34710,1,512,512,512.00,0.00,25868,25869
34711,3,395,36,170.67,25500.22,25868,25871
34712,1,512,512,512.00,0.00,25870,25871
34713,1,512,512,512.00,0.00,25870,25871
34714,1,512,512,512.00,0.00,25870,25871
34715,1,512,512,512.00,0.00,25870,25871
34716,1,512,512,512.00,0.00,25870,25871
34717,1,512,512,512.00,0.00,25870,25871
34718,1,512,512,512.00,0.00,25870,25871
34719,2,301,211,256.00,2025.00,25870,25872
34720,1,512,512,512.00,0.00,25871,25872
34721,1,512,512,512.00,0.00,25871,25872
34722,4,333,1,128.00,19083.50,25871,25875
34723,3,379,13,170.67,23609.56,25874,25877
34724,1,512,512,512.00,0.00,25876,25877
34725,3,296,88,170.67,8120.89,25876,25879
34726,2,354,158,256.00,9604.00,25878,25880
34727,3,224,121,170.67,1774.89,25879,25882
34728,1,512,512,512.00,0.00,25881,25882
34729,1,512,512,512.00,0.00,25881,25882
34730,1,512,512,512.00,0.00,25881,25882
34731,4,369,34,128.00,19620.50,25881,25885
34732,1,512,512,512.00,0.00,25884,25885
34733,1,512,512,512.00,0.00,25884,25885
34734,1,512,512,512.00,0.00,25884,25885
34735,1,512,512,512.00,0.00,25884,25885
34736,1,512,512,512.00,0.00,25884,25885
34737,1,512,512,512.00,0.00,25884,25885
34738,1,512,512,512.00,0.00,25884,25885
34739,5,207,13,102.40,4243.84,25884,25889
34740,1,512,512,512.00,0.00,25888,25889
34741,1,512,512,512.00,0.00,25888,25889
34742,1,512,512,512.00,0.00,25888,25889
34743,2,511,1,256.00,65025.00,25888,25890
34744,1,512,512,512.00,0.00,25889,25890
34745,1,512,512,512.00,0.00,25889,25890
34746,2,284,228,256.00,784.00,25889,25891
34747,2,408,104,256.00,23104.00,25890,25892
34748,1,512,512,512.00,0.00,25891,25892
34749,1,512,512,512.00,0.00,25891,25892
34750,1,512,512,512.00,0.00,25891,25892
34751,1,512,512,512.00,0.00,25891,25892
34752,1,512,512,512.00,0.00,25891,25892
34753,2,498,14,256.00,58564.00,25891,25893
34754,2,457,55,256.00,40401.00,25892,25894
34755,3,395,23,170.67,26002.89,25893,25896
34756,1,512,512,512.00,0.00,25895,25896
34757,1,512,512,512.00,0.00,25895,25896
34758,3,288,5,170.67,14516.22,25895,25898
34759,1,512,512,512.00,0.00,25897,25898
34760,1,512,512,512.00,0.00,25897,25898
34761,1,512,512,512.00,0.00,25897,25898
34762,1,512,512,512.00,0.00,25897,25898
34763,2,369,143,256.00,12769.00,25897,25899
34764,3,211,126,170.67,1213.56,25898,25901
34765,2,286,226,256.00,900.00,25900,25902
34766,1,512,512,512.00,0.00,25901,25902
34767,1,512,512,512.00,0.00,25901,25902
34768,1,512,512,512.00,0.00,25901,25902
34769,1,512,512,512.00,0.00,25901,25902
34770,1,512,512,512.00,0.00,25901,25902
34771,1,512,512,512.00,0.00,25901,25902
34772,1,512,512,512.00,0.00,25901,25902
34773,3,225,114,170.67,2056.22,25901,25904
34774,1,512,512,512.00,0.00,25903,25904
34775,1,512,512,512.00,0.00,25903,25904
34776,1,512,512,512.00,0.00,25903,25904
34777,4,183,19,128.00,4131.50,25903,25907
34778,1,512,512,512.00,0.00,25906,25907
34779,1,512,512,512.00,0.00,25906,25907
34780,1,512,512,512.00,0.00,25906,25907
34781,1,512,512,512.00,0.00,25906,25907
34782,1,512,512,512.00,0.00,25906,25907
34783,1,512,512,512.00,0.00,25906,25907
34784,1,512,512,512.00,0.00,25906,25907
34785,1,512,512,512.00,0.00,25906,25907
34786,1,512,512,512.00,0.00,25906,25907
34787,2,280,232,256.00,576.00,25906,25908
34788,2,341,171,256.00,7225.00,25907,25909
34789,1,512,512,512.00,0.00,25908,25909
34790,1,512,512,512.00,0.00,25908,25909
34791,1,512,512,512.00,0.00,25908,25909
34792,1,512,512,512.00,0.00,25908,25909
34793,1,512,512,512.00,0.00,25908,25909
34794,1,512,512,512.00,0.00,25908,25909
34795,2,406,106,256.00,22500.00,25908,25910
34796,1,512,512,512.00,0.00,25909,25910
34797,2,368,144,256.00,12544.00,25909,25911
34798,1,512,512,512.00,0.00,25910,25911
34799,2,292,220,256.00,1296.00,25910,25912
34800,1,512,512,512.00,0.00,25911,25912
34801,1,512,512,512.00,0.00,25911,25912
34802,1,512,512,512.00,0.00,25911,25912
34803,2,432,80,256.00,30976.00,25911,25913
34804,4,212,93,128.00,2398.50,25912,25916
34805,1,512,512,512.00,0.00,25915,25916
34806,1,512,512,512.00,0.00,25915,25916
34807,1,512,512,512.00,0.00,25915,25916
34808,1,512,512,512.00,0.00,25915,25916
34809,1,512,512,512.00,0.00,25915,25916
34810,1,512,512,512.00,0.00,25915,25916
34811,1,512,512,512.00,0.00,25915,25916
34812,2,397,115,256.00,19881.00,25915,25917
34813,1,512,512,512.00,0.00,25916,25917
34814,1,512,512,512.00,0.00,25916,25917
34815,1,512,512,512.00,0.00,25916,25917
34816,1,512,512,512.00,0.00,25916,25917
34817,3,371,1,170.67,23286.89,25916,25919
34818,3,230,137,170.67,1770.89,25918,25921
34819,1,512,512,512.00,0.00,25920,25921
34820,1,512,512,512.00,0.00,25920,25921
34821,1,512,512,512.00,0.00,25920,25921
34822,1,512,512,512.00,0.00,25920,25921
34823,1,512,512,512.00,0.00,25920,25921
34824,2,326,186,256.00,4900.00,25920,25922
34825,4,215,51,128.00,3459.00,25921,25925
34826,1,512,512,512.00,0.00,25924,25925
34827,1,512,512,512.00,0.00,25924,25925
34828,1,512,512,512.00,0.00,25924,25925
34829,1,512,512,512.00,0.00,25924,25925
34830,2,397,115,256.00,19881.00,25924,25926
34831,2,389,123,256.00,17689.00,25925,25927
34832,2,393,119,256.00,18769.00,25926,25928
34833,2,462,50,256.00,42436.00,25927,25929
34834,1,512,512,512.00,0.00,25928,25929
34835,1,512,512,512.00,0.00,25928,25929
34836,1,512,512,512.00,0.00,25928,25929
34837,3,440,31,170.67,36286.89,25928,25931
34838,1,512,512,512.00,0.00,25930,25931
34839,1,512,512,512.00,0.00,25930,25931
34840,3,373,59,170.67,20542.89,25930,25933
34841,3,333,2,170.67,18280.22,25932,25935
34842,3,308,8,170.67,15320.89,25934,25937
34843,1,512,512,512.00,0.00,25936,25937
34844,1,512,512,512.00,0.00,25936,25937
34845,4,350,3,128.00,19356.50,25936,25940
34846,1,512,512,512.00,0.00,25939,25940
34847,1,512,512,512.00,0.00,25939,25940
34848,1,512,512,512.00,0.00,25939,25940
34849,1,512,512,512.00,0.00,25939,25940
34850,1,512,512,512.00,0.00,25939,25940
34851,1,512,512,512.00,0.00,25939,25940
34852,2,382,130,256.00,15876.00,25939,25941
34853,1,512,512,512.00,0.00,25940,25941
34854,1,512,512,512.00,0.00,25940,25941
34855,1,512,512,512.00,0.00,25940,25941
34856,1,512,512,512.00,0.00,25940,25941
34857,3,287,103,170.67,6826.89,25940,25943
34858,1,512,512,512.00,0.00,25942,25943
34859,1,512,512,512.00,0.00,25942,25943
34860,1,512,512,512.00,0.00,25942,25943
34861,2,417,95,256.00,25921.00,25942,25944
34862,2,355,157,256.00,9801.00,25943,25945
34863,1,512,512,512.00,0.00,25944,25945
34864,1,512,512,512.00,0.00,25944,25945
34865,3,227,117,170.67,2020.22,25944,25947
34866,1,512,512,512.00,0.00,25946,25947
34867,2,501,11,256.00,60025.00,25946,25948
34868,1,512,512,512.00,0.00,25947,25948
34869,2,396,116,256.00,19600.00,25947,25949
34870,2,471,41,256.00,46225.00,25948,25950
34871,8,208,2,64.00,4071.50,25949,25957
34872,2,494,18,256.00,56644.00,25956,25958
34873,1,512,512,512.00,0.00,25957,25958
34874,1,512,512,512.00,0.00,25957,25958
34875,2,359,153,256.00,10609.00,25957,25959
34876,1,512,512,512.00,0.00,25958,25959
34877,1,512,512,512.00,0.00,25958,25959
34878,1,512,512,512.00,0.00,25958,25959
34879,1,512,512,512.00,0.00,25958,25959
34880,1,512,512,512.00,0.00,25958,25959
34881,1,512,512,512.00,0.00,25958,25959
34882,2,351,161,256.00,9025.00,25958,25960
34883,4,410,3,128.00,27039.50,25959,25963
34884,1,512,512,512.00,0.00,25962,25963
34885,2,363,149,256.00,11449.00,25962,25964
34886,1,512,512,512.00,0.00,25963,25964
34887,1,512,512,512.00,0.00,25963,25964
34888,2,452,60,256.00,38416.00,25963,25965
34889,1,512,512,512.00,0.00,25964,25965
34890,1,512,512,512.00,0.00,25964,25965
34891,3,436,6,170.67,35883.56,25964,25967
34892,1,512,512,512.00,0.00,25966,25967
34893,1,512,512,512.00,0.00,25966,25967
34894,2,424,88,256.00,28224.00,25966,25968
34895,1,512,512,512.00,0.00,25967,25968
34896,1,512,512,512.00,0.00,25967,25968
34897,1,512,512,512.00,0.00,25967,25968
34898,2,428,84,256.00,29584.00,25967,25969
34899,1,512,512,512.00,0.00,25968,25969
34900,1,512,512,512.00,0.00,25968,25969
34901,3,383,55,170.67,22602.89,25968,25971
34902,1,512,512,512.00,0.00,25970,25971
34903,1,512,512,512.00,0.00,25970,25971
34904,2,347,165,256.00,8281.00,25970,25972
34905,5,299,21,102.40,10153.04,25971,25976
34906,3,241,127,170.67,2521.56,25975,25978
34907,1,512,512,512.00,0.00,25977,25978
34908,1,512,512,512.00,0.00,25977,25978
34909,1,512,512,512.00,0.00,25977,25978
34910,1,512,512,512.00,0.00,25977,25978
34911,1,512,512,512.00,0.00,25977,25978
34912,1,512,512,512.00,0.00,25977,25978
34913,1,512,512,512.00,0.00,25977,25978
34914,1,512,512,512.00,0.00,25977,25978
34915,2,292,220,256.00,1296.00,25977,25979
34916,1,512,512,512.00,0.00,25978,25979
34917,1,512,512,512.00,0.00,25978,25979
34918,1,512,512,512.00,0.00,25978,25979
34919,1,512,512,512.00,0.00,25978,25979
34920,1,512,512,512.00,0.00,25978,25979
34921,1,512,512,512.00,0.00,25978,25979
34922,1,512,512,512.00,0.00,25978,25979
34923,2,406,106,256.00,22500.00,25978,25980
34924,1,512,512,512.00,0.00,25979,25980
34925,1,512,512,512.00,0.00,25979,25980
34926,3,254,9,170.67,13072.22,25979,25982
34927,1,512,512,512.00,0.00,25981,25982
34928,2,466,46,256.00,44100.00,25981,25983
34929,3,262,110,170.67,4320.89,25982,25985
34930,1,512,512,512.00,0.00,25984,25985
34931,1,512,512,512.00,0.00,25984,25985
34932,1,512,512,512.00,0.00,25984,25985
34933,2,303,209,256.00,2209.00,25984,25986
34934,2,338,174,256.00,6724.00,25985,25987
34935,1,512,512,512.00,0.00,25986,25987
34936,1,512,512,512.00,0.00,25986,25987
34937,1,512,512,512.00,0.00,25986,25987
34938,1,512,512,512.00,0.00,25986,25987
34939,1,512,512,512.00,0.00,25986,25987
34940,1,512,512,512.00,0.00,25986,25987
34941,1,512,512,512.00,0.00,25986,25987
34942,2,418,94,256.00,26244.00,25986,25988
34943,1,512,512,512.00,0.00,25987,25988
34944,4,232,4,128.00,8002.50,25987,25991
34945,1,512,512,512.00,0.00,25990,25991
34946,3,227,110,170.67,2290.89,25990,25993
34947,4,416,1,128.00,28218.50,25992,25996
34948,1,512,512,512.00,0.00,25995,25996
34949,3,441,22,170.67,36661.56,25995,25998
34950,1,512,512,512.00,0.00,25997,25998
34951,1,512,512,512.00,0.00,25997,25998
34952,2,462,50,256.00,42436.00,25997,25999
34953,4,375,14,128.00,20713.50,25998,26002
34954,1,512,512,512.00,0.00,26001,26002
34955,1,512,512,512.00,0.00,26001,26002
34956,1,512,512,512.00,0.00,26001,26002
34957,1,512,512,512.00,0.00,26001,26002
34958,1,512,512,512.00,0.00,26001,26002
34959,2,354,158,256.00,9604.00,26001,26003
34960,1,512,512,512.00,0.00,26002,26003
34961,3,194,157,170.67,274.89,26002,26005
34962,1,512,512,512.00,0.00,26004,26005
34963,1,512,512,512.00,0.00,26004,26005
34964,1,512,512,512.00,0.00,26004,26005
34965,1,512,512,512.00,0.00,26004,26005
34966,1,512,512,512.00,0.00,26004,26005
34967,1,512,512,512.00,0.00,26004,26005
34968,1,512,512,512.00,0.00,26004,26005
34969,1,512,512,512.00,0.00,26004,26005
34970,2,294,218,256.00,1444.00,26004,26006
34971,1,512,512,512.00,0.00,26005,26006
34972,2,303,209,256.00,2209.00,26005,26007
34973,1,512,512,512.00,0.00,26006,26007
34974,1,512,512,512.00,0.00,26006,26007
34975,1,512,512,512.00,0.00,26006,26007
34976,1,512,512,512.00,0.00,26006,26007
34977,1,512,512,512.00,0.00,26006,26007
34978,1,512,512,512.00,0.00,26006,26007
34979,1,512,512,512.00,0.00,26006,26007
34980,5,232,1,102.40,10102.24,26006,26011
34981,1,512,512,512.00,0.00,26010,26011
34982,1,512,512,512.00,0.00,26010,26011
34983,2,491,21,256.00,55225.00,26010,26012
34984,3,211,108,170.67,2017.56,26011,26014
34985,1,512,512,512.00,0.00,26013,26014
34986,1,512,512,512.00,0.00,26013,26014
34987,2,397,115,256.00,19881.00,26013,26015
34988,1,512,512,512.00,0.00,26014,26015
34989,1,512,512,512.00,0.00,26014,26015
34990,1,512,512,512.00,0.00,26014,26015
34991,2,361,151,256.00,11025.00,26014,26016
34992,1,512,512,512.00,0.00,26015,26016
34993,2,320,192,256.00,4096.00,26015,26017
34994,2,392,120,256.00,18496.00,26016,26018
34995,1,512,512,512.00,0.00,26017,26018
34996,2,493,19,256.00,56169.00,26017,26019
34997,1,512,512,512.00,0.00,26018,26019
34998,1,512,512,512.00,0.00,26018,26019
34999,2,500,12,256.00,59536.00,26018,26020
35000,2,406,106,256.00,22500.00,26019,26021
35001,1,512,512,512.00,0.00,26020,26021
35002,1,512,512,512.00,0.00,26020,26021
35003,1,512,512,512.00,0.00,26020,26021
35004,1,512,512,512.00,0.00,26020,26021
35005,7,206,6,73.14,5220.98,26020,26027
35006,1,512,512,512.00,0.00,26026,26027
35007,2,287,225,256.00,961.00,26026,26028
35008,1,512,512,512.00,0.00,26027,26028
35009,5,403,6,102.40,23027.44,26027,26032
35010,1,512,512,512.00,0.00,26031,26032
35011,1,512,512,512.00,0.00,26031,26032
35012,3,336,1,170.67,18713.56,26031,26034
35013,3,449,24,170.67,38772.22,26033,26036
35014,1,512,512,512.00,0.00,26035,26036
35015,4,333,1,128.00,19083.50,26035,26039
35016,2,290,222,256.00,1156.00,26038,26040
35017,1,512,512,512.00,0.00,26039,26040
35018,1,512,512,512.00,0.00,26039,26040
35019,1,512,512,512.00,0.00,26039,26040
35020,1,512,512,512.00,0.00,26039,26040
35021,3,237,136,170.67,2201.56,26039,26042
35022,4,378,2,128.00,21628.50,26041,26045
35023,4,414,17,128.00,27633.50,26044,26048
35024,1,512,512,512.00,0.00,26047,26048
35025,1,512,512,512.00,0.00,26047,26048
35026,1,512,512,512.00,0.00,26047,26048
35027,1,512,512,512.00,0.00,26047,26048
35028,1,512,512,512.00,0.00,26047,26048
35029,4,338,10,128.00,15576.50,26047,26051
35030,1,512,512,512.00,0.00,26050,26051
35031,1,512,512,512.00,0.00,26050,26051
35032,1,512,512,512.00,0.00,26050,26051
35033,1,512,512,512.00,0.00,26050,26051
35034,1,512,512,512.00,0.00,26050,26051
35035,3,287,4,170.67,14614.89,26050,26053
35036,1,512,512,512.00,0.00,26052,26053
35037,2,341,171,256.00,7225.00,26052,26054
35038,1,512,512,512.00,0.00,26053,26054
35039,3,421,15,170.67,31953.56,26053,26056
35040,3,444,1,170.67,38081.56,26055,26058
35041,1,512,512,512.00,0.00,26057,26058
35042,2,346,166,256.00,8100.00,26057,26059
35043,1,512,512,512.00,0.00,26058,26059
35044,2,288,224,256.00,1024.00,26058,26060
35045,1,512,512,512.00,0.00,26059,26060
35046,2,438,74,256.00,33124.00,26059,26061
35047,1,512,512,512.00,0.00,26060,26061
35048,1,512,512,512.00,0.00,26060,26061
35049,1,512,512,512.00,0.00,26060,26061
35050,5,233,20,102.40,8230.24,26060,26065
35051,2,455,57,256.00,39601.00,26064,26066
35052,1,512,512,512.00,0.00,26065,26066
35053,3,427,36,170.67,32881.56,26065,26068
35054,2,400,112,256.00,20736.00,26067,26069
35055,2,306,206,256.00,2500.00,26068,26070
35056,1,512,512,512.00,0.00,26069,26070
35057,1,512,512,512.00,0.00,26069,26070
35058,1,512,512,512.00,0.00,26069,26070
35059,1,512,512,512.00,0.00,26069,26070
35060,1,512,512,512.00,0.00,26069,26070
35061,1,512,512,512.00,0.00,26069,26070
35062,1,512,512,512.00,0.00,26069,26070
35063,3,298,1,170.67,15597.56,26069,26072
35064,3,262,34,170.67,9691.56,26071,26074
35065,2,397,115,256.00,19881.00,26073,26075
35066,1,512,512,512.00,0.00,26074,26075
35067,4,226,8,128.00,6943.50,26074,26078
35068,1,512,512,512.00,0.00,26077,26078
35069,3,341,14,170.67,17914.89,26077,26080
35070,1,512,512,512.00,0.00,26079,26080
35071,1,512,512,512.00,0.00,26079,26080
35072,1,512,512,512.00,0.00,26079,26080
35073,2,441,71,256.00,34225.00,26079,26081
35074,1,512,512,512.00,0.00,26080,26081
35075,3,338,2,170.67,18816.89,26080,26083
35076,1,512,512,512.00,0.00,26082,26083
35077,1,512,512,512.00,0.00,26082,26083
35078,1,512,512,512.00,0.00,26082,26083
35079,1,512,512,512.00,0.00,26082,26083
35080,1,512,512,512.00,0.00,26082,26083
35081,3,471,9,170.67,45188.22,26082,26085
35082,1,512,512,512.00,0.00,26084,26085
35083,1,512,512,512.00,0.00,26084,26085
35084,1,512,512,512.00,0.00,26084,26085
35085,1,512,512,512.00,0.00,26084,26085
35086,1,512,512,512.00,0.00,26084,26085
35087,2,281,231,256.00,625.00,26084,26086
35088,3,262,117,170.67,4213.56,26085,26088
35089,3,272,2,170.67,14416.89,26087,26090
35090,1,512,512,512.00,0.00,26089,26090
35091,1,512,512,512.00,0.00,26089,26090
35092,1,512,512,512.00,0.00,26089,26090
35093,3,414,6,170.67,30838.22,26089,26092
35094,5,209,26,102.40,3826.64,26091,26096
35095,1,512,512,512.00,0.00,26095,26096
35096,1,512,512,512.00,0.00,26095,26096
35097,1,512,512,512.00,0.00,26095,26096
35098,1,512,512,512.00,0.00,26095,26096
35099,1,512,512,512.00,0.00,26095,26096
35100,1,512,512,512.00,0.00,26095,26096
35101,1,512,512,512.00,0.00,26095,26096
35102,1,512,512,512.00,0.00,26095,26096
35103,2,257,255,256.00,1.00,26095,26097
35104,1,512,512,512.00,0.00,26096,26097
35105,1,512,512,512.00,0.00,26096,26097
35106,1,512,512,512.00,0.00,26096,26097
35107,1,512,512,512.00,0.00,26096,26097
35108,1,512,512,512.00,0.00,26096,26097
35109,1,512,512,512.00,0.00,26096,26097
35110,1,512,512,512.00,0.00,26096,26097
35111,1,512,512,512.00,0.00,26096,26097
35112,4,343,1,128.00,18937.00,26096,26100
35113,2,441,71,256.00,34225.00,26099,26101
35114,1,512,512,512.00,0.00,26100,26101
35115,2,442,70,256.00,34596.00,26100,26102
35116,3,316,91,170.67,10593.56,26101,26104
35117,1,512,512,512.00,0.00,26103,26104
35118,5,341,2,102.40,15392.24,26103,26108
35119,3,343,72,170.67,14953.56,26107,26110
35120,1,512,512,512.00,0.00,26109,26110
35121,1,512,512,512.00,0.00,26109,26110
35122,2,404,108,256.00,21904.00,26109,26111
35123,2,329,183,256.00,5329.00,26110,26112
35124,1,512,512,512.00,0.00,26111,26112
35125,1,512,512,512.00,0.00,26111,26112
35126,1,512,512,512.00,0.00,26111,26112
35127,1,512,512,512.00,0.00,26111,26112
35128,1,512,512,512.00,0.00,26111,26112
35129,4,290,24,128.00,10106.00,26111,26115
35130,6,262,6,85.33,8502.56,26114,26120
35131,1,512,512,512.00,0.00,26119,26120
35132,1,512,512,512.00,0.00,26119,26120
35133,3,241,54,170.67,6901.56,26119,26122
35134,2,276,236,256.00,400.00,26121,26123
35135,3,389,32,170.67,24414.89,26122,26125
35136,6,402,1,85.33,20535.56,26124,26130
35137,1,512,512,512.00,0.00,26129,26130
35138,1,512,512,512.00,0.00,26129,26130
35139,1,512,512,512.00,0.00,26129,26130
35140,1,512,512,512.00,0.00,26129,26130
35141,1,512,512,512.00,0.00,26129,26130
35142,1,512,512,512.00,0.00,26129,26130
35143,1,512,512,512.00,0.00,26129,26130
35144,1,512,512,512.00,0.00,26129,26130
35145,1,512,512,512.00,0.00,26129,26130
35146,1,512,512,512.00,0.00,26129,26130
35147,5,391,2,102.40,21737.04,26129,26134
35148,1,512,512,512.00,0.00,26133,26134
35149,1,512,512,512.00,0.00,26133,26134
35150,1,512,512,512.00,0.00,26133,26134
35151,2,453,59,256.00,38809.00,26133,26135
35152,3,433,22,170.67,34613.56,26134,26137
35153,1,512,512,512.00,0.00,26136,26137
35154,1,512,512,512.00,0.00,26136,26137
35155,2,408,104,256.00,23104.00,26136,26138
35156,3,341,55,170.67,15126.89,26137,26140
35157,1,512,512,512.00,0.00,26139,26140
35158,1,512,512,512.00,0.00,26139,26140
35159,1,512,512,512.00,0.00,26139,26140
35160,3,455,23,170.67,40442.89,26139,26142
35161,1,512,512,512.00,0.00,26141,26142
35162,1,512,512,512.00,0.00,26141,26142
35163,1,512,512,512.00,0.00,26141,26142
35164,1,512,512,512.00,0.00,26141,26142
35165,1,512,512,512.00,0.00,26141,26142
35166,1,512,512,512.00,0.00,26141,26142
35167,1,512,512,512.00,0.00,26141,26142
35168,2,294,218,256.00,1444.00,26141,26143
35169,2,260,252,256.00,16.00,26142,26144
35170,1,512,512,512.00,0.00,26143,26144
35171,1,512,512,512.00,0.00,26143,26144
35172,1,512,512,512.00,0.00,26143,26144
35173,1,512,512,512.00,0.00,26143,26144
35174,5,205,32,102.40,4168.24,26143,26148
35175,5,434,5,102.40,27713.84,26147,26152
35176,3,235,115,170.67,2437.56,26151,26154
35177,5,229,3,102.40,7483.04,26153,26158
35178,1,512,512,512.00,0.00,26157,26158
35179,1,512,512,512.00,0.00,26157,26158
35180,1,512,512,512.00,0.00,26157,26158
35181,2,355,157,256.00,9801.00,26157,26159
35182,1,512,512,512.00,0.00,26158,26159
35183,3,439,33,170.67,36009.56,26158,26161
35184,3,492,9,170.67,51628.22,26160,26163
35185,3,366,31,170.67,20253.56,26162,26165
35186,2,369,143,256.00,12769.00,26164,26166
35187,1,512,512,512.00,0.00,26165,26166
35188,1,512,512,512.00,0.00,26165,26166
35189,1,512,512,512.00,0.00,26165,26166
35190,1,512,512,512.00,0.00,26165,26166
35191,2,332,180,256.00,5776.00,26165,26167
35192,1,512,512,512.00,0.00,26166,26167
35193,3,234,130,170.67,2059.56,26166,26169
35194,1,512,512,512.00,0.00,26168,26169
35195,2,338,174,256.00,6724.00,26168,26170
35196,1,512,512,512.00,0.00,26169,26170
35197,2,473,39,256.00,47089.00,26169,26171
35198,1,512,512,512.00,0.00,26170,26171
35199,1,512,512,512.00,0.00,26170,26171
35200,1,512,512,512.00,0.00,26170,26171
35201,1,512,512,512.00,0.00,26170,26171
35202,1,512,512,512.00,0.00,26170,26171
35203,1,512,512,512.00,0.00,26170,26171
35204,1,512,512,512.00,0.00,26170,26171
35205,1,512,512,512.00,0.00,26170,26171
35206,4,218,58,128.00,4704.50,26170,26174
35207,1,512,512,512.00,0.00,26173,26174
35208,2,461,51,256.00,42025.00,26173,26175
35209,2,359,153,256.00,10609.00,26174,26176
35210,3,344,21,170.67,17668.22,26175,26178
35211,1,512,512,512.00,0.00,26177,26178
35212,1,512,512,512.00,0.00,26177,26178
35213,1,512,512,512.00,0.00,26177,26178
35214,1,512,512,512.00,0.00,26177,26178
35215,2,318,194,256.00,3844.00,26177,26179
35216,3,335,1,170.67,18606.89,26178,26181
35217,1,512,512,512.00,0.00,26180,26181
35218,1,512,512,512.00,0.00,26180,26181
35219,1,512,512,512.00,0.00,26180,26181
35220,1,512,512,512.00,0.00,26180,26181
35221,1,512,512,512.00,0.00,26180,26181
35222,1,512,512,512.00,0.00,26180,26181
35223,2,458,54,256.00,40804.00,26180,26182
35224,1,512,512,512.00,0.00,26181,26182
35225,1,512,512,512.00,0.00,26181,26182
35226,3,237,131,170.67,2228.22,26181,26184
35227,1,512,512,512.00,0.00,26183,26184
35228,1,512,512,512.00,0.00,26183,26184
35229,2,414,98,256.00,24964.00,26183,26185
35230,1,512,512,512.00,0.00,26184,26185
35231,2,350,162,256.00,8836.00,26184,26186
35232,1,512,512,512.00,0.00,26185,26186
35233,1,512,512,512.00,0.00,26185,26186
35234,1,512,512,512.00,0.00,26185,26186
35235,2,337,175,256.00,6561.00,26185,26187
35236,2,506,6,256.00,62500.00,26186,26188
35237,2,329,183,256.00,5329.00,26187,26189
35238,3,245,67,170.67,5710.89,26188,26191
35239,1,512,512,512.00,0.00,26190,26191
35240,4,359,3,128.00,20451.00,26190,26194
35241,6,266,3,85.33,8385.22,26193,26199
35242,1,512,512,512.00,0.00,26198,26199
35243,1,512,512,512.00,0.00,26198,26199
35244,1,512,512,512.00,0.00,26198,26199
35245,1,512,512,512.00,0.00,26198,26199
35246,2,483,29,256.00,51529.00,26198,26200
35247,2,323,189,256.00,4489.00,26199,26201
35248,1,512,512,512.00,0.00,26200,26201
35249,1,512,512,512.00,0.00,26200,26201
35250,2,257,255,256.00,1.00,26200,26202
35251,1,512,512,512.00,0.00,26201,26202
35252,2,488,24,256.00,53824.00,26201,26203
35253,3,425,18,170.67,32776.22,26202,26205
35254,1,512,512,512.00,0.00,26204,26205
35255,1,512,512,512.00,0.00,26204,26205
35256,1,512,512,512.00,0.00,26204,26205
35257,1,512,512,512.00,0.00,26204,26205
35258,1,512,512,512.00,0.00,26204,26205
35259,3,324,6,170.67,16918.22,26204,26207
35260,1,512,512,512.00,0.00,26206,26207
35261,1,512,512,512.00,0.00,26206,26207
35262,4,375,15,128.00,21747.00,26206,26210
35263,2,406,106,256.00,22500.00,26209,26211
35264,1,512,512,512.00,0.00,26210,26211
35265,1,512,512,512.00,0.00,26210,26211
35266,1,512,512,512.00,0.00,26210,26211
35267,1,512,512,512.00,0.00,26210,26211
35268,1,512,512,512.00,0.00,26210,26211
35269,2,381,131,256.00,15625.00,26210,26212
35270,1,512,512,512.00,0.00,26211,26212
35271,3,333,58,170.67,13837.56,26211,26214
35272,1,512,512,512.00,0.00,26213,26214
35273,1,512,512,512.00,0.00,26213,26214
35274,1,512,512,512.00,0.00,26213,26214
35275,3,256,11,170.67,12766.89,26213,26216
35276,2,466,46,256.00,44100.00,26215,26217
35277,1,512,512,512.00,0.00,26216,26217
35278,1,512,512,512.00,0.00,26216,26217
35279,1,512,512,512.00,0.00,26216,26217
35280,3,382,37,170.67,22853.56,26216,26219
35281,2,397,115,256.00,19881.00,26218,26220
35282,1,512,512,512.00,0.00,26219,26220
35283,3,266,105,170.67,4760.22,26219,26222
35284,1,512,512,512.00,0.00,26221,26222
35285,1,512,512,512.00,0.00,26221,26222
35286,1,512,512,512.00,0.00,26221,26222
35287,1,512,512,512.00,0.00,26221,26222
35288,1,512,512,512.00,0.00,26221,26222
35289,3,294,40,170.67,10779.56,26221,26224
35290,2,267,245,256.00,121.00,26223,26225
35291,1,512,512,512.00,0.00,26224,26225
35292,1,512,512,512.00,0.00,26224,26225
35293,1,512,512,512.00,0.00,26224,26225
35294,1,512,512,512.00,0.00,26224,26225
35295,3,289,58,170.67,8909.56,26224,26227
35296,3,306,70,170.67,9883.56,26226,26229
35297,1,512,512,512.00,0.00,26228,26229
35298,1,512,512,512.00,0.00,26228,26229
35299,1,512,512,512.00,0.00,26228,26229
35300,1,512,512,512.00,0.00,26228,26229
35301,1,512,512,512.00,0.00,26228,26229
35302,1,512,512,512.00,0.00,26228,26229
35303,1,512,512,512.00,0.00,26228,26229
35304,2,335,177,256.00,6241.00,26228,26230
35305,1,512,512,512.00,0.00,26229,26230
35306,1,512,512,512.00,0.00,26229,26230
35307,1,512,512,512.00,0.00,26229,26230
35308,1,512,512,512.00,0.00,26229,26230
35309,1,512,512,512.00,0.00,26229,26230
35310,1,512,512,512.00,0.00,26229,26230
35311,1,512,512,512.00,0.00,26229,26230
35312,1,512,512,512.00,0.00,26229,26230
35313,6,359,1,85.33,15804.56,26229,26235
35314,2,259,253,256.00,9.00,26234,26236
35315,2,422,90,256.00,27556.00,26235,26237
35316,1,512,512,512.00,0.00,26236,26237
35317,1,512,512,512.00,0.00,26236,26237
35318,1,512,512,512.00,0.00,26236,26237
35319,2,314,198,256.00,3364.00,26236,26238
35320,3,480,10,170.67,47867.56,26237,26240
35321,2,373,139,256.00,13689.00,26239,26241
35322,1,512,512,512.00,0.00,26240,26241
35323,1,512,512,512.00,0.00,26240,26241
35324,2,488,24,256.00,53824.00,26240,26242
35325,1,512,512,512.00,0.00,26241,26242
35326,3,280,59,170.67,8142.89,26241,26244
35327,1,512,512,512.00,0.00,26243,26244
35328,2,424,88,256.00,28224.00,26243,26245
35329,1,512,512,512.00,0.00,26244,26245
35330,4,332,8,128.00,16686.00,26244,26248
35331,1,512,512,512.00,0.00,26247,26248
35332,1,512,512,512.00,0.00,26247,26248
35333,1,512,512,512.00,0.00,26247,26248
35334,2,264,248,256.00,64.00,26247,26249
35335,1,512,512,512.00,0.00,26248,26249
35336,1,512,512,512.00,0.00,26248,26249
35337,1,512,512,512.00,0.00,26248,26249
35338,2,428,84,256.00,29584.00,26248,26250
35339,1,512,512,512.00,0.00,26249,26250
35340,1,512,512,512.00,0.00,26249,26250
35341,1,512,512,512.00,0.00,26249,26250
35342,1,512,512,512.00,0.00,26249,26250
35343,1,512,512,512.00,0.00,26249,26250
35344,1,512,512,512.00,0.00,26249,26250
35345,1,512,512,512.00,0.00,26249,26250
35346,1,512,512,512.00,0.00,26249,26250
35347,3,253,85,170.67,4709.56,26249,26252
35348,2,293,219,256.00,1369.00,26251,26253
35349,1,512,512,512.00,0.00,26252,26253
35350,1,512,512,512.00,0.00,26252,26253
35351,1,512,512,512.00,0.00,26252,26253
35352,1,512,512,512.00,0.00,26252,26253
35353,2,455,57,256.00,39601.00,26252,26254
35354,1,512,512,512.00,0.00,26253,26254
35355,1,512,512,512.00,0.00,26253,26254
35356,1,512,512,512.00,0.00,26253,26254
35357,1,512,512,512.00,0.00,26253,26254
35358,1,512,512,512.00,0.00,26253,26254
35359,1,512,512,512.00,0.00,26253,26254
35360,1,512,512,512.00,0.00,26253,26254
35361,1,512,512,512.00,0.00,26253,26254
35362,2,411,101,256.00,24025.00,26253,26255
35363,1,512,512,512.00,0.00,26254,26255
35364,2,287,225,256.00,961.00,26254,26256
35365,1,512,512,512.00,0.00,26255,26256
35366,1,512,512,512.00,0.00,26255,26256
35367,1,512,512,512.00,0.00,26255,26256
35368,1,512,512,512.00,0.00,26255,26256
35369,1,512,512,512.00,0.00,26255,26256
35370,1,512,512,512.00,0.00,26255,26256
35371,1,512,512,512.00,0.00,26255,26256
35372,1,512,512,512.00,0.00,26255,26256
35373,1,512,512,512.00,0.00,26255,26256
35374,3,310,85,170.67,9877.56,26255,26258
35375,3,458,26,170.67,41280.89,26257,26260
35376,1,512,512,512.00,0.00,26259,26260
35377,1,512,512,512.00,0.00,26259,26260
35378,3,283,70,170.67,7629.56,26259,26262
35379,1,512,512,512.00,0.00,26261,26262
35380,1,512,512,512.00,0.00,26261,26262
35381,4,261,10,128.00,7959.50,26261,26265
35382,1,512,512,512.00,0.00,26264,26265
35383,1,512,512,512.00,0.00,26264,26265
35384,1,512,512,512.00,0.00,26264,26265
35385,1,512,512,512.00,0.00,26264,26265
35386,1,512,512,512.00,0.00,26264,26265
35387,1,512,512,512.00,0.00,26264,26265
35388,1,512,512,512.00,0.00,26264,26265
35389,2,384,128,256.00,16384.00,26264,26266
35390,1,512,512,512.00,0.00,26265,26266
35391,1,512,512,512.00,0.00,26265,26266
35392,1,512,512,512.00,0.00,26265,26266
35393,1,512,512,512.00,0.00,26265,26266
35394,1,512,512,512.00,0.00,26265,26266
35395,1,512,512,512.00,0.00,26265,26266
35396,2,461,51,256.00,42025.00,26265,26267
35397,1,512,512,512.00,0.00,26266,26267
35398,4,237,16,128.00,11258.50,26266,26270
35399,1,512,512,512.00,0.00,26269,26270
35400,1,512,512,512.00,0.00,26269,26270
35401,1,512,512,512.00,0.00,26269,26270
35402,1,512,512,512.00,0.00,26269,26270
35403,1,512,512,512.00,0.00,26269,26270
35404,1,512,512,512.00,0.00,26269,26270
35405,2,418,94,256.00,26244.00,26269,26271
35406,1,512,512,512.00,0.00,26270,26271
35407,1,512,512,512.00,0.00,26270,26271
35408,1,512,512,512.00,0.00,26270,26271
35409,1,512,512,512.00,0.00,26270,26271
35410,3,368,22,170.67,21136.89,26270,26273
35411,2,298,214,256.00,1764.00,26272,26274
35412,2,416,96,256.00,25600.00,26273,26275
35413,1,512,512,512.00,0.00,26274,26275
35414,1,512,512,512.00,0.00,26274,26275
35415,1,512,512,512.00,0.00,26274,26275
35416,3,318,26,170.67,14214.22,26274,26277
35417,1,512,512,512.00,0.00,26276,26277
35418,2,269,243,256.00,169.00,26276,26278
35419,1,512,512,512.00,0.00,26277,26278
35420,1,512,512,512.00,0.00,26277,26278
35421,1,512,512,512.00,0.00,26277,26278
35422,1,512,512,512.00,0.00,26277,26278
35423,1,512,512,512.00,0.00,26277,26278
35424,2,474,38,256.00,47524.00,26277,26279
35425,1,512,512,512.00,0.00,26278,26279
35426,1,512,512,512.00,0.00,26278,26279
35427,1,512,512,512.00,0.00,26278,26279
35428,3,262,121,170.67,4181.56,26278,26281
35429,1,512,512,512.00,0.00,26280,26281
35430,1,512,512,512.00,0.00,26280,26281
35431,1,512,512,512.00,0.00,26280,26281
35432,1,512,512,512.00,0.00,26280,26281
35433,3,375,65,170.67,20884.22,26280,26283
35434,1,512,512,512.00,0.00,26282,26283
35435,4,318,5,128.00,16689.50,26282,26286
35436,1,512,512,512.00,0.00,26285,26286
35437,2,288,224,256.00,1024.00,26285,26287
35438,1,512,512,512.00,0.00,26286,26287
35439,1,512,512,512.00,0.00,26286,26287
35440,1,512,512,512.00,0.00,26286,26287
35441,1,512,512,512.00,0.00,26286,26287
35442,2,341,171,256.00,7225.00,26286,26288
35443,1,512,512,512.00,0.00,26287,26288
35444,1,512,512,512.00,0.00,26287,26288
35445,2,432,80,256.00,30976.00,26287,26289
35446,1,512,512,512.00,0.00,26288,26289
35447,1,512,512,512.00,0.00,26288,26289
35448,1,512,512,512.00,0.00,26288,26289
35449,2,497,15,256.00,58081.00,26288,26290
35450,2,268,244,256.00,144.00,26289,26291
35451,1,512,512,512.00,0.00,26290,26291
35452,3,497,1,170.67,53274.89,26290,26293
35453,3,322,70,170.67,11867.56,26292,26295
35454,2,389,123,256.00,17689.00,26294,26296
35455,1,512,512,512.00,0.00,26295,26296
35456,1,512,512,512.00,0.00,26295,26296
35457,2,407,105,256.00,22801.00,26295,26297
35458,2,281,231,256.00,625.00,26296,26298
35459,1,512,512,512.00,0.00,26297,26298
35460,3,357,56,170.67,17668.22,26297,26300
35461,2,373,139,256.00,13689.00,26299,26301
35462,2,500,12,256.00,59536.00,26300,26302
35463,2,303,209,256.00,2209.00,26301,26303
35464,8,275,1,64.00,7569.00,26302,26310
35465,3,358,1,170.67,21397.56,26309,26312
35466,1,512,512,512.00,0.00,26311,26312
35467,1,512,512,512.00,0.00,26311,26312
35468,1,512,512,512.00,0.00,26311,26312
35469,1,512,512,512.00,0.00,26311,26312
35470,3,267,67,170.67,6693.56,26311,26314
35471,1,512,512,512.00,0.00,26313,26314
35472,1,512,512,512.00,0.00,26313,26314
35473,1,512,512,512.00,0.00,26313,26314
35474,1,512,512,512.00,0.00,26313,26314
35475,2,363,149,256.00,11449.00,26313,26315
35476,2,299,213,256.00,1849.00,26314,26316
35477,1,512,512,512.00,0.00,26315,26316
35478,1,512,512,512.00,0.00,26315,26316
35479,2,317,195,256.00,3721.00,26315,26317
35480,1,512,512,512.00,0.00,26316,26317
35481,1,512,512,512.00,0.00,26316,26317
35482,1,512,512,512.00,0.00,26316,26317
35483,1,512,512,512.00,0.00,26316,26317
35484,1,512,512,512.00,0.00,26316,26317
35485,1,512,512,512.00,0.00,26316,26317
35486,1,512,512,512.00,0.00,26316,26317
35487,2,435,77,256.00,32041.00,26316,26318
35488,1,512,512,512.00,0.00,26317,26318
35489,1,512,512,512.00,0.00,26317,26318
35490,1,512,512,512.00,0.00,26317,26318
35491,1,512,512,512.00,0.00,26317,26318
35492,1,512,512,512.00,0.00,26317,26318
35493,2,354,158,256.00,9604.00,26317,26319
35494,4,273,1,128.00,13469.50,26318,26322
35495,1,512,512,512.00,0.00,26321,26322
35496,1,512,512,512.00,0.00,26321,26322
35497,1,512,512,512.00,0.00,26321,26322
35498,1,512,512,512.00,0.00,26321,26322
35499,1,512,512,512.00,0.00,26321,26322
35500,2,367,145,256.00,12321.00,26321,26323
35501,4,492,1,128.00,44178.50,26322,26326
35502,2,410,102,256.00,23716.00,26325,26327
35503,2,500,12,256.00,59536.00,26326,26328
35504,1,512,512,512.00,0.00,26327,26328
35505,1,512,512,512.00,0.00,26327,26328
35506,2,392,120,256.00,18496.00,26327,26329
35507,1,512,512,512.00,0.00,26328,26329
35508,1,512,512,512.00,0.00,26328,26329
35509,6,302,11,85.33,9807.56,26328,26334
35510,1,512,512,512.00,0.00,26333,26334
35511,2,485,27,256.00,52441.00,26333,26335
35512,2,340,172,256.00,7056.00,26334,26336
35513,1,512,512,512.00,0.00,26335,26336
35514,1,512,512,512.00,0.00,26335,26336
35515,1,512,512,512.00,0.00,26335,26336
35516,1,512,512,512.00,0.00,26335,26336
35517,1,512,512,512.00,0.00,26335,26336
35518,1,512,512,512.00,0.00,26335,26336
35519,1,512,512,512.00,0.00,26335,26336
35520,4,213,51,128.00,3688.50,26335,26339
35521,1,512,512,512.00,0.00,26338,26339
35522,1,512,512,512.00,0.00,26338,26339
35523,1,512,512,512.00,0.00,26338,26339
35524,3,396,14,170.67,26678.22,26338,26341
35525,1,512,512,512.00,0.00,26340,26341
35526,1,512,512,512.00,0.00,26340,26341
35527,1,512,512,512.00,0.00,26340,26341
35528,1,512,512,512.00,0.00,26340,26341
35529,1,512,512,512.00,0.00,26340,26341
35530,1,512,512,512.00,0.00,26340,26341
35531,1,512,512,512.00,0.00,26340,26341
35532,1,512,512,512.00,0.00,26340,26341
35533,1,512,512,512.00,0.00,26340,26341
35534,1,512,512,512.00,0.00,26340,26341
35535,3,327,20,170.67,15724.22,26340,26343
35536,1,512,512,512.00,0.00,26342,26343
35537,1,512,512,512.00,0.00,26342,26343
35538,1,512,512,512.00,0.00,26342,26343
35539,1,512,512,512.00,0.00,26342,26343
35540,1,512,512,512.00,0.00,26342,26343
35541,2,418,94,256.00,26244.00,26342,26344
35542,3,438,13,170.67,36117.56,26343,26346
35543,3,324,2,170.67,17398.22,26345,26348
35544,1,512,512,512.00,0.00,26347,26348
35545,1,512,512,512.00,0.00,26347,26348
35546,2,347,165,256.00,8281.00,26347,26349
35547,1,512,512,512.00,0.00,26348,26349
35548,1,512,512,512.00,0.00,26348,26349
35549,2,498,14,256.00,58564.00,26348,26350
35550,2,286,226,256.00,900.00,26349,26351
35551,1,512,512,512.00,0.00,26350,26351
35552,1,512,512,512.00,0.00,26350,26351
35553,1,512,512,512.00,0.00,26350,26351
35554,2,395,117,256.00,19321.00,26350,26352
35555,1,512,512,512.00,0.00,26351,26352
35556,1,512,512,512.00,0.00,26351,26352
35557,3,318,92,170.67,10870.22,26351,26354
35558,1,512,512,512.00,0.00,26353,26354
35559,1,512,512,512.00,0.00,26353,26354
35560,3,315,77,170.67,10724.22,26353,26356
35561,1,512,512,512.00,0.00,26355,26356
35562,1,512,512,512.00,0.00,26355,26356
35563,1,512,512,512.00,0.00,26355,26356
35564,2,312,200,256.00,3136.00,26355,26357
35565,1,512,512,512.00,0.00,26356,26357
35566,1,512,512,512.00,0.00,26356,26357
35567,1,512,512,512.00,0.00,26356,26357
35568,1,512,512,512.00,0.00,26356,26357
35569,1,512,512,512.00,0.00,26356,26357
35570,2,505,7,256.00,62001.00,26356,26358
35571,2,440,72,256.00,33856.00,26358,26360
35572,1,512,512,512.00,0.00,26359,26360
35573,4,276,18,128.00,8902.00,26359,26363
35574,3,232,58,170.67,6363.56,26362,26365
35575,3,236,131,170.67,2166.89,26364,26367
35576,1,512,512,512.00,0.00,26366,26367
35577,2,316,196,256.00,3600.00,26366,26368
35578,1,512,512,512.00,0.00,26367,26368
35579,1,512,512,512.00,0.00,26367,26368
35580,1,512,512,512.00,0.00,26367,26368
35581,1,512,512,512.00,0.00,26367,26368
35582,1,512,512,512.00,0.00,26367,26368
35583,2,385,127,256.00,16641.00,26367,26369
35584,4,285,49,128.00,8995.00,26368,26372
35585,1,512,512,512.00,0.00,26371,26372
35586,1,512,512,512.00,0.00,26371,26372
35587,1,512,512,512.00,0.00,26371,26372
35588,1,512,512,512.00,0.00,26371,26372
35589,1,512,512,512.00,0.00,26371,26372
35590,1,512,512,512.00,0.00,26371,26372
35591,2,473,39,256.00,47089.00,26371,26373
35592,3,258,106,170.67,4107.56,26372,26375
35593,1,512,512,512.00,0.00,26374,26375
35594,1,512,512,512.00,0.00,26374,26375
35595,1,512,512,512.00,0.00,26374,26375
35596,1,512,512,512.00,0.00,26374,26375
35597,1,512,512,512.00,0.00,26374,26375
35598,1,512,512,512.00,0.00,26374,26375
35599,1,512,512,512.00,0.00,26374,26375
35600,1,512,512,512.00,0.00,26374,26375
35601,1,512,512,512.00,0.00,26374,26375
35602,2,289,223,256.00,1089.00,26374,26376
35603,3,346,83,170.67,15370.89,26375,26378
35604,2,296,216,256.00,1600.00,26377,26379
35605,1,512,512,512.00,0.00,26378,26379
35606,1,512,512,512.00,0.00,26378,26379
35607,2,331,181,256.00,5625.00,26378,26380
35608,1,512,512,512.00,0.00,26379,26380
35609,1,512,512,512.00,0.00,26379,26380
35610,1,512,512,512.00,0.00,26379,26380
35611,1,512,512,512.00,0.00,26379,26380
35612,1,512,512,512.00,0.00,26379,26380
35613,1,512,512,512.00,0.00,26379,26380
35614,1,512,512,512.00,0.00,26379,26380
35615,1,512,512,512.00,0.00,26379,26380
35616,2,418,94,256.00,26244.00,26379,26381
35617,2,468,44,256.00,44944.00,26380,26382
35618,2,370,142,256.00,12996.00,26381,26383
35619,2,504,8,256.00,61504.00,26382,26384
35620,4,280,3,128.00,10514.50,26383,26387
35621,6,224,1,85.33,6038.22,26386,26392
35622,1,512,512,512.00,0.00,26391,26392
35623,1,512,512,512.00,0.00,26391,26392
35624,1,512,512,512.00,0.00,26391,26392
35625,1,512,512,512.00,0.00,26391,26392
35626,2,449,63,256.00,37249.00,26391,26393
35627,3,233,132,170.67,1980.22,26392,26395
35628,1,512,512,512.00,0.00,26394,26395
35629,1,512,512,512.00,0.00,26394,26395
35630,1,512,512,512.00,0.00,26394,26395
35631,3,265,2,170.67,14290.89,26394,26397
35632,1,512,512,512.00,0.00,26396,26397
35633,1,512,512,512.00,0.00,26396,26397
35634,1,512,512,512.00,0.00,26396,26397
35635,1,512,512,512.00,0.00,26396,26397
35636,1,512,512,512.00,0.00,26396,26397
35637,3,322,36,170.67,13771.56,26396,26399
35638,2,322,190,256.00,4356.00,26398,26400
35639,1,512,512,512.00,0.00,26399,26400
35640,1,512,512,512.00,0.00,26399,26400
35641,1,512,512,512.00,0.00,26399,26400
35642,1,512,512,512.00,0.00,26399,26400
35643,2,467,45,256.00,44521.00,26399,26401
35644,2,397,115,256.00,19881.00,26400,26402
35645,2,433,79,256.00,31329.00,26401,26403
35646,1,512,512,512.00,0.00,26402,26403
35647,1,512,512,512.00,0.00,26402,26403
35648,2,501,11,256.00,60025.00,26402,26404
35649,3,282,16,170.67,12731.56,26403,26406
35650,1,512,512,512.00,0.00,26405,26406
35651,2,282,230,256.00,676.00,26405,26407
35652,1,512,512,512.00,0.00,26406,26407
35653,2,450,62,256.00,37636.00,26406,26408
35654,1,512,512,512.00,0.00,26407,26408
35655,1,512,512,512.00,0.00,26407,26408
35656,1,512,512,512.00,0.00,26407,26408
35657,3,327,1,170.67,17801.56,26407,26410
35658,1,512,512,512.00,0.00,26409,26410
35659,1,512,512,512.00,0.00,26409,26410
35660,1,512,512,512.00,0.00,26409,26410
35661,1,512,512,512.00,0.00,26409,26410
35662,1,512,512,512.00,0.00,26409,26410
35663,5,267,2,102.40,11613.04,26409,26414
35664,1,512,512,512.00,0.00,26413,26414
35665,1,512,512,512.00,0.00,26413,26414
35666,1,512,512,512.00,0.00,26413,26414
35667,1,512,512,512.00,0.00,26413,26414
35668,1,512,512,512.00,0.00,26413,26414
35669,2,309,203,256.00,2809.00,26413,26415
35670,1,512,512,512.00,0.00,26414,26415
35671,1,512,512,512.00,0.00,26414,26415
35672,1,512,512,512.00,0.00,26414,26415
35673,1,512,512,512.00,0.00,26414,26415
35674,1,512,512,512.00,0.00,26414,26415
35675,1,512,512,512.00,0.00,26414,26415
35676,5,220,5,102.40,7521.44,26414,26419
35677,1,512,512,512.00,0.00,26418,26419
35678,1,512,512,512.00,0.00,26418,26419
35679,1,512,512,512.00,0.00,26418,26419
35680,3,243,29,170.67,10036.22,26418,26421
35681,2,295,217,256.00,1521.00,26420,26422
35682,4,355,27,128.00,18065.00,26421,26425
35683,3,365,19,170.67,20862.89,26424,26427
35684,1,512,512,512.00,0.00,26426,26427
35685,1,512,512,512.00,0.00,26426,26427
35686,1,512,512,512.00,0.00,26426,26427
35687,1,512,512,512.00,0.00,26426,26427
35688,2,393,119,256.00,18769.00,26426,26428
35689,1,512,512,512.00,0.00,26427,26428
35690,1,512,512,512.00,0.00,26427,26428
35691,1,512,512,512.00,0.00,26427,26428
35692,2,266,246,256.00,100.00,26427,26429
35693,1,512,512,512.00,0.00,26428,26429
35694,1,512,512,512.00,0.00,26428,26429
35695,1,512,512,512.00,0.00,26428,26429
35696,1,512,512,512.00,0.00,26428,26429
35697,3,283,88,170.67,6777.56,26428,26431
35698,2,473,39,256.00,47089.00,26430,26432
35699,2,318,194,256.00,3844.00,26431,26433
35700,1,512,512,512.00,0.00,26432,26433
35701,1,512,512,512.00,0.00,26432,26433
35702,1,512,512,512.00,0.00,26432,26433
35703,1,512,512,512.00,0.00,26432,26433
35704,2,410,102,256.00,23716.00,26432,26434
35705,1,512,512,512.00,0.00,26433,26434
35706,3,276,40,170.67,9603.56,26433,26436
35707,2,505,7,256.00,62001.00,26435,26437
35708,1,512,512,512.00,0.00,26436,26437
35709,1,512,512,512.00,0.00,26436,26437
35710,1,512,512,512.00,0.00,26436,26437
35711,1,512,512,512.00,0.00,26436,26437
35712,1,512,512,512.00,0.00,26436,26437
35713,2,368,144,256.00,12544.00,26436,26438
35714,1,512,512,512.00,0.00,26437,26438
35715,2,384,128,256.00,16384.00,26437,26439
35716,1,512,512,512.00,0.00,26438,26439
35717,1,512,512,512.00,0.00,26438,26439
35718,1,512,512,512.00,0.00,26438,26439
35719,1,512,512,512.00,0.00,26438,26439
35720,3,205,138,170.67,749.56,26438,26441
35721,1,512,512,512.00,0.00,26440,26441
35722,1,512,512,512.00,0.00,26440,26441
35723,1,512,512,512.00,0.00,26440,26441
35724,1,512,512,512.00,0.00,26440,26441
35725,1,512,512,512.00,0.00,26440,26441
35726,1,512,512,512.00,0.00,26440,26441
35727,1,512,512,512.00,0.00,26440,26441
35728,1,512,512,512.00,0.00,26440,26441
35729,3,297,33,170.67,11680.22,26440,26443
35730,1,512,512,512.00,0.00,26442,26443
35731,1,512,512,512.00,0.00,26442,26443
35732,1,512,512,512.00,0.00,26442,26443
35733,1,512,512,512.00,0.00,26442,26443
35734,1,512,512,512.00,0.00,26442,26443
35735,1,512,512,512.00,0.00,26442,26443
35736,2,399,113,256.00,20449.00,26442,26444
35737,2,393,119,256.00,18769.00,26443,26445
35738,5,242,37,102.40,5385.04,26444,26449
35739,1,512,512,512.00,0.00,26448,26449
35740,1,512,512,512.00,0.00,26448,26449
35741,1,512,512,512.00,0.00,26448,26449
35742,1,512,512,512.00,0.00,26448,26449
35743,2,473,39,256.00,47089.00,26448,26450
35744,3,407,4,170.67,29494.89,26449,26452
35745,2,292,220,256.00,1296.00,26451,26453
35746,1,512,512,512.00,0.00,26452,26453
35747,1,512,512,512.00,0.00,26452,26453
35748,1,512,512,512.00,0.00,26452,26453
35749,1,512,512,512.00,0.00,26452,26453
35750,1,512,512,512.00,0.00,26452,26453
35751,1,512,512,512.00,0.00,26452,26453
35752,1,512,512,512.00,0.00,26452,26453
35753,1,512,512,512.00,0.00,26452,26453
35754,1,512,512,512.00,0.00,26452,26453
35755,1,512,512,512.00,0.00,26452,26453
35756,1,512,512,512.00,0.00,26452,26453
35757,3,330,65,170.67,13144.22,26452,26455
35758,4,293,18,128.00,10287.50,26454,26458
35759,2,370,142,256.00,12996.00,26457,26459
35760,1,512,512,512.00,0.00,26458,26459
35761,1,512,512,512.00,0.00,26458,26459
35762,1,512,512,512.00,0.00,26458,26459
35763,1,512,512,512.00,0.00,26458,26459
35764,5,261,3,102.40,11305.44,26458,26463
35765,1,512,512,512.00,0.00,26462,26463
35766,1,512,512,512.00,0.00,26462,26463
35767,1,512,512,512.00,0.00,26462,26463
35768,2,276,236,256.00,400.00,26462,26464
35769,3,370,36,170.67,20683.56,26463,26466
35770,2,301,211,256.00,2025.00,26465,26467
35771,3,335,47,170.67,14650.89,26466,26469
35772,2,367,145,256.00,12321.00,26468,26470
35773,1,512,512,512.00,0.00,26469,26470
35774,1,512,512,512.00,0.00,26469,26470
35775,1,512,512,512.00,0.00,26469,26470
35776,1,512,512,512.00,0.00,26469,26470
35777,1,512,512,512.00,0.00,26469,26470
35778,1,512,512,512.00,0.00,26469,26470
35779,2,402,110,256.00,21316.00,26469,26471
35780,1,512,512,512.00,0.00,26470,26471
35781,2,421,91,256.00,27225.00,26470,26472
35782,1,512,512,512.00,0.00,26471,26472
35783,2,326,186,256.00,4900.00,26471,26473
35784,1,512,512,512.00,0.00,26472,26473
35785,1,512,512,512.00,0.00,26472,26473
35786,2,342,170,256.00,7396.00,26472,26474
35787,1,512,512,512.00,0.00,26473,26474
35788,1,512,512,512.00,0.00,26473,26474
35789,1,512,512,512.00,0.00,26473,26474
35790,2,414,98,256.00,24964.00,26473,26475
35791,1,512,512,512.00,0.00,26474,26475
35792,1,512,512,512.00,0.00,26474,26475
35793,1,512,512,512.00,0.00,26474,26475
35794,1,512,512,512.00,0.00,26474,26475
35795,1,512,512,512.00,0.00,26474,26475
35796,1,512,512,512.00,0.00,26474,26475
35797,1,512,512,512.00,0.00,26474,26475
35798,2,286,226,256.00,900.00,26474,26476
35799,1,512,512,512.00,0.00,26475,26476
35800,1,512,512,512.00,0.00,26475,26476
35801,1,512,512,512.00,0.00,26475,26476
35802,1,512,512,512.00,0.00,26475,26476
35803,7,187,2,73.14,4143.27,26475,26482
35804,1,512,512,512.00,0.00,26481,26482
35805,1,512,512,512.00,0.00,26481,26482
35806,2,402,110,256.00,21316.00,26481,26483
35807,2,496,16,256.00,57600.00,26482,26484
35808,2,462,50,256.00,42436.00,26483,26485
35809,1,512,512,512.00,0.00,26484,26485
35810,2,340,172,256.00,7056.00,26484,26486
35811,1,512,512,512.00,0.00,26485,26486
35812,1,512,512,512.00,0.00,26485,26486
35813,1,512,512,512.00,0.00,26485,26486
35814,2,477,35,256.00,48841.00,26485,26487
35815,1,512,512,512.00,0.00,26486,26487
35816,2,453,59,256.00,38809.00,26486,26488
35817,1,512,512,512.00,0.00,26487,26488
35818,1,512,512,512.00,0.00,26487,26488
35819,1,512,512,512.00,0.00,26487,26488
35820,1,512,512,512.00,0.00,26487,26488
35821,3,350,51,170.67,16680.22,26487,26490
35822,1,512,512,512.00,0.00,26489,26490
35823,1,512,512,512.00,0.00,26489,26490
35824,1,512,512,512.00,0.00,26489,26490
35825,1,512,512,512.00,0.00,26489,26490
35826,2,484,28,256.00,51984.00,26489,26491
35827,1,512,512,512.00,0.00,26490,26491
35828,1,512,512,512.00,0.00,26490,26491
35829,1,512,512,512.00,0.00,26490,26491
35830,2,307,205,256.00,2601.00,26490,26492
35831,2,493,19,256.00,56169.00,26491,26493
35832,1,512,512,512.00,0.00,26492,26493
35833,1,512,512,512.00,0.00,26492,26493
35834,2,471,41,256.00,46225.00,26492,26494
35835,1,512,512,512.00,0.00,26493,26494
35836,3,495,7,170.67,52597.56,26493,26496
35837,1,512,512,512.00,0.00,26495,26496
35838,2,430,82,256.00,30276.00,26495,26497
35839,2,429,83,256.00,29929.00,26496,26498
35840,2,504,8,256.00,61504.00,26497,26499
35841,1,512,512,512.00,0.00,26498,26499
35842,1,512,512,512.00,0.00,26498,26499
35843,1,512,512,512.00,0.00,26498,26499
35844,2,281,231,256.00,625.00,26498,26500
35845,1,512,512,512.00,0.00,26499,26500
35846,1,512,512,512.00,0.00,26499,26500
35847,1,512,512,512.00,0.00,26499,26500
35848,1,512,512,512.00,0.00,26499,26500
35849,2,264,248,256.00,64.00,26499,26501
35850,1,512,512,512.00,0.00,26500,26501
35851,4,245,27,128.00,9965.00,26500,26504
35852,2,433,79,256.00,31329.00,26503,26505
35853,1,512,512,512.00,0.00,26504,26505
35854,2,470,42,256.00,45796.00,26504,26506
35855,2,412,100,256.00,24336.00,26505,26507
35856,2,501,11,256.00,60025.00,26506,26508
35857,2,331,181,256.00,5625.00,26507,26509
35858,2,297,215,256.00,1681.00,26508,26510
35859,1,512,512,512.00,0.00,26509,26510
35860,1,512,512,512.00,0.00,26509,26510
35861,1,512,512,512.00,0.00,26509,26510
35862,1,512,512,512.00,0.00,26509,26510
35863,1,512,512,512.00,0.00,26509,26510
35864,1,512,512,512.00,0.00,26509,26510
35865,4,196,1,128.00,5678.50,26509,26513
35866,2,481,31,256.00,50625.00,26512,26514
35867,1,512,512,512.00,0.00,26513,26514
35868,1,512,512,512.00,0.00,26513,26514
35869,1,512,512,512.00,0.00,26513,26514
35870,1,512,512,512.00,0.00,26513,26514
35871,2,477,35,256.00,48841.00,26513,26515
35872,2,334,178,256.00,6084.00,26514,26516
35873,1,512,512,512.00,0.00,26515,26516
35874,1,512,512,512.00,0.00,26515,26516
35875,2,308,204,256.00,2704.00,26515,26517
35876,4,245,34,128.00,7350.50,26516,26520
35877,1,512,512,512.00,0.00,26519,26520
35878,1,512,512,512.00,0.00,26519,26520
35879,1,512,512,512.00,0.00,26519,26520
35880,1,512,512,512.00,0.00,26519,26520
35881,1,512,512,512.00,0.00,26519,26520
35882,1,512,512,512.00,0.00,26519,26520
35883,1,512,512,512.00,0.00,26519,26520
35884,1,512,512,512.00,0.00,26519,26520
35885,2,282,230,256.00,676.00,26519,26521
35886,1,512,512,512.00,0.00,26520,26521
35887,1,512,512,512.00,0.00,26520,26521
35888,2,296,216,256.00,1600.00,26520,26522
35889,2,434,78,256.00,31684.00,26521,26523
35890,2,502,10,256.00,60516.00,26522,26524
35891,2,383,129,256.00,16129.00,26523,26525
35892,1,512,512,512.00,0.00,26524,26525
35893,1,512,512,512.00,0.00,26524,26525
35894,1,512,512,512.00,0.00,26524,26525
35895,1,512,512,512.00,0.00,26524,26525
35896,1,512,512,512.00,0.00,26524,26525
35897,1,512,512,512.00,0.00,26524,26525
35898,1,512,512,512.00,0.00,26524,26525
35899,1,512,512,512.00,0.00,26524,26525
35900,2,307,205,256.00,2601.00,26524,26526
35901,1,512,512,512.00,0.00,26525,26526
35902,1,512,512,512.00,0.00,26525,26526
35903,1,512,512,512.00,0.00,26525,26526
35904,1,512,512,512.00,0.00,26525,26526
35905,2,431,81,256.00,30625.00,26525,26527
35906,1,512,512,512.00,0.00,26526,26527
35907,2,463,49,256.00,42849.00,26526,26528
35908,1,512,512,512.00,0.00,26527,26528
35909,1,512,512,512.00,0.00,26527,26528
35910,1,512,512,512.00,0.00,26527,26528
35911,1,512,512,512.00,0.00,26527,26528
35912,1,512,512,512.00,0.00,26527,26528
35913,1,512,512,512.00,0.00,26527,26528
35914,2,467,45,256.00,44521.00,26527,26529
35915,1,512,512,512.00,0.00,26528,26529
35916,1,512,512,512.00,0.00,26528,26529
35917,1,512,512,512.00,0.00,26528,26529
35918,2,446,66,256.00,36100.00,26528,26530
35919,1,512,512,512.00,0.00,26529,26530
35920,1,512,512,512.00,0.00,26529,26530
35921,1,512,512,512.00,0.00,26529,26530
35922,1,512,512,512.00,0.00,26529,26530
35923,1,512,512,512.00,0.00,26529,26530
35924,1,512,512,512.00,0.00,26529,26530
35925,5,376,1,102.40,19164.24,26529,26534
35926,2,397,115,256.00,19881.00,26533,26535
35927,2,401,111,256.00,21025.00,26534,26536
35928,1,512,512,512.00,0.00,26535,26536
35929,2,486,26,256.00,52900.00,26535,26537
35930,1,512,512,512.00,0.00,26536,26537
35931,1,512,512,512.00,0.00,26536,26537
35932,1,512,512,512.00,0.00,26536,26537
35933,1,512,512,512.00,0.00,26536,26537
35934,1,512,512,512.00,0.00,26536,26537
35935,1,512,512,512.00,0.00,26536,26537
35936,1,512,512,512.00,0.00,26536,26537
35937,2,279,233,256.00,529.00,26536,26538
35938,2,307,205,256.00,2601.00,26537,26539
35939,1,512,512,512.00,0.00,26538,26539
35940,1,512,512,512.00,0.00,26538,26539
35941,1,512,512,512.00,0.00,26538,26539
35942,1,512,512,512.00,0.00,26538,26539
35943,2,256,256,256.00,0.00,26538,26540
35944,1,512,512,512.00,0.00,26539,26540
35945,1,512,512,512.00,0.00,26539,26540
35946,1,512,512,512.00,0.00,26539,26540
35947,1,512,512,512.00,0.00,26539,26540
35948,4,257,61,128.00,6183.50,26539,26543
35949,1,512,512,512.00,0.00,26542,26543
35950,1,512,512,512.00,0.00,26542,26543
35951,3,273,47,170.67,8740.22,26542,26545
35952,1,512,512,512.00,0.00,26544,26545
35953,1,512,512,512.00,0.00,26544,26545
35954,1,512,512,512.00,0.00,26544,26545
35955,4,355,11,128.00,18237.50,26544,26548
35956,1,512,512,512.00,0.00,26547,26548
35957,2,420,92,256.00,26896.00,26547,26549
35958,1,512,512,512.00,0.00,26548,26549
35959,1,512,512,512.00,0.00,26548,26549
35960,1,512,512,512.00,0.00,26548,26549
35961,3,274,6,170.67,13851.56,26548,26551
35962,1,512,512,512.00,0.00,26550,26551
35963,1,512,512,512.00,0.00,26550,26551
35964,1,512,512,512.00,0.00,26550,26551
35965,1,512,512,512.00,0.00,26550,26551
35966,1,512,512,512.00,0.00,26550,26551
35967,1,512,512,512.00,0.00,26550,26551
35968,1,512,512,512.00,0.00,26550,26551
35969,1,512,512,512.00,0.00,26550,26551
35970,3,423,13,170.67,32497.56,26550,26553
35971,2,443,69,256.00,34969.00,26552,26554
35972,1,512,512,512.00,0.00,26553,26554
35973,2,332,180,256.00,5776.00,26553,26555
35974,1,512,512,512.00,0.00,26554,26555
35975,1,512,512,512.00,0.00,26554,26555
35976,1,512,512,512.00,0.00,26554,26555
35977,1,512,512,512.00,0.00,26554,26555
35978,2,328,184,256.00,5184.00,26554,26556
35979,3,304,97,170.67,8921.56,26555,26558
35980,1,512,512,512.00,0.00,26557,26558
35981,1,512,512,512.00,0.00,26557,26558
35982,2,348,164,256.00,8464.00,26557,26559
35983,1,512,512,512.00,0.00,26558,26559
35984,1,512,512,512.00,0.00,26558,26559
35985,1,512,512,512.00,0.00,26558,26559
35986,3,309,18,170.67,14216.22,26558,26561
35987,2,353,159,256.00,9409.00,26560,26562
35988,1,512,512,512.00,0.00,26561,26562
35989,1,512,512,512.00,0.00,26561,26562
35990,3,283,12,170.67,13313.56,26561,26564
35991,1,512,512,512.00,0.00,26563,26564
35992,1,512,512,512.00,0.00,26563,26564
35993,1,512,512,512.00,0.00,26563,26564
35994,1,512,512,512.00,0.00,26563,26564
35995,1,512,512,512.00,0.00,26563,26564
35996,1,512,512,512.00,0.00,26563,26564
35997,1,512,512,512.00,0.00,26563,26564
35998,2,506,6,256.00,62500.00,26563,26565
35999,2,362,150,256.00,11236.00,26564,26566
36000,1,512,512,512.00,0.00,26565,26566
36001,1,512,512,512.00,0.00,26565,26566
36002,2,467,45,256.00,44521.00,26565,26567
36003,1,512,512,512.00,0.00,26566,26567
36004,3,278,31,170.67,10690.89,26566,26569
36005,1,512,512,512.00,0.00,26568,26569
36006,1,512,512,512.00,0.00,26568,26569
36007,1,512,512,512.00,0.00,26568,26569
36008,3,220,89,170.67,3382.89,26568,26571
36009,1,512,512,512.00,0.00,26570,26571
36010,1,512,512,512.00,0.00,26570,26571
36011,2,335,177,256.00,6241.00,26570,26572
36012,1,512,512,512.00,0.00,26571,26572
36013,1,512,512,512.00,0.00,26571,26572
36014,1,512,512,512.00,0.00,26571,26572
36015,1,512,512,512.00,0.00,26571,26572
36016,1,512,512,512.00,0.00,26571,26572
36017,1,512,512,512.00,0.00,26571,26572
36018,1,512,512,512.00,0.00,26571,26572
36019,1,512,512,512.00,0.00,26571,26572
36020,1,512,512,512.00,0.00,26571,26572
36021,1,512,512,512.00,0.00,26571,26572
36022,1,512,512,512.00,0.00,26571,26572
36023,1,512,512,512.00,0.00,26571,26572
36024,1,512,512,512.00,0.00,26571,26572
36025,1,512,512,512.00,0.00,26571,26572
36026,1,512,512,512.00,0.00,26571,26572
36027,5,222,3,102.40,7761.04,26571,26576
36028,2,317,195,256.00,3721.00,26575,26577
36029,2,264,248,256.00,64.00,26576,26578
36030,1,512,512,512.00,0.00,26577,26578
36031,2,507,5,256.00,63001.00,26577,26579
36032,2,424,88,256.00,28224.00,26578,26580
36033,2,363,149,256.00,11449.00,26579,26581
36034,1,512,512,512.00,0.00,26580,26581
36035,1,512,512,512.00,0.00,26580,26581
36036,1,512,512,512.00,0.00,26580,26581
36037,1,512,512,512.00,0.00,26580,26581
36038,2,262,250,256.00,36.00,26580,26582
36039,1,512,512,512.00,0.00,26581,26582
36040,1,512,512,512.00,0.00,26581,26582
36041,1,512,512,512.00,0.00,26581,26582
36042,1,512,512,512.00,0.00,26581,26582
36043,1,512,512,512.00,0.00,26581,26582
36044,1,512,512,512.00,0.00,26581,26582
36045,1,512,512,512.00,0.00,26581,26582
36046,2,478,34,256.00,49284.00,26581,26583
36047,1,512,512,512.00,0.00,26582,26583
36048,3,411,11,170.67,29920.22,26582,26585
36049,1,512,512,512.00,0.00,26584,26585
36050,1,512,512,512.00,0.00,26584,26585
36051,2,403,109,256.00,21609.00,26584,26586
36052,1,512,512,512.00,0.00,26585,26586
36053,1,512,512,512.00,0.00,26585,26586
36054,1,512,512,512.00,0.00,26585,26586
36055,2,505,7,256.00,62001.00,26585,26587
36056,2,504,8,256.00,61504.00,26586,26588
36057,3,319,54,170.67,12205.56,26587,26590
36058,1,512,512,512.00,0.00,26589,26590
36059,1,512,512,512.00,0.00,26589,26590
36060,1,512,512,512.00,0.00,26589,26590
36061,1,512,512,512.00,0.00,26589,26590
36062,1,512,512,512.00,0.00,26589,26590
36063,1,512,512,512.00,0.00,26589,26590
36064,4,294,48,128.00,9634.00,26589,26593
36065,1,512,512,512.00,0.00,26592,26593
36066,1,512,512,512.00,0.00,26592,26593
36067,2,257,255,256.00,1.00,26592,26594
36068,2,291,221,256.00,1225.00,26593,26595
36069,1,512,512,512.00,0.00,26594,26595
36070,1,512,512,512.00,0.00,26594,26595
36071,1,512,512,512.00,0.00,26594,26595
36072,1,512,512,512.00,0.00,26594,26595
36073,1,512,512,512.00,0.00,26594,26595
36074,1,512,512,512.00,0.00,26594,26595
36075,3,279,51,170.67,8728.22,26594,26597
36076,1,512,512,512.00,0.00,26596,26597
36077,1,512,512,512.00,0.00,26596,26597
36078,1,512,512,512.00,0.00,26596,26597
36079,1,512,512,512.00,0.00,26596,26597
36080,1,512,512,512.00,0.00,26596,26597
36081,1,512,512,512.00,0.00,26596,26597
36082,1,512,512,512.00,0.00,26596,26597
36083,2,406,106,256.00,22500.00,26596,26598
36084,1,512,512,512.00,0.00,26597,26598
36085,1,512,512,512.00,0.00,26597,26598
36086,1,512,512,512.00,0.00,26597,26598
36087,1,512,512,512.00,0.00,26597,26598
36088,2,341,171,256.00,7225.00,26597,26599
36089,2,261,251,256.00,25.00,26598,26600
36090,1,512,512,512.00,0.00,26599,26600
36091,1,512,512,512.00,0.00,26599,26600
36092,1,512,512,512.00,0.00,26599,26600
36093,1,512,512,512.00,0.00,26599,26600
36094,2,302,210,256.00,2116.00,26599,26601
36095,1,512,512,512.00,0.00,26600,26601
36096,1,512,512,512.00,0.00,26600,26601
36097,1,512,512,512.00,0.00,26600,26601
36098,3,365,62,170.67,18970.89,26600,26603
36099,1,512,512,512.00,0.00,26602,26603
36100,1,512,512,512.00,0.00,26602,26603
36101,1,512,512,512.00,0.00,26602,26603
36102,3,411,2,170.67,30448.22,26602,26605
36103,3,247,86,170.67,4354.89,26604,26607
36104,1,512,512,512.00,0.00,26606,26607
36105,1,512,512,512.00,0.00,26606,26607
36106,1,512,512,512.00,0.00,26606,26607
36107,1,512,512,512.00,0.00,26606,26607
36108,1,512,512,512.00,0.00,26606,26607
36109,1,512,512,512.00,0.00,26606,26607
36110,3,295,79,170.67,8309.56,26606,26609
36111,1,512,512,512.00,0.00,26608,26609
36112,1,512,512,512.00,0.00,26608,26609
36113,1,512,512,512.00,0.00,26608,26609
36114,1,512,512,512.00,0.00,26608,26609
36115,2,380,132,256.00,15376.00,26608,26610
36116,1,512,512,512.00,0.00,26609,26610
36117,1,512,512,512.00,0.00,26609,26610
36118,3,484,11,170.67,49094.89,26609,26612
36119,1,512,512,512.00,0.00,26611,26612
36120,3,445,29,170.67,37642.89,26611,26614
36121,1,512,512,512.00,0.00,26613,26614
36122,1,512,512,512.00,0.00,26613,26614
36123,1,512,512,512.00,0.00,26613,26614
36124,1,512,512,512.00,0.00,26613,26614
36125,1,512,512,512.00,0.00,26613,26614
36126,1,512,512,512.00,0.00,26613,26614
36127,1,512,512,512.00,0.00,26613,26614
36128,1,512,512,512.00,0.00,26613,26614
36129,2,314,198,256.00,3364.00,26613,26615
36130,2,383,129,256.00,16129.00,26614,26616
36131,2,401,111,256.00,21025.00,26615,26617
36132,1,512,512,512.00,0.00,26616,26617
36133,1,512,512,512.00,0.00,26616,26617
36134,2,297,215,256.00,1681.00,26616,26618
36135,4,493,6,128.00,44408.50,26617,26621
36136,1,512,512,512.00,0.00,26620,26621
36137,4,455,5,128.00,35718.50,26620,26624
36138,1,512,512,512.00,0.00,26623,26624
36139,1,512,512,512.00,0.00,26623,26624
36140,1,512,512,512.00,0.00,26623,26624
36141,1,512,512,512.00,0.00,26623,26624
36142,1,512,512,512.00,0.00,26623,26624
36143,2,481,31,256.00,50625.00,26623,26625
36144,2,284,228,256.00,784.00,26624,26626
36145,1,512,512,512.00,0.00,26625,26626
36146,2,331,181,256.00,5625.00,26625,26627
36147,1,512,512,512.00,0.00,26626,26627
36148,1,512,512,512.00,0.00,26626,26627
36149,1,512,512,512.00,0.00,26626,26627
36150,1,512,512,512.00,0.00,26626,26627
36151,1,512,512,512.00,0.00,26626,26627
36152,1,512,512,512.00,0.00,26626,26627
36153,1,512,512,512.00,0.00,26626,26627
36154,1,512,512,512.00,0.00,26626,26627
36155,2,379,133,256.00,15129.00,26626,26628
36156,1,512,512,512.00,0.00,26627,26628
36157,2,386,126,256.00,16900.00,26627,26629
36158,1,512,512,512.00,0.00,26628,26629
36159,1,512,512,512.00,0.00,26628,26629
36160,1,512,512,512.00,0.00,26628,26629
36161,1,512,512,512.00,0.00,26628,26629
36162,2,410,102,256.00,23716.00,26628,26630
36163,1,512,512,512.00,0.00,26629,26630
36164,1,512,512,512.00,0.00,26629,26630
36165,2,372,140,256.00,13456.00,26630,26632
36166,2,258,254,256.00,4.00,26631,26633
36167,1,512,512,512.00,0.00,26632,26633
36168,1,512,512,512.00,0.00,26632,26633
36169,5,204,6,102.40,5257.04,26632,26637
36170,1,512,512,512.00,0.00,26636,26637
36171,3,198,126,170.67,1014.22,26636,26639
36172,2,510,2,256.00,64516.00,26638,26640
36173,1,512,512,512.00,0.00,26639,26640
36174,1,512,512,512.00,0.00,26639,26640
36175,1,512,512,512.00,0.00,26639,26640
36176,1,512,512,512.00,0.00,26639,26640
36177,1,512,512,512.00,0.00,26639,26640
36178,1,512,512,512.00,0.00,26639,26640
36179,3,446,8,170.67,38320.89,26639,26642
36180,1,512,512,512.00,0.00,26641,26642
36181,1,512,512,512.00,0.00,26641,26642
36182,1,512,512,512.00,0.00,26641,26642
36183,1,512,512,512.00,0.00,26641,26642
36184,1,512,512,512.00,0.00,26641,26642
36185,1,512,512,512.00,0.00,26641,26642
36186,1,512,512,512.00,0.00,26641,26642
36187,2,441,71,256.00,34225.00,26641,26643
36188,1,512,512,512.00,0.00,26642,26643
36189,2,480,32,256.00,50176.00,26642,26644
36190,1,512,512,512.00,0.00,26643,26644
36191,1,512,512,512.00,0.00,26643,26644
36192,1,512,512,512.00,0.00,26643,26644
36193,3,467,17,170.67,43926.89,26643,26646
36194,4,298,12,128.00,13474.00,26645,26649
36195,1,512,512,512.00,0.00,26648,26649
36196,1,512,512,512.00,0.00,26648,26649
36197,1,512,512,512.00,0.00,26648,26649
36198,1,512,512,512.00,0.00,26648,26649
36199,1,512,512,512.00,0.00,26648,26649
36200,2,421,91,256.00,27225.00,26648,26650
36201,1,512,512,512.00,0.00,26649,26650
36202,1,512,512,512.00,0.00,26649,26650
36203,1,512,512,512.00,0.00,26649,26650
36204,1,512,512,512.00,0.00,26649,26650
36205,1,512,512,512.00,0.00,26649,26650
36206,3,257,13,170.67,12466.89,26649,26652
36207,4,252,42,128.00,6634.00,26651,26655
36208,1,512,512,512.00,0.00,26654,26655
36209,1,512,512,512.00,0.00,26654,26655
36210,1,512,512,512.00,0.00,26654,26655
36211,2,381,131,256.00,15625.00,26654,26656
36212,1,512,512,512.00,0.00,26655,26656
36213,3,302,21,170.67,13328.22,26655,26658
36214,2,474,38,256.00,47524.00,26657,26659
36215,1,512,512,512.00,0.00,26658,26659
36216,1,512,512,512.00,0.00,26658,26659
36217,1,512,512,512.00,0.00,26658,26659
36218,1,512,512,512.00,0.00,26658,26659
36219,1,512,512,512.00,0.00,26658,26659
36220,1,512,512,512.00,0.00,26658,26659
36221,1,512,512,512.00,0.00,26658,26659
36222,1,512,512,512.00,0.00,26658,26659
36223,1,512,512,512.00,0.00,26658,26659
36224,1,512,512,512.00,0.00,26658,26659
36225,1,512,512,512.00,0.00,26658,26659
36226,1,512,512,512.00,0.00,26658,26659
36227,1,512,512,512.00,0.00,26658,26659
36228,2,484,28,256.00,51984.00,26658,26660
36229,1,512,512,512.00,0.00,26659,26660
36230,1,512,512,512.00,0.00,26659,26660
36231,1,512,512,512.00,0.00,26659,26660
36232,1,512,512,512.00,0.00,26659,26660
36233,2,291,221,256.00,1225.00,26659,26661
36234,2,281,231,256.00,625.00,26660,26662
36235,1,512,512,512.00,0.00,26661,26662
36236,1,512,512,512.00,0.00,26661,26662
36237,1,512,512,512.00,0.00,26661,26662
36238,1,512,512,512.00,0.00,26661,26662
36239,1,512,512,512.00,0.00,26661,26662
36240,2,401,111,256.00,21025.00,26661,26663
36241,2,469,43,256.00,45369.00,26662,26664
36242,1,512,512,512.00,0.00,26663,26664
36243,2,282,230,256.00,676.00,26663,26665
36244,3,384,2,170.67,25318.22,26664,26667
36245,1,512,512,512.00,0.00,26666,26667
36246,1,512,512,512.00,0.00,26666,26667
36247,2,259,253,256.00,9.00,26666,26668
36248,1,512,512,512.00,0.00,26667,26668
36249,1,512,512,512.00,0.00,26667,26668
36250,3,422,42,170.67,31590.22,26667,26670
36251,2,431,81,256.00,30625.00,26669,26671
36252,1,512,512,512.00,0.00,26670,26671
36253,1,512,512,512.00,0.00,26670,26671
36254,3,336,8,170.67,17934.22,26670,26673
36255,1,512,512,512.00,0.00,26672,26673
36256,2,394,118,256.00,19044.00,26672,26674
36257,3,344,48,170.67,15886.22,26673,26676
36258,4,360,5,128.00,19626.50,26675,26679
36259,2,471,41,256.00,46225.00,26678,26680
36260,1,512,512,512.00,0.00,26679,26680
36261,1,512,512,512.00,0.00,26679,26680
36262,1,512,512,512.00,0.00,26679,26680
36263,1,512,512,512.00,0.00,26679,26680
36264,1,512,512,512.00,0.00,26679,26680
36265,1,512,512,512.00,0.00,26679,26680
36266,1,512,512,512.00,0.00,26679,26680
36267,1,512,512,512.00,0.00,26679,26680
36268,2,461,51,256.00,42025.00,26679,26681
36269,2,511,1,256.00,65025.00,26680,26682
36270,3,204,134,170.67,822.22,26681,26684
36271,1,512,512,512.00,0.00,26683,26684
36272,1,512,512,512.00,0.00,26683,26684
36273,2,258,254,256.00,4.00,26683,26685
36274,1,512,512,512.00,0.00,26684,26685
36275,1,512,512,512.00,0.00,26684,26685
36276,3,412,8,170.67,30296.89,26684,26687
36277,1,512,512,512.00,0.00,26686,26687
36278,1,512,512,512.00,0.00,26686,26687
36279,1,512,512,512.00,0.00,26686,26687
36280,1,512,512,512.00,0.00,26686,26687
36281,1,512,512,512.00,0.00,26686,26687
36282,1,512,512,512.00,0.00,26686,26687
36283,1,512,512,512.00,0.00,26686,26687
36284,1,512,512,512.00,0.00,26686,26687
36285,1,512,512,512.00,0.00,26686,26687
36286,1,512,512,512.00,0.00,26686,26687
36287,1,512,512,512.00,0.00,26686,26687
36288,4,230,2,128.00,8564.00,26686,26690
36289,2,454,58,256.00,39204.00,26689,26691
36290,2,326,186,256.00,4900.00,26690,26692
36291,2,466,46,256.00,44100.00,26691,26693
36292,1,512,512,512.00,0.00,26692,26693
36293,1,512,512,512.00,0.00,26692,26693
36294,2,376,136,256.00,14400.00,26692,26694
36295,2,285,227,256.00,841.00,26693,26695
36296,1,512,512,512.00,0.00,26694,26695
36297,1,512,512,512.00,0.00,26694,26695
36298,2,335,177,256.00,6241.00,26694,26696
36299,1,512,512,512.00,0.00,26695,26696
36300,1,512,512,512.00,0.00,26695,26696
36301,2,280,232,256.00,576.00,26695,26697
36302,1,512,512,512.00,0.00,26696,26697
36303,1,512,512,512.00,0.00,26696,26697
36304,1,512,512,512.00,0.00,26696,26697
36305,3,435,16,170.67,35273.56,26696,26699
36306,2,289,223,256.00,1089.00,26698,26700
36307,1,512,512,512.00,0.00,26699,26700
36308,1,512,512,512.00,0.00,26699,26700
36309,1,512,512,512.00,0.00,26699,26700
36310,1,512,512,512.00,0.00,26699,26700
36311,1,512,512,512.00,0.00,26699,26700
36312,2,405,107,256.00,22201.00,26699,26701
36313,2,403,109,256.00,21609.00,26700,26702
36314,1,512,512,512.00,0.00,26701,26702
36315,1,512,512,512.00,0.00,26701,26702
36316,1,512,512,512.00,0.00,26701,26702
36317,1,512,512,512.00,0.00,26701,26702
36318,1,512,512,512.00,0.00,26701,26702
36319,1,512,512,512.00,0.00,26701,26702
36320,1,512,512,512.00,0.00,26701,26702
36321,2,476,36,256.00,48400.00,26701,26703
36322,1,512,512,512.00,0.00,26702,26703
36323,1,512,512,512.00,0.00,26702,26703
36324,3,395,12,170.67,26604.22,26702,26705
36325,2,367,145,256.00,12321.00,26704,26706
36326,1,512,512,512.00,0.00,26705,26706
36327,2,280,232,256.00,576.00,26705,26707
36328,4,256,2,128.00,15027.50,26706,26710
36329,1,512,512,512.00,0.00,26709,26710
36330,1,512,512,512.00,0.00,26709,26710
36331,1,512,512,512.00,0.00,26709,26710
36332,2,362,150,256.00,11236.00,26709,26711
36333,1,512,512,512.00,0.00,26710,26711
36334,1,512,512,512.00,0.00,26710,26711
36335,1,512,512,512.00,0.00,26710,26711
36336,2,333,179,256.00,5929.00,26710,26712
36337,2,469,43,256.00,45369.00,26711,26713
36338,4,349,7,128.00,17133.00,26712,26716
36339,2,265,247,256.00,81.00,26715,26717
36340,1,512,512,512.00,0.00,26716,26717
36341,1,512,512,512.00,0.00,26716,26717
36342,1,512,512,512.00,0.00,26716,26717
36343,1,512,512,512.00,0.00,26716,26717
36344,1,512,512,512.00,0.00,26716,26717
36345,1,512,512,512.00,0.00,26716,26717
36346,1,512,512,512.00,0.00,26716,26717
36347,1,512,512,512.00,0.00,26716,26717
36348,1,512,512,512.00,0.00,26716,26717
36349,1,512,512,512.00,0.00,26716,26717
36350,2,296,216,256.00,1600.00,26716,26718
36351,2,504,8,256.00,61504.00,26717,26719
36352,2,477,35,256.00,48841.00,26718,26720
36353,3,372,49,170.67,20561.56,26719,26722
36354,1,512,512,512.00,0.00,26721,26722
36355,2,498,14,256.00,58564.00,26721,26723
36356,2,349,163,256.00,8649.00,26722,26724
36357,4,400,1,128.00,25276.50,26723,26727
36358,2,447,65,256.00,36481.00,26726,26728
36359,1,512,512,512.00,0.00,26727,26728
36360,1,512,512,512.00,0.00,26727,26728
36361,1,512,512,512.00,0.00,26727,26728
36362,2,382,130,256.00,15876.00,26727,26729
36363,2,475,37,256.00,47961.00,26728,26730
36364,1,512,512,512.00,0.00,26729,26730
36365,1,512,512,512.00,0.00,26729,26730
36366,2,275,237,256.00,361.00,26729,26731
36367,3,391,23,170.67,25210.89,26730,26733
36368,1,512,512,512.00,0.00,26732,26733
36369,3,269,9,170.67,13272.22,26732,26735
36370,1,512,512,512.00,0.00,26734,26735
36371,3,304,47,170.67,11054.89,26734,26737
36372,2,294,218,256.00,1444.00,26736,26738
36373,1,512,512,512.00,0.00,26737,26738
36374,1,512,512,512.00,0.00,26737,26738
36375,2,421,91,256.00,27225.00,26737,26739
36376,2,510,2,256.00,64516.00,26738,26740
36377,1,512,512,512.00,0.00,26739,26740
36378,1,512,512,512.00,0.00,26739,26740
36379,1,512,512,512.00,0.00,26739,26740
36380,1,512,512,512.00,0.00,26739,26740
36381,1,512,512,512.00,0.00,26739,26740
36382,1,512,512,512.00,0.00,26739,26740
36383,1,512,512,512.00,0.00,26739,26740
36384,2,400,112,256.00,20736.00,26739,26741
36385,1,512,512,512.00,0.00,26740,26741
36386,1,512,512,512.00,0.00,26740,26741
36387,1,512,512,512.00,0.00,26740,26741
36388,1,512,512,512.00,0.00,26740,26741
36389,1,512,512,512.00,0.00,26740,26741
36390,1,512,512,512.00,0.00,26740,26741
36391,1,512,512,512.00,0.00,26740,26741
36392,1,512,512,512.00,0.00,26740,26741
36393,1,512,512,512.00,0.00,26740,26741
36394,1,512,512,512.00,0.00,26740,26741
36395,1,512,512,512.00,0.00,26740,26741
36396,4,375,2,128.00,23196.50,26740,26744
36397,1,512,512,512.00,0.00,26743,26744
36398,1,512,512,512.00,0.00,26743,26744
36399,1,512,512,512.00,0.00,26743,26744
36400,1,512,512,512.00,0.00,26743,26744
36401,1,512,512,512.00,0.00,26743,26744
36402,1,512,512,512.00,0.00,26743,26744
36403,1,512,512,512.00,0.00,26743,26744
36404,1,512,512,512.00,0.00,26743,26744
36405,2,420,92,256.00,26896.00,26743,26745
36406,1,512,512,512.00,0.00,26744,26745
36407,3,239,97,170.67,3374.89,26744,26747
36408,1,512,512,512.00,0.00,26746,26747
36409,1,512,512,512.00,0.00,26746,26747
36410,2,388,124,256.00,17424.00,26746,26748
36411,2,326,186,256.00,4900.00,26747,26749
36412,1,512,512,512.00,0.00,26748,26749
36413,1,512,512,512.00,0.00,26748,26749
36414,1,512,512,512.00,0.00,26748,26749
36415,1,512,512,512.00,0.00,26748,26749
36416,1,512,512,512.00,0.00,26748,26749
36417,1,512,512,512.00,0.00,26748,26749
36418,1,512,512,512.00,0.00,26748,26749
36419,1,512,512,512.00,0.00,26748,26749
36420,3,405,21,170.67,28160.22,26748,26751
36421,2,377,135,256.00,14641.00,26750,26752
36422,5,305,2,102.40,11409.84,26751,26756
36423,1,512,512,512.00,0.00,26755,26756
36424,1,512,512,512.00,0.00,26755,26756
36425,1,512,512,512.00,0.00,26755,26756
36426,1,512,512,512.00,0.00,26755,26756
36427,1,512,512,512.00,0.00,26755,26756
36428,1,512,512,512.00,0.00,26755,26756
36429,2,458,54,256.00,40804.00,26755,26757
36430,2,304,208,256.00,2304.00,26756,26758
36431,1,512,512,512.00,0.00,26757,26758
36432,1,512,512,512.00,0.00,26757,26758
36433,3,311,91,170.67,9906.89,26757,26760
36434,2,379,133,256.00,15129.00,26759,26761
36435,1,512,512,512.00,0.00,26760,26761
36436,2,418,94,256.00,26244.00,26760,26762
36437,2,266,246,256.00,100.00,26761,26763
36438,1,512,512,512.00,0.00,26762,26763
36439,1,512,512,512.00,0.00,26762,26763
36440,1,512,512,512.00,0.00,26762,26763
36441,1,512,512,512.00,0.00,26762,26763
36442,1,512,512,512.00,0.00,26762,26763
36443,1,512,512,512.00,0.00,26762,26763
36444,1,512,512,512.00,0.00,26762,26763
36445,2,418,94,256.00,26244.00,26762,26764
36446,1,512,512,512.00,0.00,26763,26764
36447,1,512,512,512.00,0.00,26763,26764
36448,2,312,200,256.00,3136.00,26763,26765
36449,1,512,512,512.00,0.00,26764,26765
36450,1,512,512,512.00,0.00,26764,26765
36451,1,512,512,512.00,0.00,26764,26765
36452,2,394,118,256.00,19044.00,26764,26766
36453,1,512,512,512.00,0.00,26765,26766
36454,2,293,219,256.00,1369.00,26765,26767
36455,1,512,512,512.00,0.00,26766,26767
36456,2,321,191,256.00,4225.00,26766,26768
36457,1,512,512,512.00,0.00,26767,26768
36458,2,265,247,256.00,81.00,26767,26769
36459,1,512,512,512.00,0.00,26768,26769
36460,1,512,512,512.00,0.00,26768,26769
36461,1,512,512,512.00,0.00,26768,26769
36462,1,512,512,512.00,0.00,26768,26769
36463,1,512,512,512.00,0.00,26768,26769
36464,1,512,512,512.00,0.00,26768,26769
36465,1,512,512,512.00,0.00,26768,26769
36466,1,512,512,512.00,0.00,26768,26769
36467,4,275,35,128.00,10107.00,26768,26772
36468,1,512,512,512.00,0.00,26771,26772
36469,3,290,30,170.67,11494.22,26771,26774
36470,1,512,512,512.00,0.00,26773,26774
36471,1,512,512,512.00,0.00,26773,26774
36472,1,512,512,512.00,0.00,26773,26774
36473,2,415,97,256.00,25281.00,26773,26775
36474,1,512,512,512.00,0.00,26774,26775
36475,1,512,512,512.00,0.00,26774,26775
36476,1,512,512,512.00,0.00,26774,26775
36477,1,512,512,512.00,0.00,26774,26775
36478,1,512,512,512.00,0.00,26774,26775
36479,1,512,512,512.00,0.00,26774,26775
36480,3,305,78,170.67,9456.22,26774,26777
36481,1,512,512,512.00,0.00,26776,26777
36482,1,512,512,512.00,0.00,26776,26777
36483,1,512,512,512.00,0.00,26776,26777
36484,4,230,10,128.00,6122.00,26776,26780
36485,2,470,42,256.00,45796.00,26779,26781
36486,2,341,171,256.00,7225.00,26780,26782
36487,1,512,512,512.00,0.00,26781,26782
36488,1,512,512,512.00,0.00,26781,26782
36489,1,512,512,512.00,0.00,26781,26782
36490,1,512,512,512.00,0.00,26781,26782
36491,1,512,512,512.00,0.00,26781,26782
36492,1,512,512,512.00,0.00,26781,26782
36493,3,329,22,170.67,15754.89,26781,26784
36494,2,424,88,256.00,28224.00,26783,26785
36495,1,512,512,512.00,0.00,26784,26785
36496,1,512,512,512.00,0.00,26784,26785
36497,1,512,512,512.00,0.00,26784,26785
36498,1,512,512,512.00,0.00,26784,26785
36499,1,512,512,512.00,0.00,26784,26785
36500,1,512,512,512.00,0.00,26784,26785
36501,1,512,512,512.00,0.00,26784,26785
36502,2,338,174,256.00,6724.00,26784,26786
36503,1,512,512,512.00,0.00,26785,26786
36504,2,384,128,256.00,16384.00,26785,26787
36505,3,350,54,170.67,16566.22,26786,26789
36506,1,512,512,512.00,0.00,26788,26789
36507,1,512,512,512.00,0.00,26788,26789
36508,2,459,53,256.00,41209.00,26788,26790
36509,1,512,512,512.00,0.00,26789,26790
36510,1,512,512,512.00,0.00,26789,26790
36511,1,512,512,512.00,0.00,26789,26790
36512,1,512,512,512.00,0.00,26789,26790
36513,2,486,26,256.00,52900.00,26789,26791
36514,1,512,512,512.00,0.00,26790,26791
36515,4,200,47,128.00,4074.50,26790,26794
36516,2,275,237,256.00,361.00,26793,26795
36517,1,512,512,512.00,0.00,26794,26795
36518,3,439,25,170.67,36089.56,26794,26797
36519,2,382,130,256.00,15876.00,26796,26798
36520,1,512,512,512.00,0.00,26797,26798
36521,1,512,512,512.00,0.00,26797,26798
36522,1,512,512,512.00,0.00,26797,26798
36523,1,512,512,512.00,0.00,26797,26798
36524,1,512,512,512.00,0.00,26797,26798
36525,2,511,1,256.00,65025.00,26797,26799
36526,1,512,512,512.00,0.00,26798,26799
36527,1,512,512,512.00,0.00,26798,26799
36528,1,512,512,512.00,0.00,26798,26799
36529,1,512,512,512.00,0.00,26798,26799
36530,1,512,512,512.00,0.00,26798,26799
36531,2,424,88,256.00,28224.00,26798,26800
36532,4,247,39,128.00,5633.00,26799,26803
36533,2,367,145,256.00,12321.00,26802,26804
36534,3,218,145,170.67,1122.89,26803,26806
36535,5,228,7,102.40,6383.84,26805,26810
36536,3,324,52,170.67,12931.56,26809,26812
36537,2,430,82,256.00,30276.00,26811,26813
36538,2,304,208,256.00,2304.00,26812,26814
36539,4,359,10,128.00,19237.50,26813,26817
36540,1,512,512,512.00,0.00,26816,26817
36541,1,512,512,512.00,0.00,26816,26817
36542,1,512,512,512.00,0.00,26816,26817
36543,1,512,512,512.00,0.00,26816,26817
36544,1,512,512,512.00,0.00,26816,26817
36545,1,512,512,512.00,0.00,26816,26817
36546,3,312,88,170.67,10083.56,26816,26819
36547,2,493,19,256.00,56169.00,26818,26820
36548,1,512,512,512.00,0.00,26819,26820
36549,3,302,23,170.67,13106.89,26819,26822
36550,1,512,512,512.00,0.00,26821,26822
36551,1,512,512,512.00,0.00,26821,26822
36552,2,424,88,256.00,28224.00,26821,26823
36553,3,498,6,170.67,53574.22,26822,26825
36554,1,512,512,512.00,0.00,26824,26825
36555,1,512,512,512.00,0.00,26824,26825
36556,1,512,512,512.00,0.00,26824,26825
36557,1,512,512,512.00,0.00,26824,26825
36558,1,512,512,512.00,0.00,26824,26825
36559,2,396,116,256.00,19600.00,26824,26826
36560,4,246,22,128.00,10006.00,26825,26829
36561,2,304,208,256.00,2304.00,26828,26830
36562,3,295,13,170.67,13809.56,26829,26832
36563,2,291,221,256.00,1225.00,26831,26833
36564,1,512,512,512.00,0.00,26832,26833
36565,1,512,512,512.00,0.00,26832,26833
36566,2,382,130,256.00,15876.00,26832,26834
36567,3,502,1,170.67,54901.56,26833,26836
36568,1,512,512,512.00,0.00,26835,26836
36569,1,512,512,512.00,0.00,26835,26836
36570,1,512,512,512.00,0.00,26835,26836
36571,2,446,66,256.00,36100.00,26835,26837
36572,1,512,512,512.00,0.00,26836,26837
36573,1,512,512,512.00,0.00,26836,26837
36574,1,512,512,512.00,0.00,26836,26837
36575,1,512,512,512.00,0.00,26836,26837
36576,3,445,29,170.67,37642.89,26836,26839
36577,1,512,512,512.00,0.00,26838,26839
36578,2,449,63,256.00,37249.00,26838,26840
36579,1,512,512,512.00,0.00,26839,26840
36580,1,512,512,512.00,0.00,26839,26840
36581,1,512,512,512.00,0.00,26839,26840
36582,1,512,512,512.00,0.00,26839,26840
36583,4,235,20,128.00,8263.50,26839,26843
36584,1,512,512,512.00,0.00,26842,26843
36585,1,512,512,512.00,0.00,26842,26843
36586,1,512,512,512.00,0.00,26842,26843
36587,1,512,512,512.00,0.00,26842,26843
36588,3,287,64,170.67,8334.89,26842,26845
36589,1,512,512,512.00,0.00,26844,26845
36590,1,512,512,512.00,0.00,26844,26845
36591,1,512,512,512.00,0.00,26844,26845
36592,1,512,512,512.00,0.00,26844,26845
36593,1,512,512,512.00,0.00,26844,26845
36594,1,512,512,512.00,0.00,26844,26845
36595,1,512,512,512.00,0.00,26844,26845
36596,1,512,512,512.00,0.00,26844,26845
36597,2,308,204,256.00,2704.00,26844,26846
36598,1,512,512,512.00,0.00,26845,26846
36599,3,331,51,170.67,13893.56,26845,26848
36600,1,512,512,512.00,0.00,26847,26848
36601,2,469,43,256.00,45369.00,26847,26849
36602,1,512,512,512.00,0.00,26848,26849
36603,1,512,512,512.00,0.00,26848,26849
36604,2,385,127,256.00,16641.00,26848,26850
36605,5,183,34,102.40,3327.04,26849,26854
36606,1,512,512,512.00,0.00,26853,26854
36607,1,512,512,512.00,0.00,26853,26854
36608,1,512,512,512.00,0.00,26853,26854
36609,1,512,512,512.00,0.00,26853,26854
36610,1,512,512,512.00,0.00,26853,26854
36611,2,474,38,256.00,47524.00,26853,26855
36612,2,381,131,256.00,15625.00,26854,26856
36613,1,512,512,512.00,0.00,26855,26856
36614,1,512,512,512.00,0.00,26855,26856
36615,1,512,512,512.00,0.00,26855,26856
36616,1,512,512,512.00,0.00,26855,26856
36617,1,512,512,512.00,0.00,26855,26856
36618,1,512,512,512.00,0.00,26855,26856
36619,1,512,512,512.00,0.00,26855,26856
36620,1,512,512,512.00,0.00,26855,26856
36621,4,437,1,128.00,32587.50,26855,26859
36622,1,512,512,512.00,0.00,26858,26859
36623,1,512,512,512.00,0.00,26858,26859
36624,1,512,512,512.00,0.00,26858,26859
36625,1,512,512,512.00,0.00,26858,26859
36626,1,512,512,512.00,0.00,26858,26859
36627,2,430,82,256.00,30276.00,26858,26860
36628,1,512,512,512.00,0.00,26859,26860
36629,5,357,1,102.40,16941.44,26859,26864
36630,2,369,143,256.00,12769.00,26863,26865
36631,1,512,512,512.00,0.00,26864,26865
36632,1,512,512,512.00,0.00,26864,26865
36633,2,510,2,256.00,64516.00,26864,26866
36634,1,512,512,512.00,0.00,26865,26866
36635,1,512,512,512.00,0.00,26865,26866
36636,1,512,512,512.00,0.00,26865,26866
36637,1,512,512,512.00,0.00,26865,26866
36638,3,317,48,170.67,12340.22,26865,26868
36639,1,512,512,512.00,0.00,26867,26868
36640,5,271,6,102.40,8965.04,26867,26872
36641,1,512,512,512.00,0.00,26871,26872
36642,1,512,512,512.00,0.00,26871,26872
36643,1,512,512,512.00,0.00,26871,26872
36644,2,394,118,256.00,19044.00,26871,26873
36645,1,512,512,512.00,0.00,26872,26873
36646,1,512,512,512.00,0.00,26872,26873
36647,1,512,512,512.00,0.00,26872,26873
36648,1,512,512,512.00,0.00,26872,26873
36649,1,512,512,512.00,0.00,26872,26873
36650,3,250,66,170.67,5963.56,26872,26875
36651,1,512,512,512.00,0.00,26874,26875
36652,1,512,512,512.00,0.00,26874,26875
36653,1,512,512,512.00,0.00,26874,26875
36654,1,512,512,512.00,0.00,26874,26875
36655,1,512,512,512.00,0.00,26874,26875
36656,1,512,512,512.00,0.00,26874,26875
36657,2,279,233,256.00,529.00,26874,26876
36658,1,512,512,512.00,0.00,26875,26876
36659,1,512,512,512.00,0.00,26875,26876
36660,1,512,512,512.00,0.00,26875,26876
36661,2,465,47,256.00,43681.00,26875,26877
36662,2,499,13,256.00,59049.00,26876,26878
36663,1,512,512,512.00,0.00,26877,26878
36664,1,512,512,512.00,0.00,26877,26878
36665,1,512,512,512.00,0.00,26877,26878
36666,1,512,512,512.00,0.00,26877,26878
36667,3,407,51,170.67,27928.22,26877,26880
36668,2,493,19,256.00,56169.00,26879,26881
36669,1,512,512,512.00,0.00,26880,26881
36670,1,512,512,512.00,0.00,26880,26881
36671,2,325,187,256.00,4761.00,26880,26882
36672,1,512,512,512.00,0.00,26881,26882
36673,1,512,512,512.00,0.00,26881,26882
36674,1,512,512,512.00,0.00,26881,26882
36675,4,365,6,128.00,19471.50,26881,26885
36676,1,512,512,512.00,0.00,26884,26885
36677,2,420,92,256.00,26896.00,26884,26886
36678,1,512,512,512.00,0.00,26885,26886
36679,1,512,512,512.00,0.00,26885,26886
36680,1,512,512,512.00,0.00,26885,26886
36681,3,351,23,170.67,18464.22,26885,26888
36682,1,512,512,512.00,0.00,26887,26888
36683,3,316,16,170.67,15043.56,26887,26890
36684,1,512,512,512.00,0.00,26889,26890
36685,1,512,512,512.00,0.00,26889,26890
36686,2,409,103,256.00,23409.00,26889,26891
36687,1,512,512,512.00,0.00,26890,26891
36688,1,512,512,512.00,0.00,26890,26891
36689,1,512,512,512.00,0.00,26890,26891
36690,1,512,512,512.00,0.00,26890,26891
36691,1,512,512,512.00,0.00,26890,26891
36692,1,512,512,512.00,0.00,26890,26891
36693,1,512,512,512.00,0.00,26890,26891
36694,5,228,48,102.40,4611.84,26890,26895
36695,1,512,512,512.00,0.00,26894,26895
36696,1,512,512,512.00,0.00,26894,26895
36697,1,512,512,512.00,0.00,26894,26895
36698,1,512,512,512.00,0.00,26894,26895
36699,1,512,512,512.00,0.00,26894,26895
36700,2,449,63,256.00,37249.00,26894,26896
36701,1,512,512,512.00,0.00,26895,26896
36702,1,512,512,512.00,0.00,26895,26896
36703,1,512,512,512.00,0.00,26895,26896
36704,1,512,512,512.00,0.00,26895,26896
36705,1,512,512,512.00,0.00,26895,26896
36706,1,512,512,512.00,0.00,26895,26896
36707,1,512,512,512.00,0.00,26895,26896
36708,1,512,512,512.00,0.00,26895,26896
36709,1,512,512,512.00,0.00,26895,26896
36710,1,512,512,512.00,0.00,26895,26896
36711,2,488,24,256.00,53824.00,26895,26897
36712,1,512,512,512.00,0.00,26896,26897
36713,1,512,512,512.00,0.00,26896,26897
36714,1,512,512,512.00,0.00,26896,26897
36715,1,512,512,512.00,0.00,26896,26897
36716,1,512,512,512.00,0.00,26896,26897
36717,1,512,512,512.00,0.00,26896,26897
36718,2,371,141,256.00,13225.00,26896,26898
36719,2,489,23,256.00,54289.00,26897,26899
36720,1,512,512,512.00,0.00,26898,26899
36721,1,512,512,512.00,0.00,26898,26899
36722,1,512,512,512.00,0.00,26898,26899
36723,1,512,512,512.00,0.00,26898,26899
36724,3,376,13,170.67,23097.56,26898,26901
36725,3,357,8,170.67,20580.22,26900,26903
36726,1,512,512,512.00,0.00,26902,26903
36727,2,490,22,256.00,54756.00,26902,26904
36728,1,512,512,512.00,0.00,26903,26904
36729,2,338,174,256.00,6724.00,26903,26905
36730,2,329,183,256.00,5329.00,26904,26906
36731,2,508,4,256.00,63504.00,26905,26907
36732,1,512,512,512.00,0.00,26906,26907
36733,1,512,512,512.00,0.00,26906,26907
36734,3,240,66,170.67,5670.22,26906,26909
36735,2,267,245,256.00,121.00,26908,26910
36736,1,512,512,512.00,0.00,26909,26910
36737,1,512,512,512.00,0.00,26909,26910
36738,1,512,512,512.00,0.00,26909,26910
36739,2,269,243,256.00,169.00,26909,26911
36740,1,512,512,512.00,0.00,26910,26911
36741,4,250,36,128.00,6130.00,26910,26914
36742,2,292,220,256.00,1296.00,26913,26915
36743,1,512,512,512.00,0.00,26914,26915
36744,2,450,62,256.00,37636.00,26914,26916
36745,4,233,27,128.00,6276.50,26915,26919
36746,1,512,512,512.00,0.00,26918,26919
36747,1,512,512,512.00,0.00,26918,26919
36748,1,512,512,512.00,0.00,26918,26919
36749,1,512,512,512.00,0.00,26918,26919
36750,3,330,11,170.67,16960.22,26918,26921
36751,1,512,512,512.00,0.00,26920,26921
36752,1,512,512,512.00,0.00,26920,26921
36753,1,512,512,512.00,0.00,26920,26921
36754,3,426,13,170.67,33197.56,26920,26923
36755,2,405,107,256.00,22201.00,26922,26924
36756,1,512,512,512.00,0.00,26923,26924
36757,1,512,512,512.00,0.00,26923,26924
36758,4,320,47,128.00,12567.50,26923,26927
36759,3,358,3,170.67,21197.56,26926,26929
36760,4,440,2,128.00,32994.00,26928,26932
36761,1,512,512,512.00,0.00,26931,26932
36762,3,254,32,170.67,9744.89,26931,26934
36763,4,380,31,128.00,21267.50,26933,26937
36764,3,333,10,170.67,17389.56,26936,26939
36765,2,396,116,256.00,19600.00,26938,26940
36766,3,290,28,170.67,11712.89,26939,26942
36767,1,512,512,512.00,0.00,26941,26942
36768,2,490,22,256.00,54756.00,26941,26943
36769,4,215,32,128.00,4242.50,26942,26946
36770,4,431,1,128.00,30897.00,26945,26949
36771,3,413,17,170.67,30066.89,26948,26951
36772,1,512,512,512.00,0.00,26950,26951
36773,1,512,512,512.00,0.00,26950,26951
36774,3,428,27,170.67,33260.22,26950,26953
36775,2,375,137,256.00,14161.00,26952,26954
36776,1,512,512,512.00,0.00,26953,26954
36777,1,512,512,512.00,0.00,26953,26954
36778,1,512,512,512.00,0.00,26953,26954
36779,1,512,512,512.00,0.00,26953,26954
36780,1,512,512,512.00,0.00,26953,26954
36781,2,484,28,256.00,51984.00,26953,26955
36782,1,512,512,512.00,0.00,26954,26955
36783,1,512,512,512.00,0.00,26954,26955
36784,2,293,219,256.00,1369.00,26954,26956
36785,2,510,2,256.00,64516.00,26955,26957
36786,2,490,22,256.00,54756.00,26956,26958
36787,1,512,512,512.00,0.00,26957,26958
36788,1,512,512,512.00,0.00,26957,26958
36789,1,512,512,512.00,0.00,26957,26958
36790,1,512,512,512.00,0.00,26957,26958
36791,1,512,512,512.00,0.00,26957,26958
36792,4,267,9,128.00,10161.00,26957,26961
36793,1,512,512,512.00,0.00,26960,26961
36794,3,333,49,170.67,14269.56,26960,26963
36795,3,347,67,170.67,15706.89,26962,26965
36796,1,512,512,512.00,0.00,26964,26965
36797,2,377,135,256.00,14641.00,26964,26966
36798,1,512,512,512.00,0.00,26965,26966
36799,1,512,512,512.00,0.00,26965,26966
36800,1,512,512,512.00,0.00,26965,26966
36801,1,512,512,512.00,0.00,26965,26966
36802,2,384,128,256.00,16384.00,26965,26967
36803,2,409,103,256.00,23409.00,26966,26968
36804,2,273,239,256.00,289.00,26967,26969
36805,1,512,512,512.00,0.00,26968,26969
36806,1,512,512,512.00,0.00,26968,26969
36807,1,512,512,512.00,0.00,26968,26969
36808,1,512,512,512.00,0.00,26968,26969
36809,1,512,512,512.00,0.00,26968,26969
36810,2,284,228,256.00,784.00,26968,26970
36811,1,512,512,512.00,0.00,26969,26970
36812,5,267,29,102.40,7598.24,26969,26974
36813,3,279,53,170.67,8556.22,26974,26977
36814,3,242,40,170.67,8560.89,26976,26979
36815,1,512,512,512.00,0.00,26978,26979
36816,5,258,1,102.40,11819.44,26978,26983
36817,4,350,1,128.00,19561.50,26982,26986
36818,6,213,1,85.33,4594.89,26985,26991
36819,1,512,512,512.00,0.00,26990,26991
36820,2,259,253,256.00,9.00,26990,26992
36821,1,512,512,512.00,0.00,26991,26992
36822,1,512,512,512.00,0.00,26991,26992
36823,1,512,512,512.00,0.00,26991,26992
36824,2,369,143,256.00,12769.00,26991,26993
36825,1,512,512,512.00,0.00,26992,26993
36826,1,512,512,512.00,0.00,26992,26993
36827,1,512,512,512.00,0.00,26992,26993
36828,2,445,67,256.00,35721.00,26992,26994
36829,1,512,512,512.00,0.00,26993,26994
36830,1,512,512,512.00,0.00,26993,26994
36831,2,262,250,256.00,36.00,26993,26995
36832,4,345,14,128.00,17572.50,26994,26998
36833,2,411,101,256.00,24025.00,26997,26999
36834,2,349,163,256.00,8649.00,26998,27000
36835,2,463,49,256.00,42849.00,26999,27001
36836,1,512,512,512.00,0.00,27000,27001
36837,1,512,512,512.00,0.00,27000,27001
36838,1,512,512,512.00,0.00,27000,27001
36839,2,266,246,256.00,100.00,27000,27002
36840,3,455,7,170.67,40730.89,27001,27004
36841,1,512,512,512.00,0.00,27003,27004
36842,3,373,44,170.67,20902.89,27003,27006
36843,3,254,25,170.67,10682.89,27005,27008
36844,1,512,512,512.00,0.00,27007,27008
36845,1,512,512,512.00,0.00,27007,27008
36846,2,382,130,256.00,15876.00,27007,27009
36847,2,406,106,256.00,22500.00,27008,27010
36848,1,512,512,512.00,0.00,27009,27010
36849,1,512,512,512.00,0.00,27009,27010
36850,1,512,512,512.00,0.00,27009,27010
36851,2,387,125,256.00,17161.00,27009,27011
36852,1,512,512,512.00,0.00,27010,27011
36853,1,512,512,512.00,0.00,27010,27011
36854,4,307,22,128.00,13255.50,27010,27014
36855,4,473,4,128.00,39741.50,27013,27017
36856,1,512,512,512.00,0.00,27016,27017
36857,3,352,9,170.67,19801.56,27016,27019
36858,3,264,38,170.67,9286.22,27018,27021
36859,1,512,512,512.00,0.00,27020,27021
36860,2,331,181,256.00,5625.00,27020,27022
36861,1,512,512,512.00,0.00,27021,27022
36862,1,512,512,512.00,0.00,27021,27022
36863,1,512,512,512.00,0.00,27021,27022
36864,1,512,512,512.00,0.00,27021,27022
36865,3,288,24,170.67,12046.22,27021,27024
36866,2,286,226,256.00,900.00,27023,27025
36867,2,458,54,256.00,40804.00,27024,27026
36868,2,346,166,256.00,8100.00,27025,27027
36869,1,512,512,512.00,0.00,27026,27027
36870,1,512,512,512.00,0.00,27026,27027
36871,3,376,57,170.67,21161.56,27026,27029
36872,2,274,238,256.00,324.00,27028,27030
36873,1,512,512,512.00,0.00,27029,27030
36874,1,512,512,512.00,0.00,27029,27030
36875,1,512,512,512.00,0.00,27029,27030
36876,1,512,512,512.00,0.00,27029,27030
36877,3,366,43,170.67,19677.56,27029,27032
36878,2,437,75,256.00,32761.00,27031,27033
36879,2,350,162,256.00,8836.00,27032,27034
36880,2,311,201,256.00,3025.00,27033,27035
36881,3,260,27,170.67,10524.22,27034,27037
36882,2,469,43,256.00,45369.00,27036,27038
36883,2,455,57,256.00,39601.00,27037,27039
36884,1,512,512,512.00,0.00,27038,27039
36885,1,512,512,512.00,0.00,27038,27039
36886,6,274,13,85.33,7768.56,27038,27044
36887,1,512,512,512.00,0.00,27043,27044
36888,2,309,203,256.00,2809.00,27043,27045
36889,1,512,512,512.00,0.00,27044,27045
36890,1,512,512,512.00,0.00,27044,27045
36891,1,512,512,512.00,0.00,27044,27045
36892,4,404,2,128.00,26275.50,27044,27048
36893,1,512,512,512.00,0.00,27047,27048
36894,2,392,120,256.00,18496.00,27047,27049
36895,2,466,46,256.00,44100.00,27048,27050
36896,3,347,6,170.67,19448.22,27049,27052
36897,1,512,512,512.00,0.00,27051,27052
36898,2,431,81,256.00,30625.00,27051,27053
36899,1,512,512,512.00,0.00,27052,27053
36900,1,512,512,512.00,0.00,27052,27053
36901,2,477,35,256.00,48841.00,27052,27054
36902,1,512,512,512.00,0.00,27053,27054
36903,2,491,21,256.00,55225.00,27053,27055
36904,1,512,512,512.00,0.00,27054,27055
36905,5,350,3,102.40,17027.84,27054,27059
36906,1,512,512,512.00,0.00,27058,27059
36907,1,512,512,512.00,0.00,27058,27059
36908,1,512,512,512.00,0.00,27058,27059
36909,1,512,512,512.00,0.00,27058,27059
36910,1,512,512,512.00,0.00,27058,27059
36911,1,512,512,512.00,0.00,27058,27059
36912,2,494,18,256.00,56644.00,27058,27060
36913,1,512,512,512.00,0.00,27059,27060
36914,1,512,512,512.00,0.00,27059,27060
36915,3,305,86,170.67,9226.89,27059,27062
36916,1,512,512,512.00,0.00,27061,27062
36917,1,512,512,512.00,0.00,27061,27062
36918,1,512,512,512.00,0.00,27061,27062
36919,2,291,221,256.00,1225.00,27061,27063
36920,1,512,512,512.00,0.00,27062,27063
36921,1,512,512,512.00,0.00,27062,27063
36922,1,512,512,512.00,0.00,27062,27063
36923,2,281,231,256.00,625.00,27062,27064
36924,1,512,512,512.00,0.00,27063,27064
36925,1,512,512,512.00,0.00,27063,27064
36926,1,512,512,512.00,0.00,27063,27064
36927,2,312,200,256.00,3136.00,27063,27065
36928,1,512,512,512.00,0.00,27064,27065
36929,2,359,153,256.00,10609.00,27064,27066
36930,1,512,512,512.00,0.00,27065,27066
36931,1,512,512,512.00,0.00,27065,27066
36932,1,512,512,512.00,0.00,27065,27066
36933,2,373,139,256.00,13689.00,27065,27067
36934,2,360,152,256.00,10816.00,27066,27068
36935,1,512,512,512.00,0.00,27067,27068
36936,3,429,14,170.67,33872.22,27067,27070
36937,2,461,51,256.00,42025.00,27069,27071
36938,1,512,512,512.00,0.00,27070,27071
36939,2,450,62,256.00,37636.00,27070,27072
36940,2,278,234,256.00,484.00,27071,27073
36941,4,331,14,128.00,14562.50,27072,27076
36942,2,408,104,256.00,23104.00,27075,27077
36943,1,512,512,512.00,0.00,27076,27077
36944,1,512,512,512.00,0.00,27076,27077
36945,2,483,29,256.00,51529.00,27076,27078
36946,1,512,512,512.00,0.00,27077,27078
36947,1,512,512,512.00,0.00,27077,27078
36948,2,487,25,256.00,53361.00,27077,27079
36949,2,488,24,256.00,53824.00,27078,27080
36950,1,512,512,512.00,0.00,27079,27080
36951,1,512,512,512.00,0.00,27079,27080
36952,2,449,63,256.00,37249.00,27079,27081
36953,1,512,512,512.00,0.00,27080,27081
36954,1,512,512,512.00,0.00,27080,27081
36955,2,399,113,256.00,20449.00,27080,27082
36956,2,487,25,256.00,53361.00,27081,27083
36957,1,512,512,512.00,0.00,27082,27083
36958,5,157,58,102.40,1974.64,27082,27087
36959,1,512,512,512.00,0.00,27086,27087
36960,2,508,4,256.00,63504.00,27086,27088
36961,3,308,64,170.67,10392.89,27087,27090
36962,3,295,48,170.67,10169.56,27089,27092
36963,1,512,512,512.00,0.00,27091,27092
36964,1,512,512,512.00,0.00,27091,27092
36965,1,512,512,512.00,0.00,27091,27092
36966,1,512,512,512.00,0.00,27091,27092
36967,1,512,512,512.00,0.00,27091,27092
36968,2,385,127,256.00,16641.00,27091,27093
36969,5,278,3,102.40,10490.24,27092,27097
36970,1,512,512,512.00,0.00,27096,27097
36971,1,512,512,512.00,0.00,27096,27097
36972,2,495,17,256.00,57121.00,27096,27098
36973,1,512,512,512.00,0.00,27097,27098
36974,3,298,54,170.67,9979.56,27097,27100
36975,1,512,512,512.00,0.00,27099,27100
36976,1,512,512,512.00,0.00,27099,27100
36977,2,260,252,256.00,16.00,27099,27101
36978,1,512,512,512.00,0.00,27100,27101
36979,7,217,1,73.14,5880.98,27100,27107
36980,1,512,512,512.00,0.00,27106,27107
36981,5,308,15,102.40,11353.04,27106,27111
36982,2,347,165,256.00,8281.00,27110,27112
36983,2,341,171,256.00,7225.00,27111,27113
36984,1,512,512,512.00,0.00,27112,27113
36985,2,396,116,256.00,19600.00,27112,27114
36986,4,202,16,128.00,4927.50,27113,27117
36987,1,512,512,512.00,0.00,27116,27117
36988,2,399,113,256.00,20449.00,27116,27118
36989,3,315,33,170.67,13276.22,27117,27120
36990,2,413,99,256.00,24649.00,27119,27121
36991,3,259,6,170.67,13581.56,27120,27123
36992,1,512,512,512.00,0.00,27122,27123
36993,1,512,512,512.00,0.00,27122,27123
36994,2,329,183,256.00,5329.00,27122,27124
36995,1,512,512,512.00,0.00,27123,27124
36996,1,512,512,512.00,0.00,27123,27124
36997,2,370,142,256.00,12996.00,27123,27125
36998,1,512,512,512.00,0.00,27124,27125
36999,1,512,512,512.00,0.00,27124,27125
37000,2,269,243,256.00,169.00,27124,27126
37001,1,512,512,512.00,0.00,27125,27126
37002,2,269,243,256.00,169.00,27125,27127
37003,1,512,512,512.00,0.00,27126,27127
37004,2,316,196,256.00,3600.00,27126,27128
37005,1,512,512,512.00,0.00,27127,27128
37006,1,512,512,512.00,0.00,27127,27128
37007,2,379,133,256.00,15129.00,27127,27129
37008,3,267,81,170.67,5788.22,27128,27131
37009,1,512,512,512.00,0.00,27130,27131
37010,2,348,164,256.00,8464.00,27130,27132
37011,1,512,512,512.00,0.00,27131,27132
37012,4,284,2,128.00,13527.50,27131,27135
37013,1,512,512,512.00,0.00,27134,27135
37014,2,257,255,256.00,1.00,27134,27136
37015,2,369,143,256.00,12769.00,27135,27137
37016,1,512,512,512.00,0.00,27136,27137
37017,1,512,512,512.00,0.00,27136,27137
37018,1,512,512,512.00,0.00,27136,27137
37019,2,314,198,256.00,3364.00,27136,27138
37020,2,460,52,256.00,41616.00,27137,27139
37021,2,496,16,256.00,57600.00,27138,27140
37022,1,512,512,512.00,0.00,27139,27140
37023,4,246,1,128.00,10926.50,27139,27143
37024,1,512,512,512.00,0.00,27142,27143
37025,1,512,512,512.00,0.00,27142,27143
37026,1,512,512,512.00,0.00,27142,27143
37027,1,512,512,512.00,0.00,27142,27143
37028,2,275,237,256.00,361.00,27142,27144
37029,1,512,512,512.00,0.00,27143,27144
37030,1,512,512,512.00,0.00,27143,27144
37031,5,397,1,102.40,22314.24,27143,27148
37032,3,467,2,170.67,44186.89,27147,27150
37033,1,512,512,512.00,0.00,27149,27150
37034,2,387,125,256.00,17161.00,27149,27151
37035,2,389,123,256.00,17689.00,27150,27152
37036,1,512,512,512.00,0.00,27151,27152
37037,1,512,512,512.00,0.00,27151,27152
37038,1,512,512,512.00,0.00,27151,27152
37039,2,444,68,256.00,35344.00,27151,27153
37040,2,287,225,256.00,961.00,27152,27154
37041,1,512,512,512.00,0.00,27153,27154
37042,2,306,206,256.00,2500.00,27153,27155
37043,1,512,512,512.00,0.00,27154,27155
37044,2,428,84,256.00,29584.00,27154,27156
37045,3,270,31,170.67,10333.56,27155,27158
37046,1,512,512,512.00,0.00,27157,27158
37047,2,505,7,256.00,62001.00,27157,27159
37048,5,359,2,102.40,18687.44,27158,27163
37049,1,512,512,512.00,0.00,27162,27163
37050,1,512,512,512.00,0.00,27162,27163
37051,1,512,512,512.00,0.00,27162,27163
37052,1,512,512,512.00,0.00,27162,27163
37053,2,411,101,256.00,24025.00,27162,27164
37054,1,512,512,512.00,0.00,27163,27164
37055,2,268,244,256.00,144.00,27163,27165
37056,1,512,512,512.00,0.00,27164,27165
37057,2,504,8,256.00,61504.00,27164,27166
37058,1,512,512,512.00,0.00,27165,27166
37059,1,512,512,512.00,0.00,27165,27166
37060,2,294,218,256.00,1444.00,27165,27167
37061,1,512,512,512.00,0.00,27166,27167
37062,2,350,162,256.00,8836.00,27166,27168
37063,3,406,24,170.67,28251.56,27167,27170
37064,2,378,134,256.00,14884.00,27169,27171
37065,3,322,63,170.67,12133.56,27170,27173
37066,1,512,512,512.00,0.00,27172,27173
37067,1,512,512,512.00,0.00,27172,27173
37068,3,253,59,170.67,6702.89,27172,27175
37069,4,315,21,128.00,12949.00,27174,27178
37070,4,339,5,128.00,18472.50,27177,27181
37071,2,455,57,256.00,39601.00,27180,27182
37072,2,317,195,256.00,3721.00,27181,27183
37073,1,512,512,512.00,0.00,27182,27183
37074,1,512,512,512.00,0.00,27182,27183
37075,1,512,512,512.00,0.00,27182,27183
37076,3,316,45,170.67,12433.56,27182,27185
37077,1,512,512,512.00,0.00,27184,27185
37078,1,512,512,512.00,0.00,27184,27185
37079,1,512,512,512.00,0.00,27184,27185
37080,1,512,512,512.00,0.00,27184,27185
37081,1,512,512,512.00,0.00,27184,27185
37082,2,434,78,256.00,31684.00,27184,27186
37083,2,326,186,256.00,4900.00,27185,27187
37084,2,335,177,256.00,6241.00,27186,27188
37085,2,365,147,256.00,11881.00,27187,27189
37086,1,512,512,512.00,0.00,27188,27189
37087,3,433,1,170.67,35397.56,27188,27191
37088,1,512,512,512.00,0.00,27190,27191
37089,4,279,7,128.00,12917.50,27190,27194
37090,1,512,512,512.00,0.00,27193,27194
37091,1,512,512,512.00,0.00,27193,27194
37092,1,512,512,512.00,0.00,27193,27194
37093,2,409,103,256.00,23409.00,27193,27195
37094,1,512,512,512.00,0.00,27194,27195
37095,1,512,512,512.00,0.00,27194,27195
37096,1,512,512,512.00,0.00,27194,27195
37097,1,512,512,512.00,0.00,27194,27195
37098,2,358,154,256.00,10404.00,27194,27196
37099,2,507,5,256.00,63001.00,27195,27197
37100,1,512,512,512.00,0.00,27196,27197
37101,3,343,1,170.67,19497.56,27196,27199
37102,1,512,512,512.00,0.00,27198,27199
37103,2,277,235,256.00,441.00,27198,27200
37104,2,306,206,256.00,2500.00,27199,27201
37105,1,512,512,512.00,0.00,27200,27201
37106,1,512,512,512.00,0.00,27200,27201
37107,1,512,512,512.00,0.00,27200,27201
37108,2,298,214,256.00,1764.00,27200,27202
37109,1,512,512,512.00,0.00,27201,27202
37110,4,408,3,128.00,27250.50,27201,27205
37111,1,512,512,512.00,0.00,27204,27205
37112,1,512,512,512.00,0.00,27204,27205
37113,2,315,197,256.00,3481.00,27204,27206
37114,1,512,512,512.00,0.00,27205,27206
37115,6,340,11,85.33,13311.56,27205,27211
37116,2,451,61,256.00,38025.00,27210,27212
37117,1,512,512,512.00,0.00,27211,27212
37118,3,273,33,170.67,10224.22,27211,27214
37119,1,512,512,512.00,0.00,27213,27214
37120,2,327,185,256.00,5041.00,27213,27215
37121,2,435,77,256.00,32041.00,27214,27216
37122,2,504,8,256.00,61504.00,27215,27217
37123,1,512,512,512.00,0.00,27216,27217
37124,1,512,512,512.00,0.00,27216,27217
37125,1,512,512,512.00,0.00,27216,27217
37126,2,468,44,256.00,44944.00,27216,27218
37127,1,512,512,512.00,0.00,27217,27218
37128,2,503,9,256.00,61009.00,27217,27219
37129,1,512,512,512.00,0.00,27218,27219
37130,1,512,512,512.00,0.00,27218,27219
37131,5,461,3,102.40,32294.24,27218,27223
37132,1,512,512,512.00,0.00,27222,27223
37133,3,448,3,170.67,39017.56,27222,27225
37134,1,512,512,512.00,0.00,27224,27225
37135,1,512,512,512.00,0.00,27224,27225
37136,2,291,221,256.00,1225.00,27224,27226
37137,2,372,140,256.00,13456.00,27225,27227
37138,1,512,512,512.00,0.00,27226,27227
37139,1,512,512,512.00,0.00,27226,27227
37140,1,512,512,512.00,0.00,27226,27227
37141,1,512,512,512.00,0.00,27226,27227
37142,2,267,245,256.00,121.00,27226,27228
37143,1,512,512,512.00,0.00,27227,27228
37144,3,343,20,170.67,17622.89,27227,27230
37145,1,512,512,512.00,0.00,27229,27230
37146,4,344,31,128.00,16137.50,27229,27233
37147,2,362,150,256.00,11236.00,27232,27234
37148,1,512,512,512.00,0.00,27233,27234
37149,2,377,135,256.00,14641.00,27233,27235
37150,1,512,512,512.00,0.00,27234,27235
37151,1,512,512,512.00,0.00,27234,27235
37152,1,512,512,512.00,0.00,27234,27235
37153,1,512,512,512.00,0.00,27234,27235
37154,1,512,512,512.00,0.00,27234,27235
37155,2,398,114,256.00,20164.00,27234,27236
37156,1,512,512,512.00,0.00,27235,27236
37157,2,464,48,256.00,43264.00,27235,27237
37158,1,512,512,512.00,0.00,27236,27237
37159,2,364,148,256.00,11664.00,27236,27238
37160,1,512,512,512.00,0.00,27237,27238
37161,3,499,5,170.67,53902.89,27237,27240
37162,6,348,5,85.33,15015.56,27239,27245
37163,1,512,512,512.00,0.00,27244,27245
37164,2,296,216,256.00,1600.00,27244,27246
37165,1,512,512,512.00,0.00,27245,27246
37166,1,512,512,512.00,0.00,27245,27246
37167,2,480,32,256.00,50176.00,27245,27247
37168,1,512,512,512.00,0.00,27246,27247
37169,1,512,512,512.00,0.00,27246,27247
37170,1,512,512,512.00,0.00,27246,27247
37171,1,512,512,512.00,0.00,27246,27247
37172,3,418,36,170.67,30667.56,27246,27249
37173,1,512,512,512.00,0.00,27248,27249
37174,2,498,14,256.00,58564.00,27248,27250
37175,6,169,30,85.33,2215.22,27249,27255
37176,2,423,89,256.00,27889.00,27254,27256
37177,1,512,512,512.00,0.00,27255,27256
37178,1,512,512,512.00,0.00,27255,27256
37179,1,512,512,512.00,0.00,27255,27256
37180,2,470,42,256.00,45796.00,27255,27257
37181,1,512,512,512.00,0.00,27256,27257
37182,2,315,197,256.00,3481.00,27256,27258
37183,1,512,512,512.00,0.00,27257,27258
37184,2,369,143,256.00,12769.00,27257,27259
37185,1,512,512,512.00,0.00,27258,27259
37186,2,286,226,256.00,900.00,27258,27260
37187,1,512,512,512.00,0.00,27259,27260
37188,2,484,28,256.00,51984.00,27259,27261
37189,2,485,27,256.00,52441.00,27260,27262
37190,1,512,512,512.00,0.00,27261,27262
37191,1,512,512,512.00,0.00,27261,27262
37192,1,512,512,512.00,0.00,27261,27262
37193,1,512,512,512.00,0.00,27261,27262
37194,2,433,79,256.00,31329.00,27261,27263
37195,2,394,118,256.00,19044.00,27262,27264
37196,4,405,2,128.00,26904.50,27264,27268
37197,5,267,11,102.40,9823.84,27267,27272
37198,1,512,512,512.00,0.00,27271,27272
37199,1,512,512,512.00,0.00,27271,27272
37200,1,512,512,512.00,0.00,27271,27272
37201,1,512,512,512.00,0.00,27271,27272
37202,5,287,6,102.40,10583.44,27271,27276
37203,1,512,512,512.00,0.00,27275,27276
37204,1,512,512,512.00,0.00,27275,27276
37205,1,512,512,512.00,0.00,27275,27276
37206,2,505,7,256.00,62001.00,27275,27277
37207,1,512,512,512.00,0.00,27276,27277
37208,1,512,512,512.00,0.00,27276,27277
37209,2,395,117,256.00,19321.00,27276,27278
37210,2,276,236,256.00,400.00,27277,27279
37211,5,150,41,102.40,1739.84,27278,27283
37212,2,335,177,256.00,6241.00,27282,27284
37213,2,371,141,256.00,13225.00,27283,27285
37214,1,512,512,512.00,0.00,27284,27285
37215,1,512,512,512.00,0.00,27284,27285
37216,2,454,58,256.00,39204.00,27284,27286
37217,4,231,43,128.00,6879.50,27285,27289
37218,1,512,512,512.00,0.00,27288,27289
37219,1,512,512,512.00,0.00,27288,27289
37220,3,262,4,170.67,13931.56,27288,27291
37221,4,244,45,128.00,5600.50,27290,27294
37222,1,512,512,512.00,0.00,27293,27294
37223,3,386,31,170.67,23866.89,27293,27296
37224,6,333,3,85.33,12559.56,27295,27301
37225,1,512,512,512.00,0.00,27300,27301
37226,1,512,512,512.00,0.00,27300,27301
37227,3,241,30,170.67,9893.56,27300,27303
37228,1,512,512,512.00,0.00,27302,27303
37229,3,470,11,170.67,44866.89,27302,27305
37230,1,512,512,512.00,0.00,27304,27305
37231,3,396,21,170.67,26300.22,27304,27307
37232,2,403,109,256.00,21609.00,27306,27308
37233,6,420,5,85.33,22529.89,27307,27313
37234,1,512,512,512.00,0.00,27312,27313
37235,1,512,512,512.00,0.00,27312,27313
37236,1,512,512,512.00,0.00,27312,27313
37237,2,306,206,256.00,2500.00,27312,27314
37238,1,512,512,512.00,0.00,27313,27314
37239,1,512,512,512.00,0.00,27313,27314
37240,2,350,162,256.00,8836.00,27313,27315
37241,1,512,512,512.00,0.00,27314,27315
37242,1,512,512,512.00,0.00,27314,27315
37243,1,512,512,512.00,0.00,27314,27315
37244,1,512,512,512.00,0.00,27314,27315
37245,1,512,512,512.00,0.00,27314,27315
37246,2,365,147,256.00,11881.00,27314,27316
37247,1,512,512,512.00,0.00,27315,27316
37248,1,512,512,512.00,0.00,27315,27316
37249,1,512,512,512.00,0.00,27315,27316
37250,1,512,512,512.00,0.00,27315,27316
37251,2,313,199,256.00,3249.00,27315,27317
37252,2,347,165,256.00,8281.00,27316,27318
37253,2,332,180,256.00,5776.00,27317,27319
37254,3,398,7,170.67,27506.89,27318,27321
37255,1,512,512,512.00,0.00,27320,27321
37256,1,512,512,512.00,0.00,27320,27321
37257,1,512,512,512.00,0.00,27320,27321
37258,3,502,3,170.67,54893.56,27320,27323
37259,1,512,512,512.00,0.00,27322,27323
37260,3,437,24,170.67,35588.22,27322,27325
37261,3,383,61,170.67,22550.89,27324,27327
37262,2,459,53,256.00,41209.00,27326,27328
37263,2,266,246,256.00,100.00,27327,27329
37264,5,356,5,102.40,18197.04,27328,27333
37265,5,295,2,102.40,11616.24,27332,27337
37266,1,512,512,512.00,0.00,27336,27337
37267,1,512,512,512.00,0.00,27336,27337
37268,2,427,85,256.00,29241.00,27336,27338
37269,2,329,183,256.00,5329.00,27337,27339
37270,2,385,127,256.00,16641.00,27338,27340
37271,1,512,512,512.00,0.00,27339,27340
37272,2,304,208,256.00,2304.00,27339,27341
37273,7,174,1,73.14,4280.41,27340,27347
37274,1,512,512,512.00,0.00,27346,27347
37275,1,512,512,512.00,0.00,27346,27347
37276,2,369,143,256.00,12769.00,27346,27348
37277,3,470,1,170.67,45066.89,27347,27350
37278,1,512,512,512.00,0.00,27349,27350
37279,1,512,512,512.00,0.00,27349,27350
37280,1,512,512,512.00,0.00,27349,27350
37281,2,440,72,256.00,33856.00,27349,27351
37282,1,512,512,512.00,0.00,27350,27351
37283,1,512,512,512.00,0.00,27350,27351
37284,1,512,512,512.00,0.00,27350,27351
37285,1,512,512,512.00,0.00,27350,27351
37286,1,512,512,512.00,0.00,27350,27351
37287,2,283,229,256.00,729.00,27350,27352
37288,1,512,512,512.00,0.00,27351,27352
37289,2,386,126,256.00,16900.00,27351,27353
37290,2,285,227,256.00,841.00,27352,27354
37291,1,512,512,512.00,0.00,27353,27354
37292,1,512,512,512.00,0.00,27353,27354
37293,2,406,106,256.00,22500.00,27353,27355
37294,3,289,26,170.67,11874.89,27354,27357
37295,7,372,1,73.14,15121.55,27356,27363
37296,3,253,80,170.67,5022.89,27362,27365
37297,2,465,47,256.00,43681.00,27364,27366
37298,4,228,87,128.00,3361.50,27365,27369
37299,3,221,95,170.67,2966.89,27368,27371
37300,1,512,512,512.00,0.00,27370,27371
37301,1,512,512,512.00,0.00,27370,27371
37302,1,512,512,512.00,0.00,27370,27371
37303,2,305,207,256.00,2401.00,27370,27372
37304,4,220,48,128.00,5358.50,27371,27375
37305,1,512,512,512.00,0.00,27374,27375
37306,3,502,4,170.67,54891.56,27374,27377
37307,2,495,17,256.00,57121.00,27376,27378
37308,2,400,112,256.00,20736.00,27377,27379
37309,1,512,512,512.00,0.00,27378,27379
37310,1,512,512,512.00,0.00,27378,27379
37311,1,512,512,512.00,0.00,27378,27379
37312,1,512,512,512.00,0.00,27378,27379
37313,1,512,512,512.00,0.00,27378,27379
37314,2,377,135,256.00,14641.00,27378,27380
37315,2,447,65,256.00,36481.00,27379,27381
37316,2,299,213,256.00,1849.00,27380,27382
37317,1,512,512,512.00,0.00,27381,27382
37318,2,281,231,256.00,625.00,27381,27383
37319,1,512,512,512.00,0.00,27382,27383
37320,2,338,174,256.00,6724.00,27382,27384
37321,3,307,3,170.67,15893.56,27383,27386
37322,1,512,512,512.00,0.00,27385,27386
37323,1,512,512,512.00,0.00,27385,27386
37324,3,367,30,170.67,20477.56,27385,27388
37325,1,512,512,512.00,0.00,27387,27388
37326,3,382,1,170.67,25061.56,27387,27390
37327,1,512,512,512.00,0.00,27389,27390
37328,3,472,5,170.67,45550.89,27389,27392
37329,3,237,82,170.67,4253.56,27391,27394
37330,1,512,512,512.00,0.00,27393,27394
37331,2,300,212,256.00,1936.00,27393,27395
37332,3,349,2,170.67,20114.89,27394,27397
37333,1,512,512,512.00,0.00,27396,27397
37334,1,512,512,512.00,0.00,27396,27397
37335,1,512,512,512.00,0.00,27396,27397
37336,2,398,114,256.00,20164.00,27396,27398
37337,3,268,101,170.67,5030.89,27397,27400
37338,2,279,233,256.00,529.00,27399,27401
37339,1,512,512,512.00,0.00,27400,27401
37340,1,512,512,512.00,0.00,27400,27401
37341,2,264,248,256.00,64.00,27400,27402
37342,5,303,3,102.40,15129.84,27401,27406
37343,1,512,512,512.00,0.00,27405,27406
37344,1,512,512,512.00,0.00,27405,27406
37345,3,305,20,170.67,13670.89,27405,27408
37346,1,512,512,512.00,0.00,27407,27408
37347,2,369,143,256.00,12769.00,27407,27409
37348,1,512,512,512.00,0.00,27408,27409
37349,2,425,87,256.00,28561.00,27408,27410
37350,1,512,512,512.00,0.00,27409,27410
37351,1,512,512,512.00,0.00,27409,27410
37352,6,271,2,85.33,9261.56,27409,27415
37353,1,512,512,512.00,0.00,27414,27415
37354,1,512,512,512.00,0.00,27414,27415
37355,1,512,512,512.00,0.00,27414,27415
37356,2,474,38,256.00,47524.00,27414,27416
37357,1,512,512,512.00,0.00,27415,27416
37358,1,512,512,512.00,0.00,27415,27416
37359,2,435,77,256.00,32041.00,27415,27417
37360,2,503,9,256.00,61009.00,27416,27418
37361,4,285,17,128.00,11619.50,27417,27421
37362,3,243,71,170.67,5304.22,27420,27423
37363,1,512,512,512.00,0.00,27422,27423
37364,2,426,86,256.00,28900.00,27422,27424
37365,1,512,512,512.00,0.00,27423,27424
37366,2,351,161,256.00,9025.00,27423,27425
37367,1,512,512,512.00,0.00,27424,27425
37368,1,512,512,512.00,0.00,27424,27425
37369,2,466,46,256.00,44100.00,27424,27426
37370,1,512,512,512.00,0.00,27425,27426
37371,1,512,512,512.00,0.00,27425,27426
37372,2,267,245,256.00,121.00,27425,27427
37373,2,376,136,256.00,14400.00,27426,27428
37374,1,512,512,512.00,0.00,27427,27428
37375,5,286,1,102.40,11100.24,27427,27432
37376,1,512,512,512.00,0.00,27431,27432
37377,1,512,512,512.00,0.00,27431,27432
37378,1,512,512,512.00,0.00,27431,27432
37379,1,512,512,512.00,0.00,27431,27432
37380,1,512,512,512.00,0.00,27431,27432
37381,2,484,28,256.00,51984.00,27431,27433
37382,2,298,214,256.00,1764.00,27432,27434
37383,2,409,103,256.00,23409.00,27433,27435
37384,1,512,512,512.00,0.00,27434,27435
37385,2,426,86,256.00,28900.00,27434,27436
37386,2,423,89,256.00,27889.00,27435,27437
37387,1,512,512,512.00,0.00,27436,27437
37388,1,512,512,512.00,0.00,27436,27437
37389,1,512,512,512.00,0.00,27436,27437
37390,2,463,49,256.00,42849.00,27436,27438
37391,2,382,130,256.00,15876.00,27437,27439
37392,1,512,512,512.00,0.00,27438,27439
37393,1,512,512,512.00,0.00,27438,27439
37394,2,284,228,256.00,784.00,27438,27440
37395,1,512,512,512.00,0.00,27439,27440
37396,1,512,512,512.00,0.00,27439,27440
37397,1,512,512,512.00,0.00,27439,27440
37398,2,324,188,256.00,4624.00,27439,27441
37399,1,512,512,512.00,0.00,27440,27441
37400,1,512,512,512.00,0.00,27440,27441
37401,1,512,512,512.00,0.00,27440,27441
37402,1,512,512,512.00,0.00,27440,27441
37403,3,264,14,170.67,12422.22,27440,27443
37404,2,511,1,256.00,65025.00,27442,27444
37405,1,512,512,512.00,0.00,27443,27444
37406,1,512,512,512.00,0.00,27443,27444
37407,2,423,89,256.00,27889.00,27443,27445
37408,1,512,512,512.00,0.00,27444,27445
37409,2,412,100,256.00,24336.00,27444,27446
37410,3,255,21,170.67,11260.22,27445,27448
37411,1,512,512,512.00,0.00,27447,27448
37412,1,512,512,512.00,0.00,27447,27448
37413,1,512,512,512.00,0.00,27447,27448
37414,6,193,3,85.33,6772.56,27447,27453
37415,1,512,512,512.00,0.00,27452,27453
37416,1,512,512,512.00,0.00,27453,27454
37417,3,466,14,170.67,43664.89,27453,27456
37418,2,336,176,256.00,6400.00,27455,27457
37419,2,430,82,256.00,30276.00,27456,27458
37420,1,512,512,512.00,0.00,27457,27458
37421,1,512,512,512.00,0.00,27457,27458
37422,2,350,162,256.00,8836.00,27457,27459
37423,1,512,512,512.00,0.00,27458,27459
37424,6,338,2,85.33,14046.56,27458,27464
37425,2,353,159,256.00,9409.00,27463,27465
37426,1,512,512,512.00,0.00,27464,27465
37427,2,354,158,256.00,9604.00,27464,27466
37428,1,512,512,512.00,0.00,27465,27466
37429,1,512,512,512.00,0.00,27465,27466
37430,2,333,179,256.00,5929.00,27465,27467
37431,1,512,512,512.00,0.00,27466,27467
37432,1,512,512,512.00,0.00,27466,27467
37433,2,441,71,256.00,34225.00,27466,27468
37434,1,512,512,512.00,0.00,27467,27468
37435,3,282,8,170.67,13830.22,27467,27470
37436,1,512,512,512.00,0.00,27469,27470
37437,1,512,512,512.00,0.00,27469,27470
37438,1,512,512,512.00,0.00,27469,27470
37439,1,512,512,512.00,0.00,27469,27470
37440,3,281,10,170.67,13506.89,27469,27472
37441,2,455,57,256.00,39601.00,27471,27473
37442,1,512,512,512.00,0.00,27472,27473
37443,1,512,512,512.00,0.00,27472,27473
37444,1,512,512,512.00,0.00,27472,27473
37445,1,512,512,512.00,0.00,27472,27473
37446,7,223,12,73.14,4641.84,27472,27479
37447,1,512,512,512.00,0.00,27478,27479
37448,1,512,512,512.00,0.00,27478,27479
37449,3,272,113,170.67,5166.89,27478,27481
37450,1,512,512,512.00,0.00,27480,27481
37451,1,512,512,512.00,0.00,27480,27481
37452,1,512,512,512.00,0.00,27480,27481
37453,2,424,88,256.00,28224.00,27480,27482
37454,1,512,512,512.00,0.00,27481,27482
37455,1,512,512,512.00,0.00,27481,27482
37456,1,512,512,512.00,0.00,27481,27482
37457,2,342,170,256.00,7396.00,27481,27483
37458,2,477,35,256.00,48841.00,27482,27484
37459,4,483,3,128.00,42049.50,27483,27487
37460,2,391,121,256.00,18225.00,27486,27488
37461,1,512,512,512.00,0.00,27487,27488
37462,1,512,512,512.00,0.00,27487,27488
37463,1,512,512,512.00,0.00,27487,27488
37464,2,259,253,256.00,9.00,27487,27489
37465,2,261,251,256.00,25.00,27488,27490
37466,1,512,512,512.00,0.00,27489,27490
37467,2,335,177,256.00,6241.00,27489,27491
37468,1,512,512,512.00,0.00,27490,27491
37469,1,512,512,512.00,0.00,27490,27491
37470,2,314,198,256.00,3364.00,27490,27492
37471,1,512,512,512.00,0.00,27491,27492
37472,2,262,250,256.00,36.00,27491,27493
37473,1,512,512,512.00,0.00,27492,27493
37474,1,512,512,512.00,0.00,27492,27493
37475,4,238,4,128.00,6918.00,27492,27496
37476,2,332,180,256.00,5776.00,27495,27497
37477,1,512,512,512.00,0.00,27496,27497
37478,2,469,43,256.00,45369.00,27496,27498
37479,1,512,512,512.00,0.00,27497,27498
37480,1,512,512,512.00,0.00,27497,27498
37481,1,512,512,512.00,0.00,27497,27498
37482,1,512,512,512.00,0.00,27497,27498
37483,6,222,1,85.33,5366.89,27497,27503
37484,3,415,12,170.67,30737.56,27502,27505
37485,1,512,512,512.00,0.00,27504,27505
37486,1,512,512,512.00,0.00,27504,27505
37487,2,358,154,256.00,10404.00,27504,27506
37488,2,401,111,256.00,21025.00,27505,27507
37489,1,512,512,512.00,0.00,27506,27507
37490,3,378,41,170.67,21944.22,27506,27509
37491,2,395,117,256.00,19321.00,27508,27510
37492,1,512,512,512.00,0.00,27509,27510
37493,1,512,512,512.00,0.00,27509,27510
37494,1,512,512,512.00,0.00,27509,27510
37495,1,512,512,512.00,0.00,27509,27510
37496,3,347,25,170.67,17750.89,27509,27512
37497,1,512,512,512.00,0.00,27511,27512
37498,1,512,512,512.00,0.00,27511,27512
37499,1,512,512,512.00,0.00,27511,27512
37500,4,481,1,128.00,41667.00,27511,27515
37501,9,315,1,56.89,9895.43,27514,27523
37502,2,320,192,256.00,4096.00,27522,27524
37503,2,312,200,256.00,3136.00,27523,27525
37504,1,512,512,512.00,0.00,27524,27525
37505,2,257,255,256.00,1.00,27524,27526
37506,1,512,512,512.00,0.00,27525,27526
37507,1,512,512,512.00,0.00,27525,27526
37508,4,261,5,128.00,8505.00,27525,27529
37509,1,512,512,512.00,0.00,27528,27529
37510,1,512,512,512.00,0.00,27528,27529
37511,1,512,512,512.00,0.00,27528,27529
37512,2,303,209,256.00,2209.00,27528,27530
37513,2,445,67,256.00,35721.00,27529,27531
37514,1,512,512,512.00,0.00,27530,27531
37515,1,512,512,512.00,0.00,27530,27531
37516,3,287,17,170.67,12846.89,27530,27533
37517,2,502,10,256.00,60516.00,27532,27534
37518,1,512,512,512.00,0.00,27533,27534
37519,2,449,63,256.00,37249.00,27533,27535
37520,1,512,512,512.00,0.00,27534,27535
37521,1,512,512,512.00,0.00,27534,27535
37522,5,184,50,102.40,3551.04,27534,27539
37523,3,292,81,170.67,7921.56,27538,27541
37524,2,392,120,256.00,18496.00,27540,27542
37525,4,355,2,128.00,19837.50,27541,27545
37526,1,512,512,512.00,0.00,27544,27545
37527,1,512,512,512.00,0.00,27544,27545
37528,5,384,5,102.40,20584.24,27544,27549
37529,3,295,3,170.67,15149.56,27548,27551
37530,4,447,1,128.00,34530.50,27550,27554
37531,1,512,512,512.00,0.00,27553,27554
37532,1,512,512,512.00,0.00,27553,27554
37533,2,303,209,256.00,2209.00,27553,27555
37534,1,512,512,512.00,0.00,27554,27555
37535,1,512,512,512.00,0.00,27554,27555
37536,2,338,174,256.00,6724.00,27554,27556
37537,1,512,512,512.00,0.00,27555,27556
37538,5,215,8,102.40,5153.04,27555,27560
37539,1,512,512,512.00,0.00,27559,27560
37540,2,376,136,256.00,14400.00,27559,27561
37541,1,512,512,512.00,0.00,27560,27561
37542,5,482,3,102.40,36065.84,27560,27565
37543,3,375,1,170.67,23913.56,27564,27567
37544,6,193,4,85.33,6941.22,27566,27572
37545,1,512,512,512.00,0.00,27571,27572
37546,2,337,175,256.00,6561.00,27571,27573
37547,2,374,138,256.00,13924.00,27572,27574
37548,1,512,512,512.00,0.00,27573,27574
37549,1,512,512,512.00,0.00,27573,27574
37550,1,512,512,512.00,0.00,27573,27574
37551,2,348,164,256.00,8464.00,27573,27575
37552,1,512,512,512.00,0.00,27574,27575
37553,2,350,162,256.00,8836.00,27574,27576
37554,1,512,512,512.00,0.00,27575,27576
37555,2,425,87,256.00,28561.00,27575,27577
37556,2,353,159,256.00,9409.00,27576,27578
37557,1,512,512,512.00,0.00,27577,27578
37558,2,294,218,256.00,1444.00,27577,27579
37559,2,416,96,256.00,25600.00,27578,27580
37560,1,512,512,512.00,0.00,27579,27580
37561,1,512,512,512.00,0.00,27579,27580
37562,1,512,512,512.00,0.00,27579,27580
37563,2,279,233,256.00,529.00,27579,27581
37564,1,512,512,512.00,0.00,27580,27581
37565,1,512,512,512.00,0.00,27580,27581
37566,1,512,512,512.00,0.00,27580,27581
37567,2,479,33,256.00,49729.00,27580,27582
37568,2,399,113,256.00,20449.00,27581,27583
37569,3,426,34,170.67,32651.56,27582,27585
37570,1,512,512,512.00,0.00,27584,27585
37571,1,512,512,512.00,0.00,27584,27585
37572,3,410,4,170.67,30112.89,27584,27587
37573,2,300,212,256.00,1936.00,27586,27588
37574,1,512,512,512.00,0.00,27587,27588
37575,1,512,512,512.00,0.00,27587,27588
37576,4,235,25,128.00,5629.00,27587,27591
37577,1,512,512,512.00,0.00,27590,27591
37578,3,434,6,170.67,35398.22,27590,27593
37579,1,512,512,512.00,0.00,27592,27593
37580,3,479,15,170.67,47536.22,27592,27595
37581,1,512,512,512.00,0.00,27594,27595
37582,1,512,512,512.00,0.00,27594,27595
37583,1,512,512,512.00,0.00,27594,27595
37584,4,270,51,128.00,7871.50,27594,27598
37585,2,495,17,256.00,57121.00,27597,27599
37586,2,450,62,256.00,37636.00,27598,27600
37587,1,512,512,512.00,0.00,27599,27600
37588,2,309,203,256.00,2809.00,27599,27601
37589,1,512,512,512.00,0.00,27600,27601
37590,3,452,11,170.67,39814.89,27600,27603
37591,2,476,36,256.00,48400.00,27602,27604
37592,1,512,512,512.00,0.00,27603,27604
37593,1,512,512,512.00,0.00,27603,27604
37594,1,512,512,512.00,0.00,27603,27604
37595,1,512,512,512.00,0.00,27603,27604
37596,2,479,33,256.00,49729.00,27603,27605
37597,1,512,512,512.00,0.00,27604,27605
37598,2,376,136,256.00,14400.00,27604,27606
37599,2,504,8,256.00,61504.00,27605,27607
37600,1,512,512,512.00,0.00,27606,27607
37601,1,512,512,512.00,0.00,27606,27607
37602,2,439,73,256.00,33489.00,27606,27608
37603,1,512,512,512.00,0.00,27607,27608
37604,1,512,512,512.00,0.00,27607,27608
37605,3,332,9,170.67,17388.22,27607,27610
37606,1,512,512,512.00,0.00,27609,27610
37607,1,512,512,512.00,0.00,27609,27610
37608,2,473,39,256.00,47089.00,27609,27611
37609,2,496,16,256.00,57600.00,27610,27612
37610,2,402,110,256.00,21316.00,27611,27613
37611,4,255,3,128.00,9091.00,27612,27616
37612,1,512,512,512.00,0.00,27615,27616
37613,1,512,512,512.00,0.00,27615,27616
37614,1,512,512,512.00,0.00,27615,27616
37615,2,374,138,256.00,13924.00,27615,27617
37616,2,485,27,256.00,52441.00,27616,27618
37617,2,401,111,256.00,21025.00,27617,27619
37618,1,512,512,512.00,0.00,27618,27619
37619,2,397,115,256.00,19881.00,27618,27620
37620,3,300,79,170.67,8849.56,27619,27622
37621,4,339,3,128.00,19081.50,27621,27625
37622,3,238,81,170.67,4357.56,27624,27627
37623,1,512,512,512.00,0.00,27626,27627
37624,4,363,4,128.00,20093.50,27626,27630
37625,2,489,23,256.00,54289.00,27629,27631
37626,1,512,512,512.00,0.00,27630,27631
37627,2,365,147,256.00,11881.00,27630,27632
37628,3,265,64,170.67,6809.56,27631,27634
37629,1,512,512,512.00,0.00,27633,27634
37630,1,512,512,512.00,0.00,27633,27634
37631,1,512,512,512.00,0.00,27633,27634
37632,3,251,16,170.67,11966.89,27633,27636
37633,1,512,512,512.00,0.00,27635,27636
37634,1,512,512,512.00,0.00,27635,27636
37635,1,512,512,512.00,0.00,27635,27636
37636,1,512,512,512.00,0.00,27635,27636
37637,1,512,512,512.00,0.00,27635,27636
37638,2,284,228,256.00,784.00,27635,27637
37639,1,512,512,512.00,0.00,27636,27637
37640,2,313,199,256.00,3249.00,27636,27638
37641,1,512,512,512.00,0.00,27637,27638
37642,2,486,26,256.00,52900.00,27637,27639
37643,6,403,8,85.33,20310.56,27638,27644
37644,5,405,7,102.40,23199.84,27643,27648
37645,1,512,512,512.00,0.00,27647,27648
37646,1,512,512,512.00,0.00,27647,27648
37647,2,464,48,256.00,43264.00,27647,27649
37648,1,512,512,512.00,0.00,27648,27649
37649,1,512,512,512.00,0.00,27648,27649
37650,1,512,512,512.00,0.00,27648,27649
37651,4,303,13,128.00,11633.00,27648,27652
37652,2,263,249,256.00,49.00,27651,27653
37653,3,250,21,170.67,11213.56,27652,27655
37654,1,512,512,512.00,0.00,27654,27655
37655,1,512,512,512.00,0.00,27654,27655
37656,1,512,512,512.00,0.00,27654,27655
37657,1,512,512,512.00,0.00,27654,27655
37658,4,408,17,128.00,26421.50,27654,27658
37659,2,497,15,256.00,58081.00,27657,27659
37660,1,512,512,512.00,0.00,27658,27659
37661,2,504,8,256.00,61504.00,27658,27660
37662,3,197,150,170.67,384.22,27659,27662
37663,2,408,104,256.00,23104.00,27661,27663
37664,3,478,16,170.67,47227.56,27662,27665
37665,6,262,1,85.33,11189.89,27664,27670
37666,2,304,208,256.00,2304.00,27669,27671
37667,2,473,39,256.00,47089.00,27670,27672
37668,1,512,512,512.00,0.00,27671,27672
37669,1,512,512,512.00,0.00,27671,27672
37670,1,512,512,512.00,0.00,27671,27672
37671,2,303,209,256.00,2209.00,27671,27673
37672,1,512,512,512.00,0.00,27672,27673
37673,5,451,2,102.40,30456.24,27672,27677
37674,3,318,13,170.67,15557.56,27676,27679
37675,4,260,1,128.00,11092.50,27678,27682
37676,2,477,35,256.00,48841.00,27681,27683
37677,2,474,38,256.00,47524.00,27682,27684
37678,2,486,26,256.00,52900.00,27683,27685
37679,1,512,512,512.00,0.00,27684,27685
37680,2,496,16,256.00,57600.00,27684,27686
37681,2,487,25,256.00,53361.00,27685,27687
37682,2,485,27,256.00,52441.00,27686,27688
37683,3,305,25,170.67,13130.89,27687,27690
37684,2,407,105,256.00,22801.00,27689,27691
37685,1,512,512,512.00,0.00,27690,27691
37686,1,512,512,512.00,0.00,27690,27691
37687,2,399,113,256.00,20449.00,27690,27692
37688,1,512,512,512.00,0.00,27691,27692
37689,3,257,60,170.67,6764.22,27691,27694
37690,1,512,512,512.00,0.00,27693,27694
37691,1,512,512,512.00,0.00,27693,27694
37692,1,512,512,512.00,0.00,27693,27694
37693,1,512,512,512.00,0.00,27693,27694
37694,2,260,252,256.00,16.00,27693,27695
37695,1,512,512,512.00,0.00,27694,27695
37696,1,512,512,512.00,0.00,27694,27695
37697,1,512,512,512.00,0.00,27694,27695
37698,1,512,512,512.00,0.00,27694,27695
37699,1,512,512,512.00,0.00,27694,27695
37700,4,221,1,128.00,7539.50,27694,27698
37701,3,279,40,170.67,9769.56,27697,27700
37702,4,376,1,128.00,21904.50,27699,27703
37703,1,512,512,512.00,0.00,27702,27703
37704,1,512,512,512.00,0.00,27702,27703
37705,1,512,512,512.00,0.00,27702,27703
37706,1,512,512,512.00,0.00,27702,27703
37707,2,415,97,256.00,25281.00,27702,27704
37708,1,512,512,512.00,0.00,27703,27704
37709,1,512,512,512.00,0.00,27703,27704
37710,1,512,512,512.00,0.00,27703,27704
37711,1,512,512,512.00,0.00,27703,27704
37712,1,512,512,512.00,0.00,27703,27704
37713,3,506,2,170.67,56224.89,27703,27706
37714,2,421,91,256.00,27225.00,27705,27707
37715,2,285,227,256.00,841.00,27706,27708
37716,2,365,147,256.00,11881.00,27707,27709
37717,3,427,5,170.67,33790.89,27708,27711
37718,3,380,47,170.67,22150.89,27710,27713
37719,1,512,512,512.00,0.00,27712,27713
37720,1,512,512,512.00,0.00,27712,27713
37721,4,211,35,128.00,3915.00,27712,27716
37722,1,512,512,512.00,0.00,27715,27716
37723,3,364,65,170.67,18742.89,27715,27718
37724,1,512,512,512.00,0.00,27717,27718
37725,1,512,512,512.00,0.00,27717,27718
37726,1,512,512,512.00,0.00,27717,27718
37727,2,458,54,256.00,40804.00,27717,27719
37728,3,250,68,170.67,5792.89,27718,27721
37729,4,357,11,128.00,18550.50,27720,27724
37730,2,507,5,256.00,63001.00,27723,27725
37731,1,512,512,512.00,0.00,27724,27725
37732,2,420,92,256.00,26896.00,27724,27726
37733,1,512,512,512.00,0.00,27725,27726
37734,3,395,40,170.67,25390.89,27725,27728
37735,1,512,512,512.00,0.00,27727,27728
37736,1,512,512,512.00,0.00,27727,27728
37737,1,512,512,512.00,0.00,27727,27728
37738,2,304,208,256.00,2304.00,27727,27729
37739,3,498,7,170.67,53573.56,27728,27731
37740,6,250,1,85.33,13233.89,27730,27736
37741,4,347,8,128.00,18895.50,27735,27739
37742,2,394,118,256.00,19044.00,27738,27740
37743,2,494,18,256.00,56644.00,27739,27741
37744,2,507,5,256.00,63001.00,27740,27742
37745,1,512,512,512.00,0.00,27741,27742
37746,2,433,79,256.00,31329.00,27741,27743
37747,1,512,512,512.00,0.00,27742,27743
37748,2,496,16,256.00,57600.00,27742,27744
37749,1,512,512,512.00,0.00,27743,27744
37750,1,512,512,512.00,0.00,27743,27744
37751,1,512,512,512.00,0.00,27743,27744
37752,5,188,12,102.40,5263.04,27743,27748
37753,2,366,146,256.00,12100.00,27747,27749
37754,1,512,512,512.00,0.00,27748,27749
37755,1,512,512,512.00,0.00,27748,27749
37756,2,463,49,256.00,42849.00,27748,27750
37757,2,412,100,256.00,24336.00,27749,27751
37758,1,512,512,512.00,0.00,27750,27751
37759,4,282,6,128.00,12090.00,27750,27754
37760,1,512,512,512.00,0.00,27753,27754
37761,1,512,512,512.00,0.00,27753,27754
37762,2,469,43,256.00,45369.00,27753,27755
37763,2,465,47,256.00,43681.00,27754,27756
37764,3,301,70,170.67,9333.56,27755,27758
37765,4,350,4,128.00,19047.50,27757,27761
37766,3,331,13,170.67,16857.56,27760,27763
37767,3,264,82,170.67,5531.56,27762,27765
37768,2,291,221,256.00,1225.00,27764,27766
37769,1,512,512,512.00,0.00,27765,27766
37770,2,466,46,256.00,44100.00,27765,27767
37771,1,512,512,512.00,0.00,27766,27767
37772,5,327,1,102.40,16637.44,27766,27771
37773,6,186,3,85.33,5788.56,27770,27776
37774,1,512,512,512.00,0.00,27775,27776
37775,1,512,512,512.00,0.00,27775,27776
37776,2,491,21,256.00,55225.00,27775,27777
37777,2,379,133,256.00,15129.00,27776,27778
37778,1,512,512,512.00,0.00,27777,27778
37779,2,501,11,256.00,60025.00,27777,27779
37780,1,512,512,512.00,0.00,27778,27779
37781,1,512,512,512.00,0.00,27778,27779
37782,1,512,512,512.00,0.00,27778,27779
37783,1,512,512,512.00,0.00,27778,27779
37784,2,334,178,256.00,6084.00,27778,27780
37785,1,512,512,512.00,0.00,27779,27780
37786,2,269,243,256.00,169.00,27779,27781
37787,1,512,512,512.00,0.00,27780,27781
37788,2,280,232,256.00,576.00,27780,27782
37789,1,512,512,512.00,0.00,27781,27782
37790,2,260,252,256.00,16.00,27781,27783
37791,1,512,512,512.00,0.00,27782,27783
37792,2,339,173,256.00,6889.00,27782,27784
37793,1,512,512,512.00,0.00,27783,27784
37794,2,494,18,256.00,56644.00,27783,27785
37795,3,280,60,170.67,8067.56,27784,27787
37796,1,512,512,512.00,0.00,27786,27787
37797,2,258,254,256.00,4.00,27786,27788
37798,2,280,232,256.00,576.00,27787,27789
37799,1,512,512,512.00,0.00,27788,27789
37800,1,512,512,512.00,0.00,27788,27789
37801,5,343,2,102.40,17045.04,27788,27793
37802,2,390,122,256.00,17956.00,27792,27794
37803,2,436,76,256.00,32400.00,27793,27795
37804,3,303,74,170.67,9376.22,27794,27797
37805,1,512,512,512.00,0.00,27796,27797
37806,2,461,51,256.00,42025.00,27796,27798
37807,1,512,512,512.00,0.00,27797,27798
37808,7,222,1,73.14,5988.98,27797,27804
37809,5,319,6,102.40,14312.64,27803,27808
37810,1,512,512,512.00,0.00,27807,27808
37811,4,418,8,128.00,28365.50,27807,27811
37812,1,512,512,512.00,0.00,27810,27811
37813,3,274,24,170.67,11355.56,27810,27813
37814,1,512,512,512.00,0.00,27812,27813
37815,3,242,93,170.67,3720.22,27812,27815
37816,1,512,512,512.00,0.00,27814,27815
37817,7,194,20,73.14,4179.27,27814,27821
37818,1,512,512,512.00,0.00,27820,27821
37819,3,371,2,170.67,23194.89,27820,27823
37820,1,512,512,512.00,0.00,27822,27823
37821,2,303,209,256.00,2209.00,27822,27824
37822,2,314,198,256.00,3364.00,27823,27825
37823,2,442,70,256.00,34596.00,27824,27826
37824,2,351,161,256.00,9025.00,27825,27827
37825,1,512,512,512.00,0.00,27826,27827
37826,1,512,512,512.00,0.00,27826,27827
37827,2,309,203,256.00,2809.00,27826,27828
37828,1,512,512,512.00,0.00,27827,27828
37829,3,299,19,170.67,13338.89,27827,27830
37830,2,383,129,256.00,16129.00,27829,27831
37831,1,512,512,512.00,0.00,27830,27831
37832,1,512,512,512.00,0.00,27830,27831
37833,1,512,512,512.00,0.00,27830,27831
37834,1,512,512,512.00,0.00,27830,27831
37835,2,332,180,256.00,5776.00,27830,27832
37836,1,512,512,512.00,0.00,27831,27832
37837,1,512,512,512.00,0.00,27831,27832
37838,1,512,512,512.00,0.00,27831,27832
37839,1,512,512,512.00,0.00,27831,27832
37840,2,433,79,256.00,31329.00,27831,27833
37841,2,427,85,256.00,29241.00,27832,27834
37842,4,246,9,128.00,13924.50,27833,27837
37843,2,362,150,256.00,11236.00,27836,27838
37844,1,512,512,512.00,0.00,27837,27838
37845,1,512,512,512.00,0.00,27837,27838
37846,2,453,59,256.00,38809.00,27837,27839
37847,1,512,512,512.00,0.00,27838,27839
37848,2,426,86,256.00,28900.00,27838,27840
37849,2,331,181,256.00,5625.00,27839,27841
37850,4,269,3,128.00,12521.00,27840,27844
37851,3,322,5,170.67,16850.89,27843,27846
37852,1,512,512,512.00,0.00,27845,27846
37853,3,277,1,170.67,14701.56,27845,27848
37854,8,273,1,64.00,9752.25,27847,27855
37855,1,512,512,512.00,0.00,27854,27855
37856,1,512,512,512.00,0.00,27854,27855
37857,1,512,512,512.00,0.00,27854,27855
37858,4,285,1,128.00,15509.00,27854,27858
37859,1,512,512,512.00,0.00,27857,27858
37860,1,512,512,512.00,0.00,27857,27858
37861,3,327,26,170.67,15168.22,27857,27860
37862,4,468,1,128.00,38658.50,27859,27863
37863,1,512,512,512.00,0.00,27862,27863
37864,5,472,1,102.40,34345.44,27862,27867
37865,2,423,89,256.00,27889.00,27866,27868
37866,1,512,512,512.00,0.00,27867,27868
37867,1,512,512,512.00,0.00,27867,27868
37868,4,303,20,128.00,11799.50,27867,27871
37869,2,276,236,256.00,400.00,27870,27872
37870,5,293,34,102.40,9495.44,27871,27876
37871,3,387,42,170.67,23680.22,27875,27878
37872,4,377,38,128.00,20700.50,27877,27881
37873,1,512,512,512.00,0.00,27880,27881
37874,1,512,512,512.00,0.00,27880,27881
37875,2,483,29,256.00,51529.00,27880,27882
37876,1,512,512,512.00,0.00,27881,27882
37877,4,271,3,128.00,9157.00,27881,27885
37878,1,512,512,512.00,0.00,27884,27885
37879,1,512,512,512.00,0.00,27884,27885
37880,3,292,91,170.67,7601.56,27884,27887
37881,2,300,212,256.00,1936.00,27886,27888
37882,1,512,512,512.00,0.00,27887,27888
37883,1,512,512,512.00,0.00,27887,27888
37884,4,310,9,128.00,16058.50,27887,27891
37885,1,512,512,512.00,0.00,27890,27891
37886,1,512,512,512.00,0.00,27890,27891
37887,1,512,512,512.00,0.00,27890,27891
37888,4,327,7,128.00,16841.50,27890,27894
37889,1,512,512,512.00,0.00,27893,27894
37890,2,409,103,256.00,23409.00,27893,27895
37891,1,512,512,512.00,0.00,27894,27895
37892,1,512,512,512.00,0.00,27894,27895
37893,1,512,512,512.00,0.00,27894,27895
37894,1,512,512,512.00,0.00,27894,27895
37895,3,265,33,170.67,9909.56,27894,27897
37896,2,424,88,256.00,28224.00,27896,27898
37897,3,443,7,170.67,37586.89,27897,27900
37898,1,512,512,512.00,0.00,27899,27900
37899,10,212,1,51.20,3910.96,27899,27909
37900,2,294,218,256.00,1444.00,27908,27910
37901,1,512,512,512.00,0.00,27909,27910
37902,3,299,56,170.67,9934.89,27909,27912
37903,4,183,8,128.00,4884.50,27911,27915
37904,3,249,90,170.67,4216.22,27914,27917
37905,3,411,1,170.67,30513.56,27916,27919
37906,6,168,6,85.33,4499.22,27918,27924
37907,2,352,160,256.00,9216.00,27923,27925
37908,1,512,512,512.00,0.00,27924,27925
37909,1,512,512,512.00,0.00,27924,27925
37910,1,512,512,512.00,0.00,27924,27925
37911,5,322,14,102.40,13970.24,27924,27929
37912,1,512,512,512.00,0.00,27928,27929
37913,1,512,512,512.00,0.00,27928,27929
37914,1,512,512,512.00,0.00,27928,27929
37915,2,427,85,256.00,29241.00,27928,27930
37916,1,512,512,512.00,0.00,27929,27930
37917,1,512,512,512.00,0.00,27929,27930
37918,1,512,512,512.00,0.00,27929,27930
37919,1,512,512,512.00,0.00,27929,27930
37920,2,380,132,256.00,15376.00,27929,27931
37921,2,348,164,256.00,8464.00,27930,27932
37922,2,466,46,256.00,44100.00,27931,27933
37923,2,369,143,256.00,12769.00,27932,27934
37924,2,261,251,256.00,25.00,27933,27935
37925,2,468,44,256.00,44944.00,27934,27936
37926,1,512,512,512.00,0.00,27935,27936
37927,1,512,512,512.00,0.00,27935,27936
37928,1,512,512,512.00,0.00,27935,27936
37929,1,512,512,512.00,0.00,27935,27936
37930,5,281,1,102.40,10667.84,27935,27940
37931,1,512,512,512.00,0.00,27939,27940
37932,2,265,247,256.00,81.00,27939,27941
37933,1,512,512,512.00,0.00,27940,27941
37934,1,512,512,512.00,0.00,27940,27941
37935,1,512,512,512.00,0.00,27940,27941
37936,2,367,145,256.00,12321.00,27940,27942
37937,1,512,512,512.00,0.00,27941,27942
37938,2,319,193,256.00,3969.00,27941,27943
37939,1,512,512,512.00,0.00,27942,27943
37940,1,512,512,512.00,0.00,27942,27943
37941,1,512,512,512.00,0.00,27942,27943
37942,2,273,239,256.00,289.00,27942,27944
37943,4,240,51,128.00,5852.50,27943,27947
37944,2,424,88,256.00,28224.00,27946,27948
37945,2,263,249,256.00,49.00,27947,27949
37946,3,395,36,170.67,25500.22,27948,27951
37947,1,512,512,512.00,0.00,27950,27951
37948,5,240,32,102.40,5809.04,27950,27955
37949,1,512,512,512.00,0.00,27954,27955
37950,1,512,512,512.00,0.00,27954,27955
37951,1,512,512,512.00,0.00,27954,27955
37952,1,512,512,512.00,0.00,27954,27955
37953,2,506,6,256.00,62500.00,27954,27956
37954,1,512,512,512.00,0.00,27955,27956
37955,1,512,512,512.00,0.00,27955,27956
37956,1,512,512,512.00,0.00,27955,27956
37957,1,512,512,512.00,0.00,27955,27956
37958,1,512,512,512.00,0.00,27955,27956
37959,4,473,3,128.00,39762.50,27955,27959
37960,1,512,512,512.00,0.00,27958,27959
37961,1,512,512,512.00,0.00,27958,27959
37962,1,512,512,512.00,0.00,27958,27959
37963,1,512,512,512.00,0.00,27958,27959
37964,1,512,512,512.00,0.00,27958,27959
37965,3,441,5,170.67,37160.22,27958,27961
37966,1,512,512,512.00,0.00,27960,27961
37967,2,284,228,256.00,784.00,27960,27962
37968,3,182,153,170.67,160.22,27961,27964
37969,3,462,12,170.67,42550.22,27963,27966
37970,1,512,512,512.00,0.00,27965,27966
37971,1,512,512,512.00,0.00,27965,27966
37972,1,512,512,512.00,0.00,27965,27966
37973,6,177,7,85.33,5139.56,27965,27971
37974,1,512,512,512.00,0.00,27970,27971
37975,1,512,512,512.00,0.00,27970,27971
37976,1,512,512,512.00,0.00,27970,27971
37977,1,512,512,512.00,0.00,27970,27971
37978,5,332,1,102.40,14418.64,27970,27975
37979,1,512,512,512.00,0.00,27974,27975
37980,5,215,12,102.40,5432.24,27974,27979
37981,2,458,54,256.00,40804.00,27978,27980
37982,3,209,107,170.67,2054.89,27979,27982
37983,11,141,1,46.55,1977.16,27981,27992
37984,1,512,512,512.00,0.00,27991,27992
37985,1,512,512,512.00,0.00,27991,27992
37986,1,512,512,512.00,0.00,27991,27992
37987,2,430,82,256.00,30276.00,27991,27993
37988,2,321,191,256.00,4225.00,27992,27994
37989,1,512,512,512.00,0.00,27993,27994
37990,2,496,16,256.00,57600.00,27993,27995
37991,3,213,91,170.67,3177.56,27994,27997
37992,7,141,27,73.14,1690.69,27996,28003
37993,4,204,32,128.00,3816.00,28002,28006
37994,1,512,512,512.00,0.00,28005,28006
37995,1,512,512,512.00,0.00,28005,28006
37996,2,482,30,256.00,51076.00,28005,28007
37997,1,512,512,512.00,0.00,28006,28007
37998,9,343,1,56.89,11320.77,28006,28015
37999,7,212,2,73.14,7506.98,28014,28021
38000,1,512,512,512.00,0.00,28020,28021
38001,1,512,512,512.00,0.00,28020,28021
38002,1,512,512,512.00,0.00,28020,28021
38003,3,310,1,170.67,16373.56,28020,28023
38004,1,512,512,512.00,0.00,28022,28023
38005,1,512,512,512.00,0.00,28022,28023
38006,1,512,512,512.00,0.00,28022,28023
38007,2,259,253,256.00,9.00,28022,28024
38008,2,474,38,256.00,47524.00,28023,28025
38009,2,466,46,256.00,44100.00,28024,28026
38010,1,512,512,512.00,0.00,28025,28026
38011,5,357,6,102.40,17221.04,28025,28030
38012,2,297,215,256.00,1681.00,28029,28031
38013,1,512,512,512.00,0.00,28030,28031
38014,1,512,512,512.00,0.00,28030,28031
38015,1,512,512,512.00,0.00,28030,28031
38016,3,417,26,170.67,30648.22,28030,28033
38017,3,238,94,170.67,3499.56,28032,28035
38018,1,512,512,512.00,0.00,28034,28035
38019,1,512,512,512.00,0.00,28034,28035
38020,1,512,512,512.00,0.00,28034,28035
38021,2,296,216,256.00,1600.00,28034,28036
38022,1,512,512,512.00,0.00,28035,28036
38023,3,341,12,170.67,18108.22,28035,28038
38024,1,512,512,512.00,0.00,28037,28038
38025,5,296,3,102.40,12894.64,28037,28042
38026,6,233,2,85.33,5914.89,28041,28047
38027,2,414,98,256.00,24964.00,28046,28048
38028,7,160,3,73.14,3361.55,28047,28054
38029,5,345,1,102.40,16238.24,28053,28058
38030,3,297,87,170.67,8260.22,28057,28060
38031,2,495,17,256.00,57121.00,28059,28061
38032,1,512,512,512.00,0.00,28060,28061
38033,3,425,29,170.67,32482.89,28060,28063
38034,2,298,214,256.00,1764.00,28062,28064
38035,1,512,512,512.00,0.00,28063,28064
38036,1,512,512,512.00,0.00,28063,28064
38037,3,364,5,170.67,21862.89,28063,28066
38038,1,512,512,512.00,0.00,28065,28066
38039,1,512,512,512.00,0.00,28065,28066
38040,1,512,512,512.00,0.00,28065,28066
38041,2,272,240,256.00,256.00,28065,28067
38042,1,512,512,512.00,0.00,28066,28067
38043,2,455,57,256.00,39601.00,28066,28068
38044,3,247,60,170.67,6417.56,28067,28070
38045,1,512,512,512.00,0.00,28069,28070
38046,1,512,512,512.00,0.00,28069,28070
38047,2,436,76,256.00,32400.00,28069,28071
38048,3,345,35,170.67,16764.22,28070,28073
38049,1,512,512,512.00,0.00,28072,28073
38050,3,279,27,170.67,11208.22,28072,28075
38051,5,406,4,102.40,23510.64,28074,28079
38052,1,512,512,512.00,0.00,28078,28079
38053,3,490,8,170.67,50992.89,28078,28081
38054,1,512,512,512.00,0.00,28080,28081
38055,1,512,512,512.00,0.00,28080,28081
38056,6,247,7,85.33,6404.56,28080,28086
38057,5,244,8,102.40,7844.24,28085,28090
38058,1,512,512,512.00,0.00,28089,28090
38059,1,512,512,512.00,0.00,28089,28090
38060,3,285,101,170.67,6640.22,28089,28092
38061,1,512,512,512.00,0.00,28091,28092
38062,1,512,512,512.00,0.00,28091,28092
38063,1,512,512,512.00,0.00,28091,28092
38064,2,310,202,256.00,2916.00,28091,28093
38065,1,512,512,512.00,0.00,28092,28093
38066,1,512,512,512.00,0.00,28092,28093
38067,1,512,512,512.00,0.00,28092,28093
38068,1,512,512,512.00,0.00,28092,28093
38069,2,413,99,256.00,24649.00,28092,28094
38070,3,392,10,170.67,26160.89,28093,28096
38071,1,512,512,512.00,0.00,28095,28096
38072,1,512,512,512.00,0.00,28095,28096
38073,2,397,115,256.00,19881.00,28095,28097
38074,2,479,33,256.00,49729.00,28096,28098
38075,3,189,138,170.67,536.22,28097,28100
38076,6,225,7,85.33,5516.89,28099,28105
38077,1,512,512,512.00,0.00,28104,28105
38078,1,512,512,512.00,0.00,28104,28105
38079,1,512,512,512.00,0.00,28104,28105
38080,2,413,99,256.00,24649.00,28104,28106
38081,1,512,512,512.00,0.00,28105,28106
38082,5,276,8,102.40,12842.24,28105,28110
38083,3,414,14,170.67,30422.22,28109,28112
38084,5,204,2,102.40,6351.44,28111,28116
38085,3,352,55,170.67,16857.56,28115,28118
38086,1,512,512,512.00,0.00,28117,28118
38087,4,278,8,128.00,9378.00,28117,28121
38088,2,339,173,256.00,6889.00,28120,28122
38089,2,422,90,256.00,27556.00,28121,28123
38090,3,235,83,170.67,4122.89,28122,28125
38091,3,255,119,170.67,3616.22,28124,28127
38092,1,512,512,512.00,0.00,28126,28127
38093,2,416,96,256.00,25600.00,28126,28128
38094,3,322,53,170.67,12626.89,28127,28130
38095,1,512,512,512.00,0.00,28129,28130
38096,3,465,9,170.67,43456.22,28129,28132
38097,1,512,512,512.00,0.00,28131,28132
38098,1,512,512,512.00,0.00,28131,28132
38099,2,422,90,256.00,27556.00,28131,28133
38100,1,512,512,512.00,0.00,28132,28133
38101,1,512,512,512.00,0.00,28132,28133
38102,1,512,512,512.00,0.00,28132,28133
38103,1,512,512,512.00,0.00,28132,28133
38104,2,461,51,256.00,42025.00,28132,28134
38105,1,512,512,512.00,0.00,28133,28134
38106,1,512,512,512.00,0.00,28133,28134
38107,2,459,53,256.00,41209.00,28133,28135
38108,2,391,121,256.00,18225.00,28134,28136
38109,1,512,512,512.00,0.00,28135,28136
38110,2,370,142,256.00,12996.00,28135,28137
38111,1,512,512,512.00,0.00,28136,28137
38112,1,512,512,512.00,0.00,28136,28137
38113,3,372,34,170.67,21131.56,28136,28139
38114,1,512,512,512.00,0.00,28138,28139
38115,1,512,512,512.00,0.00,28138,28139
38116,5,267,19,102.40,8072.24,28138,28143
38117,2,259,253,256.00,9.00,28142,28144
38118,1,512,512,512.00,0.00,28143,28144
38119,2,389,123,256.00,17689.00,28143,28145
38120,4,227,4,128.00,8325.50,28144,28148
38121,4,467,2,128.00,38371.50,28147,28151
38122,1,512,512,512.00,0.00,28150,28151
38123,1,512,512,512.00,0.00,28150,28151
38124,1,512,512,512.00,0.00,28150,28151
38125,2,351,161,256.00,9025.00,28150,28152
38126,1,512,512,512.00,0.00,28151,28152
38127,3,358,2,170.67,21296.89,28151,28154
38128,1,512,512,512.00,0.00,28153,28154
38129,1,512,512,512.00,0.00,28153,28154
38130,3,374,1,170.67,23754.89,28153,28156
38131,1,512,512,512.00,0.00,28155,28156
38132,2,343,169,256.00,7569.00,28155,28157
38133,1,512,512,512.00,0.00,28156,28157
38134,2,463,49,256.00,42849.00,28156,28158
38135,5,340,2,102.40,15929.84,28157,28162
38136,5,303,2,102.40,12303.44,28161,28166
38137,1,512,512,512.00,0.00,28165,28166
38138,2,340,172,256.00,7056.00,28165,28167
38139,2,339,173,256.00,6889.00,28166,28168
38140,3,291,110,170.67,7240.22,28167,28170
38141,4,317,8,128.00,16446.50,28169,28173
38142,1,512,512,512.00,0.00,28172,28173
38143,1,512,512,512.00,0.00,28172,28173
38144,1,512,512,512.00,0.00,28172,28173
38145,3,301,17,170.67,13714.89,28172,28175
38146,8,269,2,64.00,7051.75,28174,28182
38147,2,310,202,256.00,2916.00,28181,28183
38148,2,272,240,256.00,256.00,28182,28184
38149,5,365,4,102.40,17604.24,28183,28188
38150,1,512,512,512.00,0.00,28187,28188
38151,1,512,512,512.00,0.00,28187,28188
38152,2,343,169,256.00,7569.00,28187,28189
38153,9,212,1,56.89,5580.54,28188,28197
38154,1,512,512,512.00,0.00,28196,28197
38155,1,512,512,512.00,0.00,28196,28197
38156,2,364,148,256.00,11664.00,28196,28198
38157,2,387,125,256.00,17161.00,28197,28199
38158,7,184,4,73.14,4592.98,28198,28205
38159,4,260,3,128.00,8733.50,28204,28208
38160,5,240,20,102.40,7345.04,28207,28212
38161,1,512,512,512.00,0.00,28211,28212
38162,1,512,512,512.00,0.00,28211,28212
38163,1,512,512,512.00,0.00,28211,28212
38164,1,512,512,512.00,0.00,28211,28212
38165,4,243,7,128.00,10755.50,28211,28215
38166,2,396,116,256.00,19600.00,28214,28216
38167,1,512,512,512.00,0.00,28215,28216
38168,1,512,512,512.00,0.00,28215,28216
38169,1,512,512,512.00,0.00,28215,28216
38170,3,490,4,170.67,51019.56,28215,28218
38171,2,356,156,256.00,10000.00,28217,28219
38172,3,259,92,170.67,4694.89,28218,28221
38173,7,299,1,73.14,9518.69,28220,28227
38174,1,512,512,512.00,0.00,28226,28227
38175,2,438,74,256.00,33124.00,28226,28228
38176,5,151,53,102.40,1737.04,28227,28232
38177,3,274,31,170.67,10501.56,28231,28234
38178,3,281,83,170.67,6790.89,28233,28236
38179,7,222,2,73.14,5767.84,28235,28242
38180,1,512,512,512.00,0.00,28241,28242
38181,1,512,512,512.00,0.00,28241,28242
38182,1,512,512,512.00,0.00,28241,28242
38183,1,512,512,512.00,0.00,28241,28242
38184,9,282,7,56.89,7326.99,28241,28250
38185,2,455,57,256.00,39601.00,28249,28251
38186,1,512,512,512.00,0.00,28250,28251
38187,4,228,7,128.00,8295.50,28250,28254
38188,2,336,176,256.00,6400.00,28253,28255
38189,1,512,512,512.00,0.00,28254,28255
38190,3,310,38,170.67,12352.89,28254,28257
38191,1,512,512,512.00,0.00,28256,28257
38192,5,185,20,102.40,4024.24,28256,28261
38193,5,265,7,102.40,7553.44,28260,28265
38194,3,321,14,170.67,15728.22,28264,28267
38195,1,512,512,512.00,0.00,28266,28267
38196,2,446,66,256.00,36100.00,28266,28268
38197,1,512,512,512.00,0.00,28267,28268
38198,3,480,4,170.67,47939.56,28267,28270
38199,2,427,85,256.00,29241.00,28269,28271
38200,3,204,143,170.67,636.22,28270,28273
38201,1,512,512,512.00,0.00,28272,28273
38202,1,512,512,512.00,0.00,28272,28273
38203,7,173,11,73.14,3833.55,28272,28279
38204,1,512,512,512.00,0.00,28278,28279
38205,1,512,512,512.00,0.00,28278,28279
38206,1,512,512,512.00,0.00,28278,28279
38207,1,512,512,512.00,0.00,28278,28279
38208,6,234,1,85.33,9183.22,28278,28284
38209,1,512,512,512.00,0.00,28283,28284
38210,1,512,512,512.00,0.00,28283,28284
38211,1,512,512,512.00,0.00,28283,28284
38212,2,472,40,256.00,46656.00,28283,28285
38213,1,512,512,512.00,0.00,28284,28285
38214,1,512,512,512.00,0.00,28284,28285
38215,1,512,512,512.00,0.00,28284,28285
38216,2,359,153,256.00,10609.00,28284,28286
38217,3,286,56,170.67,8816.89,28285,28288
38218,2,304,208,256.00,2304.00,28287,28289
38219,1,512,512,512.00,0.00,28288,28289
38220,2,393,119,256.00,18769.00,28288,28290
38221,2,338,174,256.00,6724.00,28289,28291
38222,2,457,55,256.00,40401.00,28290,28292
38223,3,311,30,170.67,13160.22,28291,28294
38224,1,512,512,512.00,0.00,28293,28294
38225,1,512,512,512.00,0.00,28293,28294
38226,3,326,79,170.67,12194.89,28293,28296
38227,1,512,512,512.00,0.00,28295,28296
38228,1,512,512,512.00,0.00,28295,28296
38229,1,512,512,512.00,0.00,28295,28296
38230,2,336,176,256.00,6400.00,28295,28297
38231,1,512,512,512.00,0.00,28296,28297
38232,3,362,39,170.67,19168.22,28296,28299
38233,2,365,147,256.00,11881.00,28298,28300
38234,4,359,32,128.00,18013.50,28299,28303
38235,4,393,9,128.00,23941.50,28302,28306
38236,2,483,29,256.00,51529.00,28305,28307
38237,1,512,512,512.00,0.00,28306,28307
38238,5,212,7,102.40,7925.04,28306,28311
38239,1,512,512,512.00,0.00,28310,28311
38240,1,512,512,512.00,0.00,28310,28311
38241,2,452,60,256.00,38416.00,28310,28312
38242,1,512,512,512.00,0.00,28311,28312
38243,5,282,15,102.40,11115.44,28311,28316
38244,3,484,2,170.67,49184.89,28315,28318
38245,1,512,512,512.00,0.00,28317,28318
38246,1,512,512,512.00,0.00,28317,28318
38247,1,512,512,512.00,0.00,28317,28318
38248,3,313,17,170.67,14666.89,28317,28320
38249,1,512,512,512.00,0.00,28319,28320
38250,2,379,133,256.00,15129.00,28319,28321
38251,3,406,12,170.67,28811.56,28320,28323
38252,1,512,512,512.00,0.00,28322,28323
38253,1,512,512,512.00,0.00,28322,28323
38254,8,173,1,64.00,5015.50,28322,28330
38255,1,512,512,512.00,0.00,28329,28330
38256,5,298,28,102.40,10491.84,28329,28334
38257,5,230,22,102.40,8417.84,28333,28338
38258,5,226,4,102.40,7459.84,28337,28342
38259,1,512,512,512.00,0.00,28341,28342
38260,1,512,512,512.00,0.00,28341,28342
38261,2,502,10,256.00,60516.00,28341,28343
38262,3,261,16,170.67,12073.56,28342,28345
38263,4,197,46,128.00,3063.50,28344,28348
38264,3,317,32,170.67,13566.89,28347,28350
38265,2,324,188,256.00,4624.00,28349,28351
38266,1,512,512,512.00,0.00,28350,28351
38267,3,378,38,170.67,22054.22,28350,28353
38268,3,259,114,170.67,4005.56,28352,28355
38269,2,454,58,256.00,39204.00,28354,28356
38270,1,512,512,512.00,0.00,28355,28356
38271,1,512,512,512.00,0.00,28355,28356
38272,1,512,512,512.00,0.00,28355,28356
38273,4,327,29,128.00,13800.50,28355,28359
38274,2,308,204,256.00,2704.00,28358,28360
38275,2,505,7,256.00,62001.00,28359,28361
38276,1,512,512,512.00,0.00,28360,28361
38277,2,352,160,256.00,9216.00,28360,28362
38278,2,290,222,256.00,1156.00,28361,28363
38279,1,512,512,512.00,0.00,28362,28363
38280,2,484,28,256.00,51984.00,28362,28364
38281,2,335,177,256.00,6241.00,28363,28365
38282,2,359,153,256.00,10609.00,28364,28366
38283,3,423,40,170.67,31849.56,28365,28368
38284,6,201,3,85.33,5472.22,28367,28373
38285,1,512,512,512.00,0.00,28372,28373
38286,2,325,187,256.00,4761.00,28372,28374
38287,2,497,15,256.00,58081.00,28373,28375
38288,3,505,1,170.67,55893.56,28374,28377
38289,1,512,512,512.00,0.00,28376,28377
38290,6,222,3,85.33,7742.89,28376,28382
38291,1,512,512,512.00,0.00,28381,28382
38292,1,512,512,512.00,0.00,28381,28382
38293,1,512,512,512.00,0.00,28381,28382
38294,2,357,155,256.00,10201.00,28381,28383
38295,1,512,512,512.00,0.00,28382,28383
38296,2,420,92,256.00,26896.00,28382,28384
38297,1,512,512,512.00,0.00,28383,28384
38298,2,499,13,256.00,59049.00,28383,28385
38299,4,435,3,128.00,31771.00,28384,28388
38300,1,512,512,512.00,0.00,28387,28388
38301,6,215,3,85.33,6084.22,28387,28393
38302,1,512,512,512.00,0.00,28392,28393
38303,1,512,512,512.00,0.00,28392,28393
38304,1,512,512,512.00,0.00,28392,28393
38305,1,512,512,512.00,0.00,28392,28393
38306,1,512,512,512.00,0.00,28392,28393
38307,1,512,512,512.00,0.00,28392,28393
38308,1,512,512,512.00,0.00,28392,28393
38309,3,267,51,170.67,8048.22,28392,28395
38310,1,512,512,512.00,0.00,28394,28395
38311,4,262,29,128.00,8803.50,28394,28398
38312,1,512,512,512.00,0.00,28397,28398
38313,2,379,133,256.00,15129.00,28397,28399
38314,2,439,73,256.00,33489.00,28398,28400
38315,2,258,254,256.00,4.00,28399,28401
38316,5,250,2,102.40,8608.64,28400,28405
38317,7,242,1,73.14,6114.98,28404,28411
38318,3,370,29,170.67,21042.89,28410,28413
38319,3,500,3,170.67,54236.22,28412,28415
38320,2,502,10,256.00,60516.00,28414,28416
38321,4,279,32,128.00,9978.50,28415,28419
38322,1,512,512,512.00,0.00,28418,28419
38323,3,385,22,170.67,24117.56,28418,28421
38324,1,512,512,512.00,0.00,28420,28421
38325,1,512,512,512.00,0.00,28420,28421
38326,6,183,6,85.33,5054.89,28420,28426
38327,3,450,5,170.67,39464.22,28425,28428
38328,11,219,1,46.55,4474.79,28427,28438
38329,3,372,6,170.67,22998.22,28437,28440
38330,3,469,7,170.67,44641.56,28439,28442
38331,1,512,512,512.00,0.00,28441,28442
38332,1,512,512,512.00,0.00,28441,28442
38333,1,512,512,512.00,0.00,28441,28442
38334,3,448,7,170.67,38873.56,28441,28444
38335,2,289,223,256.00,1089.00,28443,28445
38336,1,512,512,512.00,0.00,28444,28445
38337,1,512,512,512.00,0.00,28444,28445
38338,2,449,63,256.00,37249.00,28444,28446
38339,2,319,193,256.00,3969.00,28445,28447
38340,1,512,512,512.00,0.00,28446,28447
38341,1,512,512,512.00,0.00,28446,28447
38342,1,512,512,512.00,0.00,28446,28447
38343,2,456,56,256.00,40000.00,28446,28448
38344,1,512,512,512.00,0.00,28447,28448
38345,1,512,512,512.00,0.00,28447,28448
38346,2,271,241,256.00,225.00,28447,28449
38347,1,512,512,512.00,0.00,28448,28449
38348,2,263,249,256.00,49.00,28448,28450
38349,1,512,512,512.00,0.00,28449,28450
38350,1,512,512,512.00,0.00,28449,28450
38351,2,271,241,256.00,225.00,28449,28451
38352,2,298,214,256.00,1764.00,28450,28452
38353,3,469,1,170.67,44781.56,28451,28454
38354,2,476,36,256.00,48400.00,28453,28455
38355,7,291,3,73.14,8702.98,28454,28461
38356,2,369,143,256.00,12769.00,28460,28462
38357,2,269,243,256.00,169.00,28461,28463
38358,1,512,512,512.00,0.00,28462,28463
38359,2,257,255,256.00,1.00,28462,28464
38360,3,252,97,170.67,4033.56,28463,28466
38361,3,377,21,170.67,22728.22,28465,28468
38362,2,390,122,256.00,17956.00,28467,28469
38363,1,512,512,512.00,0.00,28468,28469
38364,2,467,45,256.00,44521.00,28468,28470
38365,5,216,40,102.40,3884.24,28469,28474
38366,4,234,14,128.00,9108.00,28473,28477
38367,1,512,512,512.00,0.00,28476,28477
38368,3,348,29,170.67,17596.22,28476,28479
38369,1,512,512,512.00,0.00,28478,28479
38370,1,512,512,512.00,0.00,28478,28479
38371,1,512,512,512.00,0.00,28478,28479
38372,2,463,49,256.00,42849.00,28478,28480
38373,6,209,2,85.33,7069.22,28479,28485
38374,2,356,156,256.00,10000.00,28484,28486
38375,1,512,512,512.00,0.00,28485,28486
38376,1,512,512,512.00,0.00,28485,28486
38377,4,185,57,128.00,2259.00,28485,28489
38378,1,512,512,512.00,0.00,28488,28489
38379,4,360,1,128.00,19272.50,28488,28492
38380,2,265,247,256.00,81.00,28491,28493
38381,4,329,1,128.00,18689.00,28492,28496
38382,2,340,172,256.00,7056.00,28495,28497
38383,3,345,9,170.67,18896.22,28496,28499
38384,3,323,46,170.67,13170.89,28498,28501
38385,1,512,512,512.00,0.00,28500,28501
38386,1,512,512,512.00,0.00,28500,28501
38387,1,512,512,512.00,0.00,28500,28501
38388,13,145,3,39.38,1439.78,28500,28513
38389,2,313,199,256.00,3249.00,28512,28514
38390,1,512,512,512.00,0.00,28513,28514
38391,4,436,1,128.00,31858.50,28513,28517
38392,1,512,512,512.00,0.00,28516,28517
38393,1,512,512,512.00,0.00,28516,28517
38394,6,296,10,85.33,9539.56,28516,28522
38395,4,281,6,128.00,10323.50,28521,28525
38396,2,341,171,256.00,7225.00,28524,28526
38397,4,462,4,128.00,37253.50,28525,28529
38398,2,398,114,256.00,20164.00,28528,28530
38399,1,512,512,512.00,0.00,28529,28530
38400,1,512,512,512.00,0.00,28529,28530
38401,1,512,512,512.00,0.00,28529,28530
38402,7,224,6,73.14,5134.98,28529,28536
38403,1,512,512,512.00,0.00,28535,28536
38404,3,482,5,170.67,48530.89,28535,28538
38405,2,472,40,256.00,46656.00,28537,28539
38406,4,248,5,128.00,13378.50,28538,28542
38407,2,465,47,256.00,43681.00,28541,28543
38408,1,512,512,512.00,0.00,28542,28543
38409,1,512,512,512.00,0.00,28542,28543
38410,1,512,512,512.00,0.00,28542,28543
38411,7,380,1,73.14,16045.84,28542,28549
38412,1,512,512,512.00,0.00,28548,28549
38413,1,512,512,512.00,0.00,28548,28549
38414,1,512,512,512.00,0.00,28548,28549
38415,1,512,512,512.00,0.00,28548,28549
38416,3,238,50,170.67,7312.89,28548,28551
38417,1,512,512,512.00,0.00,28550,28551
38418,1,512,512,512.00,0.00,28550,28551
38419,1,512,512,512.00,0.00,28550,28551
38420,1,512,512,512.00,0.00,28550,28551
38421,2,317,195,256.00,3721.00,28550,28552
38422,1,512,512,512.00,0.00,28551,28552
38423,1,512,512,512.00,0.00,28551,28552
38424,1,512,512,512.00,0.00,28551,28552
38425,2,284,228,256.00,784.00,28551,28553
38426,1,512,512,512.00,0.00,28552,28553
38427,1,512,512,512.00,0.00,28552,28553
38428,2,297,215,256.00,1681.00,28552,28554
38429,2,333,179,256.00,5929.00,28553,28555
38430,1,512,512,512.00,0.00,28554,28555
38431,1,512,512,512.00,0.00,28554,28555
38432,1,512,512,512.00,0.00,28554,28555
38433,7,299,6,73.14,9300.41,28554,28561
38434,3,386,33,170.67,23784.22,28560,28563
38435,1,512,512,512.00,0.00,28562,28563
38436,1,512,512,512.00,0.00,28562,28563
38437,1,512,512,512.00,0.00,28562,28563
38438,2,445,67,256.00,35721.00,28562,28564
38439,1,512,512,512.00,0.00,28563,28564
38440,1,512,512,512.00,0.00,28563,28564
38441,1,512,512,512.00,0.00,28563,28564
38442,5,374,2,102.40,18909.44,28563,28568
38443,2,302,210,256.00,2116.00,28567,28569
38444,2,402,110,256.00,21316.00,28568,28570
38445,1,512,512,512.00,0.00,28569,28570
38446,1,512,512,512.00,0.00,28569,28570
38447,4,357,4,128.00,18368.50,28569,28573
38448,1,512,512,512.00,0.00,28572,28573
38449,1,512,512,512.00,0.00,28572,28573
38450,1,512,512,512.00,0.00,28572,28573
38451,1,512,512,512.00,0.00,28572,28573
38452,2,325,187,256.00,4761.00,28572,28574
38453,7,163,12,73.14,2924.69,28573,28580
38454,3,461,4,170.67,42454.89,28579,28582
38455,1,512,512,512.00,0.00,28581,28582
38456,10,135,3,51.20,1845.16,28581,28591
38457,2,261,251,256.00,25.00,28590,28592
38458,2,508,4,256.00,63504.00,28591,28593
38459,2,510,2,256.00,64516.00,28592,28594
38460,1,512,512,512.00,0.00,28594,28595
38461,2,497,15,256.00,58081.00,28594,28596
38462,5,199,14,102.40,4706.64,28595,28600
38463,2,405,107,256.00,22201.00,28599,28601
38464,7,382,3,73.14,16295.84,28600,28607
38465,3,389,4,170.67,26038.89,28606,28609
38466,1,512,512,512.00,0.00,28608,28609
38467,4,292,1,128.00,15977.50,28608,28612
38468,1,512,512,512.00,0.00,28611,28612
38469,1,512,512,512.00,0.00,28611,28612
38470,1,512,512,512.00,0.00,28611,28612
38471,1,512,512,512.00,0.00,28611,28612
38472,1,512,512,512.00,0.00,28611,28612
38473,3,260,102,170.67,4374.22,28611,28614
38474,4,362,3,128.00,21358.50,28613,28617
38475,1,512,512,512.00,0.00,28616,28617
38476,1,512,512,512.00,0.00,28616,28617
38477,4,343,1,128.00,19294.50,28616,28620
38478,1,512,512,512.00,0.00,28619,28620
38479,1,512,512,512.00,0.00,28619,28620
38480,1,512,512,512.00,0.00,28619,28620
38481,5,441,2,102.40,28918.64,28619,28624
38482,1,512,512,512.00,0.00,28623,28624
38483,10,161,1,51.20,3816.16,28623,28633
38484,4,353,1,128.00,18573.50,28632,28636
38485,3,410,1,170.67,30306.89,28635,28638
38486,4,280,6,128.00,12651.50,28637,28641
38487,3,314,1,170.67,16674.89,28640,28643
38488,1,512,512,512.00,0.00,28642,28643
38489,1,512,512,512.00,0.00,28642,28643
38490,1,512,512,512.00,0.00,28642,28643
38491,1,512,512,512.00,0.00,28642,28643
38492,2,475,37,256.00,47961.00,28642,28644
38493,1,512,512,512.00,0.00,28643,28644
38494,6,349,1,85.33,16407.22,28643,28649
38495,1,512,512,512.00,0.00,28648,28649
38496,1,512,512,512.00,0.00,28648,28649
38497,2,369,143,256.00,12769.00,28648,28650
38498,1,512,512,512.00,0.00,28649,28650
38499,2,465,47,256.00,43681.00,28649,28651
38500,4,347,2,128.00,19386.50,28650,28654
38501,1,512,512,512.00,0.00,28653,28654
38502,3,320,6,170.67,16550.22,28653,28656
38503,1,512,512,512.00,0.00,28655,28656
38504,1,512,512,512.00,0.00,28655,28656
38505,3,444,28,170.67,37379.56,28655,28658
38506,2,343,169,256.00,7569.00,28657,28659
38507,3,269,100,170.67,5142.89,28658,28661
38508,2,315,197,256.00,3481.00,28660,28662
38509,1,512,512,512.00,0.00,28661,28662
38510,1,512,512,512.00,0.00,28661,28662
38511,1,512,512,512.00,0.00,28661,28662
38512,1,512,512,512.00,0.00,28661,28662
38513,4,295,2,128.00,11187.50,28661,28665
38514,2,419,93,256.00,26569.00,28664,28666
38515,3,400,53,170.67,26302.89,28665,28668
38516,3,308,68,170.67,10200.89,28667,28670
38517,1,512,512,512.00,0.00,28669,28670
38518,3,374,36,170.67,21398.22,28669,28672
38519,1,512,512,512.00,0.00,28671,28672
38520,4,319,24,128.00,13550.50,28671,28675
38521,2,378,134,256.00,14884.00,28674,28676
38522,3,222,82,170.67,3963.56,28675,28678
38523,5,325,3,102.40,13655.84,28677,28682
38524,3,472,19,170.67,45401.56,28681,28684
38525,2,354,158,256.00,9604.00,28683,28685
38526,1,512,512,512.00,0.00,28684,28685
38527,1,512,512,512.00,0.00,28684,28685
38528,5,232,2,102.40,7474.64,28684,28689
38529,6,392,2,85.33,19350.22,28688,28694
38530,7,246,1,73.14,6712.98,28693,28700
38531,1,512,512,512.00,0.00,28699,28700
38532,1,512,512,512.00,0.00,28699,28700
38533,2,419,93,256.00,26569.00,28699,28701
38534,3,429,9,170.67,34072.22,28700,28703
38535,6,197,21,85.33,4082.22,28702,28708
38536,2,450,62,256.00,37636.00,28707,28709
38537,5,298,5,102.40,12083.84,28708,28713
38538,5,171,44,102.40,3210.64,28712,28717
38539,6,429,1,85.33,23966.89,28716,28722
38540,8,260,1,64.00,6653.50,28721,28729
38541,2,398,114,256.00,20164.00,28728,28730
38542,1,512,512,512.00,0.00,28729,28730
38543,1,512,512,512.00,0.00,28729,28730
38544,2,421,91,256.00,27225.00,28729,28731
38545,5,170,18,102.40,3298.24,28730,28735
38546,5,383,4,102.40,20614.64,28734,28739
38547,3,302,13,170.67,14266.89,28738,28741
38548,2,427,85,256.00,29241.00,28740,28742
38549,2,350,162,256.00,8836.00,28741,28743
38550,1,512,512,512.00,0.00,28742,28743
38551,1,512,512,512.00,0.00,28742,28743
38552,1,512,512,512.00,0.00,28742,28743
38553,1,512,512,512.00,0.00,28742,28743
38554,1,512,512,512.00,0.00,28742,28743
38555,1,512,512,512.00,0.00,28742,28743
38556,2,445,67,256.00,35721.00,28742,28744
38557,3,403,25,170.67,27569.56,28743,28746
38558,4,373,6,128.00,21794.50,28746,28750
38559,1,512,512,512.00,0.00,28749,28750
38560,2,284,228,256.00,784.00,28749,28751
38561,1,512,512,512.00,0.00,28750,28751
38562,6,180,12,85.33,3497.22,28750,28756
38563,1,512,512,512.00,0.00,28755,28756
38564,2,364,148,256.00,11664.00,28755,28757
38565,1,512,512,512.00,0.00,28756,28757
38566,4,262,20,128.00,10454.00,28756,28760
38567,6,157,14,85.33,2211.56,28759,28765
38568,1,512,512,512.00,0.00,28764,28765
38569,6,221,36,85.33,3966.89,28764,28770
38570,1,512,512,512.00,0.00,28769,28770
38571,1,512,512,512.00,0.00,28769,28770
38572,4,274,51,128.00,8267.50,28769,28773
38573,6,264,1,85.33,7720.22,28772,28778
38574,5,502,2,102.40,39920.64,28777,28782
38575,4,371,2,128.00,21927.50,28781,28785
38576,1,512,512,512.00,0.00,28784,28785
38577,3,287,44,170.67,9894.89,28784,28787
38578,4,406,6,128.00,26348.50,28786,28790
38579,5,235,2,102.40,7755.84,28789,28794
38580,1,512,512,512.00,0.00,28793,28794
38581,2,508,4,256.00,63504.00,28793,28795
38582,1,512,512,512.00,0.00,28794,28795
38583,1,512,512,512.00,0.00,28794,28795
38584,2,452,60,256.00,38416.00,28794,28796
38585,1,512,512,512.00,0.00,28795,28796
38586,1,512,512,512.00,0.00,28795,28796
38587,2,258,254,256.00,4.00,28795,28797
38588,4,226,23,128.00,9168.50,28796,28800
38589,1,512,512,512.00,0.00,28799,28800
38590,2,378,134,256.00,14884.00,28799,28801
38591,4,370,5,128.00,20199.50,28800,28804
38592,1,512,512,512.00,0.00,28803,28804
38593,1,512,512,512.00,0.00,28803,28804
38594,1,512,512,512.00,0.00,28803,28804
38595,3,379,11,170.67,23754.89,28803,28806
38596,1,512,512,512.00,0.00,28805,28806
38597,2,414,98,256.00,24964.00,28805,28807
38598,3,258,124,170.67,3819.56,28806,28809
38599,2,465,47,256.00,43681.00,28808,28810
38600,1,512,512,512.00,0.00,28809,28810
38601,3,435,30,170.67,34984.22,28809,28812
38602,2,359,153,256.00,10609.00,28811,28813
38603,1,512,512,512.00,0.00,28812,28813
38604,1,512,512,512.00,0.00,28812,28813
38605,1,512,512,512.00,0.00,28812,28813
38606,2,502,10,256.00,60516.00,28812,28814
38607,3,462,1,170.67,42821.56,28813,28816
38608,4,346,6,128.00,18494.50,28815,28819
38609,2,396,116,256.00,19600.00,28818,28820
38610,1,512,512,512.00,0.00,28819,28820
38611,1,512,512,512.00,0.00,28819,28820
38612,1,512,512,512.00,0.00,28819,28820
38613,2,394,118,256.00,19044.00,28819,28821
38614,1,512,512,512.00,0.00,28820,28821
38615,4,267,1,128.00,12752.50,28820,28824
38616,3,399,32,170.67,26468.22,28823,28826
38617,3,481,4,170.67,48241.56,28825,28828
38618,3,322,34,170.67,13931.56,28827,28830
38619,3,331,20,170.67,16166.89,28829,28832
38620,2,448,64,256.00,36864.00,28831,28833
38621,1,512,512,512.00,0.00,28832,28833
38622,1,512,512,512.00,0.00,28832,28833
38623,2,384,128,256.00,16384.00,28832,28834
38624,3,312,12,170.67,15150.22,28833,28836
38625,2,375,137,256.00,14161.00,28835,28837
38626,3,408,16,170.67,29027.56,28836,28839
38627,2,312,200,256.00,3136.00,28838,28840
38628,2,507,5,256.00,63001.00,28839,28841
38629,4,176,83,128.00,1336.50,28840,28844
38630,4,345,22,128.00,16862.50,28843,28847
38631,1,512,512,512.00,0.00,28846,28847
38632,1,512,512,512.00,0.00,28846,28847
38633,4,191,1,128.00,5778.50,28846,28850
38634,1,512,512,512.00,0.00,28849,28850
38635,7,272,2,73.14,11325.55,28849,28856
38636,1,512,512,512.00,0.00,28855,28856
38637,1,512,512,512.00,0.00,28855,28856
38638,2,428,84,256.00,29584.00,28855,28857
38639,1,512,512,512.00,0.00,28856,28857
38640,1,512,512,512.00,0.00,28856,28857
38641,3,321,48,170.67,12804.22,28856,28859
38642,1,512,512,512.00,0.00,28858,28859
38643,1,512,512,512.00,0.00,28858,28859
38644,2,418,94,256.00,26244.00,28858,28860
38645,9,314,2,56.89,9551.65,28859,28868
38646,2,330,182,256.00,5476.00,28867,28869
38647,1,512,512,512.00,0.00,28868,28869
38648,9,197,4,56.89,4677.65,28868,28877
38649,1,512,512,512.00,0.00,28876,28877
38650,1,512,512,512.00,0.00,28876,28877
38651,2,446,66,256.00,36100.00,28876,28878
38652,3,401,10,170.67,27906.89,28877,28880
38653,7,298,1,73.14,9642.12,28879,28886
38654,2,302,210,256.00,2116.00,28885,28887
38655,1,512,512,512.00,0.00,28886,28887
38656,1,512,512,512.00,0.00,28886,28887
38657,2,396,116,256.00,19600.00,28886,28888
38658,1,512,512,512.00,0.00,28887,28888
38659,1,512,512,512.00,0.00,28887,28888
38660,1,512,512,512.00,0.00,28887,28888
38661,6,242,1,85.33,11016.56,28887,28893
38662,1,512,512,512.00,0.00,28892,28893
38663,4,421,14,128.00,28869.50,28892,28896
38664,1,512,512,512.00,0.00,28895,28896
38665,2,403,109,256.00,21609.00,28895,28897
38666,10,161,1,51.20,3193.56,28896,28906
38667,1,512,512,512.00,0.00,28905,28906
38668,5,262,1,102.40,9688.24,28905,28910
38669,1,512,512,512.00,0.00,28909,28910
38670,1,512,512,512.00,0.00,28909,28910
38671,2,371,141,256.00,13225.00,28909,28911
38672,4,401,1,128.00,26013.50,28910,28914
38673,1,512,512,512.00,0.00,28913,28914
38674,8,291,1,64.00,10123.75,28913,28921
38675,3,312,1,170.67,16521.56,28920,28923
38676,2,354,158,256.00,9604.00,28922,28924
38677,1,512,512,512.00,0.00,28923,28924
38678,1,512,512,512.00,0.00,28923,28924
38679,1,512,512,512.00,0.00,28923,28924
38680,5,385,1,102.40,20691.04,28923,28928
38681,4,183,19,128.00,4253.00,28927,28931
38682,1,512,512,512.00,0.00,28930,28931
38683,1,512,512,512.00,0.00,28930,28931
38684,4,281,13,128.00,9341.00,28930,28934
38685,1,512,512,512.00,0.00,28933,28934
38686,1,512,512,512.00,0.00,28933,28934
38687,2,391,121,256.00,18225.00,28933,28935
38688,1,512,512,512.00,0.00,28934,28935
38689,1,512,512,512.00,0.00,28934,28935
38690,1,512,512,512.00,0.00,28934,28935
38691,2,453,59,256.00,38809.00,28934,28936
38692,8,322,2,64.00,9919.00,28935,28943
38693,2,318,194,256.00,3844.00,28942,28944
38694,1,512,512,512.00,0.00,28943,28944
38695,1,512,512,512.00,0.00,28943,28944
38696,2,429,83,256.00,29929.00,28943,28945
38697,2,348,164,256.00,8464.00,28944,28946
38698,1,512,512,512.00,0.00,28945,28946
38699,2,359,153,256.00,10609.00,28945,28947
38700,3,425,5,170.67,33330.89,28946,28949
38701,1,512,512,512.00,0.00,28948,28949
38702,1,512,512,512.00,0.00,28948,28949
38703,4,352,4,128.00,19378.50,28948,28952
38704,1,512,512,512.00,0.00,28951,28952
38705,2,397,115,256.00,19881.00,28951,28953
38706,3,419,23,170.67,31202.89,28952,28955
38707,1,512,512,512.00,0.00,28954,28955
38708,1,512,512,512.00,0.00,28954,28955
38709,1,512,512,512.00,0.00,28954,28955
38710,1,512,512,512.00,0.00,28954,28955
38711,3,428,1,170.67,34230.89,28954,28957
38712,4,262,6,128.00,12460.00,28956,28960
38713,1,512,512,512.00,0.00,28959,28960
38714,1,512,512,512.00,0.00,28959,28960
38715,1,512,512,512.00,0.00,28959,28960
38716,2,319,193,256.00,3969.00,28959,28961
38717,1,512,512,512.00,0.00,28960,28961
38718,2,340,172,256.00,7056.00,28960,28962
38719,3,337,84,170.67,13841.56,28961,28964
38720,2,434,78,256.00,31684.00,28963,28965
38721,1,512,512,512.00,0.00,28964,28965
38722,7,272,3,73.14,8288.98,28964,28971
38723,2,482,30,256.00,51076.00,28970,28972
38724,3,406,46,170.67,27723.56,28971,28974
38725,3,347,45,170.67,16484.22,28973,28976
38726,1,512,512,512.00,0.00,28975,28976
38727,2,503,9,256.00,61009.00,28975,28977
38728,7,319,1,73.14,12818.12,28976,28983
38729,1,512,512,512.00,0.00,28982,28983
38730,1,512,512,512.00,0.00,28982,28983
38731,5,181,3,102.40,5689.44,28982,28987
38732,1,512,512,512.00,0.00,28986,28987
38733,1,512,512,512.00,0.00,28986,28987
38734,1,512,512,512.00,0.00,28986,28987
38735,1,512,512,512.00,0.00,28986,28987
38736,2,380,132,256.00,15376.00,28986,28988
38737,2,457,55,256.00,40401.00,28987,28989
38738,2,363,149,256.00,11449.00,28988,28990
38739,1,512,512,512.00,0.00,28989,28990
38740,4,460,2,128.00,36914.00,28989,28993
38741,1,512,512,512.00,0.00,28992,28993
38742,1,512,512,512.00,0.00,28992,28993
38743,2,310,202,256.00,2916.00,28992,28994
38744,4,363,22,128.00,18995.50,28993,28997
38745,1,512,512,512.00,0.00,28996,28997
38746,1,512,512,512.00,0.00,28996,28997
38747,8,179,1,64.00,3605.50,28996,29004
38748,1,512,512,512.00,0.00,29003,29004
38749,2,360,152,256.00,10816.00,29003,29005
38750,2,477,35,256.00,48841.00,29004,29006
38751,1,512,512,512.00,0.00,29005,29006
38752,1,512,512,512.00,0.00,29005,29006
38753,1,512,512,512.00,0.00,29005,29006
38754,2,471,41,256.00,46225.00,29005,29007
38755,1,512,512,512.00,0.00,29006,29007
38756,1,512,512,512.00,0.00,29006,29007
38757,1,512,512,512.00,0.00,29006,29007
38758,1,512,512,512.00,0.00,29006,29007
38759,2,316,196,256.00,3600.00,29006,29008
38760,1,512,512,512.00,0.00,29007,29008
38761,1,512,512,512.00,0.00,29007,29008
38762,1,512,512,512.00,0.00,29007,29008
38763,4,396,2,128.00,24530.00,29007,29011
38764,1,512,512,512.00,0.00,29010,29011
38765,2,273,239,256.00,289.00,29010,29012
38766,2,322,190,256.00,4356.00,29011,29013
38767,1,512,512,512.00,0.00,29012,29013
38768,2,493,19,256.00,56169.00,29012,29014
38769,1,512,512,512.00,0.00,29013,29014
38770,1,512,512,512.00,0.00,29013,29014
38771,2,424,88,256.00,28224.00,29013,29015
38772,8,211,5,64.00,4436.00,29014,29022
38773,2,508,4,256.00,63504.00,29021,29023
38774,4,321,30,128.00,13621.50,29022,29026
38775,2,344,168,256.00,7744.00,29025,29027
38776,1,512,512,512.00,0.00,29026,29027
38777,1,512,512,512.00,0.00,29026,29027
38778,1,512,512,512.00,0.00,29026,29027
38779,1,512,512,512.00,0.00,29026,29027
38780,3,458,10,170.67,41472.89,29026,29029
38781,2,257,255,256.00,1.00,29028,29030
38782,4,310,3,128.00,13971.50,29029,29033
38783,4,201,63,128.00,3697.00,29032,29036
38784,2,431,81,256.00,30625.00,29035,29037
38785,2,436,76,256.00,32400.00,29036,29038
38786,2,346,166,256.00,8100.00,29037,29039
38787,2,362,150,256.00,11236.00,29038,29040
38788,1,512,512,512.00,0.00,29039,29040
38789,1,512,512,512.00,0.00,29039,29040
38790,1,512,512,512.00,0.00,29039,29040
38791,1,512,512,512.00,0.00,29039,29040
38792,3,345,4,170.67,19409.56,29039,29042
38793,4,362,15,128.00,19839.50,29041,29045
38794,1,512,512,512.00,0.00,29044,29045
38795,5,323,5,102.40,13874.24,29044,29049
38796,1,512,512,512.00,0.00,29048,29049
38797,1,512,512,512.00,0.00,29048,29049
38798,1,512,512,512.00,0.00,29048,29049
38799,3,248,30,170.67,9926.22,29048,29051
38800,3,477,14,170.67,46928.22,29050,29053
38801,6,350,2,85.33,15283.22,29052,29058
38802,1,512,512,512.00,0.00,29057,29058
38803,1,512,512,512.00,0.00,29057,29058
38804,4,315,1,128.00,14576.50,29057,29061
38805,3,429,39,170.67,33372.22,29060,29063
38806,1,512,512,512.00,0.00,29062,29063
38807,1,512,512,512.00,0.00,29062,29063
38808,2,259,253,256.00,9.00,29062,29064
38809,1,512,512,512.00,0.00,29063,29064
38810,3,397,22,170.67,26453.56,29063,29066
38811,3,408,48,170.67,28174.22,29065,29068
38812,1,512,512,512.00,0.00,29067,29068
38813,2,323,189,256.00,4489.00,29067,29069
38814,1,512,512,512.00,0.00,29068,29069
38815,1,512,512,512.00,0.00,29068,29069
38816,2,427,85,256.00,29241.00,29068,29070
38817,1,512,512,512.00,0.00,29069,29070
38818,3,374,1,170.67,23754.89,29069,29072
38819,1,512,512,512.00,0.00,29071,29072
38820,1,512,512,512.00,0.00,29071,29072
38821,1,512,512,512.00,0.00,29071,29072
38822,1,512,512,512.00,0.00,29071,29072
38823,2,308,204,256.00,2704.00,29071,29073
38824,1,512,512,512.00,0.00,29072,29073
38825,1,512,512,512.00,0.00,29072,29073
38826,2,289,223,256.00,1089.00,29072,29074
38827,1,512,512,512.00,0.00,29073,29074
38828,2,287,225,256.00,961.00,29073,29075
38829,1,512,512,512.00,0.00,29074,29075
38830,4,483,2,128.00,42096.50,29074,29078
38831,2,481,31,256.00,50625.00,29077,29079
38832,1,512,512,512.00,0.00,29078,29079
38833,2,300,212,256.00,1936.00,29078,29080
38834,4,260,59,128.00,6448.50,29079,29083
38835,5,351,28,102.40,15539.04,29082,29087
38836,1,512,512,512.00,0.00,29086,29087
38837,2,410,102,256.00,23716.00,29086,29088
38838,2,507,5,256.00,63001.00,29087,29089
38839,1,512,512,512.00,0.00,29088,29089
38840,1,512,512,512.00,0.00,29088,29089
38841,1,512,512,512.00,0.00,29088,29089
38842,1,512,512,512.00,0.00,29088,29089
38843,1,512,512,512.00,0.00,29088,29089
38844,2,493,19,256.00,56169.00,29088,29090
38845,6,252,1,85.33,9605.89,29089,29095
38846,1,512,512,512.00,0.00,29094,29095
38847,1,512,512,512.00,0.00,29094,29095
38848,1,512,512,512.00,0.00,29094,29095
38849,1,512,512,512.00,0.00,29094,29095
38850,1,512,512,512.00,0.00,29094,29095
38851,2,394,118,256.00,19044.00,29094,29096
38852,1,512,512,512.00,0.00,29095,29096
38853,6,253,3,85.33,7205.56,29095,29101
38854,1,512,512,512.00,0.00,29100,29101
38855,6,463,1,85.33,28586.22,29100,29106
38856,1,512,512,512.00,0.00,29105,29106
38857,2,411,101,256.00,24025.00,29105,29107
38858,2,387,125,256.00,17161.00,29106,29108
38859,2,341,171,256.00,7225.00,29107,29109
38860,1,512,512,512.00,0.00,29108,29109
38861,1,512,512,512.00,0.00,29108,29109
38862,3,340,10,170.67,18187.56,29108,29111
38863,1,512,512,512.00,0.00,29110,29111
38864,3,188,138,170.67,534.22,29110,29113
38865,4,248,5,128.00,12636.50,29112,29116
38866,3,272,47,170.67,8686.89,29115,29118
38867,5,357,2,102.40,17929.04,29117,29122
38868,2,467,45,256.00,44521.00,29121,29123
38869,4,250,13,128.00,12184.50,29122,29126
38870,8,296,1,64.00,9779.25,29125,29133
38871,2,349,163,256.00,8649.00,29132,29134
38872,1,512,512,512.00,0.00,29133,29134
38873,1,512,512,512.00,0.00,29133,29134
38874,1,512,512,512.00,0.00,29133,29134
38875,1,512,512,512.00,0.00,29133,29134
38876,1,512,512,512.00,0.00,29133,29134
38877,2,398,114,256.00,20164.00,29133,29135
38878,1,512,512,512.00,0.00,29134,29135
38879,3,348,9,170.67,19276.22,29134,29137
38880,1,512,512,512.00,0.00,29136,29137
38881,1,512,512,512.00,0.00,29136,29137
38882,1,512,512,512.00,0.00,29136,29137
38883,2,402,110,256.00,21316.00,29136,29138
38884,1,512,512,512.00,0.00,29137,29138
38885,1,512,512,512.00,0.00,29137,29138
38886,1,512,512,512.00,0.00,29137,29138
38887,1,512,512,512.00,0.00,29137,29138
38888,3,224,110,170.67,2192.89,29137,29140
38889,1,512,512,512.00,0.00,29139,29140
38890,1,512,512,512.00,0.00,29139,29140
38891,1,512,512,512.00,0.00,29139,29140
38892,4,283,2,128.00,11850.50,29139,29143
38893,1,512,512,512.00,0.00,29142,29143
38894,1,512,512,512.00,0.00,29142,29143
38895,5,230,27,102.40,6901.84,29142,29147
38896,4,338,20,128.00,15242.00,29146,29150
38897,1,512,512,512.00,0.00,29149,29150
38898,1,512,512,512.00,0.00,29149,29150
38899,1,512,512,512.00,0.00,29149,29150
38900,2,374,138,256.00,13924.00,29149,29151
38901,1,512,512,512.00,0.00,29150,29151
38902,3,265,121,170.67,4453.56,29150,29153
38903,1,512,512,512.00,0.00,29152,29153
38904,1,512,512,512.00,0.00,29152,29153
38905,1,512,512,512.00,0.00,29152,29153
38906,1,512,512,512.00,0.00,29152,29153
38907,4,287,1,128.00,12105.00,29152,29156
38908,5,324,3,102.40,14677.84,29155,29160
38909,4,210,73,128.00,2906.50,29159,29163
38910,2,473,39,256.00,47089.00,29162,29164
38911,1,512,512,512.00,0.00,29163,29164
38912,1,512,512,512.00,0.00,29163,29164
38913,2,314,198,256.00,3364.00,29163,29165
38914,1,512,512,512.00,0.00,29164,29165
38915,3,397,4,170.67,27521.56,29164,29167
38916,1,512,512,512.00,0.00,29166,29167
38917,1,512,512,512.00,0.00,29166,29167
38918,1,512,512,512.00,0.00,29166,29167
38919,3,305,88,170.67,9182.89,29166,29169
38920,1,512,512,512.00,0.00,29168,29169
38921,1,512,512,512.00,0.00,29168,29169
38922,1,512,512,512.00,0.00,29168,29169
38923,1,512,512,512.00,0.00,29168,29169
38924,3,325,66,170.67,12413.56,29168,29171
38925,1,512,512,512.00,0.00,29170,29171
38926,1,512,512,512.00,0.00,29170,29171
38927,1,512,512,512.00,0.00,29170,29171
38928,1,512,512,512.00,0.00,29170,29171
38929,5,242,25,102.40,5668.24,29170,29175
38930,4,262,5,128.00,9106.50,29174,29178
38931,1,512,512,512.00,0.00,29177,29178
38932,2,286,226,256.00,900.00,29177,29179
38933,2,433,79,256.00,31329.00,29178,29180
38934,1,512,512,512.00,0.00,29179,29180
38935,1,512,512,512.00,0.00,29179,29180
38936,3,352,1,170.67,20601.56,29179,29182
38937,1,512,512,512.00,0.00,29181,29182
38938,1,512,512,512.00,0.00,29181,29182
38939,1,512,512,512.00,0.00,29181,29182
38940,1,512,512,512.00,0.00,29181,29182
38941,3,379,20,170.67,23142.89,29181,29184
38942,2,424,88,256.00,28224.00,29183,29185
38943,1,512,512,512.00,0.00,29184,29185
38944,2,346,166,256.00,8100.00,29184,29186
38945,1,512,512,512.00,0.00,29185,29186
38946,4,315,1,128.00,17642.50,29185,29189
38947,1,512,512,512.00,0.00,29188,29189
38948,1,512,512,512.00,0.00,29188,29189
38949,1,512,512,512.00,0.00,29188,29189
38950,1,512,512,512.00,0.00,29188,29189
38951,2,366,146,256.00,12100.00,29188,29190
38952,1,512,512,512.00,0.00,29189,29190
38953,4,202,28,128.00,5411.50,29189,29193
38954,1,512,512,512.00,0.00,29192,29193
38955,1,512,512,512.00,0.00,29192,29193
38956,1,512,512,512.00,0.00,29192,29193
38957,3,292,20,170.67,12760.89,29192,29195
38958,1,512,512,512.00,0.00,29194,29195
38959,1,512,512,512.00,0.00,29194,29195
38960,1,512,512,512.00,0.00,29194,29195
38961,1,512,512,512.00,0.00,29194,29195
38962,2,422,90,256.00,27556.00,29194,29196
38963,2,429,83,256.00,29929.00,29195,29197
38964,1,512,512,512.00,0.00,29196,29197
38965,2,507,5,256.00,63001.00,29196,29198
38966,3,250,22,170.67,11067.56,29197,29200
38967,5,422,5,102.40,25755.44,29199,29204
38968,1,512,512,512.00,0.00,29203,29204
38969,1,512,512,512.00,0.00,29203,29204
38970,2,415,97,256.00,25281.00,29203,29205
38971,3,308,10,170.67,15072.89,29204,29207
38972,3,268,4,170.67,14019.56,29206,29209
38973,1,512,512,512.00,0.00,29208,29209
38974,1,512,512,512.00,0.00,29208,29209
38975,1,512,512,512.00,0.00,29208,29209
38976,1,512,512,512.00,0.00,29208,29209
38977,1,512,512,512.00,0.00,29208,29209
38978,1,512,512,512.00,0.00,29208,29209
38979,1,512,512,512.00,0.00,29208,29209
38980,1,512,512,512.00,0.00,29208,29209
38981,1,512,512,512.00,0.00,29208,29209
38982,6,405,3,85.33,20948.22,29208,29214
38983,1,512,512,512.00,0.00,29213,29214
38984,3,267,43,170.67,8853.56,29213,29216
38985,1,512,512,512.00,0.00,29215,29216
38986,1,512,512,512.00,0.00,29215,29216
38987,1,512,512,512.00,0.00,29215,29216
38988,2,458,54,256.00,40804.00,29215,29217
38989,4,245,5,128.00,7233.50,29216,29220
38990,4,359,28,128.00,18216.50,29219,29223
38991,1,512,512,512.00,0.00,29222,29223
38992,3,338,68,170.67,14240.89,29222,29225
38993,3,236,118,170.67,2400.89,29224,29227
38994,1,512,512,512.00,0.00,29226,29227
38995,5,321,1,102.40,15755.84,29226,29231
38996,5,200,1,102.40,4590.64,29230,29235
38997,6,424,1,85.33,23803.56,29234,29240
38998,1,512,512,512.00,0.00,29239,29240
38999,1,512,512,512.00,0.00,29239,29240
39000,1,512,512,512.00,0.00,29239,29240
39001,2,466,46,256.00,44100.00,29239,29241
39002,3,291,37,170.67,10841.56,29240,29243
39003,1,512,512,512.00,0.00,29242,29243
39004,2,363,149,256.00,11449.00,29242,29244
39005,2,394,118,256.00,19044.00,29243,29245
39006,2,320,192,256.00,4096.00,29244,29246
39007,2,442,70,256.00,34596.00,29245,29247
39008,2,363,149,256.00,11449.00,29246,29248
39009,4,263,1,128.00,11877.00,29247,29251
39010,1,512,512,512.00,0.00,29250,29251
39011,1,512,512,512.00,0.00,29250,29251
39012,2,369,143,256.00,12769.00,29250,29252
39013,1,512,512,512.00,0.00,29251,29252
39014,1,512,512,512.00,0.00,29251,29252
39015,3,396,36,170.67,25710.22,29251,29254
39016,3,332,12,170.67,17070.22,29253,29256
39017,5,172,1,102.40,6033.84,29255,29260
39018,6,264,1,85.33,8147.22,29259,29265
39019,1,512,512,512.00,0.00,29264,29265
39020,5,290,2,102.40,10962.64,29264,29269
39021,1,512,512,512.00,0.00,29268,29269
39022,1,512,512,512.00,0.00,29268,29269
39023,1,512,512,512.00,0.00,29268,29269
39024,1,512,512,512.00,0.00,29268,29269
39025,7,236,4,73.14,8185.27,29268,29275
39026,2,497,15,256.00,58081.00,29274,29276
39027,1,512,512,512.00,0.00,29275,29276
39028,4,315,9,128.00,13005.00,29275,29279
39029,2,327,185,256.00,5041.00,29278,29280
39030,3,414,15,170.67,30376.22,29279,29282
39031,1,512,512,512.00,0.00,29281,29282
39032,1,512,512,512.00,0.00,29281,29282
39033,1,512,512,512.00,0.00,29281,29282
39034,2,259,253,256.00,9.00,29281,29283
39035,1,512,512,512.00,0.00,29282,29283
39036,1,512,512,512.00,0.00,29282,29283
39037,1,512,512,512.00,0.00,29282,29283
39038,4,193,37,128.00,3243.00,29282,29286
39039,2,445,67,256.00,35721.00,29285,29287
39040,4,362,2,128.00,21360.50,29286,29290
39041,1,512,512,512.00,0.00,29289,29290
39042,3,385,2,170.67,25490.89,29289,29292
39043,1,512,512,512.00,0.00,29291,29292
39044,1,512,512,512.00,0.00,29291,29292
39045,1,512,512,512.00,0.00,29291,29292
39046,1,512,512,512.00,0.00,29291,29292
39047,4,430,4,128.00,31218.00,29291,29295
39048,1,512,512,512.00,0.00,29294,29295
39049,1,512,512,512.00,0.00,29294,29295
39050,6,327,1,85.33,14244.56,29294,29300
39051,6,259,1,85.33,8283.56,29299,29305
39052,1,512,512,512.00,0.00,29304,29305
39053,1,512,512,512.00,0.00,29304,29305
39054,1,512,512,512.00,0.00,29304,29305
39055,5,454,4,102.40,30935.44,29304,29309
39056,2,417,95,256.00,25921.00,29308,29310
39057,6,233,2,85.33,7652.56,29309,29315
39058,1,512,512,512.00,0.00,29314,29315
39059,1,512,512,512.00,0.00,29314,29315
39060,2,290,222,256.00,1156.00,29314,29316
39061,7,155,3,73.14,3050.98,29315,29322
39062,3,431,2,170.67,34874.89,29321,29324
39063,1,512,512,512.00,0.00,29323,29324
39064,1,512,512,512.00,0.00,29323,29324
39065,1,512,512,512.00,0.00,29323,29324
39066,1,512,512,512.00,0.00,29323,29324
39067,1,512,512,512.00,0.00,29323,29324
39068,2,387,125,256.00,17161.00,29323,29325
39069,1,512,512,512.00,0.00,29324,29325
39070,3,496,2,170.67,52944.89,29324,29327
39071,1,512,512,512.00,0.00,29326,29327
39072,1,512,512,512.00,0.00,29326,29327
39073,3,397,9,170.67,27181.56,29326,29329
39074,2,329,183,256.00,5329.00,29328,29330
39075,1,512,512,512.00,0.00,29329,29330
39076,1,512,512,512.00,0.00,29329,29330
39077,2,441,71,256.00,34225.00,29329,29331
39078,2,447,65,256.00,36481.00,29330,29332
39079,4,324,10,128.00,14045.50,29331,29335
39080,1,512,512,512.00,0.00,29334,29335
39081,1,512,512,512.00,0.00,29334,29335
39082,4,216,1,128.00,6278.50,29334,29338
39083,1,512,512,512.00,0.00,29337,29338
39084,1,512,512,512.00,0.00,29337,29338
39085,3,453,26,170.67,39864.22,29337,29340
39086,9,134,2,56.89,2368.99,29339,29348
39087,4,206,1,128.00,6981.50,29347,29351
39088,1,512,512,512.00,0.00,29350,29351
39089,3,329,8,170.67,17182.89,29350,29353
39090,1,512,512,512.00,0.00,29352,29353
39091,2,357,155,256.00,10201.00,29352,29354
39092,1,512,512,512.00,0.00,29353,29354
39093,1,512,512,512.00,0.00,29353,29354
39094,1,512,512,512.00,0.00,29353,29354
39095,2,438,74,256.00,33124.00,29353,29355
39096,1,512,512,512.00,0.00,29354,29355
39097,1,512,512,512.00,0.00,29354,29355
39098,6,168,5,85.33,5062.89,29354,29360
39099,8,221,2,64.00,5869.00,29359,29367
39100,3,484,9,170.67,49105.56,29366,29369
39101,1,512,512,512.00,0.00,29368,29369
39102,1,512,512,512.00,0.00,29368,29369
39103,3,339,16,170.67,17481.56,29368,29371
39104,1,512,512,512.00,0.00,29370,29371
39105,2,470,42,256.00,45796.00,29370,29372
39106,1,512,512,512.00,0.00,29371,29372
39107,1,512,512,512.00,0.00,29371,29372
39108,4,224,20,128.00,6750.50,29371,29375
39109,1,512,512,512.00,0.00,29374,29375
39110,1,512,512,512.00,0.00,29374,29375
39111,5,313,2,102.40,12748.24,29374,29379
39112,4,401,2,128.00,26527.50,29378,29382
39113,5,233,37,102.40,5845.04,29381,29386
39114,1,512,512,512.00,0.00,29385,29386
39115,2,346,166,256.00,8100.00,29385,29387
39116,2,452,60,256.00,38416.00,29386,29388
39117,3,295,87,170.67,8037.56,29387,29390
39118,1,512,512,512.00,0.00,29389,29390
39119,1,512,512,512.00,0.00,29389,29390
39120,1,512,512,512.00,0.00,29389,29390
39121,1,512,512,512.00,0.00,29389,29390
39122,2,346,166,256.00,8100.00,29389,29391
39123,2,452,60,256.00,38416.00,29390,29392
39124,2,442,70,256.00,34596.00,29391,29393
39125,1,512,512,512.00,0.00,29392,29393
39126,1,512,512,512.00,0.00,29392,29393
39127,2,320,192,256.00,4096.00,29392,29394
39128,2,387,125,256.00,17161.00,29393,29395
39129,1,512,512,512.00,0.00,29394,29395
39130,1,512,512,512.00,0.00,29394,29395
39131,4,195,12,128.00,5221.50,29394,29398
39132,5,361,5,102.40,17166.24,29397,29402
39133,1,512,512,512.00,0.00,29401,29402
39134,2,278,234,256.00,484.00,29401,29403
39135,1,512,512,512.00,0.00,29402,29403
39136,1,512,512,512.00,0.00,29402,29403
39137,5,364,1,102.40,19473.04,29402,29407
39138,1,512,512,512.00,0.00,29406,29407
39139,7,352,1,73.14,15568.12,29406,29413
39140,1,512,512,512.00,0.00,29412,29413
39141,2,271,241,256.00,225.00,29412,29414
39142,1,512,512,512.00,0.00,29413,29414
39143,1,512,512,512.00,0.00,29413,29414
39144,1,512,512,512.00,0.00,29413,29414
39145,1,512,512,512.00,0.00,29413,29414
39146,1,512,512,512.00,0.00,29413,29414
39147,3,413,5,170.67,30682.89,29413,29416
39148,1,512,512,512.00,0.00,29415,29416
39149,1,512,512,512.00,0.00,29415,29416
39150,2,363,149,256.00,11449.00,29415,29417
39151,1,512,512,512.00,0.00,29416,29417
39152,2,440,72,256.00,33856.00,29416,29418
39153,2,488,24,256.00,53824.00,29417,29419
39154,6,336,2,85.33,12975.89,29418,29424
39155,2,474,38,256.00,47524.00,29423,29425
39156,3,350,23,170.67,18322.89,29424,29427
39157,1,512,512,512.00,0.00,29426,29427
39158,2,334,178,256.00,6084.00,29426,29428
39159,1,512,512,512.00,0.00,29427,29428
39160,1,512,512,512.00,0.00,29427,29428
39161,2,320,192,256.00,4096.00,29427,29429
39162,4,414,2,128.00,27798.50,29428,29432
39163,1,512,512,512.00,0.00,29431,29432
39164,1,512,512,512.00,0.00,29431,29432
39165,6,219,1,85.33,5762.89,29431,29437
39166,5,318,21,102.40,12200.24,29436,29441
39167,4,483,1,128.00,42068.50,29440,29444
39168,1,512,512,512.00,0.00,29443,29444
39169,1,512,512,512.00,0.00,29443,29444
39170,1,512,512,512.00,0.00,29443,29444
39171,2,369,143,256.00,12769.00,29443,29445
39172,1,512,512,512.00,0.00,29444,29445
39173,4,207,30,128.00,5491.50,29444,29448
39174,1,512,512,512.00,0.00,29447,29448
39175,2,342,170,256.00,7396.00,29447,29449
39176,1,512,512,512.00,0.00,29448,29449
39177,1,512,512,512.00,0.00,29448,29449
39178,1,512,512,512.00,0.00,29448,29449
39179,1,512,512,512.00,0.00,29448,29449
39180,1,512,512,512.00,0.00,29448,29449
39181,3,220,120,170.67,1667.56,29448,29451
39182,3,260,33,170.67,9756.22,29450,29453
39183,1,512,512,512.00,0.00,29452,29453
39184,8,177,1,64.00,3164.25,29452,29460
39185,3,479,9,170.67,47572.22,29459,29462
39186,2,311,201,256.00,3025.00,29461,29463
39187,2,444,68,256.00,35344.00,29462,29464
39188,1,512,512,512.00,0.00,29463,29464
39189,1,512,512,512.00,0.00,29463,29464
39190,1,512,512,512.00,0.00,29463,29464
39191,3,416,18,170.67,30694.22,29463,29466
39192,8,177,6,64.00,3782.50,29465,29473
39193,1,512,512,512.00,0.00,29472,29473
39194,1,512,512,512.00,0.00,29472,29473
39195,1,512,512,512.00,0.00,29472,29473
39196,9,321,1,56.89,9288.54,29472,29481
39197,1,512,512,512.00,0.00,29480,29481
39198,4,300,9,128.00,11288.50,29480,29484
39199,1,512,512,512.00,0.00,29483,29484
39200,1,512,512,512.00,0.00,29483,29484
39201,6,144,2,85.33,1991.89,29483,29489
39202,1,512,512,512.00,0.00,29488,29489
39203,1,512,512,512.00,0.00,29488,29489
39204,1,512,512,512.00,0.00,29488,29489
39205,2,478,34,256.00,49284.00,29488,29490
39206,1,512,512,512.00,0.00,29489,29490
39207,1,512,512,512.00,0.00,29489,29490
39208,1,512,512,512.00,0.00,29489,29490
39209,1,512,512,512.00,0.00,29489,29490
39210,2,469,43,256.00,45369.00,29489,29491
39211,1,512,512,512.00,0.00,29490,29491
39212,3,393,2,170.67,26920.22,29490,29493
39213,1,512,512,512.00,0.00,29492,29493
39214,1,512,512,512.00,0.00,29492,29493
39215,2,468,44,256.00,44944.00,29492,29494
39216,1,512,512,512.00,0.00,29493,29494
39217,1,512,512,512.00,0.00,29493,29494
39218,1,512,512,512.00,0.00,29493,29494
39219,1,512,512,512.00,0.00,29493,29494
39220,1,512,512,512.00,0.00,29493,29494
39221,2,363,149,256.00,11449.00,29493,29495
39222,2,424,88,256.00,28224.00,29494,29496
39223,4,205,73,128.00,2519.50,29495,29499
39224,1,512,512,512.00,0.00,29498,29499
39225,1,512,512,512.00,0.00,29498,29499
39226,1,512,512,512.00,0.00,29498,29499
39227,4,242,54,128.00,4826.00,29498,29502
39228,2,480,32,256.00,50176.00,29501,29503
39229,1,512,512,512.00,0.00,29502,29503
39230,1,512,512,512.00,0.00,29502,29503
39231,6,313,9,85.33,11088.89,29502,29508
39232,1,512,512,512.00,0.00,29507,29508
39233,4,411,7,128.00,26965.00,29507,29511
39234,1,512,512,512.00,0.00,29510,29511
39235,6,288,1,85.33,11680.56,29510,29516
39236,1,512,512,512.00,0.00,29515,29516
39237,2,503,9,256.00,61009.00,29515,29517
39238,1,512,512,512.00,0.00,29516,29517
39239,4,312,9,128.00,12610.50,29516,29520
39240,1,512,512,512.00,0.00,29519,29520
39241,2,330,182,256.00,5476.00,29519,29521
39242,1,512,512,512.00,0.00,29520,29521
39243,1,512,512,512.00,0.00,29520,29521
39244,2,498,14,256.00,58564.00,29520,29522
39245,1,512,512,512.00,0.00,29521,29522
39246,1,512,512,512.00,0.00,29521,29522
39247,2,388,124,256.00,17424.00,29521,29523
39248,1,512,512,512.00,0.00,29522,29523
39249,1,512,512,512.00,0.00,29522,29523
39250,1,512,512,512.00,0.00,29522,29523
39251,2,484,28,256.00,51984.00,29522,29524
39252,1,512,512,512.00,0.00,29523,29524
39253,1,512,512,512.00,0.00,29523,29524
39254,1,512,512,512.00,0.00,29523,29524
39255,1,512,512,512.00,0.00,29523,29524
39256,1,512,512,512.00,0.00,29523,29524
39257,1,512,512,512.00,0.00,29523,29524
39258,1,512,512,512.00,0.00,29523,29524
39259,1,512,512,512.00,0.00,29523,29524
39260,1,512,512,512.00,0.00,29523,29524
39261,1,512,512,512.00,0.00,29523,29524
39262,2,327,185,256.00,5041.00,29523,29525
39263,1,512,512,512.00,0.00,29524,29525
39264,4,389,2,128.00,23683.50,29524,29528
39265,4,299,34,128.00,10963.50,29527,29531
39266,1,512,512,512.00,0.00,29530,29531
39267,1,512,512,512.00,0.00,29530,29531
39268,1,512,512,512.00,0.00,29530,29531
39269,1,512,512,512.00,0.00,29530,29531
39270,2,349,163,256.00,8649.00,29530,29532
39271,2,319,193,256.00,3969.00,29531,29533
39272,1,512,512,512.00,0.00,29532,29533
39273,1,512,512,512.00,0.00,29532,29533
39274,1,512,512,512.00,0.00,29532,29533
39275,3,330,36,170.67,14710.22,29532,29535
39276,1,512,512,512.00,0.00,29534,29535
39277,2,440,72,256.00,33856.00,29534,29536
39278,2,365,147,256.00,11881.00,29535,29537
39279,1,512,512,512.00,0.00,29536,29537
39280,2,402,110,256.00,21316.00,29536,29538
39281,2,323,189,256.00,4489.00,29537,29539
39282,3,268,3,170.67,14177.56,29538,29541
39283,2,477,35,256.00,48841.00,29540,29542
39284,1,512,512,512.00,0.00,29541,29542
39285,3,374,2,170.67,23664.89,29541,29544
39286,1,512,512,512.00,0.00,29543,29544
39287,1,512,512,512.00,0.00,29543,29544
39288,2,266,246,256.00,100.00,29543,29545
39289,2,464,48,256.00,43264.00,29544,29546
39290,1,512,512,512.00,0.00,29545,29546
39291,5,329,1,102.40,17091.04,29545,29550
39292,1,512,512,512.00,0.00,29549,29550
39293,1,512,512,512.00,0.00,29549,29550
39294,1,512,512,512.00,0.00,29549,29550
39295,1,512,512,512.00,0.00,29549,29550
39296,2,370,142,256.00,12996.00,29549,29551
39297,1,512,512,512.00,0.00,29550,29551
39298,2,469,43,256.00,45369.00,29550,29552
39299,1,512,512,512.00,0.00,29551,29552
39300,4,438,6,128.00,32214.00,29551,29555
39301,3,420,5,170.67,32204.22,29554,29557
39302,1,512,512,512.00,0.00,29556,29557
39303,1,512,512,512.00,0.00,29556,29557
39304,13,188,1,39.38,2503.16,29556,29569
39305,2,413,99,256.00,24649.00,29568,29570
39306,1,512,512,512.00,0.00,29569,29570
39307,1,512,512,512.00,0.00,29569,29570
39308,1,512,512,512.00,0.00,29569,29570
39309,1,512,512,512.00,0.00,29569,29570
39310,1,512,512,512.00,0.00,29569,29570
39311,10,250,1,51.20,5896.56,29569,29579
39312,1,512,512,512.00,0.00,29578,29579
39313,1,512,512,512.00,0.00,29578,29579
39314,1,512,512,512.00,0.00,29578,29579
39315,2,432,80,256.00,30976.00,29578,29580
39316,1,512,512,512.00,0.00,29579,29580
39317,3,493,1,170.67,51997.56,29579,29582
39318,2,263,249,256.00,49.00,29581,29583
39319,1,512,512,512.00,0.00,29582,29583
39320,1,512,512,512.00,0.00,29582,29583
39321,1,512,512,512.00,0.00,29582,29583
39322,1,512,512,512.00,0.00,29582,29583
39323,2,369,143,256.00,12769.00,29582,29584
39324,1,512,512,512.00,0.00,29583,29584
39325,1,512,512,512.00,0.00,29583,29584
39326,3,468,3,170.67,44444.22,29583,29586
39327,1,512,512,512.00,0.00,29585,29586
39328,1,512,512,512.00,0.00,29585,29586
39329,1,512,512,512.00,0.00,29585,29586
39330,1,512,512,512.00,0.00,29585,29586
39331,1,512,512,512.00,0.00,29585,29586
39332,1,512,512,512.00,0.00,29585,29586
39333,4,312,36,128.00,12286.00,29585,29589
39334,3,260,35,170.67,9510.89,29588,29591
39335,1,512,512,512.00,0.00,29590,29591
39336,1,512,512,512.00,0.00,29590,29591
39337,1,512,512,512.00,0.00,29590,29591
39338,2,289,223,256.00,1089.00,29590,29592
39339,1,512,512,512.00,0.00,29591,29592
39340,1,512,512,512.00,0.00,29591,29592
39341,5,323,1,102.40,14669.44,29591,29596
39342,1,512,512,512.00,0.00,29595,29596
39343,2,457,55,256.00,40401.00,29595,29597
39344,3,496,4,170.67,52931.56,29596,29599
39345,5,238,7,102.40,10445.04,29598,29603
39346,1,512,512,512.00,0.00,29602,29603
39347,2,378,134,256.00,14884.00,29602,29604
39348,1,512,512,512.00,0.00,29603,29604
39349,3,360,1,170.67,21673.56,29603,29606
39350,1,512,512,512.00,0.00,29605,29606
39351,1,512,512,512.00,0.00,29605,29606
39352,5,251,1,102.40,12915.04,29605,29610
39353,1,512,512,512.00,0.00,29609,29610
39354,1,512,512,512.00,0.00,29609,29610
39355,1,512,512,512.00,0.00,29609,29610
39356,1,512,512,512.00,0.00,29609,29610
39357,1,512,512,512.00,0.00,29609,29610
39358,3,432,23,170.67,34340.22,29609,29612
39359,7,390,1,73.14,17807.27,29611,29618
39360,6,266,1,85.33,12491.22,29617,29623
39361,1,512,512,512.00,0.00,29622,29623
39362,1,512,512,512.00,0.00,29622,29623
39363,1,512,512,512.00,0.00,29622,29623
39364,1,512,512,512.00,0.00,29622,29623
39365,1,512,512,512.00,0.00,29622,29623
39366,1,512,512,512.00,0.00,29622,29623
39367,1,512,512,512.00,0.00,29622,29623
39368,1,512,512,512.00,0.00,29622,29623
39369,1,512,512,512.00,0.00,29622,29623
39370,1,512,512,512.00,0.00,29622,29623
39371,1,512,512,512.00,0.00,29622,29623
39372,1,512,512,512.00,0.00,29622,29623
39373,2,268,244,256.00,144.00,29622,29624
39374,2,374,138,256.00,13924.00,29623,29625
39375,1,512,512,512.00,0.00,29624,29625
39376,4,173,61,128.00,1817.00,29624,29628
39377,1,512,512,512.00,0.00,29627,29628
39378,1,512,512,512.00,0.00,29627,29628
39379,1,512,512,512.00,0.00,29627,29628
39380,1,512,512,512.00,0.00,29627,29628
39381,6,306,4,85.33,10793.89,29627,29633
39382,1,512,512,512.00,0.00,29632,29633
39383,1,512,512,512.00,0.00,29632,29633
39384,1,512,512,512.00,0.00,29632,29633
39385,4,334,1,128.00,17836.50,29632,29636
39386,2,414,98,256.00,24964.00,29635,29637
39387,1,512,512,512.00,0.00,29636,29637
39388,4,228,62,128.00,3914.00,29636,29640
39389,4,255,23,128.00,7269.50,29639,29643
39390,1,512,512,512.00,0.00,29642,29643
39391,1,512,512,512.00,0.00,29642,29643
39392,1,512,512,512.00,0.00,29642,29643
39393,1,512,512,512.00,0.00,29642,29643
39394,2,500,12,256.00,59536.00,29642,29644
39395,1,512,512,512.00,0.00,29643,29644
39396,8,368,1,64.00,13618.25,29643,29651
39397,1,512,512,512.00,0.00,29650,29651
39398,5,243,4,102.40,8831.84,29650,29655
39399,2,413,99,256.00,24649.00,29654,29656
39400,1,512,512,512.00,0.00,29655,29656
39401,2,406,106,256.00,22500.00,29655,29657
39402,3,369,52,170.67,19921.56,29656,29659
39403,2,511,1,256.00,65025.00,29658,29660
39404,1,512,512,512.00,0.00,29659,29660
39405,2,467,45,256.00,44521.00,29659,29661
39406,2,430,82,256.00,30276.00,29660,29662
39407,2,479,33,256.00,49729.00,29661,29663
39408,1,512,512,512.00,0.00,29662,29663
39409,1,512,512,512.00,0.00,29662,29663
39410,1,512,512,512.00,0.00,29662,29663
39411,2,490,22,256.00,54756.00,29662,29664
39412,1,512,512,512.00,0.00,29663,29664
39413,1,512,512,512.00,0.00,29663,29664
39414,1,512,512,512.00,0.00,29663,29664
39415,1,512,512,512.00,0.00,29663,29664
39416,1,512,512,512.00,0.00,29663,29664
39417,6,243,3,85.33,10096.89,29663,29669
39418,1,512,512,512.00,0.00,29668,29669
39419,2,405,107,256.00,22201.00,29668,29670
39420,1,512,512,512.00,0.00,29669,29670
39421,1,512,512,512.00,0.00,29669,29670
39422,2,430,82,256.00,30276.00,29669,29671
39423,3,218,102,170.67,2470.22,29670,29673
39424,1,512,512,512.00,0.00,29672,29673
39425,1,512,512,512.00,0.00,29672,29673
39426,1,512,512,512.00,0.00,29672,29673
39427,2,459,53,256.00,41209.00,29672,29674
39428,1,512,512,512.00,0.00,29673,29674
39429,1,512,512,512.00,0.00,29673,29674
39430,1,512,512,512.00,0.00,29673,29674
39431,2,491,21,256.00,55225.00,29673,29675
39432,5,337,6,102.40,15269.04,29674,29679
39433,3,263,91,170.67,5010.89,29678,29681
39434,2,342,170,256.00,7396.00,29680,29682
39435,1,512,512,512.00,0.00,29681,29682
39436,2,353,159,256.00,9409.00,29681,29683
39437,1,512,512,512.00,0.00,29682,29683
39438,1,512,512,512.00,0.00,29682,29683
39439,5,388,4,102.40,21894.64,29682,29687
39440,1,512,512,512.00,0.00,29686,29687
39441,2,347,165,256.00,8281.00,29686,29688
39442,2,481,31,256.00,50625.00,29687,29689
39443,2,421,91,256.00,27225.00,29688,29690
39444,1,512,512,512.00,0.00,29689,29690
39445,1,512,512,512.00,0.00,29689,29690
39446,1,512,512,512.00,0.00,29689,29690
39447,1,512,512,512.00,0.00,29689,29690
39448,2,354,158,256.00,9604.00,29689,29691
39449,1,512,512,512.00,0.00,29690,29691
39450,2,480,32,256.00,50176.00,29690,29692
39451,2,352,160,256.00,9216.00,29691,29693
39452,8,210,1,64.00,7612.25,29692,29700
39453,1,512,512,512.00,0.00,29699,29700
39454,1,512,512,512.00,0.00,29699,29700
39455,1,512,512,512.00,0.00,29699,29700
39456,2,406,106,256.00,22500.00,29699,29701
39457,2,269,243,256.00,169.00,29700,29702
39458,1,512,512,512.00,0.00,29701,29702
39459,2,275,237,256.00,361.00,29701,29703
39460,3,259,13,170.67,12489.56,29702,29705
39461,2,473,39,256.00,47089.00,29704,29706
39462,1,512,512,512.00,0.00,29705,29706
39463,1,512,512,512.00,0.00,29705,29706
39464,4,265,2,128.00,15346.50,29705,29709
39465,7,143,7,73.14,2582.69,29708,29715
39466,1,512,512,512.00,0.00,29714,29715
39467,2,508,4,256.00,63504.00,29714,29716
39468,3,254,56,170.67,7024.89,29715,29718
39469,1,512,512,512.00,0.00,29717,29718
39470,2,459,53,256.00,41209.00,29717,29719
39471,1,512,512,512.00,0.00,29718,29719
39472,1,512,512,512.00,0.00,29718,29719
39473,1,512,512,512.00,0.00,29718,29719
39474,7,355,1,73.14,13629.55,29718,29725
39475,2,388,124,256.00,17424.00,29724,29726
39476,1,512,512,512.00,0.00,29725,29726
39477,1,512,512,512.00,0.00,29725,29726
39478,2,294,218,256.00,1444.00,29725,29727
39479,1,512,512,512.00,0.00,29726,29727
39480,1,512,512,512.00,0.00,29726,29727
39481,1,512,512,512.00,0.00,29726,29727
39482,1,512,512,512.00,0.00,29726,29727
39483,6,427,2,85.33,23618.22,29726,29732
39484,10,169,1,51.20,2831.76,29731,29741
39485,1,512,512,512.00,0.00,29740,29741
39486,1,512,512,512.00,0.00,29740,29741
39487,2,356,156,256.00,10000.00,29740,29742
39488,1,512,512,512.00,0.00,29741,29742
39489,1,512,512,512.00,0.00,29741,29742
39490,1,512,512,512.00,0.00,29741,29742
39491,1,512,512,512.00,0.00,29741,29742
39492,4,259,6,128.00,13274.50,29741,29745
39493,1,512,512,512.00,0.00,29744,29745
39494,1,512,512,512.00,0.00,29744,29745
39495,1,512,512,512.00,0.00,29744,29745
39496,2,352,160,256.00,9216.00,29744,29746
39497,4,254,67,128.00,5442.50,29745,29749
39498,1,512,512,512.00,0.00,29748,29749
39499,2,421,91,256.00,27225.00,29748,29750
39500,1,512,512,512.00,0.00,29749,29750
39501,1,512,512,512.00,0.00,29749,29750
39502,1,512,512,512.00,0.00,29749,29750
39503,4,402,3,128.00,26080.50,29749,29753
39504,1,512,512,512.00,0.00,29752,29753
39505,1,512,512,512.00,0.00,29752,29753
39506,1,512,512,512.00,0.00,29752,29753
39507,7,354,5,73.14,13572.69,29752,29759
39508,7,215,3,73.14,6178.69,29758,29765
39509,1,512,512,512.00,0.00,29764,29765
39510,1,512,512,512.00,0.00,29764,29765
39511,1,512,512,512.00,0.00,29764,29765
39512,1,512,512,512.00,0.00,29764,29765
39513,2,344,168,256.00,7744.00,29764,29766
39514,1,512,512,512.00,0.00,29765,29766
39515,3,307,1,170.67,16161.56,29765,29768
39516,3,467,19,170.67,43914.89,29767,29770
39517,3,393,53,170.67,24744.22,29769,29772
39518,1,512,512,512.00,0.00,29771,29772
39519,2,474,38,256.00,47524.00,29771,29773
39520,4,254,39,128.00,6555.50,29772,29776
39521,1,512,512,512.00,0.00,29775,29776
39522,3,210,101,170.67,2440.22,29775,29778
39523,1,512,512,512.00,0.00,29777,29778
39524,2,318,194,256.00,3844.00,29777,29779
39525,3,341,6,170.67,18720.22,29778,29781
39526,3,471,2,170.67,45328.22,29780,29783
39527,3,365,10,170.67,21570.89,29782,29785
39528,3,291,27,170.67,11888.22,29784,29787
39529,2,402,110,256.00,21316.00,29786,29788
39530,1,512,512,512.00,0.00,29787,29788
39531,1,512,512,512.00,0.00,29787,29788
39532,1,512,512,512.00,0.00,29787,29788
39533,1,512,512,512.00,0.00,29787,29788
39534,1,512,512,512.00,0.00,29787,29788
39535,6,238,2,85.33,9748.56,29787,29793
39536,1,512,512,512.00,0.00,29792,29793
39537,2,340,172,256.00,7056.00,29792,29794
39538,1,512,512,512.00,0.00,29793,29794
39539,4,316,53,128.00,11866.50,29793,29797
39540,1,512,512,512.00,0.00,29796,29797
39541,1,512,512,512.00,0.00,29796,29797
39542,2,342,170,256.00,7396.00,29796,29798
39543,3,444,5,170.67,37916.22,29797,29800
39544,1,512,512,512.00,0.00,29799,29800
39545,2,312,200,256.00,3136.00,29799,29801
39546,2,399,113,256.00,20449.00,29800,29802
39547,1,512,512,512.00,0.00,29801,29802
39548,2,482,30,256.00,51076.00,29801,29803
39549,4,432,9,128.00,31175.50,29802,29806
39550,1,512,512,512.00,0.00,29805,29806
39551,1,512,512,512.00,0.00,29805,29806
39552,1,512,512,512.00,0.00,29805,29806
39553,1,512,512,512.00,0.00,29805,29806
39554,3,316,3,170.67,16577.56,29805,29808
39555,1,512,512,512.00,0.00,29807,29808
39556,1,512,512,512.00,0.00,29807,29808
39557,2,507,5,256.00,63001.00,29807,29809
39558,3,272,37,170.67,9726.89,29808,29811
39559,1,512,512,512.00,0.00,29810,29811
39560,1,512,512,512.00,0.00,29810,29811
39561,3,313,86,170.67,10250.89,29810,29813
39562,1,512,512,512.00,0.00,29812,29813
39563,1,512,512,512.00,0.00,29812,29813
39564,1,512,512,512.00,0.00,29812,29813
39565,1,512,512,512.00,0.00,29812,29813
39566,1,512,512,512.00,0.00,29812,29813
39567,4,244,11,128.00,10527.50,29812,29816
39568,1,512,512,512.00,0.00,29815,29816
39569,1,512,512,512.00,0.00,29815,29816
39570,1,512,512,512.00,0.00,29815,29816
39571,3,478,10,170.67,47259.56,29815,29818
39572,1,512,512,512.00,0.00,29817,29818
39573,4,364,2,128.00,21146.00,29817,29821
39574,4,378,35,128.00,20913.50,29820,29824
39575,1,512,512,512.00,0.00,29823,29824
39576,2,299,213,256.00,1849.00,29823,29825
39577,1,512,512,512.00,0.00,29824,29825
39578,1,512,512,512.00,0.00,29824,29825
39579,1,512,512,512.00,0.00,29824,29825
39580,1,512,512,512.00,0.00,29824,29825
39581,2,341,171,256.00,7225.00,29824,29826
39582,5,288,11,102.40,9658.64,29825,29830
39583,3,450,2,170.67,39574.22,29829,29832
39584,2,510,2,256.00,64516.00,29831,29833
39585,8,223,4,64.00,5241.75,29832,29840
39586,1,512,512,512.00,0.00,29839,29840
39587,1,512,512,512.00,0.00,29839,29840
39588,1,512,512,512.00,0.00,29839,29840
39589,3,250,30,170.67,9947.56,29839,29842
39590,1,512,512,512.00,0.00,29841,29842
39591,1,512,512,512.00,0.00,29841,29842
39592,3,442,6,170.67,37371.56,29841,29844
39593,2,431,81,256.00,30625.00,29843,29845
39594,3,342,15,170.67,17944.22,29844,29847
39595,4,348,3,128.00,17189.50,29846,29850
39596,1,512,512,512.00,0.00,29849,29850
39597,4,264,2,128.00,15805.50,29849,29853
39598,4,356,6,128.00,18249.50,29852,29856
39599,1,512,512,512.00,0.00,29855,29856
39600,1,512,512,512.00,0.00,29855,29856
39601,2,506,6,256.00,62500.00,29855,29857
39602,2,445,67,256.00,35721.00,29856,29858
39603,4,354,16,128.00,17561.50,29857,29861
39604,1,512,512,512.00,0.00,29860,29861
39605,3,411,1,170.67,30513.56,29860,29863
39606,3,262,90,170.67,4987.56,29862,29865
39607,1,512,512,512.00,0.00,29864,29865
39608,4,314,2,128.00,15588.50,29864,29868
39609,1,512,512,512.00,0.00,29867,29868
39610,4,235,13,128.00,8421.00,29867,29871
39611,3,466,17,170.67,43634.89,29870,29873
39612,1,512,512,512.00,0.00,29872,29873
39613,5,423,2,102.40,26213.84,29872,29877
39614,1,512,512,512.00,0.00,29876,29877
39615,3,371,2,170.67,23194.89,29876,29879
39616,1,512,512,512.00,0.00,29878,29879
39617,2,285,227,256.00,841.00,29878,29880
39618,1,512,512,512.00,0.00,29879,29880
39619,1,512,512,512.00,0.00,29879,29880
39620,2,458,54,256.00,40804.00,29879,29881
39621,1,512,512,512.00,0.00,29880,29881
39622,1,512,512,512.00,0.00,29880,29881
39623,3,349,3,170.67,20009.56,29880,29883
39624,1,512,512,512.00,0.00,29882,29883
39625,1,512,512,512.00,0.00,29882,29883
39626,1,512,512,512.00,0.00,29882,29883
39627,3,426,38,170.67,32614.22,29882,29885
39628,1,512,512,512.00,0.00,29884,29885
39629,1,512,512,512.00,0.00,29884,29885
39630,2,497,15,256.00,58081.00,29884,29886
39631,1,512,512,512.00,0.00,29885,29886
39632,4,198,5,128.00,5373.50,29885,29889
39633,1,512,512,512.00,0.00,29888,29889
39634,1,512,512,512.00,0.00,29888,29889
39635,7,256,2,73.14,8580.69,29888,29895
39636,5,225,5,102.40,5467.04,29894,29899
39637,1,512,512,512.00,0.00,29898,29899
39638,3,452,28,170.67,39576.89,29898,29901
39639,1,512,512,512.00,0.00,29900,29901
39640,2,291,221,256.00,1225.00,29900,29902
39641,1,512,512,512.00,0.00,29901,29902
39642,2,455,57,256.00,39601.00,29901,29903
39643,5,286,6,102.40,12271.04,29902,29907
39644,1,512,512,512.00,0.00,29906,29907
39645,7,254,4,73.14,8350.69,29906,29913
39646,1,512,512,512.00,0.00,29912,29913
39647,1,512,512,512.00,0.00,29912,29913
39648,1,512,512,512.00,0.00,29912,29913
39649,1,512,512,512.00,0.00,29912,29913
39650,2,315,197,256.00,3481.00,29912,29914
39651,3,341,57,170.67,15048.22,29913,29916
39652,2,441,71,256.00,34225.00,29915,29917
39653,1,512,512,512.00,0.00,29916,29917
39654,1,512,512,512.00,0.00,29916,29917
39655,1,512,512,512.00,0.00,29916,29917
39656,1,512,512,512.00,0.00,29916,29917
39657,2,395,117,256.00,19321.00,29916,29918
39658,2,396,116,256.00,19600.00,29917,29919
39659,3,319,15,170.67,15429.56,29918,29921
39660,4,344,4,128.00,18190.50,29920,29924
39661,1,512,512,512.00,0.00,29923,29924
39662,1,512,512,512.00,0.00,29923,29924
39663,1,512,512,512.00,0.00,29923,29924
39664,1,512,512,512.00,0.00,29923,29924
39665,1,512,512,512.00,0.00,29923,29924
39666,3,341,7,170.67,18614.89,29923,29926
39667,1,512,512,512.00,0.00,29925,29926
39668,3,422,4,170.67,32704.89,29925,29928
39669,1,512,512,512.00,0.00,29927,29928
39670,1,512,512,512.00,0.00,29927,29928
39671,3,354,48,170.67,17446.22,29927,29930
39672,5,221,19,102.40,6632.64,29929,29934
39673,1,512,512,512.00,0.00,29933,29934
39674,1,512,512,512.00,0.00,29933,29934
39675,1,512,512,512.00,0.00,29933,29934
39676,4,431,2,128.00,31540.50,29933,29937
39677,1,512,512,512.00,0.00,29936,29937
39678,7,220,1,73.14,7696.98,29936,29943
39679,1,512,512,512.00,0.00,29942,29943
39680,1,512,512,512.00,0.00,29942,29943
39681,1,512,512,512.00,0.00,29942,29943
39682,1,512,512,512.00,0.00,29942,29943
39683,1,512,512,512.00,0.00,29942,29943
39684,3,280,12,170.67,13187.56,29942,29945
39685,3,362,29,170.67,19714.89,29944,29947
39686,1,512,512,512.00,0.00,29946,29947
39687,1,512,512,512.00,0.00,29946,29947
39688,1,512,512,512.00,0.00,29946,29947
39689,6,263,1,85.33,10176.56,29946,29952
39690,1,512,512,512.00,0.00,29951,29952
39691,2,503,9,256.00,61009.00,29951,29953
39692,4,447,1,128.00,34080.50,29952,29956
39693,5,216,14,102.40,5587.84,29955,29960
39694,1,512,512,512.00,0.00,29959,29960
39695,3,278,1,170.67,14730.89,29959,29962
39696,1,512,512,512.00,0.00,29961,29962
39697,1,512,512,512.00,0.00,29961,29962
39698,1,512,512,512.00,0.00,29961,29962
39699,1,512,512,512.00,0.00,29961,29962
39700,3,384,1,170.67,25401.56,29961,29964
39701,1,512,512,512.00,0.00,29963,29964
39702,1,512,512,512.00,0.00,29963,29964
39703,3,334,74,170.67,13488.89,29963,29966
39704,3,445,1,170.67,38333.56,29965,29968
39705,1,512,512,512.00,0.00,29967,29968
39706,1,512,512,512.00,0.00,29967,29968
39707,2,499,13,256.00,59049.00,29967,29969
39708,1,512,512,512.00,0.00,29968,29969
39709,1,512,512,512.00,0.00,29968,29969
39710,2,416,96,256.00,25600.00,29968,29970
39711,1,512,512,512.00,0.00,29969,29970
39712,1,512,512,512.00,0.00,29969,29970
39713,4,297,2,128.00,14041.50,29969,29973
39714,2,425,87,256.00,28561.00,29972,29974
39715,1,512,512,512.00,0.00,29973,29974
39716,1,512,512,512.00,0.00,29973,29974
39717,2,487,25,256.00,53361.00,29973,29975
39718,1,512,512,512.00,0.00,29974,29975
39719,1,512,512,512.00,0.00,29974,29975
39720,1,512,512,512.00,0.00,29974,29975
39721,3,286,70,170.67,7883.56,29974,29977
39722,1,512,512,512.00,0.00,29976,29977
39723,1,512,512,512.00,0.00,29976,29977
39724,1,512,512,512.00,0.00,29976,29977
39725,3,301,4,170.67,15361.56,29976,29979
39726,1,512,512,512.00,0.00,29978,29979
39727,1,512,512,512.00,0.00,29978,29979
39728,1,512,512,512.00,0.00,29978,29979
39729,2,454,58,256.00,39204.00,29978,29980
39730,1,512,512,512.00,0.00,29979,29980
39731,1,512,512,512.00,0.00,29979,29980
39732,1,512,512,512.00,0.00,29979,29980
39733,2,450,62,256.00,37636.00,29979,29981
39734,2,348,164,256.00,8464.00,29980,29982
39735,1,512,512,512.00,0.00,29981,29982
39736,2,445,67,256.00,35721.00,29981,29983
39737,1,512,512,512.00,0.00,29982,29983
39738,1,512,512,512.00,0.00,29982,29983
39739,1,512,512,512.00,0.00,29982,29983
39740,1,512,512,512.00,0.00,29982,29983
39741,2,374,138,256.00,13924.00,29982,29984
39742,5,345,5,102.40,16467.44,29983,29988
39743,3,368,66,170.67,19494.22,29987,29990
39744,1,512,512,512.00,0.00,29989,29990
39745,1,512,512,512.00,0.00,29989,29990
39746,1,512,512,512.00,0.00,29989,29990
39747,2,306,206,256.00,2500.00,29989,29991
39748,1,512,512,512.00,0.00,29990,29991
39749,1,512,512,512.00,0.00,29990,29991
39750,1,512,512,512.00,0.00,29990,29991
39751,1,512,512,512.00,0.00,29990,29991
39752,1,512,512,512.00,0.00,29990,29991
39753,3,361,12,170.67,20801.56,29990,29993
39754,3,422,36,170.67,31638.22,29992,29995
39755,1,512,512,512.00,0.00,29994,29995
39756,1,512,512,512.00,0.00,29994,29995
39757,2,332,180,256.00,5776.00,29994,29996
39758,1,512,512,512.00,0.00,29995,29996
39759,1,512,512,512.00,0.00,29995,29996
39760,1,512,512,512.00,0.00,29995,29996
39761,1,512,512,512.00,0.00,29995,29996
39762,1,512,512,512.00,0.00,29995,29996
39763,2,328,184,256.00,5184.00,29995,29997
39764,1,512,512,512.00,0.00,29996,29997
39765,1,512,512,512.00,0.00,29996,29997
39766,1,512,512,512.00,0.00,29996,29997
39767,1,512,512,512.00,0.00,29996,29997
39768,2,319,193,256.00,3969.00,29996,29998
39769,3,373,43,170.67,20937.56,29997,30000
39770,4,463,2,128.00,37540.50,29999,30003
39771,1,512,512,512.00,0.00,30002,30003
39772,1,512,512,512.00,0.00,30002,30003
39773,1,512,512,512.00,0.00,30002,30003
39774,1,512,512,512.00,0.00,30002,30003
39775,2,439,73,256.00,33489.00,30002,30004
39776,1,512,512,512.00,0.00,30003,30004
39777,11,153,1,46.55,2827.70,30003,30014
39778,3,234,72,170.67,4998.22,30013,30016
39779,2,429,83,256.00,29929.00,30015,30017
39780,4,289,9,128.00,11809.00,30016,30020
39781,2,344,168,256.00,7744.00,30019,30021
39782,1,512,512,512.00,0.00,30020,30021
39783,1,512,512,512.00,0.00,30020,30021
39784,1,512,512,512.00,0.00,30020,30021
39785,1,512,512,512.00,0.00,30020,30021
39786,2,291,221,256.00,1225.00,30020,30022
39787,1,512,512,512.00,0.00,30021,30022
39788,1,512,512,512.00,0.00,30021,30022
39789,1,512,512,512.00,0.00,30021,30022
39790,3,226,139,170.67,1541.56,30021,30024
39791,2,304,208,256.00,2304.00,30023,30025
39792,1,512,512,512.00,0.00,30024,30025
39793,1,512,512,512.00,0.00,30024,30025
39794,1,512,512,512.00,0.00,30024,30025
39795,1,512,512,512.00,0.00,30024,30025
39796,1,512,512,512.00,0.00,30024,30025
39797,1,512,512,512.00,0.00,30024,30025
39798,6,147,1,85.33,2352.22,30024,30030
39799,1,512,512,512.00,0.00,30029,30030
39800,1,512,512,512.00,0.00,30029,30030
39801,3,265,2,170.67,14290.89,30029,30032
39802,1,512,512,512.00,0.00,30031,30032
39803,2,410,102,256.00,23716.00,30031,30033
39804,1,512,512,512.00,0.00,30032,30033
39805,3,459,4,170.67,41905.56,30032,30035
39806,2,442,70,256.00,34596.00,30034,30036
39807,1,512,512,512.00,0.00,30035,30036
39808,1,512,512,512.00,0.00,30035,30036
39809,1,512,512,512.00,0.00,30035,30036
39810,1,512,512,512.00,0.00,30035,30036
39811,4,330,1,128.00,18257.50,30035,30039
39812,2,369,143,256.00,12769.00,30038,30040
39813,1,512,512,512.00,0.00,30039,30040
39814,1,512,512,512.00,0.00,30039,30040
39815,1,512,512,512.00,0.00,30039,30040
39816,1,512,512,512.00,0.00,30039,30040
39817,2,400,112,256.00,20736.00,30039,30041
39818,3,311,85,170.67,10006.89,30040,30043
39819,1,512,512,512.00,0.00,30042,30043
39820,4,183,7,128.00,5123.00,30042,30046
39821,5,202,1,102.40,6496.24,30045,30050
39822,4,370,1,128.00,22156.50,30049,30053
39823,1,512,512,512.00,0.00,30052,30053
39824,2,337,175,256.00,6561.00,30052,30054
39825,1,512,512,512.00,0.00,30053,30054
39826,1,512,512,512.00,0.00,30053,30054
39827,3,328,7,170.67,17193.56,30053,30056
39828,1,512,512,512.00,0.00,30055,30056
39829,1,512,512,512.00,0.00,30055,30056
39830,2,509,3,256.00,64009.00,30055,30057
39831,2,465,47,256.00,43681.00,30056,30058
39832,2,415,97,256.00,25281.00,30057,30059
39833,3,304,76,170.67,9411.56,30058,30061
39834,1,512,512,512.00,0.00,30060,30061
39835,2,349,163,256.00,8649.00,30060,30062
39836,5,333,8,102.40,15275.44,30061,30066
39837,4,243,17,128.00,8373.00,30065,30069
39838,1,512,512,512.00,0.00,30068,30069
39839,3,307,13,170.67,14633.56,30068,30071
39840,2,360,152,256.00,10816.00,30070,30072
39841,4,232,11,128.00,7050.50,30071,30075
39842,1,512,512,512.00,0.00,30074,30075
39843,1,512,512,512.00,0.00,30074,30075
39844,1,512,512,512.00,0.00,30074,30075
39845,3,294,1,170.67,15381.56,30074,30077
39846,3,449,30,170.67,38736.22,30076,30079
39847,4,412,4,128.00,27930.00,30078,30082
39848,3,252,86,170.67,4598.22,30081,30084
39849,2,351,161,256.00,9025.00,30083,30085
39850,9,190,3,56.89,4118.77,30084,30093
39851,1,512,512,512.00,0.00,30092,30093
39852,5,268,9,102.40,8387.04,30092,30097
39853,1,512,512,512.00,0.00,30096,30097
39854,3,468,2,170.67,44470.22,30096,30099
39855,2,391,121,256.00,18225.00,30098,30100
39856,5,202,4,102.40,6751.44,30099,30104
39857,1,512,512,512.00,0.00,30103,30104
39858,1,512,512,512.00,0.00,30103,30104
39859,2,271,241,256.00,225.00,30103,30105
39860,2,470,42,256.00,45796.00,30104,30106
39861,1,512,512,512.00,0.00,30105,30106
39862,4,248,6,128.00,7326.00,30105,30109
39863,1,512,512,512.00,0.00,30108,30109
39864,1,512,512,512.00,0.00,30108,30109
39865,1,512,512,512.00,0.00,30108,30109
39866,1,512,512,512.00,0.00,30108,30109
39867,4,193,1,128.00,5601.00,30108,30112
39868,3,471,2,170.67,45328.22,30111,30114
39869,3,311,7,170.67,15674.89,30113,30116
39870,1,512,512,512.00,0.00,30115,30116
39871,3,410,3,170.67,30176.22,30115,30118
39872,2,476,36,256.00,48400.00,30117,30119
39873,4,321,12,128.00,15433.50,30118,30122
39874,1,512,512,512.00,0.00,30121,30122
39875,2,346,166,256.00,8100.00,30121,30123
39876,1,512,512,512.00,0.00,30122,30123
39877,1,512,512,512.00,0.00,30122,30123
39878,1,512,512,512.00,0.00,30122,30123
39879,1,512,512,512.00,0.00,30122,30123
39880,3,278,1,170.67,14730.89,30122,30125
39881,1,512,512,512.00,0.00,30124,30125
39882,2,281,231,256.00,625.00,30124,30126
39883,3,185,158,170.67,122.89,30125,30128
39884,2,456,56,256.00,40000.00,30127,30129
39885,2,423,89,256.00,27889.00,30128,30130
39886,6,325,1,85.33,12058.89,30129,30135
39887,4,330,5,128.00,14899.50,30134,30138
39888,1,512,512,512.00,0.00,30137,30138
39889,1,512,512,512.00,0.00,30137,30138
39890,1,512,512,512.00,0.00,30137,30138
39891,5,305,7,102.40,12436.64,30137,30142
39892,1,512,512,512.00,0.00,30141,30142
39893,1,512,512,512.00,0.00,30141,30142
39894,1,512,512,512.00,0.00,30141,30142
39895,1,512,512,512.00,0.00,30141,30142
39896,1,512,512,512.00,0.00,30141,30142
39897,2,504,8,256.00,61504.00,30141,30143
39898,1,512,512,512.00,0.00,30142,30143
39899,2,410,102,256.00,23716.00,30142,30144
39900,1,512,512,512.00,0.00,30143,30144
39901,1,512,512,512.00,0.00,30143,30144
39902,1,512,512,512.00,0.00,30143,30144
39903,1,512,512,512.00,0.00,30143,30144
39904,4,302,6,128.00,15678.00,30143,30147
39905,3,314,55,170.67,11562.89,30146,30149
39906,2,357,155,256.00,10201.00,30148,30150
39907,2,414,98,256.00,24964.00,30149,30151
39908,4,267,4,128.00,15257.50,30150,30154
39909,1,512,512,512.00,0.00,30153,30154
39910,1,512,512,512.00,0.00,30153,30154
39911,2,454,58,256.00,39204.00,30153,30155
39912,1,512,512,512.00,0.00,30154,30155
39913,1,512,512,512.00,0.00,30154,30155
39914,1,512,512,512.00,0.00,30154,30155
39915,1,512,512,512.00,0.00,30154,30155
39916,3,332,8,170.67,17496.89,30154,30157
39917,3,241,100,170.67,3313.56,30156,30159
39918,1,512,512,512.00,0.00,30158,30159
39919,1,512,512,512.00,0.00,30158,30159
39920,1,512,512,512.00,0.00,30158,30159
39921,3,377,7,170.67,23726.89,30158,30161
39922,1,512,512,512.00,0.00,30160,30161
39923,1,512,512,512.00,0.00,30160,30161
39924,1,512,512,512.00,0.00,30160,30161
39925,1,512,512,512.00,0.00,30160,30161
39926,2,402,110,256.00,21316.00,30160,30162
39927,1,512,512,512.00,0.00,30161,30162
39928,2,261,251,256.00,25.00,30161,30163
39929,3,501,4,170.67,54561.56,30162,30165
39930,1,512,512,512.00,0.00,30164,30165
39931,1,512,512,512.00,0.00,30164,30165
39932,2,389,123,256.00,17689.00,30164,30166
39933,1,512,512,512.00,0.00,30165,30166
39934,3,344,15,170.67,18196.22,30165,30168
39935,2,371,141,256.00,13225.00,30167,30169
39936,2,385,127,256.00,16641.00,30168,30170
39937,2,338,174,256.00,6724.00,30169,30171
39938,2,406,106,256.00,22500.00,30170,30172
39939,1,512,512,512.00,0.00,30171,30172
39940,1,512,512,512.00,0.00,30171,30172
39941,1,512,512,512.00,0.00,30171,30172
39942,2,300,212,256.00,1936.00,30171,30173
39943,2,313,199,256.00,3249.00,30172,30174
39944,1,512,512,512.00,0.00,30173,30174
39945,1,512,512,512.00,0.00,30173,30174
39946,3,439,2,170.67,36794.89,30173,30176
39947,1,512,512,512.00,0.00,30175,30176
39948,2,296,216,256.00,1600.00,30175,30177
39949,1,512,512,512.00,0.00,30176,30177
39950,1,512,512,512.00,0.00,30176,30177
39951,1,512,512,512.00,0.00,30176,30177
39952,2,420,92,256.00,26896.00,30176,30178
39953,1,512,512,512.00,0.00,30177,30178
39954,4,194,58,128.00,2356.50,30177,30181
39955,1,512,512,512.00,0.00,30180,30181
39956,2,330,182,256.00,5476.00,30180,30182
39957,2,350,162,256.00,8836.00,30181,30183
39958,1,512,512,512.00,0.00,30182,30183
39959,1,512,512,512.00,0.00,30182,30183
39960,1,512,512,512.00,0.00,30182,30183
39961,5,315,21,102.40,12533.44,30182,30187
39962,3,485,2,170.67,49490.89,30186,30189
39963,1,512,512,512.00,0.00,30188,30189
39964,1,512,512,512.00,0.00,30188,30189
39965,1,512,512,512.00,0.00,30188,30189
39966,1,512,512,512.00,0.00,30188,30189
39967,10,189,1,51.20,3715.56,30188,30198
39968,1,512,512,512.00,0.00,30197,30198
39969,1,512,512,512.00,0.00,30197,30198
39970,3,345,3,170.67,19516.22,30197,30200
39971,1,512,512,512.00,0.00,30199,30200
39972,1,512,512,512.00,0.00,30199,30200
39973,6,293,2,85.33,10708.89,30199,30205
39974,1,512,512,512.00,0.00,30204,30205
39975,1,512,512,512.00,0.00,30204,30205
39976,1,512,512,512.00,0.00,30204,30205
39977,1,512,512,512.00,0.00,30204,30205
39978,3,359,21,170.67,19788.22,30204,30207
39979,1,512,512,512.00,0.00,30206,30207
39980,1,512,512,512.00,0.00,30206,30207
39981,1,512,512,512.00,0.00,30206,30207
39982,4,298,6,128.00,15558.50,30206,30210
39983,1,512,512,512.00,0.00,30209,30210
39984,1,512,512,512.00,0.00,30209,30210
39985,1,512,512,512.00,0.00,30209,30210
39986,1,512,512,512.00,0.00,30209,30210
39987,6,354,1,85.33,15634.89,30209,30215
39988,1,512,512,512.00,0.00,30214,30215
39989,1,512,512,512.00,0.00,30214,30215
39990,1,512,512,512.00,0.00,30214,30215
39991,1,512,512,512.00,0.00,30214,30215
39992,2,325,187,256.00,4761.00,30214,30216
39993,3,351,43,170.67,17197.56,30215,30218
39994,1,512,512,512.00,0.00,30217,30218
39995,1,512,512,512.00,0.00,30217,30218
39996,1,512,512,512.00,0.00,30217,30218
39997,2,482,30,256.00,51076.00,30217,30219
39998,1,512,512,512.00,0.00,30218,30219
39999,1,512,512,512.00,0.00,30218,30219
40000,1,512,512,512.00,0.00,30218,30219
40001,1,512,512,512.00,0.00,30218,30219
40002,5,229,1,102.40,6405.04,30218,30223
40003,3,343,3,170.67,19277.56,30222,30225
40004,1,512,512,512.00,0.00,30224,30225
40005,1,512,512,512.00,0.00,30224,30225
40006,2,329,183,256.00,5329.00,30224,30226
40007,1,512,512,512.00,0.00,30225,30226
40008,1,512,512,512.00,0.00,30225,30226
40009,2,434,78,256.00,31684.00,30225,30227
40010,1,512,512,512.00,0.00,30226,30227
40011,1,512,512,512.00,0.00,30226,30227
40012,1,512,512,512.00,0.00,30226,30227
40013,3,500,2,170.67,54240.89,30226,30229
40014,6,287,9,85.33,10281.56,30228,30234
40015,1,512,512,512.00,0.00,30233,30234
40016,1,512,512,512.00,0.00,30233,30234
40017,1,512,512,512.00,0.00,30233,30234
40018,1,512,512,512.00,0.00,30233,30234
40019,3,298,55,170.67,9909.56,30233,30236
40020,5,377,1,102.40,20754.24,30235,30240
40021,1,512,512,512.00,0.00,30239,30240
40022,4,422,1,128.00,29478.50,30239,30243
40023,3,410,38,170.67,28752.89,30242,30245
40024,1,512,512,512.00,0.00,30244,30245
40025,1,512,512,512.00,0.00,30244,30245
40026,1,512,512,512.00,0.00,30244,30245
40027,1,512,512,512.00,0.00,30244,30245
40028,1,512,512,512.00,0.00,30244,30245
40029,1,512,512,512.00,0.00,30244,30245
40030,1,512,512,512.00,0.00,30244,30245
40031,1,512,512,512.00,0.00,30244,30245
40032,3,387,4,170.67,25681.56,30244,30247
40033,1,512,512,512.00,0.00,30246,30247
40034,3,325,56,170.67,12846.89,30246,30249
40035,1,512,512,512.00,0.00,30248,30249
40036,1,512,512,512.00,0.00,30248,30249
40037,4,331,12,128.00,14822.50,30248,30252
40038,2,306,206,256.00,2500.00,30251,30253
40039,1,512,512,512.00,0.00,30252,30253
40040,1,512,512,512.00,0.00,30252,30253
40041,1,512,512,512.00,0.00,30252,30253
40042,3,408,35,170.67,28356.22,30252,30255
40043,3,287,37,170.67,10566.89,30254,30257
40044,1,512,512,512.00,0.00,30256,30257
40045,1,512,512,512.00,0.00,30256,30257
40046,2,352,160,256.00,9216.00,30256,30258
40047,1,512,512,512.00,0.00,30257,30258
40048,1,512,512,512.00,0.00,30257,30258
40049,2,309,203,256.00,2809.00,30257,30259
40050,1,512,512,512.00,0.00,30258,30259
40051,1,512,512,512.00,0.00,30258,30259
40052,1,512,512,512.00,0.00,30258,30259
40053,1,512,512,512.00,0.00,30258,30259
40054,9,308,3,56.89,8378.54,30258,30267
40055,4,242,4,128.00,11810.00,30266,30270
40056,1,512,512,512.00,0.00,30269,30270
40057,1,512,512,512.00,0.00,30269,30270
40058,1,512,512,512.00,0.00,30269,30270
40059,3,304,82,170.67,9211.56,30269,30272
40060,2,288,224,256.00,1024.00,30271,30273
40061,1,512,512,512.00,0.00,30272,30273
40062,1,512,512,512.00,0.00,30272,30273
40063,1,512,512,512.00,0.00,30272,30273
40064,3,412,48,170.67,29123.56,30272,30275
40065,1,512,512,512.00,0.00,30274,30275
40066,1,512,512,512.00,0.00,30274,30275
40067,4,205,89,128.00,2043.50,30274,30278
40068,1,512,512,512.00,0.00,30277,30278
40069,1,512,512,512.00,0.00,30277,30278
40070,1,512,512,512.00,0.00,30277,30278
40071,2,269,243,256.00,169.00,30277,30279
40072,2,465,47,256.00,43681.00,30278,30280
40073,3,400,33,170.67,26649.56,30279,30282
40074,3,390,12,170.67,25654.22,30281,30284
40075,1,512,512,512.00,0.00,30283,30284
40076,2,348,164,256.00,8464.00,30283,30285
40077,2,491,21,256.00,55225.00,30284,30286
40078,3,422,6,170.67,32598.22,30285,30288
40079,1,512,512,512.00,0.00,30287,30288
40080,2,380,132,256.00,15376.00,30287,30289
40081,1,512,512,512.00,0.00,30288,30289
40082,2,509,3,256.00,64009.00,30288,30290
40083,1,512,512,512.00,0.00,30289,30290
40084,6,236,14,85.33,6787.22,30289,30295
40085,5,214,3,102.40,7118.64,30294,30299
40086,1,512,512,512.00,0.00,30298,30299
40087,2,393,119,256.00,18769.00,30298,30300
40088,3,447,2,170.67,38800.22,30299,30302
40089,1,512,512,512.00,0.00,30301,30302
40090,1,512,512,512.00,0.00,30301,30302
40091,5,211,11,102.40,4405.44,30301,30306
40092,2,459,53,256.00,41209.00,30305,30307
40093,1,512,512,512.00,0.00,30306,30307
40094,2,491,21,256.00,55225.00,30306,30308
40095,1,512,512,512.00,0.00,30307,30308
40096,2,349,163,256.00,8649.00,30307,30309
40097,1,512,512,512.00,0.00,30308,30309
40098,1,512,512,512.00,0.00,30308,30309
40099,1,512,512,512.00,0.00,30308,30309
40100,1,512,512,512.00,0.00,30308,30309
40101,1,512,512,512.00,0.00,30308,30309
40102,2,281,231,256.00,625.00,30308,30310
40103,1,512,512,512.00,0.00,30309,30310
40104,4,247,46,128.00,6617.50,30309,30313
40105,1,512,512,512.00,0.00,30312,30313
40106,1,512,512,512.00,0.00,30312,30313
40107,1,512,512,512.00,0.00,30312,30313
40108,1,512,512,512.00,0.00,30312,30313
40109,2,401,111,256.00,21025.00,30312,30314
40110,1,512,512,512.00,0.00,30313,30314
40111,1,512,512,512.00,0.00,30313,30314
40112,3,252,22,170.67,11083.56,30313,30316
40113,1,512,512,512.00,0.00,30315,30316
40114,1,512,512,512.00,0.00,30315,30316
40115,1,512,512,512.00,0.00,30315,30316
40116,3,394,2,170.67,27104.89,30315,30318
40117,2,437,75,256.00,32761.00,30317,30319
40118,1,512,512,512.00,0.00,30318,30319
40119,1,512,512,512.00,0.00,30318,30319
40120,1,512,512,512.00,0.00,30318,30319
40121,4,305,8,128.00,12784.50,30318,30322
40122,2,364,148,256.00,11664.00,30321,30323
40123,2,373,139,256.00,13689.00,30322,30324
40124,1,512,512,512.00,0.00,30323,30324
40125,1,512,512,512.00,0.00,30323,30324
40126,1,512,512,512.00,0.00,30323,30324
40127,2,295,217,256.00,1521.00,30323,30325
40128,1,512,512,512.00,0.00,30324,30325
40129,1,512,512,512.00,0.00,30324,30325
40130,1,512,512,512.00,0.00,30324,30325
40131,1,512,512,512.00,0.00,30324,30325
40132,5,223,3,102.40,7684.64,30324,30329
40133,4,392,7,128.00,24168.50,30328,30332
40134,1,512,512,512.00,0.00,30331,30332
40135,1,512,512,512.00,0.00,30331,30332
40136,1,512,512,512.00,0.00,30331,30332
40137,2,387,125,256.00,17161.00,30331,30333
40138,1,512,512,512.00,0.00,30332,30333
40139,1,512,512,512.00,0.00,30332,30333
40140,1,512,512,512.00,0.00,30332,30333
40141,1,512,512,512.00,0.00,30332,30333
40142,1,512,512,512.00,0.00,30332,30333
40143,1,512,512,512.00,0.00,30332,30333
40144,1,512,512,512.00,0.00,30332,30333
40145,1,512,512,512.00,0.00,30332,30333
40146,1,512,512,512.00,0.00,30332,30333
40147,1,512,512,512.00,0.00,30332,30333
40148,2,468,44,256.00,44944.00,30332,30334
40149,1,512,512,512.00,0.00,30333,30334
40150,1,512,512,512.00,0.00,30333,30334
40151,1,512,512,512.00,0.00,30333,30334
40152,1,512,512,512.00,0.00,30333,30334
40153,1,512,512,512.00,0.00,30333,30334
40154,2,496,16,256.00,57600.00,30333,30335
40155,1,512,512,512.00,0.00,30334,30335
40156,1,512,512,512.00,0.00,30334,30335
40157,1,512,512,512.00,0.00,30334,30335
40158,2,341,171,256.00,7225.00,30334,30336
40159,1,512,512,512.00,0.00,30335,30336
40160,1,512,512,512.00,0.00,30335,30336
40161,2,510,2,256.00,64516.00,30335,30337
40162,2,414,98,256.00,24964.00,30336,30338
40163,3,412,45,170.67,29137.56,30337,30340
40164,6,337,1,85.33,14025.89,30339,30345
40165,1,512,512,512.00,0.00,30344,30345
40166,1,512,512,512.00,0.00,30344,30345
40167,2,493,19,256.00,56169.00,30344,30346
40168,2,335,177,256.00,6241.00,30345,30347
40169,1,512,512,512.00,0.00,30346,30347
40170,1,512,512,512.00,0.00,30346,30347
40171,1,512,512,512.00,0.00,30346,30347
40172,2,256,256,256.00,0.00,30346,30348
40173,1,512,512,512.00,0.00,30347,30348
40174,1,512,512,512.00,0.00,30347,30348
40175,3,254,54,170.67,7222.22,30347,30350
40176,6,230,1,85.33,6947.22,30349,30355
40177,2,484,28,256.00,51984.00,30354,30356
40178,2,322,190,256.00,4356.00,30355,30357
40179,3,474,16,170.67,46011.56,30356,30359
40180,1,512,512,512.00,0.00,30358,30359
40181,2,257,255,256.00,1.00,30358,30360
40182,3,343,1,170.67,19497.56,30359,30362
40183,1,512,512,512.00,0.00,30361,30362
40184,1,512,512,512.00,0.00,30361,30362
40185,1,512,512,512.00,0.00,30362,30363
40186,1,512,512,512.00,0.00,30362,30363
40187,1,512,512,512.00,0.00,30362,30363
40188,1,512,512,512.00,0.00,30362,30363
40189,2,402,110,256.00,21316.00,30362,30364
40190,1,512,512,512.00,0.00,30363,30364
40191,2,455,57,256.00,39601.00,30363,30365
40192,1,512,512,512.00,0.00,30364,30365
40193,1,512,512,512.00,0.00,30364,30365
40194,1,512,512,512.00,0.00,30364,30365
40195,1,512,512,512.00,0.00,30364,30365
40196,4,449,1,128.00,34497.50,30364,30368
40197,1,512,512,512.00,0.00,30367,30368
40198,2,434,78,256.00,31684.00,30367,30369
40199,1,512,512,512.00,0.00,30368,30369
40200,1,512,512,512.00,0.00,30368,30369
40201,2,481,31,256.00,50625.00,30368,30370
40202,1,512,512,512.00,0.00,30369,30370
40203,1,512,512,512.00,0.00,30369,30370
40204,2,311,201,256.00,3025.00,30369,30371
40205,1,512,512,512.00,0.00,30370,30371
40206,1,512,512,512.00,0.00,30370,30371
40207,1,512,512,512.00,0.00,30370,30371
40208,2,391,121,256.00,18225.00,30370,30372
40209,3,282,65,170.67,7864.22,30371,30374
40210,2,336,176,256.00,6400.00,30373,30375
40211,8,198,1,64.00,5095.50,30374,30382
40212,1,512,512,512.00,0.00,30381,30382
40213,1,512,512,512.00,0.00,30381,30382
40214,6,327,1,85.33,12594.89,30381,30387
40215,4,394,2,128.00,24252.50,30386,30390
40216,1,512,512,512.00,0.00,30389,30390
40217,2,448,64,256.00,36864.00,30389,30391
40218,4,183,24,128.00,3775.50,30390,30394
40219,1,512,512,512.00,0.00,30393,30394
40220,3,370,31,170.67,20933.56,30393,30396
40221,1,512,512,512.00,0.00,30395,30396
40222,2,415,97,256.00,25281.00,30395,30397
40223,1,512,512,512.00,0.00,30396,30397
40224,1,512,512,512.00,0.00,30396,30397
40225,1,512,512,512.00,0.00,30396,30397
40226,1,512,512,512.00,0.00,30396,30397
40227,2,432,80,256.00,30976.00,30396,30398
40228,5,376,7,102.40,19320.24,30397,30402
40229,2,297,215,256.00,1681.00,30401,30403
40230,2,463,49,256.00,42849.00,30402,30404
40231,1,512,512,512.00,0.00,30403,30404
40232,1,512,512,512.00,0.00,30403,30404
40233,1,512,512,512.00,0.00,30403,30404
40234,1,512,512,512.00,0.00,30403,30404
40235,3,377,40,170.67,21790.89,30403,30406
40236,1,512,512,512.00,0.00,30405,30406
40237,3,364,1,170.67,22241.56,30405,30408
40238,1,512,512,512.00,0.00,30407,30408
40239,2,499,13,256.00,59049.00,30407,30409
40240,1,512,512,512.00,0.00,30408,30409
40241,1,512,512,512.00,0.00,30408,30409
40242,3,407,6,170.67,29368.22,30408,30411
40243,1,512,512,512.00,0.00,30410,30411
40244,2,437,75,256.00,32761.00,30410,30412
40245,1,512,512,512.00,0.00,30411,30412
40246,4,267,22,128.00,9428.50,30411,30415
40247,1,512,512,512.00,0.00,30414,30415
40248,3,298,19,170.67,13269.56,30414,30417
40249,1,512,512,512.00,0.00,30416,30417
40250,1,512,512,512.00,0.00,30416,30417
40251,3,285,13,170.67,13269.56,30416,30419
40252,1,512,512,512.00,0.00,30418,30419
40253,2,450,62,256.00,37636.00,30418,30420
40254,1,512,512,512.00,0.00,30419,30420
40255,3,251,95,170.67,4066.89,30419,30422
40256,1,512,512,512.00,0.00,30421,30422
40257,1,512,512,512.00,0.00,30421,30422
40258,1,512,512,512.00,0.00,30421,30422
40259,1,512,512,512.00,0.00,30421,30422
40260,2,312,200,256.00,3136.00,30421,30423
40261,4,399,1,128.00,25866.50,30422,30426
40262,1,512,512,512.00,0.00,30425,30426
40263,1,512,512,512.00,0.00,30425,30426
40264,1,512,512,512.00,0.00,30425,30426
40265,2,407,105,256.00,22801.00,30425,30427
40266,6,260,7,85.33,7281.89,30426,30432
40267,2,358,154,256.00,10404.00,30431,30433
40268,1,512,512,512.00,0.00,30432,30433
40269,2,485,27,256.00,52441.00,30432,30434
40270,5,341,15,102.40,14592.64,30433,30438
40271,4,256,16,128.00,11872.00,30437,30441
40272,1,512,512,512.00,0.00,30440,30441
40273,1,512,512,512.00,0.00,30440,30441
40274,1,512,512,512.00,0.00,30440,30441
40275,3,248,122,170.67,3056.89,30440,30443
40276,4,229,12,128.00,8792.50,30442,30446
40277,4,393,3,128.00,25317.00,30445,30449
40278,1,512,512,512.00,0.00,30448,30449
40279,1,512,512,512.00,0.00,30448,30449
40280,4,306,13,128.00,12353.50,30448,30452
40281,1,512,512,512.00,0.00,30451,30452
40282,2,469,43,256.00,45369.00,30451,30453
40283,1,512,512,512.00,0.00,30452,30453
40284,4,418,1,128.00,29198.50,30452,30456
40285,1,512,512,512.00,0.00,30455,30456
40286,1,512,512,512.00,0.00,30455,30456
40287,4,216,1,128.00,6509.50,30455,30459
40288,1,512,512,512.00,0.00,30458,30459
40289,1,512,512,512.00,0.00,30458,30459
40290,1,512,512,512.00,0.00,30458,30459
40291,1,512,512,512.00,0.00,30458,30459
40292,2,366,146,256.00,12100.00,30458,30460
40293,3,236,100,170.67,3096.89,30459,30462
40294,2,342,170,256.00,7396.00,30461,30463
40295,1,512,512,512.00,0.00,30462,30463
40296,3,340,31,170.67,16353.56,30462,30465
40297,2,334,178,256.00,6084.00,30464,30466
40298,1,512,512,512.00,0.00,30465,30466
40299,1,512,512,512.00,0.00,30465,30466
40300,3,407,3,170.67,29560.22,30465,30468
40301,1,512,512,512.00,0.00,30467,30468
40302,1,512,512,512.00,0.00,30467,30468
40303,1,512,512,512.00,0.00,30467,30468
40304,2,471,41,256.00,46225.00,30467,30469
40305,1,512,512,512.00,0.00,30468,30469
40306,1,512,512,512.00,0.00,30468,30469
40307,1,512,512,512.00,0.00,30468,30469
40308,1,512,512,512.00,0.00,30468,30469
40309,1,512,512,512.00,0.00,30468,30469
40310,5,277,19,102.40,9967.84,30468,30473
40311,1,512,512,512.00,0.00,30472,30473
40312,3,268,109,170.67,4849.56,30472,30475
40313,1,512,512,512.00,0.00,30474,30475
40314,1,512,512,512.00,0.00,30474,30475
40315,1,512,512,512.00,0.00,30474,30475
40316,2,284,228,256.00,784.00,30474,30476
40317,2,409,103,256.00,23409.00,30475,30477
40318,1,512,512,512.00,0.00,30476,30477
40319,1,512,512,512.00,0.00,30476,30477
40320,1,512,512,512.00,0.00,30476,30477
40321,1,512,512,512.00,0.00,30476,30477
40322,2,376,136,256.00,14400.00,30476,30478
40323,1,512,512,512.00,0.00,30477,30478
40324,1,512,512,512.00,0.00,30477,30478
40325,1,512,512,512.00,0.00,30477,30478
40326,2,374,138,256.00,13924.00,30477,30479
40327,2,261,251,256.00,25.00,30478,30480
40328,1,512,512,512.00,0.00,30479,30480
40329,1,512,512,512.00,0.00,30479,30480
40330,1,512,512,512.00,0.00,30479,30480
40331,2,419,93,256.00,26569.00,30479,30481
40332,2,479,33,256.00,49729.00,30480,30482
40333,1,512,512,512.00,0.00,30481,30482
40334,1,512,512,512.00,0.00,30481,30482
40335,1,512,512,512.00,0.00,30481,30482
40336,1,512,512,512.00,0.00,30481,30482
40337,1,512,512,512.00,0.00,30481,30482
40338,4,258,3,128.00,12139.50,30481,30485
40339,1,512,512,512.00,0.00,30484,30485
40340,1,512,512,512.00,0.00,30484,30485
40341,2,269,243,256.00,169.00,30484,30486
40342,3,503,3,170.67,55224.22,30485,30488
40343,1,512,512,512.00,0.00,30487,30488
40344,1,512,512,512.00,0.00,30487,30488
40345,2,381,131,256.00,15625.00,30487,30489
40346,1,512,512,512.00,0.00,30488,30489
40347,1,512,512,512.00,0.00,30488,30489
40348,1,512,512,512.00,0.00,30488,30489
40349,1,512,512,512.00,0.00,30488,30489
40350,2,285,227,256.00,841.00,30488,30490
40351,1,512,512,512.00,0.00,30489,30490
40352,1,512,512,512.00,0.00,30489,30490
40353,1,512,512,512.00,0.00,30489,30490
40354,3,339,69,170.67,14372.22,30489,30492
40355,4,232,37,128.00,4948.50,30491,30495
40356,1,512,512,512.00,0.00,30494,30495
40357,3,280,62,170.67,7920.89,30494,30497
40358,1,512,512,512.00,0.00,30496,30497
40359,1,512,512,512.00,0.00,30496,30497
40360,1,512,512,512.00,0.00,30496,30497
40361,2,349,163,256.00,8649.00,30496,30498
40362,1,512,512,512.00,0.00,30497,30498
40363,1,512,512,512.00,0.00,30497,30498
40364,1,512,512,512.00,0.00,30497,30498
40365,1,512,512,512.00,0.00,30497,30498
40366,1,512,512,512.00,0.00,30497,30498
40367,4,250,3,128.00,14649.50,30497,30501
40368,1,512,512,512.00,0.00,30500,30501
40369,1,512,512,512.00,0.00,30500,30501
40370,1,512,512,512.00,0.00,30500,30501
40371,2,508,4,256.00,63504.00,30500,30502
40372,2,294,218,256.00,1444.00,30501,30503
40373,1,512,512,512.00,0.00,30502,30503
40374,1,512,512,512.00,0.00,30502,30503
40375,1,512,512,512.00,0.00,30502,30503
40376,1,512,512,512.00,0.00,30502,30503
40377,3,478,2,170.67,47376.89,30502,30505
40378,1,512,512,512.00,0.00,30504,30505
40379,3,469,21,170.67,44501.56,30504,30507
40380,2,416,96,256.00,25600.00,30506,30508
40381,2,304,208,256.00,2304.00,30507,30509
40382,1,512,512,512.00,0.00,30508,30509
40383,6,330,1,85.33,13661.56,30508,30514
40384,1,512,512,512.00,0.00,30513,30514
40385,2,448,64,256.00,36864.00,30513,30515
40386,2,445,67,256.00,35721.00,30514,30516
40387,4,494,1,128.00,44682.50,30515,30519
40388,1,512,512,512.00,0.00,30518,30519
40389,1,512,512,512.00,0.00,30518,30519
40390,1,512,512,512.00,0.00,30518,30519
40391,3,252,36,170.67,9198.22,30518,30521
40392,2,497,15,256.00,58081.00,30520,30522
40393,1,512,512,512.00,0.00,30521,30522
40394,1,512,512,512.00,0.00,30521,30522
40395,1,512,512,512.00,0.00,30521,30522
40396,2,275,237,256.00,361.00,30521,30523
40397,1,512,512,512.00,0.00,30522,30523
40398,4,243,10,128.00,10443.50,30522,30526
40399,1,512,512,512.00,0.00,30525,30526
40400,1,512,512,512.00,0.00,30525,30526
40401,1,512,512,512.00,0.00,30525,30526
40402,1,512,512,512.00,0.00,30526,30527
40403,1,512,512,512.00,0.00,30526,30527
40404,3,308,12,170.67,14830.22,30526,30529
40405,1,512,512,512.00,0.00,30528,30529
40406,1,512,512,512.00,0.00,30528,30529
40407,1,512,512,512.00,0.00,30528,30529
40408,1,512,512,512.00,0.00,30528,30529
40409,2,394,118,256.00,19044.00,30528,30530
40410,3,300,32,170.67,12014.22,30529,30532
40411,1,512,512,512.00,0.00,30531,30532
40412,2,319,193,256.00,3969.00,30531,30533
40413,1,512,512,512.00,0.00,30532,30533
40414,1,512,512,512.00,0.00,30532,30533
40415,1,512,512,512.00,0.00,30532,30533
40416,2,333,179,256.00,5929.00,30532,30534
40417,4,269,2,128.00,11452.50,30533,30537
40418,1,512,512,512.00,0.00,30536,30537
40419,4,328,1,128.00,18614.50,30536,30540
40420,1,512,512,512.00,0.00,30539,30540
40421,1,512,512,512.00,0.00,30539,30540
40422,4,367,8,128.00,19903.50,30539,30543
40423,1,512,512,512.00,0.00,30542,30543
40424,1,512,512,512.00,0.00,30542,30543
40425,3,266,73,170.67,6210.89,30542,30545
40426,1,512,512,512.00,0.00,30544,30545
40427,1,512,512,512.00,0.00,30544,30545
40428,1,512,512,512.00,0.00,30544,30545
40429,1,512,512,512.00,0.00,30544,30545
40430,1,512,512,512.00,0.00,30544,30545
40431,1,512,512,512.00,0.00,30544,30545
40432,2,445,67,256.00,35721.00,30544,30546
40433,1,512,512,512.00,0.00,30545,30546
40434,1,512,512,512.00,0.00,30545,30546
40435,1,512,512,512.00,0.00,30545,30546
40436,1,512,512,512.00,0.00,30545,30546
40437,1,512,512,512.00,0.00,30545,30546
40438,7,348,3,73.14,13733.55,30545,30552
40439,1,512,512,512.00,0.00,30551,30552
40440,1,512,512,512.00,0.00,30551,30552
40441,3,421,22,170.67,31701.56,30551,30554
40442,2,381,131,256.00,15625.00,30553,30555
40443,1,512,512,512.00,0.00,30554,30555
40444,1,512,512,512.00,0.00,30554,30555
40445,2,464,48,256.00,43264.00,30554,30556
40446,1,512,512,512.00,0.00,30555,30556
40447,1,512,512,512.00,0.00,30555,30556
40448,1,512,512,512.00,0.00,30555,30556
40449,4,232,24,128.00,5570.00,30555,30559
40450,1,512,512,512.00,0.00,30558,30559
40451,2,317,195,256.00,3721.00,30558,30560
40452,8,250,1,64.00,7704.00,30559,30567
40453,1,512,512,512.00,0.00,30566,30567
40454,2,321,191,256.00,4225.00,30566,30568
40455,2,471,41,256.00,46225.00,30567,30569
40456,5,267,1,102.40,9830.24,30568,30573
40457,1,512,512,512.00,0.00,30572,30573
40458,1,512,512,512.00,0.00,30572,30573
40459,1,512,512,512.00,0.00,30572,30573
40460,9,219,4,56.89,3840.54,30572,30581
40461,1,512,512,512.00,0.00,30580,30581
40462,2,491,21,256.00,55225.00,30580,30582
40463,5,314,1,102.40,15155.84,30581,30586
40464,3,271,29,170.67,10614.89,30585,30588
40465,2,474,38,256.00,47524.00,30587,30589
40466,2,465,47,256.00,43681.00,30588,30590
40467,1,512,512,512.00,0.00,30589,30590
40468,2,337,175,256.00,6561.00,30589,30591
40469,1,512,512,512.00,0.00,30590,30591
40470,2,293,219,256.00,1369.00,30590,30592
40471,1,512,512,512.00,0.00,30591,30592
40472,3,397,2,170.67,27666.89,30591,30594
40473,1,512,512,512.00,0.00,30593,30594
40474,1,512,512,512.00,0.00,30593,30594
40475,1,512,512,512.00,0.00,30593,30594
40476,1,512,512,512.00,0.00,30593,30594
40477,5,219,14,102.40,5224.24,30593,30598
40478,1,512,512,512.00,0.00,30597,30598
40479,4,375,9,128.00,21352.50,30597,30601
40480,3,401,38,170.67,26730.89,30600,30603
40481,1,512,512,512.00,0.00,30602,30603
40482,1,512,512,512.00,0.00,30602,30603
40483,1,512,512,512.00,0.00,30602,30603
40484,1,512,512,512.00,0.00,30602,30603
40485,3,273,5,170.67,13976.22,30602,30605
40486,1,512,512,512.00,0.00,30604,30605
40487,1,512,512,512.00,0.00,30604,30605
40488,3,444,1,170.67,38081.56,30604,30607
40489,1,512,512,512.00,0.00,30606,30607
40490,5,452,3,102.40,30651.04,30606,30611
40491,5,291,5,102.40,11124.64,30610,30615
40492,1,512,512,512.00,0.00,30614,30615
40493,1,512,512,512.00,0.00,30614,30615
40494,1,512,512,512.00,0.00,30614,30615
40495,2,322,190,256.00,4356.00,30614,30616
40496,1,512,512,512.00,0.00,30615,30616
40497,4,344,1,128.00,17589.50,30615,30619
40498,1,512,512,512.00,0.00,30618,30619
40499,2,324,188,256.00,4624.00,30618,30620
40500,1,512,512,512.00,0.00,30619,30620
40501,3,400,30,170.67,26747.56,30619,30622
40502,1,512,512,512.00,0.00,30621,30622
40503,1,512,512,512.00,0.00,30621,30622
40504,1,512,512,512.00,0.00,30621,30622
40505,1,512,512,512.00,0.00,30621,30622
40506,1,512,512,512.00,0.00,30621,30622
40507,2,438,74,256.00,33124.00,30621,30623
40508,1,512,512,512.00,0.00,30622,30623
40509,1,512,512,512.00,0.00,30622,30623
40510,2,498,14,256.00,58564.00,30622,30624
40511,3,300,80,170.67,8814.22,30623,30626
40512,2,436,76,256.00,32400.00,30625,30627
40513,1,512,512,512.00,0.00,30626,30627
40514,1,512,512,512.00,0.00,30626,30627
40515,4,421,4,128.00,29176.50,30626,30630
40516,2,391,121,256.00,18225.00,30629,30631
40517,1,512,512,512.00,0.00,30630,30631
40518,3,280,1,170.67,14793.56,30630,30633
40519,1,512,512,512.00,0.00,30632,30633
40520,2,463,49,256.00,42849.00,30632,30634
40521,5,304,2,102.40,12037.04,30633,30638
40522,2,423,89,256.00,27889.00,30637,30639
40523,2,271,241,256.00,225.00,30638,30640
40524,1,512,512,512.00,0.00,30639,30640
40525,1,512,512,512.00,0.00,30639,30640
40526,1,512,512,512.00,0.00,30639,30640
40527,1,512,512,512.00,0.00,30639,30640
40528,2,435,77,256.00,32041.00,30639,30641
40529,7,155,3,73.14,4425.84,30640,30647
40530,2,454,58,256.00,39204.00,30646,30648
40531,1,512,512,512.00,0.00,30647,30648
40532,3,410,34,170.67,28832.89,30647,30650
40533,1,512,512,512.00,0.00,30649,30650
40534,1,512,512,512.00,0.00,30649,30650
40535,2,497,15,256.00,58081.00,30649,30651
40536,1,512,512,512.00,0.00,30650,30651
40537,1,512,512,512.00,0.00,30650,30651
40538,2,418,94,256.00,26244.00,30650,30652
40539,1,512,512,512.00,0.00,30651,30652
40540,1,512,512,512.00,0.00,30651,30652
40541,1,512,512,512.00,0.00,30651,30652
40542,1,512,512,512.00,0.00,30651,30652
40543,3,246,50,170.67,7430.22,30651,30654
40544,1,512,512,512.00,0.00,30653,30654
40545,2,272,240,256.00,256.00,30653,30655
40546,1,512,512,512.00,0.00,30654,30655
40547,1,512,512,512.00,0.00,30654,30655
40548,2,470,42,256.00,45796.00,30654,30656
40549,1,512,512,512.00,0.00,30655,30656
40550,4,313,1,128.00,17059.00,30655,30659
40551,1,512,512,512.00,0.00,30658,30659
40552,1,512,512,512.00,0.00,30658,30659
40553,6,240,3,85.33,9366.89,30658,30664
40554,1,512,512,512.00,0.00,30663,30664
40555,1,512,512,512.00,0.00,30663,30664
40556,2,374,138,256.00,13924.00,30663,30665
40557,1,512,512,512.00,0.00,30664,30665
40558,2,356,156,256.00,10000.00,30664,30666
40559,1,512,512,512.00,0.00,30665,30666
40560,2,452,60,256.00,38416.00,30665,30667
40561,1,512,512,512.00,0.00,30666,30667
40562,2,477,35,256.00,48841.00,30666,30668
40563,1,512,512,512.00,0.00,30667,30668
40564,5,221,36,102.40,4459.04,30667,30672
40565,2,508,4,256.00,63504.00,30671,30673
40566,1,512,512,512.00,0.00,30672,30673
40567,4,190,66,128.00,1922.50,30672,30676
40568,4,217,25,128.00,7037.50,30675,30679
40569,1,512,512,512.00,0.00,30678,30679
40570,1,512,512,512.00,0.00,30678,30679
40571,1,512,512,512.00,0.00,30678,30679
40572,1,512,512,512.00,0.00,30678,30679
40573,3,280,95,170.67,6270.89,30678,30681
40574,1,512,512,512.00,0.00,30680,30681
40575,4,271,29,128.00,7876.50,30680,30684
40576,1,512,512,512.00,0.00,30683,30684
40577,4,310,24,128.00,12033.50,30683,30687
40578,1,512,512,512.00,0.00,30686,30687
40579,1,512,512,512.00,0.00,30686,30687
40580,1,512,512,512.00,0.00,30686,30687
40581,7,226,1,73.14,7242.69,30686,30693
40582,1,512,512,512.00,0.00,30692,30693
40583,3,347,6,170.67,19448.22,30692,30695
40584,1,512,512,512.00,0.00,30694,30695
40585,1,512,512,512.00,0.00,30694,30695
40586,2,424,88,256.00,28224.00,30694,30696
40587,3,464,17,170.67,43054.89,30695,30698
40588,1,512,512,512.00,0.00,30697,30698
40589,1,512,512,512.00,0.00,30697,30698
40590,1,512,512,512.00,0.00,30697,30698
40591,8,224,1,64.00,5608.25,30697,30705
40592,1,512,512,512.00,0.00,30704,30705
40593,1,512,512,512.00,0.00,30704,30705
40594,1,512,512,512.00,0.00,30704,30705
40595,1,512,512,512.00,0.00,30704,30705
40596,2,285,227,256.00,841.00,30704,30706
40597,1,512,512,512.00,0.00,30705,30706
40598,1,512,512,512.00,0.00,30705,30706
40599,5,257,1,102.40,8793.84,30705,30710
40600,1,512,512,512.00,0.00,30709,30710
40601,1,512,512,512.00,0.00,30709,30710
40602,1,512,512,512.00,0.00,30709,30710
40603,4,348,6,128.00,18079.50,30709,30713
40604,1,512,512,512.00,0.00,30712,30713
40605,2,431,81,256.00,30625.00,30712,30714
40606,1,512,512,512.00,0.00,30713,30714
40607,1,512,512,512.00,0.00,30713,30714
40608,1,512,512,512.00,0.00,30713,30714
40609,1,512,512,512.00,0.00,30713,30714
40610,4,259,50,128.00,6982.50,30713,30717
40611,1,512,512,512.00,0.00,30716,30717
40612,1,512,512,512.00,0.00,30716,30717
40613,1,512,512,512.00,0.00,30716,30717
40614,2,500,12,256.00,59536.00,30716,30718
40615,1,512,512,512.00,0.00,30717,30718
40616,2,382,130,256.00,15876.00,30717,30719
40617,1,512,512,512.00,0.00,30718,30719
40618,1,512,512,512.00,0.00,30718,30719
40619,1,512,512,512.00,0.00,30718,30719
40620,1,512,512,512.00,0.00,30718,30719
40621,2,495,17,256.00,57121.00,30718,30720
40622,3,235,43,170.67,8149.56,30719,30722
40623,1,512,512,512.00,0.00,30721,30722
40624,1,512,512,512.00,0.00,30721,30722
40625,1,512,512,512.00,0.00,30721,30722
40626,2,312,200,256.00,3136.00,30721,30723
40627,1,512,512,512.00,0.00,30722,30723
40628,1,512,512,512.00,0.00,30722,30723
40629,1,512,512,512.00,0.00,30722,30723
40630,4,207,36,128.00,5350.50,30722,30726
40631,2,307,205,256.00,2601.00,30725,30727
40632,5,374,1,102.40,20041.04,30726,30731
40633,1,512,512,512.00,0.00,30730,30731
40634,1,512,512,512.00,0.00,30730,30731
40635,1,512,512,512.00,0.00,30730,30731
40636,2,438,74,256.00,33124.00,30730,30732
40637,3,477,5,170.67,47024.22,30731,30734
40638,1,512,512,512.00,0.00,30733,30734
40639,2,490,22,256.00,54756.00,30733,30735
40640,4,390,23,128.00,23188.50,30734,30738
40641,2,507,5,256.00,63001.00,30737,30739
40642,1,512,512,512.00,0.00,30738,30739
40643,1,512,512,512.00,0.00,30738,30739
40644,1,512,512,512.00,0.00,30738,30739
40645,2,421,91,256.00,27225.00,30738,30740
40646,1,512,512,512.00,0.00,30739,30740
40647,1,512,512,512.00,0.00,30739,30740
40648,1,512,512,512.00,0.00,30739,30740
40649,1,512,512,512.00,0.00,30739,30740
40650,2,382,130,256.00,15876.00,30739,30741
40651,1,512,512,512.00,0.00,30740,30741
40652,3,322,22,170.67,15003.56,30740,30743
40653,1,512,512,512.00,0.00,30742,30743
40654,2,496,16,256.00,57600.00,30742,30744
40655,2,463,49,256.00,42849.00,30743,30745
40656,1,512,512,512.00,0.00,30744,30745
40657,1,512,512,512.00,0.00,30744,30745
40658,1,512,512,512.00,0.00,30744,30745
40659,9,277,1,56.89,6644.77,30744,30753
40660,2,475,37,256.00,47961.00,30752,30754
40661,1,512,512,512.00,0.00,30753,30754
40662,1,512,512,512.00,0.00,30753,30754
40663,1,512,512,512.00,0.00,30753,30754
40664,1,512,512,512.00,0.00,30753,30754
40665,1,512,512,512.00,0.00,30753,30754
40666,1,512,512,512.00,0.00,30753,30754
40667,2,497,15,256.00,58081.00,30753,30755
40668,1,512,512,512.00,0.00,30754,30755
40669,4,266,1,128.00,15478.50,30754,30758
40670,1,512,512,512.00,0.00,30757,30758
40671,1,512,512,512.00,0.00,30757,30758
40672,1,512,512,512.00,0.00,30757,30758
40673,3,366,2,170.67,22438.22,30757,30760
40674,1,512,512,512.00,0.00,30759,30760
40675,1,512,512,512.00,0.00,30759,30760
40676,1,512,512,512.00,0.00,30759,30760
40677,1,512,512,512.00,0.00,30759,30760
40678,1,512,512,512.00,0.00,30759,30760
40679,1,512,512,512.00,0.00,30759,30760
40680,1,512,512,512.00,0.00,30759,30760
40681,2,347,165,256.00,8281.00,30759,30761
40682,1,512,512,512.00,0.00,30760,30761
40683,1,512,512,512.00,0.00,30760,30761
40684,2,491,21,256.00,55225.00,30760,30762
40685,1,512,512,512.00,0.00,30761,30762
40686,2,344,168,256.00,7744.00,30761,30763
40687,1,512,512,512.00,0.00,30762,30763
40688,2,329,183,256.00,5329.00,30762,30764
40689,6,231,1,85.33,6859.22,30763,30769
40690,3,446,8,170.67,38320.89,30768,30771
40691,1,512,512,512.00,0.00,30770,30771
40692,1,512,512,512.00,0.00,30770,30771
40693,2,421,91,256.00,27225.00,30770,30772
40694,1,512,512,512.00,0.00,30771,30772
40695,1,512,512,512.00,0.00,30771,30772
40696,1,512,512,512.00,0.00,30771,30772
40697,6,238,2,85.33,9381.22,30771,30777
40698,1,512,512,512.00,0.00,30776,30777
40699,1,512,512,512.00,0.00,30776,30777
40700,5,255,14,102.40,10557.44,30776,30781
40701,1,512,512,512.00,0.00,30780,30781
40702,1,512,512,512.00,0.00,30780,30781
40703,1,512,512,512.00,0.00,30780,30781
40704,8,265,2,64.00,6652.75,30780,30788
40705,2,377,135,256.00,14641.00,30787,30789
40706,1,512,512,512.00,0.00,30788,30789
40707,1,512,512,512.00,0.00,30788,30789
40708,1,512,512,512.00,0.00,30788,30789
40709,4,343,9,128.00,18048.50,30788,30792
40710,2,296,216,256.00,1600.00,30791,30793
40711,1,512,512,512.00,0.00,30792,30793
40712,1,512,512,512.00,0.00,30792,30793
40713,2,280,232,256.00,576.00,30792,30794
40714,4,438,1,128.00,32568.50,30793,30797
40715,10,226,4,51.20,4929.96,30796,30806
40716,2,262,250,256.00,36.00,30805,30807
40717,1,512,512,512.00,0.00,30806,30807
40718,2,442,70,256.00,34596.00,30806,30808
40719,3,490,1,170.67,51053.56,30807,30810
40720,1,512,512,512.00,0.00,30809,30810
40721,1,512,512,512.00,0.00,30809,30810
40722,1,512,512,512.00,0.00,30809,30810
40723,3,455,2,170.67,40890.89,30809,30812
40724,1,512,512,512.00,0.00,30811,30812
40725,1,512,512,512.00,0.00,30811,30812
40726,1,512,512,512.00,0.00,30811,30812
40727,1,512,512,512.00,0.00,30811,30812
40728,7,280,1,73.14,9544.41,30811,30818
40729,1,512,512,512.00,0.00,30817,30818
40730,4,391,1,128.00,25149.00,30817,30821
40731,2,426,86,256.00,28900.00,30820,30822
40732,8,198,1,64.00,5187.00,30821,30829
40733,1,512,512,512.00,0.00,30828,30829
40734,1,512,512,512.00,0.00,30828,30829
40735,1,512,512,512.00,0.00,30828,30829
40736,1,512,512,512.00,0.00,30828,30829
40737,3,252,59,170.67,6668.22,30828,30831
40738,1,512,512,512.00,0.00,30830,30831
40739,1,512,512,512.00,0.00,30830,30831
40740,1,512,512,512.00,0.00,30830,30831
40741,8,157,5,64.00,2504.25,30830,30838
40742,1,512,512,512.00,0.00,30837,30838
40743,3,300,11,170.67,14380.22,30837,30840
40744,1,512,512,512.00,0.00,30839,30840
40745,1,512,512,512.00,0.00,30839,30840
40746,2,333,179,256.00,5929.00,30839,30841
40747,1,512,512,512.00,0.00,30840,30841
40748,5,187,11,102.40,4922.24,30840,30845
40749,2,361,151,256.00,11025.00,30844,30846
40750,4,319,17,128.00,13032.50,30845,30849
40751,9,267,1,56.89,6289.88,30848,30857
40752,6,421,1,85.33,23048.22,30856,30862
40753,4,237,8,128.00,6756.50,30861,30865
40754,1,512,512,512.00,0.00,30864,30865
40755,1,512,512,512.00,0.00,30864,30865
40756,5,151,1,102.40,2985.04,30864,30869
40757,1,512,512,512.00,0.00,30868,30869
40758,1,512,512,512.00,0.00,30868,30869
40759,1,512,512,512.00,0.00,30868,30869
40760,1,512,512,512.00,0.00,30868,30869
40761,7,245,1,73.14,6875.84,30868,30875
40762,1,512,512,512.00,0.00,30874,30875
40763,1,512,512,512.00,0.00,30874,30875
40764,1,512,512,512.00,0.00,30874,30875
40765,1,512,512,512.00,0.00,30874,30875
40766,3,309,45,170.67,11696.22,30874,30877
40767,3,406,1,170.67,29493.56,30876,30879
40768,1,512,512,512.00,0.00,30878,30879
40769,3,421,7,170.67,32321.56,30878,30881
40770,2,460,52,256.00,41616.00,30880,30882
40771,1,512,512,512.00,0.00,30881,30882
40772,3,449,8,170.67,39102.89,30881,30884
40773,1,512,512,512.00,0.00,30883,30884
40774,3,314,1,170.67,16674.89,30883,30886
40775,1,512,512,512.00,0.00,30885,30886
40776,1,512,512,512.00,0.00,30885,30886
40777,1,512,512,512.00,0.00,30885,30886
40778,1,512,512,512.00,0.00,30885,30886
40779,4,303,1,128.00,12901.00,30885,30889
40780,2,493,19,256.00,56169.00,30888,30890
40781,2,506,6,256.00,62500.00,30889,30891
40782,4,160,84,128.00,776.00,30890,30894
40783,1,512,512,512.00,0.00,30893,30894
40784,1,512,512,512.00,0.00,30893,30894
40785,1,512,512,512.00,0.00,30893,30894
40786,2,487,25,256.00,53361.00,30893,30895
40787,5,372,9,102.40,18871.84,30894,30899
40788,3,312,27,170.67,13540.22,30898,30901
40789,1,512,512,512.00,0.00,30900,30901
40790,2,333,179,256.00,5929.00,30900,30902
40791,1,512,512,512.00,0.00,30901,30902
40792,1,512,512,512.00,0.00,30901,30902
40793,1,512,512,512.00,0.00,30901,30902
40794,1,512,512,512.00,0.00,30901,30902
40795,5,360,1,102.40,17193.44,30901,30906
40796,5,209,7,102.40,5543.44,30905,30910
40797,6,217,4,85.33,5464.89,30909,30915
40798,5,208,3,102.40,7345.04,30914,30919
40799,1,512,512,512.00,0.00,30918,30919
40800,1,512,512,512.00,0.00,30918,30919
40801,1,512,512,512.00,0.00,30918,30919
40802,1,512,512,512.00,0.00,30918,30919
40803,7,293,10,73.14,8506.98,30918,30925
40804,6,259,2,85.33,8692.22,30924,30930
40805,1,512,512,512.00,0.00,30929,30930
40806,4,253,35,128.00,6646.50,30929,30933
40807,1,512,512,512.00,0.00,30932,30933
40808,1,512,512,512.00,0.00,30932,30933
40809,1,512,512,512.00,0.00,30932,30933
40810,7,245,1,73.14,11357.27,30932,30939
40811,1,512,512,512.00,0.00,30938,30939
40812,1,512,512,512.00,0.00,30938,30939
40813,1,512,512,512.00,0.00,30938,30939
40814,4,185,7,128.00,4997.00,30938,30942
40815,1,512,512,512.00,0.00,30941,30942
40816,1,512,512,512.00,0.00,30941,30942
40817,3,476,5,170.67,46726.89,30941,30944
40818,5,224,5,102.40,5915.44,30943,30948
40819,1,512,512,512.00,0.00,30947,30948
40820,4,428,2,128.00,30975.50,30947,30951
40821,2,293,219,256.00,1369.00,30950,30952
40822,3,288,35,170.67,10836.22,30951,30954
40823,4,192,27,128.00,4151.50,30953,30957
40824,1,512,512,512.00,0.00,30956,30957
40825,1,512,512,512.00,0.00,30956,30957
40826,1,512,512,512.00,0.00,30956,30957
40827,6,447,2,85.33,26273.56,30956,30962
40828,2,371,141,256.00,13225.00,30961,30963
40829,3,455,4,170.67,40822.89,30962,30965
40830,1,512,512,512.00,0.00,30964,30965
40831,1,512,512,512.00,0.00,30964,30965
40832,4,208,13,128.00,6770.50,30964,30968
40833,10,324,1,51.20,8870.36,30967,30977
40834,3,273,6,170.67,13824.22,30976,30979
40835,1,512,512,512.00,0.00,30978,30979
40836,1,512,512,512.00,0.00,30978,30979
40837,2,313,199,256.00,3249.00,30978,30980
40838,3,385,6,170.67,25173.56,30979,30982
40839,1,512,512,512.00,0.00,30981,30982
40840,2,487,25,256.00,53361.00,30981,30983
40841,2,320,192,256.00,4096.00,30982,30984
40842,4,498,2,128.00,45644.00,30983,30987
40843,2,510,2,256.00,64516.00,30986,30988
40844,1,512,512,512.00,0.00,30987,30988
40845,3,412,28,170.67,29443.56,30987,30990
40846,1,512,512,512.00,0.00,30989,30990
40847,2,411,101,256.00,24025.00,30989,30991
40848,1,512,512,512.00,0.00,30990,30991
40849,1,512,512,512.00,0.00,30990,30991
40850,2,309,203,256.00,2809.00,30990,30992
40851,1,512,512,512.00,0.00,30991,30992
40852,2,301,211,256.00,2025.00,30991,30993
40853,1,512,512,512.00,0.00,30992,30993
40854,1,512,512,512.00,0.00,30992,30993
40855,2,280,232,256.00,576.00,30992,30994
40856,1,512,512,512.00,0.00,30993,30994
40857,2,346,166,256.00,8100.00,30993,30995
40858,3,439,20,170.67,36182.89,30994,30997
40859,4,241,1,128.00,7249.00,30996,31000
40860,1,512,512,512.00,0.00,30999,31000
40861,1,512,512,512.00,0.00,30999,31000
40862,3,242,91,170.67,3834.89,30999,31002
40863,4,380,7,128.00,21957.50,31001,31005
40864,1,512,512,512.00,0.00,31004,31005
40865,1,512,512,512.00,0.00,31004,31005
40866,4,349,2,128.00,18960.50,31004,31008
40867,3,376,20,170.67,22616.89,31007,31010
40868,1,512,512,512.00,0.00,31009,31010
40869,1,512,512,512.00,0.00,31009,31010
40870,2,454,58,256.00,39204.00,31009,31011
40871,1,512,512,512.00,0.00,31010,31011
40872,1,512,512,512.00,0.00,31010,31011
40873,1,512,512,512.00,0.00,31010,31011
40874,1,512,512,512.00,0.00,31010,31011
40875,2,345,167,256.00,7921.00,31010,31012
40876,1,512,512,512.00,0.00,31011,31012
40877,1,512,512,512.00,0.00,31011,31012
40878,1,512,512,512.00,0.00,31011,31012
40879,3,250,61,170.67,6413.56,31011,31014
40880,2,300,212,256.00,1936.00,31013,31015
40881,3,307,64,170.67,10281.56,31014,31017
40882,1,512,512,512.00,0.00,31016,31017
40883,1,512,512,512.00,0.00,31016,31017
40884,5,271,1,102.40,14525.44,31016,31021
40885,4,359,3,128.00,18779.00,31020,31024
40886,6,404,3,85.33,20643.89,31023,31029
40887,1,512,512,512.00,0.00,31028,31029
40888,1,512,512,512.00,0.00,31028,31029
40889,1,512,512,512.00,0.00,31028,31029
40890,3,323,63,170.67,12264.22,31028,31031
40891,1,512,512,512.00,0.00,31030,31031
40892,1,512,512,512.00,0.00,31030,31031
40893,1,512,512,512.00,0.00,31030,31031
40894,2,500,12,256.00,59536.00,31030,31032
40895,1,512,512,512.00,0.00,31031,31032
40896,4,363,1,128.00,20264.50,31031,31035
40897,4,390,1,128.00,24797.50,31034,31038
40898,1,512,512,512.00,0.00,31037,31038
40899,1,512,512,512.00,0.00,31037,31038
40900,3,449,20,170.67,38822.89,31037,31040
40901,7,289,1,73.14,11369.84,31039,31046
40902,1,512,512,512.00,0.00,31045,31046
40903,2,462,50,256.00,42436.00,31045,31047
40904,4,303,15,128.00,11473.50,31046,31050
40905,1,512,512,512.00,0.00,31049,31050
40906,1,512,512,512.00,0.00,31049,31050
40907,2,323,189,256.00,4489.00,31049,31051
40908,1,512,512,512.00,0.00,31050,31051
40909,3,325,63,170.67,12529.56,31050,31053
40910,1,512,512,512.00,0.00,31052,31053
40911,1,512,512,512.00,0.00,31052,31053
40912,3,255,2,170.67,14224.22,31052,31055
40913,1,512,512,512.00,0.00,31054,31055
40914,1,512,512,512.00,0.00,31054,31055
40915,1,512,512,512.00,0.00,31054,31055
40916,1,512,512,512.00,0.00,31054,31055
40917,2,462,50,256.00,42436.00,31054,31056
40918,2,302,210,256.00,2116.00,31055,31057
40919,3,247,58,170.67,6613.56,31056,31059
40920,1,512,512,512.00,0.00,31058,31059
40921,2,498,14,256.00,58564.00,31058,31060
40922,7,197,1,73.14,6085.55,31059,31066
40923,2,344,168,256.00,7744.00,31065,31067
40924,1,512,512,512.00,0.00,31066,31067
40925,1,512,512,512.00,0.00,31066,31067
40926,2,365,147,256.00,11881.00,31066,31068
40927,1,512,512,512.00,0.00,31067,31068
40928,1,512,512,512.00,0.00,31067,31068
40929,1,512,512,512.00,0.00,31067,31068
40930,2,445,67,256.00,35721.00,31067,31069
40931,1,512,512,512.00,0.00,31068,31069
40932,2,289,223,256.00,1089.00,31068,31070
40933,1,512,512,512.00,0.00,31069,31070
40934,1,512,512,512.00,0.00,31069,31070
40935,1,512,512,512.00,0.00,31069,31070
40936,1,512,512,512.00,0.00,31069,31070
40937,2,370,142,256.00,12996.00,31069,31071
40938,1,512,512,512.00,0.00,31070,31071
40939,1,512,512,512.00,0.00,31070,31071
40940,1,512,512,512.00,0.00,31070,31071
40941,7,404,1,73.14,18592.98,31070,31077
40942,1,512,512,512.00,0.00,31076,31077
40943,1,512,512,512.00,0.00,31076,31077
40944,1,512,512,512.00,0.00,31076,31077
40945,3,427,17,170.67,33286.89,31076,31079
40946,1,512,512,512.00,0.00,31078,31079
40947,1,512,512,512.00,0.00,31078,31079
40948,1,512,512,512.00,0.00,31078,31079
40949,5,434,1,102.40,28013.44,31078,31083
40950,1,512,512,512.00,0.00,31082,31083
40951,2,311,201,256.00,3025.00,31082,31084
40952,1,512,512,512.00,0.00,31083,31084
40953,2,304,208,256.00,2304.00,31083,31085
40954,1,512,512,512.00,0.00,31084,31085
40955,1,512,512,512.00,0.00,31084,31085
40956,1,512,512,512.00,0.00,31084,31085
40957,4,457,7,128.00,36213.00,31084,31088
40958,3,358,16,170.67,20027.56,31087,31090
40959,1,512,512,512.00,0.00,31089,31090
40960,2,478,34,256.00,49284.00,31089,31091
40961,2,344,168,256.00,7744.00,31090,31092
40962,3,348,77,170.67,15740.22,31091,31094
40963,1,512,512,512.00,0.00,31093,31094
40964,1,512,512,512.00,0.00,31093,31094
40965,1,512,512,512.00,0.00,31093,31094
40966,2,484,28,256.00,51984.00,31093,31095
40967,1,512,512,512.00,0.00,31094,31095
40968,1,512,512,512.00,0.00,31094,31095
40969,2,336,176,256.00,6400.00,31094,31096
40970,1,512,512,512.00,0.00,31095,31096
40971,1,512,512,512.00,0.00,31095,31096
40972,1,512,512,512.00,0.00,31095,31096
40973,2,430,82,256.00,30276.00,31095,31097
40974,2,319,193,256.00,3969.00,31096,31098
40975,4,341,3,128.00,19181.00,31097,31101
40976,4,258,57,128.00,5986.50,31100,31104
40977,1,512,512,512.00,0.00,31103,31104
40978,2,491,21,256.00,55225.00,31103,31105
40979,3,409,3,170.67,29969.56,31104,31107
40980,1,512,512,512.00,0.00,31106,31107
40981,1,512,512,512.00,0.00,31106,31107
40982,2,421,91,256.00,27225.00,31106,31108
40983,1,512,512,512.00,0.00,31107,31108
40984,1,512,512,512.00,0.00,31107,31108
40985,1,512,512,512.00,0.00,31107,31108
40986,2,441,71,256.00,34225.00,31107,31109
40987,4,198,1,128.00,5939.50,31108,31112
40988,1,512,512,512.00,0.00,31111,31112
40989,1,512,512,512.00,0.00,31111,31112
40990,1,512,512,512.00,0.00,31111,31112
40991,1,512,512,512.00,0.00,31111,31112
40992,3,316,4,170.67,16451.56,31111,31114
40993,2,370,142,256.00,12996.00,31113,31115
40994,1,512,512,512.00,0.00,31114,31115
40995,1,512,512,512.00,0.00,31114,31115
40996,2,324,188,256.00,4624.00,31114,31116
40997,3,379,22,170.67,23021.56,31115,31118
40998,6,250,4,85.33,8041.89,31117,31123
40999,1,512,512,512.00,0.00,31122,31123
41000,1,512,512,512.00,0.00,31122,31123
41001,1,512,512,512.00,0.00,31122,31123
41002,1,512,512,512.00,0.00,31122,31123
41003,3,347,16,170.67,18494.89,31122,31125
41004,1,512,512,512.00,0.00,31124,31125
41005,3,305,11,170.67,14726.89,31124,31127
41006,1,512,512,512.00,0.00,31126,31127
41007,1,512,512,512.00,0.00,31126,31127
41008,1,512,512,512.00,0.00,31126,31127
41009,1,512,512,512.00,0.00,31126,31127
41010,1,512,512,512.00,0.00,31126,31127
41011,1,512,512,512.00,0.00,31126,31127
41012,7,208,4,73.14,4317.55,31126,31133
41013,3,313,2,170.67,16466.89,31132,31135
41014,1,512,512,512.00,0.00,31134,31135
41015,1,512,512,512.00,0.00,31134,31135
41016,1,512,512,512.00,0.00,31134,31135
41017,1,512,512,512.00,0.00,31134,31135
41018,3,284,1,170.67,14934.89,31134,31137
41019,2,342,170,256.00,7396.00,31136,31138
41020,2,394,118,256.00,19044.00,31137,31139
41021,2,386,126,256.00,16900.00,31138,31140
41022,1,512,512,512.00,0.00,31139,31140
41023,1,512,512,512.00,0.00,31139,31140
41024,1,512,512,512.00,0.00,31139,31140
41025,1,512,512,512.00,0.00,31139,31140
41026,4,377,3,128.00,22529.00,31139,31143
41027,4,455,1,128.00,35862.50,31142,31146
41028,2,505,7,256.00,62001.00,31145,31147
41029,1,512,512,512.00,0.00,31146,31147
41030,2,467,45,256.00,44521.00,31146,31148
41031,2,328,184,256.00,5184.00,31147,31149
41032,1,512,512,512.00,0.00,31148,31149
41033,1,512,512,512.00,0.00,31148,31149
41034,4,474,1,128.00,40034.50,31148,31152
41035,1,512,512,512.00,0.00,31151,31152
41036,1,512,512,512.00,0.00,31151,31152
41037,1,512,512,512.00,0.00,31151,31152
41038,4,255,9,128.00,13305.00,31151,31155
41039,5,307,2,102.40,15184.24,31154,31159
41040,1,512,512,512.00,0.00,31158,31159
41041,1,512,512,512.00,0.00,31158,31159
41042,3,193,130,170.67,829.56,31158,31161
41043,1,512,512,512.00,0.00,31160,31161
41044,1,512,512,512.00,0.00,31160,31161
41045,1,512,512,512.00,0.00,31160,31161
41046,1,512,512,512.00,0.00,31160,31161
41047,2,337,175,256.00,6561.00,31160,31162
41048,1,512,512,512.00,0.00,31161,31162
41049,1,512,512,512.00,0.00,31161,31162
41050,3,221,138,170.67,1304.22,31161,31164
41051,1,512,512,512.00,0.00,31163,31164
41052,1,512,512,512.00,0.00,31163,31164
41053,1,512,512,512.00,0.00,31163,31164
41054,2,469,43,256.00,45369.00,31163,31165
41055,6,298,1,85.33,11309.89,31164,31170
41056,3,301,2,170.67,15634.89,31169,31172
41057,1,512,512,512.00,0.00,31171,31172
41058,3,476,12,170.67,46638.22,31171,31174
41059,2,296,216,256.00,1600.00,31173,31175
41060,1,512,512,512.00,0.00,31174,31175
41061,1,512,512,512.00,0.00,31174,31175
41062,1,512,512,512.00,0.00,31174,31175
41063,2,311,201,256.00,3025.00,31174,31176
41064,2,423,89,256.00,27889.00,31175,31177
41065,1,512,512,512.00,0.00,31176,31177
41066,2,367,145,256.00,12321.00,31176,31178
41067,2,316,196,256.00,3600.00,31177,31179
41068,2,393,119,256.00,18769.00,31178,31180
41069,1,512,512,512.00,0.00,31179,31180
41070,1,512,512,512.00,0.00,31179,31180
41071,1,512,512,512.00,0.00,31179,31180
41072,3,343,18,170.67,17797.56,31179,31182
41073,1,512,512,512.00,0.00,31181,31182
41074,5,235,10,102.40,6348.24,31181,31186
41075,6,187,1,85.33,4417.89,31185,31191
41076,1,512,512,512.00,0.00,31190,31191
41077,1,512,512,512.00,0.00,31190,31191
41078,5,396,2,102.40,22019.44,31190,31195
41079,3,452,6,170.67,39958.22,31194,31197
41080,4,270,5,128.00,15196.50,31196,31200
41081,2,338,174,256.00,6724.00,31199,31201
41082,7,218,2,73.14,6021.55,31200,31207
41083,1,512,512,512.00,0.00,31206,31207
41084,1,512,512,512.00,0.00,31206,31207
41085,2,389,123,256.00,17689.00,31206,31208
41086,1,512,512,512.00,0.00,31207,31208
41087,1,512,512,512.00,0.00,31207,31208
41088,2,364,148,256.00,11664.00,31207,31209
41089,1,512,512,512.00,0.00,31208,31209
41090,2,459,53,256.00,41209.00,31208,31210
41091,7,330,3,73.14,11774.69,31209,31216
41092,1,512,512,512.00,0.00,31215,31216
41093,1,512,512,512.00,0.00,31215,31216
41094,3,498,7,170.67,53573.56,31215,31218
41095,3,481,4,170.67,48241.56,31217,31220
41096,1,512,512,512.00,0.00,31219,31220
41097,1,512,512,512.00,0.00,31219,31220
41098,1,512,512,512.00,0.00,31219,31220
41099,2,437,75,256.00,32761.00,31219,31221
41100,1,512,512,512.00,0.00,31220,31221
41101,1,512,512,512.00,0.00,31220,31221
41102,1,512,512,512.00,0.00,31220,31221
41103,4,271,27,128.00,8195.50,31220,31224
41104,2,397,115,256.00,19881.00,31223,31225
41105,3,343,4,170.67,19169.56,31224,31227
41106,12,134,3,42.67,1876.89,31227,31239
41107,1,512,512,512.00,0.00,31238,31239
41108,2,494,18,256.00,56644.00,31238,31240
41109,1,512,512,512.00,0.00,31239,31240
41110,1,512,512,512.00,0.00,31239,31240
41111,3,282,102,170.67,6310.22,31239,31242
41112,3,435,9,170.67,35516.22,31241,31244
41113,3,358,4,170.67,21099.56,31243,31246
41114,3,262,1,170.67,14421.56,31245,31248
41115,2,489,23,256.00,54289.00,31247,31249
41116,1,512,512,512.00,0.00,31248,31249
41117,1,512,512,512.00,0.00,31248,31249
41118,2,472,40,256.00,46656.00,31248,31250
41119,3,201,141,170.67,600.22,31249,31252
41120,3,378,1,170.67,24397.56,31251,31254
41121,3,456,1,170.67,41193.56,31253,31256
41122,1,512,512,512.00,0.00,31255,31256
41123,4,299,2,128.00,12478.50,31255,31259
41124,6,372,1,85.33,16781.89,31258,31264
41125,6,159,34,85.33,1443.56,31263,31269
41126,4,286,18,128.00,9754.00,31268,31272
41127,1,512,512,512.00,0.00,31271,31272
41128,1,512,512,512.00,0.00,31271,31272
41129,1,512,512,512.00,0.00,31271,31272
41130,1,512,512,512.00,0.00,31271,31272
41131,3,260,6,170.67,13590.22,31271,31274
41132,1,512,512,512.00,0.00,31273,31274
41133,2,296,216,256.00,1600.00,31273,31275
41134,1,512,512,512.00,0.00,31274,31275
41135,1,512,512,512.00,0.00,31274,31275
41136,1,512,512,512.00,0.00,31274,31275
41137,1,512,512,512.00,0.00,31274,31275
41138,1,512,512,512.00,0.00,31274,31275
41139,4,232,1,128.00,10543.50,31274,31278
41140,1,512,512,512.00,0.00,31277,31278
41141,1,512,512,512.00,0.00,31277,31278
41142,1,512,512,512.00,0.00,31277,31278
41143,3,413,48,170.67,29364.22,31277,31280
41144,1,512,512,512.00,0.00,31279,31280
41145,3,492,1,170.67,51681.56,31279,31282
41146,2,384,128,256.00,16384.00,31281,31283
41147,2,501,11,256.00,60025.00,31282,31284
41148,1,512,512,512.00,0.00,31283,31284
41149,6,335,11,85.33,12632.56,31283,31289
41150,2,271,241,256.00,225.00,31288,31290
41151,1,512,512,512.00,0.00,31289,31290
41152,3,487,6,170.67,50061.56,31289,31292
41153,2,298,214,256.00,1764.00,31291,31293
41154,1,512,512,512.00,0.00,31292,31293
41155,1,512,512,512.00,0.00,31292,31293
41156,6,231,2,85.33,7143.89,31292,31298
41157,1,512,512,512.00,0.00,31297,31298
41158,1,512,512,512.00,0.00,31297,31298
41159,1,512,512,512.00,0.00,31297,31298
41160,3,228,99,170.67,2876.22,31297,31300
41161,4,407,7,128.00,26853.50,31299,31303
41162,3,267,1,170.67,14481.56,31302,31305
41163,2,308,204,256.00,2704.00,31304,31306
41164,2,355,157,256.00,9801.00,31305,31307
41165,1,512,512,512.00,0.00,31306,31307
41166,1,512,512,512.00,0.00,31306,31307
41167,2,448,64,256.00,36864.00,31306,31308
41168,1,512,512,512.00,0.00,31307,31308
41169,1,512,512,512.00,0.00,31307,31308
41170,1,512,512,512.00,0.00,31307,31308
41171,2,284,228,256.00,784.00,31307,31309
41172,1,512,512,512.00,0.00,31308,31309
41173,1,512,512,512.00,0.00,31308,31309
41174,1,512,512,512.00,0.00,31308,31309
41175,3,466,22,170.67,43611.56,31308,31311
41176,1,512,512,512.00,0.00,31310,31311
41177,5,238,5,102.40,8168.64,31310,31315
41178,2,505,7,256.00,62001.00,31314,31316
41179,1,512,512,512.00,0.00,31315,31316
41180,1,512,512,512.00,0.00,31315,31316
41181,1,512,512,512.00,0.00,31315,31316
41182,1,512,512,512.00,0.00,31315,31316
41183,5,337,15,102.40,14069.44,31315,31320
41184,3,440,4,170.67,36952.89,31319,31322
41185,4,358,8,128.00,18482.00,31321,31325
41186,1,512,512,512.00,0.00,31324,31325
41187,1,512,512,512.00,0.00,31324,31325
41188,1,512,512,512.00,0.00,31324,31325
41189,1,512,512,512.00,0.00,31324,31325
41190,3,393,17,170.67,25920.22,31324,31327
41191,1,512,512,512.00,0.00,31326,31327
41192,1,512,512,512.00,0.00,31326,31327
41193,1,512,512,512.00,0.00,31326,31327
41194,1,512,512,512.00,0.00,31326,31327
41195,3,299,69,170.67,9172.22,31326,31329
41196,1,512,512,512.00,0.00,31328,31329
41197,1,512,512,512.00,0.00,31328,31329
41198,6,347,1,85.33,14501.56,31328,31334
41199,2,438,74,256.00,33124.00,31333,31335
41200,1,512,512,512.00,0.00,31334,31335
41201,1,512,512,512.00,0.00,31334,31335
41202,1,512,512,512.00,0.00,31334,31335
41203,2,476,36,256.00,48400.00,31334,31336
41204,5,245,8,102.40,11639.84,31335,31340
41205,3,460,5,170.67,42150.89,31339,31342
41206,1,512,512,512.00,0.00,31341,31342
41207,1,512,512,512.00,0.00,31341,31342
41208,2,469,43,256.00,45369.00,31341,31343
41209,1,512,512,512.00,0.00,31342,31343
41210,1,512,512,512.00,0.00,31342,31343
41211,1,512,512,512.00,0.00,31342,31343
41212,6,171,12,85.33,4414.89,31342,31348
41213,1,512,512,512.00,0.00,31347,31348
41214,1,512,512,512.00,0.00,31347,31348
41215,2,257,255,256.00,1.00,31347,31349
41216,1,512,512,512.00,0.00,31348,31349
41217,4,230,77,128.00,3876.50,31348,31352
41218,1,512,512,512.00,0.00,31351,31352
41219,3,353,39,170.67,17716.22,31351,31354
41220,2,460,52,256.00,41616.00,31353,31355
41221,1,512,512,512.00,0.00,31354,31355
41222,3,322,5,170.67,16850.89,31354,31357
41223,2,454,58,256.00,39204.00,31356,31358
41224,2,500,12,256.00,59536.00,31357,31359
41225,3,490,6,170.67,51003.56,31358,31361
41226,2,504,8,256.00,61504.00,31360,31362
41227,1,512,512,512.00,0.00,31361,31362
41228,1,512,512,512.00,0.00,31361,31362
41229,1,512,512,512.00,0.00,31361,31362
41230,4,243,17,128.00,7956.50,31361,31365
41231,1,512,512,512.00,0.00,31364,31365
41232,1,512,512,512.00,0.00,31364,31365
41233,1,512,512,512.00,0.00,31364,31365
41234,1,512,512,512.00,0.00,31364,31365
41235,2,390,122,256.00,17956.00,31364,31366
41236,1,512,512,512.00,0.00,31365,31366
41237,3,306,6,170.67,15430.22,31365,31368
41238,1,512,512,512.00,0.00,31367,31368
41239,1,512,512,512.00,0.00,31367,31368
41240,1,512,512,512.00,0.00,31367,31368
41241,12,189,3,42.67,2523.06,31367,31379
41242,1,512,512,512.00,0.00,31378,31379
41243,1,512,512,512.00,0.00,31378,31379
41244,3,207,103,170.67,2293.56,31378,31381
41245,1,512,512,512.00,0.00,31380,31381
41246,5,317,1,102.40,12547.84,31380,31385
41247,4,458,2,128.00,36638.00,31384,31388
41248,1,512,512,512.00,0.00,31387,31388
41249,1,512,512,512.00,0.00,31387,31388
41250,3,340,1,170.67,19153.56,31387,31390
41251,4,248,21,128.00,7809.50,31389,31393
41252,2,476,36,256.00,48400.00,31392,31394
41253,1,512,512,512.00,0.00,31393,31394
41254,3,334,67,170.67,13661.56,31393,31396
41255,1,512,512,512.00,0.00,31395,31396
41256,1,512,512,512.00,0.00,31395,31396
41257,1,512,512,512.00,0.00,31395,31396
41258,1,512,512,512.00,0.00,31395,31396
41259,3,491,3,170.67,51344.22,31395,31398
41260,1,512,512,512.00,0.00,31397,31398
41261,1,512,512,512.00,0.00,31397,31398
41262,2,486,26,256.00,52900.00,31397,31399
41263,1,512,512,512.00,0.00,31398,31399
41264,1,512,512,512.00,0.00,31398,31399
41265,5,383,1,102.40,20426.24,31398,31403
41266,1,512,512,512.00,0.00,31402,31403
41267,5,328,2,102.40,14855.04,31402,31407
41268,2,283,229,256.00,729.00,31406,31408
41269,2,427,85,256.00,29241.00,31407,31409
41270,1,512,512,512.00,0.00,31408,31409
41271,1,512,512,512.00,0.00,31408,31409
41272,4,345,4,128.00,16707.50,31408,31412
41273,1,512,512,512.00,0.00,31411,31412
41274,1,512,512,512.00,0.00,31411,31412
41275,1,512,512,512.00,0.00,31411,31412
41276,3,397,14,170.67,26874.89,31411,31414
41277,1,512,512,512.00,0.00,31413,31414
41278,1,512,512,512.00,0.00,31413,31414
41279,1,512,512,512.00,0.00,31413,31414
41280,1,512,512,512.00,0.00,31413,31414
41281,1,512,512,512.00,0.00,31413,31414
41282,1,512,512,512.00,0.00,31413,31414
41283,3,380,35,170.67,22550.89,31413,31416
41284,1,512,512,512.00,0.00,31415,31416
41285,1,512,512,512.00,0.00,31415,31416
41286,1,512,512,512.00,0.00,31415,31416
41287,1,512,512,512.00,0.00,31415,31416
41288,1,512,512,512.00,0.00,31415,31416
41289,1,512,512,512.00,0.00,31415,31416
41290,1,512,512,512.00,0.00,31415,31416
41291,1,512,512,512.00,0.00,31415,31416
41292,1,512,512,512.00,0.00,31415,31416
41293,3,379,2,170.67,24474.89,31415,31418
41294,2,378,134,256.00,14884.00,31417,31419
41295,1,512,512,512.00,0.00,31418,31419
41296,1,512,512,512.00,0.00,31418,31419
41297,2,443,69,256.00,34969.00,31418,31420
41298,1,512,512,512.00,0.00,31419,31420
41299,1,512,512,512.00,0.00,31419,31420
41300,1,512,512,512.00,0.00,31419,31420
41301,1,512,512,512.00,0.00,31419,31420
41302,1,512,512,512.00,0.00,31419,31420
41303,3,412,2,170.67,30656.89,31419,31422
41304,1,512,512,512.00,0.00,31421,31422
41305,1,512,512,512.00,0.00,31421,31422
41306,2,279,233,256.00,529.00,31421,31423
41307,3,303,2,170.67,15760.22,31422,31425
41308,3,365,21,170.67,20720.22,31424,31427
41309,2,325,187,256.00,4761.00,31426,31428
41310,3,303,24,170.67,13076.22,31427,31430
41311,5,460,1,102.40,32174.64,31429,31434
41312,1,512,512,512.00,0.00,31433,31434
41313,1,512,512,512.00,0.00,31433,31434
41314,5,229,9,102.40,5729.44,31433,31438
41315,1,512,512,512.00,0.00,31437,31438
41316,1,512,512,512.00,0.00,31437,31438
41317,2,322,190,256.00,4356.00,31437,31439
41318,1,512,512,512.00,0.00,31438,31439
41319,4,279,2,128.00,9757.50,31438,31442
41320,4,264,27,128.00,9472.50,31441,31445
41321,4,449,7,128.00,34533.00,31444,31448
41322,3,490,2,170.67,51040.89,31447,31450
41323,2,369,143,256.00,12769.00,31449,31451
41324,1,512,512,512.00,0.00,31450,31451
41325,1,512,512,512.00,0.00,31450,31451
41326,1,512,512,512.00,0.00,31450,31451
41327,2,329,183,256.00,5329.00,31450,31452
41328,1,512,512,512.00,0.00,31451,31452
41329,1,512,512,512.00,0.00,31451,31452
41330,3,265,3,170.67,14129.56,31451,31454
41331,2,281,231,256.00,625.00,31453,31455
41332,3,199,146,170.67,474.89,31454,31457
41333,3,374,1,170.67,23754.89,31456,31459
41334,4,348,15,128.00,16724.50,31458,31462
41335,1,512,512,512.00,0.00,31461,31462
41336,1,512,512,512.00,0.00,31461,31462
41337,1,512,512,512.00,0.00,31461,31462
41338,2,342,170,256.00,7396.00,31461,31463
41339,2,478,34,256.00,49284.00,31462,31464
41340,1,512,512,512.00,0.00,31463,31464
41341,1,512,512,512.00,0.00,31463,31464
41342,1,512,512,512.00,0.00,31463,31464
41343,1,512,512,512.00,0.00,31463,31464
41344,4,197,19,128.00,4725.00,31463,31467
41345,1,512,512,512.00,0.00,31466,31467
41346,1,512,512,512.00,0.00,31466,31467
41347,1,512,512,512.00,0.00,31466,31467
41348,1,512,512,512.00,0.00,31466,31467
41349,2,431,81,256.00,30625.00,31466,31468
41350,1,512,512,512.00,0.00,31467,31468
41351,5,350,1,102.40,18469.04,31467,31472
41352,2,433,79,256.00,31329.00,31471,31473
41353,5,330,11,102.40,14355.44,31472,31477
41354,1,512,512,512.00,0.00,31476,31477
41355,2,343,169,256.00,7569.00,31476,31478
41356,1,512,512,512.00,0.00,31477,31478
41357,1,512,512,512.00,0.00,31477,31478
41358,2,465,47,256.00,43681.00,31477,31479
41359,1,512,512,512.00,0.00,31478,31479
41360,1,512,512,512.00,0.00,31478,31479
41361,3,497,5,170.67,53250.89,31478,31481
41362,3,450,3,170.67,39536.22,31480,31483
41363,1,512,512,512.00,0.00,31482,31483
41364,2,393,119,256.00,18769.00,31482,31484
41365,2,417,95,256.00,25921.00,31483,31485
41366,2,342,170,256.00,7396.00,31484,31486
41367,1,512,512,512.00,0.00,31485,31486
41368,2,325,187,256.00,4761.00,31485,31487
41369,1,512,512,512.00,0.00,31486,31487
41370,1,512,512,512.00,0.00,31486,31487
41371,1,512,512,512.00,0.00,31486,31487
41372,1,512,512,512.00,0.00,31486,31487
41373,3,386,15,170.67,24720.22,31486,31489
41374,2,356,156,256.00,10000.00,31488,31490
41375,1,512,512,512.00,0.00,31489,31490
41376,2,486,26,256.00,52900.00,31489,31491
41377,1,512,512,512.00,0.00,31490,31491
41378,2,319,193,256.00,3969.00,31490,31492
41379,4,263,3,128.00,13179.50,31491,31495
41380,1,512,512,512.00,0.00,31494,31495
41381,2,386,126,256.00,16900.00,31494,31496
41382,1,512,512,512.00,0.00,31495,31496
41383,1,512,512,512.00,0.00,31495,31496
41384,4,267,1,128.00,15725.00,31495,31499
41385,1,512,512,512.00,0.00,31498,31499
41386,3,272,104,170.67,5304.89,31498,31501
41387,4,256,9,128.00,12111.50,31500,31504
41388,1,512,512,512.00,0.00,31503,31504
41389,4,453,6,128.00,35369.50,31503,31507
41390,1,512,512,512.00,0.00,31506,31507
41391,1,512,512,512.00,0.00,31506,31507
41392,1,512,512,512.00,0.00,31506,31507
41393,1,512,512,512.00,0.00,31506,31507
41394,1,512,512,512.00,0.00,31506,31507
41395,1,512,512,512.00,0.00,31506,31507
41396,2,443,69,256.00,34969.00,31506,31508
41397,1,512,512,512.00,0.00,31507,31508
41398,1,512,512,512.00,0.00,31507,31508
41399,1,512,512,512.00,0.00,31507,31508
41400,1,512,512,512.00,0.00,31507,31508
41401,1,512,512,512.00,0.00,31507,31508
41402,2,477,35,256.00,48841.00,31507,31509
41403,3,287,40,170.67,10270.89,31508,31511
41404,1,512,512,512.00,0.00,31510,31511
41405,1,512,512,512.00,0.00,31510,31511
41406,6,219,2,85.33,7631.56,31510,31516
41407,1,512,512,512.00,0.00,31515,31516
41408,1,512,512,512.00,0.00,31515,31516
41409,1,512,512,512.00,0.00,31515,31516
41410,5,233,1,102.40,8773.44,31515,31520
41411,1,512,512,512.00,0.00,31519,31520
41412,1,512,512,512.00,0.00,31519,31520
41413,2,281,231,256.00,625.00,31519,31521
41414,1,512,512,512.00,0.00,31520,31521
41415,1,512,512,512.00,0.00,31520,31521
41416,1,512,512,512.00,0.00,31520,31521
41417,3,378,2,170.67,24310.22,31520,31523
41418,3,369,1,170.67,22981.56,31522,31525
41419,3,484,2,170.67,49184.89,31524,31527
41420,1,512,512,512.00,0.00,31526,31527
41421,2,462,50,256.00,42436.00,31526,31528
41422,3,313,82,170.67,10333.56,31527,31530
41423,1,512,512,512.00,0.00,31529,31530
41424,6,224,1,85.33,8537.22,31529,31535
41425,1,512,512,512.00,0.00,31534,31535
41426,1,512,512,512.00,0.00,31534,31535
41427,2,378,134,256.00,14884.00,31534,31536
41428,2,260,252,256.00,16.00,31535,31537
41429,1,512,512,512.00,0.00,31536,31537
41430,8,274,1,64.00,7863.50,31536,31544
41431,2,474,38,256.00,47524.00,31543,31545
41432,2,330,182,256.00,5476.00,31544,31546
41433,2,484,28,256.00,51984.00,31545,31547
41434,5,332,3,102.40,14694.64,31546,31551
41435,3,275,21,170.67,11780.22,31550,31553
41436,1,512,512,512.00,0.00,31552,31553
41437,4,328,6,128.00,14794.00,31552,31556
41438,2,362,150,256.00,11236.00,31555,31557
41439,1,512,512,512.00,0.00,31556,31557
41440,1,512,512,512.00,0.00,31556,31557
41441,1,512,512,512.00,0.00,31556,31557
41442,3,357,1,170.67,21261.56,31556,31559
41443,1,512,512,512.00,0.00,31558,31559
41444,1,512,512,512.00,0.00,31558,31559
41445,1,512,512,512.00,0.00,31558,31559
41446,2,366,146,256.00,12100.00,31558,31560
41447,5,341,5,102.40,15391.04,31559,31564
41448,1,512,512,512.00,0.00,31563,31564
41449,1,512,512,512.00,0.00,31563,31564
41450,1,512,512,512.00,0.00,31563,31564
41451,1,512,512,512.00,0.00,31563,31564
41452,1,512,512,512.00,0.00,31563,31564
41453,3,338,32,170.67,16016.89,31563,31566
41454,1,512,512,512.00,0.00,31565,31566
41455,1,512,512,512.00,0.00,31565,31566
41456,1,512,512,512.00,0.00,31565,31566
41457,2,415,97,256.00,25281.00,31565,31567
41458,1,512,512,512.00,0.00,31566,31567
41459,1,512,512,512.00,0.00,31566,31567
41460,1,512,512,512.00,0.00,31566,31567
41461,2,347,165,256.00,8281.00,31566,31568
41462,4,262,9,128.00,10685.50,31567,31571
41463,1,512,512,512.00,0.00,31570,31571
41464,1,512,512,512.00,0.00,31570,31571
41465,1,512,512,512.00,0.00,31570,31571
41466,1,512,512,512.00,0.00,31570,31571
41467,4,465,8,128.00,37933.50,31570,31574
41468,1,512,512,512.00,0.00,31573,31574
41469,1,512,512,512.00,0.00,31573,31574
41470,1,512,512,512.00,0.00,31573,31574
41471,6,190,1,85.33,5709.56,31573,31579
41472,1,512,512,512.00,0.00,31578,31579
41473,1,512,512,512.00,0.00,31578,31579
41474,1,512,512,512.00,0.00,31578,31579
41475,4,411,6,128.00,27004.50,31578,31582
41476,2,375,137,256.00,14161.00,31581,31583
41477,2,370,142,256.00,12996.00,31582,31584
41478,3,434,17,170.67,34994.89,31583,31586
41479,1,512,512,512.00,0.00,31585,31586
41480,5,227,11,102.40,5913.84,31585,31590
41481,1,512,512,512.00,0.00,31589,31590
41482,1,512,512,512.00,0.00,31589,31590
41483,3,261,49,170.67,7981.56,31589,31592
41484,1,512,512,512.00,0.00,31591,31592
41485,2,446,66,256.00,36100.00,31591,31593
41486,1,512,512,512.00,0.00,31592,31593
41487,1,512,512,512.00,0.00,31592,31593
41488,1,512,512,512.00,0.00,31592,31593
41489,2,326,186,256.00,4900.00,31592,31594
41490,1,512,512,512.00,0.00,31593,31594
41491,1,512,512,512.00,0.00,31593,31594
41492,2,287,225,256.00,961.00,31593,31595
41493,1,512,512,512.00,0.00,31594,31595
41494,3,357,1,170.67,21261.56,31594,31597
41495,1,512,512,512.00,0.00,31596,31597
41496,1,512,512,512.00,0.00,31596,31597
41497,1,512,512,512.00,0.00,31596,31597
41498,1,512,512,512.00,0.00,31596,31597
41499,2,300,212,256.00,1936.00,31596,31598
41500,3,304,5,170.67,15422.89,31597,31600
41501,8,200,1,64.00,5354.25,31600,31608
41502,2,498,14,256.00,58564.00,31607,31609
41503,1,512,512,512.00,0.00,31608,31609
41504,3,486,12,170.67,49718.22,31608,31611
41505,1,512,512,512.00,0.00,31610,31611
41506,3,265,22,170.67,11317.56,31610,31613
41507,1,512,512,512.00,0.00,31612,31613
41508,1,512,512,512.00,0.00,31612,31613
41509,1,512,512,512.00,0.00,31612,31613
41510,2,474,38,256.00,47524.00,31612,31614
41511,5,300,2,102.40,10600.64,31613,31618
41512,2,369,143,256.00,12769.00,31617,31619
41513,1,512,512,512.00,0.00,31618,31619
41514,1,512,512,512.00,0.00,31618,31619
41515,1,512,512,512.00,0.00,31618,31619
41516,2,457,55,256.00,40401.00,31618,31620
41517,1,512,512,512.00,0.00,31619,31620
41518,1,512,512,512.00,0.00,31619,31620
41519,1,512,512,512.00,0.00,31619,31620
41520,1,512,512,512.00,0.00,31619,31620
41521,1,512,512,512.00,0.00,31619,31620
41522,1,512,512,512.00,0.00,31619,31620
41523,2,285,227,256.00,841.00,31619,31621
41524,3,465,8,170.67,43476.22,31620,31623
41525,1,512,512,512.00,0.00,31622,31623
41526,1,512,512,512.00,0.00,31622,31623
41527,1,512,512,512.00,0.00,31622,31623
41528,3,270,29,170.67,10576.22,31622,31625
41529,1,512,512,512.00,0.00,31624,31625
41530,1,512,512,512.00,0.00,31624,31625
41531,1,512,512,512.00,0.00,31624,31625
41532,1,512,512,512.00,0.00,31624,31625
41533,2,379,133,256.00,15129.00,31624,31626
41534,3,329,2,170.67,17874.89,31625,31628
41535,1,512,512,512.00,0.00,31627,31628
41536,3,283,58,170.67,8437.56,31627,31630
41537,1,512,512,512.00,0.00,31629,31630
41538,3,220,107,170.67,2230.89,31629,31632
41539,1,512,512,512.00,0.00,31631,31632
41540,1,512,512,512.00,0.00,31631,31632
41541,1,512,512,512.00,0.00,31631,31632
41542,2,368,144,256.00,12544.00,31631,31633
41543,1,512,512,512.00,0.00,31632,31633
41544,1,512,512,512.00,0.00,31632,31633
41545,4,344,1,128.00,19767.50,31632,31636
41546,1,512,512,512.00,0.00,31635,31636
41547,4,315,1,128.00,16112.50,31635,31639
41548,4,316,5,128.00,14799.50,31638,31642
41549,1,512,512,512.00,0.00,31641,31642
41550,4,446,2,128.00,33866.00,31641,31645
41551,1,512,512,512.00,0.00,31644,31645
41552,4,442,6,128.00,33002.50,31644,31648
41553,1,512,512,512.00,0.00,31647,31648
41554,1,512,512,512.00,0.00,31647,31648
41555,2,293,219,256.00,1369.00,31647,31649
41556,1,512,512,512.00,0.00,31648,31649
41557,1,512,512,512.00,0.00,31648,31649
41558,1,512,512,512.00,0.00,31648,31649
41559,2,280,232,256.00,576.00,31648,31650
41560,2,461,51,256.00,42025.00,31649,31651
41561,1,512,512,512.00,0.00,31650,31651
41562,1,512,512,512.00,0.00,31650,31651
41563,1,512,512,512.00,0.00,31650,31651
41564,1,512,512,512.00,0.00,31650,31651
41565,2,300,212,256.00,1936.00,31650,31652
41566,1,512,512,512.00,0.00,31651,31652
41567,3,403,9,170.67,28369.56,31651,31654
41568,1,512,512,512.00,0.00,31653,31654
41569,1,512,512,512.00,0.00,31653,31654
41570,3,425,1,170.67,33546.89,31653,31656
41571,5,415,1,102.40,24815.44,31655,31660
41572,4,272,1,128.00,9658.50,31659,31663
41573,3,397,25,170.67,26317.56,31662,31665
41574,1,512,512,512.00,0.00,31664,31665
41575,2,303,209,256.00,2209.00,31664,31666
41576,2,361,151,256.00,11025.00,31665,31667
41577,1,512,512,512.00,0.00,31666,31667
41578,2,386,126,256.00,16900.00,31666,31668
41579,1,512,512,512.00,0.00,31667,31668
41580,3,345,31,170.67,17033.56,31667,31670
41581,4,339,14,128.00,16150.50,31669,31673
41582,6,314,1,85.33,10892.22,31672,31678
41583,5,280,14,102.40,8573.84,31677,31682
41584,1,512,512,512.00,0.00,31681,31682
41585,3,506,1,170.67,56226.89,31681,31684
41586,3,389,3,170.67,26116.22,31683,31686
41587,1,512,512,512.00,0.00,31685,31686
41588,1,512,512,512.00,0.00,31685,31686
41589,2,440,72,256.00,33856.00,31685,31687
41590,1,512,512,512.00,0.00,31686,31687
41591,1,512,512,512.00,0.00,31686,31687
41592,1,512,512,512.00,0.00,31686,31687
41593,3,332,10,170.67,17280.89,31686,31689
41594,3,499,1,170.67,53921.56,31688,31691
41595,1,512,512,512.00,0.00,31690,31691
41596,1,512,512,512.00,0.00,31690,31691
41597,2,475,37,256.00,47961.00,31690,31692
41598,1,512,512,512.00,0.00,31691,31692
41599,1,512,512,512.00,0.00,31691,31692
41600,7,173,1,73.14,4249.27,31691,31698
41601,1,512,512,512.00,0.00,31697,31698
41602,1,512,512,512.00,0.00,31697,31698
41603,2,485,27,256.00,52441.00,31697,31699
41604,4,426,10,128.00,29764.00,31698,31702
41605,1,512,512,512.00,0.00,31701,31702
41606,3,313,15,170.67,14889.56,31701,31704
41607,1,512,512,512.00,0.00,31703,31704
41608,1,512,512,512.00,0.00,31703,31704
41609,2,310,202,256.00,2916.00,31703,31705
41610,3,408,9,170.67,29396.22,31704,31707
41611,9,296,1,56.89,10221.43,31706,31715
41612,2,460,52,256.00,41616.00,31714,31716
41613,1,512,512,512.00,0.00,31715,31716
41614,1,512,512,512.00,0.00,31715,31716
41615,1,512,512,512.00,0.00,31715,31716
41616,2,421,91,256.00,27225.00,31715,31717
41617,5,281,6,102.40,11097.04,31716,31721
41618,1,512,512,512.00,0.00,31720,31721
41619,1,512,512,512.00,0.00,31720,31721
41620,1,512,512,512.00,0.00,31720,31721
41621,5,309,11,102.40,11575.84,31720,31725
41622,1,512,512,512.00,0.00,31724,31725
41623,1,512,512,512.00,0.00,31724,31725
41624,1,512,512,512.00,0.00,31724,31725
41625,2,418,94,256.00,26244.00,31724,31726
41626,4,355,23,128.00,17517.00,31726,31730
41627,1,512,512,512.00,0.00,31729,31730
41628,4,274,1,128.00,14762.50,31729,31733
41629,2,326,186,256.00,4900.00,31732,31734
41630,2,471,41,256.00,46225.00,31733,31735
41631,1,512,512,512.00,0.00,31734,31735
41632,1,512,512,512.00,0.00,31734,31735
41633,1,512,512,512.00,0.00,31734,31735
41634,2,490,22,256.00,54756.00,31734,31736
41635,5,446,5,102.40,29599.44,31735,31740
41636,1,512,512,512.00,0.00,31739,31740
41637,2,494,18,256.00,56644.00,31739,31741
41638,1,512,512,512.00,0.00,31740,31741
41639,3,330,1,170.67,18093.56,31740,31743
41640,1,512,512,512.00,0.00,31742,31743
41641,5,384,9,102.40,20705.84,31742,31747
41642,1,512,512,512.00,0.00,31746,31747
41643,1,512,512,512.00,0.00,31746,31747
41644,1,512,512,512.00,0.00,31746,31747
41645,1,512,512,512.00,0.00,31746,31747
41646,1,512,512,512.00,0.00,31746,31747
41647,1,512,512,512.00,0.00,31746,31747
41648,1,512,512,512.00,0.00,31746,31747
41649,1,512,512,512.00,0.00,31746,31747
41650,7,241,1,73.14,9183.55,31746,31753
41651,1,512,512,512.00,0.00,31752,31753
41652,4,358,1,128.00,18611.50,31752,31756
41653,1,512,512,512.00,0.00,31755,31756
41654,2,334,178,256.00,6084.00,31755,31757
41655,1,512,512,512.00,0.00,31756,31757
41656,1,512,512,512.00,0.00,31756,31757
41657,1,512,512,512.00,0.00,31756,31757
41658,1,512,512,512.00,0.00,31756,31757
41659,4,270,1,128.00,16241.50,31756,31760
41660,1,512,512,512.00,0.00,31759,31760
41661,1,512,512,512.00,0.00,31759,31760
41662,1,512,512,512.00,0.00,31759,31760
41663,3,403,14,170.67,28082.89,31759,31762
41664,1,512,512,512.00,0.00,31761,31762
41665,1,512,512,512.00,0.00,31761,31762
41666,1,512,512,512.00,0.00,31761,31762
41667,1,512,512,512.00,0.00,31761,31762
41668,3,399,1,170.67,28121.56,31761,31764
41669,2,469,43,256.00,45369.00,31763,31765
41670,1,512,512,512.00,0.00,31764,31765
41671,2,400,112,256.00,20736.00,31764,31766
41672,1,512,512,512.00,0.00,31765,31766
41673,2,497,15,256.00,58081.00,31765,31767
41674,1,512,512,512.00,0.00,31766,31767
41675,1,512,512,512.00,0.00,31766,31767
41676,1,512,512,512.00,0.00,31766,31767
41677,2,325,187,256.00,4761.00,31766,31768
41678,1,512,512,512.00,0.00,31767,31768
41679,2,450,62,256.00,37636.00,31767,31769
41680,2,340,172,256.00,7056.00,31768,31770
41681,5,258,6,102.40,7022.64,31769,31774
41682,1,512,512,512.00,0.00,31773,31774
41683,1,512,512,512.00,0.00,31773,31774
41684,3,261,53,170.67,7584.22,31773,31776
41685,2,431,81,256.00,30625.00,31775,31777
41686,1,512,512,512.00,0.00,31776,31777
41687,1,512,512,512.00,0.00,31776,31777
41688,2,323,189,256.00,4489.00,31776,31778
41689,1,512,512,512.00,0.00,31777,31778
41690,4,363,1,128.00,19777.00,31777,31781
41691,1,512,512,512.00,0.00,31780,31781
41692,1,512,512,512.00,0.00,31780,31781
41693,5,324,1,102.40,15882.64,31780,31785
41694,1,512,512,512.00,0.00,31784,31785
41695,1,512,512,512.00,0.00,31784,31785
41696,1,512,512,512.00,0.00,31784,31785
41697,4,359,33,128.00,17980.50,31784,31788
41698,1,512,512,512.00,0.00,31787,31788
41699,1,512,512,512.00,0.00,31787,31788
41700,8,341,1,64.00,11749.25,31787,31795
41701,1,512,512,512.00,0.00,31794,31795
41702,1,512,512,512.00,0.00,31794,31795
41703,2,421,91,256.00,27225.00,31794,31796
41704,1,512,512,512.00,0.00,31795,31796
41705,5,324,3,102.40,14641.84,31795,31800
41706,1,512,512,512.00,0.00,31799,31800
41707,1,512,512,512.00,0.00,31799,31800
41708,9,216,1,56.89,4462.10,31799,31808
41709,1,512,512,512.00,0.00,31807,31808
41710,1,512,512,512.00,0.00,31807,31808
41711,1,512,512,512.00,0.00,31807,31808
41712,1,512,512,512.00,0.00,31807,31808
41713,1,512,512,512.00,0.00,31807,31808
41714,1,512,512,512.00,0.00,31807,31808
41715,2,309,203,256.00,2809.00,31807,31809
41716,1,512,512,512.00,0.00,31808,31809
41717,3,481,11,170.67,48166.89,31808,31811
41718,1,512,512,512.00,0.00,31810,31811
41719,1,512,512,512.00,0.00,31810,31811
41720,1,512,512,512.00,0.00,31810,31811
41721,1,512,512,512.00,0.00,31810,31811
41722,1,512,512,512.00,0.00,31810,31811
41723,3,238,121,170.67,2437.56,31810,31813
41724,3,306,10,170.67,14923.56,31812,31815
41725,2,345,167,256.00,7921.00,31814,31816
41726,1,512,512,512.00,0.00,31815,31816
41727,3,484,7,170.67,49121.56,31815,31818
41728,3,464,11,170.67,43134.89,31817,31820
41729,3,470,8,170.67,44912.89,31819,31822
41730,1,512,512,512.00,0.00,31821,31822
41731,2,358,154,256.00,10404.00,31821,31823
41732,2,354,158,256.00,9604.00,31822,31824
41733,1,512,512,512.00,0.00,31823,31824
41734,3,330,52,170.67,13707.56,31823,31826
41735,1,512,512,512.00,0.00,31825,31826
41736,1,512,512,512.00,0.00,31825,31826
41737,3,327,2,170.67,17680.22,31825,31828
41738,1,512,512,512.00,0.00,31827,31828
41739,1,512,512,512.00,0.00,31827,31828
41740,7,306,3,73.14,11317.84,31827,31834
41741,2,267,245,256.00,121.00,31833,31835
41742,2,369,143,256.00,12769.00,31834,31836
41743,1,512,512,512.00,0.00,31835,31836
41744,1,512,512,512.00,0.00,31835,31836
41745,1,512,512,512.00,0.00,31835,31836
41746,1,512,512,512.00,0.00,31835,31836
41747,4,303,2,128.00,12201.50,31835,31839
41748,2,334,178,256.00,6084.00,31838,31840
41749,3,409,3,170.67,29969.56,31839,31842
41750,1,512,512,512.00,0.00,31841,31842
41751,1,512,512,512.00,0.00,31841,31842
41752,1,512,512,512.00,0.00,31841,31842
41753,1,512,512,512.00,0.00,31841,31842
41754,4,307,4,128.00,13012.50,31841,31845
41755,3,345,8,170.67,18996.22,31844,31847
41756,4,248,28,128.00,6312.00,31846,31850
41757,10,181,1,51.20,3121.56,31849,31859
41758,3,430,22,170.67,33867.56,31858,31861
41759,1,512,512,512.00,0.00,31860,31861
41760,1,512,512,512.00,0.00,31860,31861
41761,1,512,512,512.00,0.00,31860,31861
41762,1,512,512,512.00,0.00,31860,31861
41763,2,507,5,256.00,63001.00,31860,31862
41764,1,512,512,512.00,0.00,31861,31862
41765,1,512,512,512.00,0.00,31861,31862
41766,2,471,41,256.00,46225.00,31861,31863
41767,1,512,512,512.00,0.00,31862,31863
41768,1,512,512,512.00,0.00,31862,31863
41769,1,512,512,512.00,0.00,31862,31863
41770,1,512,512,512.00,0.00,31862,31863
41771,2,467,45,256.00,44521.00,31862,31864
41772,1,512,512,512.00,0.00,31863,31864
41773,1,512,512,512.00,0.00,31863,31864
41774,1,512,512,512.00,0.00,31863,31864
41775,4,216,51,128.00,5848.50,31863,31867
41776,1,512,512,512.00,0.00,31866,31867
41777,1,512,512,512.00,0.00,31866,31867
41778,3,446,23,170.67,37970.89,31866,31869
41779,2,295,217,256.00,1521.00,31868,31870
41780,2,422,90,256.00,27556.00,31869,31871
41781,1,512,512,512.00,0.00,31870,31871
41782,1,512,512,512.00,0.00,31870,31871
41783,4,373,4,128.00,21715.50,31870,31874
41784,2,453,59,256.00,38809.00,31873,31875
41785,4,346,22,128.00,16262.50,31874,31878
41786,1,512,512,512.00,0.00,31877,31878
41787,1,512,512,512.00,0.00,31877,31878
41788,3,250,14,170.67,12272.89,31877,31880
41789,3,413,40,170.67,29422.89,31879,31882
41790,2,342,170,256.00,7396.00,31881,31883
41791,1,512,512,512.00,0.00,31882,31883
41792,3,458,14,170.67,41392.89,31882,31885
41793,1,512,512,512.00,0.00,31884,31885
41794,1,512,512,512.00,0.00,31884,31885
41795,1,512,512,512.00,0.00,31884,31885
41796,1,512,512,512.00,0.00,31884,31885
41797,3,258,55,170.67,7269.56,31884,31887
41798,2,368,144,256.00,12544.00,31886,31888
41799,4,295,1,128.00,13942.50,31887,31891
41800,1,512,512,512.00,0.00,31890,31891
41801,4,358,1,128.00,18989.50,31890,31894
41802,1,512,512,512.00,0.00,31893,31894
41803,1,512,512,512.00,0.00,31893,31894
41804,1,512,512,512.00,0.00,31893,31894
41805,2,302,210,256.00,2116.00,31893,31895
41806,1,512,512,512.00,0.00,31894,31895
41807,1,512,512,512.00,0.00,31894,31895
41808,1,512,512,512.00,0.00,31894,31895
41809,1,512,512,512.00,0.00,31894,31895
41810,2,300,212,256.00,1936.00,31894,31896
41811,3,310,11,170.67,15106.89,31895,31898
41812,1,512,512,512.00,0.00,31897,31898
41813,1,512,512,512.00,0.00,31897,31898
41814,1,512,512,512.00,0.00,31897,31898
41815,1,512,512,512.00,0.00,31897,31898
41816,2,335,177,256.00,6241.00,31897,31899
41817,2,485,27,256.00,52441.00,31898,31900
41818,1,512,512,512.00,0.00,31899,31900
41819,5,259,9,102.40,8103.84,31899,31904
41820,1,512,512,512.00,0.00,31903,31904
41821,1,512,512,512.00,0.00,31903,31904
41822,1,512,512,512.00,0.00,31903,31904
41823,1,512,512,512.00,0.00,31903,31904
41824,1,512,512,512.00,0.00,31903,31904
41825,2,289,223,256.00,1089.00,31903,31905
41826,1,512,512,512.00,0.00,31904,31905
41827,5,287,11,102.40,9849.84,31904,31909
41828,10,215,1,51.20,5758.56,31908,31918
41829,5,245,7,102.40,7661.84,31917,31922
41830,4,239,13,128.00,8129.00,31921,31925
41831,3,337,57,170.67,14453.56,31924,31927
41832,3,345,65,170.67,15424.22,31926,31929
41833,1,512,512,512.00,0.00,31928,31929
41834,4,372,2,128.00,20593.50,31928,31932
41835,3,351,24,170.67,18388.22,31931,31934
41836,1,512,512,512.00,0.00,31933,31934
41837,1,512,512,512.00,0.00,31933,31934
41838,1,512,512,512.00,0.00,31933,31934
41839,1,512,512,512.00,0.00,31933,31934
41840,2,429,83,256.00,29929.00,31933,31935
41841,1,512,512,512.00,0.00,31934,31935
41842,1,512,512,512.00,0.00,31934,31935
41843,2,433,79,256.00,31329.00,31934,31936
41844,1,512,512,512.00,0.00,31935,31936
41845,3,375,9,170.67,23236.22,31935,31938
41846,1,512,512,512.00,0.00,31937,31938
41847,1,512,512,512.00,0.00,31937,31938
41848,3,325,51,170.67,13113.56,31937,31940
41849,3,268,18,170.67,11947.56,31939,31942
41850,2,448,64,256.00,36864.00,31941,31943
41851,3,272,20,170.67,11800.89,31942,31945
41852,1,512,512,512.00,0.00,31944,31945
41853,1,512,512,512.00,0.00,31944,31945
41854,1,512,512,512.00,0.00,31944,31945
41855,2,433,79,256.00,31329.00,31944,31946
41856,1,512,512,512.00,0.00,31945,31946
41857,2,263,249,256.00,49.00,31945,31947
41858,1,512,512,512.00,0.00,31946,31947
41859,1,512,512,512.00,0.00,31946,31947
41860,1,512,512,512.00,0.00,31946,31947
41861,2,483,29,256.00,51529.00,31946,31948
41862,4,454,1,128.00,35557.50,31947,31951
41863,1,512,512,512.00,0.00,31950,31951
41864,1,512,512,512.00,0.00,31950,31951
41865,4,443,3,128.00,33227.00,31950,31954
41866,7,278,2,73.14,8663.27,31953,31960
41867,6,387,1,85.33,18542.22,31959,31965
41868,1,512,512,512.00,0.00,31964,31965
41869,2,305,207,256.00,2401.00,31964,31966
41870,1,512,512,512.00,0.00,31965,31966
41871,2,354,158,256.00,9604.00,31965,31967
41872,1,512,512,512.00,0.00,31966,31967
41873,1,512,512,512.00,0.00,31966,31967
41874,9,269,2,56.89,6518.99,31966,31975
41875,6,213,4,85.33,4922.22,31974,31980
41876,3,459,10,170.67,41749.56,31979,31982
41877,1,512,512,512.00,0.00,31981,31982
41878,1,512,512,512.00,0.00,31981,31982
41879,1,512,512,512.00,0.00,31981,31982
41880,1,512,512,512.00,0.00,31981,31982
41881,1,512,512,512.00,0.00,31981,31982
41882,1,512,512,512.00,0.00,31981,31982
41883,1,512,512,512.00,0.00,31981,31982
41884,1,512,512,512.00,0.00,31981,31982
41885,2,459,53,256.00,41209.00,31981,31983
41886,1,512,512,512.00,0.00,31982,31983
41887,2,325,187,256.00,4761.00,31982,31984
41888,6,237,1,85.33,6775.56,31983,31989
41889,1,512,512,512.00,0.00,31988,31989
41890,1,512,512,512.00,0.00,31988,31989
41891,3,341,60,170.67,14940.22,31988,31991
41892,1,512,512,512.00,0.00,31990,31991
41893,3,405,49,170.67,27469.56,31990,31993
41894,1,512,512,512.00,0.00,31992,31993
41895,1,512,512,512.00,0.00,31992,31993
41896,3,307,5,170.67,15630.89,31992,31995
41897,1,512,512,512.00,0.00,31994,31995
41898,1,512,512,512.00,0.00,31994,31995
41899,2,449,63,256.00,37249.00,31994,31996
41900,2,270,242,256.00,196.00,31995,31997
41901,8,190,1,64.00,4953.00,31996,32004
41902,1,512,512,512.00,0.00,32003,32004
41903,1,512,512,512.00,0.00,32003,32004
41904,1,512,512,512.00,0.00,32003,32004
41905,1,512,512,512.00,0.00,32003,32004
41906,1,512,512,512.00,0.00,32003,32004
41907,7,159,1,73.14,2843.55,32003,32010
41908,1,512,512,512.00,0.00,32009,32010
41909,1,512,512,512.00,0.00,32009,32010
41910,2,392,120,256.00,18496.00,32009,32011
41911,1,512,512,512.00,0.00,32010,32011
41912,3,214,113,170.67,1802.89,32010,32013
41913,2,378,134,256.00,14884.00,32012,32014
41914,1,512,512,512.00,0.00,32013,32014
41915,1,512,512,512.00,0.00,32013,32014
41916,1,512,512,512.00,0.00,32013,32014
41917,2,498,14,256.00,58564.00,32013,32015
41918,4,299,3,128.00,14001.50,32014,32018
41919,4,343,16,128.00,16684.50,32017,32021
41920,1,512,512,512.00,0.00,32020,32021
41921,2,397,115,256.00,19881.00,32020,32022
41922,1,512,512,512.00,0.00,32021,32022
41923,1,512,512,512.00,0.00,32021,32022
41924,1,512,512,512.00,0.00,32021,32022
41925,2,289,223,256.00,1089.00,32021,32023
41926,1,512,512,512.00,0.00,32022,32023
41927,2,263,249,256.00,49.00,32022,32024
41928,1,512,512,512.00,0.00,32023,32024
41929,7,295,1,73.14,9311.27,32023,32030
41930,2,378,134,256.00,14884.00,32029,32031
41931,3,498,6,170.67,53574.22,32030,32033
41932,1,512,512,512.00,0.00,32032,32033
41933,1,512,512,512.00,0.00,32032,32033
41934,3,334,1,170.67,18501.56,32032,32035
41935,1,512,512,512.00,0.00,32034,32035
41936,1,512,512,512.00,0.00,32034,32035
41937,4,327,11,128.00,14165.00,32034,32038
41938,1,512,512,512.00,0.00,32037,32038
41939,4,433,2,128.00,31335.50,32037,32041
41940,1,512,512,512.00,0.00,32040,32041
41941,3,448,6,170.67,38907.56,32040,32043
41942,8,212,1,64.00,5949.50,32042,32050
41943,1,512,512,512.00,0.00,32049,32050
41944,3,242,93,170.67,3720.22,32049,32052
41945,1,512,512,512.00,0.00,32051,32052
41946,1,512,512,512.00,0.00,32051,32052
41947,1,512,512,512.00,0.00,32051,32052
41948,1,512,512,512.00,0.00,32051,32052
41949,1,512,512,512.00,0.00,32051,32052
41950,1,512,512,512.00,0.00,32051,32052
41951,5,211,1,102.40,8182.24,32051,32056
41952,1,512,512,512.00,0.00,32055,32056
41953,1,512,512,512.00,0.00,32055,32056
41954,1,512,512,512.00,0.00,32055,32056
41955,1,512,512,512.00,0.00,32055,32056
41956,5,200,3,102.40,6874.64,32055,32060
41957,4,323,9,128.00,14313.00,32059,32063
41958,3,358,34,170.67,18779.56,32062,32065
41959,1,512,512,512.00,0.00,32064,32065
41960,6,189,40,85.33,3141.89,32064,32070
41961,1,512,512,512.00,0.00,32069,32070
41962,3,396,5,170.67,27260.22,32069,32072
41963,1,512,512,512.00,0.00,32071,32072
41964,2,359,153,256.00,10609.00,32071,32073
41965,1,512,512,512.00,0.00,32072,32073
41966,1,512,512,512.00,0.00,32072,32073
41967,1,512,512,512.00,0.00,32072,32073
41968,3,508,2,170.67,56896.89,32072,32075
41969,2,499,13,256.00,59049.00,32074,32076
41970,6,319,1,85.33,12751.56,32075,32081
41971,1,512,512,512.00,0.00,32080,32081
41972,1,512,512,512.00,0.00,32080,32081
41973,4,308,1,128.00,16399.50,32080,32084
41974,2,375,137,256.00,14161.00,32083,32085
41975,1,512,512,512.00,0.00,32084,32085
41976,1,512,512,512.00,0.00,32084,32085
41977,1,512,512,512.00,0.00,32084,32085
41978,2,281,231,256.00,625.00,32084,32086
41979,2,456,56,256.00,40000.00,32085,32087
41980,1,512,512,512.00,0.00,32086,32087
41981,1,512,512,512.00,0.00,32086,32087
41982,1,512,512,512.00,0.00,32086,32087
41983,5,261,1,102.40,15051.04,32086,32091
41984,1,512,512,512.00,0.00,32090,32091
41985,3,260,16,170.67,12056.89,32090,32093
41986,1,512,512,512.00,0.00,32092,32093
41987,6,228,3,85.33,10104.56,32092,32098
41988,2,259,253,256.00,9.00,32097,32099
41989,2,269,243,256.00,169.00,32098,32100
41990,3,400,39,170.67,26489.56,32099,32102
41991,2,433,79,256.00,31329.00,32101,32103
41992,1,512,512,512.00,0.00,32102,32103
41993,3,502,1,170.67,54901.56,32102,32105
41994,3,441,32,170.67,36548.22,32104,32107
41995,3,418,16,170.67,31227.56,32106,32109
41996,4,299,1,128.00,16992.50,32108,32112
41997,1,512,512,512.00,0.00,32111,32112
41998,1,512,512,512.00,0.00,32111,32112
41999,1,512,512,512.00,0.00,32111,32112
42000,1,512,512,512.00,0.00,32111,32112
42001,1,512,512,512.00,0.00,32111,32112
42002,1,512,512,512.00,0.00,32111,32112
42003,1,512,512,512.00,0.00,32111,32112
42004,1,512,512,512.00,0.00,32111,32112
42005,4,265,14,128.00,11410.50,32111,32115
42006,2,388,124,256.00,17424.00,32114,32116
42007,1,512,512,512.00,0.00,32115,32116
42008,2,486,26,256.00,52900.00,32115,32117
42009,1,512,512,512.00,0.00,32116,32117
42010,4,304,1,128.00,16171.50,32116,32120
42011,1,512,512,512.00,0.00,32119,32120
42012,1,512,512,512.00,0.00,32119,32120
42013,2,379,133,256.00,15129.00,32119,32121
42014,1,512,512,512.00,0.00,32120,32121
42015,1,512,512,512.00,0.00,32120,32121
42016,1,512,512,512.00,0.00,32120,32121
42017,5,432,9,102.40,27223.84,32120,32125
42018,1,512,512,512.00,0.00,32124,32125
42019,5,417,6,102.40,24875.84,32124,32129
42020,6,255,2,85.33,9334.22,32128,32134
42021,1,512,512,512.00,0.00,32133,32134
42022,2,297,215,256.00,1681.00,32133,32135
42023,1,512,512,512.00,0.00,32134,32135
42024,1,512,512,512.00,0.00,32134,32135
42025,1,512,512,512.00,0.00,32134,32135
42026,1,512,512,512.00,0.00,32134,32135
42027,2,482,30,256.00,51076.00,32134,32136
42028,3,254,6,170.67,13558.22,32135,32138
42029,1,512,512,512.00,0.00,32137,32138
42030,4,488,2,128.00,43245.50,32137,32141
42031,3,490,1,170.67,51053.56,32140,32143
42032,1,512,512,512.00,0.00,32142,32143
42033,1,512,512,512.00,0.00,32142,32143
42034,1,512,512,512.00,0.00,32142,32143
42035,5,243,4,102.40,10223.84,32142,32147
42036,1,512,512,512.00,0.00,32146,32147
42037,1,512,512,512.00,0.00,32146,32147
42038,1,512,512,512.00,0.00,32146,32147
42039,1,512,512,512.00,0.00,32146,32147
42040,3,325,40,170.67,13817.56,32146,32149
42041,1,512,512,512.00,0.00,32148,32149
42042,2,331,181,256.00,5625.00,32148,32150
42043,1,512,512,512.00,0.00,32149,32150
42044,1,512,512,512.00,0.00,32149,32150
42045,1,512,512,512.00,0.00,32149,32150
42046,2,508,4,256.00,63504.00,32149,32151
42047,1,512,512,512.00,0.00,32150,32151
42048,1,512,512,512.00,0.00,32150,32151
42049,1,512,512,512.00,0.00,32150,32151
42050,1,512,512,512.00,0.00,32150,32151
42051,3,234,105,170.67,2776.22,32150,32153
42052,3,380,36,170.67,22510.22,32152,32155
42053,1,512,512,512.00,0.00,32154,32155
42054,1,512,512,512.00,0.00,32154,32155
42055,1,512,512,512.00,0.00,32154,32155
42056,2,305,207,256.00,2401.00,32154,32156
42057,3,395,1,170.67,27366.89,32155,32158
42058,2,496,16,256.00,57600.00,32157,32159
42059,5,223,3,102.40,7724.64,32158,32163
42060,3,381,9,170.67,24248.22,32162,32165
42061,1,512,512,512.00,0.00,32164,32165
42062,1,512,512,512.00,0.00,32164,32165
42063,1,512,512,512.00,0.00,32164,32165
42064,2,345,167,256.00,7921.00,32164,32166
42065,4,482,1,128.00,41808.50,32165,32169
42066,3,403,3,170.67,28757.56,32168,32171
42067,1,512,512,512.00,0.00,32170,32171
42068,2,427,85,256.00,29241.00,32170,32172
42069,1,512,512,512.00,0.00,32171,32172
42070,2,398,114,256.00,20164.00,32171,32173
42071,1,512,512,512.00,0.00,32172,32173
42072,1,512,512,512.00,0.00,32172,32173
42073,1,512,512,512.00,0.00,32172,32173
42074,1,512,512,512.00,0.00,32172,32173
42075,2,474,38,256.00,47524.00,32172,32174
42076,1,512,512,512.00,0.00,32173,32174
42077,1,512,512,512.00,0.00,32173,32174
42078,3,341,1,170.67,19266.89,32173,32176
42079,1,512,512,512.00,0.00,32175,32176
42080,1,512,512,512.00,0.00,32175,32176
42081,1,512,512,512.00,0.00,32175,32176
42082,1,512,512,512.00,0.00,32175,32176
42083,2,419,93,256.00,26569.00,32175,32177
42084,1,512,512,512.00,0.00,32176,32177
42085,1,512,512,512.00,0.00,32176,32177
42086,1,512,512,512.00,0.00,32176,32177
42087,1,512,512,512.00,0.00,32176,32177
42088,2,400,112,256.00,20736.00,32176,32178
42089,1,512,512,512.00,0.00,32177,32178
42090,1,512,512,512.00,0.00,32177,32178
42091,1,512,512,512.00,0.00,32177,32178
42092,1,512,512,512.00,0.00,32177,32178
42093,2,288,224,256.00,1024.00,32177,32179
42094,2,346,166,256.00,8100.00,32178,32180
42095,4,219,10,128.00,5895.50,32179,32183
42096,1,512,512,512.00,0.00,32182,32183
42097,1,512,512,512.00,0.00,32182,32183
42098,1,512,512,512.00,0.00,32182,32183
42099,2,285,227,256.00,841.00,32182,32184
42100,1,512,512,512.00,0.00,32183,32184
42101,1,512,512,512.00,0.00,32183,32184
42102,2,315,197,256.00,3481.00,32183,32185
42103,1,512,512,512.00,0.00,32184,32185
42104,1,512,512,512.00,0.00,32184,32185
42105,2,437,75,256.00,32761.00,32184,32186
42106,1,512,512,512.00,0.00,32185,32186
42107,1,512,512,512.00,0.00,32185,32186
42108,1,512,512,512.00,0.00,32185,32186
42109,1,512,512,512.00,0.00,32185,32186
42110,3,503,1,170.67,55230.89,32185,32188
42111,1,512,512,512.00,0.00,32187,32188
42112,1,512,512,512.00,0.00,32187,32188
42113,1,512,512,512.00,0.00,32187,32188
42114,1,512,512,512.00,0.00,32187,32188
42115,1,512,512,512.00,0.00,32187,32188
42116,1,512,512,512.00,0.00,32187,32188
42117,3,455,25,170.67,40430.89,32187,32190
42118,2,358,154,256.00,10404.00,32189,32191
42119,3,330,1,170.67,18093.56,32190,32193
42120,1,512,512,512.00,0.00,32192,32193
42121,3,313,1,170.67,16597.56,32192,32195
42122,3,378,35,170.67,22176.22,32194,32197
42123,4,282,40,128.00,9377.50,32196,32200
42124,1,512,512,512.00,0.00,32199,32200
42125,1,512,512,512.00,0.00,32199,32200
42126,2,457,55,256.00,40401.00,32199,32201
42127,3,265,95,170.67,4990.89,32200,32203
42128,1,512,512,512.00,0.00,32202,32203
42129,1,512,512,512.00,0.00,32202,32203
42130,4,458,1,128.00,36579.50,32202,32206
42131,3,253,47,170.67,7926.89,32205,32208
42132,1,512,512,512.00,0.00,32207,32208
42133,2,464,48,256.00,43264.00,32207,32209
42134,3,286,85,170.67,7173.56,32208,32211
42135,1,512,512,512.00,0.00,32210,32211
42136,1,512,512,512.00,0.00,32210,32211
42137,1,512,512,512.00,0.00,32210,32211
42138,3,324,83,170.67,11836.22,32210,32213
42139,1,512,512,512.00,0.00,32212,32213
42140,1,512,512,512.00,0.00,32212,32213
42141,1,512,512,512.00,0.00,32212,32213
42142,1,512,512,512.00,0.00,32212,32213
42143,3,447,32,170.67,38180.22,32212,32215
42144,1,512,512,512.00,0.00,32214,32215
42145,1,512,512,512.00,0.00,32214,32215
42146,1,512,512,512.00,0.00,32214,32215
42147,5,424,5,102.40,26161.44,32214,32219
42148,2,406,106,256.00,22500.00,32218,32220
42149,1,512,512,512.00,0.00,32219,32220
42150,3,358,2,170.67,21296.89,32219,32222
42151,4,385,2,128.00,22627.50,32221,32225
42152,1,512,512,512.00,0.00,32224,32225
42153,1,512,512,512.00,0.00,32224,32225
42154,1,512,512,512.00,0.00,32224,32225
42155,1,512,512,512.00,0.00,32224,32225
42156,4,272,9,128.00,13458.50,32224,32228
42157,6,399,2,85.33,20082.56,32227,32233
42158,1,512,512,512.00,0.00,32232,32233
42159,1,512,512,512.00,0.00,32232,32233
42160,1,512,512,512.00,0.00,32232,32233
42161,1,512,512,512.00,0.00,32232,32233
42162,2,397,115,256.00,19881.00,32232,32234
42163,2,291,221,256.00,1225.00,32233,32235
42164,1,512,512,512.00,0.00,32234,32235
42165,1,512,512,512.00,0.00,32234,32235
42166,1,512,512,512.00,0.00,32234,32235
42167,7,207,1,73.14,6241.27,32234,32241
42168,1,512,512,512.00,0.00,32240,32241
42169,1,512,512,512.00,0.00,32240,32241
42170,1,512,512,512.00,0.00,32240,32241
42171,1,512,512,512.00,0.00,32240,32241
42172,1,512,512,512.00,0.00,32240,32241
42173,1,512,512,512.00,0.00,32240,32241
42174,1,512,512,512.00,0.00,32240,32241
42175,1,512,512,512.00,0.00,32240,32241
42176,1,512,512,512.00,0.00,32240,32241
42177,2,422,90,256.00,27556.00,32240,32242
42178,3,508,1,170.67,56897.56,32241,32244
42179,4,423,5,128.00,29381.00,32243,32247
42180,1,512,512,512.00,0.00,32246,32247
42181,1,512,512,512.00,0.00,32246,32247
42182,1,512,512,512.00,0.00,32246,32247
42183,9,156,1,56.89,3024.77,32246,32255
42184,1,512,512,512.00,0.00,32254,32255
42185,1,512,512,512.00,0.00,32254,32255
42186,3,441,2,170.67,37288.22,32254,32257
42187,3,376,6,170.67,23643.56,32256,32259
42188,1,512,512,512.00,0.00,32258,32259
42189,1,512,512,512.00,0.00,32258,32259
42190,1,512,512,512.00,0.00,32258,32259
42191,2,424,88,256.00,28224.00,32258,32260
42192,1,512,512,512.00,0.00,32259,32260
42193,2,316,196,256.00,3600.00,32259,32261
42194,1,512,512,512.00,0.00,32260,32261
42195,1,512,512,512.00,0.00,32260,32261
42196,2,479,33,256.00,49729.00,32260,32262
42197,1,512,512,512.00,0.00,32261,32262
42198,1,512,512,512.00,0.00,32261,32262
42199,2,345,167,256.00,7921.00,32261,32263
42200,1,512,512,512.00,0.00,32262,32263
42201,1,512,512,512.00,0.00,32262,32263
42202,1,512,512,512.00,0.00,32262,32263
42203,2,385,127,256.00,16641.00,32262,32264
42204,3,423,26,170.67,32064.22,32263,32266
42205,3,334,7,170.67,17821.56,32265,32268
42206,1,512,512,512.00,0.00,32267,32268
42207,1,512,512,512.00,0.00,32267,32268
42208,1,512,512,512.00,0.00,32267,32268
42209,2,432,80,256.00,30976.00,32267,32269
42210,1,512,512,512.00,0.00,32268,32269
42211,1,512,512,512.00,0.00,32268,32269
42212,1,512,512,512.00,0.00,32268,32269
42213,5,281,2,102.40,8933.04,32268,32273
42214,2,270,242,256.00,196.00,32272,32274
42215,1,512,512,512.00,0.00,32273,32274
42216,1,512,512,512.00,0.00,32273,32274
42217,1,512,512,512.00,0.00,32273,32274
42218,3,302,19,170.67,13554.89,32273,32276
42219,2,358,154,256.00,10404.00,32275,32277
42220,2,489,23,256.00,54289.00,32276,32278
42221,1,512,512,512.00,0.00,32277,32278
42222,1,512,512,512.00,0.00,32277,32278
42223,1,512,512,512.00,0.00,32277,32278
42224,1,512,512,512.00,0.00,32277,32278
42225,3,494,2,170.67,52304.89,32277,32280
42226,4,317,2,128.00,16321.50,32279,32283
42227,1,512,512,512.00,0.00,32282,32283
42228,1,512,512,512.00,0.00,32282,32283
42229,1,512,512,512.00,0.00,32282,32283
42230,1,512,512,512.00,0.00,32282,32283
42231,7,298,4,73.14,11020.69,32282,32289
42232,2,315,197,256.00,3481.00,32288,32290
42233,2,509,3,256.00,64009.00,32289,32291
42234,1,512,512,512.00,0.00,32290,32291
42235,1,512,512,512.00,0.00,32290,32291
42236,2,338,174,256.00,6724.00,32290,32292
42237,1,512,512,512.00,0.00,32291,32292
42238,1,512,512,512.00,0.00,32291,32292
42239,2,471,41,256.00,46225.00,32291,32293
42240,4,378,10,128.00,22484.50,32292,32296
42241,1,512,512,512.00,0.00,32295,32296
42242,1,512,512,512.00,0.00,32295,32296
42243,1,512,512,512.00,0.00,32295,32296
42244,1,512,512,512.00,0.00,32295,32296
42245,1,512,512,512.00,0.00,32295,32296
42246,7,305,1,73.14,10661.27,32295,32302
42247,1,512,512,512.00,0.00,32301,32302
42248,3,347,3,170.67,19760.22,32301,32304
42249,1,512,512,512.00,0.00,32303,32304
42250,1,512,512,512.00,0.00,32303,32304
42251,1,512,512,512.00,0.00,32303,32304
42252,3,278,37,170.67,10026.89,32303,32306
42253,6,292,1,85.33,11772.89,32305,32311
42254,3,305,34,170.67,12242.89,32310,32313
42255,7,217,1,73.14,5696.98,32312,32319
42256,5,401,1,102.40,22919.04,32318,32323
42257,4,275,1,128.00,12372.50,32322,32326
42258,1,512,512,512.00,0.00,32325,32326
42259,1,512,512,512.00,0.00,32325,32326
42260,2,347,165,256.00,8281.00,32325,32327
42261,1,512,512,512.00,0.00,32326,32327
42262,5,198,3,102.40,4627.84,32326,32331
42263,1,512,512,512.00,0.00,32330,32331
42264,1,512,512,512.00,0.00,32330,32331
42265,4,337,5,128.00,15627.50,32330,32334
42266,3,229,131,170.67,1774.89,32333,32336
42267,2,302,210,256.00,2116.00,32335,32337
42268,2,511,1,256.00,65025.00,32336,32338
42269,1,512,512,512.00,0.00,32337,32338
42270,1,512,512,512.00,0.00,32337,32338
42271,3,338,2,170.67,18816.89,32337,32340
42272,1,512,512,512.00,0.00,32339,32340
42273,1,512,512,512.00,0.00,32339,32340
42274,1,512,512,512.00,0.00,32339,32340
42275,3,306,1,170.67,16093.56,32339,32342
42276,5,244,8,102.40,7755.44,32341,32346
42277,1,512,512,512.00,0.00,32345,32346
42278,4,209,17,128.00,5313.50,32345,32349
42279,1,512,512,512.00,0.00,32348,32349
42280,2,284,228,256.00,784.00,32348,32350
42281,2,329,183,256.00,5329.00,32349,32351
42282,4,397,13,128.00,24489.00,32350,32354
42283,2,311,201,256.00,3025.00,32353,32355
42284,4,230,9,128.00,7773.50,32354,32358
42285,1,512,512,512.00,0.00,32357,32358
42286,1,512,512,512.00,0.00,32357,32358
42287,1,512,512,512.00,0.00,32357,32358
42288,3,485,1,170.67,49506.89,32357,32360
42289,1,512,512,512.00,0.00,32359,32360
42290,2,397,115,256.00,19881.00,32359,32361
42291,1,512,512,512.00,0.00,32360,32361
42292,1,512,512,512.00,0.00,32360,32361
42293,1,512,512,512.00,0.00,32360,32361
42294,2,327,185,256.00,5041.00,32360,32362
42295,4,284,40,128.00,9702.50,32361,32365
42296,1,512,512,512.00,0.00,32364,32365
42297,1,512,512,512.00,0.00,32364,32365
42298,1,512,512,512.00,0.00,32364,32365
42299,1,512,512,512.00,0.00,32364,32365
42300,1,512,512,512.00,0.00,32364,32365
42301,1,512,512,512.00,0.00,32364,32365
42302,1,512,512,512.00,0.00,32364,32365
42303,1,512,512,512.00,0.00,32364,32365
42304,1,512,512,512.00,0.00,32364,32365
42305,2,509,3,256.00,64009.00,32364,32366
42306,3,245,69,170.67,5536.22,32365,32368
42307,1,512,512,512.00,0.00,32367,32368
42308,4,483,1,128.00,42121.00,32367,32371
42309,3,315,8,170.67,15876.22,32370,32373
42310,2,445,67,256.00,35721.00,32372,32374
42311,1,512,512,512.00,0.00,32373,32374
42312,2,324,188,256.00,4624.00,32373,32375
42313,2,326,186,256.00,4900.00,32374,32376
42314,1,512,512,512.00,0.00,32375,32376
42315,1,512,512,512.00,0.00,32375,32376
42316,2,462,50,256.00,42436.00,32375,32377
42317,1,512,512,512.00,0.00,32376,32377
42318,1,512,512,512.00,0.00,32376,32377
42319,2,310,202,256.00,2916.00,32376,32378
42320,1,512,512,512.00,0.00,32377,32378
42321,1,512,512,512.00,0.00,32377,32378
42322,1,512,512,512.00,0.00,32377,32378
42323,2,297,215,256.00,1681.00,32377,32379
42324,1,512,512,512.00,0.00,32378,32379
42325,1,512,512,512.00,0.00,32378,32379
42326,1,512,512,512.00,0.00,32378,32379
42327,3,424,7,170.67,33001.56,32378,32381
42328,1,512,512,512.00,0.00,32380,32381
42329,1,512,512,512.00,0.00,32380,32381
42330,1,512,512,512.00,0.00,32380,32381
42331,1,512,512,512.00,0.00,32380,32381
42332,4,397,15,128.00,24869.00,32380,32384
42333,3,415,17,170.67,30510.89,32383,32386
42334,1,512,512,512.00,0.00,32385,32386
42335,1,512,512,512.00,0.00,32385,32386
42336,1,512,512,512.00,0.00,32385,32386
42337,2,482,30,256.00,51076.00,32385,32387
42338,1,512,512,512.00,0.00,32386,32387
42339,1,512,512,512.00,0.00,32386,32387
42340,1,512,512,512.00,0.00,32386,32387
42341,2,286,226,256.00,900.00,32386,32388
42342,3,306,62,170.67,10278.22,32387,32390
42343,1,512,512,512.00,0.00,32389,32390
42344,6,226,1,85.33,5973.89,32389,32395
42345,3,223,101,170.67,2630.89,32394,32397
42346,1,512,512,512.00,0.00,32396,32397
42347,1,512,512,512.00,0.00,32396,32397
42348,1,512,512,512.00,0.00,32396,32397
42349,3,380,45,170.67,22204.22,32396,32399
42350,1,512,512,512.00,0.00,32398,32399
42351,2,412,100,256.00,24336.00,32398,32400
42352,3,292,5,170.67,14710.89,32399,32402
42353,3,297,16,170.67,13561.56,32401,32404
42354,5,302,3,102.40,13597.04,32403,32408
42355,1,512,512,512.00,0.00,32407,32408
42356,3,476,10,170.67,46656.89,32407,32410
42357,4,280,2,128.00,16101.50,32409,32413
42358,1,512,512,512.00,0.00,32412,32413
42359,1,512,512,512.00,0.00,32412,32413
42360,6,365,1,85.33,16592.56,32412,32418
42361,6,388,1,85.33,18847.89,32417,32423
42362,1,512,512,512.00,0.00,32422,32423
42363,1,512,512,512.00,0.00,32422,32423
42364,2,484,28,256.00,51984.00,32422,32424
42365,1,512,512,512.00,0.00,32423,32424
42366,2,342,170,256.00,7396.00,32423,32425
42367,2,268,244,256.00,144.00,32424,32426
42368,2,381,131,256.00,15625.00,32425,32427
42369,1,512,512,512.00,0.00,32426,32427
42370,1,512,512,512.00,0.00,32426,32427
42371,2,425,87,256.00,28561.00,32426,32428
42372,1,512,512,512.00,0.00,32427,32428
42373,1,512,512,512.00,0.00,32427,32428
42374,2,418,94,256.00,26244.00,32427,32429
42375,1,512,512,512.00,0.00,32428,32429
42376,1,512,512,512.00,0.00,32428,32429
42377,1,512,512,512.00,0.00,32428,32429
42378,2,372,140,256.00,13456.00,32428,32430
42379,3,342,8,170.67,18630.22,32429,32432
42380,1,512,512,512.00,0.00,32431,32432
42381,1,512,512,512.00,0.00,32431,32432
42382,2,429,83,256.00,29929.00,32431,32433
42383,1,512,512,512.00,0.00,32432,32433
42384,1,512,512,512.00,0.00,32432,32433
42385,1,512,512,512.00,0.00,32432,32433
42386,3,308,1,170.67,16230.89,32432,32435
42387,2,365,147,256.00,11881.00,32434,32436
42388,1,512,512,512.00,0.00,32435,32436
42389,1,512,512,512.00,0.00,32435,32436
42390,3,336,44,170.67,14958.22,32435,32438
42391,2,413,99,256.00,24649.00,32437,32439
42392,1,512,512,512.00,0.00,32438,32439
42393,1,512,512,512.00,0.00,32438,32439
42394,2,268,244,256.00,144.00,32438,32440
42395,1,512,512,512.00,0.00,32439,32440
42396,1,512,512,512.00,0.00,32439,32440
42397,5,239,6,102.40,11592.64,32439,32444
42398,6,447,1,85.33,26345.56,32443,32449
42399,7,293,2,73.14,8951.84,32448,32455
42400,1,512,512,512.00,0.00,32454,32455
42401,4,320,1,128.00,17962.50,32454,32458
42402,1,512,512,512.00,0.00,32457,32458
42403,1,512,512,512.00,0.00,32457,32458
42404,1,512,512,512.00,0.00,32457,32458
42405,3,500,5,170.67,54230.89,32457,32460
42406,1,512,512,512.00,0.00,32459,32460
42407,2,316,196,256.00,3600.00,32459,32461
42408,2,493,19,256.00,56169.00,32460,32462
42409,2,308,204,256.00,2704.00,32461,32463
42410,1,512,512,512.00,0.00,32462,32463
42411,2,271,241,256.00,225.00,32462,32464
42412,2,461,51,256.00,42025.00,32463,32465
42413,1,512,512,512.00,0.00,32464,32465
42414,3,455,6,170.67,40760.22,32464,32467
42415,1,512,512,512.00,0.00,32466,32467
42416,1,512,512,512.00,0.00,32466,32467
42417,1,512,512,512.00,0.00,32466,32467
42418,1,512,512,512.00,0.00,32466,32467
42419,2,343,169,256.00,7569.00,32466,32468
42420,4,456,5,128.00,36084.50,32467,32471
42421,1,512,512,512.00,0.00,32470,32471
42422,1,512,512,512.00,0.00,32470,32471
42423,2,436,76,256.00,32400.00,32470,32472
42424,4,494,3,128.00,44655.50,32471,32475
42425,1,512,512,512.00,0.00,32474,32475
42426,1,512,512,512.00,0.00,32474,32475
42427,4,391,4,128.00,24826.50,32474,32478
42428,1,512,512,512.00,0.00,32477,32478
42429,3,385,47,170.67,23150.89,32477,32480
42430,1,512,512,512.00,0.00,32479,32480
42431,1,512,512,512.00,0.00,32479,32480
42432,1,512,512,512.00,0.00,32479,32480
42433,1,512,512,512.00,0.00,32479,32480
42434,4,270,2,128.00,9186.50,32479,32483
42435,1,512,512,512.00,0.00,32482,32483
42436,1,512,512,512.00,0.00,32482,32483
42437,1,512,512,512.00,0.00,32482,32483
42438,3,323,76,170.67,11830.89,32482,32485
42439,3,387,46,170.67,23581.56,32484,32487
42440,1,512,512,512.00,0.00,32486,32487
42441,2,314,198,256.00,3364.00,32486,32488
42442,1,512,512,512.00,0.00,32487,32488
42443,1,512,512,512.00,0.00,32487,32488
42444,1,512,512,512.00,0.00,32487,32488
42445,2,419,93,256.00,26569.00,32487,32489
42446,1,512,512,512.00,0.00,32488,32489
42447,1,512,512,512.00,0.00,32488,32489
42448,1,512,512,512.00,0.00,32488,32489
42449,2,503,9,256.00,61009.00,32488,32490
42450,1,512,512,512.00,0.00,32489,32490
42451,1,512,512,512.00,0.00,32489,32490
42452,1,512,512,512.00,0.00,32489,32490
42453,2,326,186,256.00,4900.00,32489,32491
42454,1,512,512,512.00,0.00,32490,32491
42455,1,512,512,512.00,0.00,32490,32491
42456,1,512,512,512.00,0.00,32490,32491
42457,8,148,3,64.00,3520.50,32490,32498
42458,1,512,512,512.00,0.00,32497,32498
42459,1,512,512,512.00,0.00,32497,32498
42460,3,335,3,170.67,18376.22,32497,32500
42461,1,512,512,512.00,0.00,32499,32500
42462,1,512,512,512.00,0.00,32499,32500
42463,3,292,24,170.67,12291.56,32499,32502
42464,1,512,512,512.00,0.00,32501,32502
42465,1,512,512,512.00,0.00,32501,32502
42466,1,512,512,512.00,0.00,32501,32502
42467,1,512,512,512.00,0.00,32501,32502
42468,2,274,238,256.00,324.00,32501,32503
42469,3,272,4,170.67,14104.89,32502,32505
42470,1,512,512,512.00,0.00,32504,32505
42471,2,291,221,256.00,1225.00,32504,32506
42472,1,512,512,512.00,0.00,32505,32506
42473,2,424,88,256.00,28224.00,32505,32507
42474,1,512,512,512.00,0.00,32506,32507
42475,2,319,193,256.00,3969.00,32506,32508
42476,2,320,192,256.00,4096.00,32507,32509
42477,1,512,512,512.00,0.00,32508,32509
42478,1,512,512,512.00,0.00,32508,32509
42479,3,230,60,170.67,6134.22,32508,32511
42480,3,486,11,170.67,49720.22,32510,32513
42481,1,512,512,512.00,0.00,32512,32513
42482,1,512,512,512.00,0.00,32512,32513
42483,3,254,116,170.67,3584.89,32512,32515
42484,6,265,8,85.33,7869.22,32514,32520
42485,1,512,512,512.00,0.00,32519,32520
42486,1,512,512,512.00,0.00,32519,32520
42487,2,509,3,256.00,64009.00,32519,32521
42488,3,281,98,170.67,6290.89,32520,32523
42489,2,472,40,256.00,46656.00,32522,32524
42490,3,405,14,170.67,28496.22,32523,32526
42491,1,512,512,512.00,0.00,32525,32526
42492,1,512,512,512.00,0.00,32525,32526
42493,1,512,512,512.00,0.00,32525,32526
42494,1,512,512,512.00,0.00,32525,32526
42495,1,512,512,512.00,0.00,32525,32526
42496,1,512,512,512.00,0.00,32525,32526
42497,3,411,4,170.67,30321.56,32525,32528
42498,1,512,512,512.00,0.00,32527,32528
42499,1,512,512,512.00,0.00,32527,32528
42500,1,512,512,512.00,0.00,32527,32528
42501,1,512,512,512.00,0.00,32527,32528
42502,3,320,21,170.67,14900.22,32527,32530
42503,1,512,512,512.00,0.00,32529,32530
42504,3,381,8,170.67,24324.22,32529,32532
42505,9,268,1,56.89,6379.65,32531,32540
42506,5,265,1,102.40,12060.64,32539,32544
42507,1,512,512,512.00,0.00,32543,32544
42508,2,350,162,256.00,8836.00,32543,32545
42509,1,512,512,512.00,0.00,32544,32545
42510,1,512,512,512.00,0.00,32544,32545
42511,3,328,77,170.67,12526.89,32544,32547
42512,2,332,180,256.00,5776.00,32546,32548
42513,2,433,79,256.00,31329.00,32547,32549
42514,1,512,512,512.00,0.00,32548,32549
42515,1,512,512,512.00,0.00,32548,32549
42516,1,512,512,512.00,0.00,32548,32549
42517,3,389,7,170.67,25814.89,32548,32551
42518,1,512,512,512.00,0.00,32550,32551
42519,1,512,512,512.00,0.00,32550,32551
42520,1,512,512,512.00,0.00,32550,32551
42521,2,478,34,256.00,49284.00,32550,32552
42522,1,512,512,512.00,0.00,32551,32552
42523,1,512,512,512.00,0.00,32551,32552
42524,2,318,194,256.00,3844.00,32551,32553
42525,1,512,512,512.00,0.00,32552,32553
42526,3,271,27,170.67,10861.56,32552,32555
42527,1,512,512,512.00,0.00,32554,32555
42528,4,449,1,128.00,34917.50,32554,32558
42529,1,512,512,512.00,0.00,32557,32558
42530,3,401,41,170.67,26666.89,32557,32560
42531,1,512,512,512.00,0.00,32559,32560
42532,1,512,512,512.00,0.00,32559,32560
42533,1,512,512,512.00,0.00,32559,32560
42534,2,491,21,256.00,55225.00,32559,32561
42535,1,512,512,512.00,0.00,32560,32561
42536,3,295,50,170.67,10010.89,32560,32563
42537,1,512,512,512.00,0.00,32562,32563
42538,5,285,6,102.40,10346.64,32562,32567
42539,2,318,194,256.00,3844.00,32566,32568
42540,1,512,512,512.00,0.00,32567,32568
42541,1,512,512,512.00,0.00,32567,32568
42542,1,512,512,512.00,0.00,32567,32568
42543,2,434,78,256.00,31684.00,32567,32569
42544,1,512,512,512.00,0.00,32568,32569
42545,2,422,90,256.00,27556.00,32568,32570
42546,2,272,240,256.00,256.00,32569,32571
42547,2,483,29,256.00,51529.00,32570,32572
42548,1,512,512,512.00,0.00,32571,32572
42549,1,512,512,512.00,0.00,32571,32572
42550,1,512,512,512.00,0.00,32571,32572
42551,8,312,1,64.00,9671.50,32571,32579
42552,1,512,512,512.00,0.00,32578,32579
42553,1,512,512,512.00,0.00,32578,32579
42554,1,512,512,512.00,0.00,32578,32579
42555,1,512,512,512.00,0.00,32578,32579
42556,3,234,129,170.67,2072.22,32578,32581
42557,1,512,512,512.00,0.00,32580,32581
42558,1,512,512,512.00,0.00,32580,32581
42559,1,512,512,512.00,0.00,32580,32581
42560,1,512,512,512.00,0.00,32580,32581
42561,4,186,68,128.00,2054.00,32580,32584
42562,1,512,512,512.00,0.00,32583,32584
42563,7,334,2,73.14,12264.12,32583,32590
42564,1,512,512,512.00,0.00,32589,32590
42565,1,512,512,512.00,0.00,32589,32590
42566,1,512,512,512.00,0.00,32589,32590
42567,4,384,11,128.00,22299.50,32589,32593
42568,4,186,30,128.00,3482.50,32592,32596
42569,1,512,512,512.00,0.00,32595,32596
42570,2,438,74,256.00,33124.00,32595,32597
42571,3,242,62,170.67,6096.89,32596,32599
42572,1,512,512,512.00,0.00,32598,32599
42573,2,314,198,256.00,3364.00,32598,32600
42574,4,364,2,128.00,20810.00,32599,32603
42575,1,512,512,512.00,0.00,32602,32603
42576,1,512,512,512.00,0.00,32602,32603
42577,1,512,512,512.00,0.00,32602,32603
42578,2,280,232,256.00,576.00,32602,32604
42579,2,440,72,256.00,33856.00,32603,32605
42580,2,497,15,256.00,58081.00,32604,32606
42581,4,239,11,128.00,6605.00,32605,32609
42582,3,491,9,170.67,51308.22,32608,32611
42583,4,494,1,128.00,44671.50,32610,32614
42584,1,512,512,512.00,0.00,32613,32614
42585,1,512,512,512.00,0.00,32613,32614
42586,2,488,24,256.00,53824.00,32613,32615
42587,1,512,512,512.00,0.00,32614,32615
42588,2,350,162,256.00,8836.00,32614,32616
42589,3,446,26,170.67,37936.89,32615,32618
42590,2,384,128,256.00,16384.00,32617,32619
42591,1,512,512,512.00,0.00,32618,32619
42592,4,456,4,128.00,35960.00,32618,32622
42593,5,471,1,102.40,34004.24,32621,32626
42594,2,369,143,256.00,12769.00,32625,32627
42595,3,345,62,170.67,15504.22,32626,32629
42596,3,226,83,170.67,3930.89,32628,32631
42597,4,177,46,128.00,2432.50,32630,32634
42598,1,512,512,512.00,0.00,32633,32634
42599,1,512,512,512.00,0.00,32633,32634
42600,1,512,512,512.00,0.00,32633,32634
42601,1,512,512,512.00,0.00,32633,32634
42602,3,366,30,170.67,20310.22,32633,32636
42603,2,257,255,256.00,1.00,32635,32637
42604,1,512,512,512.00,0.00,32636,32637
42605,1,512,512,512.00,0.00,32636,32637
42606,1,512,512,512.00,0.00,32636,32637
42607,3,301,1,170.67,15773.56,32636,32639
42608,1,512,512,512.00,0.00,32638,32639
42609,1,512,512,512.00,0.00,32638,32639
42610,1,512,512,512.00,0.00,32638,32639
42611,1,512,512,512.00,0.00,32638,32639
42612,4,280,1,128.00,10921.50,32638,32642
42613,1,512,512,512.00,0.00,32641,32642
42614,5,184,6,102.40,4653.44,32641,32646
42615,1,512,512,512.00,0.00,32645,32646
42616,2,300,212,256.00,1936.00,32645,32647
42617,1,512,512,512.00,0.00,32646,32647
42618,5,209,35,102.40,3527.44,32646,32651
42619,2,379,133,256.00,15129.00,32650,32652
42620,1,512,512,512.00,0.00,32651,32652
42621,2,318,194,256.00,3844.00,32651,32653
42622,1,512,512,512.00,0.00,32652,32653
42623,2,329,183,256.00,5329.00,32652,32654
42624,3,274,72,170.67,6811.56,32653,32656
42625,1,512,512,512.00,0.00,32655,32656
42626,3,400,13,170.67,27529.56,32655,32658
42627,6,493,1,85.33,33246.22,32657,32663
42628,2,260,252,256.00,16.00,32662,32664
42629,1,512,512,512.00,0.00,32663,32664
42630,3,435,3,170.67,35776.22,32663,32666
42631,1,512,512,512.00,0.00,32665,32666
42632,5,402,2,102.40,22665.04,32665,32670
42633,1,512,512,512.00,0.00,32669,32670
42634,1,512,512,512.00,0.00,32669,32670
42635,3,243,113,170.67,2924.22,32669,32672
42636,1,512,512,512.00,0.00,32671,32672
42637,1,512,512,512.00,0.00,32671,32672
42638,1,512,512,512.00,0.00,32671,32672
42639,2,448,64,256.00,36864.00,32671,32673
42640,2,493,19,256.00,56169.00,32672,32674
42641,1,512,512,512.00,0.00,32673,32674
42642,1,512,512,512.00,0.00,32673,32674
42643,3,270,71,170.67,6600.22,32673,32676
42644,1,512,512,512.00,0.00,32675,32676
42645,2,407,105,256.00,22801.00,32675,32677
42646,1,512,512,512.00,0.00,32676,32677
42647,1,512,512,512.00,0.00,32676,32677
42648,1,512,512,512.00,0.00,32676,32677
42649,4,401,2,128.00,26527.50,32676,32680
42650,1,512,512,512.00,0.00,32679,32680
42651,1,512,512,512.00,0.00,32679,32680
42652,2,274,238,256.00,324.00,32679,32681
42653,1,512,512,512.00,0.00,32680,32681
42654,3,242,39,170.67,8688.22,32680,32683
42655,6,234,1,85.33,7307.22,32682,32688
42656,1,512,512,512.00,0.00,32687,32688
42657,2,391,121,256.00,18225.00,32687,32689
42658,1,512,512,512.00,0.00,32688,32689
42659,4,175,24,128.00,3683.50,32688,32692
42660,3,384,2,170.67,25318.22,32691,32694
42661,4,373,2,128.00,22890.50,32693,32697
42662,1,512,512,512.00,0.00,32696,32697
42663,1,512,512,512.00,0.00,32696,32697
42664,3,291,16,170.67,13193.56,32696,32699
42665,2,436,76,256.00,32400.00,32698,32700
42666,2,282,230,256.00,676.00,32699,32701
42667,1,512,512,512.00,0.00,32700,32701
42668,1,512,512,512.00,0.00,32700,32701
42669,1,512,512,512.00,0.00,32700,32701
42670,2,270,242,256.00,196.00,32700,32702
42671,1,512,512,512.00,0.00,32701,32702
42672,1,512,512,512.00,0.00,32701,32702
42673,1,512,512,512.00,0.00,32701,32702
42674,2,263,249,256.00,49.00,32701,32703
42675,1,512,512,512.00,0.00,32702,32703
42676,1,512,512,512.00,0.00,32702,32703
42677,1,512,512,512.00,0.00,32702,32703
42678,2,415,97,256.00,25281.00,32702,32704
42679,1,512,512,512.00,0.00,32703,32704
42680,1,512,512,512.00,0.00,32703,32704
42681,5,449,1,102.40,30243.84,32703,32708
42682,1,512,512,512.00,0.00,32707,32708
42683,1,512,512,512.00,0.00,32707,32708
42684,1,512,512,512.00,0.00,32707,32708
42685,1,512,512,512.00,0.00,32707,32708
42686,2,372,140,256.00,13456.00,32707,32709
42687,1,512,512,512.00,0.00,32708,32709
42688,3,350,22,170.67,18400.89,32708,32711
42689,1,512,512,512.00,0.00,32710,32711
42690,4,400,5,128.00,25284.50,32710,32714
42691,2,322,190,256.00,4356.00,32713,32715
42692,2,443,69,256.00,34969.00,32714,32716
42693,1,512,512,512.00,0.00,32715,32716
42694,1,512,512,512.00,0.00,32715,32716
42695,3,430,10,170.67,34267.56,32715,32718
42696,4,376,4,128.00,21654.00,32717,32721
42697,1,512,512,512.00,0.00,32720,32721
42698,1,512,512,512.00,0.00,32720,32721
42699,2,363,149,256.00,11449.00,32720,32722
42700,6,234,1,85.33,7712.56,32721,32727
42701,1,512,512,512.00,0.00,32726,32727
42702,1,512,512,512.00,0.00,32726,32727
42703,1,512,512,512.00,0.00,32726,32727
42704,4,385,3,128.00,23797.00,32726,32730
42705,1,512,512,512.00,0.00,32729,32730
42706,1,512,512,512.00,0.00,32729,32730
42707,1,512,512,512.00,0.00,32729,32730
42708,1,512,512,512.00,0.00,32729,32730
42709,2,494,18,256.00,56644.00,32729,32731
42710,1,512,512,512.00,0.00,32730,32731
42711,2,268,244,256.00,144.00,32730,32732
42712,2,467,45,256.00,44521.00,32731,32733
42713,1,512,512,512.00,0.00,32732,32733
42714,5,293,4,102.40,9898.64,32732,32737
42715,2,387,125,256.00,17161.00,32736,32738
42716,1,512,512,512.00,0.00,32737,32738
42717,1,512,512,512.00,0.00,32737,32738
42718,1,512,512,512.00,0.00,32737,32738
42719,4,374,1,128.00,20946.50,32737,32741
42720,2,309,203,256.00,2809.00,32740,32742
42721,1,512,512,512.00,0.00,32741,32742
42722,1,512,512,512.00,0.00,32741,32742
42723,1,512,512,512.00,0.00,32741,32742
42724,2,279,233,256.00,529.00,32741,32743
42725,1,512,512,512.00,0.00,32742,32743
42726,1,512,512,512.00,0.00,32742,32743
42727,1,512,512,512.00,0.00,32742,32743
42728,1,512,512,512.00,0.00,32742,32743
42729,2,421,91,256.00,27225.00,32742,32744
42730,1,512,512,512.00,0.00,32743,32744
42731,1,512,512,512.00,0.00,32743,32744
42732,1,512,512,512.00,0.00,32743,32744
42733,1,512,512,512.00,0.00,32743,32744
42734,8,238,5,64.00,5165.75,32743,32751
42735,2,272,240,256.00,256.00,32750,32752
42736,2,482,30,256.00,51076.00,32751,32753
42737,1,512,512,512.00,0.00,32752,32753
42738,1,512,512,512.00,0.00,32752,32753
42739,1,512,512,512.00,0.00,32752,32753
42740,2,331,181,256.00,5625.00,32752,32754
42741,1,512,512,512.00,0.00,32753,32754
42742,4,412,1,128.00,28453.50,32753,32757
42743,2,341,171,256.00,7225.00,32756,32758
42744,1,512,512,512.00,0.00,32757,32758
42745,1,512,512,512.00,0.00,32757,32758
42746,1,512,512,512.00,0.00,32757,32758
42747,1,512,512,512.00,0.00,32757,32758
42748,1,512,512,512.00,0.00,32757,32758
42749,3,276,2,170.67,14518.22,32757,32760
42750,2,283,229,256.00,729.00,32759,32761
42751,1,512,512,512.00,0.00,32760,32761
42752,1,512,512,512.00,0.00,32760,32761
42753,1,512,512,512.00,0.00,32760,32761
42754,4,431,3,128.00,31467.00,32760,32764
42755,6,311,4,85.33,13808.56,32763,32769
42756,5,316,4,102.40,12498.64,32768,32773
42757,1,512,512,512.00,0.00,32772,32773
42758,1,512,512,512.00,0.00,32772,32773
42759,1,512,512,512.00,0.00,32772,32773
42760,1,512,512,512.00,0.00,32772,32773
42761,2,499,13,256.00,59049.00,32772,32774
42762,1,512,512,512.00,0.00,32773,32774
42763,1,512,512,512.00,0.00,32773,32774
42764,1,512,512,512.00,0.00,32773,32774
42765,1,512,512,512.00,0.00,32773,32774
42766,2,353,159,256.00,9409.00,32773,32775
42767,1,512,512,512.00,0.00,32774,32775
42768,2,385,127,256.00,16641.00,32774,32776
42769,4,257,15,128.00,7649.00,32775,32779
42770,3,480,15,170.67,47844.22,32778,32781
42771,3,434,5,170.67,35442.89,32780,32783
42772,1,512,512,512.00,0.00,32782,32783
42773,7,196,1,73.14,5283.27,32782,32789
42774,1,512,512,512.00,0.00,32788,32789
42775,1,512,512,512.00,0.00,32788,32789
42776,2,444,68,256.00,35344.00,32788,32790
42777,2,368,144,256.00,12544.00,32789,32791
42778,1,512,512,512.00,0.00,32790,32791
42779,1,512,512,512.00,0.00,32790,32791
42780,1,512,512,512.00,0.00,32790,32791
42781,1,512,512,512.00,0.00,32790,32791
42782,1,512,512,512.00,0.00,32790,32791
42783,9,225,3,56.89,4322.99,32790,32799
42784,6,256,1,85.33,7168.56,32798,32804
42785,1,512,512,512.00,0.00,32803,32804
42786,3,285,57,170.67,8664.22,32803,32806
42787,1,512,512,512.00,0.00,32805,32806
42788,3,287,4,170.67,14614.89,32805,32808
42789,1,512,512,512.00,0.00,32807,32808
42790,1,512,512,512.00,0.00,32807,32808
42791,1,512,512,512.00,0.00,32807,32808
42792,2,504,8,256.00,61504.00,32807,32809
42793,1,512,512,512.00,0.00,32808,32809
42794,6,247,1,85.33,9224.89,32808,32814
42795,1,512,512,512.00,0.00,32813,32814
42796,4,339,9,128.00,16741.00,32813,32817
42797,10,170,1,51.20,3043.36,32816,32826
42798,3,450,1,170.67,39613.56,32825,32828
42799,1,512,512,512.00,0.00,32827,32828
42800,1,512,512,512.00,0.00,32827,32828
42801,1,512,512,512.00,0.00,32827,32828
42802,1,512,512,512.00,0.00,32827,32828
42803,1,512,512,512.00,0.00,32827,32828
42804,5,244,11,102.40,9734.64,32827,32832
42805,5,278,1,102.40,9725.04,32831,32836
42806,1,512,512,512.00,0.00,32835,32836
42807,1,512,512,512.00,0.00,32835,32836
42808,1,512,512,512.00,0.00,32835,32836
42809,4,476,1,128.00,40479.50,32835,32839
42810,1,512,512,512.00,0.00,32838,32839
42811,4,378,1,128.00,23693.50,32838,32842
42812,2,451,61,256.00,38025.00,32841,32843
42813,1,512,512,512.00,0.00,32842,32843
42814,1,512,512,512.00,0.00,32842,32843
42815,1,512,512,512.00,0.00,32842,32843
42816,4,289,1,128.00,16381.50,32842,32846
42817,1,512,512,512.00,0.00,32845,32846
42818,1,512,512,512.00,0.00,32845,32846
42819,1,512,512,512.00,0.00,32845,32846
42820,3,381,11,170.67,24100.22,32845,32848
42821,1,512,512,512.00,0.00,32847,32848
42822,1,512,512,512.00,0.00,32847,32848
42823,1,512,512,512.00,0.00,32847,32848
42824,1,512,512,512.00,0.00,32847,32848
42825,2,407,105,256.00,22801.00,32847,32849
42826,1,512,512,512.00,0.00,32848,32849
42827,2,349,163,256.00,8649.00,32848,32850
42828,2,372,140,256.00,13456.00,32849,32851
42829,3,367,39,170.67,20021.56,32850,32853
42830,1,512,512,512.00,0.00,32852,32853
42831,1,512,512,512.00,0.00,32852,32853
42832,1,512,512,512.00,0.00,32852,32853
42833,1,512,512,512.00,0.00,32852,32853
42834,4,335,1,128.00,15672.50,32852,32856
42835,3,317,4,170.67,16534.89,32855,32858
42836,1,512,512,512.00,0.00,32857,32858
42837,1,512,512,512.00,0.00,32857,32858
42838,1,512,512,512.00,0.00,32857,32858
42839,1,512,512,512.00,0.00,32857,32858
42840,1,512,512,512.00,0.00,32857,32858
42841,1,512,512,512.00,0.00,32857,32858
42842,1,512,512,512.00,0.00,32857,32858
42843,1,512,512,512.00,0.00,32857,32858
42844,1,512,512,512.00,0.00,32857,32858
42845,1,512,512,512.00,0.00,32857,32858
42846,1,512,512,512.00,0.00,32857,32858
42847,4,328,3,128.00,14645.50,32857,32861
42848,1,512,512,512.00,0.00,32860,32861
42849,3,253,62,170.67,6426.89,32860,32863
42850,6,332,1,85.33,14308.56,32862,32868
42851,1,512,512,512.00,0.00,32867,32868
42852,1,512,512,512.00,0.00,32867,32868
42853,2,348,164,256.00,8464.00,32867,32869
42854,1,512,512,512.00,0.00,32868,32869
42855,1,512,512,512.00,0.00,32868,32869
42856,1,512,512,512.00,0.00,32868,32869
42857,1,512,512,512.00,0.00,32868,32869
42858,1,512,512,512.00,0.00,32868,32869
42859,1,512,512,512.00,0.00,32868,32869
42860,3,302,100,170.67,8640.89,32868,32871
42861,8,246,3,64.00,6713.25,32870,32878
42862,1,512,512,512.00,0.00,32877,32878
42863,4,327,18,128.00,14996.50,32877,32881
42864,2,488,24,256.00,53824.00,32880,32882
42865,1,512,512,512.00,0.00,32881,32882
42866,1,512,512,512.00,0.00,32881,32882
42867,3,396,1,170.67,27553.56,32881,32884
42868,1,512,512,512.00,0.00,32883,32884
42869,3,322,43,170.67,13253.56,32883,32886
42870,2,329,183,256.00,5329.00,32885,32887
42871,1,512,512,512.00,0.00,32886,32887
42872,1,512,512,512.00,0.00,32886,32887
42873,1,512,512,512.00,0.00,32886,32887
42874,3,227,136,170.67,1614.89,32886,32889
42875,2,440,72,256.00,33856.00,32888,32890
42876,1,512,512,512.00,0.00,32889,32890
42877,1,512,512,512.00,0.00,32889,32890
42878,2,456,56,256.00,40000.00,32889,32891
42879,4,225,48,128.00,4124.50,32890,32894
42880,3,322,2,170.67,17216.89,32893,32896
42881,1,512,512,512.00,0.00,32895,32896
42882,2,375,137,256.00,14161.00,32895,32897
42883,4,227,32,128.00,4800.50,32896,32900
42884,1,512,512,512.00,0.00,32899,32900
42885,2,423,89,256.00,27889.00,32899,32901
42886,2,342,170,256.00,7396.00,32900,32902
42887,8,443,2,64.00,20577.50,32901,32909
42888,9,228,1,56.89,5307.88,32908,32917
42889,1,512,512,512.00,0.00,32916,32917
42890,1,512,512,512.00,0.00,32916,32917
42891,1,512,512,512.00,0.00,32916,32917
42892,2,366,146,256.00,12100.00,32916,32918
42893,2,340,172,256.00,7056.00,32917,32919
42894,2,388,124,256.00,17424.00,32918,32920
42895,2,438,74,256.00,33124.00,32919,32921
42896,1,512,512,512.00,0.00,32920,32921
42897,1,512,512,512.00,0.00,32920,32921
42898,1,512,512,512.00,0.00,32920,32921
42899,1,512,512,512.00,0.00,32920,32921
42900,2,357,155,256.00,10201.00,32920,32922
42901,4,336,39,128.00,14569.50,32921,32925
42902,5,401,1,102.40,23467.84,32924,32929
42903,2,451,61,256.00,38025.00,32928,32930
42904,4,410,1,128.00,26926.50,32929,32933
42905,3,417,2,170.67,31720.22,32932,32935
42906,4,236,26,128.00,10034.00,32934,32938
42907,1,512,512,512.00,0.00,32937,32938
42908,3,362,13,170.67,20866.89,32937,32940
42909,1,512,512,512.00,0.00,32939,32940
42910,1,512,512,512.00,0.00,32939,32940
42911,8,238,1,64.00,6225.50,32939,32947
42912,2,390,122,256.00,17956.00,32946,32948
42913,3,377,15,170.67,23124.22,32947,32950
42914,3,464,8,170.67,43192.89,32949,32952
42915,1,512,512,512.00,0.00,32951,32952
42916,1,512,512,512.00,0.00,32951,32952
42917,5,399,1,102.40,22601.04,32951,32956
42918,6,399,2,85.33,20724.22,32955,32961
42919,2,371,141,256.00,13225.00,32960,32962
42920,3,275,3,170.67,14336.22,32961,32964
42921,4,227,3,128.00,6921.50,32963,32967
42922,1,512,512,512.00,0.00,32966,32967
42923,3,483,4,170.67,48849.56,32966,32969
42924,5,241,6,102.40,7554.24,32968,32973
42925,3,475,2,170.67,46490.89,32972,32975
42926,1,512,512,512.00,0.00,32974,32975
42927,1,512,512,512.00,0.00,32974,32975
42928,1,512,512,512.00,0.00,32974,32975
42929,3,503,2,170.67,55226.89,32974,32977
42930,3,234,46,170.67,7771.56,32976,32979
42931,1,512,512,512.00,0.00,32978,32979
42932,7,270,1,73.14,7300.69,32978,32985
42933,3,304,81,170.67,9241.56,32984,32987
42934,3,494,2,170.67,52304.89,32986,32989
42935,1,512,512,512.00,0.00,32988,32989
42936,1,512,512,512.00,0.00,32988,32989
42937,1,512,512,512.00,0.00,32988,32989
42938,4,247,5,128.00,8046.50,32988,32992
42939,1,512,512,512.00,0.00,32991,32992
42940,4,249,2,128.00,13848.50,32991,32995
42941,1,512,512,512.00,0.00,32994,32995
42942,1,512,512,512.00,0.00,32994,32995
42943,2,340,172,256.00,7056.00,32994,32996
42944,4,277,1,128.00,16255.50,32995,32999
42945,1,512,512,512.00,0.00,32998,32999
42946,5,237,1,102.40,6515.84,32998,33003
42947,3,492,2,170.67,51670.22,33002,33005
42948,1,512,512,512.00,0.00,33004,33005
42949,3,227,135,170.67,1624.22,33004,33007
42950,1,512,512,512.00,0.00,33006,33007
42951,4,271,46,128.00,7261.50,33006,33010
42952,3,271,111,170.67,5093.56,33009,33012
42953,8,313,1,64.00,11057.00,33011,33019
42954,1,512,512,512.00,0.00,33018,33019
42955,2,321,191,256.00,4225.00,33018,33020
42956,4,274,2,128.00,16076.00,33019,33023
42957,1,512,512,512.00,0.00,33022,33023
42958,1,512,512,512.00,0.00,33022,33023
42959,2,290,222,256.00,1156.00,33022,33024
42960,1,512,512,512.00,0.00,33023,33024
42961,3,443,34,170.67,37082.89,33023,33026
42962,2,373,139,256.00,13689.00,33025,33027
42963,1,512,512,512.00,0.00,33026,33027
42964,1,512,512,512.00,0.00,33026,33027
42965,4,361,3,128.00,19514.50,33026,33030
42966,1,512,512,512.00,0.00,33029,33030
42967,1,512,512,512.00,0.00,33029,33030
42968,4,375,2,128.00,21997.50,33029,33033
42969,2,403,109,256.00,21609.00,33032,33034
42970,1,512,512,512.00,0.00,33033,33034
42971,3,296,6,170.67,14790.22,33033,33036
42972,6,324,4,85.33,12289.89,33035,33041
42973,1,512,512,512.00,0.00,33040,33041
42974,1,512,512,512.00,0.00,33040,33041
42975,2,276,236,256.00,400.00,33040,33042
42976,1,512,512,512.00,0.00,33041,33042
42977,1,512,512,512.00,0.00,33041,33042
42978,2,441,71,256.00,34225.00,33041,33043
42979,2,435,77,256.00,32041.00,33042,33044
42980,8,341,1,64.00,11578.75,33043,33051
42981,1,512,512,512.00,0.00,33050,33051
42982,5,200,5,102.40,6004.24,33050,33055
42983,1,512,512,512.00,0.00,33054,33055
42984,4,210,1,128.00,6401.50,33054,33058
42985,8,277,3,64.00,7627.50,33057,33065
42986,1,512,512,512.00,0.00,33064,33065
42987,1,512,512,512.00,0.00,33064,33065
42988,1,512,512,512.00,0.00,33064,33065
42989,3,202,114,170.67,1611.56,33064,33067
42990,1,512,512,512.00,0.00,33066,33067
42991,2,487,25,256.00,53361.00,33066,33068
42992,1,512,512,512.00,0.00,33067,33068
42993,2,341,171,256.00,7225.00,33067,33069
42994,1,512,512,512.00,0.00,33068,33069
42995,1,512,512,512.00,0.00,33068,33069
42996,3,269,39,170.67,9372.22,33068,33071
42997,1,512,512,512.00,0.00,33070,33071
42998,1,512,512,512.00,0.00,33070,33071
42999,2,489,23,256.00,54289.00,33070,33072
43000,1,512,512,512.00,0.00,33071,33072
43001,3,494,1,170.67,52314.89,33071,33074
43002,1,512,512,512.00,0.00,33073,33074
43003,1,512,512,512.00,0.00,33073,33074
43004,6,226,10,85.33,9765.22,33073,33079
43005,3,240,104,170.67,3086.22,33078,33081
43006,3,421,34,170.67,31421.56,33080,33083
43007,1,512,512,512.00,0.00,33082,33083
43008,2,346,166,256.00,8100.00,33082,33084
43009,1,512,512,512.00,0.00,33083,33084
43010,2,402,110,256.00,21316.00,33083,33085
43011,2,301,211,256.00,2025.00,33084,33086
43012,1,512,512,512.00,0.00,33085,33086
43013,6,238,3,85.33,7754.56,33085,33091
43014,1,512,512,512.00,0.00,33090,33091
43015,1,512,512,512.00,0.00,33090,33091
43016,2,339,173,256.00,6889.00,33090,33092
43017,4,350,45,128.00,16536.50,33091,33095
43018,2,478,34,256.00,49284.00,33094,33096
43019,1,512,512,512.00,0.00,33095,33096
43020,1,512,512,512.00,0.00,33095,33096
43021,1,512,512,512.00,0.00,33095,33096
43022,4,351,20,128.00,17254.50,33095,33099
43023,1,512,512,512.00,0.00,33098,33099
43024,2,436,76,256.00,32400.00,33098,33100
43025,1,512,512,512.00,0.00,33099,33100
43026,1,512,512,512.00,0.00,33099,33100
43027,3,476,1,170.67,46806.89,33099,33102
43028,2,309,203,256.00,2809.00,33101,33103
43029,1,512,512,512.00,0.00,33102,33103
43030,1,512,512,512.00,0.00,33102,33103
43031,1,512,512,512.00,0.00,33102,33103
43032,10,113,1,51.20,1602.96,33102,33112
43033,4,289,3,128.00,10561.00,33111,33115
43034,1,512,512,512.00,0.00,33114,33115
43035,1,512,512,512.00,0.00,33114,33115
43036,2,273,239,256.00,289.00,33114,33116
43037,1,512,512,512.00,0.00,33115,33116
43038,1,512,512,512.00,0.00,33115,33116
43039,1,512,512,512.00,0.00,33115,33116
43040,1,512,512,512.00,0.00,33115,33116
43041,2,261,251,256.00,25.00,33115,33117
43042,1,512,512,512.00,0.00,33116,33117
43043,1,512,512,512.00,0.00,33116,33117
43044,1,512,512,512.00,0.00,33116,33117
43045,2,424,88,256.00,28224.00,33116,33118
43046,1,512,512,512.00,0.00,33117,33118
43047,1,512,512,512.00,0.00,33117,33118
43048,3,460,5,170.67,42150.89,33117,33120
43049,2,334,178,256.00,6084.00,33119,33121
43050,1,512,512,512.00,0.00,33120,33121
43051,2,352,160,256.00,9216.00,33120,33122
43052,1,512,512,512.00,0.00,33121,33122
43053,1,512,512,512.00,0.00,33121,33122
43054,1,512,512,512.00,0.00,33121,33122
43055,1,512,512,512.00,0.00,33121,33122
43056,3,299,1,170.67,15654.89,33121,33124
43057,1,512,512,512.00,0.00,33123,33124
43058,1,512,512,512.00,0.00,33123,33124
43059,1,512,512,512.00,0.00,33123,33124
43060,2,266,246,256.00,100.00,33123,33125
43061,11,231,1,46.55,4874.98,33124,33135
43062,1,512,512,512.00,0.00,33134,33135
43063,4,356,6,128.00,20433.50,33134,33138
43064,1,512,512,512.00,0.00,33137,33138
43065,1,512,512,512.00,0.00,33137,33138
43066,1,512,512,512.00,0.00,33137,33138
43067,2,381,131,256.00,15625.00,33137,33139
43068,1,512,512,512.00,0.00,33138,33139
43069,1,512,512,512.00,0.00,33138,33139
43070,1,512,512,512.00,0.00,33138,33139
43071,3,343,84,170.67,14849.56,33138,33141
43072,3,424,3,170.67,33209.56,33140,33143
43073,3,327,30,170.67,14824.22,33142,33145
43074,1,512,512,512.00,0.00,33144,33145
43075,1,512,512,512.00,0.00,33144,33145
43076,3,291,26,170.67,12000.22,33144,33147
43077,2,303,209,256.00,2209.00,33146,33148
43078,1,512,512,512.00,0.00,33147,33148
43079,5,262,2,102.40,9357.04,33147,33152
43080,4,412,3,128.00,27665.50,33151,33155
43081,1,512,512,512.00,0.00,33154,33155
43082,3,431,4,170.67,34774.89,33154,33157
43083,4,258,1,128.00,12914.50,33156,33160
43084,3,409,2,170.67,30034.89,33159,33162
43085,1,512,512,512.00,0.00,33161,33162
43086,1,512,512,512.00,0.00,33161,33162
43087,2,377,135,256.00,14641.00,33161,33163
43088,1,512,512,512.00,0.00,33162,33163
43089,1,512,512,512.00,0.00,33162,33163
43090,1,512,512,512.00,0.00,33162,33163
43091,1,512,512,512.00,0.00,33162,33163
43092,5,389,2,102.40,21469.44,33162,33167
43093,1,512,512,512.00,0.00,33166,33167
43094,1,512,512,512.00,0.00,33166,33167
43095,1,512,512,512.00,0.00,33166,33167
43096,1,512,512,512.00,0.00,33166,33167
43097,1,512,512,512.00,0.00,33166,33167
43098,5,471,1,102.40,34097.44,33166,33171
43099,1,512,512,512.00,0.00,33170,33171
43100,1,512,512,512.00,0.00,33170,33171
43101,1,512,512,512.00,0.00,33170,33171
43102,1,512,512,512.00,0.00,33170,33171
43103,1,512,512,512.00,0.00,33170,33171
43104,5,319,1,102.40,15447.04,33170,33175
43105,1,512,512,512.00,0.00,33174,33175
43106,1,512,512,512.00,0.00,33174,33175
43107,1,512,512,512.00,0.00,33174,33175
43108,4,332,1,128.00,18663.50,33174,33178
43109,3,374,1,170.67,23754.89,33177,33180
43110,1,512,512,512.00,0.00,33179,33180
43111,1,512,512,512.00,0.00,33179,33180
43112,1,512,512,512.00,0.00,33179,33180
43113,1,512,512,512.00,0.00,33179,33180
43114,2,313,199,256.00,3249.00,33179,33181
43115,1,512,512,512.00,0.00,33180,33181
43116,1,512,512,512.00,0.00,33180,33181
43117,1,512,512,512.00,0.00,33180,33181
43118,2,434,78,256.00,31684.00,33180,33182
43119,2,329,183,256.00,5329.00,33181,33183
43120,1,512,512,512.00,0.00,33182,33183
43121,2,353,159,256.00,9409.00,33182,33184
43122,6,208,11,85.33,6793.22,33183,33189
43123,1,512,512,512.00,0.00,33188,33189
43124,4,314,4,128.00,15494.00,33188,33192
43125,1,512,512,512.00,0.00,33191,33192
43126,1,512,512,512.00,0.00,33191,33192
43127,3,335,20,170.67,16630.89,33191,33194
43128,3,509,1,170.67,57234.89,33193,33196
43129,1,512,512,512.00,0.00,33195,33196
43130,8,176,1,64.00,5137.00,33195,33203
43131,2,363,149,256.00,11449.00,33202,33204
43132,1,512,512,512.00,0.00,33203,33204
43133,2,440,72,256.00,33856.00,33203,33205
43134,2,486,26,256.00,52900.00,33204,33206
43135,3,449,2,170.67,39314.89,33205,33208
43136,1,512,512,512.00,0.00,33207,33208
43137,1,512,512,512.00,0.00,33207,33208
43138,1,512,512,512.00,0.00,33207,33208
43139,2,510,2,256.00,64516.00,33207,33209
43140,1,512,512,512.00,0.00,33208,33209
43141,1,512,512,512.00,0.00,33208,33209
43142,1,512,512,512.00,0.00,33208,33209
43143,2,417,95,256.00,25921.00,33208,33210
43144,1,512,512,512.00,0.00,33209,33210
43145,2,423,89,256.00,27889.00,33209,33211
43146,5,251,1,102.40,12063.84,33210,33215
43147,5,387,4,102.40,20756.24,33214,33219
43148,1,512,512,512.00,0.00,33218,33219
43149,1,512,512,512.00,0.00,33218,33219
43150,1,512,512,512.00,0.00,33218,33219
43151,2,287,225,256.00,961.00,33218,33220
43152,1,512,512,512.00,0.00,33219,33220
43153,1,512,512,512.00,0.00,33219,33220
43154,4,332,3,128.00,17791.50,33219,33223
43155,2,275,237,256.00,361.00,33222,33224
43156,1,512,512,512.00,0.00,33223,33224
43157,3,460,11,170.67,42006.89,33223,33226
43158,2,360,152,256.00,10816.00,33225,33227
43159,1,512,512,512.00,0.00,33226,33227
43160,2,305,207,256.00,2401.00,33226,33228
43161,5,421,1,102.40,26074.24,33227,33232
43162,1,512,512,512.00,0.00,33231,33232
43163,1,512,512,512.00,0.00,33231,33232
43164,1,512,512,512.00,0.00,33231,33232
43165,2,264,248,256.00,64.00,33231,33233
43166,3,427,8,170.67,33646.89,33232,33235
43167,4,364,10,128.00,20497.50,33234,33238
43168,7,305,1,73.14,10070.69,33238,33245
43169,1,512,512,512.00,0.00,33244,33245
43170,3,425,36,170.67,32380.22,33244,33247
43171,1,512,512,512.00,0.00,33246,33247
43172,3,208,135,170.67,889.56,33246,33249
43173,2,316,196,256.00,3600.00,33248,33250
43174,1,512,512,512.00,0.00,33249,33250
43175,1,512,512,512.00,0.00,33249,33250
43176,2,455,57,256.00,39601.00,33249,33251
43177,1,512,512,512.00,0.00,33250,33251
43178,1,512,512,512.00,0.00,33250,33251
43179,1,512,512,512.00,0.00,33250,33251
43180,5,224,1,102.40,7073.04,33250,33255
43181,4,202,1,128.00,6217.50,33254,33258
43182,1,512,512,512.00,0.00,33257,33258
43183,1,512,512,512.00,0.00,33257,33258
43184,3,257,34,170.67,9554.89,33257,33260
43185,1,512,512,512.00,0.00,33259,33260
43186,2,297,215,256.00,1681.00,33259,33261
43187,1,512,512,512.00,0.00,33260,33261
43188,3,346,38,170.67,16720.89,33260,33263
43189,2,312,200,256.00,3136.00,33262,33264
43190,1,512,512,512.00,0.00,33263,33264
43191,1,512,512,512.00,0.00,33263,33264
43192,1,512,512,512.00,0.00,33263,33264
43193,2,385,127,256.00,16641.00,33263,33265
43194,2,488,24,256.00,53824.00,33264,33266
43195,1,512,512,512.00,0.00,33265,33266
43196,3,447,7,170.67,38613.56,33265,33268
43197,1,512,512,512.00,0.00,33267,33268
43198,1,512,512,512.00,0.00,33267,33268
43199,2,476,36,256.00,48400.00,33267,33269
43200,4,321,2,128.00,17583.50,33268,33272
43201,1,512,512,512.00,0.00,33271,33272
43202,4,227,1,128.00,8758.50,33271,33275
43203,2,357,155,256.00,10201.00,33274,33276
43204,1,512,512,512.00,0.00,33275,33276
43205,5,352,1,102.40,18055.44,33275,33280
43206,1,512,512,512.00,0.00,33279,33280
43207,1,512,512,512.00,0.00,33279,33280
43208,2,293,219,256.00,1369.00,33279,33281
43209,5,227,1,102.40,7938.24,33280,33285
43210,1,512,512,512.00,0.00,33284,33285
43211,1,512,512,512.00,0.00,33284,33285
43212,3,378,65,170.67,21496.22,33284,33287
43213,1,512,512,512.00,0.00,33286,33287
43214,1,512,512,512.00,0.00,33286,33287
43215,2,452,60,256.00,38416.00,33286,33288
43216,2,370,142,256.00,12996.00,33287,33289
43217,2,298,214,256.00,1764.00,33288,33290
43218,5,436,1,102.40,28030.24,33289,33294
43219,3,314,57,170.67,11448.22,33293,33296
43220,3,312,23,170.67,13940.22,33295,33298
43221,1,512,512,512.00,0.00,33297,33298
43222,2,469,43,256.00,45369.00,33297,33299
43223,5,262,1,102.40,8509.84,33298,33303
43224,1,512,512,512.00,0.00,33302,33303
43225,1,512,512,512.00,0.00,33302,33303
43226,3,431,31,170.67,33946.89,33302,33305
43227,1,512,512,512.00,0.00,33304,33305
43228,1,512,512,512.00,0.00,33304,33305
43229,1,512,512,512.00,0.00,33304,33305
43230,3,332,87,170.67,13020.22,33304,33307
43231,1,512,512,512.00,0.00,33306,33307
43232,1,512,512,512.00,0.00,33306,33307
43233,1,512,512,512.00,0.00,33306,33307
43234,2,322,190,256.00,4356.00,33306,33308
43235,2,318,194,256.00,3844.00,33307,33309
43236,1,512,512,512.00,0.00,33308,33309
43237,1,512,512,512.00,0.00,33308,33309
43238,3,330,44,170.67,14166.22,33308,33311
43239,4,226,1,128.00,9094.50,33310,33314
43240,1,512,512,512.00,0.00,33313,33314
43241,5,350,1,102.40,16627.44,33313,33318
43242,1,512,512,512.00,0.00,33317,33318
43243,2,323,189,256.00,4489.00,33317,33319
43244,1,512,512,512.00,0.00,33318,33319
43245,2,494,18,256.00,56644.00,33318,33320
43246,1,512,512,512.00,0.00,33319,33320
43247,1,512,512,512.00,0.00,33319,33320
43248,1,512,512,512.00,0.00,33319,33320
43249,2,376,136,256.00,14400.00,33319,33321
43250,1,512,512,512.00,0.00,33320,33321
43251,6,358,5,85.33,15625.56,33320,33326
43252,1,512,512,512.00,0.00,33325,33326
43253,3,435,1,170.67,35873.56,33325,33328
43254,2,288,224,256.00,1024.00,33327,33329
43255,1,512,512,512.00,0.00,33328,33329
43256,1,512,512,512.00,0.00,33328,33329
43257,1,512,512,512.00,0.00,33328,33329
43258,1,512,512,512.00,0.00,33328,33329
43259,4,360,10,128.00,18826.00,33328,33332
43260,1,512,512,512.00,0.00,33331,33332
43261,1,512,512,512.00,0.00,33331,33332
43262,1,512,512,512.00,0.00,33331,33332
43263,1,512,512,512.00,0.00,33331,33332
43264,1,512,512,512.00,0.00,33331,33332
43265,1,512,512,512.00,0.00,33331,33332
43266,1,512,512,512.00,0.00,33331,33332
43267,6,171,6,85.33,3300.89,33331,33337
43268,1,512,512,512.00,0.00,33336,33337
43269,1,512,512,512.00,0.00,33336,33337
43270,1,512,512,512.00,0.00,33336,33337
43271,1,512,512,512.00,0.00,33336,33337
43272,2,309,203,256.00,2809.00,33336,33338
43273,2,434,78,256.00,31684.00,33337,33339
43274,5,191,5,102.40,6007.44,33338,33343
43275,3,408,15,170.67,29076.22,33342,33345
43276,1,512,512,512.00,0.00,33344,33345
43277,2,488,24,256.00,53824.00,33344,33346
43278,6,370,7,85.33,16520.22,33345,33351
43279,1,512,512,512.00,0.00,33350,33351
43280,1,512,512,512.00,0.00,33350,33351
43281,1,512,512,512.00,0.00,33350,33351
43282,6,283,2,85.33,10550.89,33350,33356
43283,11,151,1,46.55,2838.43,33355,33366
43284,1,512,512,512.00,0.00,33365,33366
43285,1,512,512,512.00,0.00,33365,33366
43286,1,512,512,512.00,0.00,33365,33366
43287,1,512,512,512.00,0.00,33365,33366
43288,3,419,14,170.67,31538.89,33365,33368
43289,1,512,512,512.00,0.00,33367,33368
43290,1,512,512,512.00,0.00,33367,33368
43291,3,282,45,170.67,9464.22,33367,33370
43292,4,426,1,128.00,30059.50,33369,33373
43293,1,512,512,512.00,0.00,33372,33373
43294,1,512,512,512.00,0.00,33372,33373
43295,1,512,512,512.00,0.00,33372,33373
43296,1,512,512,512.00,0.00,33372,33373
43297,3,378,2,170.67,24310.22,33372,33375
43298,3,228,81,170.67,4124.22,33374,33377
43299,6,388,1,85.33,19100.56,33376,33382
43300,1,512,512,512.00,0.00,33381,33382
43301,1,512,512,512.00,0.00,33381,33382
43302,6,263,7,85.33,7876.56,33381,33387
43303,1,512,512,512.00,0.00,33386,33387
43304,1,512,512,512.00,0.00,33386,33387
43305,1,512,512,512.00,0.00,33386,33387
43306,1,512,512,512.00,0.00,33386,33387
43307,2,432,80,256.00,30976.00,33386,33388
43308,3,454,1,170.67,40661.56,33387,33390
43309,4,403,1,128.00,26361.00,33389,33393
43310,4,210,66,128.00,3236.50,33392,33396
43311,2,374,138,256.00,13924.00,33395,33397
43312,2,300,212,256.00,1936.00,33396,33398
43313,4,238,1,128.00,8524.50,33397,33401
43314,3,456,8,170.67,40974.22,33400,33403
43315,2,377,135,256.00,14641.00,33402,33404
43316,1,512,512,512.00,0.00,33403,33404
43317,3,380,45,170.67,22204.22,33403,33406
43318,2,402,110,256.00,21316.00,33405,33407
43319,1,512,512,512.00,0.00,33406,33407
43320,5,416,1,102.40,25191.44,33406,33411
43321,4,223,2,128.00,6780.50,33410,33414
43322,3,275,54,170.67,8216.22,33413,33416
43323,1,512,512,512.00,0.00,33415,33416
43324,2,438,74,256.00,33124.00,33415,33417
43325,2,359,153,256.00,10609.00,33416,33418
43326,1,512,512,512.00,0.00,33417,33418
43327,4,346,2,128.00,19152.50,33417,33421
43328,3,428,5,170.67,34022.89,33420,33423
43329,1,512,512,512.00,0.00,33422,33423
43330,1,512,512,512.00,0.00,33422,33423
43331,1,512,512,512.00,0.00,33422,33423
43332,3,329,51,170.67,13628.22,33422,33425
43333,1,512,512,512.00,0.00,33424,33425
43334,1,512,512,512.00,0.00,33424,33425
43335,2,315,197,256.00,3481.00,33424,33426
43336,1,512,512,512.00,0.00,33425,33426
43337,1,512,512,512.00,0.00,33425,33426
43338,2,398,114,256.00,20164.00,33425,33427
43339,4,194,73,128.00,1980.50,33426,33430
43340,1,512,512,512.00,0.00,33429,33430
43341,1,512,512,512.00,0.00,33429,33430
43342,1,512,512,512.00,0.00,33429,33430
43343,1,512,512,512.00,0.00,33429,33430
43344,1,512,512,512.00,0.00,33429,33430
43345,2,283,229,256.00,729.00,33429,33431
43346,1,512,512,512.00,0.00,33430,33431
43347,1,512,512,512.00,0.00,33430,33431
43348,2,508,4,256.00,63504.00,33430,33432
43349,3,449,1,170.67,39354.89,33431,33434
43350,2,342,170,256.00,7396.00,33433,33435
43351,1,512,512,512.00,0.00,33434,33435
43352,1,512,512,512.00,0.00,33434,33435
43353,1,512,512,512.00,0.00,33434,33435
43354,1,512,512,512.00,0.00,33434,33435
43355,3,456,7,170.67,41001.56,33434,33437
43356,4,383,2,128.00,23845.50,33436,33440
43357,1,512,512,512.00,0.00,33439,33440
43358,1,512,512,512.00,0.00,33439,33440
43359,1,512,512,512.00,0.00,33439,33440
43360,6,368,1,85.33,17913.56,33439,33445
43361,3,351,77,170.67,16268.22,33444,33447
43362,2,417,95,256.00,25921.00,33446,33448
43363,3,392,2,170.67,26736.89,33447,33450
43364,1,512,512,512.00,0.00,33449,33450
43365,3,445,9,170.67,38029.56,33449,33452
43366,3,376,37,170.67,21721.56,33451,33454
43367,1,512,512,512.00,0.00,33453,33454
43368,4,441,11,128.00,32829.00,33453,33457
43369,2,453,59,256.00,38809.00,33456,33458
43370,1,512,512,512.00,0.00,33457,33458
43371,1,512,512,512.00,0.00,33457,33458
43372,1,512,512,512.00,0.00,33457,33458
43373,1,512,512,512.00,0.00,33457,33458
43374,2,507,5,256.00,63001.00,33457,33459
43375,4,255,18,128.00,10921.50,33458,33462
43376,1,512,512,512.00,0.00,33461,33462
43377,1,512,512,512.00,0.00,33461,33462
43378,2,434,78,256.00,31684.00,33461,33463
43379,1,512,512,512.00,0.00,33462,33463
43380,1,512,512,512.00,0.00,33462,33463
43381,5,174,10,102.40,3405.04,33462,33467
43382,1,512,512,512.00,0.00,33466,33467
43383,1,512,512,512.00,0.00,33466,33467
43384,1,512,512,512.00,0.00,33466,33467
43385,1,512,512,512.00,0.00,33466,33467
43386,1,512,512,512.00,0.00,33466,33467
43387,1,512,512,512.00,0.00,33466,33467
43388,1,512,512,512.00,0.00,33466,33467
43389,1,512,512,512.00,0.00,33466,33467
43390,1,512,512,512.00,0.00,33466,33467
43391,1,512,512,512.00,0.00,33466,33467
43392,1,512,512,512.00,0.00,33466,33467
43393,3,303,73,170.67,9417.56,33466,33469
43394,1,512,512,512.00,0.00,33468,33469
43395,2,304,208,256.00,2304.00,33468,33470
43396,1,512,512,512.00,0.00,33469,33470
43397,3,469,8,170.67,44622.89,33469,33472
43398,3,460,9,170.67,42049.56,33471,33474
43399,2,381,131,256.00,15625.00,33473,33475
43400,1,512,512,512.00,0.00,33474,33475
43401,1,512,512,512.00,0.00,33474,33475
43402,2,409,103,256.00,23409.00,33474,33476
43403,1,512,512,512.00,0.00,33475,33476
43404,4,286,10,128.00,12034.50,33475,33479
43405,3,373,57,170.67,20573.56,33478,33481
43406,2,257,255,256.00,1.00,33480,33482
43407,1,512,512,512.00,0.00,33481,33482
43408,1,512,512,512.00,0.00,33481,33482
43409,2,415,97,256.00,25281.00,33481,33483
43410,1,512,512,512.00,0.00,33482,33483
43411,3,451,1,170.67,39873.56,33482,33485
43412,3,500,5,170.67,54230.89,33484,33487
43413,2,342,170,256.00,7396.00,33486,33488
43414,1,512,512,512.00,0.00,33487,33488
43415,2,272,240,256.00,256.00,33487,33489
43416,1,512,512,512.00,0.00,33488,33489
43417,2,351,161,256.00,9025.00,33488,33490
43418,2,443,69,256.00,34969.00,33489,33491
43419,1,512,512,512.00,0.00,33490,33491
43420,1,512,512,512.00,0.00,33490,33491
43421,1,512,512,512.00,0.00,33490,33491
43422,1,512,512,512.00,0.00,33490,33491
43423,3,374,65,170.67,20682.89,33490,33493
43424,1,512,512,512.00,0.00,33492,33493
43425,1,512,512,512.00,0.00,33492,33493
43426,1,512,512,512.00,0.00,33492,33493
43427,4,233,24,128.00,8620.50,33492,33496
43428,2,334,178,256.00,6084.00,33495,33497
43429,1,512,512,512.00,0.00,33496,33497
43430,3,300,1,170.67,15713.56,33496,33499
43431,3,244,104,170.67,3288.89,33498,33501
43432,1,512,512,512.00,0.00,33500,33501
43433,2,470,42,256.00,45796.00,33500,33502
43434,1,512,512,512.00,0.00,33501,33502
43435,3,434,35,170.67,34682.89,33501,33504
43436,3,457,23,170.67,41006.89,33503,33506
43437,2,397,115,256.00,19881.00,33505,33507
43438,3,435,1,170.67,35873.56,33506,33509
43439,3,398,1,170.67,27930.89,33508,33511
43440,1,512,512,512.00,0.00,33510,33511
43441,1,512,512,512.00,0.00,33510,33511
43442,3,321,32,170.67,13988.22,33510,33513
43443,1,512,512,512.00,0.00,33512,33513
43444,1,512,512,512.00,0.00,33512,33513
43445,1,512,512,512.00,0.00,33512,33513
43446,3,359,3,170.67,21336.22,33512,33515
43447,1,512,512,512.00,0.00,33514,33515
43448,1,512,512,512.00,0.00,33514,33515
43449,3,256,1,170.67,14393.56,33514,33517
43450,2,378,134,256.00,14884.00,33516,33518
43451,4,253,13,128.00,8065.50,33517,33521
43452,1,512,512,512.00,0.00,33520,33521
43453,1,512,512,512.00,0.00,33520,33521
43454,3,271,21,170.67,11633.56,33520,33523
43455,3,308,54,170.67,10966.22,33522,33525
43456,1,512,512,512.00,0.00,33524,33525
43457,1,512,512,512.00,0.00,33524,33525
43458,4,355,7,128.00,19247.50,33524,33528
43459,2,463,49,256.00,42849.00,33527,33529
43460,1,512,512,512.00,0.00,33528,33529
43461,2,499,13,256.00,59049.00,33528,33530
43462,2,338,174,256.00,6724.00,33529,33531
43463,4,450,4,128.00,34697.50,33530,33534
43464,1,512,512,512.00,0.00,33533,33534
43465,1,512,512,512.00,0.00,33533,33534
43466,1,512,512,512.00,0.00,33533,33534
43467,1,512,512,512.00,0.00,33533,33534
43468,4,261,8,128.00,11698.50,33533,33537
43469,1,512,512,512.00,0.00,33536,33537
43470,1,512,512,512.00,0.00,33536,33537
43471,1,512,512,512.00,0.00,33536,33537
43472,3,308,3,170.67,15964.22,33536,33539
43473,3,293,4,170.67,14902.89,33538,33541
43474,1,512,512,512.00,0.00,33540,33541
43475,1,512,512,512.00,0.00,33540,33541
43476,1,512,512,512.00,0.00,33540,33541
43477,1,512,512,512.00,0.00,33540,33541
43478,1,512,512,512.00,0.00,33540,33541
43479,2,314,198,256.00,3364.00,33540,33542
43480,2,264,248,256.00,64.00,33541,33543
43481,1,512,512,512.00,0.00,33542,33543
43482,1,512,512,512.00,0.00,33542,33543
43483,3,334,50,170.67,14352.89,33542,33545
43484,1,512,512,512.00,0.00,33544,33545
43485,1,512,512,512.00,0.00,33544,33545
43486,2,439,73,256.00,33489.00,33544,33546
43487,6,284,8,85.33,10271.56,33545,33551
43488,3,403,11,170.67,28250.89,33550,33553
43489,8,133,1,64.00,1975.00,33552,33560
43490,5,188,1,102.40,4558.64,33559,33564
43491,2,285,227,256.00,841.00,33563,33565
43492,1,512,512,512.00,0.00,33564,33565
43493,1,512,512,512.00,0.00,33564,33565
43494,5,300,1,102.40,15764.24,33564,33569
43495,1,512,512,512.00,0.00,33568,33569
43496,1,512,512,512.00,0.00,33568,33569
43497,3,441,1,170.67,37333.56,33568,33571
43498,1,512,512,512.00,0.00,33570,33571
43499,1,512,512,512.00,0.00,33570,33571
43500,1,512,512,512.00,0.00,33570,33571
43501,1,512,512,512.00,0.00,33570,33571
43502,1,512,512,512.00,0.00,33570,33571
43503,3,470,10,170.67,44880.89,33570,33573
43504,1,512,512,512.00,0.00,33572,33573
43505,1,512,512,512.00,0.00,33572,33573
43506,10,149,3,51.20,2817.36,33572,33582
43507,1,512,512,512.00,0.00,33581,33582
43508,1,512,512,512.00,0.00,33581,33582
43509,4,259,4,128.00,9736.50,33581,33585
43510,1,512,512,512.00,0.00,33584,33585
43511,1,512,512,512.00,0.00,33584,33585
43512,3,504,2,170.67,55558.22,33584,33587
43513,2,457,55,256.00,40401.00,33587,33589
43514,1,512,512,512.00,0.00,33588,33589
43515,6,258,1,85.33,11256.89,33588,33594
43516,1,512,512,512.00,0.00,33593,33594
43517,2,315,197,256.00,3481.00,33593,33595
43518,2,375,137,256.00,14161.00,33594,33596
43519,1,512,512,512.00,0.00,33595,33596
43520,2,309,203,256.00,2809.00,33595,33597
43521,2,290,222,256.00,1156.00,33596,33598
43522,1,512,512,512.00,0.00,33597,33598
43523,1,512,512,512.00,0.00,33597,33598
43524,1,512,512,512.00,0.00,33597,33598
43525,1,512,512,512.00,0.00,33597,33598
43526,2,357,155,256.00,10201.00,33597,33599
43527,2,344,168,256.00,7744.00,33598,33600
43528,2,276,236,256.00,400.00,33599,33601
43529,2,332,180,256.00,5776.00,33600,33602
43530,3,430,5,170.67,34490.89,33601,33604
43531,2,290,222,256.00,1156.00,33603,33605
43532,5,416,3,102.40,24815.44,33604,33609
43533,3,338,4,170.67,18592.89,33608,33611
43534,2,391,121,256.00,18225.00,33610,33612
43535,1,512,512,512.00,0.00,33611,33612
43536,2,419,93,256.00,26569.00,33611,33613
43537,2,510,2,256.00,64516.00,33612,33614
43538,2,338,174,256.00,6724.00,33613,33615
43539,2,494,18,256.00,56644.00,33614,33616
43540,2,499,13,256.00,59049.00,33615,33617
43541,2,455,57,256.00,39601.00,33616,33618
43542,1,512,512,512.00,0.00,33617,33618
43543,1,512,512,512.00,0.00,33617,33618
43544,2,409,103,256.00,23409.00,33617,33619
43545,1,512,512,512.00,0.00,33618,33619
43546,1,512,512,512.00,0.00,33618,33619
43547,1,512,512,512.00,0.00,33618,33619
43548,2,460,52,256.00,41616.00,33618,33620
43549,2,338,174,256.00,6724.00,33619,33621
43550,1,512,512,512.00,0.00,33620,33621
43551,1,512,512,512.00,0.00,33620,33621
43552,2,345,167,256.00,7921.00,33620,33622
43553,1,512,512,512.00,0.00,33621,33622
43554,3,436,12,170.67,35651.56,33621,33624
43555,1,512,512,512.00,0.00,33623,33624
43556,4,333,2,128.00,18996.50,33623,33627
43557,4,338,1,128.00,18546.50,33626,33630
43558,3,261,83,170.67,5284.22,33629,33632
43559,1,512,512,512.00,0.00,33631,33632
43560,1,512,512,512.00,0.00,33631,33632
43561,5,166,48,102.40,1629.04,33631,33636
43562,1,512,512,512.00,0.00,33635,33636
43563,1,512,512,512.00,0.00,33635,33636
43564,1,512,512,512.00,0.00,33635,33636
43565,2,475,37,256.00,47961.00,33635,33637
43566,3,339,71,170.67,14328.22,33636,33639
43567,1,512,512,512.00,0.00,33638,33639
43568,1,512,512,512.00,0.00,33638,33639
43569,1,512,512,512.00,0.00,33638,33639
43570,1,512,512,512.00,0.00,33638,33639
43571,1,512,512,512.00,0.00,33638,33639
43572,1,512,512,512.00,0.00,33638,33639
43573,1,512,512,512.00,0.00,33638,33639
43574,1,512,512,512.00,0.00,33638,33639
43575,1,512,512,512.00,0.00,33638,33639
43576,2,293,219,256.00,1369.00,33638,33640
43577,1,512,512,512.00,0.00,33639,33640
43578,2,496,16,256.00,57600.00,33639,33641
43579,3,493,9,170.67,51949.56,33640,33643
43580,5,177,8,102.40,4422.64,33642,33647
43581,2,374,138,256.00,13924.00,33646,33648
43582,4,409,16,128.00,26599.50,33647,33651
43583,3,394,24,170.67,25755.56,33650,33653
43584,3,327,51,170.67,13368.22,33652,33655
43585,1,512,512,512.00,0.00,33654,33655
43586,1,512,512,512.00,0.00,33654,33655
43587,1,512,512,512.00,0.00,33654,33655
43588,3,365,3,170.67,22196.22,33654,33657
43589,2,364,148,256.00,11664.00,33656,33658
43590,1,512,512,512.00,0.00,33657,33658
43591,1,512,512,512.00,0.00,33657,33658
43592,3,273,77,170.67,6440.22,33657,33660
43593,1,512,512,512.00,0.00,33659,33660
43594,2,419,93,256.00,26569.00,33659,33661
43595,2,376,136,256.00,14400.00,33660,33662
43596,1,512,512,512.00,0.00,33661,33662
43597,1,512,512,512.00,0.00,33661,33662
43598,1,512,512,512.00,0.00,33661,33662
43599,1,512,512,512.00,0.00,33661,33662
43600,1,512,512,512.00,0.00,33661,33662
43601,2,286,226,256.00,900.00,33661,33663
43602,1,512,512,512.00,0.00,33662,33663
43603,1,512,512,512.00,0.00,33662,33663
43604,1,512,512,512.00,0.00,33662,33663
43605,1,512,512,512.00,0.00,33662,33663
43606,2,442,70,256.00,34596.00,33662,33664
43607,1,512,512,512.00,0.00,33663,33664
43608,1,512,512,512.00,0.00,33663,33664
43609,1,512,512,512.00,0.00,33663,33664
43610,1,512,512,512.00,0.00,33663,33664
43611,1,512,512,512.00,0.00,33663,33664
43612,2,297,215,256.00,1681.00,33663,33665
43613,4,311,1,128.00,16668.50,33664,33668
43614,2,478,34,256.00,49284.00,33667,33669
43615,1,512,512,512.00,0.00,33668,33669
43616,1,512,512,512.00,0.00,33668,33669
43617,1,512,512,512.00,0.00,33668,33669
43618,1,512,512,512.00,0.00,33668,33669
43619,3,340,1,170.67,19153.56,33668,33671
43620,1,512,512,512.00,0.00,33670,33671
43621,1,512,512,512.00,0.00,33670,33671
43622,1,512,512,512.00,0.00,33670,33671
43623,3,280,89,170.67,6462.89,33670,33673
43624,1,512,512,512.00,0.00,33672,33673
43625,1,512,512,512.00,0.00,33672,33673
43626,4,330,24,128.00,15406.00,33672,33676
43627,2,360,152,256.00,10816.00,33675,33677
43628,1,512,512,512.00,0.00,33676,33677
43629,1,512,512,512.00,0.00,33676,33677
43630,1,512,512,512.00,0.00,33676,33677
43631,1,512,512,512.00,0.00,33676,33677
43632,2,431,81,256.00,30625.00,33676,33678
43633,1,512,512,512.00,0.00,33677,33678
43634,1,512,512,512.00,0.00,33677,33678
43635,1,512,512,512.00,0.00,33677,33678
43636,1,512,512,512.00,0.00,33677,33678
43637,4,244,5,128.00,7158.50,33677,33681
43638,1,512,512,512.00,0.00,33680,33681
43639,4,274,1,128.00,9406.50,33680,33684
43640,1,512,512,512.00,0.00,33683,33684
43641,3,292,15,170.67,13377.56,33683,33686
43642,2,481,31,256.00,50625.00,33685,33687
43643,2,492,20,256.00,55696.00,33686,33688
43644,2,296,216,256.00,1600.00,33687,33689
43645,2,363,149,256.00,11449.00,33688,33690
43646,1,512,512,512.00,0.00,33689,33690
43647,2,443,69,256.00,34969.00,33689,33691
43648,2,422,90,256.00,27556.00,33690,33692
43649,2,271,241,256.00,225.00,33691,33693
43650,3,288,32,170.67,11150.22,33692,33695
43651,1,512,512,512.00,0.00,33694,33695
43652,1,512,512,512.00,0.00,33694,33695
43653,1,512,512,512.00,0.00,33694,33695
43654,2,455,57,256.00,39601.00,33694,33696
43655,1,512,512,512.00,0.00,33695,33696
43656,1,512,512,512.00,0.00,33695,33696
43657,1,512,512,512.00,0.00,33695,33696
43658,1,512,512,512.00,0.00,33695,33696
43659,1,512,512,512.00,0.00,33695,33696
43660,1,512,512,512.00,0.00,33695,33696
43661,1,512,512,512.00,0.00,33695,33696
43662,1,512,512,512.00,0.00,33695,33696
43663,6,397,1,85.33,20147.56,33695,33701
43664,1,512,512,512.00,0.00,33700,33701
43665,3,383,1,170.67,25230.89,33700,33703
43666,6,293,1,85.33,12617.89,33702,33708
43667,1,512,512,512.00,0.00,33707,33708
43668,2,283,229,256.00,729.00,33707,33709
43669,1,512,512,512.00,0.00,33708,33709
43670,1,512,512,512.00,0.00,33708,33709
43671,3,268,96,170.67,5187.56,33708,33711
43672,1,512,512,512.00,0.00,33710,33711
43673,1,512,512,512.00,0.00,33710,33711
43674,1,512,512,512.00,0.00,33710,33711
43675,1,512,512,512.00,0.00,33710,33711
43676,3,323,31,170.67,14290.89,33710,33713
43677,6,339,3,85.33,14083.56,33712,33718
43678,3,448,9,170.67,38809.56,33717,33720
43679,1,512,512,512.00,0.00,33719,33720
43680,1,512,512,512.00,0.00,33719,33720
43681,1,512,512,512.00,0.00,33719,33720
43682,3,311,9,170.67,15428.22,33719,33722
43683,1,512,512,512.00,0.00,33721,33722
43684,1,512,512,512.00,0.00,33721,33722
43685,2,310,202,256.00,2916.00,33721,33723
43686,1,512,512,512.00,0.00,33722,33723
43687,1,512,512,512.00,0.00,33722,33723
43688,3,352,42,170.67,17403.56,33722,33725
43689,1,512,512,512.00,0.00,33724,33725
43690,3,320,1,170.67,17166.89,33724,33727
43691,2,409,103,256.00,23409.00,33726,33728
43692,1,512,512,512.00,0.00,33727,33728
43693,1,512,512,512.00,0.00,33727,33728
43694,1,512,512,512.00,0.00,33727,33728
43695,3,263,1,170.67,14430.89,33727,33730
43696,1,512,512,512.00,0.00,33729,33730
43697,3,278,87,170.67,6360.22,33729,33732
43698,4,235,30,128.00,6219.50,33731,33735
43699,3,479,8,170.67,47582.89,33734,33737
43700,1,512,512,512.00,0.00,33736,33737
43701,2,389,123,256.00,17689.00,33736,33738
43702,1,512,512,512.00,0.00,33737,33738
43703,1,512,512,512.00,0.00,33737,33738
43704,2,486,26,256.00,52900.00,33737,33739
43705,1,512,512,512.00,0.00,33738,33739
43706,1,512,512,512.00,0.00,33738,33739
43707,2,364,148,256.00,11664.00,33738,33740
43708,1,512,512,512.00,0.00,33739,33740
43709,1,512,512,512.00,0.00,33739,33740
43710,1,512,512,512.00,0.00,33739,33740
43711,1,512,512,512.00,0.00,33739,33740
43712,1,512,512,512.00,0.00,33739,33740
43713,2,476,36,256.00,48400.00,33739,33741
43714,6,243,1,85.33,12165.56,33740,33746
43715,3,367,48,170.67,19673.56,33745,33748
43716,1,512,512,512.00,0.00,33747,33748
43717,1,512,512,512.00,0.00,33747,33748
43718,2,292,220,256.00,1296.00,33747,33749
43719,1,512,512,512.00,0.00,33748,33749
43720,1,512,512,512.00,0.00,33748,33749
43721,1,512,512,512.00,0.00,33748,33749
43722,1,512,512,512.00,0.00,33748,33749
43723,2,387,125,256.00,17161.00,33748,33750
43724,1,512,512,512.00,0.00,33749,33750
43725,2,386,126,256.00,16900.00,33749,33751
43726,1,512,512,512.00,0.00,33750,33751
43727,1,512,512,512.00,0.00,33750,33751
43728,1,512,512,512.00,0.00,33750,33751
43729,1,512,512,512.00,0.00,33750,33751
43730,1,512,512,512.00,0.00,33750,33751
43731,7,252,1,73.14,7147.84,33750,33757
43732,1,512,512,512.00,0.00,33756,33757
43733,8,284,1,64.00,9232.50,33756,33764
43734,1,512,512,512.00,0.00,33763,33764
43735,1,512,512,512.00,0.00,33763,33764
43736,2,409,103,256.00,23409.00,33763,33765
43737,1,512,512,512.00,0.00,33764,33765
43738,8,250,1,64.00,6565.00,33764,33772
43739,1,512,512,512.00,0.00,33771,33772
43740,1,512,512,512.00,0.00,33771,33772
43741,1,512,512,512.00,0.00,33771,33772
43742,2,468,44,256.00,44944.00,33771,33773
43743,2,401,111,256.00,21025.00,33772,33774
43744,4,234,72,128.00,3905.50,33773,33777
43745,4,248,3,128.00,12360.50,33776,33780
43746,2,488,24,256.00,53824.00,33779,33781
43747,1,512,512,512.00,0.00,33780,33781
43748,1,512,512,512.00,0.00,33780,33781
43749,1,512,512,512.00,0.00,33780,33781
43750,12,179,1,42.67,3118.06,33780,33792
43751,2,409,103,256.00,23409.00,33791,33793
43752,1,512,512,512.00,0.00,33792,33793
43753,3,397,31,170.67,26081.56,33792,33795
43754,5,270,2,102.40,12178.64,33794,33799
43755,1,512,512,512.00,0.00,33798,33799
43756,1,512,512,512.00,0.00,33798,33799
43757,6,249,6,85.33,7105.56,33798,33804
43758,3,354,18,170.67,19286.22,33803,33806
43759,1,512,512,512.00,0.00,33805,33806
43760,1,512,512,512.00,0.00,33805,33806
43761,4,346,33,128.00,16304.50,33805,33809
43762,1,512,512,512.00,0.00,33808,33809
43763,3,496,8,170.67,52920.89,33808,33811
43764,2,498,14,256.00,58564.00,33810,33812
43765,1,512,512,512.00,0.00,33811,33812
43766,2,504,8,256.00,61504.00,33811,33813
43767,1,512,512,512.00,0.00,33812,33813
43768,4,287,9,128.00,13025.00,33812,33816
43769,1,512,512,512.00,0.00,33815,33816
43770,5,312,2,102.40,12320.24,33815,33820
43771,2,448,64,256.00,36864.00,33819,33821
43772,1,512,512,512.00,0.00,33820,33821
43773,1,512,512,512.00,0.00,33820,33821
43774,1,512,512,512.00,0.00,33820,33821
43775,3,254,54,170.67,7222.22,33820,33823
43776,3,368,16,170.67,21560.89,33822,33825
43777,1,512,512,512.00,0.00,33824,33825
43778,1,512,512,512.00,0.00,33824,33825
43779,1,512,512,512.00,0.00,33824,33825
43780,1,512,512,512.00,0.00,33824,33825
43781,1,512,512,512.00,0.00,33824,33825
43782,1,512,512,512.00,0.00,33824,33825
43783,1,512,512,512.00,0.00,33824,33825
43784,1,512,512,512.00,0.00,33824,33825
43785,1,512,512,512.00,0.00,33824,33825
43786,2,491,21,256.00,55225.00,33824,33826
43787,2,486,26,256.00,52900.00,33825,33827
43788,4,343,1,128.00,17481.00,33826,33830
43789,1,512,512,512.00,0.00,33829,33830
43790,1,512,512,512.00,0.00,33829,33830
43791,3,420,18,170.67,31606.22,33829,33832
43792,1,512,512,512.00,0.00,33831,33832
43793,4,301,40,128.00,10336.50,33831,33835
43794,2,428,84,256.00,29584.00,33834,33836
43795,2,328,184,256.00,5184.00,33835,33837
43796,1,512,512,512.00,0.00,33836,33837
43797,1,512,512,512.00,0.00,33836,33837
43798,1,512,512,512.00,0.00,33836,33837
43799,1,512,512,512.00,0.00,33836,33837
43800,2,322,190,256.00,4356.00,33836,33838
43801,1,512,512,512.00,0.00,33837,33838
43802,2,437,75,256.00,32761.00,33837,33839
43803,3,301,14,170.67,14074.89,33838,33841
43804,1,512,512,512.00,0.00,33840,33841
43805,1,512,512,512.00,0.00,33840,33841
43806,1,512,512,512.00,0.00,33840,33841
43807,1,512,512,512.00,0.00,33840,33841
43808,2,279,233,256.00,529.00,33840,33842
43809,3,276,67,170.67,7281.56,33841,33844
43810,2,371,141,256.00,13225.00,33843,33845
43811,1,512,512,512.00,0.00,33844,33845
43812,1,512,512,512.00,0.00,33844,33845
43813,2,392,120,256.00,18496.00,33844,33846
43814,3,401,2,170.67,28434.89,33845,33848
43815,1,512,512,512.00,0.00,33847,33848
43816,1,512,512,512.00,0.00,33847,33848
43817,1,512,512,512.00,0.00,33847,33848
43818,2,506,6,256.00,62500.00,33847,33849
43819,3,421,43,170.67,31337.56,33848,33851
43820,1,512,512,512.00,0.00,33850,33851
43821,5,272,10,102.40,10701.44,33850,33855
43822,1,512,512,512.00,0.00,33854,33855
43823,1,512,512,512.00,0.00,33854,33855
43824,1,512,512,512.00,0.00,33854,33855
43825,2,372,140,256.00,13456.00,33854,33856
43826,2,371,141,256.00,13225.00,33855,33857
43827,2,351,161,256.00,9025.00,33856,33858
43828,1,512,512,512.00,0.00,33857,33858
43829,1,512,512,512.00,0.00,33857,33858
43830,1,512,512,512.00,0.00,33857,33858
43831,1,512,512,512.00,0.00,33857,33858
43832,1,512,512,512.00,0.00,33857,33858
43833,5,457,1,102.40,31566.24,33857,33862
43834,1,512,512,512.00,0.00,33861,33862
43835,2,426,86,256.00,28900.00,33861,33863
43836,2,296,216,256.00,1600.00,33862,33864
43837,1,512,512,512.00,0.00,33863,33864
43838,1,512,512,512.00,0.00,33863,33864
43839,1,512,512,512.00,0.00,33863,33864
43840,5,167,46,102.40,2633.04,33863,33868
43841,1,512,512,512.00,0.00,33867,33868
43842,1,512,512,512.00,0.00,33867,33868
43843,1,512,512,512.00,0.00,33867,33868
43844,1,512,512,512.00,0.00,33867,33868
43845,1,512,512,512.00,0.00,33867,33868
43846,1,512,512,512.00,0.00,33867,33868
43847,1,512,512,512.00,0.00,33867,33868
43848,1,512,512,512.00,0.00,33867,33868
43849,1,512,512,512.00,0.00,33867,33868
43850,2,391,121,256.00,18225.00,33867,33869
43851,2,344,168,256.00,7744.00,33868,33870
43852,1,512,512,512.00,0.00,33869,33870
43853,1,512,512,512.00,0.00,33869,33870
43854,1,512,512,512.00,0.00,33869,33870
43855,4,466,3,128.00,38166.50,33869,33873
43856,1,512,512,512.00,0.00,33872,33873
43857,1,512,512,512.00,0.00,33872,33873
43858,1,512,512,512.00,0.00,33872,33873
43859,3,311,48,170.67,11684.22,33872,33875
43860,3,378,25,170.67,22669.56,33874,33877
43861,7,197,5,73.14,6461.55,33876,33883
43862,1,512,512,512.00,0.00,33882,33883
43863,2,447,65,256.00,36481.00,33882,33884
43864,1,512,512,512.00,0.00,33883,33884
43865,2,482,30,256.00,51076.00,33883,33885
43866,1,512,512,512.00,0.00,33884,33885
43867,1,512,512,512.00,0.00,33884,33885
43868,3,387,2,170.67,25840.22,33884,33887
43869,1,512,512,512.00,0.00,33886,33887
43870,1,512,512,512.00,0.00,33886,33887
43871,2,479,33,256.00,49729.00,33886,33888
43872,2,427,85,256.00,29241.00,33887,33889
43873,1,512,512,512.00,0.00,33888,33889
43874,4,259,3,128.00,11089.00,33888,33892
43875,1,512,512,512.00,0.00,33891,33892
43876,1,512,512,512.00,0.00,33891,33892
43877,2,288,224,256.00,1024.00,33891,33893
43878,1,512,512,512.00,0.00,33892,33893
43879,1,512,512,512.00,0.00,33892,33893
43880,1,512,512,512.00,0.00,33892,33893
43881,3,385,9,170.67,24949.56,33892,33895
43882,2,328,184,256.00,5184.00,33894,33896
43883,1,512,512,512.00,0.00,33895,33896
43884,1,512,512,512.00,0.00,33895,33896
43885,1,512,512,512.00,0.00,33895,33896
43886,1,512,512,512.00,0.00,33895,33896
43887,2,466,46,256.00,44100.00,33895,33897
43888,1,512,512,512.00,0.00,33896,33897
43889,2,391,121,256.00,18225.00,33896,33898
43890,5,250,2,102.40,10100.24,33897,33902
43891,3,294,5,170.67,14816.22,33901,33904
43892,3,317,96,170.67,10708.22,33903,33906
43893,2,478,34,256.00,49284.00,33905,33907
43894,4,263,2,128.00,15556.50,33906,33910
43895,4,388,6,128.00,23026.00,33909,33913
43896,3,294,32,170.67,11558.22,33912,33915
43897,4,348,38,128.00,16322.00,33914,33918
43898,1,512,512,512.00,0.00,33917,33918
43899,1,512,512,512.00,0.00,33917,33918
43900,2,426,86,256.00,28900.00,33917,33919
43901,1,512,512,512.00,0.00,33918,33919
43902,2,340,172,256.00,7056.00,33918,33920
43903,1,512,512,512.00,0.00,33919,33920
43904,1,512,512,512.00,0.00,33919,33920
43905,1,512,512,512.00,0.00,33919,33920
43906,1,512,512,512.00,0.00,33919,33920
43907,1,512,512,512.00,0.00,33919,33920
43908,1,512,512,512.00,0.00,33919,33920
43909,1,512,512,512.00,0.00,33919,33920
43910,1,512,512,512.00,0.00,33919,33920
43911,3,442,13,170.67,37133.56,33919,33922
43912,3,371,6,170.67,22840.22,33921,33924
43913,1,512,512,512.00,0.00,33923,33924
43914,3,354,41,170.67,17768.22,33923,33926
43915,1,512,512,512.00,0.00,33925,33926
43916,3,436,1,170.67,36113.56,33925,33928
43917,2,358,154,256.00,10404.00,33927,33929
43918,1,512,512,512.00,0.00,33928,33929
43919,2,334,178,256.00,6084.00,33928,33930
43920,1,512,512,512.00,0.00,33929,33930
43921,1,512,512,512.00,0.00,33929,33930
43922,1,512,512,512.00,0.00,33929,33930
43923,3,330,5,170.67,17624.22,33929,33932
43924,1,512,512,512.00,0.00,33931,33932
43925,2,275,237,256.00,361.00,33931,33933
43926,1,512,512,512.00,0.00,33932,33933
43927,1,512,512,512.00,0.00,33932,33933
43928,2,507,5,256.00,63001.00,33932,33934
43929,3,264,21,170.67,11428.22,33933,33936
43930,4,328,24,128.00,14656.00,33935,33939
43931,2,354,158,256.00,9604.00,33938,33940
43932,1,512,512,512.00,0.00,33939,33940
43933,1,512,512,512.00,0.00,33939,33940
43934,1,512,512,512.00,0.00,33939,33940
43935,2,327,185,256.00,5041.00,33939,33941
43936,2,369,143,256.00,12769.00,33940,33942
43937,1,512,512,512.00,0.00,33941,33942
43938,1,512,512,512.00,0.00,33941,33942
43939,1,512,512,512.00,0.00,33941,33942
43940,3,465,22,170.67,43317.56,33941,33944
43941,1,512,512,512.00,0.00,33943,33944
43942,1,512,512,512.00,0.00,33943,33944
43943,1,512,512,512.00,0.00,33943,33944
43944,3,255,26,170.67,10560.22,33943,33946
43945,1,512,512,512.00,0.00,33945,33946
43946,1,512,512,512.00,0.00,33945,33946
43947,1,512,512,512.00,0.00,33945,33946
43948,1,512,512,512.00,0.00,33945,33946
43949,2,393,119,256.00,18769.00,33945,33947
43950,1,512,512,512.00,0.00,33946,33947
43951,5,322,8,102.40,13707.84,33946,33951
43952,1,512,512,512.00,0.00,33950,33951
43953,1,512,512,512.00,0.00,33950,33951
43954,2,481,31,256.00,50625.00,33950,33952
43955,3,289,22,170.67,12341.56,33951,33954
43956,1,512,512,512.00,0.00,33953,33954
43957,1,512,512,512.00,0.00,33953,33954
43958,2,465,47,256.00,43681.00,33953,33955
43959,1,512,512,512.00,0.00,33954,33955
43960,2,353,159,256.00,9409.00,33954,33956
43961,1,512,512,512.00,0.00,33955,33956
43962,1,512,512,512.00,0.00,33955,33956
43963,1,512,512,512.00,0.00,33955,33956
43964,3,279,73,170.67,7129.56,33955,33958
43965,2,394,118,256.00,19044.00,33957,33959
43966,1,512,512,512.00,0.00,33958,33959
43967,3,463,10,170.67,42869.56,33958,33961
43968,2,446,66,256.00,36100.00,33960,33962
43969,1,512,512,512.00,0.00,33961,33962
43970,1,512,512,512.00,0.00,33961,33962
43971,2,486,26,256.00,52900.00,33961,33963
43972,1,512,512,512.00,0.00,33962,33963
43973,2,300,212,256.00,1936.00,33962,33964
43974,1,512,512,512.00,0.00,33963,33964
43975,3,226,76,170.67,4523.56,33963,33966
43976,1,512,512,512.00,0.00,33965,33966
43977,3,361,1,170.67,21813.56,33965,33968
43978,1,512,512,512.00,0.00,33967,33968
43979,1,512,512,512.00,0.00,33967,33968
43980,1,512,512,512.00,0.00,33967,33968
43981,4,396,12,128.00,24720.00,33967,33971
43982,1,512,512,512.00,0.00,33970,33971
43983,1,512,512,512.00,0.00,33970,33971
43984,1,512,512,512.00,0.00,33970,33971
43985,7,348,2,73.14,12919.55,33970,33977
43986,1,512,512,512.00,0.00,33976,33977
43987,3,391,2,170.67,26554.89,33976,33979
43988,2,448,64,256.00,36864.00,33978,33980
43989,1,512,512,512.00,0.00,33979,33980
43990,1,512,512,512.00,0.00,33979,33980
43991,1,512,512,512.00,0.00,33979,33980
43992,5,257,24,102.40,7599.44,33979,33984
43993,1,512,512,512.00,0.00,33983,33984
43994,1,512,512,512.00,0.00,33983,33984
43995,1,512,512,512.00,0.00,33983,33984
43996,1,512,512,512.00,0.00,33983,33984
43997,2,502,10,256.00,60516.00,33983,33985
43998,1,512,512,512.00,0.00,33985,33986
43999,1,512,512,512.00,0.00,33985,33986
44000,3,257,68,170.67,6086.89,33985,33988
44001,3,256,1,170.67,14393.56,33987,33990
44002,1,512,512,512.00,0.00,33989,33990
44003,1,512,512,512.00,0.00,33989,33990
44004,5,354,1,102.40,18083.44,33989,33994
44005,4,250,36,128.00,7199.50,33993,33997
44006,2,439,73,256.00,33489.00,33996,33998
44007,1,512,512,512.00,0.00,33997,33998
44008,1,512,512,512.00,0.00,33997,33998
44009,2,409,103,256.00,23409.00,33997,33999
44010,4,499,1,128.00,45897.00,33998,34002
44011,1,512,512,512.00,0.00,34001,34002
44012,1,512,512,512.00,0.00,34001,34002
44013,1,512,512,512.00,0.00,34001,34002
44014,2,286,226,256.00,900.00,34001,34003
44015,5,244,35,102.40,5795.44,34002,34007
44016,6,176,1,85.33,5474.56,34006,34012
44017,2,412,100,256.00,24336.00,34011,34013
44018,3,279,103,170.67,5989.56,34012,34015
44019,1,512,512,512.00,0.00,34014,34015
44020,1,512,512,512.00,0.00,34014,34015
44021,1,512,512,512.00,0.00,34014,34015
44022,1,512,512,512.00,0.00,34014,34015
44023,5,328,7,102.40,14137.84,34014,34019
44024,1,512,512,512.00,0.00,34018,34019
44025,1,512,512,512.00,0.00,34018,34019
44026,1,512,512,512.00,0.00,34018,34019
44027,3,294,71,170.67,8568.22,34018,34021
44028,1,512,512,512.00,0.00,34020,34021
44029,1,512,512,512.00,0.00,34020,34021
44030,2,499,13,256.00,59049.00,34020,34022
44031,2,510,2,256.00,64516.00,34021,34023
44032,5,266,1,102.40,8329.04,34022,34027
44033,1,512,512,512.00,0.00,34026,34027
44034,1,512,512,512.00,0.00,34026,34027
44035,3,263,1,170.67,14430.89,34026,34029
44036,1,512,512,512.00,0.00,34028,34029
44037,1,512,512,512.00,0.00,34028,34029
44038,4,224,35,128.00,4767.50,34028,34032
44039,1,512,512,512.00,0.00,34031,34032
44040,4,390,12,128.00,23670.00,34031,34035
44041,1,512,512,512.00,0.00,34034,34035
44042,1,512,512,512.00,0.00,34034,34035
44043,4,289,1,128.00,13107.00,34034,34038
44044,4,254,10,128.00,9908.00,34038,34042
44045,1,512,512,512.00,0.00,34041,34042
44046,1,512,512,512.00,0.00,34041,34042
44047,3,375,52,170.67,21057.56,34041,34044
44048,1,512,512,512.00,0.00,34043,34044
44049,1,512,512,512.00,0.00,34043,34044
44050,1,512,512,512.00,0.00,34043,34044
44051,1,512,512,512.00,0.00,34043,34044
44052,1,512,512,512.00,0.00,34043,34044
44053,1,512,512,512.00,0.00,34043,34044
44054,1,512,512,512.00,0.00,34043,34044
44055,1,512,512,512.00,0.00,34043,34044
44056,1,512,512,512.00,0.00,34043,34044
44057,1,512,512,512.00,0.00,34043,34044
44058,1,512,512,512.00,0.00,34043,34044
44059,1,512,512,512.00,0.00,34043,34044
44060,1,512,512,512.00,0.00,34043,34044
44061,2,412,100,256.00,24336.00,34043,34045
44062,1,512,512,512.00,0.00,34044,34045
44063,1,512,512,512.00,0.00,34044,34045
44064,1,512,512,512.00,0.00,34044,34045
44065,1,512,512,512.00,0.00,34044,34045
44066,1,512,512,512.00,0.00,34044,34045
44067,1,512,512,512.00,0.00,34044,34045
44068,1,512,512,512.00,0.00,34044,34045
44069,1,512,512,512.00,0.00,34044,34045
44070,2,430,82,256.00,30276.00,34044,34046
44071,1,512,512,512.00,0.00,34045,34046
44072,1,512,512,512.00,0.00,34045,34046
44073,1,512,512,512.00,0.00,34045,34046
44074,2,270,242,256.00,196.00,34045,34047
44075,1,512,512,512.00,0.00,34046,34047
44076,1,512,512,512.00,0.00,34046,34047
44077,4,262,8,128.00,10563.50,34046,34050
44078,1,512,512,512.00,0.00,34049,34050
44079,1,512,512,512.00,0.00,34049,34050
44080,2,323,189,256.00,4489.00,34049,34051
44081,2,449,63,256.00,37249.00,34050,34052
44082,1,512,512,512.00,0.00,34051,34052
44083,2,386,126,256.00,16900.00,34051,34053
44084,3,422,38,170.67,31616.89,34052,34055
44085,1,512,512,512.00,0.00,34054,34055
44086,2,488,24,256.00,53824.00,34054,34056
44087,6,222,2,85.33,6693.89,34055,34061
44088,2,290,222,256.00,1156.00,34060,34062
44089,3,210,148,170.67,779.56,34061,34064
44090,3,253,13,170.67,12437.56,34063,34066
44091,1,512,512,512.00,0.00,34065,34066
44092,1,512,512,512.00,0.00,34065,34066
44093,1,512,512,512.00,0.00,34065,34066
44094,1,512,512,512.00,0.00,34065,34066
44095,3,298,1,170.67,15597.56,34065,34068
44096,1,512,512,512.00,0.00,34067,34068
44097,1,512,512,512.00,0.00,34067,34068
44098,1,512,512,512.00,0.00,34067,34068
44099,4,305,4,128.00,13738.50,34067,34071
44100,3,430,15,170.67,34077.56,34070,34073
44101,2,511,1,256.00,65025.00,34072,34074
44102,9,368,3,56.89,12336.54,34073,34082
44103,2,348,164,256.00,8464.00,34081,34083
44104,2,485,27,256.00,52441.00,34082,34084
44105,2,456,56,256.00,40000.00,34083,34085
44106,3,394,9,170.67,26605.56,34084,34087
44107,1,512,512,512.00,0.00,34086,34087
44108,1,512,512,512.00,0.00,34086,34087
44109,1,512,512,512.00,0.00,34086,34087
44110,4,393,1,128.00,24513.50,34086,34090
44111,1,512,512,512.00,0.00,34089,34090
44112,1,512,512,512.00,0.00,34089,34090
44113,3,356,17,170.67,19654.89,34089,34092
44114,1,512,512,512.00,0.00,34091,34092
44115,1,512,512,512.00,0.00,34091,34092
44116,2,489,23,256.00,54289.00,34091,34093
44117,1,512,512,512.00,0.00,34092,34093
44118,2,429,83,256.00,29929.00,34092,34094
44119,7,133,3,73.14,1916.69,34093,34100
44120,1,512,512,512.00,0.00,34099,34100
44121,4,414,1,128.00,28137.50,34099,34103
44122,1,512,512,512.00,0.00,34102,34103
44123,1,512,512,512.00,0.00,34102,34103
44124,4,288,8,128.00,10400.00,34102,34106
44125,1,512,512,512.00,0.00,34105,34106
44126,1,512,512,512.00,0.00,34105,34106
44127,1,512,512,512.00,0.00,34105,34106
44128,2,358,154,256.00,10404.00,34105,34107
44129,4,214,9,128.00,7010.50,34106,34110
44130,3,378,34,170.67,22219.56,34109,34112
44131,1,512,512,512.00,0.00,34111,34112
44132,1,512,512,512.00,0.00,34111,34112
44133,1,512,512,512.00,0.00,34111,34112
44134,2,339,173,256.00,6889.00,34111,34113
44135,6,261,2,85.33,9064.56,34112,34118
44136,3,285,75,170.67,7524.22,34117,34120
44137,1,512,512,512.00,0.00,34119,34120
44138,1,512,512,512.00,0.00,34119,34120
44139,7,194,2,73.14,5655.27,34119,34126
44140,1,512,512,512.00,0.00,34125,34126
44141,1,512,512,512.00,0.00,34125,34126
44142,1,512,512,512.00,0.00,34125,34126
44143,3,299,8,170.67,14702.89,34125,34128
44144,2,494,18,256.00,56644.00,34127,34129
44145,1,512,512,512.00,0.00,34128,34129
44146,1,512,512,512.00,0.00,34128,34129
44147,2,415,97,256.00,25281.00,34128,34130
44148,2,368,144,256.00,12544.00,34129,34131
44149,4,484,2,128.00,42270.00,34130,34134
44150,1,512,512,512.00,0.00,34133,34134
44151,3,337,42,170.67,15213.56,34133,34136
44152,1,512,512,512.00,0.00,34135,34136
44153,1,512,512,512.00,0.00,34135,34136
44154,2,271,241,256.00,225.00,34135,34137
44155,2,341,171,256.00,7225.00,34136,34138
44156,1,512,512,512.00,0.00,34137,34138
44157,1,512,512,512.00,0.00,34137,34138
44158,2,482,30,256.00,51076.00,34137,34139
44159,1,512,512,512.00,0.00,34138,34139
44160,1,512,512,512.00,0.00,34138,34139
44161,1,512,512,512.00,0.00,34138,34139
44162,4,326,1,128.00,15024.50,34138,34142
44163,1,512,512,512.00,0.00,34141,34142
44164,3,410,47,170.67,28650.89,34141,34144
44165,1,512,512,512.00,0.00,34143,34144
44166,2,387,125,256.00,17161.00,34143,34145
44167,1,512,512,512.00,0.00,34144,34145
44168,1,512,512,512.00,0.00,34144,34145
44169,1,512,512,512.00,0.00,34144,34145
44170,4,396,1,128.00,25463.50,34144,34148
44171,1,512,512,512.00,0.00,34147,34148
44172,3,321,68,170.67,11804.22,34147,34150
44173,1,512,512,512.00,0.00,34149,34150
44174,1,512,512,512.00,0.00,34149,34150
44175,1,512,512,512.00,0.00,34149,34150
44176,2,505,7,256.00,62001.00,34149,34151
44177,1,512,512,512.00,0.00,34150,34151
44178,8,140,1,64.00,2929.00,34150,34158
44179,1,512,512,512.00,0.00,34157,34158
44180,1,512,512,512.00,0.00,34157,34158
44181,2,320,192,256.00,4096.00,34157,34159
44182,1,512,512,512.00,0.00,34158,34159
44183,1,512,512,512.00,0.00,34158,34159
44184,2,446,66,256.00,36100.00,34158,34160
44185,1,512,512,512.00,0.00,34159,34160
44186,1,512,512,512.00,0.00,34159,34160
44187,4,246,2,128.00,12260.00,34159,34163
44188,1,512,512,512.00,0.00,34162,34163
44189,4,327,5,128.00,17766.50,34162,34166
44190,1,512,512,512.00,0.00,34165,34166
44191,1,512,512,512.00,0.00,34165,34166
44192,4,239,28,128.00,6820.50,34165,34169
44193,4,243,9,128.00,6856.50,34168,34172
44194,4,173,42,128.00,2796.50,34171,34175
44195,2,391,121,256.00,18225.00,34174,34176
44196,2,462,50,256.00,42436.00,34175,34177
44197,1,512,512,512.00,0.00,34176,34177
44198,1,512,512,512.00,0.00,34176,34177
44199,1,512,512,512.00,0.00,34176,34177
44200,2,462,50,256.00,42436.00,34176,34178
44201,1,512,512,512.00,0.00,34177,34178
44202,1,512,512,512.00,0.00,34177,34178
44203,1,512,512,512.00,0.00,34177,34178
44204,3,278,36,170.67,10134.22,34177,34180
44205,2,481,31,256.00,50625.00,34179,34181
44206,3,412,35,170.67,29270.89,34180,34183
44207,5,291,2,102.40,9669.44,34182,34187
44208,3,304,1,170.67,15961.56,34186,34189
44209,2,321,191,256.00,4225.00,34188,34190
44210,1,512,512,512.00,0.00,34189,34190
44211,4,301,26,128.00,11091.50,34189,34193
44212,1,512,512,512.00,0.00,34192,34193
44213,2,489,23,256.00,54289.00,34192,34194
44214,1,512,512,512.00,0.00,34193,34194
44215,2,325,187,256.00,4761.00,34193,34195
44216,1,512,512,512.00,0.00,34194,34195
44217,2,509,3,256.00,64009.00,34194,34196
44218,3,294,100,170.67,7659.56,34195,34198
44219,1,512,512,512.00,0.00,34197,34198
44220,1,512,512,512.00,0.00,34197,34198
44221,3,458,5,170.67,41602.89,34197,34200
44222,1,512,512,512.00,0.00,34199,34200
44223,2,475,37,256.00,47961.00,34199,34201
44224,1,512,512,512.00,0.00,34200,34201
44225,4,312,2,128.00,17461.50,34200,34204
44226,1,512,512,512.00,0.00,34203,34204
44227,1,512,512,512.00,0.00,34203,34204
44228,2,481,31,256.00,50625.00,34203,34205
44229,2,356,156,256.00,10000.00,34204,34206
44230,3,295,44,170.67,10502.89,34205,34208
44231,2,483,29,256.00,51529.00,34207,34209
44232,1,512,512,512.00,0.00,34208,34209
44233,2,302,210,256.00,2116.00,34208,34210
44234,1,512,512,512.00,0.00,34209,34210
44235,1,512,512,512.00,0.00,34209,34210
44236,1,512,512,512.00,0.00,34209,34210
44237,1,512,512,512.00,0.00,34209,34210
44238,1,512,512,512.00,0.00,34209,34210
44239,2,324,188,256.00,4624.00,34209,34211
44240,1,512,512,512.00,0.00,34210,34211
44241,1,512,512,512.00,0.00,34210,34211
44242,1,512,512,512.00,0.00,34210,34211
44243,1,512,512,512.00,0.00,34210,34211
44244,3,245,42,170.67,8344.22,34210,34213
44245,1,512,512,512.00,0.00,34212,34213
44246,2,459,53,256.00,41209.00,34212,34214
44247,1,512,512,512.00,0.00,34213,34214
44248,1,512,512,512.00,0.00,34213,34214
44249,1,512,512,512.00,0.00,34213,34214
44250,3,383,15,170.67,24176.22,34213,34216
44251,4,460,5,128.00,36826.50,34215,34219
44252,2,324,188,256.00,4624.00,34218,34220
44253,1,512,512,512.00,0.00,34219,34220
44254,2,393,119,256.00,18769.00,34219,34221
44255,1,512,512,512.00,0.00,34220,34221
44256,1,512,512,512.00,0.00,34220,34221
44257,5,182,1,102.40,5089.04,34220,34225
44258,7,243,1,73.14,6026.69,34224,34231
44259,5,198,5,102.40,6094.64,34230,34235
44260,2,272,240,256.00,256.00,34234,34236
44261,1,512,512,512.00,0.00,34235,34236
44262,3,244,36,170.67,9091.56,34235,34238
44263,1,512,512,512.00,0.00,34237,34238
44264,2,418,94,256.00,26244.00,34237,34239
44265,1,512,512,512.00,0.00,34238,34239
44266,3,409,3,170.67,29969.56,34238,34241
44267,6,412,2,85.33,21489.89,34240,34246
44268,1,512,512,512.00,0.00,34245,34246
44269,3,244,77,170.67,4854.89,34245,34248
44270,5,267,25,102.40,7770.64,34247,34252
44271,3,322,81,170.67,11581.56,34251,34254
44272,2,305,207,256.00,2401.00,34253,34255
44273,1,512,512,512.00,0.00,34254,34255
44274,3,478,3,170.67,47357.56,34254,34257
44275,1,512,512,512.00,0.00,34256,34257
44276,1,512,512,512.00,0.00,34256,34257
44277,5,244,4,102.40,7403.44,34256,34261
44278,1,512,512,512.00,0.00,34260,34261
44279,3,430,18,170.67,33979.56,34260,34263
44280,2,495,17,256.00,57121.00,34262,34264
44281,1,512,512,512.00,0.00,34263,34264
44282,6,173,1,85.33,3058.22,34263,34269
44283,1,512,512,512.00,0.00,34268,34269
44284,2,374,138,256.00,13924.00,34268,34270
44285,1,512,512,512.00,0.00,34269,34270
44286,1,512,512,512.00,0.00,34269,34270
44287,1,512,512,512.00,0.00,34269,34270
44288,2,327,185,256.00,5041.00,34269,34271
44289,1,512,512,512.00,0.00,34270,34271
44290,2,338,174,256.00,6724.00,34270,34272
44291,1,512,512,512.00,0.00,34271,34272
44292,5,218,26,102.40,4792.24,34271,34276
44293,2,467,45,256.00,44521.00,34275,34277
44294,1,512,512,512.00,0.00,34276,34277
44295,4,372,15,128.00,20521.50,34276,34280
44296,3,491,3,170.67,51344.22,34279,34282
44297,4,370,2,128.00,22340.00,34281,34285
44298,1,512,512,512.00,0.00,34284,34285
44299,5,222,1,102.40,6720.24,34284,34289
44300,3,290,25,170.67,12050.89,34288,34291
44301,1,512,512,512.00,0.00,34290,34291
44302,1,512,512,512.00,0.00,34290,34291
44303,1,512,512,512.00,0.00,34290,34291
44304,1,512,512,512.00,0.00,34290,34291
44305,3,281,5,170.67,14226.89,34290,34293
44306,3,265,2,170.67,14290.89,34292,34295
44307,5,371,1,102.40,20587.84,34294,34299
44308,1,512,512,512.00,0.00,34298,34299
44309,3,361,1,170.67,21813.56,34298,34301
44310,1,512,512,512.00,0.00,34300,34301
44311,3,411,28,170.67,29217.56,34300,34303
44312,3,496,1,170.67,52953.56,34302,34305
44313,1,512,512,512.00,0.00,34304,34305
44314,1,512,512,512.00,0.00,34304,34305
44315,8,185,1,64.00,3572.25,34304,34312
44316,2,506,6,256.00,62500.00,34311,34313
44317,1,512,512,512.00,0.00,34312,34313
44318,1,512,512,512.00,0.00,34312,34313
44319,1,512,512,512.00,0.00,34312,34313
44320,1,512,512,512.00,0.00,34312,34313
44321,3,310,34,170.67,12699.56,34312,34315
44322,2,466,46,256.00,44100.00,34314,34316
44323,4,189,43,128.00,3073.00,34315,34319
44324,2,480,32,256.00,50176.00,34318,34320
44325,5,238,13,102.40,9547.44,34319,34324
44326,2,482,30,256.00,51076.00,34323,34325
44327,1,512,512,512.00,0.00,34324,34325
44328,1,512,512,512.00,0.00,34324,34325
44329,1,512,512,512.00,0.00,34324,34325
44330,3,388,36,170.67,24067.56,34324,34327
44331,1,512,512,512.00,0.00,34326,34327
44332,2,258,254,256.00,4.00,34326,34328
44333,2,468,44,256.00,44944.00,34327,34329
44334,1,512,512,512.00,0.00,34328,34329
44335,1,512,512,512.00,0.00,34328,34329
44336,1,512,512,512.00,0.00,34328,34329
44337,2,404,108,256.00,21904.00,34328,34330
44338,3,499,2,170.67,53914.89,34329,34332
44339,1,512,512,512.00,0.00,34331,34332
44340,1,512,512,512.00,0.00,34331,34332
44341,1,512,512,512.00,0.00,34331,34332
44342,2,376,136,256.00,14400.00,34331,34333
44343,2,489,23,256.00,54289.00,34332,34334
44344,1,512,512,512.00,0.00,34333,34334
44345,2,464,48,256.00,43264.00,34333,34335
44346,1,512,512,512.00,0.00,34334,34335
44347,2,274,238,256.00,324.00,34334,34336
44348,1,512,512,512.00,0.00,34335,34336
44349,1,512,512,512.00,0.00,34335,34336
44350,5,459,4,102.40,31854.64,34335,34340
44351,1,512,512,512.00,0.00,34339,34340
44352,1,512,512,512.00,0.00,34339,34340
44353,3,415,16,170.67,30553.56,34339,34342
44354,1,512,512,512.00,0.00,34341,34342
44355,2,462,50,256.00,42436.00,34341,34343
44356,1,512,512,512.00,0.00,34342,34343
44357,4,335,1,128.00,15786.50,34342,34346
44358,1,512,512,512.00,0.00,34345,34346
44359,4,256,1,128.00,16003.50,34345,34349
44360,2,429,83,256.00,29929.00,34348,34350
44361,1,512,512,512.00,0.00,34349,34350
44362,1,512,512,512.00,0.00,34349,34350
44363,1,512,512,512.00,0.00,34349,34350
44364,2,258,254,256.00,4.00,34349,34351
44365,1,512,512,512.00,0.00,34350,34351
44366,1,512,512,512.00,0.00,34350,34351
44367,6,202,9,85.33,6539.89,34350,34356
44368,3,328,50,170.67,13552.89,34355,34358
44369,4,255,26,128.00,10281.50,34357,34361
44370,1,512,512,512.00,0.00,34360,34361
44371,1,512,512,512.00,0.00,34360,34361
44372,3,353,29,170.67,18322.89,34360,34363
44373,3,379,66,170.67,21701.56,34362,34365
44374,1,512,512,512.00,0.00,34364,34365
44375,1,512,512,512.00,0.00,34364,34365
44376,1,512,512,512.00,0.00,34364,34365
44377,1,512,512,512.00,0.00,34364,34365
44378,1,512,512,512.00,0.00,34364,34365
44379,2,462,50,256.00,42436.00,34364,34366
44380,1,512,512,512.00,0.00,34365,34366
44381,1,512,512,512.00,0.00,34365,34366
44382,4,384,12,128.00,22310.50,34365,34369
44383,1,512,512,512.00,0.00,34368,34369
44384,1,512,512,512.00,0.00,34368,34369
44385,4,220,49,128.00,3698.50,34368,34372
44386,2,315,197,256.00,3481.00,34371,34373
44387,1,512,512,512.00,0.00,34372,34373
44388,1,512,512,512.00,0.00,34372,34373
44389,1,512,512,512.00,0.00,34372,34373
44390,1,512,512,512.00,0.00,34372,34373
44391,1,512,512,512.00,0.00,34372,34373
44392,4,273,1,128.00,10297.00,34372,34376
44393,1,512,512,512.00,0.00,34375,34376
44394,1,512,512,512.00,0.00,34375,34376
44395,1,512,512,512.00,0.00,34375,34376
44396,1,512,512,512.00,0.00,34375,34376
44397,1,512,512,512.00,0.00,34375,34376
44398,5,254,1,102.40,14727.44,34375,34380
44399,7,258,1,73.14,7796.98,34379,34386
44400,2,380,132,256.00,15376.00,34385,34387
44401,3,471,15,170.67,45120.22,34386,34389
44402,3,412,6,170.67,30411.56,34388,34391
44403,3,464,19,170.67,43038.89,34390,34393
44404,1,512,512,512.00,0.00,34392,34393
44405,2,412,100,256.00,24336.00,34392,34394
44406,1,512,512,512.00,0.00,34393,34394
44407,3,213,116,170.67,1644.22,34393,34396
44408,1,512,512,512.00,0.00,34395,34396
44409,1,512,512,512.00,0.00,34395,34396
44410,2,490,22,256.00,54756.00,34395,34397
44411,1,512,512,512.00,0.00,34396,34397
44412,1,512,512,512.00,0.00,34396,34397
44413,2,467,45,256.00,44521.00,34396,34398
44414,1,512,512,512.00,0.00,34397,34398
44415,1,512,512,512.00,0.00,34397,34398
44416,1,512,512,512.00,0.00,34397,34398
44417,1,512,512,512.00,0.00,34397,34398
44418,1,512,512,512.00,0.00,34397,34398
44419,1,512,512,512.00,0.00,34397,34398
44420,1,512,512,512.00,0.00,34397,34398
44421,2,359,153,256.00,10609.00,34397,34399
44422,1,512,512,512.00,0.00,34398,34399
44423,3,392,31,170.67,25054.89,34398,34401
44424,3,448,19,170.67,38569.56,34400,34403
44425,1,512,512,512.00,0.00,34402,34403
44426,2,349,163,256.00,8649.00,34402,34404
44427,1,512,512,512.00,0.00,34403,34404
44428,3,297,4,170.67,15121.56,34403,34406
44429,1,512,512,512.00,0.00,34405,34406
44430,3,390,2,170.67,26374.22,34405,34408
44431,5,235,13,102.40,6099.04,34407,34412
44432,6,347,11,85.33,13930.89,34411,34417
44433,3,442,35,170.67,36810.89,34416,34419
44434,2,456,56,256.00,40000.00,34418,34420
44435,1,512,512,512.00,0.00,34419,34420
44436,3,281,74,170.67,7234.89,34419,34422
44437,2,395,117,256.00,19321.00,34421,34423
44438,6,272,1,85.33,7780.22,34422,34428
44439,3,268,23,170.67,11270.89,34427,34430
44440,3,360,55,170.67,18217.56,34429,34432
44441,2,333,179,256.00,5929.00,34431,34433
44442,1,512,512,512.00,0.00,34432,34433
44443,1,512,512,512.00,0.00,34432,34433
44444,4,271,19,128.00,9331.50,34432,34436
44445,2,323,189,256.00,4489.00,34435,34437
44446,1,512,512,512.00,0.00,34436,34437
44447,1,512,512,512.00,0.00,34436,34437
44448,2,390,122,256.00,17956.00,34436,34438
44449,1,512,512,512.00,0.00,34437,34438
44450,1,512,512,512.00,0.00,34437,34438
44451,3,289,5,170.67,14562.89,34437,34440
44452,1,512,512,512.00,0.00,34439,34440
44453,3,342,27,170.67,16920.22,34439,34442
44454,2,333,179,256.00,5929.00,34441,34443
44455,1,512,512,512.00,0.00,34442,34443
44456,7,194,10,73.14,3120.12,34442,34449
44457,1,512,512,512.00,0.00,34448,34449
44458,2,482,30,256.00,51076.00,34448,34450
44459,1,512,512,512.00,0.00,34449,34450
44460,3,253,11,170.67,12750.89,34449,34452
44461,1,512,512,512.00,0.00,34451,34452
44462,1,512,512,512.00,0.00,34451,34452
44463,1,512,512,512.00,0.00,34451,34452
44464,1,512,512,512.00,0.00,34451,34452
44465,2,278,234,256.00,484.00,34451,34453
44466,1,512,512,512.00,0.00,34452,34453
44467,1,512,512,512.00,0.00,34452,34453
44468,1,512,512,512.00,0.00,34452,34453
44469,2,482,30,256.00,51076.00,34452,34454
44470,2,373,139,256.00,13689.00,34453,34455
44471,3,358,37,170.67,18613.56,34454,34457
44472,3,192,145,170.67,377.56,34456,34459
44473,1,512,512,512.00,0.00,34458,34459
44474,2,424,88,256.00,28224.00,34458,34460
44475,6,373,5,85.33,17061.56,34459,34465
44476,9,199,2,56.89,4394.99,34464,34473
44477,1,512,512,512.00,0.00,34472,34473
44478,1,512,512,512.00,0.00,34472,34473
44479,1,512,512,512.00,0.00,34472,34473
44480,1,512,512,512.00,0.00,34472,34473
44481,1,512,512,512.00,0.00,34472,34473
44482,1,512,512,512.00,0.00,34472,34473
44483,3,317,54,170.67,11968.22,34472,34475
44484,1,512,512,512.00,0.00,34474,34475
44485,1,512,512,512.00,0.00,34474,34475
44486,1,512,512,512.00,0.00,34474,34475
44487,2,457,55,256.00,40401.00,34474,34476
44488,1,512,512,512.00,0.00,34475,34476
44489,3,465,6,170.67,43520.22,34475,34478
44490,1,512,512,512.00,0.00,34477,34478
44491,1,512,512,512.00,0.00,34477,34478
44492,1,512,512,512.00,0.00,34477,34478
44493,1,512,512,512.00,0.00,34477,34478
44494,2,327,185,256.00,5041.00,34477,34479
44495,1,512,512,512.00,0.00,34478,34479
44496,1,512,512,512.00,0.00,34478,34479
44497,1,512,512,512.00,0.00,34478,34479
44498,1,512,512,512.00,0.00,34478,34479
44499,2,510,2,256.00,64516.00,34478,34480
44500,2,434,78,256.00,31684.00,34479,34481
44501,2,299,213,256.00,1849.00,34480,34482
44502,1,512,512,512.00,0.00,34481,34482
44503,1,512,512,512.00,0.00,34481,34482
44504,3,241,63,170.67,5977.56,34481,34484
44505,1,512,512,512.00,0.00,34483,34484
44506,1,512,512,512.00,0.00,34483,34484
44507,1,512,512,512.00,0.00,34483,34484
44508,1,512,512,512.00,0.00,34483,34484
44509,2,397,115,256.00,19881.00,34483,34485
44510,1,512,512,512.00,0.00,34484,34485
44511,1,512,512,512.00,0.00,34484,34485
44512,3,436,12,170.67,35651.56,34484,34487
44513,3,300,2,170.67,15574.22,34486,34489
44514,1,512,512,512.00,0.00,34488,34489
44515,1,512,512,512.00,0.00,34488,34489
44516,1,512,512,512.00,0.00,34488,34489
44517,1,512,512,512.00,0.00,34488,34489
44518,1,512,512,512.00,0.00,34488,34489
44519,2,358,154,256.00,10404.00,34488,34490
44520,1,512,512,512.00,0.00,34489,34490
44521,2,285,227,256.00,841.00,34489,34491
44522,3,470,20,170.67,44800.89,34490,34493
44523,1,512,512,512.00,0.00,34492,34493
44524,1,512,512,512.00,0.00,34492,34493
44525,4,263,1,128.00,11958.50,34492,34496
44526,1,512,512,512.00,0.00,34495,34496
44527,1,512,512,512.00,0.00,34495,34496
44528,1,512,512,512.00,0.00,34495,34496
44529,1,512,512,512.00,0.00,34495,34496
44530,2,490,22,256.00,54756.00,34495,34497
44531,1,512,512,512.00,0.00,34496,34497
44532,1,512,512,512.00,0.00,34496,34497
44533,1,512,512,512.00,0.00,34496,34497
44534,2,454,58,256.00,39204.00,34496,34498
44535,1,512,512,512.00,0.00,34497,34498
44536,1,512,512,512.00,0.00,34497,34498
44537,1,512,512,512.00,0.00,34497,34498
44538,1,512,512,512.00,0.00,34497,34498
44539,4,287,3,128.00,11211.50,34497,34501
44540,2,481,31,256.00,50625.00,34500,34502
44541,1,512,512,512.00,0.00,34501,34502
44542,2,456,56,256.00,40000.00,34501,34503
44543,4,442,1,128.00,33580.50,34502,34506
44544,1,512,512,512.00,0.00,34505,34506
44545,1,512,512,512.00,0.00,34505,34506
44546,1,512,512,512.00,0.00,34505,34506
44547,3,308,24,170.67,13486.22,34505,34508
44548,2,473,39,256.00,47089.00,34507,34509
44549,1,512,512,512.00,0.00,34508,34509
44550,2,403,109,256.00,21609.00,34508,34510
44551,1,512,512,512.00,0.00,34509,34510
44552,1,512,512,512.00,0.00,34509,34510
44553,3,509,1,170.67,57234.89,34509,34512
44554,1,512,512,512.00,0.00,34511,34512
44555,6,303,1,85.33,13730.89,34511,34517
44556,1,512,512,512.00,0.00,34516,34517
44557,4,296,2,128.00,15853.50,34516,34520
44558,4,252,7,128.00,11691.50,34519,34523
44559,1,512,512,512.00,0.00,34522,34523
44560,1,512,512,512.00,0.00,34522,34523
44561,4,362,9,128.00,20712.50,34522,34526
44562,11,336,3,46.55,8868.07,34525,34536
44563,1,512,512,512.00,0.00,34535,34536
44564,2,488,24,256.00,53824.00,34535,34537
44565,1,512,512,512.00,0.00,34536,34537
44566,1,512,512,512.00,0.00,34536,34537
44567,1,512,512,512.00,0.00,34536,34537
44568,1,512,512,512.00,0.00,34536,34537
44569,3,418,3,170.67,31877.56,34536,34539
44570,1,512,512,512.00,0.00,34538,34539
44571,1,512,512,512.00,0.00,34538,34539
44572,1,512,512,512.00,0.00,34538,34539
44573,2,306,206,256.00,2500.00,34538,34540
44574,5,251,29,102.40,6364.64,34539,34544
44575,3,358,50,170.67,18032.89,34543,34546
44576,2,464,48,256.00,43264.00,34545,34547
44577,3,391,36,170.67,24673.56,34546,34549
44578,1,512,512,512.00,0.00,34548,34549
44579,1,512,512,512.00,0.00,34548,34549
44580,1,512,512,512.00,0.00,34548,34549
44581,1,512,512,512.00,0.00,34548,34549
44582,1,512,512,512.00,0.00,34548,34549
44583,3,445,18,170.67,37789.56,34548,34551
44584,2,326,186,256.00,4900.00,34550,34552
44585,2,310,202,256.00,2916.00,34551,34553
44586,1,512,512,512.00,0.00,34552,34553
44587,1,512,512,512.00,0.00,34552,34553
44588,2,272,240,256.00,256.00,34552,34554
44589,1,512,512,512.00,0.00,34553,34554
44590,1,512,512,512.00,0.00,34553,34554
44591,3,312,86,170.67,10118.22,34553,34556
44592,1,512,512,512.00,0.00,34555,34556
44593,1,512,512,512.00,0.00,34555,34556
44594,1,512,512,512.00,0.00,34555,34556
44595,1,512,512,512.00,0.00,34555,34556
44596,3,300,34,170.67,11819.56,34555,34558
44597,1,512,512,512.00,0.00,34557,34558
44598,2,438,74,256.00,33124.00,34557,34559
44599,4,425,9,128.00,29697.50,34558,34562
44600,4,274,22,128.00,9690.00,34561,34565
44601,1,512,512,512.00,0.00,34564,34565
44602,1,512,512,512.00,0.00,34564,34565
44603,1,512,512,512.00,0.00,34564,34565
44604,3,419,27,170.67,31088.22,34564,34567
44605,1,512,512,512.00,0.00,34566,34567
44606,1,512,512,512.00,0.00,34566,34567
44607,1,512,512,512.00,0.00,34566,34567
44608,1,512,512,512.00,0.00,34566,34567
44609,1,512,512,512.00,0.00,34566,34567
44610,1,512,512,512.00,0.00,34566,34567
44611,2,403,109,256.00,21609.00,34566,34568
44612,1,512,512,512.00,0.00,34567,34568
44613,3,376,27,170.67,22201.56,34567,34570
44614,2,270,242,256.00,196.00,34569,34571
44615,4,355,5,128.00,18048.50,34570,34574
44616,2,459,53,256.00,41209.00,34573,34575
44617,2,370,142,256.00,12996.00,34574,34576
44618,1,512,512,512.00,0.00,34575,34576
44619,5,371,2,102.40,18933.04,34575,34580
44620,1,512,512,512.00,0.00,34579,34580
44621,7,338,1,73.14,12741.55,34579,34586
44622,1,512,512,512.00,0.00,34585,34586
44623,1,512,512,512.00,0.00,34585,34586
44624,3,276,5,170.67,14060.22,34585,34588
44625,1,512,512,512.00,0.00,34587,34588
44626,1,512,512,512.00,0.00,34587,34588
44627,2,452,60,256.00,38416.00,34587,34589
44628,1,512,512,512.00,0.00,34588,34589
44629,3,436,5,170.67,35926.89,34588,34591
44630,1,512,512,512.00,0.00,34590,34591
44631,7,295,1,73.14,8698.69,34590,34597
44632,4,229,47,128.00,5490.50,34596,34600
44633,7,220,2,73.14,6952.98,34599,34606
44634,1,512,512,512.00,0.00,34605,34606
44635,1,512,512,512.00,0.00,34605,34606
44636,3,304,95,170.67,8942.89,34605,34608
44637,1,512,512,512.00,0.00,34607,34608
44638,3,237,126,170.67,2288.22,34607,34610
44639,1,512,512,512.00,0.00,34609,34610
44640,1,512,512,512.00,0.00,34609,34610
44641,1,512,512,512.00,0.00,34609,34610
44642,1,512,512,512.00,0.00,34609,34610
44643,3,418,3,170.67,31877.56,34609,34612
44644,2,454,58,256.00,39204.00,34611,34613
44645,2,276,236,256.00,400.00,34612,34614
44646,1,512,512,512.00,0.00,34613,34614
44647,1,512,512,512.00,0.00,34613,34614
44648,2,370,142,256.00,12996.00,34613,34615
44649,1,512,512,512.00,0.00,34614,34615
44650,3,272,39,170.67,9508.22,34614,34617
44651,12,228,1,42.67,3637.39,34616,34628
44652,1,512,512,512.00,0.00,34627,34628
44653,1,512,512,512.00,0.00,34627,34628
44654,1,512,512,512.00,0.00,34627,34628
44655,1,512,512,512.00,0.00,34627,34628
44656,2,281,231,256.00,625.00,34627,34629
44657,1,512,512,512.00,0.00,34628,34629
44658,1,512,512,512.00,0.00,34628,34629
44659,1,512,512,512.00,0.00,34628,34629
44660,3,289,88,170.67,7369.56,34628,34631
44661,1,512,512,512.00,0.00,34630,34631
44662,4,323,2,128.00,16996.50,34630,34634
44663,1,512,512,512.00,0.00,34633,34634
44664,2,324,188,256.00,4624.00,34633,34635
44665,1,512,512,512.00,0.00,34634,34635
44666,2,343,169,256.00,7569.00,34634,34636
44667,1,512,512,512.00,0.00,34635,34636
44668,7,409,1,73.14,18988.98,34635,34642
44669,1,512,512,512.00,0.00,34641,34642
44670,1,512,512,512.00,0.00,34641,34642
44671,1,512,512,512.00,0.00,34641,34642
44672,1,512,512,512.00,0.00,34641,34642
44673,1,512,512,512.00,0.00,34641,34642
44674,1,512,512,512.00,0.00,34641,34642
44675,1,512,512,512.00,0.00,34641,34642
44676,1,512,512,512.00,0.00,34641,34642
44677,1,512,512,512.00,0.00,34641,34642
44678,1,512,512,512.00,0.00,34641,34642
44679,1,512,512,512.00,0.00,34641,34642
44680,1,512,512,512.00,0.00,34641,34642
44681,1,512,512,512.00,0.00,34641,34642
44682,5,343,2,102.40,16990.64,34641,34646
44683,1,512,512,512.00,0.00,34645,34646
44684,2,490,22,256.00,54756.00,34645,34647
44685,4,476,1,128.00,40533.50,34646,34650
44686,1,512,512,512.00,0.00,34649,34650
44687,1,512,512,512.00,0.00,34649,34650
44688,2,386,126,256.00,16900.00,34649,34651
44689,3,407,10,170.67,29130.89,34650,34653
44690,1,512,512,512.00,0.00,34652,34653
44691,2,496,16,256.00,57600.00,34652,34654
44692,1,512,512,512.00,0.00,34653,34654
44693,1,512,512,512.00,0.00,34653,34654
44694,1,512,512,512.00,0.00,34653,34654
44695,1,512,512,512.00,0.00,34653,34654
44696,4,195,2,128.00,5826.50,34653,34657
44697,4,244,67,128.00,4763.50,34656,34660
44698,1,512,512,512.00,0.00,34659,34660
44699,1,512,512,512.00,0.00,34659,34660
44700,4,349,3,128.00,19580.50,34659,34663
44701,1,512,512,512.00,0.00,34662,34663
44702,3,283,15,170.67,12909.56,34662,34665
44703,1,512,512,512.00,0.00,34664,34665
44704,4,424,1,128.00,30209.50,34664,34668
44705,1,512,512,512.00,0.00,34667,34668
44706,1,512,512,512.00,0.00,34667,34668
44707,1,512,512,512.00,0.00,34667,34668
44708,1,512,512,512.00,0.00,34667,34668
44709,5,268,1,102.40,15210.64,34667,34672
44710,2,443,69,256.00,34969.00,34671,34673
44711,2,283,229,256.00,729.00,34672,34674
44712,1,512,512,512.00,0.00,34673,34674
44713,3,391,1,170.67,26633.56,34673,34676
44714,1,512,512,512.00,0.00,34675,34676
44715,1,512,512,512.00,0.00,34675,34676
44716,3,347,2,170.67,19866.89,34675,34678
44717,1,512,512,512.00,0.00,34677,34678
44718,2,334,178,256.00,6084.00,34677,34679
44719,1,512,512,512.00,0.00,34678,34679
44720,4,394,2,128.00,24148.50,34678,34682
44721,2,406,106,256.00,22500.00,34681,34683
44722,1,512,512,512.00,0.00,34682,34683
44723,1,512,512,512.00,0.00,34682,34683
44724,1,512,512,512.00,0.00,34682,34683
44725,1,512,512,512.00,0.00,34682,34683
44726,1,512,512,512.00,0.00,34682,34683
44727,1,512,512,512.00,0.00,34682,34683
44728,1,512,512,512.00,0.00,34682,34683
44729,2,398,114,256.00,20164.00,34682,34684
44730,1,512,512,512.00,0.00,34683,34684
44731,1,512,512,512.00,0.00,34683,34684
44732,1,512,512,512.00,0.00,34683,34684
44733,1,512,512,512.00,0.00,34683,34684
44734,1,512,512,512.00,0.00,34683,34684
44735,1,512,512,512.00,0.00,34683,34684
44736,1,512,512,512.00,0.00,34683,34684
44737,3,315,66,170.67,11120.22,34683,34686
44738,2,424,88,256.00,28224.00,34685,34687
44739,1,512,512,512.00,0.00,34686,34687
44740,1,512,512,512.00,0.00,34686,34687
44741,1,512,512,512.00,0.00,34686,34687
44742,2,331,181,256.00,5625.00,34686,34688
44743,3,332,18,170.67,16470.22,34687,34690
44744,1,512,512,512.00,0.00,34689,34690
44745,1,512,512,512.00,0.00,34689,34690
44746,2,490,22,256.00,54756.00,34689,34691
44747,4,421,11,128.00,28756.50,34690,34694
44748,4,298,2,128.00,15308.00,34693,34697
44749,2,292,220,256.00,1296.00,34696,34698
44750,1,512,512,512.00,0.00,34697,34698
44751,1,512,512,512.00,0.00,34697,34698
44752,4,205,25,128.00,4699.50,34697,34701
44753,4,499,3,128.00,45883.00,34700,34704
44754,1,512,512,512.00,0.00,34703,34704
44755,1,512,512,512.00,0.00,34703,34704
44756,4,409,4,128.00,27611.50,34703,34707
44757,1,512,512,512.00,0.00,34706,34707
44758,1,512,512,512.00,0.00,34706,34707
44759,3,367,38,170.67,20066.89,34706,34709
44760,1,512,512,512.00,0.00,34708,34709
44761,3,474,3,170.67,46176.22,34708,34711
44762,1,512,512,512.00,0.00,34710,34711
44763,5,477,3,102.40,35151.84,34710,34715
44764,1,512,512,512.00,0.00,34714,34715
44765,1,512,512,512.00,0.00,34714,34715
44766,6,388,4,85.33,18739.22,34714,34720
44767,2,327,185,256.00,5041.00,34719,34721
44768,1,512,512,512.00,0.00,34720,34721
44769,2,452,60,256.00,38416.00,34720,34722
44770,1,512,512,512.00,0.00,34721,34722
44771,3,268,9,170.67,13249.56,34721,34724
44772,1,512,512,512.00,0.00,34723,34724
44773,4,305,43,128.00,10701.00,34723,34727
44774,2,276,236,256.00,400.00,34726,34728
44775,2,448,64,256.00,36864.00,34727,34729
44776,6,342,1,85.33,15162.56,34728,34734
44777,1,512,512,512.00,0.00,34733,34734
44778,2,300,212,256.00,1936.00,34733,34735
44779,1,512,512,512.00,0.00,34734,34735
44780,1,512,512,512.00,0.00,34734,34735
44781,1,512,512,512.00,0.00,34734,34735
44782,2,303,209,256.00,2209.00,34734,34736
44783,1,512,512,512.00,0.00,34735,34736
44784,1,512,512,512.00,0.00,34735,34736
44785,5,326,10,102.40,14061.44,34735,34740
44786,2,443,69,256.00,34969.00,34739,34741
44787,2,302,210,256.00,2116.00,34740,34742
44788,2,281,231,256.00,625.00,34741,34743
44789,1,512,512,512.00,0.00,34742,34743
44790,1,512,512,512.00,0.00,34742,34743
44791,1,512,512,512.00,0.00,34742,34743
44792,1,512,512,512.00,0.00,34742,34743
44793,1,512,512,512.00,0.00,34742,34743
44794,1,512,512,512.00,0.00,34742,34743
44795,3,427,2,170.67,33946.89,34742,34745
44796,1,512,512,512.00,0.00,34744,34745
44797,1,512,512,512.00,0.00,34744,34745
44798,1,512,512,512.00,0.00,34744,34745
44799,1,512,512,512.00,0.00,34744,34745
44800,1,512,512,512.00,0.00,34744,34745
44801,2,416,96,256.00,25600.00,34744,34746
44802,5,262,1,102.40,11049.84,34745,34750
44803,1,512,512,512.00,0.00,34749,34750
44804,1,512,512,512.00,0.00,34749,34750
44805,1,512,512,512.00,0.00,34749,34750
44806,5,295,23,102.40,10052.64,34749,34754
44807,1,512,512,512.00,0.00,34753,34754
44808,1,512,512,512.00,0.00,34753,34754
44809,1,512,512,512.00,0.00,34753,34754
44810,4,434,1,128.00,31746.50,34753,34757
44811,1,512,512,512.00,0.00,34756,34757
44812,1,512,512,512.00,0.00,34756,34757
44813,3,291,8,170.67,14244.22,34756,34759
44814,5,284,17,102.40,8895.84,34758,34763
44815,1,512,512,512.00,0.00,34762,34763
44816,4,236,4,128.00,6842.00,34762,34766
44817,7,250,2,73.14,7654.12,34765,34772
44818,1,512,512,512.00,0.00,34771,34772
44819,2,479,33,256.00,49729.00,34771,34773
44820,1,512,512,512.00,0.00,34772,34773
44821,1,512,512,512.00,0.00,34772,34773
44822,1,512,512,512.00,0.00,34772,34773
44823,3,403,38,170.67,27170.89,34772,34775
44824,4,288,3,128.00,13015.50,34774,34778
44825,1,512,512,512.00,0.00,34777,34778
44826,3,422,31,170.67,31714.89,34777,34780
44827,2,417,95,256.00,25921.00,34779,34781
44828,1,512,512,512.00,0.00,34780,34781
44829,1,512,512,512.00,0.00,34780,34781
44830,1,512,512,512.00,0.00,34780,34781
44831,1,512,512,512.00,0.00,34780,34781
44832,1,512,512,512.00,0.00,34780,34781
44833,4,357,3,128.00,18913.00,34780,34784
44834,1,512,512,512.00,0.00,34783,34784
44835,1,512,512,512.00,0.00,34783,34784
44836,1,512,512,512.00,0.00,34783,34784
44837,2,495,17,256.00,57121.00,34783,34785
44838,2,349,163,256.00,8649.00,34784,34786
44839,3,317,6,170.67,16288.22,34785,34788
44840,4,387,36,128.00,22378.50,34787,34791
44841,2,442,70,256.00,34596.00,34790,34792
44842,1,512,512,512.00,0.00,34791,34792
44843,2,486,26,256.00,52900.00,34791,34793
44844,3,311,29,170.67,13254.89,34792,34795
44845,2,470,42,256.00,45796.00,34794,34796
44846,3,363,2,170.67,22000.22,34795,34798
44847,2,332,180,256.00,5776.00,34797,34799
44848,1,512,512,512.00,0.00,34798,34799
44849,4,234,4,128.00,11301.50,34798,34802
44850,3,404,48,170.67,27246.22,34801,34804
44851,2,406,106,256.00,22500.00,34803,34805
44852,1,512,512,512.00,0.00,34804,34805
44853,1,512,512,512.00,0.00,34804,34805
44854,6,375,1,85.33,17612.22,34804,34810
44855,1,512,512,512.00,0.00,34809,34810
44856,3,411,32,170.67,29108.22,34809,34812
44857,1,512,512,512.00,0.00,34811,34812
44858,2,350,162,256.00,8836.00,34811,34813
44859,1,512,512,512.00,0.00,34812,34813
44860,2,499,13,256.00,59049.00,34812,34814
44861,4,440,8,128.00,32604.50,34813,34817
44862,1,512,512,512.00,0.00,34816,34817
44863,1,512,512,512.00,0.00,34816,34817
44864,1,512,512,512.00,0.00,34816,34817
44865,1,512,512,512.00,0.00,34816,34817
44866,2,285,227,256.00,841.00,34816,34818
44867,2,318,194,256.00,3844.00,34817,34819
44868,1,512,512,512.00,0.00,34818,34819
44869,4,251,63,128.00,5803.50,34818,34822
44870,1,512,512,512.00,0.00,34821,34822
44871,3,415,28,170.67,30129.56,34821,34824
44872,1,512,512,512.00,0.00,34823,34824
44873,1,512,512,512.00,0.00,34823,34824
44874,2,502,10,256.00,60516.00,34823,34825
44875,4,366,8,128.00,21069.50,34824,34828
44876,2,501,11,256.00,60025.00,34827,34829
44877,3,356,74,170.67,17184.89,34828,34831
44878,3,256,59,170.67,6814.89,34830,34833
44879,2,427,85,256.00,29241.00,34832,34834
44880,2,384,128,256.00,16384.00,34833,34835
44881,7,258,1,73.14,9650.12,34834,34841
44882,1,512,512,512.00,0.00,34840,34841
44883,2,442,70,256.00,34596.00,34840,34842
44884,1,512,512,512.00,0.00,34841,34842
44885,1,512,512,512.00,0.00,34841,34842
44886,4,331,2,128.00,16965.50,34841,34845
44887,2,396,116,256.00,19600.00,34844,34846
44888,2,462,50,256.00,42436.00,34845,34847
44889,2,297,215,256.00,1681.00,34846,34848
44890,1,512,512,512.00,0.00,34847,34848
44891,3,259,116,170.67,3974.89,34847,34850
44892,9,259,2,56.89,5853.21,34849,34858
44893,1,512,512,512.00,0.00,34857,34858
44894,1,512,512,512.00,0.00,34857,34858
44895,1,512,512,512.00,0.00,34857,34858
44896,5,267,6,102.40,9677.04,34857,34862
44897,1,512,512,512.00,0.00,34861,34862
44898,1,512,512,512.00,0.00,34861,34862
44899,1,512,512,512.00,0.00,34861,34862
44900,2,511,1,256.00,65025.00,34861,34863
44901,2,302,210,256.00,2116.00,34862,34864
44902,1,512,512,512.00,0.00,34863,34864
44903,4,255,13,128.00,9469.00,34863,34867
44904,4,368,1,128.00,22513.50,34866,34870
44905,3,486,1,170.67,49813.56,34869,34872
44906,3,244,100,170.67,3459.56,34871,34874
44907,3,317,39,170.67,12988.22,34873,34876
44908,4,392,10,128.00,23769.50,34875,34879
44909,4,375,13,128.00,21248.50,34878,34882
44910,7,325,2,73.14,11787.84,34881,34888
44911,8,249,5,64.00,5992.50,34887,34895
44912,1,512,512,512.00,0.00,34894,34895
44913,1,512,512,512.00,0.00,34894,34895
44914,3,366,5,170.67,22160.22,34894,34897
44915,1,512,512,512.00,0.00,34896,34897
44916,1,512,512,512.00,0.00,34896,34897
44917,4,239,54,128.00,4686.50,34896,34900
44918,1,512,512,512.00,0.00,34899,34900
44919,1,512,512,512.00,0.00,34899,34900
44920,2,471,41,256.00,46225.00,34899,34901
44921,1,512,512,512.00,0.00,34900,34901
44922,1,512,512,512.00,0.00,34900,34901
44923,2,368,144,256.00,12544.00,34900,34902
44924,1,512,512,512.00,0.00,34901,34902
44925,1,512,512,512.00,0.00,34901,34902
44926,1,512,512,512.00,0.00,34901,34902
44927,5,199,3,102.40,5171.04,34901,34906
44928,1,512,512,512.00,0.00,34905,34906
44929,1,512,512,512.00,0.00,34905,34906
44930,2,321,191,256.00,4225.00,34905,34907
44931,1,512,512,512.00,0.00,34906,34907
44932,1,512,512,512.00,0.00,34906,34907
44933,2,353,159,256.00,9409.00,34906,34908
44934,3,245,121,170.67,2866.89,34907,34910
44935,2,425,87,256.00,28561.00,34909,34911
44936,3,418,21,170.67,31037.56,34910,34913
44937,5,336,3,102.40,14918.24,34912,34917
44938,1,512,512,512.00,0.00,34916,34917
44939,3,328,75,170.67,12569.56,34916,34919
44940,1,512,512,512.00,0.00,34918,34919
44941,1,512,512,512.00,0.00,34918,34919
44942,1,512,512,512.00,0.00,34918,34919
44943,1,512,512,512.00,0.00,34918,34919
44944,3,241,53,170.67,7010.89,34918,34921
44945,1,512,512,512.00,0.00,34920,34921
44946,1,512,512,512.00,0.00,34920,34921
44947,1,512,512,512.00,0.00,34920,34921
44948,1,512,512,512.00,0.00,34920,34921
44949,1,512,512,512.00,0.00,34920,34921
44950,1,512,512,512.00,0.00,34920,34921
44951,3,420,15,170.67,31724.22,34920,34923
44952,2,491,21,256.00,55225.00,34922,34924
44953,6,199,6,85.33,4487.89,34923,34929
44954,5,310,1,102.40,13901.04,34928,34933
44955,2,325,187,256.00,4761.00,34932,34934
44956,1,512,512,512.00,0.00,34933,34934
44957,2,458,54,256.00,40804.00,34933,34935
44958,3,410,12,170.67,29654.22,34934,34937
44959,2,482,30,256.00,51076.00,34936,34938
44960,2,288,224,256.00,1024.00,34937,34939
44961,1,512,512,512.00,0.00,34938,34939
44962,2,482,30,256.00,51076.00,34938,34940
44963,2,477,35,256.00,48841.00,34939,34941
44964,2,332,180,256.00,5776.00,34940,34942
44965,1,512,512,512.00,0.00,34941,34942
44966,2,360,152,256.00,10816.00,34941,34943
44967,1,512,512,512.00,0.00,34942,34943
44968,4,221,1,128.00,7743.50,34942,34946
44969,1,512,512,512.00,0.00,34945,34946
44970,1,512,512,512.00,0.00,34945,34946
44971,1,512,512,512.00,0.00,34945,34946
44972,5,335,2,102.40,14661.44,34945,34950
44973,1,512,512,512.00,0.00,34949,34950
44974,1,512,512,512.00,0.00,34949,34950
44975,1,512,512,512.00,0.00,34949,34950
44976,1,512,512,512.00,0.00,34949,34950
44977,1,512,512,512.00,0.00,34949,34950
44978,2,511,1,256.00,65025.00,34949,34951
44979,4,229,13,128.00,6641.50,34950,34954
44980,1,512,512,512.00,0.00,34953,34954
44981,1,512,512,512.00,0.00,34953,34954
44982,1,512,512,512.00,0.00,34953,34954
44983,3,308,1,170.67,16230.89,34953,34956
44984,1,512,512,512.00,0.00,34955,34956
44985,6,229,2,85.33,7752.22,34955,34961
44986,1,512,512,512.00,0.00,34960,34961
44987,1,512,512,512.00,0.00,34960,34961
44988,1,512,512,512.00,0.00,34960,34961
44989,3,393,6,170.67,26624.22,34960,34963
44990,1,512,512,512.00,0.00,34962,34963
44991,1,512,512,512.00,0.00,34962,34963
44992,1,512,512,512.00,0.00,34962,34963
44993,5,343,1,102.40,15051.04,34962,34967
44994,1,512,512,512.00,0.00,34966,34967
44995,2,457,55,256.00,40401.00,34966,34968
44996,1,512,512,512.00,0.00,34967,34968
44997,5,376,8,102.40,20136.24,34967,34972
44998,1,512,512,512.00,0.00,34971,34972
44999,1,512,512,512.00,0.00,34971,34972
45000,1,512,512,512.00,0.00,34971,34972
45001,1,512,512,512.00,0.00,34971,34972
45002,1,512,512,512.00,0.00,34971,34972
45003,3,264,9,170.67,13172.22,34971,34974
45004,1,512,512,512.00,0.00,34973,34974
45005,4,362,15,128.00,18901.50,34973,34977
45006,1,512,512,512.00,0.00,34976,34977
45007,1,512,512,512.00,0.00,34976,34977
45008,3,225,137,170.67,1504.22,34976,34979
45009,2,327,185,256.00,5041.00,34978,34980
45010,3,383,11,170.67,24450.89,34979,34982
45011,1,512,512,512.00,0.00,34981,34982
45012,5,280,1,102.40,10523.44,34981,34986
45013,2,408,104,256.00,23104.00,34985,34987
45014,4,341,20,128.00,15639.50,34986,34990
45015,6,248,1,85.33,6905.22,34989,34995
45016,1,512,512,512.00,0.00,34994,34995
45017,5,237,1,102.40,6749.44,34994,34999
45018,1,512,512,512.00,0.00,34998,34999
45019,1,512,512,512.00,0.00,34998,34999
45020,1,512,512,512.00,0.00,34998,34999
45021,1,512,512,512.00,0.00,34998,34999
45022,1,512,512,512.00,0.00,34998,34999
45023,4,299,2,128.00,16785.50,34998,35002
45024,3,262,73,170.67,5973.56,35001,35004
45025,1,512,512,512.00,0.00,35003,35004
45026,2,358,154,256.00,10404.00,35003,35005
45027,1,512,512,512.00,0.00,35004,35005
45028,1,512,512,512.00,0.00,35004,35005
45029,2,305,207,256.00,2401.00,35004,35006
45030,1,512,512,512.00,0.00,35005,35006
45031,9,361,1,56.89,11920.10,35005,35014
45032,1,512,512,512.00,0.00,35013,35014
45033,1,512,512,512.00,0.00,35013,35014
45034,2,452,60,256.00,38416.00,35013,35015
45035,1,512,512,512.00,0.00,35014,35015
45036,7,299,1,73.14,9605.84,35014,35021
45037,4,469,1,128.00,38911.50,35020,35024
45038,4,207,81,128.00,2690.50,35023,35027
45039,1,512,512,512.00,0.00,35026,35027
45040,1,512,512,512.00,0.00,35026,35027
45041,1,512,512,512.00,0.00,35026,35027
45042,1,512,512,512.00,0.00,35026,35027
45043,4,447,1,128.00,34530.50,35026,35030
45044,1,512,512,512.00,0.00,35029,35030
45045,1,512,512,512.00,0.00,35029,35030
45046,1,512,512,512.00,0.00,35029,35030
45047,1,512,512,512.00,0.00,35029,35030
45048,3,426,6,170.67,33510.22,35029,35032
45049,1,512,512,512.00,0.00,35031,35032
45050,2,455,57,256.00,39601.00,35031,35033
45051,3,276,1,170.67,14673.56,35032,35035
45052,1,512,512,512.00,0.00,35034,35035
45053,3,449,27,170.67,38748.22,35034,35037
45054,8,202,2,64.00,6468.50,35036,35044
45055,1,512,512,512.00,0.00,35043,35044
45056,1,512,512,512.00,0.00,35043,35044
45057,1,512,512,512.00,0.00,35043,35044
45058,1,512,512,512.00,0.00,35043,35044
45059,3,439,16,170.67,36281.56,35043,35046
45060,1,512,512,512.00,0.00,35045,35046
45061,3,478,8,170.67,47280.89,35045,35048
45062,1,512,512,512.00,0.00,35047,35048
45063,1,512,512,512.00,0.00,35047,35048
45064,2,490,22,256.00,54756.00,35047,35049
45065,7,378,1,73.14,16084.41,35048,35055
45066,3,329,1,170.67,17994.89,35054,35057
45067,6,244,1,85.33,7684.89,35056,35062
45068,1,512,512,512.00,0.00,35061,35062
45069,1,512,512,512.00,0.00,35061,35062
45070,1,512,512,512.00,0.00,35061,35062
45071,3,333,5,170.67,17936.22,35061,35064
45072,3,478,2,170.67,47376.89,35063,35066
45073,2,438,74,256.00,33124.00,35065,35067
45074,1,512,512,512.00,0.00,35066,35067
45075,1,512,512,512.00,0.00,35066,35067
45076,1,512,512,512.00,0.00,35066,35067
45077,3,424,20,170.67,32472.89,35066,35069
45078,2,511,1,256.00,65025.00,35068,35070
45079,4,458,7,128.00,36366.50,35070,35074
45080,1,512,512,512.00,0.00,35073,35074
45081,1,512,512,512.00,0.00,35073,35074
45082,1,512,512,512.00,0.00,35073,35074
45083,2,276,236,256.00,400.00,35073,35075
45084,4,201,2,128.00,5673.50,35074,35078
45085,1,512,512,512.00,0.00,35077,35078
45086,1,512,512,512.00,0.00,35077,35078
45087,1,512,512,512.00,0.00,35077,35078
45088,1,512,512,512.00,0.00,35077,35078
45089,2,331,181,256.00,5625.00,35077,35079
45090,1,512,512,512.00,0.00,35078,35079
45091,2,460,52,256.00,41616.00,35078,35080
45092,1,512,512,512.00,0.00,35079,35080
45093,1,512,512,512.00,0.00,35079,35080
45094,1,512,512,512.00,0.00,35079,35080
45095,1,512,512,512.00,0.00,35079,35080
45096,2,281,231,256.00,625.00,35079,35081
45097,3,401,33,170.67,26864.22,35080,35083
45098,1,512,512,512.00,0.00,35082,35083
45099,1,512,512,512.00,0.00,35082,35083
45100,6,441,1,85.33,25685.89,35082,35088
45101,1,512,512,512.00,0.00,35087,35088
45102,1,512,512,512.00,0.00,35087,35088
45103,1,512,512,512.00,0.00,35087,35088
45104,2,319,193,256.00,3969.00,35087,35089
45105,1,512,512,512.00,0.00,35088,35089
45106,1,512,512,512.00,0.00,35088,35089
45107,4,195,4,128.00,5648.50,35088,35092
45108,1,512,512,512.00,0.00,35091,35092
45109,1,512,512,512.00,0.00,35091,35092
45110,1,512,512,512.00,0.00,35091,35092
45111,1,512,512,512.00,0.00,35091,35092
45112,3,377,17,170.67,22986.89,35091,35094
45113,1,512,512,512.00,0.00,35093,35094
45114,4,356,31,128.00,17871.50,35093,35097
45115,2,414,98,256.00,24964.00,35096,35098
45116,3,292,96,170.67,7491.56,35097,35100
45117,2,383,129,256.00,16129.00,35099,35101
45118,2,329,183,256.00,5329.00,35100,35102
45119,1,512,512,512.00,0.00,35101,35102
45120,1,512,512,512.00,0.00,35101,35102
45121,1,512,512,512.00,0.00,35101,35102
45122,4,401,1,128.00,25509.50,35101,35105
45123,1,512,512,512.00,0.00,35104,35105
45124,2,472,40,256.00,46656.00,35104,35106
45125,2,277,235,256.00,441.00,35105,35107
45126,1,512,512,512.00,0.00,35106,35107
45127,2,402,110,256.00,21316.00,35106,35108
45128,1,512,512,512.00,0.00,35107,35108
45129,1,512,512,512.00,0.00,35107,35108
45130,1,512,512,512.00,0.00,35107,35108
45131,7,172,3,73.14,3524.41,35107,35114
45132,1,512,512,512.00,0.00,35113,35114
45133,1,512,512,512.00,0.00,35113,35114
45134,5,265,1,102.40,10258.24,35113,35118
45135,3,470,19,170.67,44802.89,35117,35120
45136,1,512,512,512.00,0.00,35119,35120
45137,1,512,512,512.00,0.00,35119,35120
45138,1,512,512,512.00,0.00,35119,35120
45139,3,428,1,170.67,34230.89,35119,35122
45140,1,512,512,512.00,0.00,35121,35122
45141,1,512,512,512.00,0.00,35121,35122
45142,5,409,3,102.40,24138.64,35121,35126
45143,1,512,512,512.00,0.00,35126,35127
45144,5,337,3,102.40,14991.04,35126,35131
45145,1,512,512,512.00,0.00,35130,35131
45146,1,512,512,512.00,0.00,35130,35131
45147,1,512,512,512.00,0.00,35130,35131
45148,1,512,512,512.00,0.00,35130,35131
45149,2,353,159,256.00,9409.00,35130,35132
45150,3,324,60,170.67,12526.22,35131,35134
45151,1,512,512,512.00,0.00,35133,35134
45152,3,280,1,170.67,14793.56,35133,35136
45153,2,299,213,256.00,1849.00,35135,35137
45154,1,512,512,512.00,0.00,35136,35137
45155,4,262,7,128.00,10945.50,35136,35140
45156,1,512,512,512.00,0.00,35139,35140
45157,1,512,512,512.00,0.00,35139,35140
45158,1,512,512,512.00,0.00,35139,35140
45159,1,512,512,512.00,0.00,35139,35140
45160,2,290,222,256.00,1156.00,35139,35141
45161,1,512,512,512.00,0.00,35140,35141
45162,1,512,512,512.00,0.00,35140,35141
45163,1,512,512,512.00,0.00,35140,35141
45164,6,236,9,85.33,6701.22,35140,35146
45165,1,512,512,512.00,0.00,35145,35146
45166,1,512,512,512.00,0.00,35145,35146
45167,3,402,35,170.67,27024.22,35145,35148
45168,1,512,512,512.00,0.00,35147,35148
45169,7,128,5,73.14,2141.55,35147,35154
45170,1,512,512,512.00,0.00,35153,35154
45171,1,512,512,512.00,0.00,35153,35154
45172,1,512,512,512.00,0.00,35153,35154
45173,1,512,512,512.00,0.00,35153,35154
45174,1,512,512,512.00,0.00,35153,35154
45175,2,511,1,256.00,65025.00,35154,35156
45176,3,473,6,170.67,45824.22,35155,35158
45177,1,512,512,512.00,0.00,35157,35158
45178,5,178,1,102.40,4422.64,35157,35162
45179,1,512,512,512.00,0.00,35161,35162
45180,3,348,12,170.67,18990.22,35161,35164
45181,1,512,512,512.00,0.00,35163,35164
45182,1,512,512,512.00,0.00,35163,35164
45183,1,512,512,512.00,0.00,35163,35164
45184,2,441,71,256.00,34225.00,35163,35165
45185,3,388,12,170.67,25283.56,35164,35167
45186,1,512,512,512.00,0.00,35166,35167
45187,1,512,512,512.00,0.00,35166,35167
45188,1,512,512,512.00,0.00,35166,35167
45189,1,512,512,512.00,0.00,35166,35167
45190,1,512,512,512.00,0.00,35166,35167
45191,2,397,115,256.00,19881.00,35166,35168
45192,1,512,512,512.00,0.00,35167,35168
45193,1,512,512,512.00,0.00,35167,35168
45194,1,512,512,512.00,0.00,35167,35168
45195,7,220,1,73.14,6124.12,35167,35174
45196,4,450,14,128.00,34580.00,35173,35177
45197,1,512,512,512.00,0.00,35176,35177
45198,1,512,512,512.00,0.00,35176,35177
45199,5,226,2,102.40,7115.44,35176,35181
45200,3,478,15,170.67,47229.56,35180,35183
45201,1,512,512,512.00,0.00,35182,35183
45202,1,512,512,512.00,0.00,35182,35183
45203,4,339,2,128.00,19323.50,35182,35186
45204,1,512,512,512.00,0.00,35185,35186
45205,2,302,210,256.00,2116.00,35185,35187
45206,1,512,512,512.00,0.00,35186,35187
45207,1,512,512,512.00,0.00,35186,35187
45208,6,275,1,85.33,8881.56,35186,35192
45209,1,512,512,512.00,0.00,35191,35192
45210,1,512,512,512.00,0.00,35191,35192
45211,1,512,512,512.00,0.00,35191,35192
45212,4,286,4,128.00,13510.00,35191,35195
45213,1,512,512,512.00,0.00,35194,35195
45214,7,456,1,73.14,24624.98,35194,35201
45215,2,301,211,256.00,2025.00,35200,35202
45216,2,371,141,256.00,13225.00,35201,35203
45217,2,341,171,256.00,7225.00,35202,35204
45218,2,473,39,256.00,47089.00,35203,35205
45219,1,512,512,512.00,0.00,35204,35205
45220,1,512,512,512.00,0.00,35204,35205
45221,5,295,3,102.40,12511.84,35204,35209
45222,2,340,172,256.00,7056.00,35208,35210
45223,1,512,512,512.00,0.00,35209,35210
45224,1,512,512,512.00,0.00,35209,35210
45225,3,206,139,170.67,754.89,35209,35212
45226,1,512,512,512.00,0.00,35211,35212
45227,3,465,23,170.67,43316.22,35211,35214
45228,1,512,512,512.00,0.00,35213,35214
45229,1,512,512,512.00,0.00,35213,35214
45230,4,331,15,128.00,15659.00,35213,35217
45231,3,334,1,170.67,18501.56,35216,35219
45232,1,512,512,512.00,0.00,35218,35219
45233,1,512,512,512.00,0.00,35218,35219
45234,3,361,2,170.67,21714.89,35218,35221
45235,1,512,512,512.00,0.00,35220,35221
45236,1,512,512,512.00,0.00,35220,35221
45237,3,236,99,170.67,3148.22,35220,35223
45238,2,396,116,256.00,19600.00,35222,35224
45239,1,512,512,512.00,0.00,35223,35224
45240,1,512,512,512.00,0.00,35223,35224
45241,2,414,98,256.00,24964.00,35223,35225
45242,2,355,157,256.00,9801.00,35224,35226
45243,2,475,37,256.00,47961.00,35225,35227
45244,1,512,512,512.00,0.00,35226,35227
45245,3,405,27,170.67,27924.22,35226,35229
45246,2,493,19,256.00,56169.00,35228,35230
45247,2,270,242,256.00,196.00,35229,35231
45248,1,512,512,512.00,0.00,35230,35231
45249,1,512,512,512.00,0.00,35230,35231
45250,3,504,1,170.67,55561.56,35230,35233
45251,1,512,512,512.00,0.00,35232,35233
45252,2,509,3,256.00,64009.00,35232,35234
45253,4,308,2,128.00,16946.00,35233,35237
45254,3,500,2,170.67,54240.89,35236,35239
45255,3,235,96,170.67,3273.56,35238,35241
45256,1,512,512,512.00,0.00,35240,35241
45257,1,512,512,512.00,0.00,35240,35241
45258,3,433,6,170.67,35157.56,35240,35243
45259,6,253,10,85.33,6874.22,35242,35248
45260,1,512,512,512.00,0.00,35247,35248
45261,5,215,1,102.40,6449.44,35247,35252
45262,1,512,512,512.00,0.00,35251,35252
45263,3,434,34,170.67,34688.89,35251,35254
45264,4,362,1,128.00,21297.50,35253,35257
45265,1,512,512,512.00,0.00,35256,35257
45266,4,349,8,128.00,17865.50,35256,35260
45267,3,302,19,170.67,13554.89,35259,35262
45268,3,190,132,170.67,747.56,35261,35264
45269,6,324,6,85.33,11697.89,35263,35269
45270,1,512,512,512.00,0.00,35268,35269
45271,2,385,127,256.00,16641.00,35268,35270
45272,3,240,83,170.67,4276.22,35269,35272
45273,1,512,512,512.00,0.00,35271,35272
45274,1,512,512,512.00,0.00,35271,35272
45275,5,278,1,102.40,13784.64,35271,35276
45276,1,512,512,512.00,0.00,35275,35276
45277,2,277,235,256.00,441.00,35275,35277
45278,1,512,512,512.00,0.00,35276,35277
45279,1,512,512,512.00,0.00,35276,35277
45280,3,177,167,170.67,20.22,35276,35279
45281,3,399,2,170.67,28048.22,35278,35281
45282,1,512,512,512.00,0.00,35280,35281
45283,1,512,512,512.00,0.00,35280,35281
45284,4,477,6,128.00,40618.50,35280,35284
45285,1,512,512,512.00,0.00,35283,35284
45286,3,399,23,170.67,26816.22,35283,35286
45287,1,512,512,512.00,0.00,35285,35286
45288,2,332,180,256.00,5776.00,35285,35287
45289,1,512,512,512.00,0.00,35286,35287
45290,1,512,512,512.00,0.00,35286,35287
45291,1,512,512,512.00,0.00,35286,35287
45292,1,512,512,512.00,0.00,35286,35287
45293,7,279,1,73.14,8344.12,35286,35293
45294,1,512,512,512.00,0.00,35292,35293
45295,1,512,512,512.00,0.00,35292,35293
45296,1,512,512,512.00,0.00,35292,35293
45297,1,512,512,512.00,0.00,35292,35293
45298,5,484,1,102.40,36422.64,35292,35297
45299,3,266,16,170.67,12176.89,35296,35299
45300,2,436,76,256.00,32400.00,35298,35300
45301,1,512,512,512.00,0.00,35299,35300
45302,5,338,4,102.40,17496.64,35299,35304
45303,1,512,512,512.00,0.00,35303,35304
45304,1,512,512,512.00,0.00,35303,35304
45305,2,285,227,256.00,841.00,35303,35305
45306,4,202,8,128.00,6338.00,35304,35308
45307,1,512,512,512.00,0.00,35307,35308
45308,2,483,29,256.00,51529.00,35307,35309
45309,1,512,512,512.00,0.00,35308,35309
45310,1,512,512,512.00,0.00,35308,35309
45311,1,512,512,512.00,0.00,35308,35309
45312,1,512,512,512.00,0.00,35308,35309
45313,1,512,512,512.00,0.00,35308,35309
45314,1,512,512,512.00,0.00,35308,35309
45315,1,512,512,512.00,0.00,35308,35309
45316,1,512,512,512.00,0.00,35308,35309
45317,1,512,512,512.00,0.00,35308,35309
45318,1,512,512,512.00,0.00,35308,35309
45319,2,367,145,256.00,12321.00,35308,35310
45320,1,512,512,512.00,0.00,35309,35310
45321,2,313,199,256.00,3249.00,35309,35311
45322,2,414,98,256.00,24964.00,35310,35312
45323,1,512,512,512.00,0.00,35311,35312
45324,2,337,175,256.00,6561.00,35311,35313
45325,3,340,70,170.67,14507.56,35312,35315
45326,1,512,512,512.00,0.00,35314,35315
45327,1,512,512,512.00,0.00,35314,35315
45328,1,512,512,512.00,0.00,35314,35315
45329,2,482,30,256.00,51076.00,35314,35316
45330,1,512,512,512.00,0.00,35315,35316
45331,3,491,1,170.67,51366.89,35315,35318
45332,1,512,512,512.00,0.00,35317,35318
45333,1,512,512,512.00,0.00,35317,35318
45334,1,512,512,512.00,0.00,35317,35318
45335,1,512,512,512.00,0.00,35317,35318
45336,2,420,92,256.00,26896.00,35317,35319
45337,3,269,101,170.67,5114.89,35318,35321
45338,1,512,512,512.00,0.00,35320,35321
45339,1,512,512,512.00,0.00,35320,35321
45340,1,512,512,512.00,0.00,35320,35321
45341,2,434,78,256.00,31684.00,35320,35322
45342,1,512,512,512.00,0.00,35321,35322
45343,1,512,512,512.00,0.00,35321,35322
45344,1,512,512,512.00,0.00,35321,35322
45345,1,512,512,512.00,0.00,35321,35322
45346,2,497,15,256.00,58081.00,35321,35323
45347,1,512,512,512.00,0.00,35322,35323
45348,1,512,512,512.00,0.00,35322,35323
45349,1,512,512,512.00,0.00,35322,35323
45350,1,512,512,512.00,0.00,35322,35323
45351,4,404,4,128.00,25920.50,35322,35326
45352,1,512,512,512.00,0.00,35325,35326
45353,2,274,238,256.00,324.00,35325,35327
45354,2,260,252,256.00,16.00,35326,35328
45355,2,337,175,256.00,6561.00,35327,35329
45356,1,512,512,512.00,0.00,35328,35329
45357,3,332,2,170.67,18176.89,35328,35331
45358,1,512,512,512.00,0.00,35330,35331
45359,1,512,512,512.00,0.00,35330,35331
45360,3,347,11,170.67,18954.89,35330,35333
45361,8,119,2,64.00,2023.75,35332,35340
45362,3,495,1,170.67,52633.56,35339,35342
45363,1,512,512,512.00,0.00,35341,35342
45364,1,512,512,512.00,0.00,35341,35342
45365,4,390,1,128.00,24902.50,35341,35345
45366,1,512,512,512.00,0.00,35344,35345
45367,1,512,512,512.00,0.00,35344,35345
45368,1,512,512,512.00,0.00,35344,35345
45369,1,512,512,512.00,0.00,35344,35345
45370,1,512,512,512.00,0.00,35344,35345
45371,1,512,512,512.00,0.00,35344,35345
45372,3,186,141,170.67,440.22,35344,35347
45373,1,512,512,512.00,0.00,35346,35347
45374,1,512,512,512.00,0.00,35346,35347
45375,1,512,512,512.00,0.00,35346,35347
45376,2,269,243,256.00,169.00,35346,35348
45377,3,363,14,170.67,20936.22,35347,35350
45378,1,512,512,512.00,0.00,35349,35350
45379,1,512,512,512.00,0.00,35349,35350
45380,1,512,512,512.00,0.00,35349,35350
45381,3,329,45,170.67,13976.22,35349,35352
45382,1,512,512,512.00,0.00,35351,35352
45383,1,512,512,512.00,0.00,35351,35352
45384,1,512,512,512.00,0.00,35351,35352
45385,3,445,3,170.67,38249.56,35351,35354
45386,1,512,512,512.00,0.00,35353,35354
45387,1,512,512,512.00,0.00,35353,35354
45388,2,259,253,256.00,9.00,35353,35355
45389,1,512,512,512.00,0.00,35354,35355
45390,1,512,512,512.00,0.00,35354,35355
45391,2,354,158,256.00,9604.00,35354,35356
45392,6,182,14,85.33,3683.22,35355,35361
45393,1,512,512,512.00,0.00,35360,35361
45394,3,441,15,170.67,36820.22,35360,35363
45395,3,490,4,170.67,51019.56,35362,35365
45396,3,396,22,170.67,26251.56,35364,35367
45397,5,285,1,102.40,15102.24,35366,35371
45398,1,512,512,512.00,0.00,35370,35371
45399,1,512,512,512.00,0.00,35370,35371
45400,2,283,229,256.00,729.00,35370,35372
45401,1,512,512,512.00,0.00,35371,35372
45402,1,512,512,512.00,0.00,35371,35372
45403,1,512,512,512.00,0.00,35371,35372
45404,1,512,512,512.00,0.00,35371,35372
45405,1,512,512,512.00,0.00,35371,35372
45406,1,512,512,512.00,0.00,35371,35372
45407,1,512,512,512.00,0.00,35371,35372
45408,1,512,512,512.00,0.00,35371,35372
45409,2,398,114,256.00,20164.00,35371,35373
45410,2,353,159,256.00,9409.00,35372,35374
45411,1,512,512,512.00,0.00,35373,35374
45412,1,512,512,512.00,0.00,35373,35374
45413,1,512,512,512.00,0.00,35373,35374
45414,2,484,28,256.00,51984.00,35373,35375
45415,1,512,512,512.00,0.00,35374,35375
45416,1,512,512,512.00,0.00,35374,35375
45417,3,290,47,170.67,9850.89,35374,35377
45418,2,495,17,256.00,57121.00,35376,35378
45419,3,355,77,170.67,16990.89,35377,35380
45420,1,512,512,512.00,0.00,35379,35380
45421,1,512,512,512.00,0.00,35379,35380
45422,2,335,177,256.00,6241.00,35379,35381
45423,1,512,512,512.00,0.00,35380,35381
45424,1,512,512,512.00,0.00,35380,35381
45425,5,293,1,102.40,10980.64,35380,35385
45426,3,243,89,170.67,3996.22,35384,35387
45427,3,255,62,170.67,6504.22,35386,35389
45428,1,512,512,512.00,0.00,35388,35389
45429,1,512,512,512.00,0.00,35388,35389
45430,1,512,512,512.00,0.00,35388,35389
45431,2,301,211,256.00,2025.00,35388,35390
45432,2,327,185,256.00,5041.00,35389,35391
45433,1,512,512,512.00,0.00,35390,35391
45434,3,228,91,170.67,3377.56,35390,35393
45435,6,393,1,85.33,19069.89,35392,35398
45436,3,417,12,170.67,31180.22,35397,35400
45437,1,512,512,512.00,0.00,35399,35400
45438,1,512,512,512.00,0.00,35399,35400
45439,1,512,512,512.00,0.00,35399,35400
45440,2,450,62,256.00,37636.00,35399,35401
45441,2,291,221,256.00,1225.00,35400,35402
45442,1,512,512,512.00,0.00,35401,35402
45443,1,512,512,512.00,0.00,35401,35402
45444,1,512,512,512.00,0.00,35401,35402
45445,2,454,58,256.00,39204.00,35401,35403
45446,1,512,512,512.00,0.00,35402,35403
45447,6,245,1,85.33,6211.56,35402,35408
45448,1,512,512,512.00,0.00,35407,35408
45449,1,512,512,512.00,0.00,35407,35408
45450,1,512,512,512.00,0.00,35407,35408
45451,1,512,512,512.00,0.00,35407,35408
45452,1,512,512,512.00,0.00,35407,35408
45453,1,512,512,512.00,0.00,35407,35408
45454,8,213,3,64.00,5646.75,35407,35415
45455,2,365,147,256.00,11881.00,35414,35416
45456,1,512,512,512.00,0.00,35415,35416
45457,1,512,512,512.00,0.00,35415,35416
45458,1,512,512,512.00,0.00,35415,35416
45459,2,425,87,256.00,28561.00,35415,35417
45460,1,512,512,512.00,0.00,35416,35417
45461,1,512,512,512.00,0.00,35416,35417
45462,1,512,512,512.00,0.00,35416,35417
45463,1,512,512,512.00,0.00,35416,35417
45464,2,363,149,256.00,11449.00,35416,35418
45465,1,512,512,512.00,0.00,35417,35418
45466,2,261,251,256.00,25.00,35417,35419
45467,4,493,3,128.00,44417.00,35418,35422
45468,1,512,512,512.00,0.00,35421,35422
45469,5,324,1,102.40,13715.44,35421,35426
45470,2,490,22,256.00,54756.00,35425,35427
45471,1,512,512,512.00,0.00,35426,35427
45472,3,416,25,170.67,30446.89,35426,35429
45473,4,419,1,128.00,29532.50,35428,35432
45474,2,281,231,256.00,625.00,35431,35433
45475,3,502,5,170.67,54890.89,35432,35435
45476,1,512,512,512.00,0.00,35434,35435
45477,3,316,24,170.67,14211.56,35434,35437
45478,5,342,1,102.40,16260.24,35436,35441
45479,4,284,1,128.00,10224.50,35440,35444
45480,2,448,64,256.00,36864.00,35443,35445
45481,2,463,49,256.00,42849.00,35444,35446
45482,2,323,189,256.00,4489.00,35445,35447
45483,1,512,512,512.00,0.00,35446,35447
45484,1,512,512,512.00,0.00,35446,35447
45485,4,229,33,128.00,4871.50,35446,35450
45486,1,512,512,512.00,0.00,35449,35450
45487,1,512,512,512.00,0.00,35449,35450
45488,1,512,512,512.00,0.00,35449,35450
45489,2,444,68,256.00,35344.00,35449,35451
45490,1,512,512,512.00,0.00,35450,35451
45491,1,512,512,512.00,0.00,35450,35451
45492,3,287,1,170.67,15054.89,35450,35453
45493,5,273,5,102.40,13303.04,35452,35457
45494,1,512,512,512.00,0.00,35456,35457
45495,2,311,201,256.00,3025.00,35456,35458
45496,4,301,12,128.00,13332.50,35457,35461
45497,5,275,1,102.40,10014.24,35460,35465
45498,2,358,154,256.00,10404.00,35464,35466
45499,1,512,512,512.00,0.00,35465,35466
45500,1,512,512,512.00,0.00,35465,35466
45501,3,383,16,170.67,24110.89,35465,35468
45502,6,296,1,85.33,14742.22,35467,35473
45503,1,512,512,512.00,0.00,35472,35473
45504,1,512,512,512.00,0.00,35472,35473
45505,3,281,39,170.67,9988.22,35472,35475
45506,7,212,2,73.14,6711.84,35474,35481
45507,1,512,512,512.00,0.00,35480,35481
45508,1,512,512,512.00,0.00,35480,35481
45509,4,351,3,128.00,18187.00,35480,35484
45510,1,512,512,512.00,0.00,35483,35484
45511,1,512,512,512.00,0.00,35483,35484
45512,1,512,512,512.00,0.00,35483,35484
45513,4,458,8,128.00,36450.00,35483,35487
45514,1,512,512,512.00,0.00,35486,35487
45515,1,512,512,512.00,0.00,35486,35487
45516,1,512,512,512.00,0.00,35486,35487
45517,1,512,512,512.00,0.00,35486,35487
45518,2,451,61,256.00,38025.00,35486,35488
45519,5,194,1,102.40,4807.44,35487,35492
45520,1,512,512,512.00,0.00,35491,35492
45521,2,346,166,256.00,8100.00,35491,35493
45522,3,351,63,170.67,16464.22,35492,35495
45523,3,280,33,170.67,10569.56,35494,35497
45524,1,512,512,512.00,0.00,35496,35497
45525,4,201,2,128.00,5707.50,35496,35500
45526,1,512,512,512.00,0.00,35499,35500
45527,1,512,512,512.00,0.00,35499,35500
45528,1,512,512,512.00,0.00,35499,35500
45529,1,512,512,512.00,0.00,35499,35500
45530,1,512,512,512.00,0.00,35499,35500
45531,2,364,148,256.00,11664.00,35499,35501
45532,1,512,512,512.00,0.00,35500,35501
45533,3,408,1,170.67,29897.56,35500,35503
45534,3,438,3,170.67,36504.22,35502,35505
45535,1,512,512,512.00,0.00,35504,35505
45536,1,512,512,512.00,0.00,35504,35505
45537,1,512,512,512.00,0.00,35504,35505
45538,1,512,512,512.00,0.00,35504,35505
45539,2,377,135,256.00,14641.00,35504,35506
45540,1,512,512,512.00,0.00,35505,35506
45541,1,512,512,512.00,0.00,35505,35506
45542,6,200,6,85.33,4971.22,35505,35511
45543,3,509,1,170.67,57234.89,35510,35513
45544,1,512,512,512.00,0.00,35512,35513
45545,4,308,30,128.00,11413.50,35512,35516
45546,2,300,212,256.00,1936.00,35515,35517
45547,2,482,30,256.00,51076.00,35516,35518
45548,3,332,67,170.67,13366.89,35517,35520
45549,2,321,191,256.00,4225.00,35519,35521
45550,3,399,53,170.67,26076.22,35520,35523
45551,2,386,126,256.00,16900.00,35522,35524
45552,1,512,512,512.00,0.00,35523,35524
45553,1,512,512,512.00,0.00,35523,35524
45554,1,512,512,512.00,0.00,35523,35524
45555,1,512,512,512.00,0.00,35523,35524
45556,1,512,512,512.00,0.00,35523,35524
45557,1,512,512,512.00,0.00,35523,35524
45558,3,381,1,170.67,24893.56,35523,35526
45559,1,512,512,512.00,0.00,35525,35526
45560,2,296,216,256.00,1600.00,35525,35527
45561,1,512,512,512.00,0.00,35526,35527
45562,2,305,207,256.00,2401.00,35526,35528
45563,7,204,1,73.14,7718.41,35527,35534
45564,2,490,22,256.00,54756.00,35533,35535
45565,1,512,512,512.00,0.00,35534,35535
45566,1,512,512,512.00,0.00,35534,35535
45567,2,295,217,256.00,1521.00,35534,35536
45568,1,512,512,512.00,0.00,35535,35536
45569,1,512,512,512.00,0.00,35535,35536
45570,1,512,512,512.00,0.00,35535,35536
45571,2,457,55,256.00,40401.00,35535,35537
45572,1,512,512,512.00,0.00,35536,35537
45573,5,160,34,102.40,2464.24,35536,35541
45574,1,512,512,512.00,0.00,35540,35541
45575,2,305,207,256.00,2401.00,35540,35542
45576,1,512,512,512.00,0.00,35541,35542
45577,1,512,512,512.00,0.00,35541,35542
45578,1,512,512,512.00,0.00,35541,35542
45579,3,502,3,170.67,54893.56,35541,35544
45580,1,512,512,512.00,0.00,35543,35544
45581,1,512,512,512.00,0.00,35543,35544
45582,4,334,2,128.00,18498.50,35543,35547
45583,1,512,512,512.00,0.00,35546,35547
45584,5,217,3,102.40,7265.04,35546,35551
45585,2,336,176,256.00,6400.00,35550,35552
45586,1,512,512,512.00,0.00,35551,35552
45587,1,512,512,512.00,0.00,35551,35552
45588,1,512,512,512.00,0.00,35551,35552
45589,3,380,11,170.67,23926.89,35551,35554
45590,3,273,16,170.67,12377.56,35553,35556
45591,3,422,30,170.67,31734.22,35555,35558
45592,2,369,143,256.00,12769.00,35557,35559
45593,1,512,512,512.00,0.00,35558,35559
45594,3,481,15,170.67,48153.56,35558,35561
45595,3,376,53,170.67,21230.89,35560,35563
45596,1,512,512,512.00,0.00,35562,35563
45597,1,512,512,512.00,0.00,35562,35563
45598,4,258,47,128.00,6693.50,35562,35566
45599,8,251,1,64.00,6850.25,35565,35573
45600,5,363,2,102.40,17782.64,35572,35577
45601,3,492,2,170.67,51670.22,35576,35579
45602,5,164,7,102.40,3628.24,35578,35583
45603,4,345,15,128.00,17829.00,35582,35586
45604,1,512,512,512.00,0.00,35585,35586
45605,1,512,512,512.00,0.00,35585,35586
45606,2,461,51,256.00,42025.00,35585,35587
45607,2,352,160,256.00,9216.00,35586,35588
45608,1,512,512,512.00,0.00,35587,35588
45609,3,411,4,170.67,30321.56,35587,35590
45610,1,512,512,512.00,0.00,35589,35590
45611,1,512,512,512.00,0.00,35589,35590
45612,2,385,127,256.00,16641.00,35589,35591
45613,4,408,2,128.00,27591.50,35590,35594
45614,1,512,512,512.00,0.00,35593,35594
45615,1,512,512,512.00,0.00,35593,35594
45616,1,512,512,512.00,0.00,35593,35594
45617,1,512,512,512.00,0.00,35593,35594
45618,7,136,3,73.14,2575.55,35593,35600
45619,2,381,131,256.00,15625.00,35599,35601
45620,1,512,512,512.00,0.00,35600,35601
45621,2,326,186,256.00,4900.00,35600,35602
45622,1,512,512,512.00,0.00,35601,35602
45623,1,512,512,512.00,0.00,35601,35602
45624,2,354,158,256.00,9604.00,35601,35603
45625,1,512,512,512.00,0.00,35602,35603
45626,1,512,512,512.00,0.00,35602,35603
45627,1,512,512,512.00,0.00,35602,35603
45628,2,287,225,256.00,961.00,35602,35604
45629,1,512,512,512.00,0.00,35603,35604
45630,1,512,512,512.00,0.00,35603,35604
45631,2,284,228,256.00,784.00,35603,35605
45632,1,512,512,512.00,0.00,35604,35605
45633,1,512,512,512.00,0.00,35604,35605
45634,1,512,512,512.00,0.00,35604,35605
45635,1,512,512,512.00,0.00,35604,35605
45636,1,512,512,512.00,0.00,35604,35605
45637,1,512,512,512.00,0.00,35604,35605
45638,3,441,1,170.67,37333.56,35604,35607
45639,7,304,1,73.14,9549.55,35606,35613
45640,1,512,512,512.00,0.00,35612,35613
45641,1,512,512,512.00,0.00,35612,35613
45642,1,512,512,512.00,0.00,35612,35613
45643,6,239,2,85.33,6264.22,35612,35618
45644,2,299,213,256.00,1849.00,35617,35619
45645,1,512,512,512.00,0.00,35618,35619
45646,2,324,188,256.00,4624.00,35618,35620
45647,1,512,512,512.00,0.00,35619,35620
45648,1,512,512,512.00,0.00,35619,35620
45649,1,512,512,512.00,0.00,35619,35620
45650,3,439,1,170.67,36841.56,35619,35622
45651,1,512,512,512.00,0.00,35621,35622
45652,1,512,512,512.00,0.00,35621,35622
45653,1,512,512,512.00,0.00,35621,35622
45654,1,512,512,512.00,0.00,35621,35622
45655,2,402,110,256.00,21316.00,35621,35623
45656,6,389,5,85.33,18650.22,35622,35628
45657,1,512,512,512.00,0.00,35627,35628
45658,1,512,512,512.00,0.00,35627,35628
45659,2,387,125,256.00,17161.00,35627,35629
45660,2,331,181,256.00,5625.00,35628,35630
45661,7,275,1,73.14,9601.55,35629,35636
45662,1,512,512,512.00,0.00,35635,35636
45663,5,226,11,102.40,7415.44,35635,35640
45664,2,318,194,256.00,3844.00,35639,35641
45665,1,512,512,512.00,0.00,35640,35641
45666,1,512,512,512.00,0.00,35640,35641
45667,4,258,7,128.00,12746.50,35640,35644
45668,2,483,29,256.00,51529.00,35643,35645
45669,4,380,2,128.00,23751.50,35644,35648
45670,1,512,512,512.00,0.00,35647,35648
45671,5,186,42,102.40,2545.04,35647,35652
45672,1,512,512,512.00,0.00,35651,35652
45673,3,252,53,170.67,7260.22,35651,35654
45674,2,344,168,256.00,7744.00,35653,35655
45675,1,512,512,512.00,0.00,35654,35655
45676,1,512,512,512.00,0.00,35654,35655
45677,1,512,512,512.00,0.00,35654,35655
45678,1,512,512,512.00,0.00,35654,35655
45679,2,391,121,256.00,18225.00,35654,35656
45680,2,341,171,256.00,7225.00,35655,35657
45681,3,492,4,170.67,51651.56,35656,35659
45682,1,512,512,512.00,0.00,35658,35659
45683,2,430,82,256.00,30276.00,35658,35660
45684,3,437,15,170.67,35804.22,35659,35662
45685,1,512,512,512.00,0.00,35661,35662
45686,1,512,512,512.00,0.00,35661,35662
45687,3,293,89,170.67,7762.89,35661,35664
45688,1,512,512,512.00,0.00,35663,35664
45689,2,383,129,256.00,16129.00,35663,35665
45690,1,512,512,512.00,0.00,35664,35665
45691,1,512,512,512.00,0.00,35664,35665
45692,1,512,512,512.00,0.00,35664,35665
45693,3,293,6,170.67,14624.22,35664,35667
45694,1,512,512,512.00,0.00,35666,35667
45695,3,303,71,170.67,9504.22,35666,35669
45696,2,313,199,256.00,3249.00,35668,35670
45697,1,512,512,512.00,0.00,35669,35670
45698,2,503,9,256.00,61009.00,35669,35671
45699,1,512,512,512.00,0.00,35670,35671
45700,1,512,512,512.00,0.00,35670,35671
45701,1,512,512,512.00,0.00,35670,35671
45702,1,512,512,512.00,0.00,35670,35671
45703,4,328,1,128.00,17779.50,35670,35674
45704,2,511,1,256.00,65025.00,35673,35675
45705,5,223,1,102.40,7558.24,35675,35680
45706,2,315,197,256.00,3481.00,35679,35681
45707,1,512,512,512.00,0.00,35680,35681
45708,7,420,1,73.14,20420.41,35680,35687
45709,3,288,1,170.67,15097.56,35686,35689
45710,1,512,512,512.00,0.00,35688,35689
45711,1,512,512,512.00,0.00,35688,35689
45712,1,512,512,512.00,0.00,35688,35689
45713,1,512,512,512.00,0.00,35688,35689
45714,3,431,21,170.67,34140.22,35688,35691
45715,4,322,6,128.00,13818.50,35690,35694
45716,1,512,512,512.00,0.00,35693,35694
45717,3,386,13,170.67,24850.89,35693,35696
45718,1,512,512,512.00,0.00,35695,35696
45719,3,267,1,170.67,14481.56,35695,35698
45720,3,238,83,170.67,4210.89,35697,35700
45721,2,506,6,256.00,62500.00,35699,35701
45722,1,512,512,512.00,0.00,35700,35701
45723,1,512,512,512.00,0.00,35700,35701
45724,3,421,1,170.67,32653.56,35700,35703
45725,1,512,512,512.00,0.00,35702,35703
45726,3,370,60,170.67,19947.56,35702,35705
45727,1,512,512,512.00,0.00,35704,35705
45728,1,512,512,512.00,0.00,35704,35705
45729,1,512,512,512.00,0.00,35704,35705
45730,1,512,512,512.00,0.00,35704,35705
45731,3,360,3,170.67,21476.22,35704,35707
45732,1,512,512,512.00,0.00,35706,35707
45733,1,512,512,512.00,0.00,35706,35707
45734,2,511,1,256.00,65025.00,35706,35708
45735,4,486,3,128.00,42769.50,35707,35711
45736,1,512,512,512.00,0.00,35710,35711
45737,1,512,512,512.00,0.00,35710,35711
45738,1,512,512,512.00,0.00,35710,35711
45739,1,512,512,512.00,0.00,35710,35711
45740,3,316,54,170.67,11851.56,35710,35713
45741,3,407,9,170.67,29188.22,35712,35715
45742,1,512,512,512.00,0.00,35714,35715
45743,1,512,512,512.00,0.00,35714,35715
45744,4,476,1,128.00,40504.50,35714,35718
45745,1,512,512,512.00,0.00,35717,35718
45746,1,512,512,512.00,0.00,35717,35718
45747,2,418,94,256.00,26244.00,35717,35719
45748,1,512,512,512.00,0.00,35718,35719
45749,1,512,512,512.00,0.00,35718,35719
45750,4,287,12,128.00,13075.50,35718,35722
45751,4,406,1,128.00,27149.50,35721,35725
45752,1,512,512,512.00,0.00,35724,35725
45753,1,512,512,512.00,0.00,35724,35725
45754,1,512,512,512.00,0.00,35724,35725
45755,1,512,512,512.00,0.00,35724,35725
45756,1,512,512,512.00,0.00,35724,35725
45757,1,512,512,512.00,0.00,35724,35725
45758,1,512,512,512.00,0.00,35724,35725
45759,4,268,1,128.00,11164.50,35724,35728
45760,1,512,512,512.00,0.00,35727,35728
45761,1,512,512,512.00,0.00,35727,35728
45762,1,512,512,512.00,0.00,35727,35728
45763,3,461,3,170.67,42484.22,35727,35730
45764,1,512,512,512.00,0.00,35729,35730
45765,1,512,512,512.00,0.00,35729,35730
45766,2,465,47,256.00,43681.00,35729,35731
45767,1,512,512,512.00,0.00,35730,35731
45768,1,512,512,512.00,0.00,35730,35731
45769,2,274,238,256.00,324.00,35730,35732
45770,1,512,512,512.00,0.00,35731,35732
45771,1,512,512,512.00,0.00,35731,35732
45772,1,512,512,512.00,0.00,35731,35732
45773,1,512,512,512.00,0.00,35731,35732
45774,1,512,512,512.00,0.00,35731,35732
45775,3,467,1,170.67,44214.89,35731,35734
45776,1,512,512,512.00,0.00,35733,35734
45777,1,512,512,512.00,0.00,35733,35734
45778,3,238,85,170.67,4069.56,35733,35736
45779,1,512,512,512.00,0.00,35735,35736
45780,1,512,512,512.00,0.00,35735,35736
45781,1,512,512,512.00,0.00,35735,35736
45782,1,512,512,512.00,0.00,35735,35736
45783,2,312,200,256.00,3136.00,35735,35737
45784,1,512,512,512.00,0.00,35736,35737
45785,1,512,512,512.00,0.00,35736,35737
45786,1,512,512,512.00,0.00,35736,35737
45787,2,376,136,256.00,14400.00,35736,35738
45788,1,512,512,512.00,0.00,35737,35738
45789,1,512,512,512.00,0.00,35737,35738
45790,3,501,5,170.67,54560.22,35737,35740
45791,10,187,1,51.20,3955.96,35739,35749
45792,1,512,512,512.00,0.00,35748,35749
45793,1,512,512,512.00,0.00,35748,35749
45794,1,512,512,512.00,0.00,35748,35749
45795,2,350,162,256.00,8836.00,35748,35750
45796,1,512,512,512.00,0.00,35749,35750
45797,3,402,1,170.67,28701.56,35749,35752
45798,1,512,512,512.00,0.00,35751,35752
45799,2,405,107,256.00,22201.00,35751,35753
45800,2,355,157,256.00,9801.00,35752,35754
45801,1,512,512,512.00,0.00,35753,35754
45802,1,512,512,512.00,0.00,35753,35754
45803,1,512,512,512.00,0.00,35753,35754
45804,4,212,18,128.00,5186.00,35753,35757
45805,2,384,128,256.00,16384.00,35756,35758
45806,3,488,1,170.67,50430.89,35758,35761
45807,2,473,39,256.00,47089.00,35760,35762
45808,1,512,512,512.00,0.00,35761,35762
45809,1,512,512,512.00,0.00,35761,35762
45810,1,512,512,512.00,0.00,35761,35762
45811,1,512,512,512.00,0.00,35761,35762
45812,1,512,512,512.00,0.00,35761,35762
45813,3,344,5,170.67,19182.89,35761,35764
45814,2,444,68,256.00,35344.00,35763,35765
45815,1,512,512,512.00,0.00,35764,35765
45816,2,272,240,256.00,256.00,35764,35766
45817,1,512,512,512.00,0.00,35765,35766
45818,1,512,512,512.00,0.00,35765,35766
45819,1,512,512,512.00,0.00,35765,35766
45820,1,512,512,512.00,0.00,35765,35766
45821,1,512,512,512.00,0.00,35765,35766
45822,1,512,512,512.00,0.00,35765,35766
45823,2,383,129,256.00,16129.00,35765,35767
45824,1,512,512,512.00,0.00,35766,35767
45825,1,512,512,512.00,0.00,35766,35767
45826,2,376,136,256.00,14400.00,35766,35768
45827,1,512,512,512.00,0.00,35767,35768
45828,1,512,512,512.00,0.00,35767,35768
45829,2,375,137,256.00,14161.00,35767,35769
45830,1,512,512,512.00,0.00,35768,35769
45831,1,512,512,512.00,0.00,35768,35769
45832,1,512,512,512.00,0.00,35768,35769
45833,2,338,174,256.00,6724.00,35768,35770
45834,1,512,512,512.00,0.00,35769,35770
45835,1,512,512,512.00,0.00,35769,35770
45836,2,375,137,256.00,14161.00,35769,35771
45837,1,512,512,512.00,0.00,35770,35771
45838,2,281,231,256.00,625.00,35770,35772
45839,2,327,185,256.00,5041.00,35771,35773
45840,1,512,512,512.00,0.00,35772,35773
45841,1,512,512,512.00,0.00,35772,35773
45842,1,512,512,512.00,0.00,35772,35773
45843,1,512,512,512.00,0.00,35772,35773
45844,2,256,256,256.00,0.00,35772,35774
45845,2,337,175,256.00,6561.00,35773,35775
45846,1,512,512,512.00,0.00,35774,35775
45847,1,512,512,512.00,0.00,35774,35775
45848,1,512,512,512.00,0.00,35774,35775
45849,1,512,512,512.00,0.00,35774,35775
45850,1,512,512,512.00,0.00,35774,35775
45851,2,423,89,256.00,27889.00,35774,35776
45852,4,337,2,128.00,17703.50,35775,35779
45853,1,512,512,512.00,0.00,35778,35779
45854,2,359,153,256.00,10609.00,35778,35780
45855,1,512,512,512.00,0.00,35779,35780
45856,1,512,512,512.00,0.00,35779,35780
45857,1,512,512,512.00,0.00,35779,35780
45858,1,512,512,512.00,0.00,35779,35780
45859,3,377,20,170.67,22790.89,35779,35782
45860,1,512,512,512.00,0.00,35781,35782
45861,2,274,238,256.00,324.00,35781,35783
45862,2,414,98,256.00,24964.00,35782,35784
45863,1,512,512,512.00,0.00,35783,35784
45864,1,512,512,512.00,0.00,35783,35784
45865,3,396,10,170.67,26923.56,35783,35786
45866,1,512,512,512.00,0.00,35785,35786
45867,2,415,97,256.00,25281.00,35785,35787
45868,1,512,512,512.00,0.00,35786,35787
45869,1,512,512,512.00,0.00,35786,35787
45870,3,273,1,170.67,14597.56,35786,35789
45871,1,512,512,512.00,0.00,35788,35789
45872,2,479,33,256.00,49729.00,35788,35790
45873,1,512,512,512.00,0.00,35789,35790
45874,2,478,34,256.00,49284.00,35789,35791
45875,2,288,224,256.00,1024.00,35790,35792
45876,5,241,3,102.40,11551.04,35791,35796
45877,1,512,512,512.00,0.00,35795,35796
45878,1,512,512,512.00,0.00,35795,35796
45879,1,512,512,512.00,0.00,35795,35796
45880,2,478,34,256.00,49284.00,35795,35797
45881,2,416,96,256.00,25600.00,35796,35798
45882,1,512,512,512.00,0.00,35797,35798
45883,1,512,512,512.00,0.00,35797,35798
45884,1,512,512,512.00,0.00,35797,35798
45885,1,512,512,512.00,0.00,35797,35798
45886,3,305,9,170.67,14976.22,35797,35800
45887,1,512,512,512.00,0.00,35799,35800
45888,1,512,512,512.00,0.00,35799,35800
45889,1,512,512,512.00,0.00,35799,35800
45890,6,236,30,85.33,5063.22,35799,35805
45891,2,500,12,256.00,59536.00,35804,35806
45892,1,512,512,512.00,0.00,35805,35806
45893,1,512,512,512.00,0.00,35805,35806
45894,1,512,512,512.00,0.00,35805,35806
45895,1,512,512,512.00,0.00,35805,35806
45896,3,384,1,170.67,25401.56,35805,35808
45897,1,512,512,512.00,0.00,35807,35808
45898,2,480,32,256.00,50176.00,35807,35809
45899,1,512,512,512.00,0.00,35808,35809
45900,1,512,512,512.00,0.00,35808,35809
45901,2,295,217,256.00,1521.00,35808,35810
45902,2,377,135,256.00,14641.00,35809,35811
45903,3,243,92,170.67,3820.22,35810,35813
45904,1,512,512,512.00,0.00,35812,35813
45905,1,512,512,512.00,0.00,35812,35813
45906,1,512,512,512.00,0.00,35812,35813
45907,4,228,1,128.00,7799.50,35812,35816
45908,4,331,18,128.00,14873.50,35815,35819
45909,4,189,44,128.00,3888.50,35818,35822
45910,3,418,32,170.67,30736.89,35821,35824
45911,3,287,3,170.67,14760.22,35823,35826
45912,2,331,181,256.00,5625.00,35825,35827
45913,1,512,512,512.00,0.00,35826,35827
45914,1,512,512,512.00,0.00,35826,35827
45915,1,512,512,512.00,0.00,35826,35827
45916,2,422,90,256.00,27556.00,35826,35828
45917,1,512,512,512.00,0.00,35827,35828
45918,1,512,512,512.00,0.00,35827,35828
45919,3,374,59,170.67,20738.89,35827,35830
45920,1,512,512,512.00,0.00,35829,35830
45921,1,512,512,512.00,0.00,35829,35830
45922,2,288,224,256.00,1024.00,35829,35831
45923,3,319,4,170.67,16705.56,35830,35833
45924,1,512,512,512.00,0.00,35832,35833
45925,1,512,512,512.00,0.00,35832,35833
45926,1,512,512,512.00,0.00,35832,35833
45927,1,512,512,512.00,0.00,35832,35833
45928,1,512,512,512.00,0.00,35832,35833
45929,1,512,512,512.00,0.00,35832,35833
45930,3,380,19,170.67,23382.89,35832,35835
45931,2,505,7,256.00,62001.00,35834,35836
45932,1,512,512,512.00,0.00,35835,35836
45933,1,512,512,512.00,0.00,35835,35836
45934,1,512,512,512.00,0.00,35835,35836
45935,1,512,512,512.00,0.00,35835,35836
45936,1,512,512,512.00,0.00,35835,35836
45937,3,397,19,170.67,26601.56,35835,35838
45938,1,512,512,512.00,0.00,35837,35838
45939,1,512,512,512.00,0.00,35837,35838
45940,1,512,512,512.00,0.00,35837,35838
45941,1,512,512,512.00,0.00,35837,35838
45942,1,512,512,512.00,0.00,35837,35838
45943,3,358,2,170.67,21296.89,35837,35840
45944,1,512,512,512.00,0.00,35839,35840
45945,1,512,512,512.00,0.00,35839,35840
45946,1,512,512,512.00,0.00,35839,35840
45947,1,512,512,512.00,0.00,35839,35840
45948,1,512,512,512.00,0.00,35839,35840
45949,2,460,52,256.00,41616.00,35839,35841
45950,2,439,73,256.00,33489.00,35840,35842
45951,2,488,24,256.00,53824.00,35841,35843
45952,4,240,3,128.00,9274.50,35842,35846
45953,1,512,512,512.00,0.00,35845,35846
45954,2,282,230,256.00,676.00,35845,35847
45955,3,375,1,170.67,23913.56,35846,35849
45956,1,512,512,512.00,0.00,35848,35849
45957,1,512,512,512.00,0.00,35848,35849
45958,2,418,94,256.00,26244.00,35848,35850
45959,1,512,512,512.00,0.00,35849,35850
45960,1,512,512,512.00,0.00,35849,35850
45961,1,512,512,512.00,0.00,35849,35850
45962,1,512,512,512.00,0.00,35849,35850
45963,1,512,512,512.00,0.00,35849,35850
45964,1,512,512,512.00,0.00,35849,35850
45965,1,512,512,512.00,0.00,35849,35850
45966,1,512,512,512.00,0.00,35849,35850
45967,3,296,75,170.67,8580.22,35849,35852
45968,1,512,512,512.00,0.00,35851,35852
45969,3,228,137,170.67,1660.22,35851,35854
45970,1,512,512,512.00,0.00,35853,35854
45971,1,512,512,512.00,0.00,35853,35854
45972,3,269,64,170.67,7038.89,35853,35856
45973,3,351,69,170.67,16348.22,35855,35858
45974,1,512,512,512.00,0.00,35857,35858
45975,1,512,512,512.00,0.00,35857,35858
45976,1,512,512,512.00,0.00,35857,35858
45977,1,512,512,512.00,0.00,35857,35858
45978,1,512,512,512.00,0.00,35857,35858
45979,3,289,15,170.67,13209.56,35857,35860
45980,2,393,119,256.00,18769.00,35859,35861
45981,3,325,53,170.67,13002.89,35860,35863
45982,6,351,7,85.33,14750.89,35862,35868
45983,1,512,512,512.00,0.00,35867,35868
45984,1,512,512,512.00,0.00,35867,35868
45985,1,512,512,512.00,0.00,35867,35868
45986,1,512,512,512.00,0.00,35867,35868
45987,1,512,512,512.00,0.00,35867,35868
45988,1,512,512,512.00,0.00,35867,35868
45989,3,446,18,170.67,38054.22,35867,35870
45990,2,478,34,256.00,49284.00,35869,35871
45991,4,441,4,128.00,32816.50,35870,35874
45992,2,399,113,256.00,20449.00,35873,35875
45993,2,489,23,256.00,54289.00,35874,35876
45994,1,512,512,512.00,0.00,35875,35876
45995,1,512,512,512.00,0.00,35875,35876
45996,1,512,512,512.00,0.00,35875,35876
45997,1,512,512,512.00,0.00,35875,35876
45998,1,512,512,512.00,0.00,35875,35876
45999,1,512,512,512.00,0.00,35875,35876
46000,3,364,70,170.67,18699.56,35875,35878
46001,1,512,512,512.00,0.00,35877,35878
46002,1,512,512,512.00,0.00,35877,35878
46003,3,472,2,170.67,45616.89,35877,35880
46004,1,512,512,512.00,0.00,35879,35880
46005,1,512,512,512.00,0.00,35879,35880
46006,3,280,60,170.67,8067.56,35879,35882
46007,3,300,74,170.67,9046.22,35881,35884
46008,1,512,512,512.00,0.00,35883,35884
46009,1,512,512,512.00,0.00,35883,35884
46010,1,512,512,512.00,0.00,35883,35884
46011,1,512,512,512.00,0.00,35883,35884
46012,1,512,512,512.00,0.00,35883,35884
46013,1,512,512,512.00,0.00,35883,35884
46014,1,512,512,512.00,0.00,35883,35884
46015,2,381,131,256.00,15625.00,35883,35885
46016,2,377,135,256.00,14641.00,35884,35886
46017,1,512,512,512.00,0.00,35885,35886
46018,2,443,69,256.00,34969.00,35885,35887
46019,1,512,512,512.00,0.00,35886,35887
46020,2,487,25,256.00,53361.00,35886,35888
46021,1,512,512,512.00,0.00,35887,35888
46022,5,257,9,102.40,7941.04,35887,35892
46023,1,512,512,512.00,0.00,35891,35892
46024,1,512,512,512.00,0.00,35891,35892
46025,1,512,512,512.00,0.00,35891,35892
46026,1,512,512,512.00,0.00,35891,35892
46027,1,512,512,512.00,0.00,35891,35892
46028,1,512,512,512.00,0.00,35891,35892
46029,1,512,512,512.00,0.00,35891,35892
46030,4,228,38,128.00,4562.00,35891,35895
46031,4,269,41,128.00,8631.50,35894,35898
46032,2,498,14,256.00,58564.00,35897,35899
46033,1,512,512,512.00,0.00,35898,35899
46034,1,512,512,512.00,0.00,35898,35899
46035,1,512,512,512.00,0.00,35898,35899
46036,1,512,512,512.00,0.00,35898,35899
46037,1,512,512,512.00,0.00,35898,35899
46038,1,512,512,512.00,0.00,35898,35899
46039,2,276,236,256.00,400.00,35898,35900
46040,1,512,512,512.00,0.00,35899,35900
46041,1,512,512,512.00,0.00,35899,35900
46042,1,512,512,512.00,0.00,35899,35900
46043,3,502,1,170.67,54901.56,35899,35902
46044,1,512,512,512.00,0.00,35901,35902
46045,2,312,200,256.00,3136.00,35901,35903
46046,1,512,512,512.00,0.00,35902,35903
46047,1,512,512,512.00,0.00,35902,35903
46048,2,421,91,256.00,27225.00,35902,35904
46049,1,512,512,512.00,0.00,35903,35904
46050,3,321,30,170.67,14160.22,35903,35906
46051,1,512,512,512.00,0.00,35905,35906
46052,1,512,512,512.00,0.00,35905,35906
46053,2,373,139,256.00,13689.00,35905,35907
46054,1,512,512,512.00,0.00,35906,35907
46055,3,297,107,170.67,7980.22,35906,35909
46056,2,401,111,256.00,21025.00,35908,35910
46057,2,482,30,256.00,51076.00,35909,35911
46058,1,512,512,512.00,0.00,35910,35911
46059,1,512,512,512.00,0.00,35910,35911
46060,1,512,512,512.00,0.00,35910,35911
46061,1,512,512,512.00,0.00,35910,35911
46062,1,512,512,512.00,0.00,35910,35911
46063,1,512,512,512.00,0.00,35910,35911
46064,1,512,512,512.00,0.00,35910,35911
46065,2,330,182,256.00,5476.00,35910,35912
46066,1,512,512,512.00,0.00,35911,35912
46067,2,478,34,256.00,49284.00,35911,35913
46068,1,512,512,512.00,0.00,35912,35913
46069,1,512,512,512.00,0.00,35912,35913
46070,1,512,512,512.00,0.00,35912,35913
46071,1,512,512,512.00,0.00,35912,35913
46072,3,298,18,170.67,13387.56,35912,35915
46073,1,512,512,512.00,0.00,35914,35915
46074,3,457,3,170.67,41393.56,35914,35917
46075,1,512,512,512.00,0.00,35916,35917
46076,1,512,512,512.00,0.00,35916,35917
46077,2,467,45,256.00,44521.00,35916,35918
46078,3,217,138,170.67,1133.56,35917,35920
46079,1,512,512,512.00,0.00,35919,35920
46080,1,512,512,512.00,0.00,35919,35920
46081,5,374,6,102.40,18990.64,35919,35924
46082,2,494,18,256.00,56644.00,35923,35925
46083,1,512,512,512.00,0.00,35924,35925
46084,1,512,512,512.00,0.00,35924,35925
46085,1,512,512,512.00,0.00,35924,35925
46086,1,512,512,512.00,0.00,35924,35925
46087,1,512,512,512.00,0.00,35924,35925
46088,2,280,232,256.00,576.00,35924,35926
46089,3,265,66,170.67,6653.56,35925,35928
46090,1,512,512,512.00,0.00,35927,35928
46091,2,448,64,256.00,36864.00,35927,35929
46092,3,441,6,170.67,37120.22,35928,35931
46093,1,512,512,512.00,0.00,35930,35931
46094,2,392,120,256.00,18496.00,35930,35932
46095,2,462,50,256.00,42436.00,35931,35933
46096,1,512,512,512.00,0.00,35932,35933
46097,5,282,6,102.40,9369.04,35932,35937
46098,1,512,512,512.00,0.00,35936,35937
46099,1,512,512,512.00,0.00,35936,35937
46100,2,449,63,256.00,37249.00,35936,35938
46101,1,512,512,512.00,0.00,35937,35938
46102,1,512,512,512.00,0.00,35937,35938
46103,4,197,68,128.00,2191.50,35937,35941
46104,1,512,512,512.00,0.00,35940,35941
46105,1,512,512,512.00,0.00,35940,35941
46106,1,512,512,512.00,0.00,35940,35941
46107,1,512,512,512.00,0.00,35940,35941
46108,1,512,512,512.00,0.00,35940,35941
46109,1,512,512,512.00,0.00,35940,35941
46110,1,512,512,512.00,0.00,35940,35941
46111,3,482,6,170.67,48518.22,35940,35943
46112,2,397,115,256.00,19881.00,35942,35944
46113,4,294,43,128.00,10418.50,35943,35947
46114,1,512,512,512.00,0.00,35946,35947
46115,1,512,512,512.00,0.00,35946,35947
46116,1,512,512,512.00,0.00,35946,35947
46117,2,416,96,256.00,25600.00,35946,35948
46118,2,404,108,256.00,21904.00,35947,35949
46119,3,386,7,170.67,25274.89,35948,35951
46120,1,512,512,512.00,0.00,35950,35951
46121,1,512,512,512.00,0.00,35950,35951
46122,1,512,512,512.00,0.00,35950,35951
46123,1,512,512,512.00,0.00,35950,35951
46124,1,512,512,512.00,0.00,35950,35951
46125,2,383,129,256.00,16129.00,35950,35952
46126,1,512,512,512.00,0.00,35951,35952
46127,1,512,512,512.00,0.00,35951,35952
46128,2,502,10,256.00,60516.00,35951,35953
46129,1,512,512,512.00,0.00,35952,35953
46130,2,284,228,256.00,784.00,35952,35954
46131,1,512,512,512.00,0.00,35953,35954
46132,6,157,2,85.33,3174.22,35953,35959
46133,2,497,15,256.00,58081.00,35958,35960
46134,1,512,512,512.00,0.00,35959,35960
46135,1,512,512,512.00,0.00,35959,35960
46136,3,330,3,170.67,17856.22,35959,35962
46137,8,130,23,64.00,1417.50,35961,35969
46138,2,475,37,256.00,47961.00,35968,35970
46139,1,512,512,512.00,0.00,35969,35970
46140,1,512,512,512.00,0.00,35969,35970
46141,3,264,19,170.67,11705.56,35969,35972
46142,2,296,216,256.00,1600.00,35971,35973
46143,1,512,512,512.00,0.00,35972,35973
46144,1,512,512,512.00,0.00,35972,35973
46145,1,512,512,512.00,0.00,35972,35973
46146,2,375,137,256.00,14161.00,35972,35974
46147,1,512,512,512.00,0.00,35973,35974
46148,6,196,2,85.33,7003.89,35973,35979
46149,1,512,512,512.00,0.00,35978,35979
46150,1,512,512,512.00,0.00,35978,35979
46151,3,279,75,170.67,7016.22,35978,35981
46152,3,334,2,170.67,18384.89,35980,35983
46153,2,496,16,256.00,57600.00,35982,35984
46154,2,284,228,256.00,784.00,35983,35985
46155,1,512,512,512.00,0.00,35984,35985
46156,3,354,39,170.67,17872.22,35984,35987
46157,5,214,9,102.40,8485.44,35986,35991
46158,3,310,51,170.67,11373.56,35990,35993
46159,1,512,512,512.00,0.00,35992,35993
46160,1,512,512,512.00,0.00,35992,35993
46161,2,440,72,256.00,33856.00,35992,35994
46162,1,512,512,512.00,0.00,35993,35994
46163,5,203,20,102.40,3970.64,35993,35998
46164,2,464,48,256.00,43264.00,35997,35999
46165,1,512,512,512.00,0.00,35998,35999
46166,4,345,27,128.00,16689.00,35998,36002
46167,1,512,512,512.00,0.00,36001,36002
46168,1,512,512,512.00,0.00,36001,36002
46169,1,512,512,512.00,0.00,36001,36002
46170,2,511,1,256.00,65025.00,36001,36003
46171,1,512,512,512.00,0.00,36002,36003
46172,1,512,512,512.00,0.00,36002,36003
46173,1,512,512,512.00,0.00,36002,36003
46174,3,263,46,170.67,8370.89,36002,36005
46175,1,512,512,512.00,0.00,36004,36005
46176,1,512,512,512.00,0.00,36004,36005
46177,1,512,512,512.00,0.00,36004,36005
46178,3,466,3,170.67,43877.56,36004,36007
46179,2,482,30,256.00,51076.00,36006,36008
46180,1,512,512,512.00,0.00,36007,36008
46181,5,154,11,102.40,2706.64,36007,36012
46182,2,303,209,256.00,2209.00,36011,36013
46183,1,512,512,512.00,0.00,36012,36013
46184,1,512,512,512.00,0.00,36012,36013
46185,2,259,253,256.00,9.00,36012,36014
46186,4,244,1,128.00,11689.50,36013,36017
46187,1,512,512,512.00,0.00,36016,36017
46188,1,512,512,512.00,0.00,36016,36017
46189,2,341,171,256.00,7225.00,36016,36018
46190,5,425,1,102.40,26318.24,36017,36022
46191,4,332,4,128.00,15360.50,36021,36025
46192,2,396,116,256.00,19600.00,36024,36026
46193,1,512,512,512.00,0.00,36025,36026
46194,2,507,5,256.00,63001.00,36025,36027
46195,1,512,512,512.00,0.00,36026,36027
46196,1,512,512,512.00,0.00,36026,36027
46197,3,445,17,170.67,37810.89,36026,36029
46198,1,512,512,512.00,0.00,36028,36029
46199,1,512,512,512.00,0.00,36028,36029
46200,1,512,512,512.00,0.00,36028,36029
46201,1,512,512,512.00,0.00,36028,36029
46202,1,512,512,512.00,0.00,36028,36029
46203,1,512,512,512.00,0.00,36028,36029
46204,4,277,6,128.00,10958.50,36028,36032
46205,1,512,512,512.00,0.00,36031,36032
46206,1,512,512,512.00,0.00,36031,36032
46207,1,512,512,512.00,0.00,36031,36032
46208,1,512,512,512.00,0.00,36031,36032
46209,1,512,512,512.00,0.00,36031,36032
46210,1,512,512,512.00,0.00,36031,36032
46211,1,512,512,512.00,0.00,36031,36032
46212,1,512,512,512.00,0.00,36031,36032
46213,4,284,15,128.00,10453.50,36031,36035
46214,2,388,124,256.00,17424.00,36034,36036
46215,5,332,2,102.40,15237.04,36035,36040
46216,1,512,512,512.00,0.00,36039,36040
46217,2,394,118,256.00,19044.00,36039,36041
46218,1,512,512,512.00,0.00,36040,36041
46219,1,512,512,512.00,0.00,36040,36041
46220,4,299,16,128.00,11287.50,36040,36044
46221,3,461,2,170.67,42514.89,36043,36046
46222,1,512,512,512.00,0.00,36045,36046
46223,1,512,512,512.00,0.00,36045,36046
46224,2,314,198,256.00,3364.00,36045,36047
46225,1,512,512,512.00,0.00,36046,36047
46226,1,512,512,512.00,0.00,36046,36047
46227,3,295,5,170.67,14870.89,36046,36049
46228,2,475,37,256.00,47961.00,36048,36050
46229,1,512,512,512.00,0.00,36049,36050
46230,1,512,512,512.00,0.00,36049,36050
46231,2,310,202,256.00,2916.00,36049,36051
46232,1,512,512,512.00,0.00,36050,36051
46233,2,371,141,256.00,13225.00,36050,36052
46234,2,415,97,256.00,25281.00,36051,36053
46235,1,512,512,512.00,0.00,36052,36053
46236,5,284,19,102.40,8703.44,36052,36057
46237,3,296,25,170.67,12446.89,36056,36059
46238,1,512,512,512.00,0.00,36058,36059
46239,1,512,512,512.00,0.00,36058,36059
46240,1,512,512,512.00,0.00,36058,36059
46241,1,512,512,512.00,0.00,36058,36059
46242,1,512,512,512.00,0.00,36058,36059
46243,1,512,512,512.00,0.00,36058,36059
46244,1,512,512,512.00,0.00,36058,36059
46245,1,512,512,512.00,0.00,36058,36059
46246,2,398,114,256.00,20164.00,36058,36060
46247,1,512,512,512.00,0.00,36059,36060
46248,1,512,512,512.00,0.00,36059,36060
46249,2,446,66,256.00,36100.00,36059,36061
46250,7,348,2,73.14,13327.55,36060,36067
46251,4,314,2,128.00,15660.00,36066,36070
46252,1,512,512,512.00,0.00,36069,36070
46253,2,285,227,256.00,841.00,36069,36071
46254,1,512,512,512.00,0.00,36070,36071
46255,1,512,512,512.00,0.00,36070,36071
46256,2,395,117,256.00,19321.00,36070,36072
46257,4,358,6,128.00,20648.50,36071,36075
46258,4,302,9,128.00,11542.50,36074,36078
46259,2,509,3,256.00,64009.00,36077,36079
46260,2,380,132,256.00,15376.00,36078,36080
46261,1,512,512,512.00,0.00,36079,36080
46262,1,512,512,512.00,0.00,36079,36080
46263,1,512,512,512.00,0.00,36080,36081
46264,4,489,4,128.00,43455.50,36080,36084
46265,1,512,512,512.00,0.00,36083,36084
46266,2,356,156,256.00,10000.00,36083,36085
46267,1,512,512,512.00,0.00,36084,36085
46268,1,512,512,512.00,0.00,36084,36085
46269,5,434,1,102.40,27933.84,36084,36089
46270,6,384,1,85.33,18328.89,36088,36094
46271,2,259,253,256.00,9.00,36093,36095
46272,1,512,512,512.00,0.00,36094,36095
46273,2,353,159,256.00,9409.00,36094,36096
46274,1,512,512,512.00,0.00,36095,36096
46275,6,225,1,85.33,6188.89,36095,36101
46276,2,471,41,256.00,46225.00,36100,36102
46277,6,286,1,85.33,10287.89,36101,36107
46278,1,512,512,512.00,0.00,36106,36107
46279,1,512,512,512.00,0.00,36106,36107
46280,1,512,512,512.00,0.00,36106,36107
46281,1,512,512,512.00,0.00,36106,36107
46282,1,512,512,512.00,0.00,36106,36107
46283,1,512,512,512.00,0.00,36106,36107
46284,1,512,512,512.00,0.00,36106,36107
46285,2,418,94,256.00,26244.00,36106,36108
46286,2,391,121,256.00,18225.00,36107,36109
46287,2,277,235,256.00,441.00,36108,36110
46288,1,512,512,512.00,0.00,36109,36110
46289,2,305,207,256.00,2401.00,36109,36111
46290,3,404,35,170.67,27462.89,36110,36113
46291,2,508,4,256.00,63504.00,36112,36114
46292,2,387,125,256.00,17161.00,36113,36115
46293,1,512,512,512.00,0.00,36114,36115
46294,1,512,512,512.00,0.00,36114,36115
46295,1,512,512,512.00,0.00,36114,36115
46296,1,512,512,512.00,0.00,36114,36115
46297,1,512,512,512.00,0.00,36114,36115
46298,1,512,512,512.00,0.00,36114,36115
46299,1,512,512,512.00,0.00,36114,36115
46300,1,512,512,512.00,0.00,36114,36115
46301,1,512,512,512.00,0.00,36114,36115
46302,1,512,512,512.00,0.00,36114,36115
46303,1,512,512,512.00,0.00,36114,36115
46304,3,370,2,170.67,23040.89,36114,36117
46305,3,340,23,170.67,16982.89,36116,36119
46306,4,300,29,128.00,10533.50,36118,36122
46307,1,512,512,512.00,0.00,36121,36122
46308,1,512,512,512.00,0.00,36121,36122
46309,9,347,2,56.89,11000.54,36121,36130
46310,1,512,512,512.00,0.00,36129,36130
46311,1,512,512,512.00,0.00,36129,36130
46312,4,272,19,128.00,9087.50,36129,36133
46313,1,512,512,512.00,0.00,36132,36133
46314,1,512,512,512.00,0.00,36132,36133
46315,1,512,512,512.00,0.00,36132,36133
46316,3,372,70,170.67,20267.56,36132,36135
46317,8,221,1,64.00,7250.75,36134,36142
46318,1,512,512,512.00,0.00,36141,36142
46319,2,493,19,256.00,56169.00,36141,36143
46320,1,512,512,512.00,0.00,36142,36143
46321,1,512,512,512.00,0.00,36142,36143
46322,3,339,5,170.67,18596.22,36142,36145
46323,4,275,7,128.00,14349.00,36144,36148
46324,1,512,512,512.00,0.00,36147,36148
46325,1,512,512,512.00,0.00,36147,36148
46326,9,240,1,56.89,6434.32,36147,36156
46327,2,401,111,256.00,21025.00,36155,36157
46328,5,436,5,102.40,27979.44,36156,36161
46329,2,352,160,256.00,9216.00,36160,36162
46330,2,295,217,256.00,1521.00,36161,36163
46331,1,512,512,512.00,0.00,36162,36163
46332,5,176,1,102.40,4889.84,36162,36167
46333,1,512,512,512.00,0.00,36166,36167
46334,1,512,512,512.00,0.00,36166,36167
46335,1,512,512,512.00,0.00,36166,36167
46336,4,354,16,128.00,17817.50,36166,36170
46337,1,512,512,512.00,0.00,36169,36170
46338,1,512,512,512.00,0.00,36169,36170
46339,2,463,49,256.00,42849.00,36169,36171
46340,1,512,512,512.00,0.00,36170,36171
46341,2,373,139,256.00,13689.00,36170,36172
46342,1,512,512,512.00,0.00,36171,36172
46343,1,512,512,512.00,0.00,36171,36172
46344,3,308,7,170.67,15446.89,36171,36174
46345,2,343,169,256.00,7569.00,36173,36175
46346,7,227,4,73.14,6370.98,36174,36181
46347,3,359,55,170.67,18042.89,36180,36183
46348,1,512,512,512.00,0.00,36182,36183
46349,2,257,255,256.00,1.00,36182,36184
46350,2,279,233,256.00,529.00,36183,36185
46351,1,512,512,512.00,0.00,36184,36185
46352,1,512,512,512.00,0.00,36184,36185
46353,1,512,512,512.00,0.00,36184,36185
46354,1,512,512,512.00,0.00,36184,36185
46355,1,512,512,512.00,0.00,36184,36185
46356,6,171,4,85.33,4086.89,36184,36190
46357,1,512,512,512.00,0.00,36189,36190
46358,1,512,512,512.00,0.00,36189,36190
46359,3,424,40,170.67,32099.56,36189,36192
46360,1,512,512,512.00,0.00,36191,36192
46361,1,512,512,512.00,0.00,36191,36192
46362,1,512,512,512.00,0.00,36191,36192
46363,1,512,512,512.00,0.00,36191,36192
46364,4,384,3,128.00,22540.50,36191,36195
46365,1,512,512,512.00,0.00,36194,36195
46366,1,512,512,512.00,0.00,36194,36195
46367,2,373,139,256.00,13689.00,36194,36196
46368,3,409,25,170.67,28869.56,36195,36198
46369,2,496,16,256.00,57600.00,36197,36199
46370,1,512,512,512.00,0.00,36198,36199
46371,1,512,512,512.00,0.00,36198,36199
46372,3,388,2,170.67,26016.89,36198,36201
46373,5,203,10,102.40,6345.84,36200,36205
46374,1,512,512,512.00,0.00,36204,36205
46375,1,512,512,512.00,0.00,36204,36205
46376,1,512,512,512.00,0.00,36204,36205
46377,2,315,197,256.00,3481.00,36204,36206
46378,4,308,24,128.00,11550.50,36205,36209
46379,1,512,512,512.00,0.00,36208,36209
46380,2,335,177,256.00,6241.00,36208,36210
46381,1,512,512,512.00,0.00,36209,36210
46382,1,512,512,512.00,0.00,36209,36210
46383,1,512,512,512.00,0.00,36209,36210
46384,5,259,1,102.40,7525.44,36209,36214
46385,1,512,512,512.00,0.00,36213,36214
46386,1,512,512,512.00,0.00,36213,36214
46387,1,512,512,512.00,0.00,36213,36214
46388,4,144,106,128.00,230.00,36213,36217
46389,1,512,512,512.00,0.00,36216,36217
46390,1,512,512,512.00,0.00,36216,36217
46391,1,512,512,512.00,0.00,36216,36217
46392,1,512,512,512.00,0.00,36216,36217
46393,5,327,11,102.40,15110.24,36216,36221
46394,1,512,512,512.00,0.00,36220,36221
46395,7,227,1,73.14,9050.69,36220,36227
46396,1,512,512,512.00,0.00,36226,36227
46397,1,512,512,512.00,0.00,36226,36227
46398,1,512,512,512.00,0.00,36226,36227
46399,4,399,4,128.00,25136.50,36226,36230
46400,1,512,512,512.00,0.00,36229,36230
46401,2,454,58,256.00,39204.00,36229,36231
46402,2,363,149,256.00,11449.00,36230,36232
46403,3,320,84,170.67,11246.22,36231,36234
46404,1,512,512,512.00,0.00,36233,36234
46405,1,512,512,512.00,0.00,36233,36234
46406,1,512,512,512.00,0.00,36233,36234
46407,2,402,110,256.00,21316.00,36233,36235
46408,1,512,512,512.00,0.00,36234,36235
46409,4,257,1,128.00,12425.00,36234,36238
46410,4,250,3,128.00,7928.50,36237,36241
46411,1,512,512,512.00,0.00,36240,36241
46412,2,285,227,256.00,841.00,36240,36242
46413,2,417,95,256.00,25921.00,36241,36243
46414,2,408,104,256.00,23104.00,36242,36244
46415,4,468,1,128.00,38813.50,36243,36247
46416,3,275,14,170.67,12722.89,36246,36249
46417,3,449,5,170.67,39202.89,36248,36251
46418,1,512,512,512.00,0.00,36250,36251
46419,1,512,512,512.00,0.00,36250,36251
46420,1,512,512,512.00,0.00,36250,36251
46421,1,512,512,512.00,0.00,36250,36251
46422,3,315,1,170.67,16753.56,36250,36253
46423,1,512,512,512.00,0.00,36252,36253
46424,2,322,190,256.00,4356.00,36252,36254
46425,1,512,512,512.00,0.00,36253,36254
46426,1,512,512,512.00,0.00,36253,36254
46427,1,512,512,512.00,0.00,36253,36254
46428,2,297,215,256.00,1681.00,36253,36255
46429,3,379,38,170.67,22242.89,36254,36257
46430,1,512,512,512.00,0.00,36256,36257
46431,3,468,1,170.67,44497.56,36256,36259
46432,1,512,512,512.00,0.00,36258,36259
46433,1,512,512,512.00,0.00,36258,36259
46434,1,512,512,512.00,0.00,36258,36259
46435,3,357,6,170.67,20768.22,36258,36261
46436,1,512,512,512.00,0.00,36260,36261
46437,1,512,512,512.00,0.00,36260,36261
46438,1,512,512,512.00,0.00,36260,36261
46439,3,337,3,170.67,18593.56,36260,36263
46440,1,512,512,512.00,0.00,36262,36263
46441,1,512,512,512.00,0.00,36262,36263
46442,1,512,512,512.00,0.00,36262,36263
46443,3,407,40,170.67,28030.89,36262,36265
46444,1,512,512,512.00,0.00,36264,36265
46445,1,512,512,512.00,0.00,36264,36265
46446,1,512,512,512.00,0.00,36264,36265
46447,1,512,512,512.00,0.00,36264,36265
46448,1,512,512,512.00,0.00,36264,36265
46449,3,430,18,170.67,33979.56,36264,36267
46450,3,282,1,170.67,14861.56,36266,36269
46451,1,512,512,512.00,0.00,36268,36269
46452,1,512,512,512.00,0.00,36268,36269
46453,4,196,2,128.00,5570.00,36268,36272
46454,1,512,512,512.00,0.00,36271,36272
46455,1,512,512,512.00,0.00,36271,36272
46456,1,512,512,512.00,0.00,36271,36272
46457,1,512,512,512.00,0.00,36271,36272
46458,2,297,215,256.00,1681.00,36271,36273
46459,4,322,11,128.00,14607.50,36272,36276
46460,3,260,1,170.67,14406.89,36275,36278
46461,1,512,512,512.00,0.00,36277,36278
46462,1,512,512,512.00,0.00,36277,36278
46463,1,512,512,512.00,0.00,36277,36278
46464,1,512,512,512.00,0.00,36277,36278
46465,1,512,512,512.00,0.00,36277,36278
46466,1,512,512,512.00,0.00,36277,36278
46467,5,254,1,102.40,8943.44,36277,36282
46468,3,458,18,170.67,41334.22,36281,36284
46469,2,314,198,256.00,3364.00,36283,36285
46470,1,512,512,512.00,0.00,36284,36285
46471,1,512,512,512.00,0.00,36284,36285
46472,4,333,2,128.00,18825.50,36284,36288
46473,2,346,166,256.00,8100.00,36287,36289
46474,2,297,215,256.00,1681.00,36288,36290
46475,3,378,51,170.67,21664.22,36289,36292
46476,1,512,512,512.00,0.00,36291,36292
46477,2,346,166,256.00,8100.00,36291,36293
46478,1,512,512,512.00,0.00,36292,36293
46479,1,512,512,512.00,0.00,36292,36293
46480,1,512,512,512.00,0.00,36292,36293
46481,3,299,27,170.67,12448.22,36292,36295
46482,7,332,1,73.14,11803.84,36294,36301
46483,1,512,512,512.00,0.00,36300,36301
46484,2,448,64,256.00,36864.00,36300,36302
46485,3,278,83,170.67,6530.89,36301,36304
46486,1,512,512,512.00,0.00,36303,36304
46487,1,512,512,512.00,0.00,36303,36304
46488,1,512,512,512.00,0.00,36303,36304
46489,1,512,512,512.00,0.00,36303,36304
46490,2,311,201,256.00,3025.00,36303,36305
46491,1,512,512,512.00,0.00,36304,36305
46492,1,512,512,512.00,0.00,36304,36305
46493,2,320,192,256.00,4096.00,36304,36306
46494,1,512,512,512.00,0.00,36305,36306
46495,1,512,512,512.00,0.00,36305,36306
46496,3,471,3,170.67,45304.22,36305,36308
46497,1,512,512,512.00,0.00,36307,36308
46498,3,293,28,170.67,11910.89,36307,36310
46499,1,512,512,512.00,0.00,36309,36310
46500,4,393,27,128.00,23649.00,36309,36313
46501,1,512,512,512.00,0.00,36312,36313
46502,1,512,512,512.00,0.00,36312,36313
46503,1,512,512,512.00,0.00,36312,36313
46504,1,512,512,512.00,0.00,36312,36313
46505,1,512,512,512.00,0.00,36312,36313
46506,1,512,512,512.00,0.00,36312,36313
46507,1,512,512,512.00,0.00,36312,36313
46508,1,512,512,512.00,0.00,36312,36313
46509,1,512,512,512.00,0.00,36312,36313
46510,1,512,512,512.00,0.00,36312,36313
46511,5,277,1,102.40,15625.44,36312,36317
46512,2,296,216,256.00,1600.00,36316,36318
46513,1,512,512,512.00,0.00,36317,36318
46514,1,512,512,512.00,0.00,36317,36318
46515,5,379,6,102.40,19731.44,36317,36322
46516,1,512,512,512.00,0.00,36321,36322
46517,2,506,6,256.00,62500.00,36321,36323
46518,3,484,9,170.67,49105.56,36322,36325
46519,2,477,35,256.00,48841.00,36324,36326
46520,1,512,512,512.00,0.00,36325,36326
46521,1,512,512,512.00,0.00,36325,36326
46522,6,174,18,85.33,3239.22,36325,36331
46523,3,347,17,170.67,18406.89,36330,36333
46524,2,404,108,256.00,21904.00,36332,36334
46525,3,405,2,170.67,29224.22,36333,36336
46526,1,512,512,512.00,0.00,36335,36336
46527,1,512,512,512.00,0.00,36335,36336
46528,2,453,59,256.00,38809.00,36335,36337
46529,1,512,512,512.00,0.00,36336,36337
46530,2,387,125,256.00,17161.00,36336,36338
46531,5,205,22,102.40,3661.44,36337,36342
46532,7,235,5,73.14,6400.12,36341,36348
46533,1,512,512,512.00,0.00,36347,36348
46534,1,512,512,512.00,0.00,36347,36348
46535,1,512,512,512.00,0.00,36347,36348
46536,1,512,512,512.00,0.00,36347,36348
46537,3,444,11,170.67,37708.22,36347,36350
46538,5,235,36,102.40,6030.24,36349,36354
46539,1,512,512,512.00,0.00,36353,36354
46540,2,507,5,256.00,63001.00,36353,36355
46541,1,512,512,512.00,0.00,36354,36355
46542,2,328,184,256.00,5184.00,36354,36356
46543,1,512,512,512.00,0.00,36355,36356
46544,1,512,512,512.00,0.00,36355,36356
46545,1,512,512,512.00,0.00,36355,36356
46546,2,347,165,256.00,8281.00,36355,36357
46547,1,512,512,512.00,0.00,36356,36357
46548,2,344,168,256.00,7744.00,36356,36358
46549,1,512,512,512.00,0.00,36357,36358
46550,1,512,512,512.00,0.00,36357,36358
46551,3,495,6,170.67,52600.22,36357,36360
46552,2,343,169,256.00,7569.00,36359,36361
46553,1,512,512,512.00,0.00,36360,36361
46554,3,398,2,170.67,27856.89,36360,36363
46555,4,493,3,128.00,44413.00,36362,36366
46556,1,512,512,512.00,0.00,36365,36366
46557,3,299,1,170.67,15654.89,36365,36368
46558,1,512,512,512.00,0.00,36367,36368
46559,1,512,512,512.00,0.00,36367,36368
46560,2,282,230,256.00,676.00,36367,36369
46561,2,278,234,256.00,484.00,36368,36370
46562,1,512,512,512.00,0.00,36369,36370
46563,1,512,512,512.00,0.00,36369,36370
46564,1,512,512,512.00,0.00,36369,36370
46565,2,449,63,256.00,37249.00,36369,36371
46566,1,512,512,512.00,0.00,36370,36371
46567,1,512,512,512.00,0.00,36370,36371
46568,1,512,512,512.00,0.00,36370,36371
46569,2,480,32,256.00,50176.00,36370,36372
46570,1,512,512,512.00,0.00,36371,36372
46571,1,512,512,512.00,0.00,36371,36372
46572,1,512,512,512.00,0.00,36371,36372
46573,1,512,512,512.00,0.00,36371,36372
46574,1,512,512,512.00,0.00,36371,36372
46575,1,512,512,512.00,0.00,36371,36372
46576,1,512,512,512.00,0.00,36371,36372
46577,1,512,512,512.00,0.00,36371,36372
46578,2,383,129,256.00,16129.00,36371,36373
46579,1,512,512,512.00,0.00,36372,36373
46580,1,512,512,512.00,0.00,36372,36373
46581,1,512,512,512.00,0.00,36372,36373
46582,1,512,512,512.00,0.00,36372,36373
46583,2,482,30,256.00,51076.00,36372,36374
46584,2,373,139,256.00,13689.00,36373,36375
46585,3,232,123,170.67,2073.56,36374,36377
46586,1,512,512,512.00,0.00,36376,36377
46587,1,512,512,512.00,0.00,36376,36377
46588,1,512,512,512.00,0.00,36376,36377
46589,1,512,512,512.00,0.00,36376,36377
46590,1,512,512,512.00,0.00,36376,36377
46591,1,512,512,512.00,0.00,36376,36377
46592,3,300,78,170.67,8886.22,36376,36379
46593,4,277,4,128.00,9725.50,36378,36382
46594,1,512,512,512.00,0.00,36381,36382
46595,1,512,512,512.00,0.00,36381,36382
46596,2,344,168,256.00,7744.00,36381,36383
46597,2,346,166,256.00,8100.00,36382,36384
46598,4,321,16,128.00,13289.50,36383,36387
46599,1,512,512,512.00,0.00,36386,36387
46600,1,512,512,512.00,0.00,36386,36387
46601,4,383,7,128.00,22193.00,36386,36390
46602,5,439,1,102.40,28559.44,36389,36394
46603,4,235,37,128.00,7414.50,36393,36397
46604,1,512,512,512.00,0.00,36396,36397
46605,3,481,4,170.67,48241.56,36396,36399
46606,2,379,133,256.00,15129.00,36398,36400
46607,2,409,103,256.00,23409.00,36399,36401
46608,2,379,133,256.00,15129.00,36400,36402
46609,1,512,512,512.00,0.00,36401,36402
46610,3,412,38,170.67,29216.89,36401,36404
46611,3,343,18,170.67,17797.56,36403,36406
46612,3,455,15,170.67,40544.22,36405,36408
46613,1,512,512,512.00,0.00,36407,36408
46614,1,512,512,512.00,0.00,36407,36408
46615,1,512,512,512.00,0.00,36407,36408
46616,4,393,7,128.00,23840.50,36407,36411
46617,2,322,190,256.00,4356.00,36410,36412
46618,1,512,512,512.00,0.00,36411,36412
46619,1,512,512,512.00,0.00,36411,36412
46620,2,408,104,256.00,23104.00,36411,36413
46621,3,356,31,170.67,18646.89,36412,36415
46622,1,512,512,512.00,0.00,36414,36415
46623,1,512,512,512.00,0.00,36414,36415
46624,4,343,8,128.00,18562.50,36414,36418
46625,2,319,193,256.00,3969.00,36417,36419
46626,1,512,512,512.00,0.00,36418,36419
46627,2,264,248,256.00,64.00,36418,36420
46628,2,270,242,256.00,196.00,36419,36421
46629,1,512,512,512.00,0.00,36420,36421
46630,1,512,512,512.00,0.00,36420,36421
46631,2,411,101,256.00,24025.00,36420,36422
46632,1,512,512,512.00,0.00,36421,36422
46633,3,491,2,170.67,51354.89,36421,36424
46634,1,512,512,512.00,0.00,36423,36424
46635,1,512,512,512.00,0.00,36423,36424
46636,1,512,512,512.00,0.00,36423,36424
46637,1,512,512,512.00,0.00,36423,36424
46638,1,512,512,512.00,0.00,36423,36424
46639,1,512,512,512.00,0.00,36423,36424
46640,3,355,11,170.67,20026.89,36423,36426
46641,1,512,512,512.00,0.00,36425,36426
46642,1,512,512,512.00,0.00,36425,36426
46643,3,341,28,170.67,16710.89,36425,36428
46644,2,299,213,256.00,1849.00,36427,36429
46645,3,417,1,170.67,31781.56,36428,36431
46646,6,290,1,85.33,10292.56,36430,36436
46647,1,512,512,512.00,0.00,36435,36436
46648,2,405,107,256.00,22201.00,36435,36437
46649,4,306,28,128.00,11362.00,36436,36440
46650,2,510,2,256.00,64516.00,36439,36441
46651,1,512,512,512.00,0.00,36440,36441
46652,1,512,512,512.00,0.00,36440,36441
46653,1,512,512,512.00,0.00,36440,36441
46654,3,427,19,170.67,33221.56,36440,36443
46655,3,220,101,170.67,2566.89,36442,36445
46656,1,512,512,512.00,0.00,36444,36445
46657,1,512,512,512.00,0.00,36444,36445
46658,2,387,125,256.00,17161.00,36444,36446
46659,1,512,512,512.00,0.00,36445,36446
46660,1,512,512,512.00,0.00,36445,36446
46661,2,317,195,256.00,3721.00,36445,36447
46662,3,504,3,170.67,55556.22,36446,36449
46663,5,177,1,102.40,6571.44,36448,36453
46664,3,395,2,170.67,27290.89,36452,36455
46665,1,512,512,512.00,0.00,36454,36455
46666,2,472,40,256.00,46656.00,36454,36456
46667,5,383,4,102.40,20527.84,36455,36460
46668,4,168,76,128.00,1096.00,36459,36463
46669,1,512,512,512.00,0.00,36462,36463
46670,1,512,512,512.00,0.00,36462,36463
46671,2,452,60,256.00,38416.00,36462,36464
46672,8,216,1,64.00,4738.00,36463,36471
46673,1,512,512,512.00,0.00,36470,36471
46674,1,512,512,512.00,0.00,36470,36471
46675,1,512,512,512.00,0.00,36470,36471
46676,2,303,209,256.00,2209.00,36470,36472
46677,1,512,512,512.00,0.00,36471,36472
46678,2,310,202,256.00,2916.00,36471,36473
46679,1,512,512,512.00,0.00,36472,36473
46680,6,251,2,85.33,7343.22,36472,36478
46681,4,218,34,128.00,6686.00,36477,36481
46682,1,512,512,512.00,0.00,36480,36481
46683,4,450,7,128.00,34659.50,36480,36484
46684,1,512,512,512.00,0.00,36483,36484
46685,1,512,512,512.00,0.00,36483,36484
46686,4,412,1,128.00,28358.50,36483,36487
46687,1,512,512,512.00,0.00,36486,36487
46688,1,512,512,512.00,0.00,36486,36487
46689,2,296,216,256.00,1600.00,36486,36488
46690,1,512,512,512.00,0.00,36487,36488
46691,1,512,512,512.00,0.00,36487,36488
46692,1,512,512,512.00,0.00,36487,36488
46693,1,512,512,512.00,0.00,36487,36488
46694,1,512,512,512.00,0.00,36487,36488
46695,2,508,4,256.00,63504.00,36487,36489
46696,8,315,1,64.00,10018.00,36488,36496
46697,1,512,512,512.00,0.00,36495,36496
46698,1,512,512,512.00,0.00,36495,36496
46699,1,512,512,512.00,0.00,36495,36496
46700,1,512,512,512.00,0.00,36495,36496
46701,3,285,27,170.67,11524.22,36495,36498
46702,1,512,512,512.00,0.00,36497,36498
46703,2,435,77,256.00,32041.00,36497,36499
46704,1,512,512,512.00,0.00,36498,36499
46705,2,450,62,256.00,37636.00,36498,36500
46706,3,491,6,170.67,51320.22,36499,36502
46707,4,336,3,128.00,16909.50,36501,36505
46708,2,508,4,256.00,63504.00,36504,36506
46709,1,512,512,512.00,0.00,36505,36506
46710,1,512,512,512.00,0.00,36505,36506
46711,1,512,512,512.00,0.00,36505,36506
46712,1,512,512,512.00,0.00,36505,36506
46713,4,295,5,128.00,14609.00,36505,36509
46714,2,301,211,256.00,2025.00,36508,36510
46715,3,289,77,170.67,7794.89,36509,36512
46716,1,512,512,512.00,0.00,36511,36512
46717,1,512,512,512.00,0.00,36511,36512
46718,2,316,196,256.00,3600.00,36511,36513
46719,1,512,512,512.00,0.00,36512,36513
46720,3,484,1,170.67,49201.56,36512,36515
46721,1,512,512,512.00,0.00,36514,36515
46722,3,233,88,170.67,3710.89,36514,36517
46723,1,512,512,512.00,0.00,36516,36517
46724,1,512,512,512.00,0.00,36516,36517
46725,2,389,123,256.00,17689.00,36516,36518
46726,1,512,512,512.00,0.00,36517,36518
46727,1,512,512,512.00,0.00,36517,36518
46728,4,320,52,128.00,12366.50,36517,36521
46729,2,466,46,256.00,44100.00,36520,36522
46730,4,291,1,128.00,12188.50,36521,36525
46731,4,342,12,128.00,17813.50,36524,36528
46732,1,512,512,512.00,0.00,36527,36528
46733,1,512,512,512.00,0.00,36527,36528
46734,2,300,212,256.00,1936.00,36527,36529
46735,1,512,512,512.00,0.00,36528,36529
46736,1,512,512,512.00,0.00,36528,36529
46737,1,512,512,512.00,0.00,36528,36529
46738,1,512,512,512.00,0.00,36528,36529
46739,8,412,1,64.00,17624.25,36528,36536
46740,3,417,8,170.67,31380.22,36535,36538
46741,4,353,13,128.00,18053.00,36537,36541
46742,1,512,512,512.00,0.00,36540,36541
46743,1,512,512,512.00,0.00,36540,36541
46744,2,387,125,256.00,17161.00,36540,36542
46745,1,512,512,512.00,0.00,36541,36542
46746,1,512,512,512.00,0.00,36541,36542
46747,1,512,512,512.00,0.00,36541,36542
46748,5,170,24,102.40,2886.64,36541,36546
46749,3,313,1,170.67,16597.56,36545,36548
46750,1,512,512,512.00,0.00,36547,36548
46751,1,512,512,512.00,0.00,36547,36548
46752,3,314,4,170.67,16288.89,36547,36550
46753,1,512,512,512.00,0.00,36549,36550
46754,3,276,9,170.67,13468.22,36549,36552
46755,1,512,512,512.00,0.00,36551,36552
46756,1,512,512,512.00,0.00,36551,36552
46757,1,512,512,512.00,0.00,36551,36552
46758,1,512,512,512.00,0.00,36551,36552
46759,1,512,512,512.00,0.00,36551,36552
46760,6,300,1,85.33,11272.89,36551,36557
46761,1,512,512,512.00,0.00,36556,36557
46762,1,512,512,512.00,0.00,36556,36557
46763,3,250,116,170.67,3296.89,36556,36559
46764,6,293,6,85.33,10585.22,36558,36564
46765,1,512,512,512.00,0.00,36563,36564
46766,2,414,98,256.00,24964.00,36563,36565
46767,4,481,1,128.00,41653.50,36564,36568
46768,2,421,91,256.00,27225.00,36567,36569
46769,1,512,512,512.00,0.00,36568,36569
46770,5,307,1,102.40,12391.84,36568,36573
46771,2,483,29,256.00,51529.00,36572,36574
46772,1,512,512,512.00,0.00,36573,36574
46773,1,512,512,512.00,0.00,36573,36574
46774,1,512,512,512.00,0.00,36573,36574
46775,2,342,170,256.00,7396.00,36573,36575
46776,4,500,2,128.00,46130.00,36574,36578
46777,2,464,48,256.00,43264.00,36577,36579
46778,1,512,512,512.00,0.00,36578,36579
46779,4,270,1,128.00,14666.50,36578,36582
46780,4,442,1,128.00,33487.50,36581,36585
46781,2,487,25,256.00,53361.00,36584,36586
46782,1,512,512,512.00,0.00,36585,36586
46783,1,512,512,512.00,0.00,36585,36586
46784,1,512,512,512.00,0.00,36585,36586
46785,1,512,512,512.00,0.00,36585,36586
46786,3,364,2,170.67,22144.89,36585,36588
46787,3,427,31,170.67,32941.56,36587,36590
46788,1,512,512,512.00,0.00,36589,36590
46789,1,512,512,512.00,0.00,36589,36590
46790,1,512,512,512.00,0.00,36589,36590
46791,1,512,512,512.00,0.00,36589,36590
46792,4,372,3,128.00,20570.50,36589,36593
46793,7,254,1,73.14,8815.84,36592,36599
46794,3,467,20,170.67,43910.89,36598,36601
46795,5,174,6,102.40,3613.04,36600,36605
46796,6,358,1,85.33,15701.56,36604,36610
46797,3,368,49,170.67,19822.89,36609,36612
46798,1,512,512,512.00,0.00,36611,36612
46799,1,512,512,512.00,0.00,36611,36612
46800,1,512,512,512.00,0.00,36611,36612
46801,1,512,512,512.00,0.00,36611,36612
46802,1,512,512,512.00,0.00,36611,36612
46803,7,212,6,73.14,4320.98,36611,36618
46804,5,274,3,102.40,13058.64,36617,36622
46805,1,512,512,512.00,0.00,36621,36622
46806,1,512,512,512.00,0.00,36621,36622
46807,2,295,217,256.00,1521.00,36621,36623
46808,2,373,139,256.00,13689.00,36622,36624
46809,2,477,35,256.00,48841.00,36623,36625
46810,1,512,512,512.00,0.00,36624,36625
46811,1,512,512,512.00,0.00,36624,36625
46812,2,359,153,256.00,10609.00,36624,36626
46813,8,228,1,64.00,6625.50,36625,36633
46814,2,262,250,256.00,36.00,36632,36634
46815,1,512,512,512.00,0.00,36634,36635
46816,1,512,512,512.00,0.00,36634,36635
46817,8,162,2,64.00,3098.25,36634,36642
46818,2,420,92,256.00,26896.00,36641,36643
46819,2,295,217,256.00,1521.00,36642,36644
46820,1,512,512,512.00,0.00,36643,36644
46821,1,512,512,512.00,0.00,36643,36644
46822,2,377,135,256.00,14641.00,36643,36645
46823,1,512,512,512.00,0.00,36644,36645
46824,1,512,512,512.00,0.00,36644,36645
46825,4,252,41,128.00,5998.50,36644,36648
46826,2,287,225,256.00,961.00,36647,36649
46827,1,512,512,512.00,0.00,36648,36649
46828,1,512,512,512.00,0.00,36648,36649
46829,6,247,5,85.33,10710.56,36648,36654
46830,1,512,512,512.00,0.00,36653,36654
46831,1,512,512,512.00,0.00,36653,36654
46832,3,448,4,170.67,38979.56,36653,36656
46833,2,381,131,256.00,15625.00,36655,36657
46834,2,500,12,256.00,59536.00,36656,36658
46835,3,255,114,170.67,3696.22,36657,36660
46836,5,299,9,102.40,11554.24,36659,36664
46837,1,512,512,512.00,0.00,36663,36664
46838,5,301,21,102.40,10208.24,36663,36668
46839,2,318,194,256.00,3844.00,36667,36669
46840,1,512,512,512.00,0.00,36668,36669
46841,3,316,97,170.67,10561.56,36668,36671
46842,2,263,249,256.00,49.00,36670,36672
46843,1,512,512,512.00,0.00,36671,36672
46844,1,512,512,512.00,0.00,36671,36672
46845,1,512,512,512.00,0.00,36671,36672
46846,1,512,512,512.00,0.00,36671,36672
46847,2,405,107,256.00,22201.00,36671,36673
46848,2,506,6,256.00,62500.00,36672,36674
46849,2,412,100,256.00,24336.00,36673,36675
46850,1,512,512,512.00,0.00,36674,36675
46851,1,512,512,512.00,0.00,36674,36675
46852,1,512,512,512.00,0.00,36674,36675
46853,4,376,2,128.00,21626.00,36674,36678
46854,2,493,19,256.00,56169.00,36677,36679
46855,2,327,185,256.00,5041.00,36678,36680
46856,8,143,1,64.00,3115.75,36679,36687
46857,1,512,512,512.00,0.00,36686,36687
46858,1,512,512,512.00,0.00,36686,36687
46859,1,512,512,512.00,0.00,36686,36687
46860,1,512,512,512.00,0.00,36686,36687
46861,1,512,512,512.00,0.00,36686,36687
46862,2,260,252,256.00,16.00,36686,36688
46863,1,512,512,512.00,0.00,36687,36688
46864,1,512,512,512.00,0.00,36687,36688
46865,1,512,512,512.00,0.00,36687,36688
46866,2,438,74,256.00,33124.00,36687,36689
46867,1,512,512,512.00,0.00,36688,36689
46868,1,512,512,512.00,0.00,36688,36689
46869,1,512,512,512.00,0.00,36688,36689
46870,1,512,512,512.00,0.00,36688,36689
46871,1,512,512,512.00,0.00,36688,36689
46872,1,512,512,512.00,0.00,36688,36689
46873,1,512,512,512.00,0.00,36688,36689
46874,1,512,512,512.00,0.00,36688,36689
46875,1,512,512,512.00,0.00,36688,36689
46876,4,210,1,128.00,6086.50,36688,36692
46877,2,465,47,256.00,43681.00,36691,36693
46878,5,231,7,102.40,8873.44,36692,36697
46879,1,512,512,512.00,0.00,36696,36697
46880,1,512,512,512.00,0.00,36696,36697
46881,1,512,512,512.00,0.00,36696,36697
46882,1,512,512,512.00,0.00,36696,36697
46883,1,512,512,512.00,0.00,36696,36697
46884,3,313,78,170.67,10437.56,36696,36699
46885,1,512,512,512.00,0.00,36698,36699
46886,3,270,46,170.67,8683.56,36698,36701
46887,1,512,512,512.00,0.00,36700,36701
46888,2,415,97,256.00,25281.00,36700,36702
46889,1,512,512,512.00,0.00,36701,36702
46890,1,512,512,512.00,0.00,36701,36702
46891,1,512,512,512.00,0.00,36701,36702
46892,2,456,56,256.00,40000.00,36701,36703
46893,1,512,512,512.00,0.00,36702,36703
46894,1,512,512,512.00,0.00,36702,36703
46895,3,316,75,170.67,10913.56,36702,36705
46896,2,398,114,256.00,20164.00,36704,36706
46897,1,512,512,512.00,0.00,36705,36706
46898,1,512,512,512.00,0.00,36705,36706
46899,1,512,512,512.00,0.00,36705,36706
46900,3,347,27,170.67,17600.22,36705,36708
46901,3,312,61,170.67,11001.56,36707,36710
46902,1,512,512,512.00,0.00,36709,36710
46903,2,375,137,256.00,14161.00,36709,36711
46904,2,375,137,256.00,14161.00,36710,36712
46905,1,512,512,512.00,0.00,36711,36712
46906,1,512,512,512.00,0.00,36711,36712
46907,1,512,512,512.00,0.00,36711,36712
46908,1,512,512,512.00,0.00,36711,36712
46909,1,512,512,512.00,0.00,36711,36712
46910,1,512,512,512.00,0.00,36711,36712
46911,1,512,512,512.00,0.00,36711,36712
46912,2,444,68,256.00,35344.00,36711,36713
46913,1,512,512,512.00,0.00,36712,36713
46914,1,512,512,512.00,0.00,36712,36713
46915,2,394,118,256.00,19044.00,36712,36714
46916,4,295,6,128.00,13292.50,36713,36717
46917,6,190,13,85.33,5265.22,36716,36722
46918,2,361,151,256.00,11025.00,36721,36723
46919,2,421,91,256.00,27225.00,36722,36724
46920,2,339,173,256.00,6889.00,36723,36725
46921,4,221,46,128.00,4386.50,36724,36728
46922,1,512,512,512.00,0.00,36727,36728
46923,1,512,512,512.00,0.00,36727,36728
46924,1,512,512,512.00,0.00,36727,36728
46925,2,492,20,256.00,55696.00,36727,36729
46926,1,512,512,512.00,0.00,36728,36729
46927,1,512,512,512.00,0.00,36728,36729
46928,1,512,512,512.00,0.00,36728,36729
46929,4,384,13,128.00,22703.50,36728,36732
46930,1,512,512,512.00,0.00,36731,36732
46931,1,512,512,512.00,0.00,36731,36732
46932,1,512,512,512.00,0.00,36731,36732
46933,1,512,512,512.00,0.00,36731,36732
46934,2,442,70,256.00,34596.00,36731,36733
46935,4,206,1,128.00,6024.50,36732,36736
46936,2,409,103,256.00,23409.00,36735,36737
46937,1,512,512,512.00,0.00,36736,36737
46938,1,512,512,512.00,0.00,36736,36737
46939,1,512,512,512.00,0.00,36736,36737
46940,2,301,211,256.00,2025.00,36736,36738
46941,6,306,2,85.33,11150.56,36737,36743
46942,1,512,512,512.00,0.00,36742,36743
46943,3,362,62,170.67,18416.89,36742,36745
46944,1,512,512,512.00,0.00,36744,36745
46945,1,512,512,512.00,0.00,36744,36745
46946,1,512,512,512.00,0.00,36744,36745
46947,2,461,51,256.00,42025.00,36744,36746
46948,3,339,52,170.67,14961.56,36745,36748
46949,2,297,215,256.00,1681.00,36747,36749
46950,2,426,86,256.00,28900.00,36748,36750
46951,3,331,65,170.67,13286.89,36749,36752
46952,1,512,512,512.00,0.00,36751,36752
46953,1,512,512,512.00,0.00,36751,36752
46954,1,512,512,512.00,0.00,36751,36752
46955,1,512,512,512.00,0.00,36751,36752
46956,2,348,164,256.00,8464.00,36751,36753
46957,1,512,512,512.00,0.00,36752,36753
46958,2,379,133,256.00,15129.00,36752,36754
46959,1,512,512,512.00,0.00,36753,36754
46960,2,300,212,256.00,1936.00,36753,36755
46961,2,366,146,256.00,12100.00,36754,36756
46962,2,352,160,256.00,9216.00,36755,36757
46963,2,450,62,256.00,37636.00,36756,36758
46964,1,512,512,512.00,0.00,36757,36758
46965,1,512,512,512.00,0.00,36757,36758
46966,1,512,512,512.00,0.00,36757,36758
46967,2,455,57,256.00,39601.00,36757,36759
46968,2,502,10,256.00,60516.00,36758,36760
46969,1,512,512,512.00,0.00,36759,36760
46970,1,512,512,512.00,0.00,36759,36760
46971,1,512,512,512.00,0.00,36759,36760
46972,2,270,242,256.00,196.00,36759,36761
46973,3,241,113,170.67,2810.89,36760,36763
46974,1,512,512,512.00,0.00,36762,36763
46975,1,512,512,512.00,0.00,36762,36763
46976,2,301,211,256.00,2025.00,36762,36764
46977,1,512,512,512.00,0.00,36763,36764
46978,3,262,1,170.67,14421.56,36763,36766
46979,4,313,1,128.00,13891.00,36765,36769
46980,1,512,512,512.00,0.00,36768,36769
46981,1,512,512,512.00,0.00,36768,36769
46982,1,512,512,512.00,0.00,36768,36769
46983,1,512,512,512.00,0.00,36768,36769
46984,1,512,512,512.00,0.00,36768,36769
46985,1,512,512,512.00,0.00,36768,36769
46986,1,512,512,512.00,0.00,36768,36769
46987,1,512,512,512.00,0.00,36768,36769
46988,1,512,512,512.00,0.00,36768,36769
46989,1,512,512,512.00,0.00,36768,36769
46990,2,309,203,256.00,2809.00,36768,36770
46991,1,512,512,512.00,0.00,36769,36770
46992,2,454,58,256.00,39204.00,36769,36771
46993,1,512,512,512.00,0.00,36770,36771
46994,1,512,512,512.00,0.00,36770,36771
46995,3,481,8,170.67,48190.89,36770,36773
46996,3,369,26,170.67,21048.22,36772,36775
46997,4,335,31,128.00,14721.50,36774,36778
46998,3,483,6,170.67,48824.22,36777,36780
46999,1,512,512,512.00,0.00,36779,36780
47000,1,512,512,512.00,0.00,36779,36780
47001,2,266,246,256.00,100.00,36779,36781
47002,3,434,2,170.67,35584.89,36780,36783
47003,1,512,512,512.00,0.00,36782,36783
47004,1,512,512,512.00,0.00,36782,36783
47005,1,512,512,512.00,0.00,36782,36783
47006,1,512,512,512.00,0.00,36782,36783
47007,3,209,133,170.67,962.89,36782,36785
47008,2,283,229,256.00,729.00,36784,36786
47009,1,512,512,512.00,0.00,36785,36786
47010,1,512,512,512.00,0.00,36785,36786
47011,3,321,5,170.67,16760.22,36785,36788
47012,1,512,512,512.00,0.00,36787,36788
47013,1,512,512,512.00,0.00,36787,36788
47014,2,388,124,256.00,17424.00,36787,36789
47015,1,512,512,512.00,0.00,36788,36789
47016,1,512,512,512.00,0.00,36788,36789
47017,1,512,512,512.00,0.00,36788,36789
47018,1,512,512,512.00,0.00,36788,36789
47019,2,502,10,256.00,60516.00,36788,36790
47020,1,512,512,512.00,0.00,36789,36790
47021,3,229,83,170.67,3982.89,36789,36792
47022,1,512,512,512.00,0.00,36791,36792
47023,2,363,149,256.00,11449.00,36791,36793
47024,1,512,512,512.00,0.00,36792,36793
47025,1,512,512,512.00,0.00,36792,36793
47026,1,512,512,512.00,0.00,36792,36793
47027,2,292,220,256.00,1296.00,36792,36794
47028,1,512,512,512.00,0.00,36793,36794
47029,1,512,512,512.00,0.00,36793,36794
47030,1,512,512,512.00,0.00,36793,36794
47031,1,512,512,512.00,0.00,36793,36794
47032,2,422,90,256.00,27556.00,36793,36795
47033,1,512,512,512.00,0.00,36794,36795
47034,1,512,512,512.00,0.00,36794,36795
47035,2,408,104,256.00,23104.00,36794,36796
47036,4,405,3,128.00,26104.50,36795,36799
47037,1,512,512,512.00,0.00,36798,36799
47038,2,455,57,256.00,39601.00,36798,36800
47039,2,285,227,256.00,841.00,36799,36801
47040,1,512,512,512.00,0.00,36800,36801
47041,5,240,1,102.40,8661.04,36800,36805
47042,4,262,19,128.00,8278.50,36804,36808
47043,1,512,512,512.00,0.00,36807,36808
47044,3,227,98,170.67,2906.89,36807,36810
47045,2,356,156,256.00,10000.00,36809,36811
47046,1,512,512,512.00,0.00,36810,36811
47047,1,512,512,512.00,0.00,36810,36811
47048,1,512,512,512.00,0.00,36810,36811
47049,2,295,217,256.00,1521.00,36810,36812
47050,1,512,512,512.00,0.00,36811,36812
47051,1,512,512,512.00,0.00,36811,36812
47052,5,300,1,102.40,13723.04,36811,36816
47053,1,512,512,512.00,0.00,36815,36816
47054,2,364,148,256.00,11664.00,36815,36817
47055,3,345,15,170.67,18324.22,36816,36819
47056,1,512,512,512.00,0.00,36818,36819
47057,4,347,5,128.00,19662.50,36818,36822
47058,3,389,1,170.67,26274.89,36821,36824
47059,4,234,3,128.00,7841.50,36823,36827
47060,2,319,193,256.00,3969.00,36826,36828
47061,1,512,512,512.00,0.00,36827,36828
47062,1,512,512,512.00,0.00,36827,36828
47063,1,512,512,512.00,0.00,36827,36828
47064,1,512,512,512.00,0.00,36827,36828
47065,3,403,39,170.67,27149.56,36827,36830
47066,1,512,512,512.00,0.00,36829,36830
47067,3,279,61,170.67,7921.56,36829,36832
47068,1,512,512,512.00,0.00,36831,36832
47069,1,512,512,512.00,0.00,36831,36832
47070,1,512,512,512.00,0.00,36831,36832
47071,1,512,512,512.00,0.00,36831,36832
47072,4,213,51,128.00,3297.00,36831,36835
47073,1,512,512,512.00,0.00,36834,36835
47074,1,512,512,512.00,0.00,36834,36835
47075,1,512,512,512.00,0.00,36834,36835
47076,1,512,512,512.00,0.00,36834,36835
47077,1,512,512,512.00,0.00,36834,36835
47078,2,352,160,256.00,9216.00,36834,36836
47079,2,397,115,256.00,19881.00,36835,36837
47080,1,512,512,512.00,0.00,36836,36837
47081,3,336,42,170.67,15078.22,36836,36839
47082,1,512,512,512.00,0.00,36838,36839
47083,1,512,512,512.00,0.00,36838,36839
47084,1,512,512,512.00,0.00,36838,36839
47085,1,512,512,512.00,0.00,36838,36839
47086,3,338,15,170.67,17456.22,36838,36841
47087,1,512,512,512.00,0.00,36840,36841
47088,1,512,512,512.00,0.00,36840,36841
47089,1,512,512,512.00,0.00,36840,36841
47090,1,512,512,512.00,0.00,36840,36841
47091,2,471,41,256.00,46225.00,36840,36842
47092,1,512,512,512.00,0.00,36841,36842
47093,1,512,512,512.00,0.00,36841,36842
47094,1,512,512,512.00,0.00,36841,36842
47095,3,357,15,170.67,19964.22,36841,36844
47096,1,512,512,512.00,0.00,36843,36844
47097,2,488,24,256.00,53824.00,36843,36845
47098,2,381,131,256.00,15625.00,36844,36846
47099,1,512,512,512.00,0.00,36845,36846
47100,1,512,512,512.00,0.00,36845,36846
47101,1,512,512,512.00,0.00,36845,36846
47102,4,196,63,128.00,2213.50,36845,36849
47103,1,512,512,512.00,0.00,36848,36849
47104,2,370,142,256.00,12996.00,36848,36850
47105,3,281,4,170.67,14374.89,36849,36852
47106,2,413,99,256.00,24649.00,36851,36853
47107,1,512,512,512.00,0.00,36852,36853
47108,2,277,235,256.00,441.00,36852,36854
47109,1,512,512,512.00,0.00,36853,36854
47110,1,512,512,512.00,0.00,36853,36854
47111,1,512,512,512.00,0.00,36853,36854
47112,1,512,512,512.00,0.00,36853,36854
47113,1,512,512,512.00,0.00,36853,36854
47114,1,512,512,512.00,0.00,36853,36854
47115,2,425,87,256.00,28561.00,36853,36855
47116,1,512,512,512.00,0.00,36854,36855
47117,1,512,512,512.00,0.00,36854,36855
47118,4,364,4,128.00,19948.50,36854,36858
47119,2,333,179,256.00,5929.00,36857,36859
47120,2,363,149,256.00,11449.00,36858,36860
47121,1,512,512,512.00,0.00,36859,36860
47122,1,512,512,512.00,0.00,36859,36860
47123,1,512,512,512.00,0.00,36859,36860
47124,2,480,32,256.00,50176.00,36859,36861
47125,1,512,512,512.00,0.00,36860,36861
47126,1,512,512,512.00,0.00,36860,36861
47127,2,495,17,256.00,57121.00,36860,36862
47128,1,512,512,512.00,0.00,36861,36862
47129,1,512,512,512.00,0.00,36861,36862
47130,1,512,512,512.00,0.00,36861,36862
47131,1,512,512,512.00,0.00,36861,36862
47132,1,512,512,512.00,0.00,36861,36862
47133,1,512,512,512.00,0.00,36861,36862
47134,1,512,512,512.00,0.00,36861,36862
47135,1,512,512,512.00,0.00,36861,36862
47136,1,512,512,512.00,0.00,36861,36862
47137,1,512,512,512.00,0.00,36861,36862
47138,1,512,512,512.00,0.00,36861,36862
47139,2,328,184,256.00,5184.00,36861,36863
47140,1,512,512,512.00,0.00,36862,36863
47141,1,512,512,512.00,0.00,36862,36863
47142,1,512,512,512.00,0.00,36862,36863
47143,1,512,512,512.00,0.00,36862,36863
47144,1,512,512,512.00,0.00,36862,36863
47145,2,328,184,256.00,5184.00,36862,36864
47146,1,512,512,512.00,0.00,36863,36864
47147,4,317,26,128.00,12855.50,36863,36867
47148,3,337,85,170.67,13837.56,36866,36869
47149,1,512,512,512.00,0.00,36868,36869
47150,5,373,7,102.40,19210.24,36868,36873
47151,1,512,512,512.00,0.00,36872,36873
47152,1,512,512,512.00,0.00,36872,36873
47153,1,512,512,512.00,0.00,36872,36873
47154,1,512,512,512.00,0.00,36872,36873
47155,2,467,45,256.00,44521.00,36872,36874
47156,1,512,512,512.00,0.00,36873,36874
47157,1,512,512,512.00,0.00,36873,36874
47158,5,317,2,102.40,12989.84,36873,36878
47159,3,285,95,170.67,6764.22,36877,36880
47160,2,404,108,256.00,21904.00,36879,36881
47161,1,512,512,512.00,0.00,36880,36881
47162,1,512,512,512.00,0.00,36880,36881
47163,1,512,512,512.00,0.00,36880,36881
47164,4,246,16,128.00,7269.50,36880,36884
47165,1,512,512,512.00,0.00,36883,36884
47166,1,512,512,512.00,0.00,36883,36884
47167,1,512,512,512.00,0.00,36883,36884
47168,2,473,39,256.00,47089.00,36883,36885
47169,1,512,512,512.00,0.00,36884,36885
47170,1,512,512,512.00,0.00,36884,36885
47171,1,512,512,512.00,0.00,36884,36885
47172,2,485,27,256.00,52441.00,36884,36886
47173,2,464,48,256.00,43264.00,36885,36887
47174,1,512,512,512.00,0.00,36886,36887
47175,1,512,512,512.00,0.00,36886,36887
47176,1,512,512,512.00,0.00,36886,36887
47177,1,512,512,512.00,0.00,36886,36887
47178,1,512,512,512.00,0.00,36886,36887
47179,1,512,512,512.00,0.00,36886,36887
47180,1,512,512,512.00,0.00,36886,36887
47181,1,512,512,512.00,0.00,36886,36887
47182,2,453,59,256.00,38809.00,36886,36888
47183,1,512,512,512.00,0.00,36887,36888
47184,1,512,512,512.00,0.00,36887,36888
47185,1,512,512,512.00,0.00,36887,36888
47186,2,496,16,256.00,57600.00,36887,36889
47187,1,512,512,512.00,0.00,36888,36889
47188,3,489,1,170.67,50741.56,36888,36891
47189,1,512,512,512.00,0.00,36890,36891
47190,1,512,512,512.00,0.00,36890,36891
47191,1,512,512,512.00,0.00,36890,36891
47192,3,291,84,170.67,7708.22,36890,36893
47193,1,512,512,512.00,0.00,36892,36893
47194,1,512,512,512.00,0.00,36892,36893
47195,4,356,6,128.00,19921.50,36892,36896
47196,1,512,512,512.00,0.00,36895,36896
47197,2,333,179,256.00,5929.00,36895,36897
47198,1,512,512,512.00,0.00,36896,36897
47199,3,289,15,170.67,13209.56,36896,36899
47200,1,512,512,512.00,0.00,36898,36899
47201,1,512,512,512.00,0.00,36898,36899
47202,2,334,178,256.00,6084.00,36898,36900
47203,1,512,512,512.00,0.00,36899,36900
47204,1,512,512,512.00,0.00,36899,36900
47205,1,512,512,512.00,0.00,36899,36900
47206,1,512,512,512.00,0.00,36899,36900
47207,1,512,512,512.00,0.00,36899,36900
47208,1,512,512,512.00,0.00,36899,36900
47209,3,484,2,170.67,49184.89,36899,36902
47210,1,512,512,512.00,0.00,36901,36902
47211,1,512,512,512.00,0.00,36901,36902
47212,1,512,512,512.00,0.00,36901,36902
47213,2,367,145,256.00,12321.00,36901,36903
47214,2,290,222,256.00,1156.00,36902,36904
47215,2,357,155,256.00,10201.00,36903,36905
47216,4,376,1,128.00,23449.50,36904,36908
47217,4,398,28,128.00,24342.00,36907,36911
47218,2,511,1,256.00,65025.00,36910,36912
47219,2,365,147,256.00,11881.00,36911,36913
47220,1,512,512,512.00,0.00,36912,36913
47221,1,512,512,512.00,0.00,36912,36913
47222,1,512,512,512.00,0.00,36912,36913
47223,1,512,512,512.00,0.00,36912,36913
47224,1,512,512,512.00,0.00,36912,36913
47225,3,446,10,170.67,38256.89,36912,36915
47226,5,425,1,102.40,26144.64,36914,36919
47227,2,509,3,256.00,64009.00,36918,36920
47228,1,512,512,512.00,0.00,36919,36920
47229,7,211,1,73.14,5885.55,36919,36926
47230,1,512,512,512.00,0.00,36925,36926
47231,2,374,138,256.00,13924.00,36925,36927
47232,1,512,512,512.00,0.00,36926,36927
47233,2,497,15,256.00,58081.00,36926,36928
47234,1,512,512,512.00,0.00,36927,36928
47235,1,512,512,512.00,0.00,36927,36928
47236,1,512,512,512.00,0.00,36927,36928
47237,2,306,206,256.00,2500.00,36927,36929
47238,1,512,512,512.00,0.00,36928,36929
47239,2,460,52,256.00,41616.00,36928,36930
47240,1,512,512,512.00,0.00,36929,36930
47241,1,512,512,512.00,0.00,36929,36930
47242,1,512,512,512.00,0.00,36929,36930
47243,1,512,512,512.00,0.00,36929,36930
47244,1,512,512,512.00,0.00,36929,36930
47245,1,512,512,512.00,0.00,36929,36930
47246,1,512,512,512.00,0.00,36929,36930
47247,1,512,512,512.00,0.00,36929,36930
47248,2,379,133,256.00,15129.00,36929,36931
47249,1,512,512,512.00,0.00,36930,36931
47250,1,512,512,512.00,0.00,36930,36931
47251,1,512,512,512.00,0.00,36930,36931
47252,1,512,512,512.00,0.00,36930,36931
47253,1,512,512,512.00,0.00,36930,36931
47254,1,512,512,512.00,0.00,36930,36931
47255,1,512,512,512.00,0.00,36930,36931
47256,2,301,211,256.00,2025.00,36930,36932
47257,1,512,512,512.00,0.00,36931,36932
47258,1,512,512,512.00,0.00,36931,36932
47259,2,284,228,256.00,784.00,36931,36933
47260,1,512,512,512.00,0.00,36932,36933
47261,1,512,512,512.00,0.00,36932,36933
47262,3,330,52,170.67,13707.56,36932,36935
47263,2,399,113,256.00,20449.00,36934,36936
47264,1,512,512,512.00,0.00,36935,36936
47265,5,333,1,102.40,14805.04,36935,36940
47266,1,512,512,512.00,0.00,36939,36940
47267,1,512,512,512.00,0.00,36939,36940
47268,2,422,90,256.00,27556.00,36939,36941
47269,2,415,97,256.00,25281.00,36940,36942
47270,1,512,512,512.00,0.00,36941,36942
47271,3,482,6,170.67,48518.22,36941,36944
47272,1,512,512,512.00,0.00,36943,36944
47273,1,512,512,512.00,0.00,36943,36944
47274,1,512,512,512.00,0.00,36943,36944
47275,1,512,512,512.00,0.00,36943,36944
47276,1,512,512,512.00,0.00,36943,36944
47277,3,372,5,170.67,23084.22,36943,36946
47278,1,512,512,512.00,0.00,36945,36946
47279,1,512,512,512.00,0.00,36945,36946
47280,1,512,512,512.00,0.00,36945,36946
47281,1,512,512,512.00,0.00,36945,36946
47282,3,247,119,170.67,3034.89,36945,36948
47283,1,512,512,512.00,0.00,36947,36948
47284,4,463,1,128.00,37761.00,36947,36951
47285,1,512,512,512.00,0.00,36950,36951
47286,4,287,3,128.00,14243.00,36950,36954
47287,5,189,8,102.40,5195.44,36953,36958
47288,2,400,112,256.00,20736.00,36957,36959
47289,2,329,183,256.00,5329.00,36958,36960
47290,1,512,512,512.00,0.00,36959,36960
47291,1,512,512,512.00,0.00,36959,36960
47292,1,512,512,512.00,0.00,36959,36960
47293,1,512,512,512.00,0.00,36959,36960
47294,1,512,512,512.00,0.00,36959,36960
47295,1,512,512,512.00,0.00,36959,36960
47296,1,512,512,512.00,0.00,36959,36960
47297,4,308,37,128.00,11215.50,36959,36963
47298,2,342,170,256.00,7396.00,36962,36964
47299,1,512,512,512.00,0.00,36963,36964
47300,2,363,149,256.00,11449.00,36963,36965
47301,1,512,512,512.00,0.00,36964,36965
47302,2,312,200,256.00,3136.00,36964,36966
47303,1,512,512,512.00,0.00,36965,36966
47304,3,393,2,170.67,26920.22,36965,36968
47305,5,322,4,102.40,13104.24,36967,36972
47306,3,489,4,170.67,50705.56,36971,36974
47307,2,374,138,256.00,13924.00,36973,36975
47308,5,309,3,102.40,13839.04,36974,36979
47309,2,365,147,256.00,11881.00,36978,36980
47310,1,512,512,512.00,0.00,36979,36980
47311,1,512,512,512.00,0.00,36979,36980
47312,1,512,512,512.00,0.00,36979,36980
47313,3,426,16,170.67,33083.56,36979,36982
47314,1,512,512,512.00,0.00,36981,36982
47315,1,512,512,512.00,0.00,36981,36982
47316,1,512,512,512.00,0.00,36981,36982
47317,1,512,512,512.00,0.00,36981,36982
47318,1,512,512,512.00,0.00,36981,36982
47319,1,512,512,512.00,0.00,36981,36982
47320,1,512,512,512.00,0.00,36981,36982
47321,2,463,49,256.00,42849.00,36981,36983
47322,1,512,512,512.00,0.00,36982,36983
47323,1,512,512,512.00,0.00,36982,36983
47324,1,512,512,512.00,0.00,36982,36983
47325,2,291,221,256.00,1225.00,36982,36984
47326,1,512,512,512.00,0.00,36983,36984
47327,1,512,512,512.00,0.00,36983,36984
47328,1,512,512,512.00,0.00,36983,36984
47329,1,512,512,512.00,0.00,36983,36984
47330,1,512,512,512.00,0.00,36983,36984
47331,3,235,119,170.67,2322.89,36983,36986
47332,1,512,512,512.00,0.00,36985,36986
47333,1,512,512,512.00,0.00,36985,36986
47334,1,512,512,512.00,0.00,36985,36986
47335,1,512,512,512.00,0.00,36985,36986
47336,2,304,208,256.00,2304.00,36985,36987
47337,2,346,166,256.00,8100.00,36986,36988
47338,1,512,512,512.00,0.00,36987,36988
47339,1,512,512,512.00,0.00,36987,36988
47340,1,512,512,512.00,0.00,36987,36988
47341,1,512,512,512.00,0.00,36987,36988
47342,1,512,512,512.00,0.00,36987,36988
47343,2,506,6,256.00,62500.00,36987,36989
47344,1,512,512,512.00,0.00,36988,36989
47345,2,397,115,256.00,19881.00,36988,36990
47346,3,341,83,170.67,14510.89,36989,36992
47347,1,512,512,512.00,0.00,36991,36992
47348,2,306,206,256.00,2500.00,36991,36993
47349,4,306,16,128.00,12146.00,36992,36996
47350,4,390,2,128.00,24546.50,36995,36999
47351,2,376,136,256.00,14400.00,36998,37000
47352,3,344,39,170.67,16372.22,36999,37002
47353,4,366,2,128.00,20580.00,37001,37005
47354,2,425,87,256.00,28561.00,37004,37006
47355,1,512,512,512.00,0.00,37005,37006
47356,1,512,512,512.00,0.00,37005,37006
47357,1,512,512,512.00,0.00,37005,37006
47358,1,512,512,512.00,0.00,37005,37006
47359,1,512,512,512.00,0.00,37005,37006
47360,4,416,12,128.00,27798.00,37005,37009
47361,2,493,19,256.00,56169.00,37008,37010
47362,4,328,5,128.00,17763.50,37009,37013
47363,3,278,71,170.67,7170.89,37012,37015
47364,4,349,43,128.00,16353.00,37014,37018
47365,2,281,231,256.00,625.00,37017,37019
47366,1,512,512,512.00,0.00,37018,37019
47367,4,413,15,128.00,27246.50,37018,37022
47368,2,288,224,256.00,1024.00,37021,37023
47369,1,512,512,512.00,0.00,37022,37023
47370,1,512,512,512.00,0.00,37022,37023
47371,1,512,512,512.00,0.00,37022,37023
47372,2,308,204,256.00,2704.00,37022,37024
47373,1,512,512,512.00,0.00,37023,37024
47374,1,512,512,512.00,0.00,37023,37024
47375,2,492,20,256.00,55696.00,37023,37025
47376,2,466,46,256.00,44100.00,37024,37026
47377,1,512,512,512.00,0.00,37025,37026
47378,1,512,512,512.00,0.00,37025,37026
47379,1,512,512,512.00,0.00,37025,37026
47380,2,440,72,256.00,33856.00,37025,37027
47381,5,192,14,102.40,3409.04,37026,37031
47382,2,500,12,256.00,59536.00,37030,37032
47383,1,512,512,512.00,0.00,37031,37032
47384,1,512,512,512.00,0.00,37031,37032
47385,4,232,1,128.00,9080.50,37031,37035
47386,1,512,512,512.00,0.00,37034,37035
47387,1,512,512,512.00,0.00,37034,37035
47388,1,512,512,512.00,0.00,37034,37035
47389,3,420,17,170.67,31644.22,37034,37037
47390,6,343,1,85.33,14544.56,37036,37042
47391,1,512,512,512.00,0.00,37041,37042
47392,2,506,6,256.00,62500.00,37041,37043
47393,1,512,512,512.00,0.00,37042,37043
47394,1,512,512,512.00,0.00,37042,37043
47395,2,327,185,256.00,5041.00,37042,37044
47396,3,410,9,170.67,29816.22,37043,37046
47397,2,331,181,256.00,5625.00,37045,37047
47398,1,512,512,512.00,0.00,37046,37047
47399,1,512,512,512.00,0.00,37046,37047
47400,1,512,512,512.00,0.00,37046,37047
47401,1,512,512,512.00,0.00,37046,37047
47402,1,512,512,512.00,0.00,37046,37047
47403,5,343,12,102.40,15763.04,37046,37051
47404,1,512,512,512.00,0.00,37050,37051
47405,1,512,512,512.00,0.00,37050,37051
47406,1,512,512,512.00,0.00,37050,37051
47407,1,512,512,512.00,0.00,37050,37051
47408,1,512,512,512.00,0.00,37050,37051
47409,1,512,512,512.00,0.00,37050,37051
47410,2,509,3,256.00,64009.00,37050,37052
47411,1,512,512,512.00,0.00,37051,37052
47412,1,512,512,512.00,0.00,37051,37052
47413,2,329,183,256.00,5329.00,37051,37053
47414,2,461,51,256.00,42025.00,37052,37054
47415,1,512,512,512.00,0.00,37053,37054
47416,1,512,512,512.00,0.00,37053,37054
47417,6,353,1,85.33,17051.22,37053,37059
47418,1,512,512,512.00,0.00,37058,37059
47419,5,179,5,102.40,3877.44,37058,37063
47420,3,272,2,170.67,14416.89,37062,37065
47421,1,512,512,512.00,0.00,37064,37065
47422,4,303,27,128.00,11613.00,37064,37068
47423,1,512,512,512.00,0.00,37067,37068
47424,1,512,512,512.00,0.00,37067,37068
47425,2,369,143,256.00,12769.00,37067,37069
47426,2,344,168,256.00,7744.00,37068,37070
47427,1,512,512,512.00,0.00,37069,37070
47428,1,512,512,512.00,0.00,37069,37070
47429,1,512,512,512.00,0.00,37069,37070
47430,1,512,512,512.00,0.00,37069,37070
47431,3,229,62,170.67,5914.89,37069,37072
47432,2,294,218,256.00,1444.00,37071,37073
47433,1,512,512,512.00,0.00,37072,37073
47434,3,360,11,170.67,20740.22,37072,37075
47435,7,274,3,73.14,8180.12,37074,37081
47436,1,512,512,512.00,0.00,37080,37081
47437,2,503,9,256.00,61009.00,37080,37082
47438,5,256,1,102.40,13813.84,37081,37086
47439,1,512,512,512.00,0.00,37085,37086
47440,1,512,512,512.00,0.00,37085,37086
47441,2,429,83,256.00,29929.00,37085,37087
47442,1,512,512,512.00,0.00,37086,37087
47443,1,512,512,512.00,0.00,37086,37087
47444,2,304,208,256.00,2304.00,37086,37088
47445,2,267,245,256.00,121.00,37087,37089
47446,1,512,512,512.00,0.00,37088,37089
47447,1,512,512,512.00,0.00,37088,37089
47448,2,439,73,256.00,33489.00,37088,37090
47449,3,332,81,170.67,13068.22,37089,37092
47450,3,437,5,170.67,36170.89,37091,37094
47451,3,381,7,170.67,24401.56,37093,37096
47452,2,292,220,256.00,1296.00,37095,37097
47453,8,364,1,64.00,13280.25,37096,37104
47454,1,512,512,512.00,0.00,37103,37104
47455,1,512,512,512.00,0.00,37103,37104
47456,1,512,512,512.00,0.00,37103,37104
47457,2,287,225,256.00,961.00,37103,37105
47458,2,453,59,256.00,38809.00,37104,37106
47459,1,512,512,512.00,0.00,37105,37106
47460,1,512,512,512.00,0.00,37105,37106
47461,1,512,512,512.00,0.00,37105,37106
47462,1,512,512,512.00,0.00,37105,37106
47463,4,291,1,128.00,16668.50,37105,37109
47464,1,512,512,512.00,0.00,37108,37109
47465,1,512,512,512.00,0.00,37108,37109
47466,1,512,512,512.00,0.00,37108,37109
47467,1,512,512,512.00,0.00,37108,37109
47468,2,420,92,256.00,26896.00,37108,37110
47469,1,512,512,512.00,0.00,37109,37110
47470,1,512,512,512.00,0.00,37109,37110
47471,5,178,36,102.40,2277.44,37109,37114
47472,1,512,512,512.00,0.00,37113,37114
47473,1,512,512,512.00,0.00,37113,37114
47474,3,290,69,170.67,8296.22,37113,37116
47475,4,170,31,128.00,3181.50,37115,37119
47476,2,459,53,256.00,41209.00,37118,37120
47477,1,512,512,512.00,0.00,37119,37120
47478,1,512,512,512.00,0.00,37119,37120
47479,1,512,512,512.00,0.00,37119,37120
47480,1,512,512,512.00,0.00,37119,37120
47481,1,512,512,512.00,0.00,37119,37120
47482,1,512,512,512.00,0.00,37119,37120
47483,2,284,228,256.00,784.00,37119,37121
47484,1,512,512,512.00,0.00,37120,37121
47485,4,401,17,128.00,25121.00,37120,37124
47486,4,180,74,128.00,1826.00,37123,37127
47487,3,289,65,170.67,8442.89,37126,37129
47488,3,319,18,170.67,15109.56,37128,37131
47489,1,512,512,512.00,0.00,37130,37131
47490,1,512,512,512.00,0.00,37130,37131
47491,1,512,512,512.00,0.00,37130,37131
47492,1,512,512,512.00,0.00,37130,37131
47493,3,293,61,170.67,9050.89,37130,37133
47494,1,512,512,512.00,0.00,37132,37133
47495,1,512,512,512.00,0.00,37132,37133
47496,1,512,512,512.00,0.00,37132,37133
47497,2,460,52,256.00,41616.00,37132,37134
47498,4,203,6,128.00,5593.50,37133,37137
47499,1,512,512,512.00,0.00,37136,37137
47500,1,512,512,512.00,0.00,37136,37137
47501,1,512,512,512.00,0.00,37136,37137
47502,4,407,6,128.00,26307.50,37136,37140
47503,1,512,512,512.00,0.00,37139,37140
47504,1,512,512,512.00,0.00,37139,37140
47505,2,472,40,256.00,46656.00,37139,37141
47506,4,186,3,128.00,5308.50,37140,37144
47507,1,512,512,512.00,0.00,37143,37144
47508,2,373,139,256.00,13689.00,37143,37145
47509,2,342,170,256.00,7396.00,37144,37146
47510,5,261,24,102.40,8587.04,37145,37150
47511,1,512,512,512.00,0.00,37149,37150
47512,1,512,512,512.00,0.00,37149,37150
47513,2,478,34,256.00,49284.00,37149,37151
47514,1,512,512,512.00,0.00,37150,37151
47515,1,512,512,512.00,0.00,37150,37151
47516,1,512,512,512.00,0.00,37150,37151
47517,4,381,5,128.00,22657.50,37150,37154
47518,1,512,512,512.00,0.00,37153,37154
47519,2,278,234,256.00,484.00,37153,37155
47520,2,347,165,256.00,8281.00,37154,37156
47521,1,512,512,512.00,0.00,37155,37156
47522,1,512,512,512.00,0.00,37155,37156
47523,1,512,512,512.00,0.00,37155,37156
47524,1,512,512,512.00,0.00,37155,37156
47525,2,356,156,256.00,10000.00,37155,37157
47526,1,512,512,512.00,0.00,37156,37157
47527,1,512,512,512.00,0.00,37156,37157
47528,1,512,512,512.00,0.00,37156,37157
47529,2,390,122,256.00,17956.00,37156,37158
47530,4,313,5,128.00,16019.00,37157,37161
47531,2,331,181,256.00,5625.00,37160,37162
47532,1,512,512,512.00,0.00,37161,37162
47533,1,512,512,512.00,0.00,37161,37162
47534,2,279,233,256.00,529.00,37161,37163
47535,2,451,61,256.00,38025.00,37162,37164
47536,1,512,512,512.00,0.00,37163,37164
47537,1,512,512,512.00,0.00,37163,37164
47538,1,512,512,512.00,0.00,37163,37164
47539,2,264,248,256.00,64.00,37163,37165
47540,1,512,512,512.00,0.00,37164,37165
47541,2,436,76,256.00,32400.00,37164,37166
47542,1,512,512,512.00,0.00,37165,37166
47543,1,512,512,512.00,0.00,37165,37166
47544,1,512,512,512.00,0.00,37165,37166
47545,2,365,147,256.00,11881.00,37165,37167
47546,3,274,15,170.67,12549.56,37166,37169
47547,4,442,1,128.00,33403.50,37168,37172
47548,1,512,512,512.00,0.00,37171,37172
47549,1,512,512,512.00,0.00,37171,37172
47550,1,512,512,512.00,0.00,37171,37172
47551,3,496,1,170.67,52953.56,37171,37174
47552,4,409,1,128.00,27619.00,37173,37177
47553,4,385,14,128.00,22912.50,37176,37180
47554,6,267,1,85.33,10812.89,37179,37185
47555,3,363,37,170.67,19433.56,37184,37187
47556,1,512,512,512.00,0.00,37186,37187
47557,7,280,4,73.14,8415.55,37186,37193
47558,1,512,512,512.00,0.00,37192,37193
47559,1,512,512,512.00,0.00,37192,37193
47560,2,397,115,256.00,19881.00,37192,37194
47561,3,414,1,170.67,31141.56,37193,37196
47562,1,512,512,512.00,0.00,37195,37196
47563,2,359,153,256.00,10609.00,37195,37197
47564,1,512,512,512.00,0.00,37196,37197
47565,3,253,20,170.67,11382.89,37196,37199
47566,1,512,512,512.00,0.00,37198,37199
47567,1,512,512,512.00,0.00,37198,37199
47568,3,474,17,170.67,46008.22,37198,37201
47569,1,512,512,512.00,0.00,37200,37201
47570,1,512,512,512.00,0.00,37200,37201
47571,1,512,512,512.00,0.00,37200,37201
47572,2,509,3,256.00,64009.00,37200,37202
47573,3,309,50,170.67,11336.22,37201,37204
47574,1,512,512,512.00,0.00,37203,37204
47575,2,404,108,256.00,21904.00,37203,37205
47576,1,512,512,512.00,0.00,37204,37205
47577,2,329,183,256.00,5329.00,37204,37206
47578,1,512,512,512.00,0.00,37205,37206
47579,3,346,82,170.67,15371.56,37205,37208
47580,2,336,176,256.00,6400.00,37207,37209
47581,1,512,512,512.00,0.00,37208,37209
47582,1,512,512,512.00,0.00,37208,37209
47583,2,469,43,256.00,45369.00,37208,37210
47584,5,303,16,102.40,10590.24,37209,37214
47585,3,331,3,170.67,17957.56,37213,37216
47586,1,512,512,512.00,0.00,37215,37216
47587,3,296,13,170.67,13870.89,37215,37218
47588,2,310,202,256.00,2916.00,37217,37219
47589,1,512,512,512.00,0.00,37218,37219
47590,1,512,512,512.00,0.00,37218,37219
47591,1,512,512,512.00,0.00,37218,37219
47592,2,413,99,256.00,24649.00,37218,37220
47593,1,512,512,512.00,0.00,37219,37220
47594,1,512,512,512.00,0.00,37219,37220
47595,1,512,512,512.00,0.00,37219,37220
47596,2,294,218,256.00,1444.00,37219,37221
47597,1,512,512,512.00,0.00,37220,37221
47598,1,512,512,512.00,0.00,37220,37221
47599,2,289,223,256.00,1089.00,37220,37222
47600,3,356,5,170.67,20726.89,37221,37224
47601,2,457,55,256.00,40401.00,37223,37225
47602,1,512,512,512.00,0.00,37224,37225
47603,3,206,139,170.67,754.89,37224,37227
47604,3,235,129,170.67,2129.56,37226,37229
47605,1,512,512,512.00,0.00,37228,37229
47606,1,512,512,512.00,0.00,37228,37229
47607,1,512,512,512.00,0.00,37228,37229
47608,1,512,512,512.00,0.00,37228,37229
47609,3,285,70,170.67,7797.56,37228,37231
47610,3,466,5,170.67,43826.89,37230,37233
47611,1,512,512,512.00,0.00,37232,37233
47612,1,512,512,512.00,0.00,37232,37233
47613,1,512,512,512.00,0.00,37232,37233
47614,1,512,512,512.00,0.00,37232,37233
47615,1,512,512,512.00,0.00,37232,37233
47616,1,512,512,512.00,0.00,37232,37233
47617,3,397,1,170.67,27741.56,37232,37235
47618,2,423,89,256.00,27889.00,37234,37236
47619,2,431,81,256.00,30625.00,37235,37237
47620,2,497,15,256.00,58081.00,37236,37238
47621,2,511,1,256.00,65025.00,37237,37239
47622,3,440,1,170.67,37086.89,37238,37241
47623,1,512,512,512.00,0.00,37240,37241
47624,3,409,16,170.67,29241.56,37240,37243
47625,6,187,1,85.33,4614.56,37242,37248
47626,2,329,183,256.00,5329.00,37247,37249
47627,1,512,512,512.00,0.00,37248,37249
47628,1,512,512,512.00,0.00,37248,37249
47629,1,512,512,512.00,0.00,37248,37249
47630,1,512,512,512.00,0.00,37248,37249
47631,1,512,512,512.00,0.00,37248,37249
47632,1,512,512,512.00,0.00,37248,37249
47633,1,512,512,512.00,0.00,37248,37249
47634,3,475,11,170.67,46346.89,37248,37251
47635,1,512,512,512.00,0.00,37250,37251
47636,4,203,32,128.00,3918.50,37250,37254
47637,2,327,185,256.00,5041.00,37253,37255
47638,1,512,512,512.00,0.00,37254,37255
47639,2,495,17,256.00,57121.00,37254,37256
47640,1,512,512,512.00,0.00,37255,37256
47641,1,512,512,512.00,0.00,37255,37256
47642,1,512,512,512.00,0.00,37255,37256
47643,1,512,512,512.00,0.00,37255,37256
47644,1,512,512,512.00,0.00,37255,37256
47645,1,512,512,512.00,0.00,37255,37256
47646,1,512,512,512.00,0.00,37255,37256
47647,1,512,512,512.00,0.00,37255,37256
47648,1,512,512,512.00,0.00,37255,37256
47649,1,512,512,512.00,0.00,37255,37256
47650,3,311,5,170.67,15926.89,37255,37258
47651,2,442,70,256.00,34596.00,37257,37259
47652,3,474,3,170.67,46176.22,37258,37261
47653,4,357,2,128.00,19533.50,37260,37264
47654,1,512,512,512.00,0.00,37263,37264
47655,2,469,43,256.00,45369.00,37263,37265
47656,1,512,512,512.00,0.00,37264,37265
47657,1,512,512,512.00,0.00,37264,37265
47658,1,512,512,512.00,0.00,37264,37265
47659,2,403,109,256.00,21609.00,37264,37266
47660,1,512,512,512.00,0.00,37265,37266
47661,1,512,512,512.00,0.00,37265,37266
47662,1,512,512,512.00,0.00,37265,37266
47663,4,349,6,128.00,17247.50,37265,37269
47664,1,512,512,512.00,0.00,37268,37269
47665,1,512,512,512.00,0.00,37268,37269
47666,1,512,512,512.00,0.00,37268,37269
47667,1,512,512,512.00,0.00,37268,37269
47668,1,512,512,512.00,0.00,37268,37269
47669,5,453,1,102.40,30983.04,37268,37273
47670,3,348,1,170.67,20097.56,37272,37275
47671,3,304,1,170.67,15961.56,37274,37277
47672,4,330,1,128.00,18852.50,37276,37280
47673,1,512,512,512.00,0.00,37279,37280
47674,1,512,512,512.00,0.00,37279,37280
47675,1,512,512,512.00,0.00,37279,37280
47676,1,512,512,512.00,0.00,37279,37280
47677,1,512,512,512.00,0.00,37279,37280
47678,2,482,30,256.00,51076.00,37279,37281
47679,2,492,20,256.00,55696.00,37280,37282
47680,1,512,512,512.00,0.00,37281,37282
47681,1,512,512,512.00,0.00,37281,37282
47682,5,226,8,102.40,9888.24,37281,37286
47683,1,512,512,512.00,0.00,37285,37286
47684,1,512,512,512.00,0.00,37285,37286
47685,1,512,512,512.00,0.00,37285,37286
47686,1,512,512,512.00,0.00,37285,37286
47687,5,367,4,102.40,18189.04,37285,37290
47688,3,411,41,170.67,28940.22,37289,37292
47689,1,512,512,512.00,0.00,37291,37292
47690,1,512,512,512.00,0.00,37291,37292
47691,1,512,512,512.00,0.00,37291,37292
47692,2,316,196,256.00,3600.00,37291,37293
47693,1,512,512,512.00,0.00,37292,37293
47694,2,506,6,256.00,62500.00,37292,37294
47695,3,292,33,170.67,11313.56,37293,37296
47696,2,506,6,256.00,62500.00,37295,37297
47697,5,298,2,102.40,11674.64,37296,37301
47698,1,512,512,512.00,0.00,37300,37301
47699,1,512,512,512.00,0.00,37300,37301
47700,1,512,512,512.00,0.00,37300,37301
47701,1,512,512,512.00,0.00,37300,37301
47702,1,512,512,512.00,0.00,37300,37301
47703,3,451,20,170.67,39366.89,37300,37303
47704,2,303,209,256.00,2209.00,37302,37304
47705,2,321,191,256.00,4225.00,37303,37305
47706,4,354,2,128.00,18086.00,37304,37308
47707,1,512,512,512.00,0.00,37307,37308
47708,4,286,12,128.00,10438.00,37307,37311
47709,3,333,79,170.67,13249.56,37310,37313
47710,1,512,512,512.00,0.00,37312,37313
47711,1,512,512,512.00,0.00,37312,37313
47712,2,449,63,256.00,37249.00,37312,37314
47713,1,512,512,512.00,0.00,37313,37314
47714,1,512,512,512.00,0.00,37313,37314
47715,1,512,512,512.00,0.00,37313,37314
47716,1,512,512,512.00,0.00,37313,37314
47717,3,342,80,170.67,14694.22,37313,37316
47718,1,512,512,512.00,0.00,37315,37316
47719,1,512,512,512.00,0.00,37315,37316
47720,1,512,512,512.00,0.00,37315,37316
47721,4,239,10,128.00,6945.50,37315,37319
47722,4,208,66,128.00,3953.50,37318,37322
47723,3,438,9,170.67,36256.22,37321,37324
47724,3,454,26,170.67,40144.89,37323,37326
47725,1,512,512,512.00,0.00,37325,37326
47726,1,512,512,512.00,0.00,37325,37326
47727,1,512,512,512.00,0.00,37325,37326
47728,1,512,512,512.00,0.00,37325,37326
47729,3,284,90,170.67,6806.22,37325,37328
47730,2,372,140,256.00,13456.00,37327,37329
47731,1,512,512,512.00,0.00,37328,37329
47732,1,512,512,512.00,0.00,37328,37329
47733,1,512,512,512.00,0.00,37328,37329
47734,2,306,206,256.00,2500.00,37328,37330
47735,2,463,49,256.00,42849.00,37329,37331
47736,2,473,39,256.00,47089.00,37330,37332
47737,1,512,512,512.00,0.00,37331,37332
47738,1,512,512,512.00,0.00,37331,37332
47739,1,512,512,512.00,0.00,37331,37332
47740,1,512,512,512.00,0.00,37331,37332
47741,3,415,6,170.67,31053.56,37331,37334
47742,1,512,512,512.00,0.00,37333,37334
47743,1,512,512,512.00,0.00,37333,37334
47744,2,263,249,256.00,49.00,37333,37335
47745,2,292,220,256.00,1296.00,37334,37336
47746,1,512,512,512.00,0.00,37335,37336
47747,2,307,205,256.00,2601.00,37335,37337
47748,1,512,512,512.00,0.00,37336,37337
47749,1,512,512,512.00,0.00,37336,37337
47750,1,512,512,512.00,0.00,37336,37337
47751,1,512,512,512.00,0.00,37336,37337
47752,2,390,122,256.00,17956.00,37336,37338
47753,2,406,106,256.00,22500.00,37337,37339
47754,1,512,512,512.00,0.00,37338,37339
47755,2,326,186,256.00,4900.00,37338,37340
47756,1,512,512,512.00,0.00,37339,37340
47757,2,464,48,256.00,43264.00,37339,37341
47758,4,321,3,128.00,15201.00,37340,37344
47759,2,287,225,256.00,961.00,37343,37345
47760,2,283,229,256.00,729.00,37344,37346
47761,3,301,55,170.67,10193.56,37345,37348
47762,1,512,512,512.00,0.00,37347,37348
47763,2,464,48,256.00,43264.00,37347,37349
47764,1,512,512,512.00,0.00,37348,37349
47765,1,512,512,512.00,0.00,37348,37349
47766,1,512,512,512.00,0.00,37348,37349
47767,1,512,512,512.00,0.00,37348,37349
47768,2,426,86,256.00,28900.00,37348,37350
47769,1,512,512,512.00,0.00,37349,37350
47770,1,512,512,512.00,0.00,37349,37350
47771,1,512,512,512.00,0.00,37349,37350
47772,1,512,512,512.00,0.00,37349,37350
47773,2,293,219,256.00,1369.00,37349,37351
47774,1,512,512,512.00,0.00,37350,37351
47775,2,338,174,256.00,6724.00,37350,37352
47776,1,512,512,512.00,0.00,37351,37352
47777,2,421,91,256.00,27225.00,37351,37353
47778,1,512,512,512.00,0.00,37352,37353
47779,2,269,243,256.00,169.00,37352,37354
47780,2,415,97,256.00,25281.00,37353,37355
47781,1,512,512,512.00,0.00,37354,37355
47782,1,512,512,512.00,0.00,37354,37355
47783,1,512,512,512.00,0.00,37354,37355
47784,2,303,209,256.00,2209.00,37354,37356
47785,4,300,11,128.00,11631.50,37355,37359
47786,3,214,100,170.67,2539.56,37358,37361
47787,2,410,102,256.00,23716.00,37360,37362
47788,1,512,512,512.00,0.00,37361,37362
47789,1,512,512,512.00,0.00,37361,37362
47790,1,512,512,512.00,0.00,37361,37362
47791,2,355,157,256.00,9801.00,37361,37363
47792,1,512,512,512.00,0.00,37362,37363
47793,1,512,512,512.00,0.00,37362,37363
47794,1,512,512,512.00,0.00,37362,37363
47795,1,512,512,512.00,0.00,37362,37363
47796,4,344,17,128.00,16942.50,37362,37366
47797,1,512,512,512.00,0.00,37365,37366
47798,2,305,207,256.00,2401.00,37365,37367
47799,1,512,512,512.00,0.00,37366,37367
47800,1,512,512,512.00,0.00,37366,37367
47801,2,435,77,256.00,32041.00,37366,37368
47802,1,512,512,512.00,0.00,37367,37368
47803,1,512,512,512.00,0.00,37367,37368
47804,2,419,93,256.00,26569.00,37367,37369
47805,1,512,512,512.00,0.00,37368,37369
47806,2,394,118,256.00,19044.00,37368,37370
47807,1,512,512,512.00,0.00,37369,37370
47808,2,385,127,256.00,16641.00,37369,37371
47809,1,512,512,512.00,0.00,37371,37372
47810,1,512,512,512.00,0.00,37371,37372
47811,1,512,512,512.00,0.00,37371,37372
47812,4,443,1,128.00,33768.50,37371,37375
47813,1,512,512,512.00,0.00,37374,37375
47814,1,512,512,512.00,0.00,37374,37375
47815,1,512,512,512.00,0.00,37374,37375
47816,2,501,11,256.00,60025.00,37374,37376
47817,4,432,6,128.00,31026.00,37375,37379
47818,3,249,101,170.67,3688.22,37378,37381
47819,1,512,512,512.00,0.00,37380,37381
47820,3,354,17,170.67,19368.22,37380,37383
47821,1,512,512,512.00,0.00,37382,37383
47822,1,512,512,512.00,0.00,37382,37383
47823,2,449,63,256.00,37249.00,37382,37384
47824,2,456,56,256.00,40000.00,37383,37385
47825,2,328,184,256.00,5184.00,37384,37386
47826,1,512,512,512.00,0.00,37385,37386
47827,1,512,512,512.00,0.00,37385,37386
47828,1,512,512,512.00,0.00,37385,37386
47829,1,512,512,512.00,0.00,37385,37386
47830,1,512,512,512.00,0.00,37385,37386
47831,1,512,512,512.00,0.00,37385,37386
47832,2,474,38,256.00,47524.00,37385,37387
47833,2,475,37,256.00,47961.00,37386,37388
47834,1,512,512,512.00,0.00,37387,37388
47835,2,492,20,256.00,55696.00,37387,37389
47836,1,512,512,512.00,0.00,37388,37389
47837,1,512,512,512.00,0.00,37388,37389
47838,1,512,512,512.00,0.00,37388,37389
47839,1,512,512,512.00,0.00,37388,37389
47840,1,512,512,512.00,0.00,37388,37389
47841,1,512,512,512.00,0.00,37388,37389
47842,1,512,512,512.00,0.00,37388,37389
47843,1,512,512,512.00,0.00,37388,37389
47844,3,345,4,170.67,19409.56,37388,37391
47845,1,512,512,512.00,0.00,37390,37391
47846,1,512,512,512.00,0.00,37390,37391
47847,2,299,213,256.00,1849.00,37390,37392
47848,2,454,58,256.00,39204.00,37391,37393
47849,2,266,246,256.00,100.00,37392,37394
47850,1,512,512,512.00,0.00,37393,37394
47851,1,512,512,512.00,0.00,37393,37394
47852,1,512,512,512.00,0.00,37393,37394
47853,7,295,1,73.14,10498.12,37393,37400
47854,1,512,512,512.00,0.00,37399,37400
47855,1,512,512,512.00,0.00,37399,37400
47856,2,507,5,256.00,63001.00,37399,37401
47857,3,272,2,170.67,14416.89,37400,37403
47858,5,187,3,102.40,4143.84,37402,37407
47859,1,512,512,512.00,0.00,37406,37407
47860,2,337,175,256.00,6561.00,37406,37408
47861,1,512,512,512.00,0.00,37407,37408
47862,1,512,512,512.00,0.00,37407,37408
47863,1,512,512,512.00,0.00,37407,37408
47864,2,499,13,256.00,59049.00,37407,37409
47865,3,358,29,170.67,19082.89,37408,37411
47866,3,221,115,170.67,1886.89,37410,37413
47867,1,512,512,512.00,0.00,37412,37413
47868,1,512,512,512.00,0.00,37412,37413
47869,1,512,512,512.00,0.00,37412,37413
47870,1,512,512,512.00,0.00,37412,37413
47871,4,232,11,128.00,9387.50,37412,37416
47872,1,512,512,512.00,0.00,37415,37416
47873,2,374,138,256.00,13924.00,37415,37417
47874,4,301,1,128.00,11779.50,37416,37420
47875,1,512,512,512.00,0.00,37419,37420
47876,1,512,512,512.00,0.00,37419,37420
47877,4,354,4,128.00,18795.50,37419,37423
47878,1,512,512,512.00,0.00,37422,37423
47879,1,512,512,512.00,0.00,37422,37423
47880,3,313,84,170.67,10289.56,37422,37425
47881,2,441,71,256.00,34225.00,37424,37426
47882,2,381,131,256.00,15625.00,37425,37427
47883,1,512,512,512.00,0.00,37426,37427
47884,2,491,21,256.00,55225.00,37426,37428
47885,2,471,41,256.00,46225.00,37427,37429
47886,1,512,512,512.00,0.00,37428,37429
47887,1,512,512,512.00,0.00,37428,37429
47888,1,512,512,512.00,0.00,37428,37429
47889,2,271,241,256.00,225.00,37428,37430
47890,1,512,512,512.00,0.00,37429,37430
47891,2,274,238,256.00,324.00,37429,37431
47892,1,512,512,512.00,0.00,37430,37431
47893,3,432,30,170.67,34214.22,37430,37433
47894,4,437,1,128.00,32523.50,37432,37436
47895,1,512,512,512.00,0.00,37435,37436
47896,2,356,156,256.00,10000.00,37435,37437
47897,1,512,512,512.00,0.00,37436,37437
47898,2,291,221,256.00,1225.00,37436,37438
47899,1,512,512,512.00,0.00,37437,37438
47900,1,512,512,512.00,0.00,37437,37438
47901,1,512,512,512.00,0.00,37437,37438
47902,1,512,512,512.00,0.00,37437,37438
47903,1,512,512,512.00,0.00,37437,37438
47904,1,512,512,512.00,0.00,37437,37438
47905,1,512,512,512.00,0.00,37437,37438
47906,3,206,107,170.67,2034.89,37437,37440
47907,1,512,512,512.00,0.00,37439,37440
47908,1,512,512,512.00,0.00,37439,37440
47909,1,512,512,512.00,0.00,37439,37440
47910,9,281,1,56.89,7243.43,37439,37448
47911,1,512,512,512.00,0.00,37447,37448
47912,3,486,2,170.67,49798.22,37447,37450
47913,2,449,63,256.00,37249.00,37449,37451
47914,1,512,512,512.00,0.00,37450,37451
47915,1,512,512,512.00,0.00,37450,37451
47916,1,512,512,512.00,0.00,37450,37451
47917,1,512,512,512.00,0.00,37450,37451
47918,1,512,512,512.00,0.00,37450,37451
47919,2,341,171,256.00,7225.00,37450,37452
47920,1,512,512,512.00,0.00,37451,37452
47921,1,512,512,512.00,0.00,37451,37452
47922,1,512,512,512.00,0.00,37451,37452
47923,1,512,512,512.00,0.00,37451,37452
47924,1,512,512,512.00,0.00,37451,37452
47925,3,353,9,170.67,19936.22,37451,37454
47926,3,375,57,170.67,20964.22,37453,37456
47927,2,428,84,256.00,29584.00,37455,37457
47928,1,512,512,512.00,0.00,37456,37457
47929,1,512,512,512.00,0.00,37456,37457
47930,3,312,2,170.67,16390.22,37456,37459
47931,1,512,512,512.00,0.00,37458,37459
47932,2,405,107,256.00,22201.00,37458,37460
47933,1,512,512,512.00,0.00,37459,37460
47934,4,186,1,128.00,5489.50,37459,37463
47935,4,340,7,128.00,18076.50,37462,37466
47936,1,512,512,512.00,0.00,37465,37466
47937,1,512,512,512.00,0.00,37465,37466
47938,1,512,512,512.00,0.00,37465,37466
47939,1,512,512,512.00,0.00,37465,37466
47940,1,512,512,512.00,0.00,37465,37466
47941,1,512,512,512.00,0.00,37465,37466
47942,2,423,89,256.00,27889.00,37465,37467
47943,1,512,512,512.00,0.00,37466,37467
47944,1,512,512,512.00,0.00,37466,37467
47945,1,512,512,512.00,0.00,37466,37467
47946,3,292,88,170.67,7683.56,37466,37469
47947,1,512,512,512.00,0.00,37468,37469
47948,1,512,512,512.00,0.00,37468,37469
47949,1,512,512,512.00,0.00,37468,37469
47950,3,337,3,170.67,18593.56,37468,37471
47951,1,512,512,512.00,0.00,37470,37471
47952,4,379,7,128.00,21583.50,37470,37474
47953,2,430,82,256.00,30276.00,37473,37475
47954,1,512,512,512.00,0.00,37474,37475
47955,1,512,512,512.00,0.00,37474,37475
47956,7,162,6,73.14,2310.41,37474,37481
47957,1,512,512,512.00,0.00,37480,37481
47958,3,335,34,170.67,15482.89,37480,37483
47959,1,512,512,512.00,0.00,37482,37483
47960,2,257,255,256.00,1.00,37482,37484
47961,1,512,512,512.00,0.00,37483,37484
47962,1,512,512,512.00,0.00,37483,37484
47963,2,506,6,256.00,62500.00,37483,37485
47964,1,512,512,512.00,0.00,37484,37485
47965,1,512,512,512.00,0.00,37484,37485
47966,2,499,13,256.00,59049.00,37484,37486
47967,5,189,29,102.40,3432.64,37485,37490
47968,1,512,512,512.00,0.00,37489,37490
47969,1,512,512,512.00,0.00,37489,37490
47970,1,512,512,512.00,0.00,37489,37490
47971,3,237,73,170.67,4973.56,37489,37492
47972,2,276,236,256.00,400.00,37491,37493
47973,1,512,512,512.00,0.00,37492,37493
47974,2,455,57,256.00,39601.00,37492,37494
47975,4,438,5,128.00,32584.50,37493,37497
47976,2,331,181,256.00,5625.00,37496,37498
47977,1,512,512,512.00,0.00,37497,37498
47978,1,512,512,512.00,0.00,37497,37498
47979,4,324,3,128.00,15268.50,37497,37501
47980,2,317,195,256.00,3721.00,37500,37502
47981,1,512,512,512.00,0.00,37501,37502
47982,1,512,512,512.00,0.00,37501,37502
47983,1,512,512,512.00,0.00,37501,37502
47984,1,512,512,512.00,0.00,37501,37502
47985,1,512,512,512.00,0.00,37501,37502
47986,2,316,196,256.00,3600.00,37501,37503
47987,1,512,512,512.00,0.00,37502,37503
47988,7,174,1,73.14,6210.98,37502,37509
47989,2,344,168,256.00,7744.00,37508,37510
47990,1,512,512,512.00,0.00,37509,37510
47991,1,512,512,512.00,0.00,37509,37510
47992,1,512,512,512.00,0.00,37509,37510
47993,1,512,512,512.00,0.00,37509,37510
47994,4,291,3,128.00,15053.50,37509,37513
47995,4,390,1,128.00,24902.50,37512,37516
47996,1,512,512,512.00,0.00,37515,37516
47997,2,345,167,256.00,7921.00,37515,37517
47998,3,332,4,170.67,17944.89,37516,37519
47999,1,512,512,512.00,0.00,37518,37519
48000,1,512,512,512.00,0.00,37518,37519
48001,6,229,1,85.33,7790.22,37518,37524
48002,3,402,1,170.67,28701.56,37523,37526
48003,2,495,17,256.00,57121.00,37525,37527
48004,1,512,512,512.00,0.00,37526,37527
48005,1,512,512,512.00,0.00,37526,37527
48006,1,512,512,512.00,0.00,37526,37527
48007,1,512,512,512.00,0.00,37526,37527
48008,5,250,2,102.40,8611.84,37526,37531
48009,1,512,512,512.00,0.00,37530,37531
48010,1,512,512,512.00,0.00,37530,37531
48011,1,512,512,512.00,0.00,37530,37531
48012,3,178,158,170.67,80.89,37530,37533
48013,1,512,512,512.00,0.00,37532,37533
48014,1,512,512,512.00,0.00,37532,37533
48015,1,512,512,512.00,0.00,37532,37533
48016,1,512,512,512.00,0.00,37532,37533
48017,2,257,255,256.00,1.00,37532,37534
48018,3,334,52,170.67,14251.56,37533,37536
48019,1,512,512,512.00,0.00,37535,37536
48020,3,304,2,170.67,15824.89,37535,37538
48021,1,512,512,512.00,0.00,37537,37538
48022,1,512,512,512.00,0.00,37537,37538
48023,1,512,512,512.00,0.00,37537,37538
48024,2,478,34,256.00,49284.00,37537,37539
48025,1,512,512,512.00,0.00,37538,37539
48026,6,187,4,85.33,5837.89,37538,37544
48027,1,512,512,512.00,0.00,37543,37544
48028,2,410,102,256.00,23716.00,37543,37545
48029,1,512,512,512.00,0.00,37544,37545
48030,1,512,512,512.00,0.00,37544,37545
48031,1,512,512,512.00,0.00,37544,37545
48032,4,492,4,128.00,44170.00,37544,37548
48033,7,204,1,73.14,4990.69,37547,37554
48034,4,411,16,128.00,26891.50,37553,37557
48035,1,512,512,512.00,0.00,37556,37557
48036,1,512,512,512.00,0.00,37556,37557
48037,2,509,3,256.00,64009.00,37556,37558
48038,1,512,512,512.00,0.00,37557,37558
48039,2,414,98,256.00,24964.00,37557,37559
48040,3,402,38,170.67,26950.22,37558,37561
48041,3,415,19,170.67,30429.56,37560,37563
48042,2,499,13,256.00,59049.00,37562,37564
48043,2,433,79,256.00,31329.00,37563,37565
48044,4,210,78,128.00,2798.50,37564,37568
48045,1,512,512,512.00,0.00,37567,37568
48046,1,512,512,512.00,0.00,37567,37568
48047,1,512,512,512.00,0.00,37567,37568
48048,1,512,512,512.00,0.00,37567,37568
48049,1,512,512,512.00,0.00,37567,37568
48050,1,512,512,512.00,0.00,37567,37568
48051,1,512,512,512.00,0.00,37567,37568
48052,1,512,512,512.00,0.00,37567,37568
48053,1,512,512,512.00,0.00,37567,37568
48054,1,512,512,512.00,0.00,37567,37568
48055,1,512,512,512.00,0.00,37567,37568
48056,2,426,86,256.00,28900.00,37567,37569
48057,1,512,512,512.00,0.00,37568,37569
48058,4,244,9,128.00,7311.50,37568,37572
48059,1,512,512,512.00,0.00,37571,37572
48060,3,284,7,170.67,14054.89,37571,37574
48061,4,221,3,128.00,8057.00,37573,37577
48062,4,186,1,128.00,5534.50,37576,37580
48063,2,440,72,256.00,33856.00,37579,37581
48064,2,299,213,256.00,1849.00,37580,37582
48065,1,512,512,512.00,0.00,37581,37582
48066,3,359,27,170.67,19368.22,37581,37584
48067,2,334,178,256.00,6084.00,37583,37585
48068,1,512,512,512.00,0.00,37584,37585
48069,1,512,512,512.00,0.00,37584,37585
48070,2,462,50,256.00,42436.00,37584,37586
48071,3,476,14,170.67,46624.89,37585,37588
48072,1,512,512,512.00,0.00,37587,37588
48073,1,512,512,512.00,0.00,37587,37588
48074,5,138,86,102.40,349.04,37587,37592
48075,1,512,512,512.00,0.00,37591,37592
48076,1,512,512,512.00,0.00,37591,37592
48077,3,329,3,170.67,17756.22,37591,37594
48078,2,319,193,256.00,3969.00,37593,37595
48079,1,512,512,512.00,0.00,37594,37595
48080,1,512,512,512.00,0.00,37594,37595
48081,1,512,512,512.00,0.00,37594,37595
48082,3,207,123,170.67,1240.22,37594,37597
48083,1,512,512,512.00,0.00,37596,37597
48084,1,512,512,512.00,0.00,37596,37597
48085,4,256,27,128.00,6738.50,37596,37600
48086,1,512,512,512.00,0.00,37599,37600
48087,2,343,169,256.00,7569.00,37599,37601
48088,2,465,47,256.00,43681.00,37600,37602
48089,5,395,1,102.40,22473.44,37601,37606
48090,1,512,512,512.00,0.00,37605,37606
48091,1,512,512,512.00,0.00,37605,37606
48092,1,512,512,512.00,0.00,37605,37606
48093,1,512,512,512.00,0.00,37605,37606
48094,1,512,512,512.00,0.00,37605,37606
48095,2,425,87,256.00,28561.00,37605,37607
48096,3,181,161,170.67,66.89,37606,37609
48097,2,347,165,256.00,8281.00,37608,37610
48098,1,512,512,512.00,0.00,37609,37610
48099,2,368,144,256.00,12544.00,37609,37611
48100,1,512,512,512.00,0.00,37610,37611
48101,3,396,10,170.67,26923.56,37610,37613
48102,1,512,512,512.00,0.00,37612,37613
48103,5,306,1,102.40,11135.04,37612,37617
48104,1,512,512,512.00,0.00,37616,37617
48105,1,512,512,512.00,0.00,37616,37617
48106,2,349,163,256.00,8649.00,37616,37618
48107,1,512,512,512.00,0.00,37617,37618
48108,1,512,512,512.00,0.00,37617,37618
48109,1,512,512,512.00,0.00,37617,37618
48110,1,512,512,512.00,0.00,37617,37618
48111,4,267,4,128.00,9482.50,37617,37621
48112,1,512,512,512.00,0.00,37620,37621
48113,2,433,79,256.00,31329.00,37620,37622
48114,1,512,512,512.00,0.00,37621,37622
48115,3,315,77,170.67,10724.22,37621,37624
48116,3,439,2,170.67,36794.89,37623,37626
48117,1,512,512,512.00,0.00,37625,37626
48118,1,512,512,512.00,0.00,37625,37626
48119,1,512,512,512.00,0.00,37625,37626
48120,1,512,512,512.00,0.00,37625,37626
48121,1,512,512,512.00,0.00,37625,37626
48122,4,266,5,128.00,14349.50,37625,37629
48123,2,329,183,256.00,5329.00,37628,37630
48124,5,440,4,102.40,28753.84,37629,37634
48125,1,512,512,512.00,0.00,37633,37634
48126,1,512,512,512.00,0.00,37633,37634
48127,1,512,512,512.00,0.00,37633,37634
48128,1,512,512,512.00,0.00,37633,37634
48129,3,407,35,170.67,28130.89,37633,37636
48130,2,369,143,256.00,12769.00,37635,37637
48131,2,432,80,256.00,30976.00,37636,37638
48132,2,402,110,256.00,21316.00,37637,37639
48133,1,512,512,512.00,0.00,37638,37639
48134,1,512,512,512.00,0.00,37638,37639
48135,1,512,512,512.00,0.00,37638,37639
48136,4,372,1,128.00,21188.50,37638,37642
48137,3,433,21,170.67,34637.56,37641,37644
48138,1,512,512,512.00,0.00,37643,37644
48139,1,512,512,512.00,0.00,37643,37644
48140,3,427,5,170.67,33790.89,37643,37646
48141,1,512,512,512.00,0.00,37645,37646
48142,2,279,233,256.00,529.00,37645,37647
48143,2,276,236,256.00,400.00,37646,37648
48144,1,512,512,512.00,0.00,37647,37648
48145,1,512,512,512.00,0.00,37647,37648
48146,2,426,86,256.00,28900.00,37647,37649
48147,3,503,4,170.67,55222.89,37648,37651
48148,2,266,246,256.00,100.00,37650,37652
48149,1,512,512,512.00,0.00,37651,37652
48150,1,512,512,512.00,0.00,37651,37652
48151,1,512,512,512.00,0.00,37651,37652
48152,2,465,47,256.00,43681.00,37651,37653
48153,1,512,512,512.00,0.00,37652,37653
48154,2,400,112,256.00,20736.00,37652,37654
48155,5,240,2,102.40,9736.64,37653,37658
48156,1,512,512,512.00,0.00,37657,37658
48157,3,366,1,170.67,22533.56,37657,37660
48158,2,417,95,256.00,25921.00,37659,37661
48159,1,512,512,512.00,0.00,37660,37661
48160,1,512,512,512.00,0.00,37660,37661
48161,1,512,512,512.00,0.00,37660,37661
48162,1,512,512,512.00,0.00,37660,37661
48163,1,512,512,512.00,0.00,37660,37661
48164,7,310,1,73.14,11667.84,37660,37667
48165,1,512,512,512.00,0.00,37666,37667
48166,2,369,143,256.00,12769.00,37666,37668
48167,2,483,29,256.00,51529.00,37667,37669
48168,1,512,512,512.00,0.00,37668,37669
48169,1,512,512,512.00,0.00,37668,37669
48170,3,316,36,170.67,13123.56,37668,37671
48171,1,512,512,512.00,0.00,37670,37671
48172,2,400,112,256.00,20736.00,37670,37672
48173,2,471,41,256.00,46225.00,37671,37673
48174,3,294,64,170.67,8955.56,37672,37675
48175,2,465,47,256.00,43681.00,37674,37676
48176,4,399,1,128.00,25129.00,37675,37679
48177,1,512,512,512.00,0.00,37678,37679
48178,1,512,512,512.00,0.00,37678,37679
48179,1,512,512,512.00,0.00,37678,37679
48180,1,512,512,512.00,0.00,37678,37679
48181,1,512,512,512.00,0.00,37678,37679
48182,2,460,52,256.00,41616.00,37678,37680
48183,1,512,512,512.00,0.00,37679,37680
48184,1,512,512,512.00,0.00,37679,37680
48185,2,411,101,256.00,24025.00,37679,37681
48186,9,242,1,56.89,6061.43,37680,37689
48187,2,431,81,256.00,30625.00,37688,37690
48188,2,275,237,256.00,361.00,37689,37691
48189,2,501,11,256.00,60025.00,37690,37692
48190,1,512,512,512.00,0.00,37691,37692
48191,1,512,512,512.00,0.00,37691,37692
48192,1,512,512,512.00,0.00,37691,37692
48193,1,512,512,512.00,0.00,37691,37692
48194,1,512,512,512.00,0.00,37691,37692
48195,5,252,5,102.40,13306.64,37691,37696
48196,1,512,512,512.00,0.00,37695,37696
48197,1,512,512,512.00,0.00,37695,37696
48198,1,512,512,512.00,0.00,37695,37696
48199,2,454,58,256.00,39204.00,37695,37697
48200,2,478,34,256.00,49284.00,37696,37698
48201,1,512,512,512.00,0.00,37697,37698
48202,6,308,3,85.33,10548.22,37697,37703
48203,3,304,5,170.67,15422.89,37702,37705
48204,5,337,11,102.40,14762.24,37704,37709
48205,1,512,512,512.00,0.00,37708,37709
48206,2,447,65,256.00,36481.00,37708,37710
48207,1,512,512,512.00,0.00,37709,37710
48208,3,451,18,170.67,39397.56,37709,37712
48209,1,512,512,512.00,0.00,37711,37712
48210,1,512,512,512.00,0.00,37711,37712
48211,1,512,512,512.00,0.00,37711,37712
48212,7,140,1,73.14,2190.41,37711,37718
48213,1,512,512,512.00,0.00,37717,37718
48214,1,512,512,512.00,0.00,37717,37718
48215,2,260,252,256.00,16.00,37717,37719
48216,2,460,52,256.00,41616.00,37718,37720
48217,1,512,512,512.00,0.00,37719,37720
48218,2,436,76,256.00,32400.00,37719,37721
48219,1,512,512,512.00,0.00,37720,37721
48220,2,450,62,256.00,37636.00,37720,37722
48221,1,512,512,512.00,0.00,37721,37722
48222,1,512,512,512.00,0.00,37721,37722
48223,1,512,512,512.00,0.00,37721,37722
48224,2,449,63,256.00,37249.00,37721,37723
48225,1,512,512,512.00,0.00,37722,37723
48226,1,512,512,512.00,0.00,37722,37723
48227,1,512,512,512.00,0.00,37722,37723
48228,2,346,166,256.00,8100.00,37722,37724
48229,3,366,23,170.67,20744.22,37723,37726
48230,5,246,4,102.40,7994.64,37725,37730
48231,1,512,512,512.00,0.00,37729,37730
48232,1,512,512,512.00,0.00,37729,37730
48233,1,512,512,512.00,0.00,37729,37730
48234,2,409,103,256.00,23409.00,37729,37731
48235,1,512,512,512.00,0.00,37730,37731
48236,1,512,512,512.00,0.00,37730,37731
48237,2,387,125,256.00,17161.00,37730,37732
48238,2,379,133,256.00,15129.00,37731,37733
48239,1,512,512,512.00,0.00,37732,37733
48240,1,512,512,512.00,0.00,37732,37733
48241,1,512,512,512.00,0.00,37732,37733
48242,1,512,512,512.00,0.00,37732,37733
48243,1,512,512,512.00,0.00,37732,37733
48244,1,512,512,512.00,0.00,37732,37733
48245,1,512,512,512.00,0.00,37732,37733
48246,2,358,154,256.00,10404.00,37732,37734
48247,1,512,512,512.00,0.00,37733,37734
48248,1,512,512,512.00,0.00,37733,37734
48249,1,512,512,512.00,0.00,37733,37734
48250,5,341,2,102.40,16676.24,37733,37738
48251,1,512,512,512.00,0.00,37737,37738
48252,1,512,512,512.00,0.00,37737,37738
48253,1,512,512,512.00,0.00,37737,37738
48254,1,512,512,512.00,0.00,37737,37738
48255,1,512,512,512.00,0.00,37737,37738
48256,4,375,1,128.00,22652.50,37737,37741
48257,1,512,512,512.00,0.00,37740,37741
48258,1,512,512,512.00,0.00,37740,37741
48259,3,336,2,170.67,18598.22,37740,37743
48260,1,512,512,512.00,0.00,37742,37743
48261,1,512,512,512.00,0.00,37742,37743
48262,1,512,512,512.00,0.00,37742,37743
48263,2,492,20,256.00,55696.00,37742,37744
48264,1,512,512,512.00,0.00,37743,37744
48265,1,512,512,512.00,0.00,37743,37744
48266,2,351,161,256.00,9025.00,37743,37745
48267,2,501,11,256.00,60025.00,37744,37746
48268,4,171,14,128.00,4351.50,37745,37749
48269,1,512,512,512.00,0.00,37748,37749
48270,1,512,512,512.00,0.00,37748,37749
48271,1,512,512,512.00,0.00,37748,37749
48272,2,486,26,256.00,52900.00,37748,37750
48273,3,478,9,170.67,47269.56,37749,37752
48274,4,259,2,128.00,14040.50,37751,37755
48275,3,355,18,170.67,19429.56,37754,37757
48276,7,130,13,73.14,1915.84,37756,37763
48277,2,483,29,256.00,51529.00,37762,37764
48278,2,310,202,256.00,2916.00,37763,37765
48279,1,512,512,512.00,0.00,37764,37765
48280,3,326,5,170.67,17226.89,37764,37767
48281,1,512,512,512.00,0.00,37766,37767
48282,3,317,7,170.67,16166.89,37766,37769
48283,5,175,1,102.40,3461.44,37768,37773
48284,1,512,512,512.00,0.00,37772,37773
48285,1,512,512,512.00,0.00,37772,37773
48286,2,358,154,256.00,10404.00,37772,37774
48287,1,512,512,512.00,0.00,37773,37774
48288,1,512,512,512.00,0.00,37773,37774
48289,5,241,3,102.40,8043.84,37773,37778
48290,1,512,512,512.00,0.00,37777,37778
48291,3,319,15,170.67,15429.56,37777,37780
48292,1,512,512,512.00,0.00,37779,37780
48293,3,313,1,170.67,16597.56,37779,37782
48294,1,512,512,512.00,0.00,37781,37782
48295,2,409,103,256.00,23409.00,37781,37783
48296,2,292,220,256.00,1296.00,37782,37784
48297,1,512,512,512.00,0.00,37783,37784
48298,1,512,512,512.00,0.00,37783,37784
48299,1,512,512,512.00,0.00,37783,37784
48300,1,512,512,512.00,0.00,37783,37784
48301,1,512,512,512.00,0.00,37783,37784
48302,1,512,512,512.00,0.00,37783,37784
48303,1,512,512,512.00,0.00,37783,37784
48304,2,404,108,256.00,21904.00,37783,37785
48305,3,205,132,170.67,897.56,37784,37787
48306,1,512,512,512.00,0.00,37786,37787
48307,1,512,512,512.00,0.00,37786,37787
48308,1,512,512,512.00,0.00,37786,37787
48309,1,512,512,512.00,0.00,37786,37787
48310,1,512,512,512.00,0.00,37786,37787
48311,1,512,512,512.00,0.00,37786,37787
48312,1,512,512,512.00,0.00,37786,37787
48313,2,256,256,256.00,0.00,37786,37788
48314,1,512,512,512.00,0.00,37787,37788
48315,2,422,90,256.00,27556.00,37787,37789
48316,5,224,27,102.40,5449.04,37788,37793
48317,1,512,512,512.00,0.00,37792,37793
48318,4,300,1,128.00,13761.50,37792,37796
48319,1,512,512,512.00,0.00,37795,37796
48320,1,512,512,512.00,0.00,37795,37796
48321,1,512,512,512.00,0.00,37795,37796
48322,1,512,512,512.00,0.00,37795,37796
48323,1,512,512,512.00,0.00,37795,37796
48324,1,512,512,512.00,0.00,37795,37796
48325,1,512,512,512.00,0.00,37795,37796
48326,3,410,12,170.67,29654.22,37795,37798
48327,2,278,234,256.00,484.00,37797,37799
48328,1,512,512,512.00,0.00,37798,37799
48329,2,273,239,256.00,289.00,37798,37800
48330,1,512,512,512.00,0.00,37799,37800
48331,1,512,512,512.00,0.00,37799,37800
48332,1,512,512,512.00,0.00,37799,37800
48333,3,324,53,170.67,12876.22,37799,37802
48334,2,446,66,256.00,36100.00,37801,37803
48335,1,512,512,512.00,0.00,37802,37803
48336,2,383,129,256.00,16129.00,37802,37804
48337,1,512,512,512.00,0.00,37803,37804
48338,3,399,39,170.67,26272.22,37803,37806
48339,1,512,512,512.00,0.00,37805,37806
48340,1,512,512,512.00,0.00,37805,37806
48341,1,512,512,512.00,0.00,37805,37806
48342,3,295,98,170.67,7802.89,37805,37808
48343,1,512,512,512.00,0.00,37807,37808
48344,2,455,57,256.00,39601.00,37807,37809
48345,1,512,512,512.00,0.00,37808,37809
48346,4,226,24,128.00,9159.50,37808,37812
48347,1,512,512,512.00,0.00,37811,37812
48348,5,360,3,102.40,16928.24,37811,37816
48349,1,512,512,512.00,0.00,37815,37816
48350,1,512,512,512.00,0.00,37815,37816
48351,1,512,512,512.00,0.00,37815,37816
48352,2,480,32,256.00,50176.00,37815,37817
48353,3,365,8,170.67,21742.89,37816,37819
48354,1,512,512,512.00,0.00,37818,37819
48355,4,322,17,128.00,13371.50,37818,37822
48356,1,512,512,512.00,0.00,37821,37822
48357,3,487,4,170.67,50081.56,37821,37824
48358,3,452,25,170.67,39590.89,37823,37826
48359,5,452,1,102.40,30806.24,37825,37830
48360,1,512,512,512.00,0.00,37829,37830
48361,1,512,512,512.00,0.00,37829,37830
48362,1,512,512,512.00,0.00,37829,37830
48363,1,512,512,512.00,0.00,37829,37830
48364,7,325,1,73.14,11862.41,37829,37836
48365,2,511,1,256.00,65025.00,37835,37837
48366,1,512,512,512.00,0.00,37836,37837
48367,2,475,37,256.00,47961.00,37836,37838
48368,4,353,1,128.00,20201.00,37837,37841
48369,1,512,512,512.00,0.00,37840,37841
48370,3,257,38,170.67,9066.89,37840,37843
48371,1,512,512,512.00,0.00,37842,37843
48372,1,512,512,512.00,0.00,37842,37843
48373,1,512,512,512.00,0.00,37842,37843
48374,1,512,512,512.00,0.00,37842,37843
48375,1,512,512,512.00,0.00,37842,37843
48376,1,512,512,512.00,0.00,37842,37843
48377,1,512,512,512.00,0.00,37842,37843
48378,2,421,91,256.00,27225.00,37842,37844
48379,2,508,4,256.00,63504.00,37843,37845
48380,1,512,512,512.00,0.00,37844,37845
48381,1,512,512,512.00,0.00,37844,37845
48382,1,512,512,512.00,0.00,37844,37845
48383,1,512,512,512.00,0.00,37844,37845
48384,5,387,1,102.40,22166.24,37844,37849
48385,1,512,512,512.00,0.00,37848,37849
48386,1,512,512,512.00,0.00,37848,37849
48387,1,512,512,512.00,0.00,37848,37849
48388,2,421,91,256.00,27225.00,37848,37850
48389,1,512,512,512.00,0.00,37849,37850
48390,2,487,25,256.00,53361.00,37849,37851
48391,1,512,512,512.00,0.00,37850,37851
48392,2,295,217,256.00,1521.00,37850,37852
48393,1,512,512,512.00,0.00,37851,37852
48394,1,512,512,512.00,0.00,37851,37852
48395,1,512,512,512.00,0.00,37851,37852
48396,2,386,126,256.00,16900.00,37851,37853
48397,1,512,512,512.00,0.00,37852,37853
48398,3,372,1,170.67,23441.56,37852,37855
48399,3,341,32,170.67,16414.89,37854,37857
48400,2,459,53,256.00,41209.00,37856,37858
48401,4,279,3,128.00,12003.00,37857,37861
48402,5,236,1,102.40,6582.24,37860,37865
48403,1,512,512,512.00,0.00,37864,37865
48404,1,512,512,512.00,0.00,37864,37865
48405,1,512,512,512.00,0.00,37864,37865
48406,2,343,169,256.00,7569.00,37864,37866
48407,2,471,41,256.00,46225.00,37865,37867
48408,1,512,512,512.00,0.00,37866,37867
48409,1,512,512,512.00,0.00,37866,37867
48410,1,512,512,512.00,0.00,37866,37867
48411,2,383,129,256.00,16129.00,37866,37868
48412,1,512,512,512.00,0.00,37867,37868
48413,2,349,163,256.00,8649.00,37867,37869
48414,3,237,80,170.67,4404.22,37868,37871
48415,6,163,1,85.33,5028.89,37870,37876
48416,1,512,512,512.00,0.00,37875,37876
48417,2,486,26,256.00,52900.00,37875,37877
48418,1,512,512,512.00,0.00,37876,37877
48419,2,323,189,256.00,4489.00,37876,37878
48420,2,332,180,256.00,5776.00,37877,37879
48421,1,512,512,512.00,0.00,37878,37879
48422,1,512,512,512.00,0.00,37878,37879
48423,2,511,1,256.00,65025.00,37878,37880
48424,1,512,512,512.00,0.00,37879,37880
48425,3,428,41,170.67,33110.89,37879,37882
48426,1,512,512,512.00,0.00,37881,37882
48427,1,512,512,512.00,0.00,37881,37882
48428,1,512,512,512.00,0.00,37881,37882
48429,2,283,229,256.00,729.00,37881,37883
48430,2,401,111,256.00,21025.00,37882,37884
48431,2,260,252,256.00,16.00,37883,37885
48432,2,389,123,256.00,17689.00,37884,37886
48433,7,281,1,73.14,8986.69,37885,37892
48434,2,441,71,256.00,34225.00,37891,37893
48435,3,292,104,170.67,7384.89,37892,37895
48436,1,512,512,512.00,0.00,37894,37895
48437,1,512,512,512.00,0.00,37894,37895
48438,1,512,512,512.00,0.00,37894,37895
48439,2,446,66,256.00,36100.00,37894,37896
48440,1,512,512,512.00,0.00,37895,37896
48441,9,289,4,56.89,7011.43,37895,37904
48442,2,324,188,256.00,4624.00,37903,37905
48443,2,473,39,256.00,47089.00,37904,37906
48444,1,512,512,512.00,0.00,37905,37906
48445,1,512,512,512.00,0.00,37905,37906
48446,3,275,41,170.67,9446.89,37905,37908
48447,1,512,512,512.00,0.00,37907,37908
48448,1,512,512,512.00,0.00,37907,37908
48449,1,512,512,512.00,0.00,37907,37908
48450,1,512,512,512.00,0.00,37907,37908
48451,1,512,512,512.00,0.00,37907,37908
48452,6,388,1,85.33,18963.89,37907,37913
48453,2,273,239,256.00,289.00,37912,37914
48454,1,512,512,512.00,0.00,37913,37914
48455,1,512,512,512.00,0.00,37913,37914
48456,1,512,512,512.00,0.00,37913,37914
48457,1,512,512,512.00,0.00,37913,37914
48458,1,512,512,512.00,0.00,37913,37914
48459,1,512,512,512.00,0.00,37913,37914
48460,2,319,193,256.00,3969.00,37913,37915
48461,2,317,195,256.00,3721.00,37914,37916
48462,1,512,512,512.00,0.00,37915,37916
48463,1,512,512,512.00,0.00,37915,37916
48464,1,512,512,512.00,0.00,37915,37916
48465,2,290,222,256.00,1156.00,37915,37917
48466,2,327,185,256.00,5041.00,37916,37918
48467,2,299,213,256.00,1849.00,37917,37919
48468,1,512,512,512.00,0.00,37918,37919
48469,2,463,49,256.00,42849.00,37918,37920
48470,3,238,113,170.67,2650.89,37919,37922
48471,2,484,28,256.00,51984.00,37921,37923
48472,1,512,512,512.00,0.00,37922,37923
48473,1,512,512,512.00,0.00,37922,37923
48474,4,232,1,128.00,10372.50,37922,37926
48475,1,512,512,512.00,0.00,37925,37926
48476,4,306,2,128.00,12240.50,37925,37929
48477,4,442,3,128.00,33455.50,37928,37932
48478,1,512,512,512.00,0.00,37931,37932
48479,1,512,512,512.00,0.00,37931,37932
48480,1,512,512,512.00,0.00,37931,37932
48481,1,512,512,512.00,0.00,37931,37932
48482,1,512,512,512.00,0.00,37931,37932
48483,1,512,512,512.00,0.00,37931,37932
48484,3,466,3,170.67,43877.56,37931,37934
48485,3,348,74,170.67,15766.22,37933,37936
48486,1,512,512,512.00,0.00,37935,37936
48487,1,512,512,512.00,0.00,37935,37936
48488,2,337,175,256.00,6561.00,37935,37937
48489,1,512,512,512.00,0.00,37936,37937
48490,2,487,25,256.00,53361.00,37936,37938
48491,1,512,512,512.00,0.00,37937,37938
48492,3,392,43,170.67,24686.89,37937,37940
48493,4,265,2,128.00,11836.50,37939,37943
48494,2,389,123,256.00,17689.00,37942,37944
48495,1,512,512,512.00,0.00,37943,37944
48496,1,512,512,512.00,0.00,37943,37944
48497,1,512,512,512.00,0.00,37943,37944
48498,1,512,512,512.00,0.00,37943,37944
48499,3,418,6,170.67,31707.56,37943,37946
48500,1,512,512,512.00,0.00,37945,37946
48501,1,512,512,512.00,0.00,37945,37946
48502,1,512,512,512.00,0.00,37945,37946
48503,3,367,36,170.67,20161.56,37945,37948
48504,1,512,512,512.00,0.00,37947,37948
48505,1,512,512,512.00,0.00,37947,37948
48506,3,343,28,170.67,16977.56,37947,37950
48507,4,265,47,128.00,6724.50,37949,37953
48508,1,512,512,512.00,0.00,37952,37953
48509,1,512,512,512.00,0.00,37952,37953
48510,6,335,7,85.33,14192.89,37952,37958
48511,1,512,512,512.00,0.00,37957,37958
48512,1,512,512,512.00,0.00,37957,37958
48513,1,512,512,512.00,0.00,37957,37958
48514,2,381,131,256.00,15625.00,37957,37959
48515,3,429,26,170.67,33528.22,37958,37961
48516,1,512,512,512.00,0.00,37960,37961
48517,1,512,512,512.00,0.00,37960,37961
48518,2,468,44,256.00,44944.00,37960,37962
48519,1,512,512,512.00,0.00,37961,37962
48520,1,512,512,512.00,0.00,37961,37962
48521,1,512,512,512.00,0.00,37961,37962
48522,1,512,512,512.00,0.00,37961,37962
48523,1,512,512,512.00,0.00,37961,37962
48524,2,299,213,256.00,1849.00,37961,37963
48525,1,512,512,512.00,0.00,37962,37963
48526,2,405,107,256.00,22201.00,37962,37964
48527,1,512,512,512.00,0.00,37963,37964
48528,1,512,512,512.00,0.00,37963,37964
48529,1,512,512,512.00,0.00,37963,37964
48530,1,512,512,512.00,0.00,37963,37964
48531,1,512,512,512.00,0.00,37963,37964
48532,1,512,512,512.00,0.00,37963,37964
48533,1,512,512,512.00,0.00,37963,37964
48534,7,175,4,73.14,5137.55,37963,37970
48535,1,512,512,512.00,0.00,37969,37970
48536,3,425,19,170.67,32742.89,37969,37972
48537,1,512,512,512.00,0.00,37971,37972
48538,1,512,512,512.00,0.00,37971,37972
48539,1,512,512,512.00,0.00,37971,37972
48540,1,512,512,512.00,0.00,37971,37972
48541,2,260,252,256.00,16.00,37971,37973
48542,2,422,90,256.00,27556.00,37972,37974
48543,1,512,512,512.00,0.00,37973,37974
48544,1,512,512,512.00,0.00,37973,37974
48545,1,512,512,512.00,0.00,37973,37974
48546,1,512,512,512.00,0.00,37973,37974
48547,2,462,50,256.00,42436.00,37973,37975
48548,1,512,512,512.00,0.00,37974,37975
48549,3,362,16,170.67,20624.89,37974,37977
48550,4,209,31,128.00,5429.00,37976,37980
48551,5,278,16,102.40,8867.44,37979,37984
48552,1,512,512,512.00,0.00,37983,37984
48553,1,512,512,512.00,0.00,37983,37984
48554,1,512,512,512.00,0.00,37983,37984
48555,1,512,512,512.00,0.00,37983,37984
48556,1,512,512,512.00,0.00,37983,37984
48557,1,512,512,512.00,0.00,37983,37984
48558,4,326,1,128.00,14529.50,37983,37987
48559,1,512,512,512.00,0.00,37986,37987
48560,1,512,512,512.00,0.00,37986,37987
48561,1,512,512,512.00,0.00,37986,37987
48562,3,321,77,170.67,11528.22,37986,37989
48563,1,512,512,512.00,0.00,37988,37989
48564,5,193,16,102.40,4321.44,37988,37993
48565,4,338,2,128.00,19156.50,37992,37996
48566,1,512,512,512.00,0.00,37995,37996
48567,1,512,512,512.00,0.00,37995,37996
48568,1,512,512,512.00,0.00,37995,37996
48569,2,306,206,256.00,2500.00,37995,37997
48570,1,512,512,512.00,0.00,37996,37997
48571,1,512,512,512.00,0.00,37996,37997
48572,1,512,512,512.00,0.00,37996,37997
48573,1,512,512,512.00,0.00,37996,37997
48574,1,512,512,512.00,0.00,37996,37997
48575,1,512,512,512.00,0.00,37996,37997
48576,2,495,17,256.00,57121.00,37996,37998
48577,1,512,512,512.00,0.00,37997,37998
48578,1,512,512,512.00,0.00,37997,37998
48579,3,298,1,170.67,15597.56,37997,38000
48580,1,512,512,512.00,0.00,37999,38000
48581,1,512,512,512.00,0.00,37999,38000
48582,5,193,9,102.40,5091.84,37999,38004
48583,1,512,512,512.00,0.00,38003,38004
48584,2,436,76,256.00,32400.00,38003,38005
48585,1,512,512,512.00,0.00,38004,38005
48586,7,254,1,73.14,7086.41,38004,38011
48587,2,487,25,256.00,53361.00,38010,38012
48588,1,512,512,512.00,0.00,38011,38012
48589,3,344,56,170.67,15544.89,38011,38014
48590,1,512,512,512.00,0.00,38013,38014
48591,1,512,512,512.00,0.00,38013,38014
48592,1,512,512,512.00,0.00,38013,38014
48593,1,512,512,512.00,0.00,38013,38014
48594,1,512,512,512.00,0.00,38013,38014
48595,1,512,512,512.00,0.00,38013,38014
48596,1,512,512,512.00,0.00,38013,38014
48597,1,512,512,512.00,0.00,38013,38014
48598,1,512,512,512.00,0.00,38013,38014
48599,1,512,512,512.00,0.00,38013,38014
48600,2,468,44,256.00,44944.00,38013,38015
48601,5,279,1,102.40,9500.64,38014,38019
48602,1,512,512,512.00,0.00,38018,38019
48603,1,512,512,512.00,0.00,38018,38019
48604,1,512,512,512.00,0.00,38018,38019
48605,1,512,512,512.00,0.00,38018,38019
48606,8,292,1,64.00,8164.00,38018,38026
48607,1,512,512,512.00,0.00,38025,38026
48608,5,386,4,102.40,20487.44,38025,38030
48609,2,478,34,256.00,49284.00,38029,38031
48610,1,512,512,512.00,0.00,38030,38031
48611,2,283,229,256.00,729.00,38030,38032
48612,1,512,512,512.00,0.00,38031,38032
48613,1,512,512,512.00,0.00,38031,38032
48614,1,512,512,512.00,0.00,38031,38032
48615,3,327,63,170.67,12800.22,38031,38034
48616,1,512,512,512.00,0.00,38033,38034
48617,2,382,130,256.00,15876.00,38033,38035
48618,1,512,512,512.00,0.00,38034,38035
48619,2,476,36,256.00,48400.00,38034,38036
48620,1,512,512,512.00,0.00,38035,38036
48621,1,512,512,512.00,0.00,38035,38036
48622,2,387,125,256.00,17161.00,38035,38037
48623,1,512,512,512.00,0.00,38036,38037
48624,1,512,512,512.00,0.00,38036,38037
48625,1,512,512,512.00,0.00,38036,38037
48626,4,365,1,128.00,21045.00,38036,38040
48627,1,512,512,512.00,0.00,38039,38040
48628,1,512,512,512.00,0.00,38039,38040
48629,1,512,512,512.00,0.00,38039,38040
48630,1,512,512,512.00,0.00,38039,38040
48631,2,454,58,256.00,39204.00,38039,38041
48632,1,512,512,512.00,0.00,38040,38041
48633,1,512,512,512.00,0.00,38040,38041
48634,1,512,512,512.00,0.00,38040,38041
48635,1,512,512,512.00,0.00,38040,38041
48636,3,494,1,170.67,52314.89,38040,38043
48637,2,437,75,256.00,32761.00,38042,38044
48638,1,512,512,512.00,0.00,38043,38044
48639,1,512,512,512.00,0.00,38043,38044
48640,1,512,512,512.00,0.00,38043,38044
48641,1,512,512,512.00,0.00,38043,38044
48642,4,368,1,128.00,22374.50,38043,38047
48643,6,308,2,85.33,11438.22,38046,38052
48644,1,512,512,512.00,0.00,38051,38052
48645,1,512,512,512.00,0.00,38051,38052
48646,1,512,512,512.00,0.00,38051,38052
48647,1,512,512,512.00,0.00,38051,38052
48648,3,447,1,170.67,38841.56,38051,38054
48649,2,476,36,256.00,48400.00,38053,38055
48650,1,512,512,512.00,0.00,38054,38055
48651,3,398,1,170.67,27930.89,38054,38057
48652,2,386,126,256.00,16900.00,38056,38058
48653,1,512,512,512.00,0.00,38057,38058
48654,1,512,512,512.00,0.00,38057,38058
48655,1,512,512,512.00,0.00,38057,38058
48656,2,467,45,256.00,44521.00,38057,38059
48657,3,327,4,170.67,17441.56,38058,38061
48658,2,351,161,256.00,9025.00,38060,38062
48659,1,512,512,512.00,0.00,38061,38062
48660,1,512,512,512.00,0.00,38061,38062
48661,1,512,512,512.00,0.00,38061,38062
48662,1,512,512,512.00,0.00,38061,38062
48663,1,512,512,512.00,0.00,38061,38062
48664,3,240,102,170.67,3174.22,38061,38064
48665,1,512,512,512.00,0.00,38063,38064
48666,1,512,512,512.00,0.00,38063,38064
48667,1,512,512,512.00,0.00,38063,38064
48668,3,441,2,170.67,37288.22,38063,38066
48669,2,406,106,256.00,22500.00,38065,38067
48670,2,334,178,256.00,6084.00,38066,38068
48671,3,452,24,170.67,39598.22,38067,38070
48672,1,512,512,512.00,0.00,38069,38070
48673,1,512,512,512.00,0.00,38069,38070
48674,1,512,512,512.00,0.00,38069,38070
48675,3,361,33,170.67,19317.56,38069,38072
48676,1,512,512,512.00,0.00,38071,38072
48677,1,512,512,512.00,0.00,38071,38072
48678,2,468,44,256.00,44944.00,38071,38073
48679,1,512,512,512.00,0.00,38072,38073
48680,1,512,512,512.00,0.00,38072,38073
48681,3,290,2,170.67,15040.89,38072,38075
48682,1,512,512,512.00,0.00,38074,38075
48683,1,512,512,512.00,0.00,38074,38075
48684,10,170,1,51.20,2860.36,38074,38084
48685,1,512,512,512.00,0.00,38083,38084
48686,1,512,512,512.00,0.00,38083,38084
48687,1,512,512,512.00,0.00,38083,38084
48688,2,279,233,256.00,529.00,38083,38085
48689,1,512,512,512.00,0.00,38084,38085
48690,1,512,512,512.00,0.00,38084,38085
48691,1,512,512,512.00,0.00,38084,38085
48692,1,512,512,512.00,0.00,38084,38085
48693,2,468,44,256.00,44944.00,38084,38086
48694,2,279,233,256.00,529.00,38085,38087
48695,1,512,512,512.00,0.00,38086,38087
48696,2,275,237,256.00,361.00,38086,38088
48697,1,512,512,512.00,0.00,38087,38088
48698,1,512,512,512.00,0.00,38087,38088
48699,1,512,512,512.00,0.00,38087,38088
48700,7,356,3,73.14,14627.84,38087,38094
48701,1,512,512,512.00,0.00,38093,38094
48702,2,425,87,256.00,28561.00,38093,38095
48703,1,512,512,512.00,0.00,38094,38095
48704,1,512,512,512.00,0.00,38094,38095
48705,1,512,512,512.00,0.00,38094,38095
48706,1,512,512,512.00,0.00,38094,38095
48707,2,383,129,256.00,16129.00,38094,38096
48708,1,512,512,512.00,0.00,38095,38096
48709,1,512,512,512.00,0.00,38095,38096
48710,2,373,139,256.00,13689.00,38095,38097
48711,1,512,512,512.00,0.00,38096,38097
48712,1,512,512,512.00,0.00,38096,38097
48713,1,512,512,512.00,0.00,38096,38097
48714,1,512,512,512.00,0.00,38096,38097
48715,1,512,512,512.00,0.00,38096,38097
48716,3,367,1,170.67,22681.56,38096,38099
48717,1,512,512,512.00,0.00,38098,38099
48718,1,512,512,512.00,0.00,38098,38099
48719,1,512,512,512.00,0.00,38098,38099
48720,1,512,512,512.00,0.00,38098,38099
48721,1,512,512,512.00,0.00,38098,38099
48722,1,512,512,512.00,0.00,38098,38099
48723,1,512,512,512.00,0.00,38098,38099
48724,1,512,512,512.00,0.00,38098,38099
48725,3,250,130,170.67,3147.56,38098,38101
48726,1,512,512,512.00,0.00,38100,38101
48727,2,256,256,256.00,0.00,38100,38102
48728,1,512,512,512.00,0.00,38101,38102
48729,2,295,217,256.00,1521.00,38101,38103
48730,1,512,512,512.00,0.00,38102,38103
48731,3,308,13,170.67,14710.89,38102,38105
48732,4,253,5,128.00,8747.00,38104,38108
48733,1,512,512,512.00,0.00,38107,38108
48734,1,512,512,512.00,0.00,38107,38108
48735,1,512,512,512.00,0.00,38107,38108
48736,3,411,1,170.67,30513.56,38107,38110
48737,1,512,512,512.00,0.00,38109,38110
48738,2,294,218,256.00,1444.00,38109,38111
48739,3,247,105,170.67,3417.56,38110,38113
48740,1,512,512,512.00,0.00,38112,38113
48741,2,334,178,256.00,6084.00,38112,38114
48742,2,286,226,256.00,900.00,38113,38115
48743,1,512,512,512.00,0.00,38114,38115
48744,1,512,512,512.00,0.00,38114,38115
48745,1,512,512,512.00,0.00,38114,38115
48746,2,507,5,256.00,63001.00,38114,38116
48747,1,512,512,512.00,0.00,38115,38116
48748,2,440,72,256.00,33856.00,38115,38117
48749,2,393,119,256.00,18769.00,38116,38118
48750,3,373,2,170.67,23506.89,38117,38120
48751,1,512,512,512.00,0.00,38119,38120
48752,5,248,1,102.40,12588.24,38119,38124
48753,2,433,79,256.00,31329.00,38123,38125
48754,1,512,512,512.00,0.00,38124,38125
48755,1,512,512,512.00,0.00,38124,38125
48756,2,303,209,256.00,2209.00,38124,38126
48757,1,512,512,512.00,0.00,38125,38126
48758,1,512,512,512.00,0.00,38125,38126
48759,2,392,120,256.00,18496.00,38125,38127
48760,6,377,1,85.33,17441.56,38126,38132
48761,2,396,116,256.00,19600.00,38131,38133
48762,1,512,512,512.00,0.00,38132,38133
48763,1,512,512,512.00,0.00,38132,38133
48764,1,512,512,512.00,0.00,38132,38133
48765,1,512,512,512.00,0.00,38132,38133
48766,3,407,4,170.67,29494.89,38132,38135
48767,1,512,512,512.00,0.00,38134,38135
48768,1,512,512,512.00,0.00,38134,38135
48769,1,512,512,512.00,0.00,38134,38135
48770,1,512,512,512.00,0.00,38134,38135
48771,1,512,512,512.00,0.00,38134,38135
48772,1,512,512,512.00,0.00,38134,38135
48773,1,512,512,512.00,0.00,38134,38135
48774,2,472,40,256.00,46656.00,38134,38136
48775,1,512,512,512.00,0.00,38135,38136
48776,1,512,512,512.00,0.00,38135,38136
48777,1,512,512,512.00,0.00,38135,38136
48778,1,512,512,512.00,0.00,38135,38136
48779,1,512,512,512.00,0.00,38135,38136
48780,1,512,512,512.00,0.00,38135,38136
48781,1,512,512,512.00,0.00,38135,38136
48782,1,512,512,512.00,0.00,38135,38136
48783,6,299,9,85.33,11390.89,38135,38141
48784,1,512,512,512.00,0.00,38140,38141
48785,1,512,512,512.00,0.00,38140,38141
48786,1,512,512,512.00,0.00,38140,38141
48787,1,512,512,512.00,0.00,38140,38141
48788,3,296,20,170.67,13016.89,38140,38143
48789,1,512,512,512.00,0.00,38142,38143
48790,1,512,512,512.00,0.00,38142,38143
48791,1,512,512,512.00,0.00,38142,38143
48792,5,284,10,102.40,10495.44,38142,38147
48793,1,512,512,512.00,0.00,38146,38147
48794,1,512,512,512.00,0.00,38146,38147
48795,1,512,512,512.00,0.00,38146,38147
48796,2,400,112,256.00,20736.00,38146,38148
48797,2,324,188,256.00,4624.00,38147,38149
48798,1,512,512,512.00,0.00,38148,38149
48799,1,512,512,512.00,0.00,38148,38149
48800,5,277,1,102.40,10515.04,38148,38153
48801,1,512,512,512.00,0.00,38152,38153
48802,1,512,512,512.00,0.00,38152,38153
48803,1,512,512,512.00,0.00,38152,38153
48804,1,512,512,512.00,0.00,38152,38153
48805,1,512,512,512.00,0.00,38152,38153
48806,1,512,512,512.00,0.00,38152,38153
48807,1,512,512,512.00,0.00,38152,38153
48808,1,512,512,512.00,0.00,38152,38153
48809,1,512,512,512.00,0.00,38152,38153
48810,1,512,512,512.00,0.00,38152,38153
48811,2,376,136,256.00,14400.00,38152,38154
48812,1,512,512,512.00,0.00,38153,38154
48813,1,512,512,512.00,0.00,38153,38154
48814,6,263,3,85.33,7566.22,38153,38159
48815,1,512,512,512.00,0.00,38158,38159
48816,2,414,98,256.00,24964.00,38158,38160
48817,2,380,132,256.00,15376.00,38159,38161
48818,1,512,512,512.00,0.00,38160,38161
48819,1,512,512,512.00,0.00,38160,38161
48820,1,512,512,512.00,0.00,38160,38161
48821,1,512,512,512.00,0.00,38160,38161
48822,3,456,1,170.67,41193.56,38160,38163
48823,3,308,69,170.67,10156.22,38162,38165
48824,1,512,512,512.00,0.00,38164,38165
48825,1,512,512,512.00,0.00,38164,38165
48826,1,512,512,512.00,0.00,38164,38165
48827,6,155,5,85.33,3512.89,38164,38170
48828,1,512,512,512.00,0.00,38169,38170
48829,1,512,512,512.00,0.00,38169,38170
48830,1,512,512,512.00,0.00,38169,38170
48831,5,261,2,102.40,12663.44,38169,38174
48832,1,512,512,512.00,0.00,38173,38174
48833,1,512,512,512.00,0.00,38173,38174
48834,1,512,512,512.00,0.00,38173,38174
48835,4,250,3,128.00,9581.50,38173,38177
48836,1,512,512,512.00,0.00,38176,38177
48837,1,512,512,512.00,0.00,38176,38177
48838,1,512,512,512.00,0.00,38176,38177
48839,5,418,10,102.40,25008.24,38176,38181
48840,1,512,512,512.00,0.00,38180,38181
48841,3,265,55,170.67,7577.56,38180,38183
48842,1,512,512,512.00,0.00,38182,38183
48843,2,343,169,256.00,7569.00,38182,38184
48844,4,478,5,128.00,40848.50,38183,38187
48845,2,330,182,256.00,5476.00,38186,38188
48846,1,512,512,512.00,0.00,38187,38188
48847,9,145,1,56.89,1879.43,38187,38196
48848,1,512,512,512.00,0.00,38195,38196
48849,1,512,512,512.00,0.00,38195,38196
48850,1,512,512,512.00,0.00,38195,38196
48851,1,512,512,512.00,0.00,38195,38196
48852,1,512,512,512.00,0.00,38195,38196
48853,1,512,512,512.00,0.00,38195,38196
48854,1,512,512,512.00,0.00,38195,38196
48855,4,182,82,128.00,1630.50,38195,38199
48856,1,512,512,512.00,0.00,38198,38199
48857,1,512,512,512.00,0.00,38198,38199
48858,1,512,512,512.00,0.00,38198,38199
48859,2,275,237,256.00,361.00,38198,38200
48860,1,512,512,512.00,0.00,38199,38200
48861,1,512,512,512.00,0.00,38199,38200
48862,1,512,512,512.00,0.00,38199,38200
48863,6,479,2,85.33,31027.89,38199,38205
48864,1,512,512,512.00,0.00,38204,38205
48865,1,512,512,512.00,0.00,38204,38205
48866,1,512,512,512.00,0.00,38204,38205
48867,1,512,512,512.00,0.00,38204,38205
48868,4,265,3,128.00,12229.00,38204,38208
48869,4,423,1,128.00,29497.00,38207,38211
48870,1,512,512,512.00,0.00,38210,38211
48871,2,509,3,256.00,64009.00,38210,38212
48872,4,358,1,128.00,21284.50,38211,38215
48873,1,512,512,512.00,0.00,38214,38215
48874,1,512,512,512.00,0.00,38214,38215
48875,1,512,512,512.00,0.00,38214,38215
48876,1,512,512,512.00,0.00,38214,38215
48877,2,372,140,256.00,13456.00,38214,38216
48878,1,512,512,512.00,0.00,38215,38216
48879,1,512,512,512.00,0.00,38215,38216
48880,2,426,86,256.00,28900.00,38215,38217
48881,1,512,512,512.00,0.00,38216,38217
48882,1,512,512,512.00,0.00,38216,38217
48883,1,512,512,512.00,0.00,38216,38217
48884,2,378,134,256.00,14884.00,38216,38218
48885,1,512,512,512.00,0.00,38217,38218
48886,1,512,512,512.00,0.00,38217,38218
48887,1,512,512,512.00,0.00,38217,38218
48888,1,512,512,512.00,0.00,38217,38218
48889,1,512,512,512.00,0.00,38217,38218
48890,1,512,512,512.00,0.00,38217,38218
48891,1,512,512,512.00,0.00,38217,38218
48892,1,512,512,512.00,0.00,38217,38218
48893,2,477,35,256.00,48841.00,38217,38219
48894,1,512,512,512.00,0.00,38218,38219
48895,3,323,92,170.67,11606.89,38218,38221
48896,5,232,5,102.40,7822.24,38220,38225
48897,1,512,512,512.00,0.00,38224,38225
48898,1,512,512,512.00,0.00,38224,38225
48899,2,418,94,256.00,26244.00,38224,38226
48900,3,412,2,170.67,30656.89,38225,38228
48901,2,422,90,256.00,27556.00,38227,38229
48902,1,512,512,512.00,0.00,38228,38229
48903,1,512,512,512.00,0.00,38228,38229
48904,1,512,512,512.00,0.00,38228,38229
48905,1,512,512,512.00,0.00,38228,38229
48906,1,512,512,512.00,0.00,38228,38229
48907,2,302,210,256.00,2116.00,38228,38230
48908,3,376,47,170.67,21374.89,38229,38232
48909,4,210,30,128.00,4138.50,38231,38235
48910,1,512,512,512.00,0.00,38234,38235
48911,1,512,512,512.00,0.00,38234,38235
48912,1,512,512,512.00,0.00,38234,38235
48913,1,512,512,512.00,0.00,38234,38235
48914,1,512,512,512.00,0.00,38234,38235
48915,5,472,1,102.40,34183.84,38234,38239
48916,4,459,6,128.00,36649.50,38238,38242
48917,5,311,2,102.40,13493.84,38241,38246
48918,7,263,10,73.14,6420.69,38245,38252
48919,3,308,79,170.67,9782.89,38251,38254
48920,1,512,512,512.00,0.00,38253,38254
48921,1,512,512,512.00,0.00,38253,38254
48922,8,335,1,64.00,11234.25,38253,38261
48923,6,210,1,85.33,7099.22,38260,38266
48924,1,512,512,512.00,0.00,38265,38266
48925,1,512,512,512.00,0.00,38265,38266
48926,3,265,24,170.67,11049.56,38265,38268
48927,1,512,512,512.00,0.00,38267,38268
48928,2,420,92,256.00,26896.00,38267,38269
48929,2,368,144,256.00,12544.00,38268,38270
48930,2,457,55,256.00,40401.00,38269,38271
48931,4,191,4,128.00,5829.50,38270,38274
48932,1,512,512,512.00,0.00,38273,38274
48933,2,382,130,256.00,15876.00,38273,38275
48934,3,181,153,170.67,157.56,38274,38277
48935,1,512,512,512.00,0.00,38276,38277
48936,1,512,512,512.00,0.00,38276,38277
48937,1,512,512,512.00,0.00,38276,38277
48938,1,512,512,512.00,0.00,38276,38277
48939,1,512,512,512.00,0.00,38276,38277
48940,1,512,512,512.00,0.00,38276,38277
48941,3,234,112,170.67,2491.56,38276,38279
48942,1,512,512,512.00,0.00,38278,38279
48943,1,512,512,512.00,0.00,38278,38279
48944,1,512,512,512.00,0.00,38278,38279
48945,1,512,512,512.00,0.00,38278,38279
48946,1,512,512,512.00,0.00,38278,38279
48947,1,512,512,512.00,0.00,38278,38279
48948,1,512,512,512.00,0.00,38278,38279
48949,1,512,512,512.00,0.00,38278,38279
48950,5,401,2,102.40,22860.24,38278,38283
48951,1,512,512,512.00,0.00,38282,38283
48952,1,512,512,512.00,0.00,38282,38283
48953,5,356,1,102.40,18969.44,38282,38287
48954,2,500,12,256.00,59536.00,38286,38288
48955,6,214,2,85.33,7974.56,38287,38293
48956,2,271,241,256.00,225.00,38292,38294
48957,8,210,1,64.00,6184.00,38293,38301
48958,1,512,512,512.00,0.00,38300,38301
48959,1,512,512,512.00,0.00,38300,38301
48960,1,512,512,512.00,0.00,38300,38301
48961,1,512,512,512.00,0.00,38300,38301
48962,1,512,512,512.00,0.00,38300,38301
48963,1,512,512,512.00,0.00,38300,38301
48964,5,330,1,102.40,16845.04,38300,38305
48965,6,236,1,85.33,7222.22,38304,38310
48966,1,512,512,512.00,0.00,38309,38310
48967,1,512,512,512.00,0.00,38309,38310
48968,1,512,512,512.00,0.00,38309,38310
48969,2,298,214,256.00,1764.00,38309,38311
48970,1,512,512,512.00,0.00,38310,38311
48971,1,512,512,512.00,0.00,38310,38311
48972,3,329,50,170.67,13682.89,38310,38313
48973,2,342,170,256.00,7396.00,38312,38314
48974,1,512,512,512.00,0.00,38313,38314
48975,1,512,512,512.00,0.00,38313,38314
48976,1,512,512,512.00,0.00,38313,38314
48977,2,262,250,256.00,36.00,38313,38315
48978,3,200,147,170.67,484.22,38314,38317
48979,5,170,4,102.40,3946.24,38316,38321
48980,1,512,512,512.00,0.00,38320,38321
48981,1,512,512,512.00,0.00,38320,38321
48982,1,512,512,512.00,0.00,38320,38321
48983,2,393,119,256.00,18769.00,38320,38322
48984,1,512,512,512.00,0.00,38321,38322
48985,2,342,170,256.00,7396.00,38321,38323
48986,1,512,512,512.00,0.00,38322,38323
48987,1,512,512,512.00,0.00,38322,38323
48988,4,476,1,128.00,40468.50,38322,38326
48989,1,512,512,512.00,0.00,38325,38326
48990,1,512,512,512.00,0.00,38325,38326
48991,1,512,512,512.00,0.00,38325,38326
48992,3,386,46,170.67,23376.89,38325,38328
48993,2,387,125,256.00,17161.00,38327,38329
48994,2,269,243,256.00,169.00,38328,38330
48995,1,512,512,512.00,0.00,38329,38330
48996,1,512,512,512.00,0.00,38329,38330
48997,1,512,512,512.00,0.00,38329,38330
48998,1,512,512,512.00,0.00,38329,38330
48999,1,512,512,512.00,0.00,38329,38330
49000,1,512,512,512.00,0.00,38329,38330
49001,2,273,239,256.00,289.00,38329,38331
49002,1,512,512,512.00,0.00,38330,38331
49003,1,512,512,512.00,0.00,38330,38331
49004,1,512,512,512.00,0.00,38330,38331
49005,1,512,512,512.00,0.00,38330,38331
49006,1,512,512,512.00,0.00,38330,38331
49007,1,512,512,512.00,0.00,38330,38331
49008,1,512,512,512.00,0.00,38330,38331
49009,1,512,512,512.00,0.00,38330,38331
49010,2,451,61,256.00,38025.00,38330,38332
49011,2,404,108,256.00,21904.00,38331,38333
49012,1,512,512,512.00,0.00,38332,38333
49013,1,512,512,512.00,0.00,38332,38333
49014,1,512,512,512.00,0.00,38332,38333
49015,7,174,1,73.14,3795.27,38332,38339
49016,1,512,512,512.00,0.00,38338,38339
49017,1,512,512,512.00,0.00,38338,38339
49018,4,344,2,128.00,16866.00,38338,38342
49019,1,512,512,512.00,0.00,38341,38342
49020,2,462,50,256.00,42436.00,38341,38343
49021,1,512,512,512.00,0.00,38342,38343
49022,2,452,60,256.00,38416.00,38342,38344
49023,3,208,135,170.67,889.56,38343,38346
49024,2,438,74,256.00,33124.00,38345,38347
49025,2,493,19,256.00,56169.00,38346,38348
49026,1,512,512,512.00,0.00,38347,38348
49027,1,512,512,512.00,0.00,38347,38348
49028,2,271,241,256.00,225.00,38347,38349
49029,2,426,86,256.00,28900.00,38348,38350
49030,2,489,23,256.00,54289.00,38349,38351
49031,1,512,512,512.00,0.00,38350,38351
49032,1,512,512,512.00,0.00,38350,38351
49033,1,512,512,512.00,0.00,38350,38351
49034,1,512,512,512.00,0.00,38350,38351
49035,5,290,1,102.40,15668.24,38350,38355
49036,4,274,15,128.00,9738.50,38354,38358
49037,2,487,25,256.00,53361.00,38357,38359
49038,1,512,512,512.00,0.00,38358,38359
49039,1,512,512,512.00,0.00,38358,38359
49040,3,281,1,170.67,14826.89,38358,38361
49041,1,512,512,512.00,0.00,38360,38361
49042,3,487,1,170.67,50121.56,38360,38363
49043,2,271,241,256.00,225.00,38362,38364
49044,1,512,512,512.00,0.00,38363,38364
49045,2,396,116,256.00,19600.00,38363,38365
49046,6,269,1,85.33,9591.56,38364,38370
49047,2,488,24,256.00,53824.00,38369,38371
49048,1,512,512,512.00,0.00,38370,38371
49049,2,292,220,256.00,1296.00,38370,38372
49050,6,256,1,85.33,10646.56,38371,38377
49051,4,444,11,128.00,33364.50,38376,38380
49052,1,512,512,512.00,0.00,38379,38380
49053,1,512,512,512.00,0.00,38379,38380
49054,1,512,512,512.00,0.00,38379,38380
49055,2,490,22,256.00,54756.00,38379,38381
49056,1,512,512,512.00,0.00,38380,38381
49057,1,512,512,512.00,0.00,38380,38381
49058,5,204,14,102.40,5122.64,38380,38385
49059,1,512,512,512.00,0.00,38384,38385
49060,1,512,512,512.00,0.00,38384,38385
49061,1,512,512,512.00,0.00,38384,38385
49062,1,512,512,512.00,0.00,38384,38385
49063,1,512,512,512.00,0.00,38384,38385
49064,1,512,512,512.00,0.00,38384,38385
49065,1,512,512,512.00,0.00,38384,38385
49066,2,508,4,256.00,63504.00,38384,38386
49067,1,512,512,512.00,0.00,38385,38386
49068,5,239,1,102.40,8767.84,38385,38390
49069,1,512,512,512.00,0.00,38389,38390
49070,1,512,512,512.00,0.00,38389,38390
49071,1,512,512,512.00,0.00,38389,38390
49072,2,316,196,256.00,3600.00,38389,38391
49073,7,378,2,73.14,16195.55,38390,38397
49074,1,512,512,512.00,0.00,38396,38397
49075,1,512,512,512.00,0.00,38396,38397
49076,1,512,512,512.00,0.00,38396,38397
49077,6,372,1,85.33,16973.22,38396,38402
49078,2,272,240,256.00,256.00,38401,38403
49079,1,512,512,512.00,0.00,38402,38403
49080,1,512,512,512.00,0.00,38402,38403
49081,1,512,512,512.00,0.00,38402,38403
49082,2,381,131,256.00,15625.00,38402,38404
49083,2,509,3,256.00,64009.00,38403,38405
49084,1,512,512,512.00,0.00,38404,38405
49085,1,512,512,512.00,0.00,38404,38405
49086,1,512,512,512.00,0.00,38404,38405
49087,1,512,512,512.00,0.00,38404,38405
49088,1,512,512,512.00,0.00,38404,38405
49089,1,512,512,512.00,0.00,38404,38405
49090,1,512,512,512.00,0.00,38404,38405
49091,1,512,512,512.00,0.00,38404,38405
49092,1,512,512,512.00,0.00,38404,38405
49093,2,449,63,256.00,37249.00,38404,38406
49094,4,277,30,128.00,9987.50,38405,38409
49095,5,408,1,102.40,23766.64,38408,38413
49096,4,335,1,128.00,19072.50,38412,38416
49097,1,512,512,512.00,0.00,38415,38416
49098,1,512,512,512.00,0.00,38415,38416
49099,1,512,512,512.00,0.00,38415,38416
49100,1,512,512,512.00,0.00,38415,38416
49101,1,512,512,512.00,0.00,38415,38416
49102,1,512,512,512.00,0.00,38415,38416
49103,1,512,512,512.00,0.00,38415,38416
49104,1,512,512,512.00,0.00,38415,38416
49105,2,370,142,256.00,12996.00,38415,38417
49106,1,512,512,512.00,0.00,38416,38417
49107,1,512,512,512.00,0.00,38416,38417
49108,1,512,512,512.00,0.00,38416,38417
49109,1,512,512,512.00,0.00,38416,38417
49110,1,512,512,512.00,0.00,38416,38417
49111,4,330,2,128.00,17204.00,38416,38420
49112,1,512,512,512.00,0.00,38419,38420
49113,1,512,512,512.00,0.00,38419,38420
49114,1,512,512,512.00,0.00,38419,38420
49115,1,512,512,512.00,0.00,38419,38420
49116,1,512,512,512.00,0.00,38419,38420
49117,3,260,79,170.67,5462.89,38419,38422
49118,1,512,512,512.00,0.00,38421,38422
49119,3,298,59,170.67,9642.89,38421,38424
49120,1,512,512,512.00,0.00,38423,38424
49121,1,512,512,512.00,0.00,38423,38424
49122,1,512,512,512.00,0.00,38423,38424
49123,2,332,180,256.00,5776.00,38423,38425
49124,1,512,512,512.00,0.00,38424,38425
49125,1,512,512,512.00,0.00,38424,38425
49126,1,512,512,512.00,0.00,38424,38425
49127,4,204,51,128.00,5482.50,38424,38428
49128,1,512,512,512.00,0.00,38427,38428
49129,2,363,149,256.00,11449.00,38427,38429
49130,2,351,161,256.00,9025.00,38428,38430
49131,1,512,512,512.00,0.00,38429,38430
49132,2,431,81,256.00,30625.00,38429,38431
49133,2,397,115,256.00,19881.00,38430,38432
49134,1,512,512,512.00,0.00,38431,38432
49135,1,512,512,512.00,0.00,38431,38432
49136,1,512,512,512.00,0.00,38431,38432
49137,3,217,111,170.67,1961.56,38431,38434
49138,2,313,199,256.00,3249.00,38433,38435
49139,1,512,512,512.00,0.00,38434,38435
49140,1,512,512,512.00,0.00,38434,38435
49141,9,165,2,56.89,3167.43,38434,38443
49142,2,498,14,256.00,58564.00,38442,38444
49143,1,512,512,512.00,0.00,38443,38444
49144,3,349,3,170.67,20009.56,38443,38446
49145,1,512,512,512.00,0.00,38445,38446
49146,1,512,512,512.00,0.00,38445,38446
49147,1,512,512,512.00,0.00,38445,38446
49148,1,512,512,512.00,0.00,38445,38446
49149,2,332,180,256.00,5776.00,38445,38447
49150,1,512,512,512.00,0.00,38446,38447
49151,1,512,512,512.00,0.00,38446,38447
49152,1,512,512,512.00,0.00,38446,38447
49153,1,512,512,512.00,0.00,38446,38447
49154,1,512,512,512.00,0.00,38446,38447
49155,7,287,1,73.14,9120.12,38446,38453
49156,1,512,512,512.00,0.00,38452,38453
49157,3,339,2,170.67,18928.22,38452,38455
49158,1,512,512,512.00,0.00,38454,38455
49159,1,512,512,512.00,0.00,38454,38455
49160,1,512,512,512.00,0.00,38454,38455
49161,3,462,20,170.67,42454.22,38454,38457
49162,2,454,58,256.00,39204.00,38456,38458
49163,1,512,512,512.00,0.00,38457,38458
49164,2,334,178,256.00,6084.00,38457,38459
49165,1,512,512,512.00,0.00,38458,38459
49166,3,287,2,170.67,14906.89,38458,38461
49167,1,512,512,512.00,0.00,38460,38461
49168,1,512,512,512.00,0.00,38460,38461
49169,1,512,512,512.00,0.00,38460,38461
49170,4,377,1,128.00,21393.50,38460,38464
49171,3,486,6,170.67,49750.22,38463,38466
49172,2,503,9,256.00,61009.00,38465,38467
49173,3,308,54,170.67,10966.22,38466,38469
49174,1,512,512,512.00,0.00,38468,38469
49175,1,512,512,512.00,0.00,38468,38469
49176,2,327,185,256.00,5041.00,38468,38470
49177,1,512,512,512.00,0.00,38469,38470
49178,2,447,65,256.00,36481.00,38469,38471
49179,1,512,512,512.00,0.00,38470,38471
49180,1,512,512,512.00,0.00,38470,38471
49181,1,512,512,512.00,0.00,38470,38471
49182,1,512,512,512.00,0.00,38470,38471
49183,1,512,512,512.00,0.00,38470,38471
49184,1,512,512,512.00,0.00,38470,38471
49185,1,512,512,512.00,0.00,38470,38471
49186,1,512,512,512.00,0.00,38470,38471
49187,1,512,512,512.00,0.00,38470,38471
49188,3,199,137,170.67,654.89,38470,38473
49189,1,512,512,512.00,0.00,38472,38473
49190,3,470,1,170.67,45066.89,38472,38475
49191,1,512,512,512.00,0.00,38474,38475
49192,1,512,512,512.00,0.00,38474,38475
49193,1,512,512,512.00,0.00,38474,38475
49194,1,512,512,512.00,0.00,38474,38475
49195,1,512,512,512.00,0.00,38474,38475
49196,1,512,512,512.00,0.00,38474,38475
49197,1,512,512,512.00,0.00,38474,38475
49198,3,397,41,170.67,25794.89,38474,38477
49199,1,512,512,512.00,0.00,38476,38477
49200,1,512,512,512.00,0.00,38476,38477
49201,1,512,512,512.00,0.00,38476,38477
49202,1,512,512,512.00,0.00,38476,38477
49203,1,512,512,512.00,0.00,38476,38477
49204,3,368,45,170.67,19956.22,38476,38479
49205,1,512,512,512.00,0.00,38478,38479
49206,2,413,99,256.00,24649.00,38478,38480
49207,1,512,512,512.00,0.00,38479,38480
49208,1,512,512,512.00,0.00,38479,38480
49209,1,512,512,512.00,0.00,38479,38480
49210,1,512,512,512.00,0.00,38479,38480
49211,1,512,512,512.00,0.00,38479,38480
49212,1,512,512,512.00,0.00,38479,38480
49213,1,512,512,512.00,0.00,38479,38480
49214,1,512,512,512.00,0.00,38479,38480
49215,4,398,6,128.00,24828.50,38479,38483
49216,1,512,512,512.00,0.00,38482,38483
49217,1,512,512,512.00,0.00,38482,38483
49218,2,393,119,256.00,18769.00,38482,38484
49219,1,512,512,512.00,0.00,38483,38484
49220,1,512,512,512.00,0.00,38483,38484
49221,5,322,2,102.40,15092.24,38483,38488
49222,1,512,512,512.00,0.00,38487,38488
49223,1,512,512,512.00,0.00,38487,38488
49224,7,323,2,73.14,11422.41,38487,38494
49225,4,419,4,128.00,28996.50,38493,38497
49226,1,512,512,512.00,0.00,38496,38497
49227,1,512,512,512.00,0.00,38496,38497
49228,1,512,512,512.00,0.00,38496,38497
49229,3,307,1,170.67,16161.56,38496,38499
49230,1,512,512,512.00,0.00,38498,38499
49231,5,330,1,102.40,14081.84,38498,38503
49232,1,512,512,512.00,0.00,38502,38503
49233,1,512,512,512.00,0.00,38502,38503
49234,1,512,512,512.00,0.00,38502,38503
49235,1,512,512,512.00,0.00,38502,38503
49236,2,283,229,256.00,729.00,38502,38504
49237,3,438,15,170.67,36056.22,38503,38506
49238,2,459,53,256.00,41209.00,38505,38507
49239,1,512,512,512.00,0.00,38506,38507
49240,1,512,512,512.00,0.00,38506,38507
49241,1,512,512,512.00,0.00,38506,38507
49242,2,308,204,256.00,2704.00,38506,38508
49243,3,313,41,170.67,12410.89,38507,38510
49244,1,512,512,512.00,0.00,38509,38510
49245,2,274,238,256.00,324.00,38509,38511
49246,5,325,1,102.40,13923.04,38510,38515
49247,1,512,512,512.00,0.00,38514,38515
49248,1,512,512,512.00,0.00,38514,38515
49249,1,512,512,512.00,0.00,38514,38515
49250,3,338,2,170.67,18816.89,38514,38517
49251,1,512,512,512.00,0.00,38516,38517
49252,3,318,38,170.67,13174.22,38516,38519
49253,2,484,28,256.00,51984.00,38518,38520
49254,3,458,16,170.67,41360.89,38519,38522
49255,1,512,512,512.00,0.00,38521,38522
49256,1,512,512,512.00,0.00,38521,38522
49257,2,373,139,256.00,13689.00,38521,38523
49258,1,512,512,512.00,0.00,38522,38523
49259,2,498,14,256.00,58564.00,38522,38524
49260,1,512,512,512.00,0.00,38523,38524
49261,6,252,1,85.33,9509.22,38523,38529
49262,1,512,512,512.00,0.00,38528,38529
49263,1,512,512,512.00,0.00,38528,38529
49264,2,293,219,256.00,1369.00,38528,38530
49265,1,512,512,512.00,0.00,38529,38530
49266,1,512,512,512.00,0.00,38529,38530
49267,1,512,512,512.00,0.00,38529,38530
49268,6,236,2,85.33,8240.56,38529,38535
49269,3,423,31,170.67,31957.56,38534,38537
49270,5,330,3,102.40,15264.24,38536,38541
49271,2,484,28,256.00,51984.00,38540,38542
49272,1,512,512,512.00,0.00,38541,38542
49273,1,512,512,512.00,0.00,38541,38542
49274,3,299,14,170.67,13938.89,38541,38544
49275,1,512,512,512.00,0.00,38543,38544
49276,1,512,512,512.00,0.00,38543,38544
49277,1,512,512,512.00,0.00,38543,38544
49278,2,354,158,256.00,9604.00,38543,38545
49279,1,512,512,512.00,0.00,38544,38545
49280,1,512,512,512.00,0.00,38544,38545
49281,1,512,512,512.00,0.00,38544,38545
49282,3,333,5,170.67,17936.22,38544,38547
49283,3,347,4,170.67,19654.89,38547,38550
49284,5,340,1,102.40,14637.04,38549,38554
49285,3,260,9,170.67,13116.22,38553,38556
49286,1,512,512,512.00,0.00,38555,38556
49287,1,512,512,512.00,0.00,38555,38556
49288,1,512,512,512.00,0.00,38555,38556
49289,1,512,512,512.00,0.00,38555,38556
49290,1,512,512,512.00,0.00,38555,38556
49291,1,512,512,512.00,0.00,38555,38556
49292,1,512,512,512.00,0.00,38555,38556
49293,2,495,17,256.00,57121.00,38555,38557
49294,1,512,512,512.00,0.00,38556,38557
49295,1,512,512,512.00,0.00,38556,38557
49296,2,437,75,256.00,32761.00,38556,38558
49297,1,512,512,512.00,0.00,38557,38558
49298,2,465,47,256.00,43681.00,38557,38559
49299,1,512,512,512.00,0.00,38558,38559
49300,2,378,134,256.00,14884.00,38558,38560
49301,1,512,512,512.00,0.00,38559,38560
49302,1,512,512,512.00,0.00,38559,38560
49303,2,375,137,256.00,14161.00,38559,38561
49304,2,413,99,256.00,24649.00,38560,38562
49305,1,512,512,512.00,0.00,38561,38562
49306,1,512,512,512.00,0.00,38561,38562
49307,1,512,512,512.00,0.00,38561,38562
49308,3,335,26,170.67,16106.89,38561,38564
49309,3,347,1,170.67,19974.89,38563,38566
49310,1,512,512,512.00,0.00,38565,38566
49311,1,512,512,512.00,0.00,38565,38566
49312,1,512,512,512.00,0.00,38565,38566
49313,3,360,8,170.67,21006.22,38565,38568
49314,1,512,512,512.00,0.00,38567,38568
49315,1,512,512,512.00,0.00,38567,38568
49316,1,512,512,512.00,0.00,38567,38568
49317,1,512,512,512.00,0.00,38567,38568
49318,2,308,204,256.00,2704.00,38567,38569
49319,3,441,30,170.67,36560.22,38568,38571
49320,1,512,512,512.00,0.00,38570,38571
49321,2,451,61,256.00,38025.00,38570,38572
49322,1,512,512,512.00,0.00,38571,38572
49323,1,512,512,512.00,0.00,38571,38572
49324,2,476,36,256.00,48400.00,38571,38573
49325,1,512,512,512.00,0.00,38572,38573
49326,1,512,512,512.00,0.00,38572,38573
49327,1,512,512,512.00,0.00,38572,38573
49328,2,380,132,256.00,15376.00,38572,38574
49329,1,512,512,512.00,0.00,38573,38574
49330,2,273,239,256.00,289.00,38573,38575
49331,1,512,512,512.00,0.00,38574,38575
49332,1,512,512,512.00,0.00,38574,38575
49333,1,512,512,512.00,0.00,38574,38575
49334,1,512,512,512.00,0.00,38574,38575
49335,1,512,512,512.00,0.00,38574,38575
49336,3,283,42,170.67,9813.56,38574,38577
49337,1,512,512,512.00,0.00,38576,38577
49338,2,478,34,256.00,49284.00,38576,38578
49339,1,512,512,512.00,0.00,38577,38578
49340,1,512,512,512.00,0.00,38577,38578
49341,1,512,512,512.00,0.00,38577,38578
49342,1,512,512,512.00,0.00,38577,38578
49343,5,419,3,102.40,25595.84,38577,38582
49344,3,422,32,170.67,31696.89,38581,38584
49345,1,512,512,512.00,0.00,38583,38584
49346,2,405,107,256.00,22201.00,38583,38585
49347,1,512,512,512.00,0.00,38584,38585
49348,3,434,36,170.67,34678.22,38584,38587
49349,1,512,512,512.00,0.00,38586,38587
49350,2,383,129,256.00,16129.00,38586,38588
49351,1,512,512,512.00,0.00,38587,38588
49352,1,512,512,512.00,0.00,38587,38588
49353,1,512,512,512.00,0.00,38587,38588
49354,1,512,512,512.00,0.00,38587,38588
49355,2,438,74,256.00,33124.00,38587,38589
49356,1,512,512,512.00,0.00,38588,38589
49357,5,262,12,102.40,8138.64,38588,38593
49358,1,512,512,512.00,0.00,38592,38593
49359,2,496,16,256.00,57600.00,38592,38594
49360,1,512,512,512.00,0.00,38593,38594
49361,1,512,512,512.00,0.00,38593,38594
49362,2,396,116,256.00,19600.00,38593,38595
49363,1,512,512,512.00,0.00,38594,38595
49364,1,512,512,512.00,0.00,38594,38595
49365,1,512,512,512.00,0.00,38594,38595
49366,1,512,512,512.00,0.00,38594,38595
49367,3,468,4,170.67,44419.56,38594,38597
49368,1,512,512,512.00,0.00,38596,38597
49369,2,455,57,256.00,39601.00,38596,38598
49370,1,512,512,512.00,0.00,38597,38598
49371,1,512,512,512.00,0.00,38597,38598
49372,2,382,130,256.00,15876.00,38597,38599
49373,1,512,512,512.00,0.00,38598,38599
49374,1,512,512,512.00,0.00,38598,38599
49375,1,512,512,512.00,0.00,38598,38599
49376,1,512,512,512.00,0.00,38598,38599
49377,1,512,512,512.00,0.00,38598,38599
49378,1,512,512,512.00,0.00,38598,38599
49379,1,512,512,512.00,0.00,38598,38599
49380,1,512,512,512.00,0.00,38598,38599
49381,1,512,512,512.00,0.00,38598,38599
49382,2,380,132,256.00,15376.00,38598,38600
49383,1,512,512,512.00,0.00,38599,38600
49384,1,512,512,512.00,0.00,38599,38600
49385,3,417,39,170.67,30388.22,38599,38602
49386,5,313,10,102.40,13081.84,38601,38606
49387,1,512,512,512.00,0.00,38605,38606
49388,3,452,27,170.67,39580.22,38605,38608
49389,4,294,1,128.00,14766.50,38607,38611
49390,1,512,512,512.00,0.00,38610,38611
49391,1,512,512,512.00,0.00,38610,38611
49392,1,512,512,512.00,0.00,38610,38611
49393,1,512,512,512.00,0.00,38610,38611
49394,3,334,49,170.67,14405.56,38610,38613
49395,1,512,512,512.00,0.00,38612,38613
49396,1,512,512,512.00,0.00,38612,38613
49397,1,512,512,512.00,0.00,38612,38613
49398,2,444,68,256.00,35344.00,38612,38614
49399,1,512,512,512.00,0.00,38613,38614
49400,5,302,17,102.40,10744.24,38613,38618
49401,4,252,14,128.00,7617.50,38617,38621
49402,2,418,94,256.00,26244.00,38620,38622
49403,2,483,29,256.00,51529.00,38621,38623
49404,5,236,12,102.40,5771.84,38622,38627
49405,3,302,1,170.67,15834.89,38626,38629
49406,4,362,1,128.00,20748.50,38628,38632
49407,4,333,4,128.00,15206.50,38631,38635
49408,1,512,512,512.00,0.00,38634,38635
49409,1,512,512,512.00,0.00,38634,38635
49410,1,512,512,512.00,0.00,38634,38635
49411,1,512,512,512.00,0.00,38634,38635
49412,1,512,512,512.00,0.00,38634,38635
49413,2,447,65,256.00,36481.00,38634,38636
49414,1,512,512,512.00,0.00,38635,38636
49415,2,299,213,256.00,1849.00,38635,38637
49416,1,512,512,512.00,0.00,38636,38637
49417,1,512,512,512.00,0.00,38636,38637
49418,1,512,512,512.00,0.00,38636,38637
49419,1,512,512,512.00,0.00,38636,38637
49420,1,512,512,512.00,0.00,38636,38637
49421,1,512,512,512.00,0.00,38636,38637
49422,1,512,512,512.00,0.00,38636,38637
49423,1,512,512,512.00,0.00,38636,38637
49424,2,377,135,256.00,14641.00,38636,38638
49425,7,286,2,73.14,8342.98,38637,38644
49426,1,512,512,512.00,0.00,38643,38644
49427,2,320,192,256.00,4096.00,38643,38645
49428,2,265,247,256.00,81.00,38644,38646
49429,2,510,2,256.00,64516.00,38645,38647
49430,5,234,2,102.40,8847.04,38646,38651
49431,1,512,512,512.00,0.00,38650,38651
49432,3,344,1,170.67,19614.89,38650,38653
49433,1,512,512,512.00,0.00,38652,38653
49434,1,512,512,512.00,0.00,38652,38653
49435,1,512,512,512.00,0.00,38652,38653
49436,1,512,512,512.00,0.00,38652,38653
49437,2,266,246,256.00,100.00,38652,38654
49438,1,512,512,512.00,0.00,38653,38654
49439,5,371,18,102.40,18333.04,38653,38658
49440,4,239,10,128.00,9052.50,38657,38661
49441,1,512,512,512.00,0.00,38660,38661
49442,1,512,512,512.00,0.00,38660,38661
49443,1,512,512,512.00,0.00,38660,38661
49444,1,512,512,512.00,0.00,38660,38661
49445,2,389,123,256.00,17689.00,38660,38662
49446,1,512,512,512.00,0.00,38661,38662
49447,1,512,512,512.00,0.00,38661,38662
49448,1,512,512,512.00,0.00,38661,38662
49449,3,325,45,170.67,13477.56,38661,38664
49450,1,512,512,512.00,0.00,38663,38664
49451,3,463,12,170.67,42833.56,38663,38666
49452,1,512,512,512.00,0.00,38665,38666
49453,3,274,53,170.67,8242.89,38665,38668
49454,3,294,85,170.67,7989.56,38667,38670
49455,1,512,512,512.00,0.00,38669,38670
49456,1,512,512,512.00,0.00,38669,38670
49457,5,297,9,102.40,12273.44,38669,38674
49458,1,512,512,512.00,0.00,38673,38674
49459,1,512,512,512.00,0.00,38673,38674
49460,2,434,78,256.00,31684.00,38673,38675
49461,1,512,512,512.00,0.00,38674,38675
49462,2,335,177,256.00,6241.00,38674,38676
49463,2,414,98,256.00,24964.00,38675,38677
49464,6,401,2,85.33,20217.89,38676,38682
49465,2,401,111,256.00,21025.00,38681,38683
49466,1,512,512,512.00,0.00,38682,38683
49467,1,512,512,512.00,0.00,38682,38683
49468,7,264,1,73.14,8042.98,38682,38689
49469,1,512,512,512.00,0.00,38688,38689
49470,1,512,512,512.00,0.00,38688,38689
49471,1,512,512,512.00,0.00,38688,38689
49472,1,512,512,512.00,0.00,38688,38689
49473,2,413,99,256.00,24649.00,38688,38690
49474,1,512,512,512.00,0.00,38689,38690
49475,1,512,512,512.00,0.00,38689,38690
49476,1,512,512,512.00,0.00,38689,38690
49477,1,512,512,512.00,0.00,38689,38690
49478,1,512,512,512.00,0.00,38689,38690
49479,2,379,133,256.00,15129.00,38689,38691
49480,1,512,512,512.00,0.00,38690,38691
49481,1,512,512,512.00,0.00,38690,38691
49482,1,512,512,512.00,0.00,38690,38691
49483,1,512,512,512.00,0.00,38690,38691
49484,1,512,512,512.00,0.00,38690,38691
49485,4,503,1,128.00,46876.50,38690,38694
49486,1,512,512,512.00,0.00,38693,38694
49487,6,243,4,85.33,7958.56,38693,38699
49488,5,449,10,102.40,30042.64,38698,38703
49489,1,512,512,512.00,0.00,38702,38703
49490,1,512,512,512.00,0.00,38702,38703
49491,1,512,512,512.00,0.00,38702,38703
49492,1,512,512,512.00,0.00,38702,38703
49493,2,361,151,256.00,11025.00,38702,38704
49494,1,512,512,512.00,0.00,38703,38704
49495,1,512,512,512.00,0.00,38703,38704
49496,1,512,512,512.00,0.00,38703,38704
49497,1,512,512,512.00,0.00,38703,38704
49498,1,512,512,512.00,0.00,38703,38704
49499,8,211,1,64.00,6415.50,38703,38711
49500,3,461,21,170.67,42160.22,38710,38713
49501,1,512,512,512.00,0.00,38712,38713
49502,2,358,154,256.00,10404.00,38712,38714
49503,4,214,28,128.00,4573.50,38713,38717
49504,1,512,512,512.00,0.00,38716,38717
49505,4,340,23,128.00,15433.50,38716,38720
49506,7,274,6,73.14,7241.84,38719,38726
49507,1,512,512,512.00,0.00,38725,38726
49508,1,512,512,512.00,0.00,38725,38726
49509,2,281,231,256.00,625.00,38725,38727
49510,4,397,2,128.00,25743.50,38726,38730
49511,5,181,3,102.40,6626.64,38729,38734
49512,1,512,512,512.00,0.00,38733,38734
49513,8,297,2,64.00,8735.50,38733,38741
49514,1,512,512,512.00,0.00,38740,38741
49515,5,254,6,102.40,10491.44,38740,38745
49516,3,296,11,170.67,14126.89,38744,38747
49517,1,512,512,512.00,0.00,38746,38747
49518,7,399,1,73.14,18085.84,38746,38753
49519,5,185,12,102.40,4642.64,38752,38757
49520,1,512,512,512.00,0.00,38756,38757
49521,4,308,9,128.00,15426.50,38756,38760
49522,2,423,89,256.00,27889.00,38759,38761
49523,9,261,1,56.89,5780.77,38760,38769
49524,1,512,512,512.00,0.00,38768,38769
49525,1,512,512,512.00,0.00,38768,38769
49526,4,468,3,128.00,38720.50,38768,38772
49527,1,512,512,512.00,0.00,38771,38772
49528,3,391,34,170.67,24741.56,38771,38774
49529,2,499,13,256.00,59049.00,38773,38775
49530,6,257,3,85.33,7122.22,38774,38780
49531,2,263,249,256.00,49.00,38779,38781
49532,3,295,2,170.67,15290.89,38780,38783
49533,4,243,3,128.00,12027.00,38782,38786
49534,1,512,512,512.00,0.00,38785,38786
49535,2,502,10,256.00,60516.00,38785,38787
49536,1,512,512,512.00,0.00,38786,38787
49537,2,316,196,256.00,3600.00,38786,38788
49538,2,454,58,256.00,39204.00,38787,38789
49539,1,512,512,512.00,0.00,38788,38789
49540,2,446,66,256.00,36100.00,38788,38790
49541,1,512,512,512.00,0.00,38789,38790
49542,2,262,250,256.00,36.00,38789,38791
49543,4,251,43,128.00,7753.50,38790,38794
49544,2,303,209,256.00,2209.00,38793,38795
49545,1,512,512,512.00,0.00,38794,38795
49546,1,512,512,512.00,0.00,38794,38795
49547,1,512,512,512.00,0.00,38794,38795
49548,2,413,99,256.00,24649.00,38794,38796
49549,1,512,512,512.00,0.00,38795,38796
49550,1,512,512,512.00,0.00,38795,38796
49551,4,285,4,128.00,10418.50,38795,38799
49552,1,512,512,512.00,0.00,38798,38799
49553,1,512,512,512.00,0.00,38798,38799
49554,2,373,139,256.00,13689.00,38798,38800
49555,2,505,7,256.00,62001.00,38799,38801
49556,4,214,1,128.00,7522.50,38800,38804
49557,5,294,1,102.40,13693.44,38803,38808
49558,1,512,512,512.00,0.00,38807,38808
49559,6,367,2,85.33,16495.22,38807,38813
49560,1,512,512,512.00,0.00,38812,38813
49561,1,512,512,512.00,0.00,38812,38813
49562,5,238,1,102.40,11321.04,38812,38817
49563,2,455,57,256.00,39601.00,38816,38818
49564,2,392,120,256.00,18496.00,38817,38819
49565,1,512,512,512.00,0.00,38818,38819
49566,1,512,512,512.00,0.00,38818,38819
49567,5,205,3,102.40,5518.24,38818,38823
49568,3,407,7,170.67,29306.89,38822,38825
49569,2,427,85,256.00,29241.00,38824,38826
49570,4,243,31,128.00,6623.50,38825,38829
49571,1,512,512,512.00,0.00,38828,38829
49572,1,512,512,512.00,0.00,38828,38829
49573,2,387,125,256.00,17161.00,38828,38830
49574,1,512,512,512.00,0.00,38829,38830
49575,3,413,23,170.67,29830.89,38829,38832
49576,3,507,1,170.67,56561.56,38831,38834
49577,2,441,71,256.00,34225.00,38833,38835
49578,1,512,512,512.00,0.00,38834,38835
49579,1,512,512,512.00,0.00,38834,38835
49580,1,512,512,512.00,0.00,38834,38835
49581,3,329,1,170.67,17994.89,38834,38837
49582,5,330,1,102.40,13897.04,38836,38841
49583,4,282,1,128.00,11648.50,38840,38844
49584,4,405,16,128.00,25857.50,38843,38847
49585,10,162,3,51.20,2994.16,38846,38856
49586,2,369,143,256.00,12769.00,38855,38857
49587,1,512,512,512.00,0.00,38856,38857
49588,1,512,512,512.00,0.00,38856,38857
49589,1,512,512,512.00,0.00,38856,38857
49590,1,512,512,512.00,0.00,38856,38857
49591,1,512,512,512.00,0.00,38856,38857
49592,1,512,512,512.00,0.00,38856,38857
49593,1,512,512,512.00,0.00,38856,38857
49594,2,321,191,256.00,4225.00,38856,38858
49595,1,512,512,512.00,0.00,38857,38858
49596,2,393,119,256.00,18769.00,38857,38859
49597,5,230,5,102.40,7648.64,38858,38863
49598,1,512,512,512.00,0.00,38862,38863
49599,2,344,168,256.00,7744.00,38862,38864
49600,4,370,2,128.00,22604.00,38863,38867
49601,1,512,512,512.00,0.00,38866,38867
49602,1,512,512,512.00,0.00,38866,38867
49603,5,281,23,102.40,9533.44,38866,38871
49604,2,345,167,256.00,7921.00,38870,38872
49605,1,512,512,512.00,0.00,38871,38872
49606,1,512,512,512.00,0.00,38871,38872
49607,1,512,512,512.00,0.00,38871,38872
49608,2,308,204,256.00,2704.00,38871,38873
49609,5,347,2,102.40,15522.64,38872,38877
49610,1,512,512,512.00,0.00,38876,38877
49611,1,512,512,512.00,0.00,38876,38877
49612,2,475,37,256.00,47961.00,38876,38878
49613,3,461,16,170.67,42206.89,38877,38880
49614,1,512,512,512.00,0.00,38879,38880
49615,2,298,214,256.00,1764.00,38879,38881
49616,2,460,52,256.00,41616.00,38880,38882
49617,1,512,512,512.00,0.00,38881,38882
49618,3,456,22,170.67,40731.56,38881,38884
49619,3,363,22,170.67,20333.56,38883,38886
49620,1,512,512,512.00,0.00,38885,38886
49621,1,512,512,512.00,0.00,38885,38886
49622,1,512,512,512.00,0.00,38885,38886
49623,1,512,512,512.00,0.00,38885,38886
49624,2,314,198,256.00,3364.00,38885,38887
49625,1,512,512,512.00,0.00,38886,38887
49626,4,319,15,128.00,13465.00,38886,38890
49627,5,305,13,102.40,12175.04,38889,38894
49628,1,512,512,512.00,0.00,38893,38894
49629,1,512,512,512.00,0.00,38893,38894
49630,1,512,512,512.00,0.00,38893,38894
49631,4,324,4,128.00,14258.00,38893,38897
49632,1,512,512,512.00,0.00,38896,38897
49633,1,512,512,512.00,0.00,38896,38897
49634,2,497,15,256.00,58081.00,38896,38898
49635,1,512,512,512.00,0.00,38897,38898
49636,2,364,148,256.00,11664.00,38897,38899
49637,6,298,2,85.33,10502.56,38898,38904
49638,2,301,211,256.00,2025.00,38903,38905
49639,1,512,512,512.00,0.00,38904,38905
49640,2,334,178,256.00,6084.00,38904,38906
49641,1,512,512,512.00,0.00,38905,38906
49642,1,512,512,512.00,0.00,38905,38906
49643,1,512,512,512.00,0.00,38905,38906
49644,1,512,512,512.00,0.00,38905,38906
49645,1,512,512,512.00,0.00,38905,38906
49646,1,512,512,512.00,0.00,38905,38906
49647,1,512,512,512.00,0.00,38905,38906
49648,1,512,512,512.00,0.00,38905,38906
49649,1,512,512,512.00,0.00,38905,38906
49650,2,506,6,256.00,62500.00,38905,38907
49651,4,266,5,128.00,13521.50,38907,38911
49652,1,512,512,512.00,0.00,38910,38911
49653,1,512,512,512.00,0.00,38910,38911
49654,2,268,244,256.00,144.00,38910,38912
49655,4,325,8,128.00,16969.50,38911,38915
49656,1,512,512,512.00,0.00,38914,38915
49657,1,512,512,512.00,0.00,38914,38915
49658,1,512,512,512.00,0.00,38914,38915
49659,5,315,2,102.40,16360.64,38914,38919
49660,5,293,1,102.40,13948.64,38918,38923
49661,1,512,512,512.00,0.00,38922,38923
49662,1,512,512,512.00,0.00,38922,38923
49663,1,512,512,512.00,0.00,38922,38923
49664,1,512,512,512.00,0.00,38922,38923
49665,3,280,51,170.67,8793.56,38922,38925
49666,1,512,512,512.00,0.00,38924,38925
49667,2,501,11,256.00,60025.00,38924,38926
49668,1,512,512,512.00,0.00,38925,38926
49669,3,375,9,170.67,23236.22,38925,38928
49670,1,512,512,512.00,0.00,38927,38928
49671,2,323,189,256.00,4489.00,38927,38929
49672,4,317,2,128.00,13585.50,38928,38932
49673,2,380,132,256.00,15376.00,38931,38933
49674,1,512,512,512.00,0.00,38932,38933
49675,2,284,228,256.00,784.00,38932,38934
49676,1,512,512,512.00,0.00,38933,38934
49677,1,512,512,512.00,0.00,38933,38934
49678,1,512,512,512.00,0.00,38933,38934
49679,2,284,228,256.00,784.00,38933,38935
49680,5,291,1,102.40,10893.44,38934,38939
49681,1,512,512,512.00,0.00,38938,38939
49682,2,440,72,256.00,33856.00,38938,38940
49683,2,466,46,256.00,44100.00,38939,38941
49684,2,423,89,256.00,27889.00,38940,38942
49685,2,287,225,256.00,961.00,38941,38943
49686,1,512,512,512.00,0.00,38942,38943
49687,1,512,512,512.00,0.00,38942,38943
49688,1,512,512,512.00,0.00,38942,38943
49689,2,258,254,256.00,4.00,38942,38944
49690,2,460,52,256.00,41616.00,38943,38945
49691,3,504,2,170.67,55558.22,38944,38947
49692,1,512,512,512.00,0.00,38946,38947
49693,2,418,94,256.00,26244.00,38946,38948
49694,1,512,512,512.00,0.00,38947,38948
49695,1,512,512,512.00,0.00,38947,38948
49696,1,512,512,512.00,0.00,38947,38948
49697,1,512,512,512.00,0.00,38947,38948
49698,2,349,163,256.00,8649.00,38947,38949
49699,1,512,512,512.00,0.00,38948,38949
49700,3,355,78,170.67,16989.56,38948,38951
49701,3,241,52,170.67,7121.56,38950,38953
49702,1,512,512,512.00,0.00,38952,38953
49703,3,276,117,170.67,5548.22,38952,38955
49704,1,512,512,512.00,0.00,38954,38955
49705,1,512,512,512.00,0.00,38954,38955
49706,1,512,512,512.00,0.00,38954,38955
49707,1,512,512,512.00,0.00,38954,38955
49708,2,339,173,256.00,6889.00,38954,38956
49709,1,512,512,512.00,0.00,38955,38956
49710,3,359,2,170.67,21434.89,38955,38958
49711,1,512,512,512.00,0.00,38957,38958
49712,3,234,107,170.67,2688.22,38957,38960
49713,1,512,512,512.00,0.00,38959,38960
49714,1,512,512,512.00,0.00,38959,38960
49715,1,512,512,512.00,0.00,38959,38960
49716,3,235,64,170.67,5769.56,38959,38962
49717,2,326,186,256.00,4900.00,38961,38963
49718,3,349,16,170.67,18761.56,38962,38965
49719,2,271,241,256.00,225.00,38964,38966
49720,1,512,512,512.00,0.00,38965,38966
49721,3,340,10,170.67,18187.56,38965,38968
49722,2,457,55,256.00,40401.00,38967,38969
49723,1,512,512,512.00,0.00,38968,38969
49724,1,512,512,512.00,0.00,38968,38969
49725,3,231,61,170.67,6033.56,38968,38971
49726,1,512,512,512.00,0.00,38970,38971
49727,1,512,512,512.00,0.00,38970,38971
49728,2,415,97,256.00,25281.00,38970,38972
49729,2,467,45,256.00,44521.00,38971,38973
49730,3,287,2,170.67,14906.89,38972,38975
49731,1,512,512,512.00,0.00,38974,38975
49732,1,512,512,512.00,0.00,38974,38975
49733,1,512,512,512.00,0.00,38974,38975
49734,3,229,103,170.67,2689.56,38974,38977
49735,1,512,512,512.00,0.00,38976,38977
49736,1,512,512,512.00,0.00,38976,38977
49737,1,512,512,512.00,0.00,38976,38977
49738,2,428,84,256.00,29584.00,38976,38978
49739,1,512,512,512.00,0.00,38977,38978
49740,2,268,244,256.00,144.00,38977,38979
49741,1,512,512,512.00,0.00,38978,38979
49742,2,480,32,256.00,50176.00,38978,38980
49743,3,424,33,170.67,32169.56,38979,38982
49744,6,223,20,85.33,6485.89,38981,38987
49745,1,512,512,512.00,0.00,38986,38987
49746,1,512,512,512.00,0.00,38986,38987
49747,2,301,211,256.00,2025.00,38986,38988
49748,1,512,512,512.00,0.00,38987,38988
49749,1,512,512,512.00,0.00,38987,38988
49750,1,512,512,512.00,0.00,38987,38988
49751,4,397,24,128.00,24197.50,38987,38991
49752,3,374,66,170.67,20678.22,38990,38993
49753,2,457,55,256.00,40401.00,38992,38994
49754,2,495,17,256.00,57121.00,38993,38995
49755,1,512,512,512.00,0.00,38994,38995
49756,2,298,214,256.00,1764.00,38994,38996
49757,1,512,512,512.00,0.00,38995,38996
49758,1,512,512,512.00,0.00,38995,38996
49759,1,512,512,512.00,0.00,38995,38996
49760,2,307,205,256.00,2601.00,38995,38997
49761,2,263,249,256.00,49.00,38996,38998
49762,4,253,7,128.00,7570.50,38997,39001
49763,1,512,512,512.00,0.00,39000,39001
49764,1,512,512,512.00,0.00,39000,39001
49765,2,386,126,256.00,16900.00,39000,39002
49766,1,512,512,512.00,0.00,39001,39002
49767,1,512,512,512.00,0.00,39001,39002
49768,4,266,2,128.00,15710.00,39001,39005
49769,1,512,512,512.00,0.00,39004,39005
49770,7,237,4,73.14,5374.12,39004,39011
49771,1,512,512,512.00,0.00,39010,39011
49772,1,512,512,512.00,0.00,39010,39011
49773,1,512,512,512.00,0.00,39010,39011
49774,2,453,59,256.00,38809.00,39010,39012
49775,1,512,512,512.00,0.00,39011,39012
49776,2,403,109,256.00,21609.00,39011,39013
49777,1,512,512,512.00,0.00,39012,39013
49778,1,512,512,512.00,0.00,39012,39013
49779,1,512,512,512.00,0.00,39012,39013
49780,3,368,1,170.67,22830.89,39012,39015
49781,1,512,512,512.00,0.00,39014,39015
49782,1,512,512,512.00,0.00,39014,39015
49783,3,410,31,170.67,28906.89,39014,39017
49784,1,512,512,512.00,0.00,39016,39017
49785,2,340,172,256.00,7056.00,39016,39018
49786,1,512,512,512.00,0.00,39017,39018
49787,1,512,512,512.00,0.00,39017,39018
49788,1,512,512,512.00,0.00,39017,39018
49789,3,284,49,170.67,9238.89,39017,39020
49790,2,490,22,256.00,54756.00,39019,39021
49791,3,322,2,170.67,17216.89,39020,39023
49792,1,512,512,512.00,0.00,39022,39023
49793,1,512,512,512.00,0.00,39022,39023
49794,3,327,2,170.67,17680.22,39022,39025
49795,1,512,512,512.00,0.00,39024,39025
49796,2,448,64,256.00,36864.00,39024,39026
49797,2,472,40,256.00,46656.00,39025,39027
49798,4,223,59,128.00,3535.50,39026,39030
49799,1,512,512,512.00,0.00,39029,39030
49800,1,512,512,512.00,0.00,39029,39030
49801,2,333,179,256.00,5929.00,39029,39031
49802,1,512,512,512.00,0.00,39030,39031
49803,1,512,512,512.00,0.00,39030,39031
49804,2,281,231,256.00,625.00,39030,39032
49805,1,512,512,512.00,0.00,39031,39032
49806,1,512,512,512.00,0.00,39031,39032
49807,3,448,31,170.67,38457.56,39031,39034
49808,1,512,512,512.00,0.00,39033,39034
49809,1,512,512,512.00,0.00,39033,39034
49810,1,512,512,512.00,0.00,39033,39034
49811,2,278,234,256.00,484.00,39033,39035
49812,1,512,512,512.00,0.00,39034,39035
49813,2,511,1,256.00,65025.00,39034,39036
49814,1,512,512,512.00,0.00,39035,39036
49815,5,182,20,102.40,4242.24,39035,39040
49816,4,456,14,128.00,35887.50,39039,39043
49817,1,512,512,512.00,0.00,39042,39043
49818,2,275,237,256.00,361.00,39042,39044
49819,1,512,512,512.00,0.00,39043,39044
49820,2,433,79,256.00,31329.00,39043,39045
49821,1,512,512,512.00,0.00,39044,39045
49822,1,512,512,512.00,0.00,39044,39045
49823,1,512,512,512.00,0.00,39044,39045
49824,1,512,512,512.00,0.00,39044,39045
49825,2,310,202,256.00,2916.00,39044,39046
49826,1,512,512,512.00,0.00,39045,39046
49827,6,193,5,85.33,3736.56,39045,39051
49828,1,512,512,512.00,0.00,39050,39051
49829,2,373,139,256.00,13689.00,39050,39052
49830,1,512,512,512.00,0.00,39051,39052
49831,3,267,15,170.67,12344.22,39051,39054
49832,2,465,47,256.00,43681.00,39053,39055
49833,1,512,512,512.00,0.00,39054,39055
49834,1,512,512,512.00,0.00,39054,39055
49835,4,208,2,128.00,5846.00,39054,39058
49836,1,512,512,512.00,0.00,39057,39058
49837,1,512,512,512.00,0.00,39057,39058
49838,1,512,512,512.00,0.00,39057,39058
49839,2,304,208,256.00,2304.00,39057,39059
49840,1,512,512,512.00,0.00,39058,39059
49841,1,512,512,512.00,0.00,39058,39059
49842,1,512,512,512.00,0.00,39058,39059
49843,2,320,192,256.00,4096.00,39058,39060
49844,3,376,2,170.67,23984.89,39059,39062
49845,1,512,512,512.00,0.00,39061,39062
49846,1,512,512,512.00,0.00,39061,39062
49847,1,512,512,512.00,0.00,39061,39062
49848,2,462,50,256.00,42436.00,39061,39063
49849,8,166,17,64.00,2251.75,39062,39070
49850,5,281,11,102.40,9523.04,39069,39074
49851,4,360,3,128.00,21278.50,39073,39077
49852,1,512,512,512.00,0.00,39076,39077
49853,3,449,4,170.67,39238.89,39076,39079
49854,3,374,1,170.67,23754.89,39078,39081
49855,4,323,20,128.00,13644.50,39080,39084
49856,1,512,512,512.00,0.00,39083,39084
49857,1,512,512,512.00,0.00,39083,39084
49858,1,512,512,512.00,0.00,39083,39084
49859,1,512,512,512.00,0.00,39083,39084
49860,2,383,129,256.00,16129.00,39083,39085
49861,3,359,5,170.67,21142.89,39084,39087
49862,2,377,135,256.00,14641.00,39086,39088
49863,1,512,512,512.00,0.00,39087,39088
49864,1,512,512,512.00,0.00,39087,39088
49865,9,268,2,56.89,8261.43,39087,39096
49866,2,333,179,256.00,5929.00,39095,39097
49867,1,512,512,512.00,0.00,39096,39097
49868,1,512,512,512.00,0.00,39096,39097
49869,1,512,512,512.00,0.00,39096,39097
49870,1,512,512,512.00,0.00,39096,39097
49871,2,357,155,256.00,10201.00,39096,39098
49872,1,512,512,512.00,0.00,39097,39098
49873,3,445,20,170.67,37750.89,39097,39100
49874,2,369,143,256.00,12769.00,39099,39101
49875,1,512,512,512.00,0.00,39100,39101
49876,1,512,512,512.00,0.00,39100,39101
49877,1,512,512,512.00,0.00,39100,39101
49878,1,512,512,512.00,0.00,39100,39101
49879,7,329,4,73.14,11598.41,39100,39107
49880,2,346,166,256.00,8100.00,39106,39108
49881,1,512,512,512.00,0.00,39107,39108
49882,1,512,512,512.00,0.00,39107,39108
49883,2,440,72,256.00,33856.00,39107,39109
49884,4,226,34,128.00,4630.00,39108,39112
49885,1,512,512,512.00,0.00,39111,39112
49886,3,301,83,170.67,8830.89,39111,39114
49887,1,512,512,512.00,0.00,39113,39114
49888,1,512,512,512.00,0.00,39113,39114
49889,4,231,2,128.00,10515.50,39113,39117
49890,1,512,512,512.00,0.00,39116,39117
49891,1,512,512,512.00,0.00,39116,39117
49892,3,372,1,170.67,23441.56,39116,39119
49893,1,512,512,512.00,0.00,39118,39119
49894,3,364,47,170.67,19174.89,39118,39121
49895,1,512,512,512.00,0.00,39120,39121
49896,1,512,512,512.00,0.00,39120,39121
49897,2,432,80,256.00,30976.00,39120,39122
49898,1,512,512,512.00,0.00,39121,39122
49899,1,512,512,512.00,0.00,39121,39122
49900,1,512,512,512.00,0.00,39121,39122
49901,5,267,7,102.40,11907.04,39121,39126
49902,1,512,512,512.00,0.00,39125,39126
49903,1,512,512,512.00,0.00,39125,39126
49904,2,388,124,256.00,17424.00,39125,39127
49905,3,505,2,170.67,55890.89,39126,39129
49906,1,512,512,512.00,0.00,39128,39129
49907,3,292,3,170.67,14993.56,39128,39131
49908,1,512,512,512.00,0.00,39130,39131
49909,2,454,58,256.00,39204.00,39130,39132
49910,3,466,5,170.67,43826.89,39131,39134
49911,3,264,63,170.67,6836.22,39133,39136
49912,4,275,5,128.00,10224.50,39135,39139
49913,1,512,512,512.00,0.00,39138,39139
49914,1,512,512,512.00,0.00,39138,39139
49915,1,512,512,512.00,0.00,39138,39139
49916,1,512,512,512.00,0.00,39138,39139
49917,2,334,178,256.00,6084.00,39138,39140
49918,3,337,44,170.67,15094.89,39139,39142
49919,1,512,512,512.00,0.00,39141,39142
49920,1,512,512,512.00,0.00,39141,39142
49921,2,370,142,256.00,12996.00,39141,39143
49922,2,497,15,256.00,58081.00,39142,39144
49923,1,512,512,512.00,0.00,39143,39144
49924,1,512,512,512.00,0.00,39143,39144
49925,1,512,512,512.00,0.00,39143,39144
49926,1,512,512,512.00,0.00,39143,39144
49927,3,327,16,170.67,16121.56,39143,39146
49928,2,325,187,256.00,4761.00,39145,39147
49929,2,473,39,256.00,47089.00,39146,39148
49930,6,359,1,85.33,15568.89,39147,39153
49931,1,512,512,512.00,0.00,39152,39153
49932,1,512,512,512.00,0.00,39152,39153
49933,1,512,512,512.00,0.00,39152,39153
49934,5,265,2,102.40,9482.64,39152,39157
49935,2,307,205,256.00,2601.00,39156,39158
49936,2,379,133,256.00,15129.00,39157,39159
49937,1,512,512,512.00,0.00,39158,39159
49938,2,395,117,256.00,19321.00,39158,39160
49939,1,512,512,512.00,0.00,39159,39160
49940,2,305,207,256.00,2401.00,39159,39161
49941,1,512,512,512.00,0.00,39160,39161
49942,1,512,512,512.00,0.00,39160,39161
49943,4,210,2,128.00,6996.50,39160,39164
49944,4,260,13,128.00,12748.50,39163,39167
49945,5,312,8,102.40,12281.84,39166,39171
49946,1,512,512,512.00,0.00,39170,39171
49947,1,512,512,512.00,0.00,39170,39171
49948,1,512,512,512.00,0.00,39170,39171
49949,2,390,122,256.00,17956.00,39170,39172
49950,1,512,512,512.00,0.00,39171,39172
49951,4,283,42,128.00,9045.50,39171,39175
49952,1,512,512,512.00,0.00,39174,39175
49953,5,228,1,102.40,5668.24,39174,39179
49954,1,512,512,512.00,0.00,39178,39179
49955,1,512,512,512.00,0.00,39178,39179
49956,2,443,69,256.00,34969.00,39178,39180
49957,1,512,512,512.00,0.00,39179,39180
49958,1,512,512,512.00,0.00,39179,39180
49959,8,209,7,64.00,5157.75,39179,39187
49960,9,212,4,56.89,4089.88,39186,39195
49961,1,512,512,512.00,0.00,39194,39195
49962,1,512,512,512.00,0.00,39194,39195
49963,1,512,512,512.00,0.00,39194,39195
49964,2,411,101,256.00,24025.00,39194,39196
49965,1,512,512,512.00,0.00,39195,39196
49966,1,512,512,512.00,0.00,39195,39196
49967,5,210,20,102.40,5209.04,39195,39200
49968,1,512,512,512.00,0.00,39199,39200
49969,1,512,512,512.00,0.00,39199,39200
49970,4,351,14,128.00,18112.50,39199,39203
49971,1,512,512,512.00,0.00,39202,39203
49972,1,512,512,512.00,0.00,39202,39203
49973,3,207,109,170.67,1921.56,39202,39205
49974,1,512,512,512.00,0.00,39204,39205
49975,1,512,512,512.00,0.00,39204,39205
49976,3,448,13,170.67,38697.56,39204,39207
49977,1,512,512,512.00,0.00,39206,39207
49978,6,264,1,85.33,7712.89,39206,39212
49979,5,230,2,102.40,8166.64,39211,39216
49980,1,512,512,512.00,0.00,39215,39216
49981,1,512,512,512.00,0.00,39215,39216
49982,3,319,11,170.67,15874.89,39215,39218
49983,1,512,512,512.00,0.00,39217,39218
49984,2,259,253,256.00,9.00,39217,39219
49985,1,512,512,512.00,0.00,39218,39219
49986,3,387,2,170.67,25840.22,39218,39221
49987,2,388,124,256.00,17424.00,39220,39222
49988,1,512,512,512.00,0.00,39221,39222
49989,1,512,512,512.00,0.00,39221,39222
49990,1,512,512,512.00,0.00,39221,39222
49991,6,301,1,85.33,10813.56,39221,39227
49992,1,512,512,512.00,0.00,39226,39227
49993,2,439,73,256.00,33489.00,39226,39228
49994,3,289,2,170.67,14994.89,39227,39230
49995,1,512,512,512.00,0.00,39229,39230
49996,1,512,512,512.00,0.00,39229,39230
49997,3,307,69,170.67,10041.56,39229,39232
49998,4,277,1,128.00,14251.00,39231,39235
49999,1,512,512,512.00,0.00,39234,39235
50000,1,512,512,512.00,0.00,39234,39235
50001,1,512,512,512.00,0.00,39234,39235
50002,2,494,18,256.00,56644.00,39234,39236
50003,2,402,110,256.00,21316.00,39235,39237
50004,1,512,512,512.00,0.00,39236,39237
50005,4,438,8,128.00,32379.50,39236,39240
50006,1,512,512,512.00,0.00,39239,39240
50007,1,512,512,512.00,0.00,39239,39240
50008,1,512,512,512.00,0.00,39239,39240
50009,1,512,512,512.00,0.00,39239,39240
50010,2,286,226,256.00,900.00,39239,39241
50011,1,512,512,512.00,0.00,39240,39241
50012,2,371,141,256.00,13225.00,39240,39242
50013,1,512,512,512.00,0.00,39241,39242
50014,1,512,512,512.00,0.00,39241,39242
50015,2,265,247,256.00,81.00,39241,39243
50016,1,512,512,512.00,0.00,39242,39243
50017,6,338,1,85.33,13831.22,39242,39248
50018,1,512,512,512.00,0.00,39247,39248
50019,2,315,197,256.00,3481.00,39247,39249
50020,3,283,114,170.67,6309.56,39248,39251
50021,1,512,512,512.00,0.00,39250,39251
50022,1,512,512,512.00,0.00,39250,39251
50023,1,512,512,512.00,0.00,39250,39251
50024,1,512,512,512.00,0.00,39250,39251
50025,3,317,7,170.67,16166.89,39250,39253
50026,1,512,512,512.00,0.00,39252,39253
50027,1,512,512,512.00,0.00,39252,39253
50028,1,512,512,512.00,0.00,39252,39253
50029,5,309,1,102.40,12989.44,39252,39257
50030,1,512,512,512.00,0.00,39256,39257
50031,1,512,512,512.00,0.00,39256,39257
50032,1,512,512,512.00,0.00,39256,39257
50033,2,330,182,256.00,5476.00,39256,39258
50034,1,512,512,512.00,0.00,39257,39258
50035,2,417,95,256.00,25921.00,39257,39259
50036,1,512,512,512.00,0.00,39258,39259
50037,1,512,512,512.00,0.00,39258,39259
50038,4,461,6,128.00,37063.50,39258,39262
50039,1,512,512,512.00,0.00,39261,39262
50040,1,512,512,512.00,0.00,39261,39262
50041,7,221,1,73.14,5795.27,39261,39268
50042,2,286,226,256.00,900.00,39267,39269
50043,3,453,8,170.67,40164.22,39268,39271
50044,4,413,1,128.00,27971.00,39270,39274
50045,4,261,2,128.00,13650.50,39273,39277
50046,1,512,512,512.00,0.00,39276,39277
50047,1,512,512,512.00,0.00,39276,39277
50048,3,334,1,170.67,18501.56,39276,39279
50049,1,512,512,512.00,0.00,39278,39279
50050,1,512,512,512.00,0.00,39278,39279
50051,1,512,512,512.00,0.00,39278,39279
50052,1,512,512,512.00,0.00,39278,39279
50053,2,454,58,256.00,39204.00,39278,39280
50054,1,512,512,512.00,0.00,39279,39280
50055,1,512,512,512.00,0.00,39279,39280
50056,4,485,1,128.00,42567.50,39279,39283
50057,1,512,512,512.00,0.00,39282,39283
50058,4,318,2,128.00,13668.00,39282,39286
50059,1,512,512,512.00,0.00,39285,39286
50060,3,192,159,170.67,228.22,39285,39288
50061,1,512,512,512.00,0.00,39287,39288
50062,3,341,1,170.67,19266.89,39287,39290
50063,1,512,512,512.00,0.00,39289,39290
50064,3,250,87,170.67,4437.56,39289,39292
50065,2,486,26,256.00,52900.00,39291,39293
50066,1,512,512,512.00,0.00,39292,39293
50067,2,454,58,256.00,39204.00,39292,39294
50068,1,512,512,512.00,0.00,39293,39294
50069,1,512,512,512.00,0.00,39293,39294
50070,1,512,512,512.00,0.00,39293,39294
50071,8,236,3,64.00,5349.50,39293,39301
50072,5,379,3,102.40,19861.44,39300,39305
50073,6,363,3,85.33,16673.89,39304,39310
50074,3,290,58,170.67,8992.89,39309,39312
50075,3,331,9,170.67,17281.56,39311,39314
50076,1,512,512,512.00,0.00,39313,39314
50077,1,512,512,512.00,0.00,39313,39314
50078,5,231,1,102.40,8725.84,39313,39318
50079,1,512,512,512.00,0.00,39317,39318
50080,1,512,512,512.00,0.00,39317,39318
50081,1,512,512,512.00,0.00,39317,39318
50082,3,264,33,170.67,9876.22,39317,39320
50083,1,512,512,512.00,0.00,39319,39320
50084,1,512,512,512.00,0.00,39319,39320
50085,5,386,2,102.40,21517.84,39319,39324
50086,2,382,130,256.00,15876.00,39323,39325
50087,1,512,512,512.00,0.00,39324,39325
50088,1,512,512,512.00,0.00,39324,39325
50089,1,512,512,512.00,0.00,39324,39325
50090,1,512,512,512.00,0.00,39324,39325
50091,5,306,18,102.40,11227.44,39324,39329
50092,9,273,1,56.89,6800.77,39328,39337
50093,4,257,23,128.00,7049.00,39336,39340
50094,2,318,194,256.00,3844.00,39339,39341
50095,1,512,512,512.00,0.00,39340,39341
50096,2,294,218,256.00,1444.00,39340,39342
50097,1,512,512,512.00,0.00,39341,39342
50098,6,268,1,85.33,10300.89,39341,39347
50099,1,512,512,512.00,0.00,39346,39347
50100,5,407,2,102.40,23737.04,39346,39351
50101,7,316,1,73.14,12549.55,39350,39357
50102,1,512,512,512.00,0.00,39356,39357
50103,1,512,512,512.00,0.00,39356,39357
50104,1,512,512,512.00,0.00,39356,39357
50105,1,512,512,512.00,0.00,39356,39357
50106,3,220,116,170.67,1816.89,39356,39359
50107,3,411,2,170.67,30448.22,39358,39361
50108,2,470,42,256.00,45796.00,39360,39362
50109,2,373,139,256.00,13689.00,39361,39363
50110,3,367,36,170.67,20161.56,39362,39365
50111,1,512,512,512.00,0.00,39364,39365
50112,1,512,512,512.00,0.00,39364,39365
50113,1,512,512,512.00,0.00,39364,39365
50114,1,512,512,512.00,0.00,39364,39365
50115,10,153,1,51.20,2636.16,39364,39374
50116,2,421,91,256.00,27225.00,39373,39375
50117,1,512,512,512.00,0.00,39374,39375
50118,3,378,2,170.67,24310.22,39374,39377
50119,1,512,512,512.00,0.00,39376,39377
50120,2,295,217,256.00,1521.00,39376,39378
50121,1,512,512,512.00,0.00,39377,39378
50122,2,258,254,256.00,4.00,39377,39379
50123,1,512,512,512.00,0.00,39378,39379
50124,1,512,512,512.00,0.00,39378,39379
50125,5,375,1,102.40,19615.44,39378,39383
50126,1,512,512,512.00,0.00,39382,39383
50127,2,382,130,256.00,15876.00,39382,39384
50128,4,224,2,128.00,8185.50,39383,39387
50129,1,512,512,512.00,0.00,39386,39387
50130,1,512,512,512.00,0.00,39386,39387
50131,1,512,512,512.00,0.00,39386,39387
50132,3,408,1,170.67,29897.56,39386,39389
50133,1,512,512,512.00,0.00,39388,39389
50134,4,273,1,128.00,16173.50,39388,39392
50135,2,287,225,256.00,961.00,39391,39393
50136,1,512,512,512.00,0.00,39392,39393
50137,3,432,1,170.67,35161.56,39392,39395
50138,1,512,512,512.00,0.00,39394,39395
50139,1,512,512,512.00,0.00,39394,39395
50140,1,512,512,512.00,0.00,39394,39395
50141,1,512,512,512.00,0.00,39394,39395
50142,4,261,4,128.00,13632.50,39394,39398
50143,2,449,63,256.00,37249.00,39397,39399
50144,2,339,173,256.00,6889.00,39398,39400
50145,6,252,2,85.33,12999.89,39399,39405
50146,2,355,157,256.00,9801.00,39404,39406
50147,1,512,512,512.00,0.00,39405,39406
50148,1,512,512,512.00,0.00,39405,39406
50149,1,512,512,512.00,0.00,39405,39406
50150,1,512,512,512.00,0.00,39405,39406
50151,6,179,5,85.33,3404.56,39405,39411
50152,4,269,3,128.00,15180.50,39410,39414
50153,1,512,512,512.00,0.00,39413,39414
50154,1,512,512,512.00,0.00,39413,39414
50155,2,493,19,256.00,56169.00,39413,39415
50156,1,512,512,512.00,0.00,39414,39415
50157,1,512,512,512.00,0.00,39414,39415
50158,2,460,52,256.00,41616.00,39414,39416
50159,1,512,512,512.00,0.00,39415,39416
50160,1,512,512,512.00,0.00,39415,39416
50161,2,276,236,256.00,400.00,39415,39417
50162,3,377,38,170.67,21866.89,39416,39419
50163,1,512,512,512.00,0.00,39418,39419
50164,1,512,512,512.00,0.00,39418,39419
50165,5,416,1,102.40,24748.24,39418,39423
50166,1,512,512,512.00,0.00,39422,39423
50167,2,495,17,256.00,57121.00,39422,39424
50168,1,512,512,512.00,0.00,39423,39424
50169,1,512,512,512.00,0.00,39423,39424
50170,1,512,512,512.00,0.00,39423,39424
50171,1,512,512,512.00,0.00,39423,39424
50172,1,512,512,512.00,0.00,39423,39424
50173,1,512,512,512.00,0.00,39423,39424
50174,7,240,4,73.14,6883.55,39423,39430
50175,1,512,512,512.00,0.00,39429,39430
50176,1,512,512,512.00,0.00,39429,39430
50177,2,493,19,256.00,56169.00,39429,39431
50178,1,512,512,512.00,0.00,39430,39431
50179,1,512,512,512.00,0.00,39430,39431
50180,1,512,512,512.00,0.00,39430,39431
50181,2,398,114,256.00,20164.00,39430,39432
50182,4,255,3,128.00,11383.50,39431,39435
50183,3,349,2,170.67,20114.89,39434,39437
50184,1,512,512,512.00,0.00,39436,39437
50185,1,512,512,512.00,0.00,39436,39437
50186,1,512,512,512.00,0.00,39436,39437
50187,1,512,512,512.00,0.00,39436,39437
50188,1,512,512,512.00,0.00,39436,39437
50189,2,309,203,256.00,2809.00,39436,39438
50190,7,235,1,73.14,7874.98,39437,39444
50191,2,436,76,256.00,32400.00,39443,39445
50192,4,429,1,128.00,30779.50,39444,39448
50193,3,258,120,170.67,3846.22,39447,39450
50194,1,512,512,512.00,0.00,39449,39450
50195,2,398,114,256.00,20164.00,39449,39451
50196,1,512,512,512.00,0.00,39450,39451
50197,1,512,512,512.00,0.00,39450,39451
50198,2,401,111,256.00,21025.00,39450,39452
50199,1,512,512,512.00,0.00,39451,39452
50200,1,512,512,512.00,0.00,39451,39452
50201,8,120,4,64.00,2150.75,39451,39459
50202,6,184,1,85.33,5569.56,39458,39464
50203,4,339,30,128.00,15247.50,39463,39467
50204,2,421,91,256.00,27225.00,39466,39468
50205,4,403,2,128.00,26875.50,39467,39471
50206,4,254,1,128.00,14787.50,39470,39474
50207,2,256,256,256.00,0.00,39473,39475
50208,2,352,160,256.00,9216.00,39474,39476
50209,2,421,91,256.00,27225.00,39475,39477
50210,1,512,512,512.00,0.00,39476,39477
50211,3,331,4,170.67,17841.56,39476,39479
50212,1,512,512,512.00,0.00,39478,39479
50213,1,512,512,512.00,0.00,39478,39479
50214,3,336,10,170.67,17723.56,39478,39481
50215,2,486,26,256.00,52900.00,39480,39482
50216,1,512,512,512.00,0.00,39481,39482
50217,1,512,512,512.00,0.00,39481,39482
50218,3,257,3,170.67,14060.22,39481,39484
50219,1,512,512,512.00,0.00,39483,39484
50220,1,512,512,512.00,0.00,39483,39484
50221,2,281,231,256.00,625.00,39483,39485
50222,1,512,512,512.00,0.00,39484,39485
50223,3,417,8,170.67,31380.22,39484,39487
50224,1,512,512,512.00,0.00,39486,39487
50225,2,444,68,256.00,35344.00,39486,39488
50226,3,284,4,170.67,14488.89,39487,39490
50227,1,512,512,512.00,0.00,39489,39490
50228,4,320,44,128.00,12456.00,39489,39493
50229,2,272,240,256.00,256.00,39492,39494
50230,4,339,8,128.00,15901.50,39493,39497
50231,4,288,1,128.00,15924.50,39496,39500
50232,1,512,512,512.00,0.00,39499,39500
50233,1,512,512,512.00,0.00,39499,39500
50234,1,512,512,512.00,0.00,39499,39500
50235,1,512,512,512.00,0.00,39499,39500
50236,1,512,512,512.00,0.00,39499,39500
50237,2,417,95,256.00,25921.00,39499,39501
50238,2,366,146,256.00,12100.00,39500,39502
50239,5,235,3,102.40,6563.04,39501,39506
50240,1,512,512,512.00,0.00,39505,39506
50241,2,336,176,256.00,6400.00,39505,39507
50242,1,512,512,512.00,0.00,39506,39507
50243,1,512,512,512.00,0.00,39506,39507
50244,4,248,23,128.00,9787.50,39506,39510
50245,2,364,148,256.00,11664.00,39509,39511
50246,6,207,1,85.33,7875.56,39510,39516
50247,1,512,512,512.00,0.00,39515,39516
50248,1,512,512,512.00,0.00,39515,39516
50249,1,512,512,512.00,0.00,39515,39516
50250,5,289,3,102.40,12027.04,39515,39520
50251,1,512,512,512.00,0.00,39519,39520
50252,1,512,512,512.00,0.00,39519,39520
50253,1,512,512,512.00,0.00,39519,39520
50254,5,190,7,102.40,5469.04,39519,39524
50255,1,512,512,512.00,0.00,39523,39524
50256,1,512,512,512.00,0.00,39523,39524
50257,1,512,512,512.00,0.00,39523,39524
50258,4,468,6,128.00,38566.00,39523,39527
50259,4,420,1,128.00,28752.50,39526,39530
50260,2,391,121,256.00,18225.00,39529,39531
50261,2,326,186,256.00,4900.00,39530,39532
50262,1,512,512,512.00,0.00,39531,39532
50263,2,365,147,256.00,11881.00,39531,39533
50264,1,512,512,512.00,0.00,39532,39533
50265,2,289,223,256.00,1089.00,39532,39534
50266,1,512,512,512.00,0.00,39533,39534
50267,1,512,512,512.00,0.00,39533,39534
50268,3,445,14,170.67,37882.89,39533,39536
50269,3,502,4,170.67,54891.56,39535,39538
50270,5,275,7,102.40,8896.64,39537,39542
50271,2,384,128,256.00,16384.00,39541,39543
50272,2,281,231,256.00,625.00,39542,39544
50273,1,512,512,512.00,0.00,39543,39544
50274,4,256,2,128.00,8150.00,39543,39547
50275,3,425,33,170.67,32416.22,39546,39549
50276,2,450,62,256.00,37636.00,39548,39550
50277,1,512,512,512.00,0.00,39549,39550
50278,2,329,183,256.00,5329.00,39549,39551
50279,1,512,512,512.00,0.00,39550,39551
50280,1,512,512,512.00,0.00,39550,39551
50281,1,512,512,512.00,0.00,39550,39551
50282,1,512,512,512.00,0.00,39550,39551
50283,6,286,1,85.33,8824.56,39550,39556
50284,1,512,512,512.00,0.00,39555,39556
50285,1,512,512,512.00,0.00,39555,39556
50286,2,480,32,256.00,50176.00,39555,39557
50287,1,512,512,512.00,0.00,39556,39557
50288,1,512,512,512.00,0.00,39556,39557
50289,1,512,512,512.00,0.00,39556,39557
50290,1,512,512,512.00,0.00,39556,39557
50291,1,512,512,512.00,0.00,39556,39557
50292,1,512,512,512.00,0.00,39556,39557
50293,1,512,512,512.00,0.00,39556,39557
50294,5,314,3,102.40,15147.44,39556,39561
50295,1,512,512,512.00,0.00,39560,39561
50296,1,512,512,512.00,0.00,39560,39561
50297,4,373,9,128.00,21731.50,39560,39564
50298,1,512,512,512.00,0.00,39563,39564
50299,1,512,512,512.00,0.00,39563,39564
50300,9,191,1,56.89,3417.21,39563,39572
50301,1,512,512,512.00,0.00,39571,39572
50302,2,433,79,256.00,31329.00,39571,39573
50303,1,512,512,512.00,0.00,39572,39573
50304,2,415,97,256.00,25281.00,39572,39574
50305,1,512,512,512.00,0.00,39573,39574
50306,1,512,512,512.00,0.00,39573,39574
50307,2,278,234,256.00,484.00,39573,39575
50308,1,512,512,512.00,0.00,39574,39575
50309,1,512,512,512.00,0.00,39574,39575
50310,1,512,512,512.00,0.00,39574,39575
50311,2,415,97,256.00,25281.00,39574,39576
50312,1,512,512,512.00,0.00,39575,39576
50313,1,512,512,512.00,0.00,39575,39576
50314,1,512,512,512.00,0.00,39575,39576
50315,2,464,48,256.00,43264.00,39575,39577
50316,1,512,512,512.00,0.00,39576,39577
50317,1,512,512,512.00,0.00,39576,39577
50318,9,229,1,56.89,5637.88,39576,39585
50319,3,367,69,170.67,19281.56,39584,39587
50320,4,296,9,128.00,15082.50,39586,39590
50321,5,227,1,102.40,8449.04,39589,39594
50322,1,512,512,512.00,0.00,39593,39594
50323,4,363,4,128.00,20960.50,39593,39597
50324,1,512,512,512.00,0.00,39596,39597
50325,1,512,512,512.00,0.00,39596,39597
50326,2,419,93,256.00,26569.00,39596,39598
50327,1,512,512,512.00,0.00,39597,39598
50328,1,512,512,512.00,0.00,39597,39598
50329,6,243,1,85.33,7448.89,39597,39603
50330,1,512,512,512.00,0.00,39602,39603
50331,2,360,152,256.00,10816.00,39602,39604
50332,1,512,512,512.00,0.00,39603,39604
50333,1,512,512,512.00,0.00,39603,39604
50334,1,512,512,512.00,0.00,39603,39604
50335,1,512,512,512.00,0.00,39603,39604
50336,5,353,31,102.40,15726.24,39603,39608
50337,2,331,181,256.00,5625.00,39607,39609
50338,1,512,512,512.00,0.00,39608,39609
50339,1,512,512,512.00,0.00,39608,39609
50340,1,512,512,512.00,0.00,39608,39609
50341,1,512,512,512.00,0.00,39608,39609
50342,1,512,512,512.00,0.00,39608,39609
50343,1,512,512,512.00,0.00,39608,39609
50344,1,512,512,512.00,0.00,39608,39609
50345,1,512,512,512.00,0.00,39608,39609
50346,1,512,512,512.00,0.00,39608,39609
50347,1,512,512,512.00,0.00,39608,39609
50348,1,512,512,512.00,0.00,39608,39609
50349,4,310,6,128.00,12996.50,39608,39612
50350,1,512,512,512.00,0.00,39611,39612
50351,1,512,512,512.00,0.00,39611,39612
50352,1,512,512,512.00,0.00,39611,39612
50353,1,512,512,512.00,0.00,39611,39612
50354,2,460,52,256.00,41616.00,39611,39613
50355,3,496,7,170.67,52921.56,39612,39615
50356,1,512,512,512.00,0.00,39614,39615
50357,3,398,42,170.67,25990.22,39614,39617
50358,1,512,512,512.00,0.00,39616,39617
50359,2,260,252,256.00,16.00,39616,39618
50360,3,294,2,170.67,15238.22,39617,39620
50361,1,512,512,512.00,0.00,39619,39620
50362,1,512,512,512.00,0.00,39619,39620
50363,5,279,24,102.40,9198.24,39619,39624
50364,5,322,4,102.40,14831.44,39623,39628
50365,1,512,512,512.00,0.00,39627,39628
50366,1,512,512,512.00,0.00,39627,39628
50367,1,512,512,512.00,0.00,39627,39628
50368,2,353,159,256.00,9409.00,39627,39629
50369,2,263,249,256.00,49.00,39628,39630
50370,1,512,512,512.00,0.00,39629,39630
50371,2,392,120,256.00,18496.00,39629,39631
50372,2,296,216,256.00,1600.00,39630,39632
50373,2,361,151,256.00,11025.00,39631,39633
50374,2,318,194,256.00,3844.00,39632,39634
50375,1,512,512,512.00,0.00,39633,39634
50376,2,384,128,256.00,16384.00,39633,39635
50377,4,255,1,128.00,8066.50,39634,39638
50378,1,512,512,512.00,0.00,39637,39638
50379,3,243,119,170.67,2776.22,39637,39640
50380,2,347,165,256.00,8281.00,39639,39641
50381,1,512,512,512.00,0.00,39640,39641
50382,1,512,512,512.00,0.00,39640,39641
50383,1,512,512,512.00,0.00,39640,39641
50384,1,512,512,512.00,0.00,39640,39641
50385,1,512,512,512.00,0.00,39640,39641
50386,1,512,512,512.00,0.00,39640,39641
50387,6,228,29,85.33,4507.22,39640,39646
50388,3,329,31,170.67,14974.89,39645,39648
50389,1,512,512,512.00,0.00,39647,39648
50390,1,512,512,512.00,0.00,39647,39648
50391,1,512,512,512.00,0.00,39647,39648
50392,1,512,512,512.00,0.00,39647,39648
50393,1,512,512,512.00,0.00,39647,39648
50394,3,348,4,170.67,19779.56,39647,39650
50395,1,512,512,512.00,0.00,39649,39650
50396,1,512,512,512.00,0.00,39649,39650
50397,1,512,512,512.00,0.00,39649,39650
50398,1,512,512,512.00,0.00,39649,39650
50399,1,512,512,512.00,0.00,39649,39650
50400,1,512,512,512.00,0.00,39649,39650
50401,1,512,512,512.00,0.00,39649,39650
50402,1,512,512,512.00,0.00,39649,39650
50403,1,512,512,512.00,0.00,39649,39650
50404,4,436,3,128.00,31844.50,39649,39653
50405,3,461,2,170.67,42514.89,39652,39655
50406,1,512,512,512.00,0.00,39654,39655
50407,1,512,512,512.00,0.00,39654,39655
50408,4,287,3,128.00,12483.50,39654,39658
50409,1,512,512,512.00,0.00,39657,39658
50410,1,512,512,512.00,0.00,39657,39658
50411,1,512,512,512.00,0.00,39657,39658
50412,2,439,73,256.00,33489.00,39657,39659
50413,3,271,1,170.67,14553.56,39658,39661
50414,1,512,512,512.00,0.00,39660,39661
50415,1,512,512,512.00,0.00,39660,39661
50416,1,512,512,512.00,0.00,39660,39661
50417,1,512,512,512.00,0.00,39660,39661
50418,1,512,512,512.00,0.00,39660,39661
50419,1,512,512,512.00,0.00,39660,39661
50420,3,282,83,170.67,6880.22,39660,39663
50421,2,462,50,256.00,42436.00,39662,39664
50422,4,279,53,128.00,7828.50,39663,39667
50423,2,377,135,256.00,14641.00,39666,39668
50424,2,451,61,256.00,38025.00,39667,39669
50425,3,397,48,170.67,25673.56,39668,39671
50426,4,399,2,128.00,25992.50,39670,39674
50427,1,512,512,512.00,0.00,39673,39674
50428,1,512,512,512.00,0.00,39673,39674
50429,1,512,512,512.00,0.00,39673,39674
50430,1,512,512,512.00,0.00,39673,39674
50431,1,512,512,512.00,0.00,39673,39674
50432,1,512,512,512.00,0.00,39673,39674
50433,1,512,512,512.00,0.00,39673,39674
50434,2,264,248,256.00,64.00,39673,39675
50435,2,327,185,256.00,5041.00,39674,39676
50436,5,287,1,102.40,10125.44,39675,39680
50437,4,283,2,128.00,16185.50,39679,39683
50438,2,369,143,256.00,12769.00,39682,39684
50439,1,512,512,512.00,0.00,39683,39684
50440,4,321,1,128.00,14689.00,39683,39687
50441,2,312,200,256.00,3136.00,39686,39688
50442,1,512,512,512.00,0.00,39687,39688
50443,1,512,512,512.00,0.00,39687,39688
50444,1,512,512,512.00,0.00,39687,39688
50445,2,308,204,256.00,2704.00,39687,39689
50446,1,512,512,512.00,0.00,39688,39689
50447,1,512,512,512.00,0.00,39688,39689
50448,3,337,44,170.67,15094.89,39688,39691
50449,2,431,81,256.00,30625.00,39690,39692
50450,1,512,512,512.00,0.00,39691,39692
50451,1,512,512,512.00,0.00,39691,39692
50452,1,512,512,512.00,0.00,39691,39692
50453,2,352,160,256.00,9216.00,39691,39693
50454,2,429,83,256.00,29929.00,39692,39694
50455,1,512,512,512.00,0.00,39693,39694
50456,1,512,512,512.00,0.00,39693,39694
50457,4,192,59,128.00,2218.50,39693,39697
50458,2,285,227,256.00,841.00,39696,39698
50459,1,512,512,512.00,0.00,39697,39698
50460,1,512,512,512.00,0.00,39697,39698
50461,3,327,29,170.67,14908.22,39697,39700
50462,3,215,136,170.67,1086.89,39699,39702
50463,3,364,2,170.67,22144.89,39701,39704
50464,1,512,512,512.00,0.00,39703,39704
50465,2,396,116,256.00,19600.00,39703,39705
50466,5,161,33,102.40,2147.84,39704,39709
50467,2,503,9,256.00,61009.00,39708,39710
50468,1,512,512,512.00,0.00,39709,39710
50469,1,512,512,512.00,0.00,39709,39710
50470,2,350,162,256.00,8836.00,39709,39711
50471,1,512,512,512.00,0.00,39710,39711
50472,2,361,151,256.00,11025.00,39710,39712
50473,1,512,512,512.00,0.00,39711,39712
50474,1,512,512,512.00,0.00,39711,39712
50475,2,313,199,256.00,3249.00,39711,39713
50476,2,338,174,256.00,6724.00,39712,39714
50477,1,512,512,512.00,0.00,39713,39714
50478,1,512,512,512.00,0.00,39713,39714
50479,1,512,512,512.00,0.00,39713,39714
50480,4,403,1,128.00,26014.50,39713,39717
50481,1,512,512,512.00,0.00,39716,39717
50482,2,327,185,256.00,5041.00,39716,39718
50483,5,201,5,102.40,7267.04,39717,39722
50484,1,512,512,512.00,0.00,39721,39722
50485,1,512,512,512.00,0.00,39721,39722
50486,4,434,4,128.00,31758.00,39721,39725
50487,2,504,8,256.00,61504.00,39724,39726
50488,1,512,512,512.00,0.00,39725,39726
50489,1,512,512,512.00,0.00,39725,39726
50490,1,512,512,512.00,0.00,39725,39726
50491,1,512,512,512.00,0.00,39725,39726
50492,4,270,4,128.00,9375.50,39725,39729
50493,3,369,4,170.67,22705.56,39728,39731
50494,1,512,512,512.00,0.00,39730,39731
50495,5,488,1,102.40,37188.64,39730,39735
50496,2,270,242,256.00,196.00,39734,39736
50497,1,512,512,512.00,0.00,39735,39736
50498,2,319,193,256.00,3969.00,39735,39737
50499,1,512,512,512.00,0.00,39736,39737
50500,1,512,512,512.00,0.00,39736,39737
50501,1,512,512,512.00,0.00,39736,39737
50502,1,512,512,512.00,0.00,39736,39737
50503,1,512,512,512.00,0.00,39736,39737
50504,1,512,512,512.00,0.00,39736,39737
50505,1,512,512,512.00,0.00,39736,39737
50506,3,230,101,170.67,2826.89,39736,39739
50507,1,512,512,512.00,0.00,39738,39739
50508,8,155,1,64.00,2631.75,39738,39746
50509,3,336,37,170.67,15401.56,39745,39748
50510,1,512,512,512.00,0.00,39747,39748
50511,2,266,246,256.00,100.00,39747,39749
50512,1,512,512,512.00,0.00,39748,39749
50513,2,371,141,256.00,13225.00,39748,39750
50514,1,512,512,512.00,0.00,39749,39750
50515,1,512,512,512.00,0.00,39749,39750
50516,5,288,10,102.40,9874.64,39749,39754
50517,6,148,1,85.33,3059.22,39753,39759
50518,1,512,512,512.00,0.00,39758,39759
50519,1,512,512,512.00,0.00,39758,39759
50520,1,512,512,512.00,0.00,39758,39759
50521,2,288,224,256.00,1024.00,39758,39760
50522,1,512,512,512.00,0.00,39759,39760
50523,4,423,1,128.00,30001.00,39759,39763
50524,1,512,512,512.00,0.00,39762,39763
50525,3,463,3,170.67,43037.56,39762,39765
50526,3,372,31,170.67,21281.56,39764,39767
50527,1,512,512,512.00,0.00,39766,39767
50528,1,512,512,512.00,0.00,39766,39767
50529,1,512,512,512.00,0.00,39766,39767
50530,1,512,512,512.00,0.00,39766,39767
50531,1,512,512,512.00,0.00,39766,39767
50532,1,512,512,512.00,0.00,39766,39767
50533,1,512,512,512.00,0.00,39766,39767
50534,3,495,6,170.67,52600.22,39766,39769
50535,1,512,512,512.00,0.00,39768,39769
50536,2,271,241,256.00,225.00,39768,39770
50537,2,426,86,256.00,28900.00,39769,39771
50538,1,512,512,512.00,0.00,39770,39771
50539,1,512,512,512.00,0.00,39770,39771
50540,1,512,512,512.00,0.00,39770,39771
50541,1,512,512,512.00,0.00,39770,39771
50542,1,512,512,512.00,0.00,39770,39771
50543,1,512,512,512.00,0.00,39770,39771
50544,7,177,1,73.14,3380.12,39770,39777
50545,2,278,234,256.00,484.00,39776,39778
50546,1,512,512,512.00,0.00,39777,39778
50547,1,512,512,512.00,0.00,39777,39778
50548,1,512,512,512.00,0.00,39777,39778
50549,4,269,2,128.00,15753.50,39777,39781
50550,1,512,512,512.00,0.00,39780,39781
50551,1,512,512,512.00,0.00,39780,39781
50552,1,512,512,512.00,0.00,39780,39781
50553,4,178,1,128.00,5401.50,39780,39784
50554,1,512,512,512.00,0.00,39783,39784
50555,2,424,88,256.00,28224.00,39783,39785
50556,1,512,512,512.00,0.00,39784,39785
50557,1,512,512,512.00,0.00,39784,39785
50558,1,512,512,512.00,0.00,39785,39786
50559,5,285,1,102.40,13611.04,39785,39790
50560,1,512,512,512.00,0.00,39789,39790
50561,3,332,49,170.67,14134.89,39789,39792
50562,3,356,9,170.67,20348.22,39791,39794
50563,1,512,512,512.00,0.00,39793,39794
50564,1,512,512,512.00,0.00,39793,39794
50565,1,512,512,512.00,0.00,39793,39794
50566,1,512,512,512.00,0.00,39793,39794
50567,3,344,16,170.67,18104.89,39793,39796
50568,1,512,512,512.00,0.00,39795,39796
50569,1,512,512,512.00,0.00,39795,39796
50570,3,273,15,170.67,12516.22,39795,39798
50571,6,375,15,85.33,16897.89,39797,39803
50572,3,305,23,170.67,13342.89,39802,39805
50573,1,512,512,512.00,0.00,39804,39805
50574,2,482,30,256.00,51076.00,39804,39806
50575,1,512,512,512.00,0.00,39805,39806
50576,3,377,20,170.67,22790.89,39805,39808
50577,2,494,18,256.00,56644.00,39807,39809
50578,3,269,76,170.67,6214.89,39808,39811
50579,2,510,2,256.00,64516.00,39810,39812
50580,3,336,28,170.67,16067.56,39811,39814
50581,2,398,114,256.00,20164.00,39813,39815
50582,2,302,210,256.00,2116.00,39814,39816
50583,1,512,512,512.00,0.00,39815,39816
50584,1,512,512,512.00,0.00,39815,39816
50585,1,512,512,512.00,0.00,39815,39816
50586,1,512,512,512.00,0.00,39815,39816
50587,1,512,512,512.00,0.00,39815,39816
50588,1,512,512,512.00,0.00,39815,39816
50589,1,512,512,512.00,0.00,39815,39816
50590,1,512,512,512.00,0.00,39815,39816
50591,1,512,512,512.00,0.00,39815,39816
50592,1,512,512,512.00,0.00,39815,39816
50593,3,484,1,170.67,49201.56,39815,39818
50594,1,512,512,512.00,0.00,39817,39818
50595,2,283,229,256.00,729.00,39817,39819
50596,1,512,512,512.00,0.00,39818,39819
50597,4,399,2,128.00,25282.50,39818,39822
50598,2,511,1,256.00,65025.00,39821,39823
50599,4,376,1,128.00,23383.50,39822,39826
50600,1,512,512,512.00,0.00,39825,39826
50601,1,512,512,512.00,0.00,39825,39826
50602,1,512,512,512.00,0.00,39825,39826
50603,1,512,512,512.00,0.00,39825,39826
50604,1,512,512,512.00,0.00,39825,39826
50605,1,512,512,512.00,0.00,39825,39826
50606,1,512,512,512.00,0.00,39825,39826
50607,1,512,512,512.00,0.00,39825,39826
50608,2,494,18,256.00,56644.00,39825,39827
50609,3,459,1,170.67,42001.56,39826,39829
50610,3,254,22,170.67,11104.89,39828,39831
50611,1,512,512,512.00,0.00,39830,39831
50612,1,512,512,512.00,0.00,39830,39831
50613,1,512,512,512.00,0.00,39830,39831
50614,1,512,512,512.00,0.00,39830,39831
50615,1,512,512,512.00,0.00,39830,39831
50616,1,512,512,512.00,0.00,39830,39831
50617,1,512,512,512.00,0.00,39830,39831
50618,1,512,512,512.00,0.00,39830,39831
50619,4,353,1,128.00,19937.00,39830,39834
50620,2,487,25,256.00,53361.00,39833,39835
50621,1,512,512,512.00,0.00,39834,39835
50622,1,512,512,512.00,0.00,39834,39835
50623,1,512,512,512.00,0.00,39834,39835
50624,1,512,512,512.00,0.00,39834,39835
50625,4,217,58,128.00,3286.50,39834,39838
50626,2,286,226,256.00,900.00,39837,39839
50627,1,512,512,512.00,0.00,39838,39839
50628,1,512,512,512.00,0.00,39838,39839
50629,1,512,512,512.00,0.00,39838,39839
50630,1,512,512,512.00,0.00,39838,39839
50631,2,507,5,256.00,63001.00,39838,39840
50632,1,512,512,512.00,0.00,39839,39840
50633,3,263,96,170.67,4804.22,39839,39842
50634,1,512,512,512.00,0.00,39841,39842
50635,1,512,512,512.00,0.00,39841,39842
50636,3,439,32,170.67,36014.89,39841,39844
50637,2,442,70,256.00,34596.00,39843,39845
50638,2,497,15,256.00,58081.00,39844,39846
50639,1,512,512,512.00,0.00,39845,39846
50640,1,512,512,512.00,0.00,39845,39846
50641,1,512,512,512.00,0.00,39845,39846
50642,1,512,512,512.00,0.00,39845,39846
50643,3,334,20,170.67,16512.89,39845,39848
50644,1,512,512,512.00,0.00,39847,39848
50645,1,512,512,512.00,0.00,39847,39848
50646,1,512,512,512.00,0.00,39847,39848
50647,1,512,512,512.00,0.00,39847,39848
50648,1,512,512,512.00,0.00,39847,39848
50649,1,512,512,512.00,0.00,39847,39848
50650,2,322,190,256.00,4356.00,39847,39849
50651,1,512,512,512.00,0.00,39848,39849
50652,1,512,512,512.00,0.00,39848,39849
50653,3,449,2,170.67,39314.89,39848,39851
50654,2,329,183,256.00,5329.00,39850,39852
50655,1,512,512,512.00,0.00,39851,39852
50656,1,512,512,512.00,0.00,39851,39852
50657,1,512,512,512.00,0.00,39851,39852
50658,3,373,14,170.67,22522.89,39851,39854
50659,2,268,244,256.00,144.00,39853,39855
50660,1,512,512,512.00,0.00,39854,39855
50661,1,512,512,512.00,0.00,39854,39855
50662,1,512,512,512.00,0.00,39854,39855
50663,1,512,512,512.00,0.00,39854,39855
50664,1,512,512,512.00,0.00,39854,39855
50665,1,512,512,512.00,0.00,39854,39855
50666,1,512,512,512.00,0.00,39854,39855
50667,1,512,512,512.00,0.00,39854,39855
50668,1,512,512,512.00,0.00,39854,39855
50669,1,512,512,512.00,0.00,39854,39855
50670,1,512,512,512.00,0.00,39854,39855
50671,2,345,167,256.00,7921.00,39854,39856
50672,1,512,512,512.00,0.00,39855,39856
50673,1,512,512,512.00,0.00,39855,39856
50674,1,512,512,512.00,0.00,39855,39856
50675,1,512,512,512.00,0.00,39855,39856
50676,1,512,512,512.00,0.00,39855,39856
50677,4,450,3,128.00,34714.50,39855,39859
50678,3,497,6,170.67,53248.22,39858,39861
50679,1,512,512,512.00,0.00,39860,39861
50680,1,512,512,512.00,0.00,39860,39861
50681,1,512,512,512.00,0.00,39860,39861
50682,1,512,512,512.00,0.00,39860,39861
50683,3,233,63,170.67,5844.22,39860,39863
50684,1,512,512,512.00,0.00,39862,39863
50685,2,430,82,256.00,30276.00,39862,39864
50686,1,512,512,512.00,0.00,39863,39864
50687,1,512,512,512.00,0.00,39863,39864
50688,2,452,60,256.00,38416.00,39863,39865
50689,3,390,58,170.67,24059.56,39864,39867
50690,1,512,512,512.00,0.00,39866,39867
50691,1,512,512,512.00,0.00,39866,39867
50692,1,512,512,512.00,0.00,39866,39867
50693,4,243,39,128.00,6429.00,39866,39870
50694,1,512,512,512.00,0.00,39869,39870
50695,1,512,512,512.00,0.00,39869,39870
50696,1,512,512,512.00,0.00,39869,39870
50697,3,235,121,170.67,2273.56,39869,39872
50698,1,512,512,512.00,0.00,39871,39872
50699,2,368,144,256.00,12544.00,39871,39873
50700,1,512,512,512.00,0.00,39872,39873
50701,1,512,512,512.00,0.00,39872,39873
50702,1,512,512,512.00,0.00,39872,39873
50703,1,512,512,512.00,0.00,39872,39873
50704,1,512,512,512.00,0.00,39872,39873
50705,1,512,512,512.00,0.00,39872,39873
50706,3,401,32,170.67,26894.89,39872,39875
50707,2,266,246,256.00,100.00,39874,39876
50708,1,512,512,512.00,0.00,39875,39876
50709,1,512,512,512.00,0.00,39875,39876
50710,1,512,512,512.00,0.00,39875,39876
50711,2,312,200,256.00,3136.00,39875,39877
50712,1,512,512,512.00,0.00,39876,39877
50713,1,512,512,512.00,0.00,39876,39877
50714,1,512,512,512.00,0.00,39876,39877
50715,2,495,17,256.00,57121.00,39876,39878
50716,3,288,14,170.67,13286.22,39877,39880
50717,2,298,214,256.00,1764.00,39879,39881
50718,1,512,512,512.00,0.00,39880,39881
50719,1,512,512,512.00,0.00,39880,39881
50720,2,395,117,256.00,19321.00,39880,39882
50721,1,512,512,512.00,0.00,39881,39882
50722,4,351,5,128.00,19776.50,39881,39885
50723,1,512,512,512.00,0.00,39884,39885
50724,1,512,512,512.00,0.00,39884,39885
50725,1,512,512,512.00,0.00,39884,39885
50726,3,340,3,170.67,18929.56,39884,39887
50727,2,446,66,256.00,36100.00,39886,39888
50728,1,512,512,512.00,0.00,39887,39888
50729,1,512,512,512.00,0.00,39887,39888
50730,4,252,25,128.00,6606.50,39887,39891
50731,4,291,1,128.00,11348.50,39890,39894
50732,2,266,246,256.00,100.00,39893,39895
50733,1,512,512,512.00,0.00,39894,39895
50734,1,512,512,512.00,0.00,39894,39895
50735,2,289,223,256.00,1089.00,39894,39896
50736,1,512,512,512.00,0.00,39895,39896
50737,1,512,512,512.00,0.00,39895,39896
50738,1,512,512,512.00,0.00,39895,39896
50739,3,221,71,170.67,4966.89,39895,39898
50740,1,512,512,512.00,0.00,39897,39898
50741,3,339,69,170.67,14372.22,39897,39900
50742,2,329,183,256.00,5329.00,39899,39901
50743,1,512,512,512.00,0.00,39900,39901
50744,1,512,512,512.00,0.00,39900,39901
50745,1,512,512,512.00,0.00,39900,39901
50746,1,512,512,512.00,0.00,39900,39901
50747,5,472,1,102.40,34231.84,39900,39905
50748,2,391,121,256.00,18225.00,39904,39906
50749,4,394,5,128.00,24042.50,39905,39909
50750,3,358,46,170.67,18187.56,39908,39911
50751,6,307,1,85.33,10540.89,39910,39916
50752,1,512,512,512.00,0.00,39915,39916
50753,2,294,218,256.00,1444.00,39915,39917
50754,1,512,512,512.00,0.00,39916,39917
50755,2,390,122,256.00,17956.00,39916,39918
50756,2,271,241,256.00,225.00,39917,39919
50757,2,486,26,256.00,52900.00,39918,39920
50758,4,294,31,128.00,9836.50,39919,39923
50759,2,505,7,256.00,62001.00,39922,39924
50760,2,265,247,256.00,81.00,39923,39925
50761,1,512,512,512.00,0.00,39924,39925
50762,1,512,512,512.00,0.00,39924,39925
50763,1,512,512,512.00,0.00,39924,39925
50764,1,512,512,512.00,0.00,39924,39925
50765,1,512,512,512.00,0.00,39924,39925
50766,1,512,512,512.00,0.00,39924,39925
50767,1,512,512,512.00,0.00,39924,39925
50768,1,512,512,512.00,0.00,39924,39925
50769,2,451,61,256.00,38025.00,39924,39926
50770,7,316,6,73.14,10236.69,39925,39932
50771,1,512,512,512.00,0.00,39931,39932
50772,4,255,36,128.00,8579.50,39931,39935
50773,1,512,512,512.00,0.00,39934,39935
50774,1,512,512,512.00,0.00,39934,39935
50775,1,512,512,512.00,0.00,39934,39935
50776,1,512,512,512.00,0.00,39934,39935
50777,2,413,99,256.00,24649.00,39934,39936
50778,3,380,38,170.67,22432.89,39935,39938
50779,2,390,122,256.00,17956.00,39937,39939
50780,1,512,512,512.00,0.00,39938,39939
50781,5,329,10,102.40,13882.24,39938,39943
50782,1,512,512,512.00,0.00,39942,39943
50783,1,512,512,512.00,0.00,39942,39943
50784,1,512,512,512.00,0.00,39942,39943
50785,1,512,512,512.00,0.00,39942,39943
50786,1,512,512,512.00,0.00,39942,39943
50787,3,351,36,170.67,17580.22,39942,39945
50788,1,512,512,512.00,0.00,39944,39945
50789,1,512,512,512.00,0.00,39944,39945
50790,1,512,512,512.00,0.00,39944,39945
50791,2,479,33,256.00,49729.00,39944,39946
50792,1,512,512,512.00,0.00,39945,39946
50793,1,512,512,512.00,0.00,39945,39946
50794,1,512,512,512.00,0.00,39945,39946
50795,1,512,512,512.00,0.00,39945,39946
50796,3,457,2,170.67,41426.89,39945,39948
50797,3,355,25,170.67,18897.56,39947,39950
50798,3,470,10,170.67,44880.89,39949,39952
50799,2,292,220,256.00,1296.00,39951,39953
50800,1,512,512,512.00,0.00,39952,39953
50801,1,512,512,512.00,0.00,39952,39953
50802,3,258,3,170.67,14064.22,39952,39955
50803,1,512,512,512.00,0.00,39954,39955
50804,1,512,512,512.00,0.00,39954,39955
50805,4,279,23,128.00,11609.00,39954,39958
50806,3,384,38,170.67,23206.22,39957,39960
50807,1,512,512,512.00,0.00,39959,39960
50808,3,494,1,170.67,52314.89,39960,39963
50809,1,512,512,512.00,0.00,39962,39963
50810,1,512,512,512.00,0.00,39962,39963
50811,1,512,512,512.00,0.00,39962,39963
50812,1,512,512,512.00,0.00,39962,39963
50813,1,512,512,512.00,0.00,39962,39963
50814,1,512,512,512.00,0.00,39962,39963
50815,1,512,512,512.00,0.00,39962,39963
50816,4,207,44,128.00,4317.50,39962,39966
50817,1,512,512,512.00,0.00,39965,39966
50818,1,512,512,512.00,0.00,39965,39966
50819,3,297,58,170.67,9613.56,39965,39968
50820,2,473,39,256.00,47089.00,39967,39969
50821,2,486,26,256.00,52900.00,39968,39970
50822,1,512,512,512.00,0.00,39969,39970
50823,2,418,94,256.00,26244.00,39969,39971
50824,3,370,3,170.67,22949.56,39970,39973
50825,1,512,512,512.00,0.00,39972,39973
50826,1,512,512,512.00,0.00,39972,39973
50827,1,512,512,512.00,0.00,39972,39973
50828,1,512,512,512.00,0.00,39972,39973
50829,2,325,187,256.00,4761.00,39972,39974
50830,1,512,512,512.00,0.00,39973,39974
50831,1,512,512,512.00,0.00,39973,39974
50832,1,512,512,512.00,0.00,39973,39974
50833,2,290,222,256.00,1156.00,39973,39975
50834,1,512,512,512.00,0.00,39974,39975
50835,1,512,512,512.00,0.00,39974,39975
50836,3,273,94,170.67,5669.56,39974,39977
50837,1,512,512,512.00,0.00,39976,39977
50838,1,512,512,512.00,0.00,39976,39977
50839,1,512,512,512.00,0.00,39976,39977
50840,1,512,512,512.00,0.00,39976,39977
50841,2,491,21,256.00,55225.00,39976,39978
50842,1,512,512,512.00,0.00,39977,39978
50843,3,296,67,170.67,8974.89,39977,39980
50844,2,331,181,256.00,5625.00,39979,39981
50845,1,512,512,512.00,0.00,39980,39981
50846,4,322,7,128.00,13925.50,39980,39984
50847,2,409,103,256.00,23409.00,39983,39985
50848,1,512,512,512.00,0.00,39984,39985
50849,1,512,512,512.00,0.00,39984,39985
50850,1,512,512,512.00,0.00,39984,39985
50851,3,326,88,170.67,12080.89,39984,39987
50852,1,512,512,512.00,0.00,39986,39987
50853,1,512,512,512.00,0.00,39986,39987
50854,3,314,59,170.67,11338.89,39986,39989
50855,6,161,15,85.33,3334.89,39988,39994
50856,2,395,117,256.00,19321.00,39993,39995
50857,1,512,512,512.00,0.00,39994,39995
50858,1,512,512,512.00,0.00,39994,39995
50859,2,267,245,256.00,121.00,39994,39996
50860,1,512,512,512.00,0.00,39995,39996
50861,2,358,154,256.00,10404.00,39995,39997
50862,3,468,22,170.67,44203.56,39996,39999
50863,1,512,512,512.00,0.00,39998,39999
50864,1,512,512,512.00,0.00,39998,39999
50865,1,512,512,512.00,0.00,39998,39999
50866,3,414,7,170.67,30781.56,39998,40001
50867,1,512,512,512.00,0.00,40000,40001
50868,1,512,512,512.00,0.00,40000,40001
50869,1,512,512,512.00,0.00,40000,40001
50870,2,350,162,256.00,8836.00,40000,40002
50871,2,322,190,256.00,4356.00,40001,40003
50872,1,512,512,512.00,0.00,40002,40003
50873,2,313,199,256.00,3249.00,40002,40004
50874,3,408,10,170.67,29339.56,40003,40006
50875,1,512,512,512.00,0.00,40005,40006
50876,1,512,512,512.00,0.00,40005,40006
50877,2,305,207,256.00,2401.00,40005,40007
50878,2,405,107,256.00,22201.00,40006,40008
50879,1,512,512,512.00,0.00,40007,40008
50880,1,512,512,512.00,0.00,40007,40008
50881,1,512,512,512.00,0.00,40007,40008
50882,2,483,29,256.00,51529.00,40007,40009
50883,2,438,74,256.00,33124.00,40008,40010
50884,1,512,512,512.00,0.00,40009,40010
50885,1,512,512,512.00,0.00,40009,40010
50886,1,512,512,512.00,0.00,40009,40010
50887,1,512,512,512.00,0.00,40009,40010
50888,1,512,512,512.00,0.00,40009,40010
50889,4,269,20,128.00,11677.50,40009,40013
50890,2,356,156,256.00,10000.00,40012,40014
50891,1,512,512,512.00,0.00,40013,40014
50892,1,512,512,512.00,0.00,40013,40014
50893,1,512,512,512.00,0.00,40013,40014
50894,3,343,11,170.67,18450.89,40013,40016
50895,1,512,512,512.00,0.00,40015,40016
50896,3,290,30,170.67,11494.22,40015,40018
50897,1,512,512,512.00,0.00,40017,40018
50898,1,512,512,512.00,0.00,40017,40018
50899,1,512,512,512.00,0.00,40017,40018
50900,1,512,512,512.00,0.00,40017,40018
50901,1,512,512,512.00,0.00,40017,40018
50902,1,512,512,512.00,0.00,40017,40018
50903,2,327,185,256.00,5041.00,40017,40019
50904,1,512,512,512.00,0.00,40018,40019
50905,2,510,2,256.00,64516.00,40019,40021
50906,3,239,45,170.67,7916.22,40020,40023
50907,3,260,66,170.67,6390.22,40022,40025
50908,2,352,160,256.00,9216.00,40024,40026
50909,1,512,512,512.00,0.00,40025,40026
50910,2,412,100,256.00,24336.00,40025,40027
50911,2,444,68,256.00,35344.00,40026,40028
50912,2,374,138,256.00,13924.00,40027,40029
50913,1,512,512,512.00,0.00,40028,40029
50914,1,512,512,512.00,0.00,40028,40029
50915,2,327,185,256.00,5041.00,40028,40030
50916,1,512,512,512.00,0.00,40029,40030
50917,2,315,197,256.00,3481.00,40029,40031
50918,1,512,512,512.00,0.00,40030,40031
50919,2,510,2,256.00,64516.00,40030,40032
50920,3,304,5,170.67,15422.89,40031,40034
50921,1,512,512,512.00,0.00,40033,40034
50922,1,512,512,512.00,0.00,40033,40034
50923,1,512,512,512.00,0.00,40033,40034
50924,1,512,512,512.00,0.00,40033,40034
50925,2,395,117,256.00,19321.00,40033,40035
50926,2,285,227,256.00,841.00,40034,40036
50927,3,300,35,170.67,11724.22,40035,40038
50928,3,349,35,170.67,17342.89,40037,40040
50929,2,317,195,256.00,3721.00,40039,40041
50930,1,512,512,512.00,0.00,40040,40041
50931,1,512,512,512.00,0.00,40040,40041
50932,1,512,512,512.00,0.00,40040,40041
50933,1,512,512,512.00,0.00,40040,40041
50934,4,311,3,128.00,17307.00,40040,40044
50935,1,512,512,512.00,0.00,40043,40044
50936,5,258,1,102.40,10970.24,40043,40048
50937,1,512,512,512.00,0.00,40047,40048
50938,1,512,512,512.00,0.00,40047,40048
50939,1,512,512,512.00,0.00,40047,40048
50940,1,512,512,512.00,0.00,40047,40048
50941,1,512,512,512.00,0.00,40047,40048
50942,1,512,512,512.00,0.00,40047,40048
50943,2,291,221,256.00,1225.00,40047,40049
50944,1,512,512,512.00,0.00,40048,40049
50945,1,512,512,512.00,0.00,40048,40049
50946,1,512,512,512.00,0.00,40048,40049
50947,1,512,512,512.00,0.00,40048,40049
50948,1,512,512,512.00,0.00,40048,40049
50949,2,402,110,256.00,21316.00,40048,40050
50950,2,464,48,256.00,43264.00,40049,40051
50951,1,512,512,512.00,0.00,40050,40051
50952,1,512,512,512.00,0.00,40050,40051
50953,1,512,512,512.00,0.00,40050,40051
50954,3,378,45,170.67,21816.22,40050,40053
50955,1,512,512,512.00,0.00,40052,40053
50956,1,512,512,512.00,0.00,40052,40053
50957,1,512,512,512.00,0.00,40052,40053
50958,3,279,3,170.67,14456.22,40052,40055
50959,1,512,512,512.00,0.00,40054,40055
50960,1,512,512,512.00,0.00,40054,40055
50961,1,512,512,512.00,0.00,40054,40055
50962,1,512,512,512.00,0.00,40054,40055
50963,2,502,10,256.00,60516.00,40054,40056
50964,2,511,1,256.00,65025.00,40055,40057
50965,2,484,28,256.00,51984.00,40056,40058
50966,1,512,512,512.00,0.00,40057,40058
50967,1,512,512,512.00,0.00,40057,40058
50968,1,512,512,512.00,0.00,40057,40058
50969,1,512,512,512.00,0.00,40057,40058
50970,1,512,512,512.00,0.00,40057,40058
50971,1,512,512,512.00,0.00,40057,40058
50972,1,512,512,512.00,0.00,40057,40058
50973,1,512,512,512.00,0.00,40057,40058
50974,3,424,1,170.67,33321.56,40057,40060
50975,1,512,512,512.00,0.00,40059,40060
50976,1,512,512,512.00,0.00,40059,40060
50977,2,374,138,256.00,13924.00,40059,40061
50978,1,512,512,512.00,0.00,40060,40061
50979,1,512,512,512.00,0.00,40060,40061
50980,1,512,512,512.00,0.00,40060,40061
50981,1,512,512,512.00,0.00,40060,40061
50982,2,385,127,256.00,16641.00,40060,40062
50983,1,512,512,512.00,0.00,40061,40062
50984,2,257,255,256.00,1.00,40061,40063
50985,1,512,512,512.00,0.00,40062,40063
50986,1,512,512,512.00,0.00,40062,40063
50987,1,512,512,512.00,0.00,40062,40063
50988,1,512,512,512.00,0.00,40062,40063
50989,1,512,512,512.00,0.00,40062,40063
50990,1,512,512,512.00,0.00,40062,40063
50991,1,512,512,512.00,0.00,40062,40063
50992,2,441,71,256.00,34225.00,40062,40064
50993,1,512,512,512.00,0.00,40063,40064
50994,1,512,512,512.00,0.00,40063,40064
50995,4,259,1,128.00,15405.00,40063,40067
50996,1,512,512,512.00,0.00,40066,40067
50997,4,256,4,128.00,8454.00,40066,40070
50998,1,512,512,512.00,0.00,40069,40070
50999,1,512,512,512.00,0.00,40069,40070
51000,1,512,512,512.00,0.00,40069,40070
51001,1,512,512,512.00,0.00,40069,40070
51002,1,512,512,512.00,0.00,40069,40070
51003,4,188,4,128.00,5280.50,40069,40073
51004,2,483,29,256.00,51529.00,40072,40074
51005,1,512,512,512.00,0.00,40073,40074
51006,1,512,512,512.00,0.00,40073,40074
51007,1,512,512,512.00,0.00,40073,40074
51008,1,512,512,512.00,0.00,40073,40074
51009,3,210,120,170.67,1414.22,40073,40076
51010,1,512,512,512.00,0.00,40075,40076
51011,3,256,3,170.67,14057.56,40075,40078
51012,2,420,92,256.00,26896.00,40077,40079
51013,1,512,512,512.00,0.00,40078,40079
51014,1,512,512,512.00,0.00,40078,40079
51015,1,512,512,512.00,0.00,40078,40079
51016,1,512,512,512.00,0.00,40078,40079
51017,1,512,512,512.00,0.00,40078,40079
51018,1,512,512,512.00,0.00,40078,40079
51019,1,512,512,512.00,0.00,40078,40079
51020,1,512,512,512.00,0.00,40078,40079
51021,1,512,512,512.00,0.00,40078,40079
51022,3,319,40,170.67,13129.56,40078,40081
51023,2,469,43,256.00,45369.00,40080,40082
51024,1,512,512,512.00,0.00,40081,40082
51025,1,512,512,512.00,0.00,40081,40082
51026,1,512,512,512.00,0.00,40081,40082
51027,1,512,512,512.00,0.00,40081,40082
51028,3,443,18,170.67,37264.22,40081,40084
51029,2,434,78,256.00,31684.00,40083,40085
51030,1,512,512,512.00,0.00,40084,40085
51031,3,422,2,170.67,32816.89,40084,40087
51032,1,512,512,512.00,0.00,40086,40087
51033,5,444,1,102.40,29409.84,40086,40091
51034,2,354,158,256.00,9604.00,40090,40092
51035,1,512,512,512.00,0.00,40091,40092
51036,1,512,512,512.00,0.00,40091,40092
51037,1,512,512,512.00,0.00,40091,40092
51038,1,512,512,512.00,0.00,40091,40092
51039,3,256,12,170.67,12611.56,40091,40094
51040,1,512,512,512.00,0.00,40093,40094
51041,1,512,512,512.00,0.00,40093,40094
51042,1,512,512,512.00,0.00,40093,40094
51043,1,512,512,512.00,0.00,40093,40094
51044,4,303,11,128.00,13483.50,40093,40097
51045,6,368,11,85.33,16174.56,40096,40102
51046,1,512,512,512.00,0.00,40101,40102
51047,1,512,512,512.00,0.00,40101,40102
51048,1,512,512,512.00,0.00,40101,40102
51049,1,512,512,512.00,0.00,40101,40102
51050,1,512,512,512.00,0.00,40101,40102
51051,1,512,512,512.00,0.00,40101,40102
51052,2,455,57,256.00,39601.00,40101,40103
51053,1,512,512,512.00,0.00,40102,40103
51054,1,512,512,512.00,0.00,40102,40103
51055,2,444,68,256.00,35344.00,40102,40104
51056,2,372,140,256.00,13456.00,40103,40105
51057,2,386,126,256.00,16900.00,40104,40106
51058,2,306,206,256.00,2500.00,40105,40107
51059,1,512,512,512.00,0.00,40106,40107
51060,1,512,512,512.00,0.00,40106,40107
51061,1,512,512,512.00,0.00,40106,40107
51062,5,187,3,102.40,4360.64,40106,40111
51063,1,512,512,512.00,0.00,40110,40111
51064,4,278,16,128.00,10926.00,40110,40114
51065,5,405,1,102.40,23370.24,40113,40118
51066,1,512,512,512.00,0.00,40117,40118
51067,1,512,512,512.00,0.00,40117,40118
51068,2,354,158,256.00,9604.00,40117,40119
51069,1,512,512,512.00,0.00,40118,40119
51070,2,316,196,256.00,3600.00,40118,40120
51071,2,481,31,256.00,50625.00,40119,40121
51072,1,512,512,512.00,0.00,40120,40121
51073,1,512,512,512.00,0.00,40120,40121
51074,1,512,512,512.00,0.00,40120,40121
51075,1,512,512,512.00,0.00,40120,40121
51076,1,512,512,512.00,0.00,40120,40121
51077,1,512,512,512.00,0.00,40120,40121
51078,1,512,512,512.00,0.00,40120,40121
51079,1,512,512,512.00,0.00,40120,40121
51080,1,512,512,512.00,0.00,40120,40121
51081,1,512,512,512.00,0.00,40120,40121
51082,1,512,512,512.00,0.00,40120,40121
51083,3,248,19,170.67,11502.89,40120,40123
51084,3,387,10,170.67,25237.56,40122,40125
51085,1,512,512,512.00,0.00,40124,40125
51086,2,469,43,256.00,45369.00,40124,40126
51087,3,384,29,170.67,23572.22,40125,40128
51088,2,392,120,256.00,18496.00,40127,40129
51089,2,342,170,256.00,7396.00,40128,40130
51090,1,512,512,512.00,0.00,40129,40130
51091,1,512,512,512.00,0.00,40129,40130
51092,2,375,137,256.00,14161.00,40129,40131
51093,1,512,512,512.00,0.00,40130,40131
51094,1,512,512,512.00,0.00,40130,40131
51095,1,512,512,512.00,0.00,40130,40131
51096,1,512,512,512.00,0.00,40130,40131
51097,3,454,16,170.67,40251.56,40130,40133
51098,1,512,512,512.00,0.00,40132,40133
51099,1,512,512,512.00,0.00,40132,40133
51100,2,334,178,256.00,6084.00,40132,40134
51101,7,184,1,73.14,4706.69,40133,40140
51102,2,351,161,256.00,9025.00,40139,40141
51103,1,512,512,512.00,0.00,40140,40141
51104,1,512,512,512.00,0.00,40140,40141
51105,2,421,91,256.00,27225.00,40140,40142
51106,1,512,512,512.00,0.00,40141,40142
51107,3,343,23,170.67,17370.89,40141,40144
51108,1,512,512,512.00,0.00,40143,40144
51109,1,512,512,512.00,0.00,40143,40144
51110,1,512,512,512.00,0.00,40143,40144
51111,2,279,233,256.00,529.00,40143,40145
51112,1,512,512,512.00,0.00,40144,40145
51113,1,512,512,512.00,0.00,40144,40145
51114,1,512,512,512.00,0.00,40144,40145
51115,1,512,512,512.00,0.00,40144,40145
51116,1,512,512,512.00,0.00,40144,40145
51117,1,512,512,512.00,0.00,40144,40145
51118,1,512,512,512.00,0.00,40144,40145
51119,1,512,512,512.00,0.00,40144,40145
51120,2,437,75,256.00,32761.00,40144,40146
51121,1,512,512,512.00,0.00,40145,40146
51122,1,512,512,512.00,0.00,40145,40146
51123,4,244,69,128.00,4893.50,40145,40149
51124,1,512,512,512.00,0.00,40148,40149
51125,1,512,512,512.00,0.00,40148,40149
51126,1,512,512,512.00,0.00,40148,40149
51127,2,444,68,256.00,35344.00,40148,40150
51128,1,512,512,512.00,0.00,40149,40150
51129,1,512,512,512.00,0.00,40149,40150
51130,1,512,512,512.00,0.00,40149,40150
51131,1,512,512,512.00,0.00,40149,40150
51132,1,512,512,512.00,0.00,40149,40150
51133,2,318,194,256.00,3844.00,40149,40151
51134,1,512,512,512.00,0.00,40150,40151
51135,2,380,132,256.00,15376.00,40150,40152
51136,1,512,512,512.00,0.00,40151,40152
51137,1,512,512,512.00,0.00,40151,40152
51138,1,512,512,512.00,0.00,40151,40152
51139,2,322,190,256.00,4356.00,40151,40153
51140,3,451,10,170.67,39573.56,40152,40155
51141,1,512,512,512.00,0.00,40154,40155
51142,1,512,512,512.00,0.00,40154,40155
51143,1,512,512,512.00,0.00,40154,40155
51144,2,365,147,256.00,11881.00,40154,40156
51145,1,512,512,512.00,0.00,40155,40156
51146,1,512,512,512.00,0.00,40155,40156
51147,2,500,12,256.00,59536.00,40155,40157
51148,6,193,42,85.33,2567.89,40156,40162
51149,2,463,49,256.00,42849.00,40161,40163
51150,2,505,7,256.00,62001.00,40162,40164
51151,2,415,97,256.00,25281.00,40163,40165
51152,1,512,512,512.00,0.00,40164,40165
51153,5,345,1,102.40,16820.64,40164,40169
51154,1,512,512,512.00,0.00,40168,40169
51155,1,512,512,512.00,0.00,40168,40169
51156,1,512,512,512.00,0.00,40168,40169
51157,1,512,512,512.00,0.00,40168,40169
51158,1,512,512,512.00,0.00,40168,40169
51159,1,512,512,512.00,0.00,40168,40169
51160,1,512,512,512.00,0.00,40168,40169
51161,1,512,512,512.00,0.00,40168,40169
51162,2,400,112,256.00,20736.00,40168,40170
51163,1,512,512,512.00,0.00,40169,40170
51164,1,512,512,512.00,0.00,40169,40170
51165,1,512,512,512.00,0.00,40169,40170
51166,1,512,512,512.00,0.00,40169,40170
51167,1,512,512,512.00,0.00,40169,40170
51168,1,512,512,512.00,0.00,40169,40170
51169,2,491,21,256.00,55225.00,40169,40171
51170,1,512,512,512.00,0.00,40170,40171
51171,1,512,512,512.00,0.00,40170,40171
51172,1,512,512,512.00,0.00,40170,40171
51173,1,512,512,512.00,0.00,40170,40171
51174,1,512,512,512.00,0.00,40170,40171
51175,2,308,204,256.00,2704.00,40170,40172
51176,1,512,512,512.00,0.00,40171,40172
51177,2,394,118,256.00,19044.00,40171,40173
51178,3,319,18,170.67,15109.56,40172,40175
51179,3,382,25,170.67,23397.56,40174,40177
51180,1,512,512,512.00,0.00,40176,40177
51181,1,512,512,512.00,0.00,40176,40177
51182,3,467,9,170.67,44028.22,40176,40179
51183,1,512,512,512.00,0.00,40178,40179
51184,2,476,36,256.00,48400.00,40178,40180
51185,1,512,512,512.00,0.00,40179,40180
51186,1,512,512,512.00,0.00,40179,40180
51187,1,512,512,512.00,0.00,40179,40180
51188,1,512,512,512.00,0.00,40179,40180
51189,2,444,68,256.00,35344.00,40179,40181
51190,7,184,4,73.14,3606.98,40180,40187
51191,2,371,141,256.00,13225.00,40186,40188
51192,1,512,512,512.00,0.00,40187,40188
51193,3,236,51,170.67,7180.22,40187,40190
51194,1,512,512,512.00,0.00,40189,40190
51195,1,512,512,512.00,0.00,40189,40190
51196,1,512,512,512.00,0.00,40189,40190
51197,1,512,512,512.00,0.00,40189,40190
51198,1,512,512,512.00,0.00,40189,40190
51199,1,512,512,512.00,0.00,40189,40190
51200,1,512,512,512.00,0.00,40189,40190
51201,2,265,247,256.00,81.00,40189,40191
51202,1,512,512,512.00,0.00,40190,40191
51203,1,512,512,512.00,0.00,40190,40191
51204,1,512,512,512.00,0.00,40190,40191
51205,1,512,512,512.00,0.00,40190,40191
51206,5,232,12,102.40,6641.84,40190,40195
51207,1,512,512,512.00,0.00,40194,40195
51208,1,512,512,512.00,0.00,40194,40195
51209,2,449,63,256.00,37249.00,40194,40196
51210,2,358,154,256.00,10404.00,40195,40197
51211,1,512,512,512.00,0.00,40196,40197
51212,1,512,512,512.00,0.00,40196,40197
51213,2,451,61,256.00,38025.00,40196,40198
51214,1,512,512,512.00,0.00,40197,40198
51215,1,512,512,512.00,0.00,40197,40198
51216,1,512,512,512.00,0.00,40197,40198
51217,4,382,5,128.00,23652.50,40197,40201
51218,1,512,512,512.00,0.00,40200,40201
51219,1,512,512,512.00,0.00,40200,40201
51220,2,309,203,256.00,2809.00,40200,40202
51221,1,512,512,512.00,0.00,40201,40202
51222,3,252,107,170.67,3660.22,40201,40204
51223,4,232,16,128.00,6328.50,40203,40207
51224,2,482,30,256.00,51076.00,40206,40208
51225,1,512,512,512.00,0.00,40207,40208
51226,4,408,13,128.00,26324.50,40207,40211
51227,1,512,512,512.00,0.00,40210,40211
51228,2,463,49,256.00,42849.00,40210,40212
51229,1,512,512,512.00,0.00,40211,40212
51230,4,419,2,128.00,29038.50,40211,40215
51231,2,503,9,256.00,61009.00,40214,40216
51232,1,512,512,512.00,0.00,40215,40216
51233,1,512,512,512.00,0.00,40215,40216
51234,1,512,512,512.00,0.00,40215,40216
51235,2,262,250,256.00,36.00,40215,40217
51236,1,512,512,512.00,0.00,40216,40217
51237,2,256,256,256.00,0.00,40216,40218
51238,2,415,97,256.00,25281.00,40217,40219
51239,1,512,512,512.00,0.00,40218,40219
51240,1,512,512,512.00,0.00,40218,40219
51241,1,512,512,512.00,0.00,40218,40219
51242,1,512,512,512.00,0.00,40218,40219
51243,1,512,512,512.00,0.00,40218,40219
51244,1,512,512,512.00,0.00,40218,40219
51245,2,363,149,256.00,11449.00,40218,40220
51246,4,307,3,128.00,12281.50,40219,40223
51247,1,512,512,512.00,0.00,40222,40223
51248,1,512,512,512.00,0.00,40222,40223
51249,1,512,512,512.00,0.00,40222,40223
51250,1,512,512,512.00,0.00,40222,40223
51251,1,512,512,512.00,0.00,40222,40223
51252,1,512,512,512.00,0.00,40222,40223
51253,1,512,512,512.00,0.00,40222,40223
51254,1,512,512,512.00,0.00,40222,40223
51255,1,512,512,512.00,0.00,40222,40223
51256,4,201,55,128.00,3209.00,40222,40226
51257,1,512,512,512.00,0.00,40225,40226
51258,2,348,164,256.00,8464.00,40225,40227
51259,2,495,17,256.00,57121.00,40226,40228
51260,1,512,512,512.00,0.00,40227,40228
51261,1,512,512,512.00,0.00,40227,40228
51262,1,512,512,512.00,0.00,40227,40228
51263,1,512,512,512.00,0.00,40227,40228
51264,1,512,512,512.00,0.00,40227,40228
51265,1,512,512,512.00,0.00,40227,40228
51266,1,512,512,512.00,0.00,40227,40228
51267,1,512,512,512.00,0.00,40227,40228
51268,1,512,512,512.00,0.00,40227,40228
51269,1,512,512,512.00,0.00,40227,40228
51270,1,512,512,512.00,0.00,40227,40228
51271,1,512,512,512.00,0.00,40227,40228
51272,2,422,90,256.00,27556.00,40227,40229
51273,1,512,512,512.00,0.00,40228,40229
51274,3,355,3,170.67,20789.56,40228,40231
51275,1,512,512,512.00,0.00,40230,40231
51276,1,512,512,512.00,0.00,40230,40231
51277,2,347,165,256.00,8281.00,40230,40232
51278,3,429,1,170.67,34461.56,40231,40234
51279,1,512,512,512.00,0.00,40233,40234
51280,1,512,512,512.00,0.00,40233,40234
51281,2,257,255,256.00,1.00,40233,40235
51282,1,512,512,512.00,0.00,40234,40235
51283,2,350,162,256.00,8836.00,40234,40236
51284,1,512,512,512.00,0.00,40235,40236
51285,1,512,512,512.00,0.00,40235,40236
51286,1,512,512,512.00,0.00,40235,40236
51287,1,512,512,512.00,0.00,40235,40236
51288,1,512,512,512.00,0.00,40235,40236
51289,1,512,512,512.00,0.00,40235,40236
51290,1,512,512,512.00,0.00,40235,40236
51291,1,512,512,512.00,0.00,40235,40236
51292,3,437,18,170.67,35720.22,40235,40238
51293,1,512,512,512.00,0.00,40237,40238
51294,1,512,512,512.00,0.00,40237,40238
51295,1,512,512,512.00,0.00,40237,40238
51296,2,507,5,256.00,63001.00,40237,40239
51297,2,436,76,256.00,32400.00,40238,40240
51298,1,512,512,512.00,0.00,40239,40240
51299,1,512,512,512.00,0.00,40239,40240
51300,3,465,10,170.67,43437.56,40239,40242
51301,1,512,512,512.00,0.00,40241,40242
51302,1,512,512,512.00,0.00,40241,40242
51303,1,512,512,512.00,0.00,40241,40242
51304,1,512,512,512.00,0.00,40241,40242
51305,1,512,512,512.00,0.00,40241,40242
51306,2,406,106,256.00,22500.00,40241,40243
51307,2,480,32,256.00,50176.00,40242,40244
51308,4,316,7,128.00,15613.50,40243,40247
51309,1,512,512,512.00,0.00,40246,40247
51310,1,512,512,512.00,0.00,40246,40247
51311,1,512,512,512.00,0.00,40246,40247
51312,1,512,512,512.00,0.00,40246,40247
51313,1,512,512,512.00,0.00,40246,40247
51314,2,311,201,256.00,3025.00,40246,40248
51315,1,512,512,512.00,0.00,40247,40248
51316,2,508,4,256.00,63504.00,40247,40249
51317,1,512,512,512.00,0.00,40248,40249
51318,2,325,187,256.00,4761.00,40248,40250
51319,1,512,512,512.00,0.00,40249,40250
51320,2,466,46,256.00,44100.00,40249,40251
51321,1,512,512,512.00,0.00,40250,40251
51322,1,512,512,512.00,0.00,40250,40251
51323,2,399,113,256.00,20449.00,40250,40252
51324,2,438,74,256.00,33124.00,40251,40253
51325,2,289,223,256.00,1089.00,40252,40254
51326,1,512,512,512.00,0.00,40253,40254
51327,2,283,229,256.00,729.00,40253,40255
51328,1,512,512,512.00,0.00,40254,40255
51329,3,383,6,170.67,24824.22,40254,40257
51330,1,512,512,512.00,0.00,40256,40257
51331,3,410,48,170.67,28646.22,40256,40259
51332,1,512,512,512.00,0.00,40258,40259
51333,4,467,1,128.00,38601.00,40259,40263
51334,2,354,158,256.00,9604.00,40262,40264
51335,5,270,48,102.40,7084.24,40263,40268
51336,1,512,512,512.00,0.00,40267,40268
51337,1,512,512,512.00,0.00,40267,40268
51338,1,512,512,512.00,0.00,40267,40268
51339,4,294,6,128.00,13816.50,40267,40271
51340,2,339,173,256.00,6889.00,40270,40272
51341,2,482,30,256.00,51076.00,40271,40273
51342,1,512,512,512.00,0.00,40272,40273
51343,1,512,512,512.00,0.00,40272,40273
51344,1,512,512,512.00,0.00,40272,40273
51345,1,512,512,512.00,0.00,40272,40273
51346,1,512,512,512.00,0.00,40272,40273
51347,1,512,512,512.00,0.00,40272,40273
51348,3,244,84,170.67,4355.56,40272,40275
51349,1,512,512,512.00,0.00,40274,40275
51350,1,512,512,512.00,0.00,40274,40275
51351,1,512,512,512.00,0.00,40274,40275
51352,1,512,512,512.00,0.00,40274,40275
51353,1,512,512,512.00,0.00,40274,40275
51354,2,511,1,256.00,65025.00,40274,40276
51355,2,379,133,256.00,15129.00,40276,40278
51356,1,512,512,512.00,0.00,40277,40278
51357,2,397,115,256.00,19881.00,40277,40279
51358,1,512,512,512.00,0.00,40278,40279
51359,1,512,512,512.00,0.00,40278,40279
51360,1,512,512,512.00,0.00,40278,40279
51361,1,512,512,512.00,0.00,40278,40279
51362,3,271,27,170.67,10861.56,40278,40281
51363,1,512,512,512.00,0.00,40280,40281
51364,1,512,512,512.00,0.00,40280,40281
51365,1,512,512,512.00,0.00,40280,40281
51366,1,512,512,512.00,0.00,40280,40281
51367,1,512,512,512.00,0.00,40280,40281
51368,2,291,221,256.00,1225.00,40280,40282
51369,1,512,512,512.00,0.00,40281,40282
51370,1,512,512,512.00,0.00,40281,40282
51371,2,299,213,256.00,1849.00,40281,40283
51372,4,221,49,128.00,4715.00,40282,40286
51373,1,512,512,512.00,0.00,40285,40286
51374,1,512,512,512.00,0.00,40285,40286
51375,1,512,512,512.00,0.00,40285,40286
51376,1,512,512,512.00,0.00,40285,40286
51377,2,357,155,256.00,10201.00,40285,40287
51378,1,512,512,512.00,0.00,40286,40287
51379,1,512,512,512.00,0.00,40286,40287
51380,1,512,512,512.00,0.00,40286,40287
51381,1,512,512,512.00,0.00,40286,40287
51382,1,512,512,512.00,0.00,40286,40287
51383,1,512,512,512.00,0.00,40286,40287
51384,1,512,512,512.00,0.00,40286,40287
51385,2,317,195,256.00,3721.00,40286,40288
51386,2,256,256,256.00,0.00,40287,40289
51387,1,512,512,512.00,0.00,40288,40289
51388,1,512,512,512.00,0.00,40288,40289
51389,1,512,512,512.00,0.00,40288,40289
51390,1,512,512,512.00,0.00,40288,40289
51391,1,512,512,512.00,0.00,40288,40289
51392,1,512,512,512.00,0.00,40288,40289
51393,2,257,255,256.00,1.00,40288,40290
51394,2,415,97,256.00,25281.00,40289,40291
51395,2,276,236,256.00,400.00,40290,40292
51396,2,301,211,256.00,2025.00,40291,40293
51397,2,441,71,256.00,34225.00,40292,40294
51398,2,475,37,256.00,47961.00,40293,40295
51399,2,416,96,256.00,25600.00,40294,40296
51400,2,466,46,256.00,44100.00,40295,40297
51401,3,362,17,170.67,20546.89,40296,40299
51402,1,512,512,512.00,0.00,40298,40299
51403,1,512,512,512.00,0.00,40298,40299
51404,1,512,512,512.00,0.00,40298,40299
51405,2,259,253,256.00,9.00,40298,40300
51406,1,512,512,512.00,0.00,40299,40300
51407,1,512,512,512.00,0.00,40299,40300
51408,1,512,512,512.00,0.00,40299,40300
51409,1,512,512,512.00,0.00,40299,40300
51410,4,332,8,128.00,15944.00,40299,40303
51411,1,512,512,512.00,0.00,40302,40303
51412,4,412,1,128.00,27742.50,40302,40306
51413,1,512,512,512.00,0.00,40305,40306
51414,1,512,512,512.00,0.00,40305,40306
51415,4,220,88,128.00,2894.50,40305,40309
51416,2,406,106,256.00,22500.00,40308,40310
51417,1,512,512,512.00,0.00,40309,40310
51418,3,257,126,170.67,3728.22,40309,40312
51419,1,512,512,512.00,0.00,40311,40312
51420,2,473,39,256.00,47089.00,40311,40313
51421,1,512,512,512.00,0.00,40312,40313
51422,1,512,512,512.00,0.00,40312,40313
51423,1,512,512,512.00,0.00,40312,40313
51424,1,512,512,512.00,0.00,40312,40313
51425,1,512,512,512.00,0.00,40312,40313
51426,2,480,32,256.00,50176.00,40312,40314
51427,2,484,28,256.00,51984.00,40313,40315
51428,1,512,512,512.00,0.00,40314,40315
51429,1,512,512,512.00,0.00,40314,40315
51430,2,423,89,256.00,27889.00,40314,40316
51431,2,331,181,256.00,5625.00,40315,40317
51432,1,512,512,512.00,0.00,40316,40317
51433,1,512,512,512.00,0.00,40316,40317
51434,1,512,512,512.00,0.00,40316,40317
51435,3,232,84,170.67,3971.56,40316,40319
51436,7,144,33,73.14,1107.84,40318,40325
51437,2,312,200,256.00,3136.00,40324,40326
51438,1,512,512,512.00,0.00,40325,40326
51439,1,512,512,512.00,0.00,40325,40326
51440,1,512,512,512.00,0.00,40325,40326
51441,4,220,71,128.00,3217.50,40325,40329
51442,1,512,512,512.00,0.00,40328,40329
51443,1,512,512,512.00,0.00,40328,40329
51444,2,367,145,256.00,12321.00,40328,40330
51445,1,512,512,512.00,0.00,40329,40330
51446,2,419,93,256.00,26569.00,40329,40331
51447,2,304,208,256.00,2304.00,40330,40332
51448,1,512,512,512.00,0.00,40331,40332
51449,1,512,512,512.00,0.00,40331,40332
51450,1,512,512,512.00,0.00,40331,40332
51451,1,512,512,512.00,0.00,40331,40332
51452,2,377,135,256.00,14641.00,40331,40333
51453,1,512,512,512.00,0.00,40332,40333
51454,2,343,169,256.00,7569.00,40332,40334
51455,1,512,512,512.00,0.00,40333,40334
51456,4,462,4,128.00,37247.50,40333,40337
51457,1,512,512,512.00,0.00,40336,40337
51458,1,512,512,512.00,0.00,40336,40337
51459,1,512,512,512.00,0.00,40336,40337
51460,1,512,512,512.00,0.00,40336,40337
51461,1,512,512,512.00,0.00,40336,40337
51462,1,512,512,512.00,0.00,40336,40337
51463,1,512,512,512.00,0.00,40336,40337
51464,2,374,138,256.00,13924.00,40336,40338
51465,1,512,512,512.00,0.00,40337,40338
51466,2,340,172,256.00,7056.00,40337,40339
51467,1,512,512,512.00,0.00,40338,40339
51468,2,345,167,256.00,7921.00,40338,40340
51469,1,512,512,512.00,0.00,40339,40340
51470,1,512,512,512.00,0.00,40339,40340
51471,2,407,105,256.00,22801.00,40339,40341
51472,1,512,512,512.00,0.00,40340,40341
51473,2,434,78,256.00,31684.00,40340,40342
51474,1,512,512,512.00,0.00,40341,40342
51475,1,512,512,512.00,0.00,40341,40342
51476,3,424,6,170.67,33051.56,40341,40344
51477,1,512,512,512.00,0.00,40343,40344
51478,1,512,512,512.00,0.00,40343,40344
51479,1,512,512,512.00,0.00,40343,40344
51480,1,512,512,512.00,0.00,40343,40344
51481,1,512,512,512.00,0.00,40343,40344
51482,1,512,512,512.00,0.00,40343,40344
51483,2,464,48,256.00,43264.00,40343,40345
51484,1,512,512,512.00,0.00,40344,40345
51485,5,247,2,102.40,9790.64,40344,40349
51486,1,512,512,512.00,0.00,40348,40349
51487,1,512,512,512.00,0.00,40348,40349
51488,1,512,512,512.00,0.00,40348,40349
51489,1,512,512,512.00,0.00,40348,40349
51490,1,512,512,512.00,0.00,40348,40349
51491,1,512,512,512.00,0.00,40348,40349
51492,1,512,512,512.00,0.00,40348,40349
51493,2,445,67,256.00,35721.00,40348,40350
51494,1,512,512,512.00,0.00,40349,40350
51495,1,512,512,512.00,0.00,40349,40350
51496,1,512,512,512.00,0.00,40349,40350
51497,1,512,512,512.00,0.00,40349,40350
51498,3,228,112,170.67,2243.56,40349,40352
51499,1,512,512,512.00,0.00,40351,40352
51500,1,512,512,512.00,0.00,40351,40352
51501,2,300,212,256.00,1936.00,40351,40353
51502,1,512,512,512.00,0.00,40352,40353
51503,2,368,144,256.00,12544.00,40352,40354
51504,2,300,212,256.00,1936.00,40353,40355
51505,2,433,79,256.00,31329.00,40354,40356
51506,3,282,12,170.67,13270.22,40355,40358
51507,2,403,109,256.00,21609.00,40357,40359
51508,1,512,512,512.00,0.00,40358,40359
51509,2,323,189,256.00,4489.00,40358,40360
51510,2,344,168,256.00,7744.00,40359,40361
51511,1,512,512,512.00,0.00,40360,40361
51512,1,512,512,512.00,0.00,40360,40361
51513,1,512,512,512.00,0.00,40360,40361
51514,1,512,512,512.00,0.00,40360,40361
51515,2,277,235,256.00,441.00,40360,40362
51516,1,512,512,512.00,0.00,40361,40362
51517,1,512,512,512.00,0.00,40361,40362
51518,1,512,512,512.00,0.00,40361,40362
51519,3,407,9,170.67,29188.22,40361,40364
51520,2,489,23,256.00,54289.00,40363,40365
51521,1,512,512,512.00,0.00,40364,40365
51522,1,512,512,512.00,0.00,40364,40365
51523,1,512,512,512.00,0.00,40364,40365
51524,1,512,512,512.00,0.00,40364,40365
51525,1,512,512,512.00,0.00,40364,40365
51526,4,420,22,128.00,28510.00,40364,40368
51527,1,512,512,512.00,0.00,40367,40368
51528,3,390,1,170.67,26453.56,40367,40370
51529,1,512,512,512.00,0.00,40369,40370
51530,3,325,27,170.67,14857.56,40369,40372
51531,2,435,77,256.00,32041.00,40371,40373
51532,1,512,512,512.00,0.00,40372,40373
51533,1,512,512,512.00,0.00,40372,40373
51534,2,379,133,256.00,15129.00,40372,40374
51535,1,512,512,512.00,0.00,40373,40374
51536,1,512,512,512.00,0.00,40373,40374
51537,4,261,2,128.00,14283.50,40373,40377
51538,1,512,512,512.00,0.00,40376,40377
51539,2,303,209,256.00,2209.00,40376,40378
51540,1,512,512,512.00,0.00,40377,40378
51541,1,512,512,512.00,0.00,40377,40378
51542,1,512,512,512.00,0.00,40377,40378
51543,1,512,512,512.00,0.00,40377,40378
51544,1,512,512,512.00,0.00,40377,40378
51545,3,324,77,170.67,11948.22,40377,40380
51546,1,512,512,512.00,0.00,40379,40380
51547,1,512,512,512.00,0.00,40379,40380
51548,3,200,148,170.67,472.89,40379,40382
51549,3,407,38,170.67,28066.89,40381,40384
51550,2,409,103,256.00,23409.00,40383,40385
51551,1,512,512,512.00,0.00,40384,40385
51552,2,395,117,256.00,19321.00,40384,40386
51553,1,512,512,512.00,0.00,40385,40386
51554,1,512,512,512.00,0.00,40385,40386
51555,1,512,512,512.00,0.00,40385,40386
51556,1,512,512,512.00,0.00,40385,40386
51557,1,512,512,512.00,0.00,40385,40386
51558,1,512,512,512.00,0.00,40385,40386
51559,1,512,512,512.00,0.00,40385,40386
51560,2,386,126,256.00,16900.00,40385,40387
51561,1,512,512,512.00,0.00,40386,40387
51562,2,263,249,256.00,49.00,40386,40388
51563,1,512,512,512.00,0.00,40387,40388
51564,1,512,512,512.00,0.00,40387,40388
51565,3,249,42,170.67,8408.22,40387,40390
51566,1,512,512,512.00,0.00,40389,40390
51567,1,512,512,512.00,0.00,40389,40390
51568,2,314,198,256.00,3364.00,40389,40391
51569,2,488,24,256.00,53824.00,40390,40392
51570,1,512,512,512.00,0.00,40391,40392
51571,1,512,512,512.00,0.00,40391,40392
51572,1,512,512,512.00,0.00,40391,40392
51573,1,512,512,512.00,0.00,40391,40392
51574,1,512,512,512.00,0.00,40391,40392
51575,2,421,91,256.00,27225.00,40391,40393
51576,4,400,1,128.00,26482.50,40392,40396
51577,1,512,512,512.00,0.00,40395,40396
51578,2,353,159,256.00,9409.00,40395,40397
51579,1,512,512,512.00,0.00,40396,40397
51580,1,512,512,512.00,0.00,40396,40397
51581,2,357,155,256.00,10201.00,40396,40398
51582,1,512,512,512.00,0.00,40397,40398
51583,1,512,512,512.00,0.00,40397,40398
51584,1,512,512,512.00,0.00,40397,40398
51585,1,512,512,512.00,0.00,40397,40398
51586,1,512,512,512.00,0.00,40397,40398
51587,1,512,512,512.00,0.00,40397,40398
51588,3,262,90,170.67,4987.56,40397,40400
51589,1,512,512,512.00,0.00,40399,40400
51590,1,512,512,512.00,0.00,40399,40400
51591,1,512,512,512.00,0.00,40399,40400
51592,2,479,33,256.00,49729.00,40399,40401
51593,1,512,512,512.00,0.00,40400,40401
51594,2,494,18,256.00,56644.00,40400,40402
51595,2,288,224,256.00,1024.00,40401,40403
51596,1,512,512,512.00,0.00,40402,40403
51597,3,400,3,170.67,28169.56,40402,40405
51598,1,512,512,512.00,0.00,40404,40405
51599,1,512,512,512.00,0.00,40404,40405
51600,1,512,512,512.00,0.00,40404,40405
51601,3,439,9,170.67,36505.56,40404,40407
51602,3,450,17,170.67,39144.22,40406,40409
51603,1,512,512,512.00,0.00,40408,40409
51604,2,471,41,256.00,46225.00,40408,40410
51605,2,460,52,256.00,41616.00,40409,40411
51606,1,512,512,512.00,0.00,40410,40411
51607,1,512,512,512.00,0.00,40410,40411
51608,2,278,234,256.00,484.00,40410,40412
51609,3,336,4,170.67,18371.56,40411,40414
51610,1,512,512,512.00,0.00,40413,40414
51611,3,386,50,170.67,23296.89,40413,40416
51612,3,273,64,170.67,7289.56,40415,40418
51613,1,512,512,512.00,0.00,40417,40418
51614,2,338,174,256.00,6724.00,40417,40419
51615,1,512,512,512.00,0.00,40418,40419
51616,1,512,512,512.00,0.00,40418,40419
51617,5,190,10,102.40,4435.44,40418,40423
51618,1,512,512,512.00,0.00,40422,40423
51619,1,512,512,512.00,0.00,40422,40423
51620,5,257,21,102.40,6969.44,40422,40427
51621,2,379,133,256.00,15129.00,40426,40428
51622,1,512,512,512.00,0.00,40427,40428
51623,1,512,512,512.00,0.00,40427,40428
51624,2,386,126,256.00,16900.00,40427,40429
51625,2,338,174,256.00,6724.00,40428,40430
51626,4,182,57,128.00,2620.50,40429,40433
51627,4,334,12,128.00,15746.00,40432,40436
51628,3,398,35,170.67,26162.89,40435,40438
51629,1,512,512,512.00,0.00,40437,40438
51630,1,512,512,512.00,0.00,40437,40438
51631,2,505,7,256.00,62001.00,40437,40439
51632,2,289,223,256.00,1089.00,40438,40440
51633,1,512,512,512.00,0.00,40439,40440
51634,2,465,47,256.00,43681.00,40439,40441
51635,3,368,4,170.67,22552.89,40440,40443
51636,2,441,71,256.00,34225.00,40442,40444
51637,4,221,6,128.00,8004.50,40443,40447
51638,1,512,512,512.00,0.00,40446,40447
51639,1,512,512,512.00,0.00,40446,40447
51640,2,454,58,256.00,39204.00,40446,40448
51641,1,512,512,512.00,0.00,40447,40448
51642,1,512,512,512.00,0.00,40447,40448
51643,2,437,75,256.00,32761.00,40447,40449
51644,1,512,512,512.00,0.00,40448,40449
51645,4,314,22,128.00,14306.00,40448,40452
51646,3,338,7,170.67,18266.89,40451,40454
51647,1,512,512,512.00,0.00,40453,40454
51648,5,230,7,102.40,5417.84,40453,40458
51649,1,512,512,512.00,0.00,40457,40458
51650,1,512,512,512.00,0.00,40457,40458
51651,1,512,512,512.00,0.00,40457,40458
51652,1,512,512,512.00,0.00,40457,40458
51653,2,263,249,256.00,49.00,40457,40459
51654,1,512,512,512.00,0.00,40458,40459
51655,1,512,512,512.00,0.00,40458,40459
51656,1,512,512,512.00,0.00,40458,40459
51657,1,512,512,512.00,0.00,40458,40459
51658,2,307,205,256.00,2601.00,40458,40460
51659,3,281,3,170.67,14524.22,40459,40462
51660,1,512,512,512.00,0.00,40461,40462
51661,1,512,512,512.00,0.00,40461,40462
51662,1,512,512,512.00,0.00,40461,40462
51663,1,512,512,512.00,0.00,40461,40462
51664,1,512,512,512.00,0.00,40461,40462
51665,2,301,211,256.00,2025.00,40461,40463
51666,1,512,512,512.00,0.00,40462,40463
51667,3,272,58,170.67,7696.89,40462,40465
51668,4,378,2,128.00,21518.00,40464,40468
51669,1,512,512,512.00,0.00,40467,40468
51670,1,512,512,512.00,0.00,40467,40468
51671,3,449,24,170.67,38772.22,40467,40470
51672,2,499,13,256.00,59049.00,40469,40471
51673,1,512,512,512.00,0.00,40470,40471
51674,1,512,512,512.00,0.00,40470,40471
51675,3,321,26,170.67,14520.22,40470,40473
51676,3,489,4,170.67,50705.56,40472,40475
51677,2,405,107,256.00,22201.00,40474,40476
51678,1,512,512,512.00,0.00,40475,40476
51679,1,512,512,512.00,0.00,40475,40476
51680,6,467,2,85.33,29172.22,40475,40481
51681,2,281,231,256.00,625.00,40480,40482
51682,1,512,512,512.00,0.00,40481,40482
51683,1,512,512,512.00,0.00,40481,40482
51684,1,512,512,512.00,0.00,40481,40482
51685,1,512,512,512.00,0.00,40481,40482
51686,1,512,512,512.00,0.00,40481,40482
51687,3,375,20,170.67,22444.22,40481,40484
51688,1,512,512,512.00,0.00,40483,40484
51689,1,512,512,512.00,0.00,40483,40484
51690,1,512,512,512.00,0.00,40483,40484
51691,5,200,6,102.40,5758.64,40483,40488
51692,1,512,512,512.00,0.00,40487,40488
51693,1,512,512,512.00,0.00,40487,40488
51694,1,512,512,512.00,0.00,40487,40488
51695,4,140,103,128.00,214.50,40487,40491
51696,1,512,512,512.00,0.00,40490,40491
51697,1,512,512,512.00,0.00,40490,40491
51698,2,331,181,256.00,5625.00,40490,40492
51699,2,275,237,256.00,361.00,40491,40493
51700,3,414,1,170.67,31141.56,40492,40495
51701,2,334,178,256.00,6084.00,40494,40496
51702,3,381,61,170.67,22133.56,40495,40498
51703,4,268,13,128.00,8455.50,40497,40501
51704,1,512,512,512.00,0.00,40500,40501
51705,1,512,512,512.00,0.00,40500,40501
51706,3,217,104,170.67,2334.89,40500,40503
51707,3,226,110,170.67,2256.89,40502,40505
51708,3,192,141,170.67,468.22,40504,40507
51709,1,512,512,512.00,0.00,40506,40507
51710,2,291,221,256.00,1225.00,40506,40508
51711,1,512,512,512.00,0.00,40507,40508
51712,1,512,512,512.00,0.00,40507,40508
51713,1,512,512,512.00,0.00,40507,40508
51714,1,512,512,512.00,0.00,40507,40508
51715,3,240,125,170.67,2484.22,40507,40510
51716,5,233,6,102.40,8857.04,40509,40514
51717,2,437,75,256.00,32761.00,40513,40515
51718,2,475,37,256.00,47961.00,40514,40516
51719,3,412,42,170.67,29163.56,40515,40518
51720,1,512,512,512.00,0.00,40517,40518
51721,2,386,126,256.00,16900.00,40517,40519
51722,1,512,512,512.00,0.00,40518,40519
51723,3,220,116,170.67,1816.89,40518,40521
51724,2,326,186,256.00,4900.00,40520,40522
51725,1,512,512,512.00,0.00,40521,40522
51726,1,512,512,512.00,0.00,40521,40522
51727,1,512,512,512.00,0.00,40521,40522
51728,1,512,512,512.00,0.00,40521,40522
51729,3,440,4,170.67,36952.89,40521,40524
51730,1,512,512,512.00,0.00,40523,40524
51731,2,445,67,256.00,35721.00,40523,40525
51732,2,492,20,256.00,55696.00,40524,40526
51733,1,512,512,512.00,0.00,40525,40526
51734,1,512,512,512.00,0.00,40525,40526
51735,1,512,512,512.00,0.00,40525,40526
51736,2,351,161,256.00,9025.00,40525,40527
51737,1,512,512,512.00,0.00,40526,40527
51738,1,512,512,512.00,0.00,40526,40527
51739,1,512,512,512.00,0.00,40526,40527
51740,2,374,138,256.00,13924.00,40526,40528
51741,5,335,1,102.40,16644.24,40527,40532
51742,1,512,512,512.00,0.00,40531,40532
51743,1,512,512,512.00,0.00,40531,40532
51744,2,368,144,256.00,12544.00,40531,40533
51745,9,118,2,56.89,1754.10,40532,40541
51746,1,512,512,512.00,0.00,40540,40541
51747,1,512,512,512.00,0.00,40540,40541
51748,1,512,512,512.00,0.00,40540,40541
51749,1,512,512,512.00,0.00,40540,40541
51750,1,512,512,512.00,0.00,40540,40541
51751,3,257,64,170.67,6414.89,40540,40543
51752,2,364,148,256.00,11664.00,40542,40544
51753,1,512,512,512.00,0.00,40543,40544
51754,1,512,512,512.00,0.00,40543,40544
51755,1,512,512,512.00,0.00,40543,40544
51756,1,512,512,512.00,0.00,40543,40544
51757,3,344,37,170.67,16494.89,40543,40546
51758,1,512,512,512.00,0.00,40545,40546
51759,1,512,512,512.00,0.00,40545,40546
51760,3,397,4,170.67,27521.56,40545,40548
51761,1,512,512,512.00,0.00,40547,40548
51762,1,512,512,512.00,0.00,40547,40548
51763,3,240,50,170.67,7334.22,40547,40550
51764,1,512,512,512.00,0.00,40549,40550
51765,1,512,512,512.00,0.00,40549,40550
51766,1,512,512,512.00,0.00,40549,40550
51767,1,512,512,512.00,0.00,40549,40550
51768,3,370,14,170.67,22032.89,40549,40552
51769,1,512,512,512.00,0.00,40551,40552
51770,2,482,30,256.00,51076.00,40551,40553
51771,3,337,63,170.67,14233.56,40552,40555
51772,1,512,512,512.00,0.00,40554,40555
51773,1,512,512,512.00,0.00,40554,40555
51774,2,480,32,256.00,50176.00,40554,40556
51775,1,512,512,512.00,0.00,40555,40556
51776,1,512,512,512.00,0.00,40555,40556
51777,1,512,512,512.00,0.00,40555,40556
51778,2,295,217,256.00,1521.00,40555,40557
51779,3,253,29,170.67,10122.89,40556,40559
51780,3,308,3,170.67,15964.22,40558,40561
51781,3,448,1,170.67,39097.56,40560,40563
51782,2,378,134,256.00,14884.00,40562,40564
51783,2,378,134,256.00,14884.00,40563,40565
51784,1,512,512,512.00,0.00,40564,40565
51785,1,512,512,512.00,0.00,40564,40565
51786,1,512,512,512.00,0.00,40564,40565
51787,2,438,74,256.00,33124.00,40564,40566
51788,1,512,512,512.00,0.00,40565,40566
51789,1,512,512,512.00,0.00,40565,40566
51790,2,398,114,256.00,20164.00,40565,40567
51791,1,512,512,512.00,0.00,40566,40567
51792,3,299,24,170.67,12772.22,40566,40569
51793,1,512,512,512.00,0.00,40568,40569
51794,1,512,512,512.00,0.00,40568,40569
51795,2,353,159,256.00,9409.00,40568,40570
51796,1,512,512,512.00,0.00,40569,40570
51797,1,512,512,512.00,0.00,40569,40570
51798,1,512,512,512.00,0.00,40569,40570
51799,1,512,512,512.00,0.00,40569,40570
51800,4,374,2,128.00,20938.50,40569,40573
51801,3,269,78,170.67,6096.22,40572,40575
51802,2,336,176,256.00,6400.00,40574,40576
51803,1,512,512,512.00,0.00,40575,40576
51804,4,253,3,128.00,11510.50,40575,40579
51805,1,512,512,512.00,0.00,40578,40579
51806,1,512,512,512.00,0.00,40578,40579
51807,1,512,512,512.00,0.00,40578,40579
51808,2,325,187,256.00,4761.00,40578,40580
51809,1,512,512,512.00,0.00,40579,40580
51810,1,512,512,512.00,0.00,40579,40580
51811,5,430,6,102.40,26916.24,40579,40584
51812,1,512,512,512.00,0.00,40583,40584
51813,2,511,1,256.00,65025.00,40583,40585
51814,1,512,512,512.00,0.00,40584,40585
51815,1,512,512,512.00,0.00,40584,40585
51816,1,512,512,512.00,0.00,40584,40585
51817,3,262,24,170.67,10971.56,40584,40587
51818,2,363,149,256.00,11449.00,40586,40588
51819,1,512,512,512.00,0.00,40587,40588
51820,1,512,512,512.00,0.00,40587,40588
51821,2,311,201,256.00,3025.00,40587,40589
51822,1,512,512,512.00,0.00,40588,40589
51823,1,512,512,512.00,0.00,40588,40589
51824,1,512,512,512.00,0.00,40588,40589
51825,1,512,512,512.00,0.00,40588,40589
51826,2,437,75,256.00,32761.00,40588,40590
51827,1,512,512,512.00,0.00,40589,40590
51828,1,512,512,512.00,0.00,40589,40590
51829,1,512,512,512.00,0.00,40589,40590
51830,2,374,138,256.00,13924.00,40589,40591
51831,1,512,512,512.00,0.00,40590,40591
51832,1,512,512,512.00,0.00,40590,40591
51833,1,512,512,512.00,0.00,40590,40591
51834,2,305,207,256.00,2401.00,40590,40592
51835,1,512,512,512.00,0.00,40591,40592
51836,3,270,57,170.67,7664.22,40591,40594
51837,1,512,512,512.00,0.00,40593,40594
51838,3,393,18,170.67,25864.22,40593,40596
51839,3,267,31,170.67,10221.56,40595,40598
51840,1,512,512,512.00,0.00,40597,40598
51841,1,512,512,512.00,0.00,40597,40598
51842,3,322,4,170.67,16971.56,40597,40600
51843,1,512,512,512.00,0.00,40599,40600
51844,1,512,512,512.00,0.00,40599,40600
51845,2,341,171,256.00,7225.00,40599,40601
51846,1,512,512,512.00,0.00,40600,40601
51847,1,512,512,512.00,0.00,40600,40601
51848,1,512,512,512.00,0.00,40600,40601
51849,2,269,243,256.00,169.00,40600,40602
51850,3,273,28,170.67,10817.56,40601,40604
51851,1,512,512,512.00,0.00,40603,40604
51852,1,512,512,512.00,0.00,40603,40604
51853,3,408,40,170.67,28259.56,40603,40606
51854,2,495,17,256.00,57121.00,40605,40607
51855,1,512,512,512.00,0.00,40606,40607
51856,3,300,42,170.67,11094.22,40606,40609
51857,1,512,512,512.00,0.00,40608,40609
51858,1,512,512,512.00,0.00,40608,40609
51859,2,276,236,256.00,400.00,40608,40610
51860,1,512,512,512.00,0.00,40609,40610
51861,1,512,512,512.00,0.00,40609,40610
51862,1,512,512,512.00,0.00,40609,40610
51863,2,460,52,256.00,41616.00,40609,40611
51864,1,512,512,512.00,0.00,40610,40611
51865,2,439,73,256.00,33489.00,40610,40612
51866,2,335,177,256.00,6241.00,40611,40613
51867,2,351,161,256.00,9025.00,40612,40614
51868,1,512,512,512.00,0.00,40613,40614
51869,3,372,17,170.67,22140.22,40613,40616
51870,1,512,512,512.00,0.00,40615,40616
51871,1,512,512,512.00,0.00,40615,40616
51872,2,333,179,256.00,5929.00,40615,40617
51873,4,473,2,128.00,39856.50,40616,40620
51874,3,362,15,170.67,20704.22,40619,40622
51875,3,394,15,170.67,26229.56,40621,40624
51876,1,512,512,512.00,0.00,40623,40624
51877,1,512,512,512.00,0.00,40623,40624
51878,3,278,7,170.67,13826.89,40623,40626
51879,2,393,119,256.00,18769.00,40625,40627
51880,3,347,9,170.67,19148.22,40626,40629
51881,1,512,512,512.00,0.00,40628,40629
51882,1,512,512,512.00,0.00,40628,40629
51883,3,197,151,170.67,374.89,40628,40631
51884,1,512,512,512.00,0.00,40630,40631
51885,1,512,512,512.00,0.00,40630,40631
51886,1,512,512,512.00,0.00,40630,40631
51887,1,512,512,512.00,0.00,40630,40631
51888,3,467,4,170.67,44134.89,40630,40633
51889,4,304,7,128.00,11792.50,40632,40636
51890,1,512,512,512.00,0.00,40635,40636
51891,1,512,512,512.00,0.00,40635,40636
51892,3,267,88,170.67,5433.56,40635,40638
51893,5,422,3,102.40,25750.64,40637,40642
51894,1,512,512,512.00,0.00,40641,40642
51895,1,512,512,512.00,0.00,40641,40642
51896,3,305,10,170.67,14850.89,40641,40644
51897,1,512,512,512.00,0.00,40643,40644
51898,1,512,512,512.00,0.00,40643,40644
51899,1,512,512,512.00,0.00,40643,40644
51900,1,512,512,512.00,0.00,40643,40644
51901,5,286,3,102.40,10916.24,40643,40648
51902,2,399,113,256.00,20449.00,40647,40649
51903,1,512,512,512.00,0.00,40648,40649
51904,1,512,512,512.00,0.00,40648,40649
51905,1,512,512,512.00,0.00,40648,40649
51906,3,246,25,170.67,10613.56,40648,40651
51907,1,512,512,512.00,0.00,40650,40651
51908,1,512,512,512.00,0.00,40650,40651
51909,2,502,10,256.00,60516.00,40650,40652
51910,1,512,512,512.00,0.00,40651,40652
51911,2,411,101,256.00,24025.00,40651,40653
51912,1,512,512,512.00,0.00,40652,40653
51913,3,318,3,170.67,16744.22,40652,40655
51914,4,237,30,128.00,5792.50,40654,40658
51915,1,512,512,512.00,0.00,40657,40658
51916,1,512,512,512.00,0.00,40657,40658
51917,1,512,512,512.00,0.00,40657,40658
51918,4,340,5,128.00,18354.50,40657,40661
51919,5,225,1,102.40,8027.04,40660,40665
51920,2,277,235,256.00,441.00,40664,40666
51921,1,512,512,512.00,0.00,40665,40666
51922,1,512,512,512.00,0.00,40665,40666
51923,5,322,1,102.40,15681.04,40665,40670
51924,2,293,219,256.00,1369.00,40669,40671
51925,4,324,6,128.00,16122.00,40670,40674
51926,3,336,2,170.67,18598.22,40673,40676
51927,2,388,124,256.00,17424.00,40675,40677
51928,1,512,512,512.00,0.00,40676,40677
51929,1,512,512,512.00,0.00,40676,40677
51930,1,512,512,512.00,0.00,40676,40677
51931,2,417,95,256.00,25921.00,40676,40678
51932,1,512,512,512.00,0.00,40677,40678
51933,1,512,512,512.00,0.00,40677,40678
51934,3,427,6,170.67,33741.56,40677,40680
51935,1,512,512,512.00,0.00,40679,40680
51936,1,512,512,512.00,0.00,40679,40680
51937,3,373,42,170.67,20973.56,40679,40682
51938,1,512,512,512.00,0.00,40681,40682
51939,1,512,512,512.00,0.00,40681,40682
51940,1,512,512,512.00,0.00,40681,40682
51941,2,401,111,256.00,21025.00,40681,40683
51942,1,512,512,512.00,0.00,40682,40683
51943,1,512,512,512.00,0.00,40682,40683
51944,1,512,512,512.00,0.00,40682,40683
51945,3,225,85,170.67,3757.56,40682,40685
51946,3,390,2,170.67,26374.22,40684,40687
51947,2,506,6,256.00,62500.00,40686,40688
51948,3,283,22,170.67,12013.56,40687,40690
51949,3,389,1,170.67,26274.89,40689,40692
51950,1,512,512,512.00,0.00,40691,40692
51951,1,512,512,512.00,0.00,40691,40692
51952,5,181,4,102.40,5427.04,40691,40696
51953,3,244,54,170.67,6955.56,40695,40698
51954,1,512,512,512.00,0.00,40697,40698
51955,1,512,512,512.00,0.00,40697,40698
51956,1,512,512,512.00,0.00,40697,40698
51957,2,357,155,256.00,10201.00,40697,40699
51958,2,497,15,256.00,58081.00,40698,40700
51959,1,512,512,512.00,0.00,40699,40700
51960,2,334,178,256.00,6084.00,40699,40701
51961,1,512,512,512.00,0.00,40700,40701
51962,5,343,1,102.40,16992.64,40700,40705
51963,1,512,512,512.00,0.00,40704,40705
51964,1,512,512,512.00,0.00,40704,40705
51965,1,512,512,512.00,0.00,40704,40705
51966,1,512,512,512.00,0.00,40704,40705
51967,4,233,54,128.00,4266.50,40704,40708
51968,5,200,6,102.40,4346.24,40707,40712
51969,1,512,512,512.00,0.00,40711,40712
51970,4,160,106,128.00,390.00,40711,40715
51971,1,512,512,512.00,0.00,40714,40715
51972,1,512,512,512.00,0.00,40714,40715
51973,1,512,512,512.00,0.00,40714,40715
51974,1,512,512,512.00,0.00,40714,40715
51975,2,452,60,256.00,38416.00,40714,40716
51976,4,453,2,128.00,35328.50,40715,40719
51977,3,192,146,170.67,358.22,40718,40721
51978,2,374,138,256.00,13924.00,40720,40722
51979,1,512,512,512.00,0.00,40721,40722
51980,2,459,53,256.00,41209.00,40721,40723
51981,1,512,512,512.00,0.00,40722,40723
51982,1,512,512,512.00,0.00,40722,40723
51983,1,512,512,512.00,0.00,40722,40723
51984,4,295,3,128.00,14627.00,40722,40726
51985,1,512,512,512.00,0.00,40725,40726
51986,1,512,512,512.00,0.00,40725,40726
51987,1,512,512,512.00,0.00,40725,40726
51988,2,265,247,256.00,81.00,40725,40727
51989,1,512,512,512.00,0.00,40726,40727
51990,1,512,512,512.00,0.00,40726,40727
51991,1,512,512,512.00,0.00,40726,40727
51992,1,512,512,512.00,0.00,40726,40727
51993,2,435,77,256.00,32041.00,40726,40728
51994,2,469,43,256.00,45369.00,40727,40729
51995,1,512,512,512.00,0.00,40728,40729
51996,1,512,512,512.00,0.00,40728,40729
51997,3,351,9,170.67,19668.22,40728,40731
51998,1,512,512,512.00,0.00,40730,40731
51999,5,252,10,102.40,9332.24,40730,40735
52000,1,512,512,512.00,0.00,40734,40735
52001,1,512,512,512.00,0.00,40734,40735
52002,1,512,512,512.00,0.00,40734,40735
52003,1,512,512,512.00,0.00,40734,40735
52004,6,220,1,85.33,6047.56,40734,40740
52005,1,512,512,512.00,0.00,40739,40740
52006,1,512,512,512.00,0.00,40739,40740
52007,8,328,2,64.00,10887.00,40739,40747
52008,1,512,512,512.00,0.00,40746,40747
52009,5,238,11,102.40,6590.64,40746,40751
52010,1,512,512,512.00,0.00,40750,40751
52011,2,487,25,256.00,53361.00,40750,40752
52012,1,512,512,512.00,0.00,40751,40752
52013,1,512,512,512.00,0.00,40751,40752
52014,7,369,1,73.14,15296.98,40751,40758
52015,3,248,110,170.67,3312.89,40757,40760
52016,2,297,215,256.00,1681.00,40759,40761
52017,1,512,512,512.00,0.00,40760,40761
52018,7,226,1,73.14,7436.98,40760,40767
52019,2,402,110,256.00,21316.00,40766,40768
52020,1,512,512,512.00,0.00,40767,40768
52021,2,445,67,256.00,35721.00,40767,40769
52022,2,256,256,256.00,0.00,40768,40770
52023,1,512,512,512.00,0.00,40769,40770
52024,1,512,512,512.00,0.00,40769,40770
52025,2,439,73,256.00,33489.00,40769,40771
52026,1,512,512,512.00,0.00,40770,40771
52027,6,352,2,85.33,14936.89,40770,40776
52028,2,453,59,256.00,38809.00,40775,40777
52029,1,512,512,512.00,0.00,40777,40778
52030,2,449,63,256.00,37249.00,40777,40779
52031,1,512,512,512.00,0.00,40778,40779
52032,3,498,3,170.67,53584.22,40778,40781
52033,7,166,12,73.14,3387.84,40780,40787
52034,1,512,512,512.00,0.00,40786,40787
52035,1,512,512,512.00,0.00,40786,40787
52036,1,512,512,512.00,0.00,40786,40787
52037,3,309,2,170.67,16168.22,40786,40789
52038,1,512,512,512.00,0.00,40788,40789
52039,1,512,512,512.00,0.00,40788,40789
52040,1,512,512,512.00,0.00,40788,40789
52041,1,512,512,512.00,0.00,40788,40789
52042,1,512,512,512.00,0.00,40788,40789
52043,1,512,512,512.00,0.00,40788,40789
52044,3,456,4,170.67,41091.56,40788,40791
52045,6,268,1,85.33,8051.22,40790,40796
52046,1,512,512,512.00,0.00,40795,40796
52047,1,512,512,512.00,0.00,40795,40796
52048,1,512,512,512.00,0.00,40795,40796
52049,2,500,12,256.00,59536.00,40795,40797
52050,2,503,9,256.00,61009.00,40796,40798
52051,5,190,1,102.40,4040.64,40797,40802
52052,1,512,512,512.00,0.00,40801,40802
52053,3,504,1,170.67,55561.56,40801,40804
52054,3,494,1,170.67,52314.89,40803,40806
52055,1,512,512,512.00,0.00,40805,40806
52056,2,486,26,256.00,52900.00,40805,40807
52057,4,316,15,128.00,12786.50,40806,40810
52058,1,512,512,512.00,0.00,40809,40810
52059,2,268,244,256.00,144.00,40809,40811
52060,1,512,512,512.00,0.00,40810,40811
52061,1,512,512,512.00,0.00,40810,40811
52062,1,512,512,512.00,0.00,40810,40811
52063,2,268,244,256.00,144.00,40810,40812
52064,2,260,252,256.00,16.00,40811,40813
52065,2,310,202,256.00,2916.00,40812,40814
52066,1,512,512,512.00,0.00,40813,40814
52067,1,512,512,512.00,0.00,40813,40814
52068,1,512,512,512.00,0.00,40813,40814
52069,1,512,512,512.00,0.00,40813,40814
52070,3,423,15,170.67,32416.22,40813,40816
52071,3,335,29,170.67,15862.89,40815,40818
52072,2,283,229,256.00,729.00,40817,40819
52073,1,512,512,512.00,0.00,40818,40819
52074,1,512,512,512.00,0.00,40818,40819
52075,3,402,20,170.67,27574.22,40818,40821
52076,3,400,31,170.67,26713.56,40820,40823
52077,3,294,104,170.67,7622.22,40822,40825
52078,1,512,512,512.00,0.00,40824,40825
52079,2,443,69,256.00,34969.00,40824,40826
52080,3,290,50,170.67,9600.89,40825,40828
52081,1,512,512,512.00,0.00,40827,40828
52082,1,512,512,512.00,0.00,40827,40828
52083,2,501,11,256.00,60025.00,40827,40829
52084,2,339,173,256.00,6889.00,40828,40830
52085,2,418,94,256.00,26244.00,40829,40831
52086,2,354,158,256.00,9604.00,40830,40832
52087,6,189,8,85.33,4054.89,40831,40837
52088,1,512,512,512.00,0.00,40836,40837
52089,2,370,142,256.00,12996.00,40836,40838
52090,1,512,512,512.00,0.00,40837,40838
52091,1,512,512,512.00,0.00,40837,40838
52092,3,231,60,170.67,6140.22,40837,40840
52093,2,479,33,256.00,49729.00,40839,40841
52094,1,512,512,512.00,0.00,40840,40841
52095,1,512,512,512.00,0.00,40840,40841
52096,6,314,2,85.33,11478.56,40840,40846
52097,1,512,512,512.00,0.00,40845,40846
52098,1,512,512,512.00,0.00,40845,40846
52099,5,343,8,102.40,15383.84,40845,40850
52100,5,276,12,102.40,10311.44,40849,40854
52101,6,210,2,85.33,5827.89,40853,40859
52102,3,339,4,170.67,18705.56,40858,40861
52103,2,294,218,256.00,1444.00,40860,40862
52104,1,512,512,512.00,0.00,40861,40862
52105,2,327,185,256.00,5041.00,40861,40863
52106,1,512,512,512.00,0.00,40862,40863
52107,2,344,168,256.00,7744.00,40862,40864
52108,1,512,512,512.00,0.00,40863,40864
52109,1,512,512,512.00,0.00,40863,40864
52110,2,427,85,256.00,29241.00,40863,40865
52111,1,512,512,512.00,0.00,40864,40865
52112,3,464,17,170.67,43054.89,40864,40867
52113,2,379,133,256.00,15129.00,40866,40868
52114,4,224,19,128.00,9123.50,40867,40871
52115,5,343,7,102.40,16771.84,40870,40875
52116,1,512,512,512.00,0.00,40874,40875
52117,2,267,245,256.00,121.00,40874,40876
52118,1,512,512,512.00,0.00,40875,40876
52119,1,512,512,512.00,0.00,40875,40876
52120,2,478,34,256.00,49284.00,40875,40877
52121,3,204,133,170.67,849.56,40876,40879
52122,1,512,512,512.00,0.00,40878,40879
52123,1,512,512,512.00,0.00,40878,40879
52124,6,177,4,85.33,2972.89,40878,40884
52125,4,436,3,128.00,31836.50,40883,40887
52126,1,512,512,512.00,0.00,40886,40887
52127,2,401,111,256.00,21025.00,40886,40888
52128,4,297,6,128.00,13838.50,40887,40891
52129,4,269,22,128.00,11587.50,40890,40894
52130,2,473,39,256.00,47089.00,40893,40895
52131,2,334,178,256.00,6084.00,40894,40896
52132,2,282,230,256.00,676.00,40895,40897
52133,3,383,10,170.67,24522.89,40896,40899
52134,1,512,512,512.00,0.00,40898,40899
52135,2,477,35,256.00,48841.00,40898,40900
52136,2,489,23,256.00,54289.00,40899,40901
52137,2,479,33,256.00,49729.00,40900,40902
52138,1,512,512,512.00,0.00,40901,40902
52139,7,367,1,73.14,14744.98,40901,40908
52140,7,285,4,73.14,10823.27,40907,40914
52141,1,512,512,512.00,0.00,40913,40914
52142,5,296,1,102.40,13815.44,40913,40918
52143,1,512,512,512.00,0.00,40918,40919
52144,6,220,3,85.33,9027.56,40918,40924
52145,3,406,5,170.67,29226.89,40923,40926
52146,2,338,174,256.00,6724.00,40925,40927
52147,2,494,18,256.00,56644.00,40926,40928
52148,1,512,512,512.00,0.00,40927,40928
52149,1,512,512,512.00,0.00,40927,40928
52150,2,356,156,256.00,10000.00,40927,40929
52151,1,512,512,512.00,0.00,40928,40929
52152,1,512,512,512.00,0.00,40928,40929
52153,1,512,512,512.00,0.00,40928,40929
52154,2,401,111,256.00,21025.00,40928,40930
52155,2,498,14,256.00,58564.00,40929,40931
52156,3,460,24,170.67,41859.56,40930,40933
52157,2,479,33,256.00,49729.00,40932,40934
52158,1,512,512,512.00,0.00,40933,40934
52159,1,512,512,512.00,0.00,40933,40934
52160,1,512,512,512.00,0.00,40933,40934
52161,5,383,1,102.40,20988.24,40933,40938
52162,3,256,3,170.67,14057.56,40937,40940
52163,2,360,152,256.00,10816.00,40939,40941
52164,3,415,33,170.67,30009.56,40940,40943
52165,1,512,512,512.00,0.00,40942,40943
52166,1,512,512,512.00,0.00,40942,40943
52167,1,512,512,512.00,0.00,40942,40943
52168,2,371,141,256.00,13225.00,40942,40944
52169,1,512,512,512.00,0.00,40943,40944
52170,3,496,6,170.67,52923.56,40943,40946
52171,1,512,512,512.00,0.00,40945,40946
52172,3,477,5,170.67,47024.22,40945,40948
52173,1,512,512,512.00,0.00,40947,40948
52174,1,512,512,512.00,0.00,40947,40948
52175,1,512,512,512.00,0.00,40947,40948
52176,1,512,512,512.00,0.00,40947,40948
52177,3,480,8,170.67,47886.22,40947,40950
52178,3,254,78,170.67,5206.22,40949,40952
52179,4,453,12,128.00,35245.50,40951,40955
52180,4,223,37,128.00,5089.00,40954,40958
52181,1,512,512,512.00,0.00,40957,40958
52182,9,262,3,56.89,6270.10,40957,40966
52183,3,307,15,170.67,14397.56,40965,40968
52184,1,512,512,512.00,0.00,40967,40968
52185,1,512,512,512.00,0.00,40967,40968
52186,1,512,512,512.00,0.00,40967,40968
52187,1,512,512,512.00,0.00,40967,40968
52188,5,227,1,102.40,9261.84,40967,40972
52189,2,336,176,256.00,6400.00,40971,40973
52190,1,512,512,512.00,0.00,40972,40973
52191,1,512,512,512.00,0.00,40972,40973
52192,3,498,4,170.67,53579.56,40972,40975
52193,1,512,512,512.00,0.00,40974,40975
52194,2,415,97,256.00,25281.00,40974,40976
52195,1,512,512,512.00,0.00,40975,40976
52196,2,370,142,256.00,12996.00,40975,40977
52197,1,512,512,512.00,0.00,40976,40977
52198,2,380,132,256.00,15376.00,40976,40978
52199,5,321,1,102.40,13747.84,40977,40982
52200,5,309,1,102.40,13553.44,40981,40986
52201,2,320,192,256.00,4096.00,40985,40987
52202,1,512,512,512.00,0.00,40986,40987
52203,3,314,9,170.67,15672.22,40986,40989
52204,4,355,16,128.00,19102.50,40988,40992
52205,3,428,26,170.67,33280.89,40991,40994
52206,1,512,512,512.00,0.00,40993,40994
52207,2,481,31,256.00,50625.00,40993,40995
52208,3,332,3,170.67,18060.22,40994,40997
52209,1,512,512,512.00,0.00,40996,40997
52210,2,275,237,256.00,361.00,40996,40998
52211,1,512,512,512.00,0.00,40997,40998
52212,1,512,512,512.00,0.00,40997,40998
52213,2,267,245,256.00,121.00,40997,40999
52214,2,414,98,256.00,24964.00,40998,41000
52215,6,193,15,85.33,4821.56,40999,41005
52216,1,512,512,512.00,0.00,41004,41005
52217,1,512,512,512.00,0.00,41004,41005
52218,4,197,66,128.00,2235.50,41004,41008
52219,1,512,512,512.00,0.00,41007,41008
52220,1,512,512,512.00,0.00,41007,41008
52221,1,512,512,512.00,0.00,41007,41008
52222,1,512,512,512.00,0.00,41007,41008
52223,4,325,2,128.00,17704.50,41007,41011
52224,1,512,512,512.00,0.00,41010,41011
52225,1,512,512,512.00,0.00,41010,41011
52226,4,361,8,128.00,18789.50,41010,41014
52227,3,487,9,170.67,50041.56,41013,41016
52228,1,512,512,512.00,0.00,41015,41016
52229,1,512,512,512.00,0.00,41015,41016
52230,1,512,512,512.00,0.00,41015,41016
52231,2,298,214,256.00,1764.00,41015,41017
52232,5,245,9,102.40,11687.84,41016,41021
52233,2,335,177,256.00,6241.00,41020,41022
52234,1,512,512,512.00,0.00,41021,41022
52235,1,512,512,512.00,0.00,41021,41022
52236,4,257,1,128.00,9297.50,41021,41025
52237,6,296,7,85.33,10777.56,41024,41030
52238,4,244,2,128.00,7443.50,41029,41033
52239,1,512,512,512.00,0.00,41032,41033
52240,2,304,208,256.00,2304.00,41032,41034
52241,1,512,512,512.00,0.00,41033,41034
52242,2,277,235,256.00,441.00,41033,41035
52243,4,322,6,128.00,13850.00,41034,41038
52244,2,257,255,256.00,1.00,41037,41039
52245,1,512,512,512.00,0.00,41038,41039
52246,1,512,512,512.00,0.00,41038,41039
52247,1,512,512,512.00,0.00,41038,41039
52248,1,512,512,512.00,0.00,41038,41039
52249,4,449,9,128.00,34473.00,41038,41042
52250,1,512,512,512.00,0.00,41042,41043
52251,1,512,512,512.00,0.00,41042,41043
52252,1,512,512,512.00,0.00,41042,41043
52253,3,497,6,170.67,53248.22,41042,41045
52254,5,192,5,102.40,5297.84,41044,41049
52255,1,512,512,512.00,0.00,41048,41049
52256,2,380,132,256.00,15376.00,41048,41050
52257,1,512,512,512.00,0.00,41049,41050
52258,3,256,118,170.67,3707.56,41049,41052
52259,8,144,4,64.00,2801.50,41051,41059
52260,1,512,512,512.00,0.00,41058,41059
52261,1,512,512,512.00,0.00,41058,41059
52262,1,512,512,512.00,0.00,41058,41059
52263,1,512,512,512.00,0.00,41058,41059
52264,5,257,18,102.40,7361.84,41058,41063
52265,2,457,55,256.00,40401.00,41062,41064
52266,2,445,67,256.00,35721.00,41063,41065
52267,1,512,512,512.00,0.00,41064,41065
52268,3,445,6,170.67,38133.56,41064,41067
52269,2,352,160,256.00,9216.00,41066,41068
52270,1,512,512,512.00,0.00,41067,41068
52271,2,380,132,256.00,15376.00,41067,41069
52272,3,343,23,170.67,17370.89,41068,41071
52273,1,512,512,512.00,0.00,41070,41071
52274,3,364,71,170.67,18694.89,41070,41073
52275,2,376,136,256.00,14400.00,41072,41074
52276,1,512,512,512.00,0.00,41073,41074
52277,1,512,512,512.00,0.00,41073,41074
52278,1,512,512,512.00,0.00,41073,41074
52279,1,512,512,512.00,0.00,41073,41074
52280,2,288,224,256.00,1024.00,41073,41075
52281,10,219,1,51.20,6504.36,41074,41084
52282,2,375,137,256.00,14161.00,41083,41085
52283,2,428,84,256.00,29584.00,41084,41086
52284,1,512,512,512.00,0.00,41085,41086
52285,1,512,512,512.00,0.00,41085,41086
52286,5,138,2,102.40,2557.04,41085,41090
52287,1,512,512,512.00,0.00,41089,41090
52288,2,442,70,256.00,34596.00,41089,41091
52289,7,195,3,73.14,4150.98,41090,41097
52290,3,308,42,170.67,11830.22,41096,41099
52291,1,512,512,512.00,0.00,41098,41099
52292,2,300,212,256.00,1936.00,41098,41100
52293,1,512,512,512.00,0.00,41099,41100
52294,2,335,177,256.00,6241.00,41099,41101
52295,1,512,512,512.00,0.00,41100,41101
52296,1,512,512,512.00,0.00,41100,41101
52297,6,286,13,85.33,9044.89,41100,41106
52298,1,512,512,512.00,0.00,41105,41106
52299,4,282,4,128.00,12197.50,41105,41109
52300,1,512,512,512.00,0.00,41108,41109
52301,1,512,512,512.00,0.00,41108,41109
52302,3,282,6,170.67,14118.22,41108,41111
52303,1,512,512,512.00,0.00,41110,41111
52304,4,248,5,128.00,12534.50,41110,41114
52305,1,512,512,512.00,0.00,41113,41114
52306,1,512,512,512.00,0.00,41113,41114
52307,1,512,512,512.00,0.00,41113,41114
52308,2,311,201,256.00,3025.00,41113,41115
52309,1,512,512,512.00,0.00,41114,41115
52310,3,389,1,170.67,26274.89,41114,41117
52311,2,382,130,256.00,15876.00,41116,41118
52312,1,512,512,512.00,0.00,41117,41118
52313,2,508,4,256.00,63504.00,41117,41119
52314,1,512,512,512.00,0.00,41118,41119
52315,1,512,512,512.00,0.00,41118,41119
52316,10,135,1,51.20,1874.96,41118,41128
52317,3,315,2,170.67,16624.22,41127,41130
52318,1,512,512,512.00,0.00,41129,41130
52319,1,512,512,512.00,0.00,41129,41130
52320,4,392,1,128.00,24505.50,41129,41133
52321,1,512,512,512.00,0.00,41132,41133
52322,1,512,512,512.00,0.00,41132,41133
52323,1,512,512,512.00,0.00,41132,41133
52324,3,447,12,170.67,38460.22,41132,41135
52325,1,512,512,512.00,0.00,41134,41135
52326,4,260,77,128.00,5826.50,41134,41138
52327,1,512,512,512.00,0.00,41137,41138
52328,3,464,6,170.67,43238.22,41137,41140
52329,5,264,2,102.40,8965.84,41139,41144
52330,5,258,2,102.40,9604.24,41143,41148
52331,1,512,512,512.00,0.00,41147,41148
52332,1,512,512,512.00,0.00,41147,41148
52333,1,512,512,512.00,0.00,41147,41148
52334,2,382,130,256.00,15876.00,41147,41149
52335,1,512,512,512.00,0.00,41148,41149
52336,1,512,512,512.00,0.00,41148,41149
52337,1,512,512,512.00,0.00,41148,41149
52338,2,511,1,256.00,65025.00,41148,41150
52339,3,247,122,170.67,2986.89,41149,41152
52340,1,512,512,512.00,0.00,41151,41152
52341,7,263,2,73.14,6811.27,41151,41158
52342,2,510,2,256.00,64516.00,41157,41159
52343,2,463,49,256.00,42849.00,41158,41160
52344,5,216,1,102.40,8972.24,41159,41164
52345,6,286,2,85.33,10124.56,41163,41169
52346,2,445,67,256.00,35721.00,41168,41170
52347,1,512,512,512.00,0.00,41169,41170
52348,5,253,3,102.40,13689.04,41169,41174
52349,7,197,1,73.14,5599.27,41173,41180
52350,2,332,180,256.00,5776.00,41179,41181
52351,1,512,512,512.00,0.00,41180,41181
52352,2,426,86,256.00,28900.00,41180,41182
52353,4,452,2,128.00,35126.00,41181,41185
52354,3,312,5,170.67,16004.22,41184,41187
52355,1,512,512,512.00,0.00,41186,41187
52356,3,260,77,170.67,5590.89,41186,41189
52357,2,496,16,256.00,57600.00,41188,41190
52358,7,326,1,73.14,12123.84,41189,41196
52359,2,276,236,256.00,400.00,41195,41197
52360,2,501,11,256.00,60025.00,41196,41198
52361,5,486,1,102.40,36810.24,41197,41202
52362,5,258,1,102.40,11466.24,41201,41206
52363,2,421,91,256.00,27225.00,41205,41207
52364,1,512,512,512.00,0.00,41206,41207
52365,1,512,512,512.00,0.00,41206,41207
52366,1,512,512,512.00,0.00,41206,41207
52367,4,344,27,128.00,16332.50,41206,41210
52368,1,512,512,512.00,0.00,41209,41210
52369,1,512,512,512.00,0.00,41209,41210
52370,2,506,6,256.00,62500.00,41209,41211
52371,3,316,17,170.67,14934.89,41210,41213
52372,1,512,512,512.00,0.00,41212,41213
52373,4,468,1,128.00,38723.50,41212,41216
52374,1,512,512,512.00,0.00,41215,41216
52375,1,512,512,512.00,0.00,41215,41216
52376,1,512,512,512.00,0.00,41215,41216
52377,5,229,1,102.40,8583.04,41215,41220
52378,2,470,42,256.00,45796.00,41219,41221
52379,1,512,512,512.00,0.00,41220,41221
52380,1,512,512,512.00,0.00,41220,41221
52381,5,280,11,102.40,9413.04,41220,41225
52382,4,348,1,128.00,18389.50,41224,41228
52383,1,512,512,512.00,0.00,41227,41228
52384,2,383,129,256.00,16129.00,41227,41229
52385,1,512,512,512.00,0.00,41228,41229
52386,3,500,2,170.67,54240.89,41228,41231
52387,2,501,11,256.00,60025.00,41230,41232
52388,1,512,512,512.00,0.00,41231,41232
52389,4,365,4,128.00,21435.50,41231,41235
52390,1,512,512,512.00,0.00,41234,41235
52391,2,393,119,256.00,18769.00,41234,41236
52392,1,512,512,512.00,0.00,41235,41236
52393,1,512,512,512.00,0.00,41235,41236
52394,1,512,512,512.00,0.00,41235,41236
52395,3,483,2,170.67,48880.22,41235,41238
52396,1,512,512,512.00,0.00,41237,41238
52397,2,326,186,256.00,4900.00,41237,41239
52398,1,512,512,512.00,0.00,41238,41239
52399,1,512,512,512.00,0.00,41238,41239
52400,1,512,512,512.00,0.00,41238,41239
52401,1,512,512,512.00,0.00,41238,41239
52402,5,279,2,102.40,10509.44,41238,41243
52403,1,512,512,512.00,0.00,41242,41243
52404,2,411,101,256.00,24025.00,41242,41244
52405,1,512,512,512.00,0.00,41243,41244
52406,2,346,166,256.00,8100.00,41243,41245
52407,1,512,512,512.00,0.00,41244,41245
52408,1,512,512,512.00,0.00,41244,41245
52409,2,342,170,256.00,7396.00,41244,41246
52410,2,438,74,256.00,33124.00,41245,41247
52411,5,355,1,102.40,18629.44,41246,41251
52412,1,512,512,512.00,0.00,41250,41251
52413,2,316,196,256.00,3600.00,41250,41252
52414,1,512,512,512.00,0.00,41251,41252
52415,6,249,1,85.33,7860.56,41251,41257
52416,1,512,512,512.00,0.00,41256,41257
52417,4,494,1,128.00,44689.50,41256,41260
52418,2,510,2,256.00,64516.00,41259,41261
52419,1,512,512,512.00,0.00,41260,41261
52420,1,512,512,512.00,0.00,41260,41261
52421,1,512,512,512.00,0.00,41260,41261
52422,1,512,512,512.00,0.00,41260,41261
52423,2,297,215,256.00,1681.00,41260,41262
52424,3,259,74,170.67,5738.89,41261,41264
52425,1,512,512,512.00,0.00,41263,41264
52426,5,178,10,102.40,3690.24,41263,41268
52427,6,301,5,85.33,10700.22,41267,41273
52428,1,512,512,512.00,0.00,41272,41273
52429,2,425,87,256.00,28561.00,41272,41274
52430,2,443,69,256.00,34969.00,41273,41275
52431,1,512,512,512.00,0.00,41274,41275
52432,1,512,512,512.00,0.00,41274,41275
52433,2,267,245,256.00,121.00,41274,41276
52434,1,512,512,512.00,0.00,41275,41276
52435,1,512,512,512.00,0.00,41275,41276
52436,6,288,2,85.33,13139.22,41275,41281
52437,1,512,512,512.00,0.00,41280,41281
52438,1,512,512,512.00,0.00,41280,41281
52439,1,512,512,512.00,0.00,41280,41281
52440,2,418,94,256.00,26244.00,41280,41282
52441,3,218,103,170.67,2410.89,41281,41284
52442,1,512,512,512.00,0.00,41283,41284
52443,2,443,69,256.00,34969.00,41283,41285
52444,6,193,7,85.33,3970.89,41284,41290
52445,1,512,512,512.00,0.00,41289,41290
52446,4,357,7,128.00,18566.50,41289,41293
52447,1,512,512,512.00,0.00,41292,41293
52448,1,512,512,512.00,0.00,41292,41293
52449,3,509,1,170.67,57234.89,41292,41295
52450,3,446,11,170.67,38226.89,41294,41297
52451,1,512,512,512.00,0.00,41296,41297
52452,5,195,7,102.40,4032.24,41296,41301
52453,2,366,146,256.00,12100.00,41300,41302
52454,4,396,9,128.00,24316.50,41301,41305
52455,4,420,1,128.00,29492.50,41304,41308
52456,2,274,238,256.00,324.00,41307,41309
52457,1,512,512,512.00,0.00,41308,41309
52458,1,512,512,512.00,0.00,41308,41309
52459,6,232,3,85.33,7669.89,41308,41314
52460,2,282,230,256.00,676.00,41313,41315
52461,1,512,512,512.00,0.00,41314,41315
52462,1,512,512,512.00,0.00,41314,41315
52463,1,512,512,512.00,0.00,41314,41315
52464,1,512,512,512.00,0.00,41314,41315
52465,2,370,142,256.00,12996.00,41314,41316
52466,3,398,39,170.67,26056.22,41315,41318
52467,1,512,512,512.00,0.00,41317,41318
52468,1,512,512,512.00,0.00,41317,41318
52469,2,265,247,256.00,81.00,41317,41319
52470,5,314,19,102.40,11892.24,41318,41323
52471,6,246,1,85.33,12921.56,41322,41328
52472,10,204,1,51.20,4947.36,41327,41337
52473,6,303,3,85.33,10956.22,41336,41342
52474,1,512,512,512.00,0.00,41341,41342
52475,1,512,512,512.00,0.00,41341,41342
52476,1,512,512,512.00,0.00,41341,41342
52477,1,512,512,512.00,0.00,41341,41342
52478,4,213,41,128.00,3899.00,41341,41345
52479,1,512,512,512.00,0.00,41344,41345
52480,2,386,126,256.00,16900.00,41344,41346
52481,1,512,512,512.00,0.00,41345,41346
52482,1,512,512,512.00,0.00,41345,41346
52483,3,482,4,170.67,48544.89,41345,41348
52484,1,512,512,512.00,0.00,41347,41348
52485,4,479,1,128.00,41217.00,41347,41351
52486,3,280,63,170.67,7849.56,41350,41353
52487,1,512,512,512.00,0.00,41352,41353
52488,1,512,512,512.00,0.00,41352,41353
52489,1,512,512,512.00,0.00,41352,41353
52490,1,512,512,512.00,0.00,41352,41353
52491,1,512,512,512.00,0.00,41352,41353
52492,5,432,14,102.40,27194.24,41352,41357
52493,1,512,512,512.00,0.00,41356,41357
52494,1,512,512,512.00,0.00,41356,41357
52495,1,512,512,512.00,0.00,41356,41357
52496,1,512,512,512.00,0.00,41356,41357
52497,1,512,512,512.00,0.00,41356,41357
52498,2,291,221,256.00,1225.00,41356,41358
52499,1,512,512,512.00,0.00,41357,41358
52500,1,512,512,512.00,0.00,41357,41358
52501,4,394,3,128.00,25070.50,41357,41361
52502,2,432,80,256.00,30976.00,41360,41362
52503,6,179,7,85.33,3723.22,41361,41367
52504,1,512,512,512.00,0.00,41366,41367
52505,1,512,512,512.00,0.00,41366,41367
52506,4,336,1,128.00,19071.50,41366,41370
52507,1,512,512,512.00,0.00,41369,41370
52508,2,492,20,256.00,55696.00,41369,41371
52509,2,403,109,256.00,21609.00,41370,41372
52510,2,287,225,256.00,961.00,41371,41373
52511,1,512,512,512.00,0.00,41372,41373
52512,1,512,512,512.00,0.00,41372,41373
52513,2,418,94,256.00,26244.00,41372,41374
52514,1,512,512,512.00,0.00,41373,41374
52515,2,505,7,256.00,62001.00,41373,41375
52516,1,512,512,512.00,0.00,41374,41375
52517,3,289,2,170.67,14994.89,41374,41377
52518,1,512,512,512.00,0.00,41377,41378
52519,1,512,512,512.00,0.00,41377,41378
52520,1,512,512,512.00,0.00,41377,41378
52521,1,512,512,512.00,0.00,41377,41378
52522,1,512,512,512.00,0.00,41377,41378
52523,6,245,3,85.33,10563.22,41377,41383
52524,1,512,512,512.00,0.00,41382,41383
52525,1,512,512,512.00,0.00,41382,41383
52526,3,389,36,170.67,24268.22,41382,41385
52527,1,512,512,512.00,0.00,41384,41385
52528,1,512,512,512.00,0.00,41384,41385
52529,1,512,512,512.00,0.00,41384,41385
52530,1,512,512,512.00,0.00,41384,41385
52531,1,512,512,512.00,0.00,41384,41385
52532,6,353,1,85.33,15489.56,41384,41390
52533,1,512,512,512.00,0.00,41389,41390
52534,1,512,512,512.00,0.00,41389,41390
52535,3,290,18,170.67,12886.22,41389,41392
52536,1,512,512,512.00,0.00,41391,41392
52537,3,424,22,170.67,32411.56,41391,41394
52538,2,425,87,256.00,28561.00,41393,41395
52539,1,512,512,512.00,0.00,41394,41395
52540,1,512,512,512.00,0.00,41394,41395
52541,3,466,2,170.67,43904.89,41394,41397
52542,2,431,81,256.00,30625.00,41396,41398
52543,4,228,18,128.00,5737.50,41397,41401
52544,1,512,512,512.00,0.00,41400,41401
52545,1,512,512,512.00,0.00,41400,41401
52546,1,512,512,512.00,0.00,41400,41401
52547,2,441,71,256.00,34225.00,41400,41402
52548,2,378,134,256.00,14884.00,41401,41403
52549,2,453,59,256.00,38809.00,41402,41404
52550,4,275,3,128.00,11749.50,41403,41407
52551,1,512,512,512.00,0.00,41406,41407
52552,1,512,512,512.00,0.00,41406,41407
52553,1,512,512,512.00,0.00,41406,41407
52554,1,512,512,512.00,0.00,41406,41407
52555,1,512,512,512.00,0.00,41406,41407
52556,2,384,128,256.00,16384.00,41406,41408
52557,2,441,71,256.00,34225.00,41407,41409
52558,1,512,512,512.00,0.00,41408,41409
52559,1,512,512,512.00,0.00,41408,41409
52560,1,512,512,512.00,0.00,41408,41409
52561,1,512,512,512.00,0.00,41408,41409
52562,3,364,16,170.67,20931.56,41408,41411
52563,2,428,84,256.00,29584.00,41410,41412
52564,2,511,1,256.00,65025.00,41411,41413
52565,3,282,2,170.67,14710.22,41412,41415
52566,1,512,512,512.00,0.00,41414,41415
52567,1,512,512,512.00,0.00,41414,41415
52568,1,512,512,512.00,0.00,41414,41415
52569,12,235,1,42.67,3985.56,41414,41426
52570,1,512,512,512.00,0.00,41425,41426
52571,3,370,8,170.67,22512.89,41425,41428
52572,1,512,512,512.00,0.00,41427,41428
52573,1,512,512,512.00,0.00,41427,41428
52574,5,373,3,102.40,19091.04,41427,41432
52575,1,512,512,512.00,0.00,41431,41432
52576,1,512,512,512.00,0.00,41431,41432
52577,3,250,47,170.67,7850.89,41431,41434
52578,1,512,512,512.00,0.00,41433,41434
52579,1,512,512,512.00,0.00,41433,41434
52580,2,270,242,256.00,196.00,41433,41435
52581,2,280,232,256.00,576.00,41434,41436
52582,1,512,512,512.00,0.00,41435,41436
52583,4,287,9,128.00,12305.00,41435,41439
52584,1,512,512,512.00,0.00,41438,41439
52585,1,512,512,512.00,0.00,41438,41439
52586,1,512,512,512.00,0.00,41438,41439
52587,1,512,512,512.00,0.00,41438,41439
52588,2,445,67,256.00,35721.00,41438,41440
52589,2,389,123,256.00,17689.00,41439,41441
52590,1,512,512,512.00,0.00,41440,41441
52591,1,512,512,512.00,0.00,41440,41441
52592,3,299,1,170.67,15654.89,41440,41443
52593,3,367,1,170.67,22681.56,41442,41445
52594,2,478,34,256.00,49284.00,41444,41446
52595,2,327,185,256.00,5041.00,41445,41447
52596,1,512,512,512.00,0.00,41446,41447
52597,4,383,2,128.00,22866.50,41446,41450
52598,1,512,512,512.00,0.00,41449,41450
52599,1,512,512,512.00,0.00,41449,41450
52600,1,512,512,512.00,0.00,41449,41450
52601,1,512,512,512.00,0.00,41449,41450
52602,3,296,2,170.67,15344.89,41449,41452
52603,2,330,182,256.00,5476.00,41451,41453
52604,4,350,3,128.00,17809.50,41452,41456
52605,2,349,163,256.00,8649.00,41455,41457
52606,3,389,55,170.67,23862.89,41456,41459
52607,2,468,44,256.00,44944.00,41458,41460
52608,1,512,512,512.00,0.00,41459,41460
52609,1,512,512,512.00,0.00,41459,41460
52610,7,422,1,73.14,20526.12,41459,41466
52611,3,319,1,170.67,17081.56,41465,41468
52612,1,512,512,512.00,0.00,41467,41468
52613,4,475,2,128.00,40267.50,41467,41471
52614,1,512,512,512.00,0.00,41470,41471
52615,1,512,512,512.00,0.00,41470,41471
52616,1,512,512,512.00,0.00,41470,41471
52617,2,451,61,256.00,38025.00,41470,41472
52618,1,512,512,512.00,0.00,41471,41472
52619,1,512,512,512.00,0.00,41471,41472
52620,2,353,159,256.00,9409.00,41471,41473
52621,1,512,512,512.00,0.00,41472,41473
52622,1,512,512,512.00,0.00,41472,41473
52623,2,453,59,256.00,38809.00,41472,41474
52624,1,512,512,512.00,0.00,41473,41474
52625,1,512,512,512.00,0.00,41473,41474
52626,1,512,512,512.00,0.00,41473,41474
52627,4,315,1,128.00,14525.00,41473,41477
52628,2,446,66,256.00,36100.00,41476,41478
52629,4,414,1,128.00,28202.50,41477,41481
52630,1,512,512,512.00,0.00,41480,41481
52631,1,512,512,512.00,0.00,41480,41481
52632,5,383,2,102.40,20226.24,41480,41485
52633,1,512,512,512.00,0.00,41484,41485
52634,1,512,512,512.00,0.00,41484,41485
52635,1,512,512,512.00,0.00,41484,41485
52636,2,362,150,256.00,11236.00,41484,41486
52637,4,429,1,128.00,31189.00,41485,41489
52638,1,512,512,512.00,0.00,41488,41489
52639,1,512,512,512.00,0.00,41488,41489
52640,2,437,75,256.00,32761.00,41488,41490
52641,2,382,130,256.00,15876.00,41489,41491
52642,2,299,213,256.00,1849.00,41490,41492
52643,1,512,512,512.00,0.00,41491,41492
52644,4,243,1,128.00,9278.50,41491,41495
52645,1,512,512,512.00,0.00,41494,41495
52646,1,512,512,512.00,0.00,41494,41495
52647,3,293,51,170.67,9764.22,41494,41497
52648,1,512,512,512.00,0.00,41496,41497
52649,1,512,512,512.00,0.00,41496,41497
52650,1,512,512,512.00,0.00,41496,41497
52651,1,512,512,512.00,0.00,41496,41497
52652,5,233,6,102.40,6661.04,41496,41501
52653,2,461,51,256.00,42025.00,41500,41502
52654,1,512,512,512.00,0.00,41501,41502
52655,1,512,512,512.00,0.00,41501,41502
52656,1,512,512,512.00,0.00,41501,41502
52657,1,512,512,512.00,0.00,41501,41502
52658,2,490,22,256.00,54756.00,41501,41503
52659,1,512,512,512.00,0.00,41502,41503
52660,1,512,512,512.00,0.00,41502,41503
52661,1,512,512,512.00,0.00,41502,41503
52662,5,322,3,102.40,13592.24,41502,41507
52663,2,281,231,256.00,625.00,41506,41508
52664,1,512,512,512.00,0.00,41507,41508
52665,1,512,512,512.00,0.00,41507,41508
52666,1,512,512,512.00,0.00,41507,41508
52667,2,286,226,256.00,900.00,41507,41509
52668,7,176,24,73.14,2220.98,41508,41515
52669,1,512,512,512.00,0.00,41514,41515
52670,1,512,512,512.00,0.00,41514,41515
52671,1,512,512,512.00,0.00,41514,41515
52672,1,512,512,512.00,0.00,41514,41515
52673,1,512,512,512.00,0.00,41514,41515
52674,2,473,39,256.00,47089.00,41514,41516
52675,2,442,70,256.00,34596.00,41515,41517
52676,3,364,1,170.67,22241.56,41516,41519
52677,1,512,512,512.00,0.00,41518,41519
52678,1,512,512,512.00,0.00,41518,41519
52679,1,512,512,512.00,0.00,41518,41519
52680,1,512,512,512.00,0.00,41518,41519
52681,1,512,512,512.00,0.00,41518,41519
52682,4,212,36,128.00,4200.50,41518,41522
52683,4,341,19,128.00,15672.50,41521,41525
52684,2,343,169,256.00,7569.00,41524,41526
52685,1,512,512,512.00,0.00,41525,41526
52686,1,512,512,512.00,0.00,41525,41526
52687,2,481,31,256.00,50625.00,41525,41527
52688,1,512,512,512.00,0.00,41526,41527
52689,2,356,156,256.00,10000.00,41526,41528
52690,1,512,512,512.00,0.00,41527,41528
52691,1,512,512,512.00,0.00,41527,41528
52692,1,512,512,512.00,0.00,41527,41528
52693,7,232,1,73.14,7486.12,41527,41534
52694,1,512,512,512.00,0.00,41533,41534
52695,1,512,512,512.00,0.00,41533,41534
52696,1,512,512,512.00,0.00,41533,41534
52697,1,512,512,512.00,0.00,41533,41534
52698,4,428,2,128.00,30415.50,41533,41537
52699,1,512,512,512.00,0.00,41536,41537
52700,2,466,46,256.00,44100.00,41536,41538
52701,5,488,1,102.40,37189.04,41537,41542
52702,1,512,512,512.00,0.00,41541,41542
52703,1,512,512,512.00,0.00,41541,41542
52704,1,512,512,512.00,0.00,41541,41542
52705,2,405,107,256.00,22201.00,41541,41543
52706,1,512,512,512.00,0.00,41542,41543
52707,2,375,137,256.00,14161.00,41542,41544
52708,1,512,512,512.00,0.00,41543,41544
52709,1,512,512,512.00,0.00,41543,41544
52710,1,512,512,512.00,0.00,41543,41544
52711,3,316,76,170.67,10883.56,41543,41546
52712,6,313,3,85.33,11167.56,41545,41551
52713,1,512,512,512.00,0.00,41550,41551
52714,1,512,512,512.00,0.00,41550,41551
52715,1,512,512,512.00,0.00,41550,41551
52716,1,512,512,512.00,0.00,41550,41551
52717,2,409,103,256.00,23409.00,41550,41552
52718,3,354,15,170.67,19536.22,41551,41554
52719,1,512,512,512.00,0.00,41553,41554
52720,1,512,512,512.00,0.00,41553,41554
52721,1,512,512,512.00,0.00,41553,41554
52722,2,412,100,256.00,24336.00,41553,41555
52723,1,512,512,512.00,0.00,41554,41555
52724,1,512,512,512.00,0.00,41554,41555
52725,1,512,512,512.00,0.00,41554,41555
52726,6,305,2,85.33,10441.56,41554,41560
52727,1,512,512,512.00,0.00,41559,41560
52728,1,512,512,512.00,0.00,41559,41560
52729,1,512,512,512.00,0.00,41559,41560
52730,7,262,1,73.14,8856.98,41559,41566
52731,3,365,30,170.67,20144.22,41565,41568
52732,1,512,512,512.00,0.00,41567,41568
52733,1,512,512,512.00,0.00,41567,41568
52734,4,461,1,128.00,37323.50,41567,41571
52735,1,512,512,512.00,0.00,41570,41571
52736,1,512,512,512.00,0.00,41570,41571
52737,1,512,512,512.00,0.00,41570,41571
52738,3,307,3,170.67,15893.56,41570,41573
52739,1,512,512,512.00,0.00,41572,41573
52740,1,512,512,512.00,0.00,41572,41573
52741,3,287,45,170.67,9804.22,41572,41575
52742,2,499,13,256.00,59049.00,41574,41576
52743,5,301,2,102.40,15880.64,41575,41580
52744,1,512,512,512.00,0.00,41579,41580
52745,1,512,512,512.00,0.00,41579,41580
52746,1,512,512,512.00,0.00,41579,41580
52747,3,368,20,170.67,21272.89,41579,41582
52748,1,512,512,512.00,0.00,41581,41582
52749,1,512,512,512.00,0.00,41581,41582
52750,2,335,177,256.00,6241.00,41581,41583
52751,1,512,512,512.00,0.00,41582,41583
52752,1,512,512,512.00,0.00,41582,41583
52753,3,301,38,170.67,11530.89,41582,41585
52754,1,512,512,512.00,0.00,41584,41585
52755,1,512,512,512.00,0.00,41584,41585
52756,1,512,512,512.00,0.00,41584,41585
52757,5,264,9,102.40,7911.44,41584,41589
52758,1,512,512,512.00,0.00,41588,41589
52759,1,512,512,512.00,0.00,41588,41589
52760,4,422,3,128.00,29788.50,41588,41592
52761,1,512,512,512.00,0.00,41591,41592
52762,1,512,512,512.00,0.00,41591,41592
52763,1,512,512,512.00,0.00,41591,41592
52764,7,314,1,73.14,11285.84,41591,41598
52765,7,215,1,73.14,6146.12,41597,41604
52766,1,512,512,512.00,0.00,41603,41604
52767,3,360,2,170.67,21574.22,41603,41606
52768,2,404,108,256.00,21904.00,41605,41607
52769,2,451,61,256.00,38025.00,41606,41608
52770,1,512,512,512.00,0.00,41607,41608
52771,1,512,512,512.00,0.00,41607,41608
52772,3,388,59,170.67,23622.89,41607,41610
52773,1,512,512,512.00,0.00,41609,41610
52774,4,265,33,128.00,8227.00,41609,41613
52775,1,512,512,512.00,0.00,41612,41613
52776,1,512,512,512.00,0.00,41612,41613
52777,1,512,512,512.00,0.00,41612,41613
52778,1,512,512,512.00,0.00,41612,41613
52779,2,275,237,256.00,361.00,41612,41614
52780,1,512,512,512.00,0.00,41613,41614
52781,2,414,98,256.00,24964.00,41613,41615
52782,1,512,512,512.00,0.00,41614,41615
52783,1,512,512,512.00,0.00,41614,41615
52784,1,512,512,512.00,0.00,41614,41615
52785,2,346,166,256.00,8100.00,41614,41616
52786,1,512,512,512.00,0.00,41615,41616
52787,4,266,2,128.00,15020.00,41615,41619
52788,1,512,512,512.00,0.00,41618,41619
52789,1,512,512,512.00,0.00,41618,41619
52790,1,512,512,512.00,0.00,41618,41619
52791,2,335,177,256.00,6241.00,41618,41620
52792,1,512,512,512.00,0.00,41619,41620
52793,1,512,512,512.00,0.00,41619,41620
52794,4,449,1,128.00,34785.00,41619,41623
52795,3,224,80,170.67,4152.89,41622,41625
52796,3,396,50,170.67,25430.22,41624,41627
52797,1,512,512,512.00,0.00,41626,41627
52798,1,512,512,512.00,0.00,41626,41627
52799,1,512,512,512.00,0.00,41626,41627
52800,4,343,6,128.00,18569.50,41626,41630
52801,1,512,512,512.00,0.00,41629,41630
52802,4,315,14,128.00,13647.50,41629,41633
52803,1,512,512,512.00,0.00,41632,41633
52804,1,512,512,512.00,0.00,41632,41633
52805,1,512,512,512.00,0.00,41632,41633
52806,4,399,11,128.00,25167.50,41632,41636
52807,1,512,512,512.00,0.00,41635,41636
52808,1,512,512,512.00,0.00,41635,41636
52809,1,512,512,512.00,0.00,41635,41636
52810,1,512,512,512.00,0.00,41635,41636
52811,2,266,246,256.00,100.00,41635,41637
52812,1,512,512,512.00,0.00,41636,41637
52813,2,389,123,256.00,17689.00,41636,41638
52814,1,512,512,512.00,0.00,41637,41638
52815,2,509,3,256.00,64009.00,41637,41639
52816,1,512,512,512.00,0.00,41638,41639
52817,1,512,512,512.00,0.00,41638,41639
52818,1,512,512,512.00,0.00,41638,41639
52819,3,394,1,170.67,27181.56,41638,41641
52820,1,512,512,512.00,0.00,41640,41641
52821,3,297,55,170.67,9817.56,41640,41643
52822,1,512,512,512.00,0.00,41642,41643
52823,1,512,512,512.00,0.00,41642,41643
52824,2,342,170,256.00,7396.00,41642,41644
52825,1,512,512,512.00,0.00,41643,41644
52826,1,512,512,512.00,0.00,41643,41644
52827,1,512,512,512.00,0.00,41643,41644
52828,1,512,512,512.00,0.00,41643,41644
52829,1,512,512,512.00,0.00,41643,41644
52830,4,372,2,128.00,21278.00,41643,41647
52831,1,512,512,512.00,0.00,41646,41647
52832,1,512,512,512.00,0.00,41646,41647
52833,2,408,104,256.00,23104.00,41646,41648
52834,5,283,17,102.40,9019.84,41647,41652
52835,1,512,512,512.00,0.00,41651,41652
52836,3,428,23,170.67,33350.89,41651,41654
52837,1,512,512,512.00,0.00,41653,41654
52838,1,512,512,512.00,0.00,41653,41654
52839,1,512,512,512.00,0.00,41653,41654
52840,2,276,236,256.00,400.00,41653,41655
52841,8,165,3,64.00,4368.50,41654,41662
52842,2,331,181,256.00,5625.00,41661,41663
52843,2,313,199,256.00,3249.00,41662,41664
52844,1,512,512,512.00,0.00,41663,41664
52845,2,334,178,256.00,6084.00,41663,41665
52846,1,512,512,512.00,0.00,41664,41665
52847,1,512,512,512.00,0.00,41664,41665
52848,1,512,512,512.00,0.00,41664,41665
52849,3,270,71,170.67,6600.22,41664,41667
52850,5,196,24,102.40,3021.04,41666,41671
52851,3,486,12,170.67,49718.22,41670,41673
52852,1,512,512,512.00,0.00,41672,41673
52853,2,259,253,256.00,9.00,41672,41674
52854,1,512,512,512.00,0.00,41673,41674
52855,1,512,512,512.00,0.00,41673,41674
52856,3,383,61,170.67,22550.89,41673,41676
52857,2,489,23,256.00,54289.00,41675,41677
52858,1,512,512,512.00,0.00,41676,41677
52859,1,512,512,512.00,0.00,41676,41677
52860,3,318,95,170.67,10856.22,41676,41679
52861,1,512,512,512.00,0.00,41678,41679
52862,8,179,12,64.00,3515.75,41678,41686
52863,2,274,238,256.00,324.00,41685,41687
52864,3,434,2,170.67,35584.89,41686,41689
52865,2,313,199,256.00,3249.00,41688,41690
52866,6,254,1,85.33,7640.56,41689,41695
52867,8,240,2,64.00,6654.00,41694,41702
52868,3,358,51,170.67,17997.56,41701,41704
52869,2,421,91,256.00,27225.00,41703,41705
52870,1,512,512,512.00,0.00,41704,41705
52871,2,344,168,256.00,7744.00,41704,41706
52872,1,512,512,512.00,0.00,41705,41706
52873,10,301,1,51.20,7732.16,41705,41715
52874,5,258,30,102.40,8289.04,41714,41719
52875,1,512,512,512.00,0.00,41718,41719
52876,3,471,3,170.67,45304.22,41718,41721
52877,3,402,2,170.67,28630.22,41720,41723
52878,1,512,512,512.00,0.00,41722,41723
52879,1,512,512,512.00,0.00,41722,41723
52880,1,512,512,512.00,0.00,41722,41723
52881,1,512,512,512.00,0.00,41722,41723
52882,3,408,43,170.67,28217.56,41722,41725
52883,1,512,512,512.00,0.00,41724,41725
52884,1,512,512,512.00,0.00,41724,41725
52885,1,512,512,512.00,0.00,41724,41725
52886,4,381,2,128.00,23878.50,41724,41728
52887,4,185,4,128.00,5388.50,41727,41731
52888,1,512,512,512.00,0.00,41730,41731
52889,1,512,512,512.00,0.00,41730,41731
52890,2,446,66,256.00,36100.00,41730,41732
52891,4,284,14,128.00,12915.50,41731,41735
52892,2,352,160,256.00,9216.00,41734,41736
52893,1,512,512,512.00,0.00,41735,41736
52894,1,512,512,512.00,0.00,41735,41736
52895,2,448,64,256.00,36864.00,41735,41737
52896,1,512,512,512.00,0.00,41736,41737
52897,1,512,512,512.00,0.00,41736,41737
52898,1,512,512,512.00,0.00,41736,41737
52899,4,398,6,128.00,25566.00,41736,41740
52900,3,274,1,170.67,14621.56,41739,41742
52901,1,512,512,512.00,0.00,41741,41742
52902,4,286,23,128.00,12049.50,41741,41745
52903,2,391,121,256.00,18225.00,41744,41746
52904,2,314,198,256.00,3364.00,41745,41747
52905,1,512,512,512.00,0.00,41746,41747
52906,1,512,512,512.00,0.00,41746,41747
52907,1,512,512,512.00,0.00,41746,41747
52908,6,187,1,85.33,5452.89,41746,41752
52909,7,164,1,73.14,4438.12,41751,41758
52910,7,268,1,73.14,9840.98,41757,41764
52911,1,512,512,512.00,0.00,41763,41764
52912,1,512,512,512.00,0.00,41763,41764
52913,1,512,512,512.00,0.00,41763,41764
52914,2,259,253,256.00,9.00,41763,41765
52915,1,512,512,512.00,0.00,41764,41765
52916,6,282,7,85.33,8673.89,41764,41770
52917,1,512,512,512.00,0.00,41769,41770
52918,1,512,512,512.00,0.00,41769,41770
52919,2,444,68,256.00,35344.00,41769,41771
52920,9,235,1,56.89,6186.32,41770,41779
52921,1,512,512,512.00,0.00,41778,41779
52922,1,512,512,512.00,0.00,41778,41779
52923,1,512,512,512.00,0.00,41778,41779
52924,1,512,512,512.00,0.00,41778,41779
52925,1,512,512,512.00,0.00,41778,41779
52926,1,512,512,512.00,0.00,41779,41780
52927,1,512,512,512.00,0.00,41779,41780
52928,1,512,512,512.00,0.00,41779,41780
52929,1,512,512,512.00,0.00,41779,41780
52930,3,320,5,170.67,16670.89,41779,41782
52931,1,512,512,512.00,0.00,41781,41782
52932,3,388,48,170.67,23747.56,41781,41784
52933,1,512,512,512.00,0.00,41783,41784
52934,5,302,5,102.40,13250.64,41783,41788
52935,2,494,18,256.00,56644.00,41787,41789
52936,1,512,512,512.00,0.00,41788,41789
52937,1,512,512,512.00,0.00,41788,41789
52938,1,512,512,512.00,0.00,41788,41789
52939,1,512,512,512.00,0.00,41788,41789
52940,1,512,512,512.00,0.00,41788,41789
52941,1,512,512,512.00,0.00,41788,41789
52942,1,512,512,512.00,0.00,41788,41789
52943,2,386,126,256.00,16900.00,41788,41790
52944,1,512,512,512.00,0.00,41789,41790
52945,1,512,512,512.00,0.00,41789,41790
52946,1,512,512,512.00,0.00,41789,41790
52947,4,225,5,128.00,6259.50,41789,41793
52948,1,512,512,512.00,0.00,41792,41793
52949,1,512,512,512.00,0.00,41792,41793
52950,1,512,512,512.00,0.00,41792,41793
52951,1,512,512,512.00,0.00,41792,41793
52952,2,394,118,256.00,19044.00,41792,41794
52953,6,201,1,85.33,6781.56,41793,41799
52954,7,227,1,73.14,9153.55,41798,41805
52955,3,435,18,170.67,35216.22,41804,41807
52956,1,512,512,512.00,0.00,41806,41807
52957,3,260,43,170.67,8582.89,41806,41809
52958,1,512,512,512.00,0.00,41808,41809
52959,1,512,512,512.00,0.00,41808,41809
52960,2,505,7,256.00,62001.00,41808,41810
52961,2,384,128,256.00,16384.00,41809,41811
52962,1,512,512,512.00,0.00,41810,41811
52963,1,512,512,512.00,0.00,41810,41811
52964,5,278,4,102.40,14077.04,41810,41815
52965,1,512,512,512.00,0.00,41814,41815
52966,1,512,512,512.00,0.00,41814,41815
52967,1,512,512,512.00,0.00,41814,41815
52968,1,512,512,512.00,0.00,41814,41815
52969,1,512,512,512.00,0.00,41814,41815
52970,1,512,512,512.00,0.00,41814,41815
52971,1,512,512,512.00,0.00,41814,41815
52972,1,512,512,512.00,0.00,41814,41815
52973,3,492,2,170.67,51670.22,41814,41817
52974,3,468,1,170.67,44497.56,41816,41819
52975,1,512,512,512.00,0.00,41818,41819
52976,1,512,512,512.00,0.00,41818,41819
52977,1,512,512,512.00,0.00,41818,41819
52978,4,336,2,128.00,18590.00,41818,41822
52979,1,512,512,512.00,0.00,41821,41822
52980,3,327,1,170.67,17801.56,41821,41824
52981,3,344,21,170.67,17668.22,41823,41826
52982,1,512,512,512.00,0.00,41825,41826
52983,1,512,512,512.00,0.00,41825,41826
52984,2,259,253,256.00,9.00,41825,41827
52985,1,512,512,512.00,0.00,41826,41827
52986,1,512,512,512.00,0.00,41826,41827
52987,2,459,53,256.00,41209.00,41826,41828
52988,2,407,105,256.00,22801.00,41827,41829
52989,1,512,512,512.00,0.00,41828,41829
52990,1,512,512,512.00,0.00,41828,41829
52991,2,303,209,256.00,2209.00,41828,41830
52992,1,512,512,512.00,0.00,41829,41830
52993,1,512,512,512.00,0.00,41829,41830
52994,1,512,512,512.00,0.00,41829,41830
52995,2,367,145,256.00,12321.00,41829,41831
52996,2,443,69,256.00,34969.00,41830,41832
52997,1,512,512,512.00,0.00,41831,41832
52998,1,512,512,512.00,0.00,41831,41832
52999,1,512,512,512.00,0.00,41831,41832
53000,1,512,512,512.00,0.00,41831,41832
53001,1,512,512,512.00,0.00,41831,41832
53002,1,512,512,512.00,0.00,41831,41832
53003,1,512,512,512.00,0.00,41831,41832
53004,1,512,512,512.00,0.00,41831,41832
53005,2,415,97,256.00,25281.00,41831,41833
53006,1,512,512,512.00,0.00,41832,41833
53007,2,348,164,256.00,8464.00,41832,41834
53008,1,512,512,512.00,0.00,41833,41834
53009,1,512,512,512.00,0.00,41833,41834
53010,1,512,512,512.00,0.00,41833,41834
53011,1,512,512,512.00,0.00,41833,41834
53012,5,212,17,102.40,3985.04,41833,41838
53013,3,271,25,170.67,11113.56,41837,41840
53014,1,512,512,512.00,0.00,41839,41840
53015,1,512,512,512.00,0.00,41839,41840
53016,2,511,1,256.00,65025.00,41839,41841
53017,1,512,512,512.00,0.00,41840,41841
53018,1,512,512,512.00,0.00,41840,41841
53019,1,512,512,512.00,0.00,41840,41841
53020,1,512,512,512.00,0.00,41840,41841
53021,1,512,512,512.00,0.00,41840,41841
53022,1,512,512,512.00,0.00,41840,41841
53023,1,512,512,512.00,0.00,41840,41841
53024,1,512,512,512.00,0.00,41840,41841
53025,3,493,7,170.67,51953.56,41840,41843
53026,3,343,9,170.67,18649.56,41842,41845
53027,1,512,512,512.00,0.00,41844,41845
53028,1,512,512,512.00,0.00,41844,41845
53029,1,512,512,512.00,0.00,41844,41845
53030,1,512,512,512.00,0.00,41844,41845
53031,1,512,512,512.00,0.00,41844,41845
53032,2,292,220,256.00,1296.00,41844,41846
53033,1,512,512,512.00,0.00,41845,41846
53034,1,512,512,512.00,0.00,41845,41846
53035,15,119,1,34.13,1295.05,41845,41860
53036,1,512,512,512.00,0.00,41859,41860
53037,1,512,512,512.00,0.00,41859,41860
53038,1,512,512,512.00,0.00,41859,41860
53039,2,284,228,256.00,784.00,41859,41861
53040,2,369,143,256.00,12769.00,41860,41862
53041,4,245,28,128.00,6094.50,41861,41865
53042,1,512,512,512.00,0.00,41864,41865
53043,1,512,512,512.00,0.00,41864,41865
53044,1,512,512,512.00,0.00,41864,41865
53045,1,512,512,512.00,0.00,41864,41865
53046,4,300,62,128.00,9897.50,41864,41868
53047,1,512,512,512.00,0.00,41867,41868
53048,1,512,512,512.00,0.00,41867,41868
53049,1,512,512,512.00,0.00,41867,41868
53050,2,372,140,256.00,13456.00,41867,41869
53051,1,512,512,512.00,0.00,41868,41869
53052,2,439,73,256.00,33489.00,41868,41870
53053,2,265,247,256.00,81.00,41869,41871
53054,1,512,512,512.00,0.00,41870,41871
53055,1,512,512,512.00,0.00,41870,41871
53056,3,348,50,170.67,16406.22,41870,41873
53057,1,512,512,512.00,0.00,41872,41873
53058,1,512,512,512.00,0.00,41872,41873
53059,6,246,1,85.33,6717.56,41872,41878
53060,1,512,512,512.00,0.00,41877,41878
53061,5,473,3,102.40,34393.04,41877,41882
53062,4,283,23,128.00,10427.00,41881,41885
53063,1,512,512,512.00,0.00,41884,41885
53064,3,467,8,170.67,44046.89,41884,41887
53065,1,512,512,512.00,0.00,41886,41887
53066,1,512,512,512.00,0.00,41886,41887
53067,1,512,512,512.00,0.00,41886,41887
53068,1,512,512,512.00,0.00,41886,41887
53069,2,315,197,256.00,3481.00,41886,41888
53070,1,512,512,512.00,0.00,41887,41888
53071,1,512,512,512.00,0.00,41887,41888
53072,4,218,7,128.00,8016.50,41887,41891
53073,1,512,512,512.00,0.00,41890,41891
53074,5,219,2,102.40,7347.44,41890,41895
53075,1,512,512,512.00,0.00,41894,41895
53076,1,512,512,512.00,0.00,41894,41895
53077,3,358,8,170.67,20720.89,41894,41897
53078,5,315,7,102.40,12079.04,41896,41901
53079,1,512,512,512.00,0.00,41900,41901
53080,3,390,1,170.67,26453.56,41900,41903
53081,2,328,184,256.00,5184.00,41902,41904
53082,2,463,49,256.00,42849.00,41903,41905
53083,1,512,512,512.00,0.00,41904,41905
53084,1,512,512,512.00,0.00,41904,41905
53085,4,434,3,128.00,32005.50,41904,41908
53086,1,512,512,512.00,0.00,41907,41908
53087,2,396,116,256.00,19600.00,41907,41909
53088,1,512,512,512.00,0.00,41908,41909
53089,1,512,512,512.00,0.00,41908,41909
53090,3,278,2,170.67,14576.89,41908,41911
53091,2,258,254,256.00,4.00,41910,41912
53092,5,185,12,102.40,3358.64,41911,41916
53093,1,512,512,512.00,0.00,41915,41916
53094,3,382,2,170.67,24976.89,41915,41918
53095,2,493,19,256.00,56169.00,41917,41919
53096,1,512,512,512.00,0.00,41918,41919
53097,2,477,35,256.00,48841.00,41918,41920
53098,6,376,1,85.33,17418.56,41919,41925
53099,2,326,186,256.00,4900.00,41924,41926
53100,1,512,512,512.00,0.00,41925,41926
53101,4,150,79,128.00,840.50,41925,41929
53102,4,484,6,128.00,42262.00,41928,41932
53103,1,512,512,512.00,0.00,41931,41932
53104,1,512,512,512.00,0.00,41931,41932
53105,3,475,3,170.67,46469.56,41931,41934
53106,12,165,1,42.67,2121.56,41933,41945
53107,1,512,512,512.00,0.00,41944,41945
53108,1,512,512,512.00,0.00,41944,41945
53109,2,340,172,256.00,7056.00,41944,41946
53110,1,512,512,512.00,0.00,41945,41946
53111,2,374,138,256.00,13924.00,41945,41947
53112,2,487,25,256.00,53361.00,41946,41948
53113,1,512,512,512.00,0.00,41947,41948
53114,1,512,512,512.00,0.00,41947,41948
53115,8,200,2,64.00,4603.00,41947,41955
53116,5,493,2,102.40,38147.84,41954,41959
53117,1,512,512,512.00,0.00,41958,41959
53118,7,231,1,73.14,6402.12,41958,41965
53119,1,512,512,512.00,0.00,41964,41965
53120,1,512,512,512.00,0.00,41964,41965
53121,3,259,81,170.67,5281.56,41964,41967
53122,3,331,13,170.67,16857.56,41966,41969
53123,3,290,4,170.67,14752.89,41968,41971
53124,2,385,127,256.00,16641.00,41970,41972
53125,1,512,512,512.00,0.00,41971,41972
53126,1,512,512,512.00,0.00,41971,41972
53127,1,512,512,512.00,0.00,41971,41972
53128,1,512,512,512.00,0.00,41971,41972
53129,1,512,512,512.00,0.00,41971,41972
53130,1,512,512,512.00,0.00,41971,41972
53131,1,512,512,512.00,0.00,41971,41972
53132,1,512,512,512.00,0.00,41971,41972
53133,3,412,2,170.67,30656.89,41971,41974
53134,1,512,512,512.00,0.00,41973,41974
53135,1,512,512,512.00,0.00,41973,41974
53136,1,512,512,512.00,0.00,41973,41974
53137,1,512,512,512.00,0.00,41973,41974
53138,3,479,3,170.67,47656.22,41973,41976
53139,1,512,512,512.00,0.00,41975,41976
53140,1,512,512,512.00,0.00,41975,41976
53141,1,512,512,512.00,0.00,41975,41976
53142,5,357,10,102.40,17124.24,41975,41980
53143,2,480,32,256.00,50176.00,41979,41981
53144,1,512,512,512.00,0.00,41980,41981
53145,2,260,252,256.00,16.00,41980,41982
53146,4,263,21,128.00,8061.00,41981,41985
53147,1,512,512,512.00,0.00,41984,41985
53148,1,512,512,512.00,0.00,41984,41985
53149,1,512,512,512.00,0.00,41984,41985
53150,2,508,4,256.00,63504.00,41984,41986
53151,2,505,7,256.00,62001.00,41985,41987
53152,2,495,17,256.00,57121.00,41986,41988
53153,2,331,181,256.00,5625.00,41987,41989
53154,3,325,7,170.67,16897.56,41988,41991
53155,3,264,1,170.67,14441.56,41990,41993
53156,1,512,512,512.00,0.00,41992,41993
53157,1,512,512,512.00,0.00,41992,41993
53158,1,512,512,512.00,0.00,41992,41993
53159,5,305,1,102.40,11848.24,41992,41997
53160,5,441,2,102.40,28778.24,41996,42001
53161,1,512,512,512.00,0.00,42000,42001
53162,1,512,512,512.00,0.00,42000,42001
53163,2,504,8,256.00,61504.00,42000,42002
53164,4,461,2,128.00,37050.50,42001,42005
53165,1,512,512,512.00,0.00,42004,42005
53166,1,512,512,512.00,0.00,42004,42005
53167,1,512,512,512.00,0.00,42004,42005
53168,2,334,178,256.00,6084.00,42004,42006
53169,1,512,512,512.00,0.00,42005,42006
53170,1,512,512,512.00,0.00,42005,42006
53171,5,279,12,102.40,9553.44,42005,42010
53172,1,512,512,512.00,0.00,42009,42010
53173,1,512,512,512.00,0.00,42009,42010
53174,5,360,1,102.40,17302.24,42009,42014
53175,3,251,104,170.67,3694.89,42013,42016
53176,3,411,3,170.67,30384.22,42015,42018
53177,1,512,512,512.00,0.00,42017,42018
53178,1,512,512,512.00,0.00,42017,42018
53179,2,383,129,256.00,16129.00,42017,42019
53180,4,441,3,128.00,33266.50,42018,42022
53181,1,512,512,512.00,0.00,42021,42022
53182,1,512,512,512.00,0.00,42021,42022
53183,1,512,512,512.00,0.00,42021,42022
53184,1,512,512,512.00,0.00,42021,42022
53185,6,327,1,85.33,13776.89,42021,42027
53186,7,478,1,73.14,27339.84,42026,42033
53187,1,512,512,512.00,0.00,42032,42033
53188,7,310,2,73.14,12105.55,42032,42039
53189,3,277,70,170.67,7157.56,42038,42041
53190,3,458,7,170.67,41546.89,42040,42043
53191,3,299,21,170.67,13108.22,42042,42045
53192,4,248,23,128.00,7980.50,42044,42048
53193,1,512,512,512.00,0.00,42047,42048
53194,7,378,2,73.14,15790.98,42047,42054
53195,3,348,66,170.67,15894.22,42053,42056
53196,1,512,512,512.00,0.00,42055,42056
53197,1,512,512,512.00,0.00,42055,42056
53198,4,307,4,128.00,14062.50,42055,42059
53199,3,488,1,170.67,50430.89,42058,42061
53200,8,241,1,64.00,7090.25,42060,42068
53201,1,512,512,512.00,0.00,42067,42068
53202,3,267,22,170.67,11373.56,42067,42070
53203,1,512,512,512.00,0.00,42069,42070
53204,1,512,512,512.00,0.00,42069,42070
53205,1,512,512,512.00,0.00,42069,42070
53206,1,512,512,512.00,0.00,42069,42070
53207,3,358,6,170.67,20907.56,42069,42072
53208,1,512,512,512.00,0.00,42071,42072
53209,2,258,254,256.00,4.00,42071,42073
53210,1,512,512,512.00,0.00,42072,42073
53211,1,512,512,512.00,0.00,42072,42073
53212,2,319,193,256.00,3969.00,42072,42074
53213,1,512,512,512.00,0.00,42073,42074
53214,1,512,512,512.00,0.00,42073,42074
53215,2,312,200,256.00,3136.00,42073,42075
53216,1,512,512,512.00,0.00,42074,42075
53217,6,305,5,85.33,11832.22,42074,42080
53218,1,512,512,512.00,0.00,42079,42080
53219,1,512,512,512.00,0.00,42079,42080
53220,1,512,512,512.00,0.00,42079,42080
53221,1,512,512,512.00,0.00,42079,42080
53222,1,512,512,512.00,0.00,42079,42080
53223,1,512,512,512.00,0.00,42079,42080
53224,3,291,11,170.67,13840.22,42079,42082
53225,1,512,512,512.00,0.00,42081,42082
53226,1,512,512,512.00,0.00,42081,42082
53227,1,512,512,512.00,0.00,42081,42082
53228,2,271,241,256.00,225.00,42081,42083
53229,1,512,512,512.00,0.00,42082,42083
53230,2,462,50,256.00,42436.00,42082,42084
53231,1,512,512,512.00,0.00,42083,42084
53232,1,512,512,512.00,0.00,42083,42084
53233,1,512,512,512.00,0.00,42083,42084
53234,2,425,87,256.00,28561.00,42083,42085
53235,1,512,512,512.00,0.00,42084,42085
53236,1,512,512,512.00,0.00,42084,42085
53237,1,512,512,512.00,0.00,42084,42085
53238,2,297,215,256.00,1681.00,42084,42086
53239,2,435,77,256.00,32041.00,42085,42087
53240,1,512,512,512.00,0.00,42086,42087
53241,1,512,512,512.00,0.00,42086,42087
53242,4,250,2,128.00,10892.00,42086,42090
53243,1,512,512,512.00,0.00,42089,42090
53244,1,512,512,512.00,0.00,42089,42090
53245,3,305,1,170.67,16026.89,42089,42092
53246,2,437,75,256.00,32761.00,42091,42093
53247,1,512,512,512.00,0.00,42092,42093
53248,4,292,9,128.00,10923.50,42092,42096
53249,1,512,512,512.00,0.00,42095,42096
53250,2,289,223,256.00,1089.00,42095,42097
53251,1,512,512,512.00,0.00,42096,42097
53252,1,512,512,512.00,0.00,42096,42097
53253,2,428,84,256.00,29584.00,42096,42098
53254,1,512,512,512.00,0.00,42097,42098
53255,3,366,26,170.67,20550.22,42097,42100
53256,3,356,1,170.67,21126.89,42099,42102
53257,1,512,512,512.00,0.00,42101,42102
53258,1,512,512,512.00,0.00,42101,42102
53259,4,229,1,128.00,7351.50,42101,42105
53260,1,512,512,512.00,0.00,42104,42105
53261,1,512,512,512.00,0.00,42104,42105
53262,1,512,512,512.00,0.00,42104,42105
53263,1,512,512,512.00,0.00,42104,42105
53264,1,512,512,512.00,0.00,42104,42105
53265,1,512,512,512.00,0.00,42104,42105
53266,1,512,512,512.00,0.00,42104,42105
53267,1,512,512,512.00,0.00,42104,42105
53268,1,512,512,512.00,0.00,42104,42105
53269,3,227,62,170.67,5906.89,42104,42107
53270,1,512,512,512.00,0.00,42106,42107
53271,2,411,101,256.00,24025.00,42106,42108
53272,3,300,78,170.67,8886.22,42107,42110
53273,5,348,1,102.40,17110.24,42109,42114
53274,1,512,512,512.00,0.00,42113,42114
53275,2,408,104,256.00,23104.00,42113,42115
53276,3,419,8,170.67,31822.89,42114,42117
53277,4,193,28,128.00,4115.50,42116,42120
53278,4,365,41,128.00,18747.50,42119,42123
53279,1,512,512,512.00,0.00,42122,42123
53280,1,512,512,512.00,0.00,42122,42123
53281,3,496,1,170.67,52953.56,42122,42125
53282,1,512,512,512.00,0.00,42124,42125
53283,1,512,512,512.00,0.00,42124,42125
53284,1,512,512,512.00,0.00,42124,42125
53285,1,512,512,512.00,0.00,42124,42125
53286,2,373,139,256.00,13689.00,42124,42126
53287,1,512,512,512.00,0.00,42125,42126
53288,2,257,255,256.00,1.00,42125,42127
53289,2,487,25,256.00,53361.00,42126,42128
53290,1,512,512,512.00,0.00,42127,42128
53291,3,489,6,170.67,50688.22,42127,42130
53292,3,326,4,170.67,17344.89,42129,42132
53293,2,297,215,256.00,1681.00,42131,42133
53294,1,512,512,512.00,0.00,42132,42133
53295,1,512,512,512.00,0.00,42132,42133
53296,2,358,154,256.00,10404.00,42132,42134
53297,1,512,512,512.00,0.00,42133,42134
53298,4,246,1,128.00,11894.50,42133,42137
53299,4,291,1,128.00,13014.50,42136,42140
53300,1,512,512,512.00,0.00,42139,42140
53301,3,313,56,170.67,11390.89,42139,42142
53302,1,512,512,512.00,0.00,42141,42142
53303,1,512,512,512.00,0.00,42141,42142
53304,5,273,1,102.40,9118.64,42141,42146
53305,1,512,512,512.00,0.00,42145,42146
53306,1,512,512,512.00,0.00,42145,42146
53307,1,512,512,512.00,0.00,42145,42146
53308,1,512,512,512.00,0.00,42145,42146
53309,1,512,512,512.00,0.00,42145,42146
53310,1,512,512,512.00,0.00,42145,42146
53311,6,422,2,85.33,22837.89,42145,42151
53312,2,495,17,256.00,57121.00,42150,42152
53313,1,512,512,512.00,0.00,42151,42152
53314,1,512,512,512.00,0.00,42151,42152
53315,4,323,1,128.00,16428.50,42151,42155
53316,1,512,512,512.00,0.00,42154,42155
53317,4,393,1,128.00,24617.00,42154,42158
53318,1,512,512,512.00,0.00,42157,42158
53319,1,512,512,512.00,0.00,42157,42158
53320,1,512,512,512.00,0.00,42157,42158
53321,3,304,3,170.67,15689.56,42157,42160
53322,1,512,512,512.00,0.00,42159,42160
53323,1,512,512,512.00,0.00,42159,42160
53324,3,445,25,170.67,37677.56,42159,42162
53325,4,447,10,128.00,33999.50,42161,42165
53326,7,161,4,73.14,3764.98,42164,42171
53327,1,512,512,512.00,0.00,42170,42171
53328,3,317,62,170.67,11546.89,42170,42173
53329,1,512,512,512.00,0.00,42172,42173
53330,1,512,512,512.00,0.00,42172,42173
53331,1,512,512,512.00,0.00,42172,42173
53332,1,512,512,512.00,0.00,42172,42173
53333,1,512,512,512.00,0.00,42172,42173
53334,2,336,176,256.00,6400.00,42172,42174
53335,4,227,33,128.00,5549.00,42173,42177
53336,3,489,7,170.67,50681.56,42176,42179
53337,10,150,1,51.20,2890.36,42178,42188
53338,2,365,147,256.00,11881.00,42187,42189
53339,4,295,10,128.00,12964.50,42188,42192
53340,1,512,512,512.00,0.00,42191,42192
53341,4,283,19,128.00,10699.00,42191,42195
53342,4,423,1,128.00,29894.50,42194,42198
53343,1,512,512,512.00,0.00,42197,42198
53344,1,512,512,512.00,0.00,42197,42198
53345,1,512,512,512.00,0.00,42197,42198
53346,1,512,512,512.00,0.00,42197,42198
53347,2,357,155,256.00,10201.00,42197,42199
53348,2,403,109,256.00,21609.00,42198,42200
53349,1,512,512,512.00,0.00,42199,42200
53350,1,512,512,512.00,0.00,42199,42200
53351,1,512,512,512.00,0.00,42199,42200
53352,4,330,18,128.00,14504.50,42199,42203
53353,1,512,512,512.00,0.00,42202,42203
53354,1,512,512,512.00,0.00,42202,42203
53355,1,512,512,512.00,0.00,42202,42203
53356,3,478,13,170.67,47237.56,42202,42205
53357,3,424,2,170.67,33264.89,42204,42207
53358,1,512,512,512.00,0.00,42206,42207
53359,2,415,97,256.00,25281.00,42206,42208
53360,2,383,129,256.00,16129.00,42207,42209
53361,1,512,512,512.00,0.00,42208,42209
53362,1,512,512,512.00,0.00,42208,42209
53363,1,512,512,512.00,0.00,42208,42209
53364,5,223,3,102.40,7435.84,42208,42213
53365,4,252,4,128.00,7706.00,42212,42216
53366,2,276,236,256.00,400.00,42215,42217
53367,1,512,512,512.00,0.00,42216,42217
53368,1,512,512,512.00,0.00,42216,42217
53369,6,390,1,85.33,19379.22,42216,42222
53370,1,512,512,512.00,0.00,42221,42222
53371,1,512,512,512.00,0.00,42221,42222
53372,3,432,8,170.67,34830.22,42221,42224
53373,6,391,2,85.33,19336.22,42223,42229
53374,3,428,1,170.67,34230.89,42228,42231
53375,3,354,25,170.67,18749.56,42230,42233
53376,5,339,1,102.40,15425.44,42232,42237
53377,1,512,512,512.00,0.00,42236,42237
53378,1,512,512,512.00,0.00,42236,42237
53379,1,512,512,512.00,0.00,42236,42237
53380,2,386,126,256.00,16900.00,42236,42238
53381,1,512,512,512.00,0.00,42237,42238
53382,3,481,1,170.67,48293.56,42237,42240
53383,3,379,2,170.67,24474.89,42239,42242
53384,1,512,512,512.00,0.00,42241,42242
53385,1,512,512,512.00,0.00,42241,42242
53386,2,491,21,256.00,55225.00,42241,42243
53387,1,512,512,512.00,0.00,42242,42243
53388,1,512,512,512.00,0.00,42242,42243
53389,2,278,234,256.00,484.00,42242,42244
53390,2,285,227,256.00,841.00,42243,42245
53391,3,460,2,170.67,42240.89,42244,42247
53392,1,512,512,512.00,0.00,42246,42247
53393,6,231,6,85.33,7341.22,42246,42252
53394,1,512,512,512.00,0.00,42251,42252
53395,4,434,1,128.00,31467.50,42251,42255
53396,1,512,512,512.00,0.00,42254,42255
53397,6,460,1,85.33,28271.56,42254,42260
53398,1,512,512,512.00,0.00,42259,42260
53399,1,512,512,512.00,0.00,42259,42260
53400,2,462,50,256.00,42436.00,42259,42261
53401,1,512,512,512.00,0.00,42260,42261
53402,1,512,512,512.00,0.00,42260,42261
53403,1,512,512,512.00,0.00,42260,42261
53404,4,183,3,128.00,5275.00,42260,42264
53405,1,512,512,512.00,0.00,42263,42264
53406,1,512,512,512.00,0.00,42263,42264
53407,4,328,7,128.00,16456.50,42263,42267
53408,4,373,2,128.00,21525.50,42266,42270
53409,1,512,512,512.00,0.00,42269,42270
53410,1,512,512,512.00,0.00,42269,42270
53411,1,512,512,512.00,0.00,42269,42270
53412,1,512,512,512.00,0.00,42269,42270
53413,2,341,171,256.00,7225.00,42269,42271
53414,1,512,512,512.00,0.00,42270,42271
53415,1,512,512,512.00,0.00,42270,42271
53416,1,512,512,512.00,0.00,42270,42271
53417,2,428,84,256.00,29584.00,42270,42272
53418,3,300,51,170.67,10380.22,42271,42274
53419,1,512,512,512.00,0.00,42273,42274
53420,1,512,512,512.00,0.00,42273,42274
53421,2,471,41,256.00,46225.00,42273,42275
53422,1,512,512,512.00,0.00,42274,42275
53423,3,461,2,170.67,42514.89,42274,42277
53424,1,512,512,512.00,0.00,42276,42277
53425,2,431,81,256.00,30625.00,42276,42278
53426,1,512,512,512.00,0.00,42277,42278
53427,1,512,512,512.00,0.00,42277,42278
53428,1,512,512,512.00,0.00,42277,42278
53429,1,512,512,512.00,0.00,42277,42278
53430,1,512,512,512.00,0.00,42277,42278
53431,1,512,512,512.00,0.00,42277,42278
53432,1,512,512,512.00,0.00,42277,42278
53433,1,512,512,512.00,0.00,42277,42278
53434,1,512,512,512.00,0.00,42277,42278
53435,3,272,47,170.67,8686.89,42277,42280
53436,1,512,512,512.00,0.00,42279,42280
53437,1,512,512,512.00,0.00,42279,42280
53438,3,289,107,170.67,7014.89,42279,42282
53439,3,464,2,170.67,43344.89,42281,42284
53440,1,512,512,512.00,0.00,42283,42284
53441,1,512,512,512.00,0.00,42283,42284
53442,1,512,512,512.00,0.00,42283,42284
53443,1,512,512,512.00,0.00,42283,42284
53444,2,354,158,256.00,9604.00,42283,42285
53445,1,512,512,512.00,0.00,42284,42285
53446,5,323,7,102.40,14684.64,42284,42289
53447,3,364,57,170.67,18881.56,42288,42291
53448,1,512,512,512.00,0.00,42290,42291
53449,1,512,512,512.00,0.00,42290,42291
53450,1,512,512,512.00,0.00,42290,42291
53451,1,512,512,512.00,0.00,42290,42291
53452,2,355,157,256.00,9801.00,42290,42292
53453,1,512,512,512.00,0.00,42291,42292
53454,1,512,512,512.00,0.00,42291,42292
53455,2,385,127,256.00,16641.00,42291,42293
53456,2,428,84,256.00,29584.00,42292,42294
53457,1,512,512,512.00,0.00,42293,42294
53458,1,512,512,512.00,0.00,42293,42294
53459,2,355,157,256.00,9801.00,42293,42295
53460,3,379,2,170.67,24474.89,42294,42297
53461,3,254,55,170.67,7122.89,42296,42299
53462,1,512,512,512.00,0.00,42298,42299
53463,2,420,92,256.00,26896.00,42298,42300
53464,1,512,512,512.00,0.00,42299,42300
53465,1,512,512,512.00,0.00,42299,42300
53466,1,512,512,512.00,0.00,42299,42300
53467,1,512,512,512.00,0.00,42299,42300
53468,2,360,152,256.00,10816.00,42299,42301
53469,2,466,46,256.00,44100.00,42300,42302
53470,5,384,2,102.40,20528.24,42301,42306
53471,1,512,512,512.00,0.00,42305,42306
53472,5,296,1,102.40,10929.44,42305,42310
53473,3,417,10,170.67,31277.56,42309,42312
53474,1,512,512,512.00,0.00,42311,42312
53475,2,397,115,256.00,19881.00,42311,42313
53476,2,498,14,256.00,58564.00,42312,42314
53477,9,131,1,56.89,2455.43,42313,42322
53478,1,512,512,512.00,0.00,42321,42322
53479,1,512,512,512.00,0.00,42321,42322
53480,1,512,512,512.00,0.00,42321,42322
53481,1,512,512,512.00,0.00,42321,42322
53482,1,512,512,512.00,0.00,42321,42322
53483,3,477,2,170.67,47080.22,42321,42324
53484,2,486,26,256.00,52900.00,42323,42325
53485,3,357,8,170.67,20580.22,42324,42327
53486,1,512,512,512.00,0.00,42326,42327
53487,1,512,512,512.00,0.00,42326,42327
53488,1,512,512,512.00,0.00,42326,42327
53489,1,512,512,512.00,0.00,42326,42327
53490,1,512,512,512.00,0.00,42326,42327
53491,1,512,512,512.00,0.00,42326,42327
53492,1,512,512,512.00,0.00,42326,42327
53493,3,313,1,170.67,16597.56,42326,42329
53494,2,406,106,256.00,22500.00,42328,42330
53495,1,512,512,512.00,0.00,42329,42330
53496,1,512,512,512.00,0.00,42329,42330
53497,3,436,2,170.67,36064.89,42329,42332
53498,1,512,512,512.00,0.00,42331,42332
53499,1,512,512,512.00,0.00,42331,42332
53500,1,512,512,512.00,0.00,42331,42332
53501,1,512,512,512.00,0.00,42331,42332
53502,1,512,512,512.00,0.00,42331,42332
53503,1,512,512,512.00,0.00,42331,42332
53504,1,512,512,512.00,0.00,42331,42332
53505,4,429,3,128.00,30878.50,42331,42335
53506,2,342,170,256.00,7396.00,42334,42336
53507,3,314,46,170.67,12144.89,42335,42338
53508,1,512,512,512.00,0.00,42337,42338
53509,1,512,512,512.00,0.00,42337,42338
53510,1,512,512,512.00,0.00,42337,42338
53511,1,512,512,512.00,0.00,42337,42338
53512,1,512,512,512.00,0.00,42337,42338
53513,2,339,173,256.00,6889.00,42337,42339
53514,1,512,512,512.00,0.00,42338,42339
53515,3,356,16,170.67,19736.89,42338,42341
53516,7,230,1,73.14,7587.27,42340,42347
53517,1,512,512,512.00,0.00,42346,42347
53518,1,512,512,512.00,0.00,42346,42347
53519,2,420,92,256.00,26896.00,42346,42348
53520,2,461,51,256.00,42025.00,42347,42349
53521,1,512,512,512.00,0.00,42348,42349
53522,1,512,512,512.00,0.00,42348,42349
53523,1,512,512,512.00,0.00,42348,42349
53524,2,464,48,256.00,43264.00,42348,42350
53525,1,512,512,512.00,0.00,42349,42350
53526,2,322,190,256.00,4356.00,42349,42351
53527,4,321,16,128.00,14349.50,42350,42354
53528,1,512,512,512.00,0.00,42353,42354
53529,1,512,512,512.00,0.00,42353,42354
53530,1,512,512,512.00,0.00,42353,42354
53531,1,512,512,512.00,0.00,42353,42354
53532,2,259,253,256.00,9.00,42353,42355
53533,1,512,512,512.00,0.00,42354,42355
53534,2,502,10,256.00,60516.00,42354,42356
53535,1,512,512,512.00,0.00,42355,42356
53536,1,512,512,512.00,0.00,42355,42356
53537,1,512,512,512.00,0.00,42355,42356
53538,1,512,512,512.00,0.00,42355,42356
53539,3,210,117,170.67,1544.22,42355,42358
53540,1,512,512,512.00,0.00,42357,42358
53541,1,512,512,512.00,0.00,42357,42358
53542,1,512,512,512.00,0.00,42357,42358
53543,2,303,209,256.00,2209.00,42357,42359
53544,1,512,512,512.00,0.00,42358,42359
53545,2,468,44,256.00,44944.00,42358,42360
53546,2,432,80,256.00,30976.00,42359,42361
53547,3,231,112,170.67,2361.56,42360,42363
53548,2,507,5,256.00,63001.00,42362,42364
53549,2,364,148,256.00,11664.00,42363,42365
53550,1,512,512,512.00,0.00,42364,42365
53551,1,512,512,512.00,0.00,42364,42365
53552,1,512,512,512.00,0.00,42364,42365
53553,3,270,15,170.67,12424.22,42364,42367
53554,2,333,179,256.00,5929.00,42366,42368
53555,2,507,5,256.00,63001.00,42367,42369
53556,1,512,512,512.00,0.00,42368,42369
53557,1,512,512,512.00,0.00,42368,42369
53558,1,512,512,512.00,0.00,42368,42369
53559,3,460,2,170.67,42240.89,42368,42371
53560,1,512,512,512.00,0.00,42370,42371
53561,3,303,37,170.67,11793.56,42370,42373
53562,2,299,213,256.00,1849.00,42372,42374
53563,1,512,512,512.00,0.00,42373,42374
53564,1,512,512,512.00,0.00,42373,42374
53565,1,512,512,512.00,0.00,42373,42374
53566,3,479,12,170.67,47548.22,42373,42376
53567,1,512,512,512.00,0.00,42375,42376
53568,1,512,512,512.00,0.00,42375,42376
53569,2,450,62,256.00,37636.00,42375,42377
53570,1,512,512,512.00,0.00,42376,42377
53571,1,512,512,512.00,0.00,42376,42377
53572,2,275,237,256.00,361.00,42376,42378
53573,1,512,512,512.00,0.00,42377,42378
53574,1,512,512,512.00,0.00,42377,42378
53575,2,462,50,256.00,42436.00,42377,42379
53576,1,512,512,512.00,0.00,42378,42379
53577,1,512,512,512.00,0.00,42378,42379
53578,1,512,512,512.00,0.00,42378,42379
53579,2,385,127,256.00,16641.00,42378,42380
53580,3,365,33,170.67,19976.22,42379,42382
53581,1,512,512,512.00,0.00,42381,42382
53582,2,278,234,256.00,484.00,42381,42383
53583,1,512,512,512.00,0.00,42382,42383
53584,1,512,512,512.00,0.00,42382,42383
53585,1,512,512,512.00,0.00,42382,42383
53586,2,280,232,256.00,576.00,42382,42384
53587,1,512,512,512.00,0.00,42383,42384
53588,2,398,114,256.00,20164.00,42383,42385
53589,1,512,512,512.00,0.00,42384,42385
53590,1,512,512,512.00,0.00,42384,42385
53591,2,465,47,256.00,43681.00,42384,42386
53592,2,425,87,256.00,28561.00,42385,42387
53593,2,269,243,256.00,169.00,42386,42388
53594,1,512,512,512.00,0.00,42387,42388
53595,1,512,512,512.00,0.00,42387,42388
53596,1,512,512,512.00,0.00,42387,42388
53597,3,302,63,170.67,9800.22,42387,42390
53598,1,512,512,512.00,0.00,42389,42390
53599,2,508,4,256.00,63504.00,42389,42391
53600,1,512,512,512.00,0.00,42390,42391
53601,2,327,185,256.00,5041.00,42390,42392
53602,1,512,512,512.00,0.00,42391,42392
53603,1,512,512,512.00,0.00,42391,42392
53604,1,512,512,512.00,0.00,42391,42392
53605,1,512,512,512.00,0.00,42391,42392
53606,4,298,2,128.00,11980.50,42391,42395
53607,3,315,51,170.67,11920.22,42394,42397
53608,1,512,512,512.00,0.00,42396,42397
53609,1,512,512,512.00,0.00,42396,42397
53610,2,296,216,256.00,1600.00,42396,42398
53611,2,466,46,256.00,44100.00,42397,42399
53612,1,512,512,512.00,0.00,42398,42399
53613,1,512,512,512.00,0.00,42398,42399
53614,4,278,1,128.00,9913.50,42398,42402
53615,1,512,512,512.00,0.00,42401,42402
53616,1,512,512,512.00,0.00,42401,42402
53617,2,359,153,256.00,10609.00,42401,42403
53618,1,512,512,512.00,0.00,42402,42403
53619,1,512,512,512.00,0.00,42402,42403
53620,1,512,512,512.00,0.00,42402,42403
53621,3,382,45,170.67,22597.56,42402,42405
53622,1,512,512,512.00,0.00,42404,42405
53623,1,512,512,512.00,0.00,42404,42405
53624,2,261,251,256.00,25.00,42404,42406
53625,1,512,512,512.00,0.00,42405,42406
53626,2,458,54,256.00,40804.00,42405,42407
53627,1,512,512,512.00,0.00,42406,42407
53628,1,512,512,512.00,0.00,42406,42407
53629,1,512,512,512.00,0.00,42406,42407
53630,1,512,512,512.00,0.00,42406,42407
53631,2,473,39,256.00,47089.00,42406,42408
53632,1,512,512,512.00,0.00,42407,42408
53633,2,371,141,256.00,13225.00,42407,42409
53634,1,512,512,512.00,0.00,42408,42409
53635,1,512,512,512.00,0.00,42408,42409
53636,1,512,512,512.00,0.00,42408,42409
53637,1,512,512,512.00,0.00,42408,42409
53638,4,420,1,128.00,29654.50,42408,42412
53639,2,428,84,256.00,29584.00,42411,42413
53640,2,491,21,256.00,55225.00,42412,42414
53641,1,512,512,512.00,0.00,42413,42414
53642,3,330,39,170.67,14496.22,42413,42416
53643,1,512,512,512.00,0.00,42415,42416
53644,2,462,50,256.00,42436.00,42415,42417
53645,3,348,1,170.67,20097.56,42416,42419
53646,1,512,512,512.00,0.00,42418,42419
53647,2,489,23,256.00,54289.00,42418,42420
53648,3,280,66,170.67,7643.56,42419,42422
53649,1,512,512,512.00,0.00,42421,42422
53650,1,512,512,512.00,0.00,42421,42422
53651,4,321,8,128.00,16063.50,42421,42425
53652,1,512,512,512.00,0.00,42424,42425
53653,1,512,512,512.00,0.00,42424,42425
53654,2,330,182,256.00,5476.00,42424,42426
53655,2,410,102,256.00,23716.00,42425,42427
53656,1,512,512,512.00,0.00,42426,42427
53657,3,332,74,170.67,13184.89,42426,42429
53658,1,512,512,512.00,0.00,42428,42429
53659,1,512,512,512.00,0.00,42428,42429
53660,2,343,169,256.00,7569.00,42428,42430
53661,2,327,185,256.00,5041.00,42429,42431
53662,1,512,512,512.00,0.00,42430,42431
53663,1,512,512,512.00,0.00,42430,42431
53664,2,477,35,256.00,48841.00,42430,42432
53665,3,389,58,170.67,23842.89,42431,42434
53666,1,512,512,512.00,0.00,42433,42434
53667,1,512,512,512.00,0.00,42433,42434
53668,1,512,512,512.00,0.00,42433,42434
53669,3,350,1,170.67,20346.89,42433,42436
53670,1,512,512,512.00,0.00,42435,42436
53671,1,512,512,512.00,0.00,42435,42436
53672,4,226,46,128.00,6226.50,42435,42439
53673,2,469,43,256.00,45369.00,42438,42440
53674,4,450,1,128.00,35141.50,42439,42443
53675,1,512,512,512.00,0.00,42442,42443
53676,4,313,25,128.00,13201.00,42442,42446
53677,3,405,15,170.67,28444.22,42445,42448
53678,2,284,228,256.00,784.00,42447,42449
53679,1,512,512,512.00,0.00,42448,42449
53680,3,253,40,170.67,8729.56,42448,42451
53681,6,323,3,85.33,13245.56,42450,42456
53682,1,512,512,512.00,0.00,42455,42456
53683,1,512,512,512.00,0.00,42455,42456
53684,1,512,512,512.00,0.00,42455,42456
53685,1,512,512,512.00,0.00,42455,42456
53686,2,338,174,256.00,6724.00,42455,42457
53687,1,512,512,512.00,0.00,42456,42457
53688,3,290,2,170.67,15040.89,42456,42459
53689,1,512,512,512.00,0.00,42458,42459
53690,1,512,512,512.00,0.00,42458,42459
53691,1,512,512,512.00,0.00,42458,42459
53692,6,302,1,85.33,10992.22,42458,42464
53693,1,512,512,512.00,0.00,42463,42464
53694,2,452,60,256.00,38416.00,42463,42465
53695,1,512,512,512.00,0.00,42464,42465
53696,2,422,90,256.00,27556.00,42464,42466
53697,1,512,512,512.00,0.00,42465,42466
53698,2,428,84,256.00,29584.00,42465,42467
53699,1,512,512,512.00,0.00,42466,42467
53700,3,300,45,170.67,10844.22,42466,42469
53701,1,512,512,512.00,0.00,42468,42469
53702,1,512,512,512.00,0.00,42468,42469
53703,1,512,512,512.00,0.00,42468,42469
53704,1,512,512,512.00,0.00,42468,42469
53705,1,512,512,512.00,0.00,42468,42469
53706,3,258,41,170.67,8744.22,42468,42471
53707,2,446,66,256.00,36100.00,42470,42472
53708,2,427,85,256.00,29241.00,42471,42473
53709,1,512,512,512.00,0.00,42472,42473
53710,4,420,1,128.00,29741.50,42472,42476
53711,2,420,92,256.00,26896.00,42475,42477
53712,1,512,512,512.00,0.00,42476,42477
53713,1,512,512,512.00,0.00,42476,42477
53714,2,493,19,256.00,56169.00,42476,42478
53715,5,197,1,102.40,6823.84,42477,42482
53716,1,512,512,512.00,0.00,42481,42482
53717,1,512,512,512.00,0.00,42481,42482
53718,2,443,69,256.00,34969.00,42481,42483
53719,1,512,512,512.00,0.00,42482,42483
53720,4,389,7,128.00,23253.00,42482,42486
53721,4,338,12,128.00,16898.00,42485,42489
53722,1,512,512,512.00,0.00,42488,42489
53723,1,512,512,512.00,0.00,42488,42489
53724,1,512,512,512.00,0.00,42488,42489
53725,5,313,1,102.40,15624.24,42488,42493
53726,1,512,512,512.00,0.00,42492,42493
53727,1,512,512,512.00,0.00,42492,42493
53728,1,512,512,512.00,0.00,42492,42493
53729,2,302,210,256.00,2116.00,42492,42494
53730,7,187,1,73.14,5647.27,42493,42500
53731,1,512,512,512.00,0.00,42499,42500
53732,2,338,174,256.00,6724.00,42499,42501
53733,1,512,512,512.00,0.00,42500,42501
53734,4,338,1,128.00,18619.50,42500,42504
53735,1,512,512,512.00,0.00,42503,42504
53736,1,512,512,512.00,0.00,42503,42504
53737,1,512,512,512.00,0.00,42503,42504
53738,1,512,512,512.00,0.00,42503,42504
53739,1,512,512,512.00,0.00,42503,42504
53740,1,512,512,512.00,0.00,42503,42504
53741,1,512,512,512.00,0.00,42503,42504
53742,1,512,512,512.00,0.00,42503,42504
53743,1,512,512,512.00,0.00,42503,42504
53744,2,315,197,256.00,3481.00,42503,42505
53745,3,441,10,170.67,36973.56,42504,42507
53746,1,512,512,512.00,0.00,42506,42507
53747,1,512,512,512.00,0.00,42506,42507
53748,2,267,245,256.00,121.00,42506,42508
53749,4,395,1,128.00,25505.00,42507,42511
53750,2,274,238,256.00,324.00,42510,42512
53751,1,512,512,512.00,0.00,42511,42512
53752,2,494,18,256.00,56644.00,42511,42513
53753,9,151,1,56.89,2876.99,42512,42521
53754,1,512,512,512.00,0.00,42520,42521
53755,3,425,3,170.67,33436.22,42520,42523
53756,1,512,512,512.00,0.00,42522,42523
53757,1,512,512,512.00,0.00,42522,42523
53758,1,512,512,512.00,0.00,42522,42523
53759,2,339,173,256.00,6889.00,42522,42524
53760,1,512,512,512.00,0.00,42523,42524
53761,1,512,512,512.00,0.00,42523,42524
53762,4,231,29,128.00,9065.00,42523,42527
53763,4,381,1,128.00,22741.00,42526,42530
53764,1,512,512,512.00,0.00,42529,42530
53765,1,512,512,512.00,0.00,42529,42530
53766,3,254,5,170.67,13722.89,42529,42532
53767,2,327,185,256.00,5041.00,42531,42533
53768,1,512,512,512.00,0.00,42532,42533
53769,2,492,20,256.00,55696.00,42532,42534
53770,1,512,512,512.00,0.00,42533,42534
53771,1,512,512,512.00,0.00,42533,42534
53772,2,479,33,256.00,49729.00,42533,42535
53773,1,512,512,512.00,0.00,42534,42535
53774,1,512,512,512.00,0.00,42534,42535
53775,1,512,512,512.00,0.00,42534,42535
53776,1,512,512,512.00,0.00,42534,42535
53777,2,281,231,256.00,625.00,42534,42536
53778,1,512,512,512.00,0.00,42535,42536
53779,1,512,512,512.00,0.00,42535,42536
53780,1,512,512,512.00,0.00,42535,42536
53781,9,173,1,56.89,2776.32,42535,42544
53782,2,345,167,256.00,7921.00,42543,42545
53783,6,186,2,85.33,5748.56,42544,42550
53784,2,305,207,256.00,2401.00,42549,42551
53785,3,435,4,170.67,35729.56,42550,42553
53786,4,298,54,128.00,9750.50,42552,42556
53787,1,512,512,512.00,0.00,42555,42556
53788,1,512,512,512.00,0.00,42555,42556
53789,1,512,512,512.00,0.00,42555,42556
53790,1,512,512,512.00,0.00,42555,42556
53791,9,128,3,56.89,1324.99,42555,42564
53792,1,512,512,512.00,0.00,42563,42564
53793,1,512,512,512.00,0.00,42563,42564
53794,1,512,512,512.00,0.00,42563,42564
53795,4,240,25,128.00,5843.50,42563,42567
53796,1,512,512,512.00,0.00,42566,42567
53797,1,512,512,512.00,0.00,42566,42567
53798,1,512,512,512.00,0.00,42566,42567
53799,2,487,25,256.00,53361.00,42566,42568
53800,1,512,512,512.00,0.00,42567,42568
53801,1,512,512,512.00,0.00,42567,42568
53802,4,246,2,128.00,7542.50,42567,42571
53803,1,512,512,512.00,0.00,42570,42571
53804,1,512,512,512.00,0.00,42570,42571
53805,1,512,512,512.00,0.00,42570,42571
53806,7,283,3,73.14,7984.69,42570,42577
53807,1,512,512,512.00,0.00,42576,42577
53808,1,512,512,512.00,0.00,42576,42577
53809,1,512,512,512.00,0.00,42576,42577
53810,1,512,512,512.00,0.00,42576,42577
53811,1,512,512,512.00,0.00,42576,42577
53812,1,512,512,512.00,0.00,42576,42577
53813,4,189,1,128.00,5519.50,42576,42580
53814,2,425,87,256.00,28561.00,42579,42581
53815,2,408,104,256.00,23104.00,42580,42582
53816,3,434,30,170.67,34726.22,42581,42584
53817,2,361,151,256.00,11025.00,42583,42585
53818,14,186,1,36.57,2302.67,42584,42598
53819,3,450,1,170.67,39613.56,42597,42600
53820,4,233,43,128.00,4637.00,42599,42603
53821,1,512,512,512.00,0.00,42602,42603
53822,2,350,162,256.00,8836.00,42602,42604
53823,1,512,512,512.00,0.00,42603,42604
53824,1,512,512,512.00,0.00,42603,42604
53825,1,512,512,512.00,0.00,42603,42604
53826,1,512,512,512.00,0.00,42603,42604
53827,1,512,512,512.00,0.00,42603,42604
53828,3,258,3,170.67,14064.22,42603,42606
53829,1,512,512,512.00,0.00,42605,42606
53830,1,512,512,512.00,0.00,42605,42606
53831,1,512,512,512.00,0.00,42605,42606
53832,3,268,43,170.67,8897.56,42605,42608
53833,8,280,2,64.00,8478.75,42607,42615
53834,1,512,512,512.00,0.00,42614,42615
53835,1,512,512,512.00,0.00,42614,42615
53836,1,512,512,512.00,0.00,42614,42615
53837,1,512,512,512.00,0.00,42614,42615
53838,3,489,1,170.67,50741.56,42614,42617
53839,1,512,512,512.00,0.00,42616,42617
53840,6,366,1,85.33,16502.22,42616,42622
53841,2,508,4,256.00,63504.00,42621,42623
53842,1,512,512,512.00,0.00,42622,42623
53843,1,512,512,512.00,0.00,42622,42623
53844,1,512,512,512.00,0.00,42622,42623
53845,1,512,512,512.00,0.00,42622,42623
53846,2,323,189,256.00,4489.00,42622,42624
53847,5,203,5,102.40,4662.24,42623,42628
53848,2,387,125,256.00,17161.00,42627,42629
53849,2,494,18,256.00,56644.00,42628,42630
53850,2,504,8,256.00,61504.00,42629,42631
53851,4,304,2,128.00,16926.00,42630,42634
53852,2,467,45,256.00,44521.00,42633,42635
53853,1,512,512,512.00,0.00,42634,42635
53854,3,494,4,170.67,52288.89,42634,42637
53855,1,512,512,512.00,0.00,42636,42637
53856,1,512,512,512.00,0.00,42636,42637
53857,4,410,23,128.00,26589.50,42636,42640
53858,1,512,512,512.00,0.00,42639,42640
53859,1,512,512,512.00,0.00,42639,42640
53860,1,512,512,512.00,0.00,42639,42640
53861,1,512,512,512.00,0.00,42639,42640
53862,3,328,46,170.67,13787.56,42639,42642
53863,1,512,512,512.00,0.00,42641,42642
53864,1,512,512,512.00,0.00,42641,42642
53865,1,512,512,512.00,0.00,42641,42642
53866,4,226,43,128.00,4663.50,42641,42645
53867,3,274,2,170.67,14464.89,42644,42647
53868,5,306,3,102.40,12318.64,42646,42651
53869,1,512,512,512.00,0.00,42650,42651
53870,1,512,512,512.00,0.00,42650,42651
53871,1,512,512,512.00,0.00,42650,42651
53872,1,512,512,512.00,0.00,42650,42651
53873,3,284,36,170.67,10478.22,42650,42653
53874,1,512,512,512.00,0.00,42652,42653
53875,1,512,512,512.00,0.00,42652,42653
53876,1,512,512,512.00,0.00,42652,42653
53877,2,373,139,256.00,13689.00,42652,42654
53878,3,291,5,170.67,14660.22,42653,42656
53879,1,512,512,512.00,0.00,42655,42656
53880,1,512,512,512.00,0.00,42655,42656
53881,2,472,40,256.00,46656.00,42655,42657
53882,1,512,512,512.00,0.00,42656,42657
53883,3,392,36,170.67,24878.22,42656,42659
53884,4,379,2,128.00,22707.50,42658,42662
53885,1,512,512,512.00,0.00,42661,42662
53886,1,512,512,512.00,0.00,42661,42662
53887,1,512,512,512.00,0.00,42661,42662
53888,1,512,512,512.00,0.00,42661,42662
53889,6,224,1,85.33,7093.56,42661,42667
53890,5,380,4,102.40,19948.24,42666,42671
53891,1,512,512,512.00,0.00,42670,42671
53892,1,512,512,512.00,0.00,42670,42671
53893,1,512,512,512.00,0.00,42670,42671
53894,1,512,512,512.00,0.00,42671,42672
53895,1,512,512,512.00,0.00,42671,42672
53896,2,508,4,256.00,63504.00,42671,42673
53897,1,512,512,512.00,0.00,42672,42673
53898,1,512,512,512.00,0.00,42672,42673
53899,2,371,141,256.00,13225.00,42672,42674
53900,2,263,249,256.00,49.00,42673,42675
53901,4,479,1,128.00,41154.50,42674,42678
53902,1,512,512,512.00,0.00,42677,42678
53903,1,512,512,512.00,0.00,42677,42678
53904,2,412,100,256.00,24336.00,42677,42679
53905,5,217,3,102.40,7314.24,42678,42683
53906,1,512,512,512.00,0.00,42682,42683
53907,2,308,204,256.00,2704.00,42682,42684
53908,1,512,512,512.00,0.00,42683,42684
53909,1,512,512,512.00,0.00,42683,42684
53910,1,512,512,512.00,0.00,42683,42684
53911,2,286,226,256.00,900.00,42683,42685
53912,1,512,512,512.00,0.00,42684,42685
53913,1,512,512,512.00,0.00,42684,42685
53914,1,512,512,512.00,0.00,42684,42685
53915,1,512,512,512.00,0.00,42684,42685
53916,1,512,512,512.00,0.00,42684,42685
53917,1,512,512,512.00,0.00,42684,42685
53918,1,512,512,512.00,0.00,42684,42685
53919,2,408,104,256.00,23104.00,42684,42686
53920,2,267,245,256.00,121.00,42685,42687
53921,1,512,512,512.00,0.00,42686,42687
53922,4,355,1,128.00,20756.50,42686,42690
53923,1,512,512,512.00,0.00,42689,42690
53924,1,512,512,512.00,0.00,42689,42690
53925,1,512,512,512.00,0.00,42689,42690
53926,2,258,254,256.00,4.00,42689,42691
53927,1,512,512,512.00,0.00,42690,42691
53928,1,512,512,512.00,0.00,42690,42691
53929,2,280,232,256.00,576.00,42690,42692
53930,1,512,512,512.00,0.00,42691,42692
53931,1,512,512,512.00,0.00,42691,42692
53932,2,442,70,256.00,34596.00,42691,42693
53933,4,229,15,128.00,6305.00,42692,42696
53934,4,227,1,128.00,7380.50,42695,42699
53935,1,512,512,512.00,0.00,42698,42699
53936,1,512,512,512.00,0.00,42698,42699
53937,4,255,56,128.00,5826.50,42698,42702
53938,1,512,512,512.00,0.00,42701,42702
53939,2,274,238,256.00,324.00,42701,42703
53940,1,512,512,512.00,0.00,42702,42703
53941,1,512,512,512.00,0.00,42702,42703
53942,1,512,512,512.00,0.00,42702,42703
53943,2,369,143,256.00,12769.00,42702,42704
53944,2,272,240,256.00,256.00,42703,42705
53945,2,394,118,256.00,19044.00,42704,42706
53946,2,272,240,256.00,256.00,42705,42707
53947,3,411,1,170.67,30513.56,42706,42709
53948,1,512,512,512.00,0.00,42708,42709
53949,3,219,86,170.67,3608.22,42708,42711
53950,1,512,512,512.00,0.00,42710,42711
53951,1,512,512,512.00,0.00,42710,42711
53952,4,314,7,128.00,13272.50,42710,42714
53953,1,512,512,512.00,0.00,42713,42714
53954,2,484,28,256.00,51984.00,42713,42715
53955,1,512,512,512.00,0.00,42714,42715
53956,5,289,2,102.40,14893.84,42714,42719
53957,3,260,30,170.67,10134.22,42718,42721
53958,1,512,512,512.00,0.00,42720,42721
53959,2,426,86,256.00,28900.00,42720,42722
53960,1,512,512,512.00,0.00,42721,42722
53961,1,512,512,512.00,0.00,42721,42722
53962,1,512,512,512.00,0.00,42721,42722
53963,2,294,218,256.00,1444.00,42721,42723
53964,3,257,55,170.67,7230.89,42722,42725
53965,2,466,46,256.00,44100.00,42724,42726
53966,1,512,512,512.00,0.00,42725,42726
53967,3,364,18,170.67,20779.56,42725,42728
53968,1,512,512,512.00,0.00,42727,42728
53969,1,512,512,512.00,0.00,42727,42728
53970,1,512,512,512.00,0.00,42727,42728
53971,1,512,512,512.00,0.00,42727,42728
53972,3,380,8,170.67,24152.89,42727,42730
53973,2,492,20,256.00,55696.00,42729,42731
53974,1,512,512,512.00,0.00,42730,42731
53975,1,512,512,512.00,0.00,42730,42731
53976,3,345,25,170.67,17477.56,42730,42733
53977,2,503,9,256.00,61009.00,42732,42734
53978,2,507,5,256.00,63001.00,42733,42735
53979,3,325,3,170.67,17369.56,42734,42737
53980,4,419,16,128.00,28377.50,42736,42740
53981,4,151,104,128.00,312.50,42739,42743
53982,1,512,512,512.00,0.00,42742,42743
53983,7,434,1,73.14,21940.98,42742,42749
53984,1,512,512,512.00,0.00,42748,42749
53985,2,416,96,256.00,25600.00,42748,42750
53986,1,512,512,512.00,0.00,42749,42750
53987,1,512,512,512.00,0.00,42749,42750
53988,1,512,512,512.00,0.00,42749,42750
53989,3,441,10,170.67,36973.56,42749,42752
53990,6,300,1,85.33,14527.56,42751,42757
53991,3,361,5,170.67,21426.89,42756,42759
53992,1,512,512,512.00,0.00,42758,42759
53993,5,469,2,102.40,33636.24,42758,42763
53994,9,249,2,56.89,6066.99,42762,42771
53995,1,512,512,512.00,0.00,42770,42771
53996,1,512,512,512.00,0.00,42770,42771
53997,5,150,44,102.40,1393.04,42770,42775
53998,1,512,512,512.00,0.00,42774,42775
53999,6,226,1,85.33,6652.56,42774,42780
54000,3,392,15,170.67,25844.22,42779,42782
54001,1,512,512,512.00,0.00,42781,42782
54002,1,512,512,512.00,0.00,42781,42782
54003,1,512,512,512.00,0.00,42781,42782
54004,6,405,1,85.33,21480.22,42781,42787
54005,1,512,512,512.00,0.00,42786,42787
54006,1,512,512,512.00,0.00,42786,42787
54007,2,342,170,256.00,7396.00,42786,42788
54008,1,512,512,512.00,0.00,42787,42788
54009,1,512,512,512.00,0.00,42787,42788
54010,3,480,5,170.67,47924.22,42787,42790
54011,2,502,10,256.00,60516.00,42789,42791
54012,1,512,512,512.00,0.00,42790,42791
54013,1,512,512,512.00,0.00,42790,42791
54014,1,512,512,512.00,0.00,42790,42791
54015,1,512,512,512.00,0.00,42790,42791
54016,1,512,512,512.00,0.00,42790,42791
54017,3,471,13,170.67,45137.56,42790,42793
54018,1,512,512,512.00,0.00,42792,42793
54019,1,512,512,512.00,0.00,42792,42793
54020,1,512,512,512.00,0.00,42792,42793
54021,1,512,512,512.00,0.00,42792,42793
54022,1,512,512,512.00,0.00,42792,42793
54023,4,251,3,128.00,7977.00,42792,42796
54024,1,512,512,512.00,0.00,42795,42796
54025,1,512,512,512.00,0.00,42795,42796
54026,1,512,512,512.00,0.00,42795,42796
54027,1,512,512,512.00,0.00,42795,42796
54028,4,401,10,128.00,25117.50,42795,42799
54029,1,512,512,512.00,0.00,42798,42799
54030,1,512,512,512.00,0.00,42798,42799
54031,1,512,512,512.00,0.00,42798,42799
54032,2,367,145,256.00,12321.00,42798,42800
54033,1,512,512,512.00,0.00,42799,42800
54034,1,512,512,512.00,0.00,42799,42800
54035,1,512,512,512.00,0.00,42799,42800
54036,1,512,512,512.00,0.00,42799,42800
54037,4,322,2,128.00,17654.00,42799,42803
54038,7,169,1,73.14,3922.12,42802,42809
54039,1,512,512,512.00,0.00,42808,42809
54040,1,512,512,512.00,0.00,42808,42809
54041,2,509,3,256.00,64009.00,42808,42810
54042,1,512,512,512.00,0.00,42809,42810
54043,1,512,512,512.00,0.00,42809,42810
54044,1,512,512,512.00,0.00,42809,42810
54045,8,303,2,64.00,9546.75,42809,42817
54046,1,512,512,512.00,0.00,42816,42817
54047,1,512,512,512.00,0.00,42816,42817
54048,1,512,512,512.00,0.00,42816,42817
54049,1,512,512,512.00,0.00,42816,42817
54050,1,512,512,512.00,0.00,42816,42817
54051,7,289,1,73.14,9765.55,42816,42823
54052,2,269,243,256.00,169.00,42822,42824
54053,1,512,512,512.00,0.00,42823,42824
54054,1,512,512,512.00,0.00,42823,42824
54055,3,329,25,170.67,15482.89,42823,42826
54056,1,512,512,512.00,0.00,42825,42826
54057,1,512,512,512.00,0.00,42825,42826
54058,1,512,512,512.00,0.00,42825,42826
54059,1,512,512,512.00,0.00,42825,42826
54060,1,512,512,512.00,0.00,42825,42826
54061,1,512,512,512.00,0.00,42825,42826
54062,3,284,32,170.67,10904.89,42825,42828
54063,1,512,512,512.00,0.00,42827,42828
54064,1,512,512,512.00,0.00,42827,42828
54065,1,512,512,512.00,0.00,42827,42828
54066,3,485,5,170.67,49450.89,42827,42830
54067,1,512,512,512.00,0.00,42829,42830
54068,1,512,512,512.00,0.00,42829,42830
54069,1,512,512,512.00,0.00,42829,42830
54070,2,406,106,256.00,22500.00,42829,42831
54071,1,512,512,512.00,0.00,42830,42831
54072,1,512,512,512.00,0.00,42830,42831
54073,1,512,512,512.00,0.00,42830,42831
54074,3,310,66,170.67,10523.56,42830,42833
54075,2,482,30,256.00,51076.00,42832,42834
54076,1,512,512,512.00,0.00,42833,42834
54077,3,329,7,170.67,17294.89,42833,42836
54078,1,512,512,512.00,0.00,42835,42836
54079,1,512,512,512.00,0.00,42835,42836
54080,1,512,512,512.00,0.00,42835,42836
54081,1,512,512,512.00,0.00,42835,42836
54082,1,512,512,512.00,0.00,42835,42836
54083,1,512,512,512.00,0.00,42835,42836
54084,6,329,1,85.33,13236.22,42835,42841
54085,1,512,512,512.00,0.00,42840,42841
54086,1,512,512,512.00,0.00,42840,42841
54087,1,512,512,512.00,0.00,42840,42841
54088,5,267,3,102.40,10734.24,42840,42845
54089,1,512,512,512.00,0.00,42844,42845
54090,1,512,512,512.00,0.00,42844,42845
54091,4,426,2,128.00,29940.00,42844,42848
54092,2,284,228,256.00,784.00,42847,42849
54093,1,512,512,512.00,0.00,42848,42849
54094,1,512,512,512.00,0.00,42848,42849
54095,1,512,512,512.00,0.00,42848,42849
54096,3,310,42,170.67,12027.56,42848,42851
54097,1,512,512,512.00,0.00,42850,42851
54098,2,427,85,256.00,29241.00,42850,42852
54099,1,512,512,512.00,0.00,42851,42852
54100,1,512,512,512.00,0.00,42851,42852
54101,1,512,512,512.00,0.00,42851,42852
54102,1,512,512,512.00,0.00,42851,42852
54103,1,512,512,512.00,0.00,42851,42852
54104,1,512,512,512.00,0.00,42851,42852
54105,7,272,1,73.14,7434.12,42851,42858
54106,2,379,133,256.00,15129.00,42857,42859
54107,2,413,99,256.00,24649.00,42858,42860
54108,1,512,512,512.00,0.00,42859,42860
54109,3,450,6,170.67,39430.22,42859,42862
54110,1,512,512,512.00,0.00,42861,42862
54111,4,323,27,128.00,13673.00,42861,42865
54112,1,512,512,512.00,0.00,42864,42865
54113,1,512,512,512.00,0.00,42864,42865
54114,1,512,512,512.00,0.00,42864,42865
54115,1,512,512,512.00,0.00,42864,42865
54116,5,198,40,102.40,2761.84,42864,42869
54117,2,453,59,256.00,38809.00,42868,42870
54118,2,269,243,256.00,169.00,42869,42871
54119,1,512,512,512.00,0.00,42870,42871
54120,8,223,3,64.00,5280.25,42870,42878
54121,3,466,4,170.67,43851.56,42877,42880
54122,2,481,31,256.00,50625.00,42879,42881
54123,5,200,13,102.40,4059.04,42880,42885
54124,1,512,512,512.00,0.00,42884,42885
54125,1,512,512,512.00,0.00,42884,42885
54126,1,512,512,512.00,0.00,42884,42885
54127,3,402,22,170.67,27483.56,42884,42887
54128,4,348,17,128.00,17226.50,42886,42890
54129,1,512,512,512.00,0.00,42889,42890
54130,1,512,512,512.00,0.00,42889,42890
54131,4,319,1,128.00,17026.50,42889,42893
54132,1,512,512,512.00,0.00,42892,42893
54133,1,512,512,512.00,0.00,42892,42893
54134,2,309,203,256.00,2809.00,42892,42894
54135,6,227,7,85.33,7136.56,42893,42899
54136,3,499,1,170.67,53921.56,42898,42901
54137,3,455,17,170.67,40510.89,42900,42903
54138,3,308,65,170.67,10342.89,42902,42905
54139,1,512,512,512.00,0.00,42904,42905
54140,1,512,512,512.00,0.00,42904,42905
54141,1,512,512,512.00,0.00,42904,42905
54142,2,482,30,256.00,51076.00,42904,42906
54143,1,512,512,512.00,0.00,42905,42906
54144,1,512,512,512.00,0.00,42905,42906
54145,1,512,512,512.00,0.00,42905,42906
54146,1,512,512,512.00,0.00,42905,42906
54147,1,512,512,512.00,0.00,42905,42906
54148,2,269,243,256.00,169.00,42905,42907
54149,3,294,19,170.67,13005.56,42906,42909
54150,1,512,512,512.00,0.00,42908,42909
54151,1,512,512,512.00,0.00,42908,42909
54152,1,512,512,512.00,0.00,42908,42909
54153,5,285,6,102.40,11878.64,42908,42913
54154,2,365,147,256.00,11881.00,42912,42914
54155,1,512,512,512.00,0.00,42913,42914
54156,1,512,512,512.00,0.00,42913,42914
54157,1,512,512,512.00,0.00,42913,42914
54158,2,327,185,256.00,5041.00,42913,42915
54159,1,512,512,512.00,0.00,42914,42915
54160,1,512,512,512.00,0.00,42914,42915
54161,3,428,4,170.67,34072.89,42914,42917
54162,1,512,512,512.00,0.00,42916,42917
54163,1,512,512,512.00,0.00,42916,42917
54164,7,193,1,73.14,6345.84,42916,42923
54165,2,448,64,256.00,36864.00,42922,42924
54166,2,503,9,256.00,61009.00,42923,42925
54167,2,379,133,256.00,15129.00,42924,42926
54168,3,495,4,170.67,52609.56,42925,42928
54169,1,512,512,512.00,0.00,42927,42928
54170,2,275,237,256.00,361.00,42927,42929
54171,1,512,512,512.00,0.00,42928,42929
54172,3,292,99,170.67,7441.56,42928,42931
54173,1,512,512,512.00,0.00,42930,42931
54174,1,512,512,512.00,0.00,42930,42931
54175,1,512,512,512.00,0.00,42930,42931
54176,2,300,212,256.00,1936.00,42930,42932
54177,2,290,222,256.00,1156.00,42931,42933
54178,1,512,512,512.00,0.00,42932,42933
54179,2,444,68,256.00,35344.00,42932,42934
54180,4,447,9,128.00,34065.00,42933,42937
54181,4,492,1,128.00,44205.50,42936,42940
54182,1,512,512,512.00,0.00,42939,42940
54183,1,512,512,512.00,0.00,42939,42940
54184,4,193,53,128.00,3357.00,42939,42943
54185,1,512,512,512.00,0.00,42942,42943
54186,2,501,11,256.00,60025.00,42942,42944
54187,1,512,512,512.00,0.00,42943,42944
54188,3,382,8,170.67,24496.89,42943,42946
54189,5,278,1,102.40,11983.44,42945,42950
54190,1,512,512,512.00,0.00,42949,42950
54191,2,327,185,256.00,5041.00,42949,42951
54192,2,465,47,256.00,43681.00,42950,42952
54193,1,512,512,512.00,0.00,42951,42952
54194,1,512,512,512.00,0.00,42951,42952
54195,1,512,512,512.00,0.00,42951,42952
54196,2,329,183,256.00,5329.00,42951,42953
54197,1,512,512,512.00,0.00,42952,42953
54198,1,512,512,512.00,0.00,42952,42953
54199,1,512,512,512.00,0.00,42952,42953
54200,1,512,512,512.00,0.00,42952,42953
54201,2,303,209,256.00,2209.00,42952,42954
54202,1,512,512,512.00,0.00,42953,42954
54203,1,512,512,512.00,0.00,42953,42954
54204,5,385,6,102.40,21248.24,42953,42958
54205,1,512,512,512.00,0.00,42957,42958
54206,1,512,512,512.00,0.00,42957,42958
54207,2,428,84,256.00,29584.00,42957,42959
54208,1,512,512,512.00,0.00,42958,42959
54209,1,512,512,512.00,0.00,42958,42959
54210,1,512,512,512.00,0.00,42958,42959
54211,1,512,512,512.00,0.00,42958,42959
54212,2,456,56,256.00,40000.00,42958,42960
54213,1,512,512,512.00,0.00,42959,42960
54214,4,294,1,128.00,15297.50,42959,42963
54215,3,388,6,170.67,25707.56,42962,42965
54216,1,512,512,512.00,0.00,42964,42965
54217,5,213,24,102.40,6715.04,42964,42969
54218,1,512,512,512.00,0.00,42968,42969
54219,1,512,512,512.00,0.00,42968,42969
54220,4,222,79,128.00,3315.50,42968,42972
54221,3,348,57,170.67,16140.22,42971,42974
54222,1,512,512,512.00,0.00,42973,42974
54223,1,512,512,512.00,0.00,42973,42974
54224,8,365,1,64.00,13240.00,42973,42981
54225,1,512,512,512.00,0.00,42980,42981
54226,2,428,84,256.00,29584.00,42980,42982
54227,2,508,4,256.00,63504.00,42981,42983
54228,1,512,512,512.00,0.00,42982,42983
54229,1,512,512,512.00,0.00,42982,42983
54230,1,512,512,512.00,0.00,42982,42983
54231,3,412,2,170.67,30656.89,42982,42985
54232,1,512,512,512.00,0.00,42984,42985
54233,1,512,512,512.00,0.00,42984,42985
54234,3,399,45,170.67,26156.22,42984,42987
54235,1,512,512,512.00,0.00,42986,42987
54236,1,512,512,512.00,0.00,42986,42987
54237,1,512,512,512.00,0.00,42986,42987
54238,4,268,52,128.00,7696.50,42986,42990
54239,1,512,512,512.00,0.00,42989,42990
54240,3,433,14,170.67,34842.89,42989,42992
54241,5,446,2,102.40,29836.24,42991,42996
54242,2,328,184,256.00,5184.00,42996,42998
54243,2,456,56,256.00,40000.00,42997,42999
54244,1,512,512,512.00,0.00,42998,42999
54245,1,512,512,512.00,0.00,42998,42999
54246,2,440,72,256.00,33856.00,42998,43000
54247,1,512,512,512.00,0.00,42999,43000
54248,1,512,512,512.00,0.00,42999,43000
54249,1,512,512,512.00,0.00,42999,43000
54250,1,512,512,512.00,0.00,42999,43000
54251,2,480,32,256.00,50176.00,42999,43001
54252,1,512,512,512.00,0.00,43000,43001
54253,1,512,512,512.00,0.00,43000,43001
54254,2,436,76,256.00,32400.00,43000,43002
54255,1,512,512,512.00,0.00,43001,43002
54256,1,512,512,512.00,0.00,43001,43002
54257,1,512,512,512.00,0.00,43001,43002
54258,1,512,512,512.00,0.00,43001,43002
54259,4,183,90,128.00,1453.50,43001,43005
54260,2,430,82,256.00,30276.00,43004,43006
54261,1,512,512,512.00,0.00,43005,43006
54262,2,260,252,256.00,16.00,43005,43007
54263,3,481,7,170.67,48201.56,43006,43009
54264,1,512,512,512.00,0.00,43008,43009
54265,1,512,512,512.00,0.00,43008,43009
54266,3,279,94,170.67,6205.56,43008,43011
54267,1,512,512,512.00,0.00,43010,43011
54268,1,512,512,512.00,0.00,43010,43011
54269,1,512,512,512.00,0.00,43010,43011
54270,1,512,512,512.00,0.00,43010,43011
54271,1,512,512,512.00,0.00,43010,43011
54272,2,420,92,256.00,26896.00,43010,43012
54273,1,512,512,512.00,0.00,43011,43012
54274,1,512,512,512.00,0.00,43011,43012
54275,1,512,512,512.00,0.00,43011,43012
54276,1,512,512,512.00,0.00,43011,43012
54277,2,356,156,256.00,10000.00,43011,43013
54278,1,512,512,512.00,0.00,43012,43013
54279,2,458,54,256.00,40804.00,43012,43014
54280,4,273,1,128.00,12067.00,43013,43017
54281,2,426,86,256.00,28900.00,43016,43018
54282,1,512,512,512.00,0.00,43017,43018
54283,5,244,2,102.40,8616.24,43017,43022
54284,4,466,2,128.00,38260.50,43021,43025
54285,4,401,1,128.00,25977.00,43024,43028
54286,1,512,512,512.00,0.00,43027,43028
54287,4,374,2,128.00,22302.50,43027,43031
54288,1,512,512,512.00,0.00,43030,43031
54289,1,512,512,512.00,0.00,43030,43031
54290,1,512,512,512.00,0.00,43030,43031
54291,3,407,1,170.67,29694.89,43030,43033
54292,1,512,512,512.00,0.00,43032,43033
54293,1,512,512,512.00,0.00,43032,43033
54294,1,512,512,512.00,0.00,43032,43033
54295,1,512,512,512.00,0.00,43032,43033
54296,1,512,512,512.00,0.00,43032,43033
54297,1,512,512,512.00,0.00,43032,43033
54298,2,258,254,256.00,4.00,43032,43034
54299,1,512,512,512.00,0.00,43033,43034
54300,2,423,89,256.00,27889.00,43033,43035
54301,2,415,97,256.00,25281.00,43034,43036
54302,1,512,512,512.00,0.00,43035,43036
54303,1,512,512,512.00,0.00,43035,43036
54304,1,512,512,512.00,0.00,43035,43036
54305,2,465,47,256.00,43681.00,43035,43037
54306,3,477,2,170.67,47080.22,43036,43039
54307,1,512,512,512.00,0.00,43038,43039
54308,1,512,512,512.00,0.00,43038,43039
54309,1,512,512,512.00,0.00,43038,43039
54310,1,512,512,512.00,0.00,43038,43039
54311,1,512,512,512.00,0.00,43038,43039
54312,1,512,512,512.00,0.00,43038,43039
54313,5,306,6,102.40,11517.44,43038,43043
54314,2,506,6,256.00,62500.00,43042,43044
54315,1,512,512,512.00,0.00,43043,43044
54316,1,512,512,512.00,0.00,43043,43044
54317,3,466,19,170.67,43621.56,43043,43046
54318,4,349,1,128.00,17387.50,43045,43049
54319,1,512,512,512.00,0.00,43048,43049
54320,1,512,512,512.00,0.00,43048,43049
54321,2,452,60,256.00,38416.00,43048,43050
54322,4,190,74,128.00,2090.00,43049,43053
54323,1,512,512,512.00,0.00,43052,43053
54324,3,288,47,170.67,9700.22,43052,43055
54325,2,266,246,256.00,100.00,43054,43056
54326,1,512,512,512.00,0.00,43055,43056
54327,1,512,512,512.00,0.00,43055,43056
54328,1,512,512,512.00,0.00,43055,43056
54329,4,438,1,128.00,32804.50,43055,43059
54330,1,512,512,512.00,0.00,43058,43059
54331,6,152,1,85.33,3661.56,43058,43064
54332,1,512,512,512.00,0.00,43063,43064
54333,2,356,156,256.00,10000.00,43063,43065
54334,1,512,512,512.00,0.00,43064,43065
54335,2,307,205,256.00,2601.00,43064,43066
54336,1,512,512,512.00,0.00,43065,43066
54337,1,512,512,512.00,0.00,43065,43066
54338,1,512,512,512.00,0.00,43065,43066
54339,2,398,114,256.00,20164.00,43065,43067
54340,1,512,512,512.00,0.00,43066,43067
54341,3,347,54,170.67,16088.22,43066,43069
54342,1,512,512,512.00,0.00,43068,43069
54343,1,512,512,512.00,0.00,43068,43069
54344,2,491,21,256.00,55225.00,43068,43070
54345,4,342,41,128.00,15385.50,43069,43073
54346,1,512,512,512.00,0.00,43072,43073
54347,2,305,207,256.00,2401.00,43072,43074
54348,3,266,52,170.67,7904.89,43073,43076
54349,2,296,216,256.00,1600.00,43075,43077
54350,2,411,101,256.00,24025.00,43076,43078
54351,1,512,512,512.00,0.00,43077,43078
54352,4,357,1,128.00,19795.00,43077,43081
54353,2,423,89,256.00,27889.00,43080,43082
54354,2,377,135,256.00,14641.00,43081,43083
54355,1,512,512,512.00,0.00,43082,43083
54356,1,512,512,512.00,0.00,43082,43083
54357,1,512,512,512.00,0.00,43082,43083
54358,1,512,512,512.00,0.00,43082,43083
54359,1,512,512,512.00,0.00,43082,43083
54360,3,394,8,170.67,26672.89,43082,43085
54361,1,512,512,512.00,0.00,43084,43085
54362,1,512,512,512.00,0.00,43085,43086
54363,1,512,512,512.00,0.00,43085,43086
54364,1,512,512,512.00,0.00,43085,43086
54365,5,375,1,102.40,19467.04,43085,43090
54366,3,373,48,170.67,20777.56,43089,43092
54367,1,512,512,512.00,0.00,43091,43092
54368,1,512,512,512.00,0.00,43091,43092
54369,1,512,512,512.00,0.00,43091,43092
54370,1,512,512,512.00,0.00,43091,43092
54371,2,450,62,256.00,37636.00,43091,43093
54372,1,512,512,512.00,0.00,43092,43093
54373,2,392,120,256.00,18496.00,43092,43094
54374,1,512,512,512.00,0.00,43093,43094
54375,2,496,16,256.00,57600.00,43093,43095
54376,1,512,512,512.00,0.00,43094,43095
54377,1,512,512,512.00,0.00,43094,43095
54378,2,356,156,256.00,10000.00,43094,43096
54379,1,512,512,512.00,0.00,43095,43096
54380,3,291,1,170.67,15233.56,43095,43098
54381,2,293,219,256.00,1369.00,43097,43099
54382,6,273,2,85.33,8189.89,43098,43104
54383,1,512,512,512.00,0.00,43103,43104
54384,1,512,512,512.00,0.00,43103,43104
54385,2,314,198,256.00,3364.00,43103,43105
54386,1,512,512,512.00,0.00,43104,43105
54387,2,500,12,256.00,59536.00,43104,43106
54388,1,512,512,512.00,0.00,43105,43106
54389,3,248,28,170.67,10200.89,43105,43108
54390,2,400,112,256.00,20736.00,43107,43109
54391,1,512,512,512.00,0.00,43108,43109
54392,2,475,37,256.00,47961.00,43108,43110
54393,2,351,161,256.00,9025.00,43109,43111
54394,5,221,1,102.40,6883.04,43110,43115
54395,1,512,512,512.00,0.00,43114,43115
54396,1,512,512,512.00,0.00,43114,43115
54397,5,283,1,102.40,9892.24,43114,43119
54398,1,512,512,512.00,0.00,43118,43119
54399,1,512,512,512.00,0.00,43118,43119
54400,1,512,512,512.00,0.00,43118,43119
54401,1,512,512,512.00,0.00,43118,43119
54402,1,512,512,512.00,0.00,43118,43119
54403,6,216,1,85.33,5796.56,43118,43124
54404,2,341,171,256.00,7225.00,43123,43125
54405,1,512,512,512.00,0.00,43124,43125
54406,1,512,512,512.00,0.00,43124,43125
54407,1,512,512,512.00,0.00,43124,43125
54408,3,223,69,170.67,5169.56,43124,43127
54409,1,512,512,512.00,0.00,43126,43127
54410,1,512,512,512.00,0.00,43126,43127
54411,1,512,512,512.00,0.00,43126,43127
54412,1,512,512,512.00,0.00,43126,43127
54413,1,512,512,512.00,0.00,43126,43127
54414,1,512,512,512.00,0.00,43126,43127
54415,1,512,512,512.00,0.00,43126,43127
54416,2,443,69,256.00,34969.00,43126,43128
54417,4,419,1,128.00,28596.50,43127,43131
54418,2,424,88,256.00,28224.00,43130,43132
54419,3,398,17,170.67,26906.89,43131,43134
54420,4,392,1,128.00,23868.50,43133,43137
54421,4,386,21,128.00,22444.50,43136,43140
54422,2,308,204,256.00,2704.00,43139,43141
54423,3,365,63,170.67,18956.22,43140,43143
54424,5,390,1,102.40,22335.04,43142,43147
54425,1,512,512,512.00,0.00,43146,43147
54426,1,512,512,512.00,0.00,43146,43147
54427,3,369,4,170.67,22705.56,43146,43149
54428,2,315,197,256.00,3481.00,43148,43150
54429,1,512,512,512.00,0.00,43149,43150
54430,1,512,512,512.00,0.00,43149,43150
54431,3,314,56,170.67,11504.89,43149,43152
54432,2,444,68,256.00,35344.00,43151,43153
54433,1,512,512,512.00,0.00,43152,43153
54434,1,512,512,512.00,0.00,43152,43153
54435,1,512,512,512.00,0.00,43152,43153
54436,3,274,15,170.67,12549.56,43152,43155
54437,1,512,512,512.00,0.00,43154,43155
54438,1,512,512,512.00,0.00,43154,43155
54439,1,512,512,512.00,0.00,43154,43155
54440,3,243,59,170.67,6416.22,43154,43157
54441,2,469,43,256.00,45369.00,43156,43158
54442,1,512,512,512.00,0.00,43157,43158
54443,1,512,512,512.00,0.00,43157,43158
54444,1,512,512,512.00,0.00,43157,43158
54445,1,512,512,512.00,0.00,43157,43158
54446,1,512,512,512.00,0.00,43157,43158
54447,1,512,512,512.00,0.00,43157,43158
54448,1,512,512,512.00,0.00,43157,43158
54449,4,427,4,128.00,30518.50,43157,43161
54450,1,512,512,512.00,0.00,43160,43161
54451,1,512,512,512.00,0.00,43160,43161
54452,1,512,512,512.00,0.00,43160,43161
54453,2,441,71,256.00,34225.00,43160,43162
54454,1,512,512,512.00,0.00,43161,43162
54455,1,512,512,512.00,0.00,43161,43162
54456,1,512,512,512.00,0.00,43161,43162
54457,1,512,512,512.00,0.00,43161,43162
54458,2,412,100,256.00,24336.00,43161,43163
54459,1,512,512,512.00,0.00,43162,43163
54460,1,512,512,512.00,0.00,43162,43163
54461,5,269,10,102.40,9267.44,43162,43167
54462,1,512,512,512.00,0.00,43166,43167
54463,1,512,512,512.00,0.00,43166,43167
54464,1,512,512,512.00,0.00,43166,43167
54465,8,187,5,64.00,4110.50,43166,43174
54466,6,245,35,85.33,5300.22,43173,43179
54467,1,512,512,512.00,0.00,43178,43179
54468,2,390,122,256.00,17956.00,43178,43180
54469,1,512,512,512.00,0.00,43179,43180
54470,1,512,512,512.00,0.00,43179,43180
54471,3,468,2,170.67,44470.22,43179,43182
54472,1,512,512,512.00,0.00,43181,43182
54473,1,512,512,512.00,0.00,43181,43182
54474,3,364,5,170.67,21862.89,43181,43184
54475,1,512,512,512.00,0.00,43183,43184
54476,1,512,512,512.00,0.00,43183,43184
54477,1,512,512,512.00,0.00,43183,43184
54478,6,291,1,85.33,10281.89,43183,43189
54479,2,308,204,256.00,2704.00,43188,43190
54480,3,413,1,170.67,30930.89,43189,43192
54481,1,512,512,512.00,0.00,43191,43192
54482,1,512,512,512.00,0.00,43191,43192
54483,1,512,512,512.00,0.00,43191,43192
54484,1,512,512,512.00,0.00,43191,43192
54485,1,512,512,512.00,0.00,43191,43192
54486,2,395,117,256.00,19321.00,43191,43193
54487,1,512,512,512.00,0.00,43192,43193
54488,4,224,5,128.00,8805.50,43192,43196
54489,4,405,4,128.00,26855.50,43195,43199
54490,3,453,26,170.67,39864.22,43198,43201
54491,2,455,57,256.00,39601.00,43200,43202
54492,2,291,221,256.00,1225.00,43201,43203
54493,4,211,7,128.00,6285.00,43202,43206
54494,3,279,19,170.67,12205.56,43205,43208
54495,7,260,1,73.14,10684.12,43207,43214
54496,1,512,512,512.00,0.00,43213,43214
54497,7,199,2,73.14,4172.98,43213,43220
54498,2,322,190,256.00,4356.00,43219,43221
54499,1,512,512,512.00,0.00,43220,43221
54500,1,512,512,512.00,0.00,43220,43221
54501,2,276,236,256.00,400.00,43220,43222
54502,2,454,58,256.00,39204.00,43221,43223
54503,1,512,512,512.00,0.00,43222,43223
54504,1,512,512,512.00,0.00,43222,43223
54505,1,512,512,512.00,0.00,43222,43223
54506,2,480,32,256.00,50176.00,43222,43224
54507,1,512,512,512.00,0.00,43223,43224
54508,1,512,512,512.00,0.00,43223,43224
54509,2,271,241,256.00,225.00,43223,43225
54510,2,331,181,256.00,5625.00,43224,43226
54511,1,512,512,512.00,0.00,43225,43226
54512,1,512,512,512.00,0.00,43225,43226
54513,3,279,61,170.67,7921.56,43225,43228
54514,1,512,512,512.00,0.00,43227,43228
54515,1,512,512,512.00,0.00,43227,43228
54516,1,512,512,512.00,0.00,43227,43228
54517,1,512,512,512.00,0.00,43227,43228
54518,1,512,512,512.00,0.00,43227,43228
54519,4,237,50,128.00,4747.50,43227,43231
54520,3,330,22,170.67,15867.56,43230,43233
54521,3,253,34,170.67,9469.56,43232,43235
54522,2,269,243,256.00,169.00,43234,43236
54523,1,512,512,512.00,0.00,43235,43236
54524,2,462,50,256.00,42436.00,43235,43237
54525,4,431,3,128.00,31183.50,43236,43240
54526,4,226,42,128.00,6788.50,43239,43243
54527,1,512,512,512.00,0.00,43242,43243
54528,2,302,210,256.00,2116.00,43242,43244
54529,2,298,214,256.00,1764.00,43243,43245
54530,1,512,512,512.00,0.00,43244,43245
54531,3,374,11,170.67,22914.89,43244,43247
54532,1,512,512,512.00,0.00,43246,43247
54533,1,512,512,512.00,0.00,43246,43247
54534,1,512,512,512.00,0.00,43246,43247
54535,3,225,73,170.67,4789.56,43246,43249
54536,1,512,512,512.00,0.00,43248,43249
54537,1,512,512,512.00,0.00,43248,43249
54538,6,361,8,85.33,15604.56,43248,43254
54539,3,373,1,170.67,23597.56,43253,43256
54540,5,286,2,102.40,10512.24,43255,43260
54541,2,331,181,256.00,5625.00,43259,43261
54542,2,383,129,256.00,16129.00,43260,43262
54543,1,512,512,512.00,0.00,43261,43262
54544,1,512,512,512.00,0.00,43261,43262
54545,1,512,512,512.00,0.00,43261,43262
54546,3,376,38,170.67,21680.89,43261,43264
54547,1,512,512,512.00,0.00,43263,43264
54548,1,512,512,512.00,0.00,43263,43264
54549,5,221,1,102.40,7550.24,43263,43268
54550,4,260,7,128.00,14586.50,43267,43271
54551,8,254,1,64.00,5935.25,43270,43278
54552,5,152,19,102.40,2056.24,43277,43282
54553,1,512,512,512.00,0.00,43281,43282
54554,4,211,1,128.00,6028.50,43281,43285
54555,1,512,512,512.00,0.00,43284,43285
54556,4,308,1,128.00,16138.50,43284,43288
54557,2,492,20,256.00,55696.00,43287,43289
54558,3,307,57,170.67,10673.56,43288,43291
54559,4,355,9,128.00,19130.50,43290,43294
54560,1,512,512,512.00,0.00,43293,43294
54561,1,512,512,512.00,0.00,43293,43294
54562,3,352,1,170.67,20601.56,43293,43296
54563,2,333,179,256.00,5929.00,43295,43297
54564,3,249,101,170.67,3688.22,43296,43299
54565,2,414,98,256.00,24964.00,43298,43300
54566,2,262,250,256.00,36.00,43299,43301
54567,1,512,512,512.00,0.00,43300,43301
54568,2,371,141,256.00,13225.00,43300,43302
54569,1,512,512,512.00,0.00,43301,43302
54570,1,512,512,512.00,0.00,43301,43302
54571,1,512,512,512.00,0.00,43301,43302
54572,2,399,113,256.00,20449.00,43301,43303
54573,3,321,8,170.67,16404.22,43302,43305
54574,3,290,2,170.67,15040.89,43304,43307
54575,1,512,512,512.00,0.00,43306,43307
54576,1,512,512,512.00,0.00,43306,43307
54577,1,512,512,512.00,0.00,43306,43307
54578,3,357,43,170.67,18153.56,43306,43309
54579,2,499,13,256.00,59049.00,43308,43310
54580,3,230,65,170.67,5610.89,43309,43312
54581,3,430,37,170.67,33637.56,43311,43314
54582,4,262,52,128.00,6865.50,43313,43317
54583,4,337,1,128.00,15825.00,43316,43320
54584,1,512,512,512.00,0.00,43319,43320
54585,1,512,512,512.00,0.00,43319,43320
54586,3,315,97,170.67,10417.56,43319,43322
54587,1,512,512,512.00,0.00,43321,43322
54588,1,512,512,512.00,0.00,43321,43322
54589,1,512,512,512.00,0.00,43321,43322
54590,3,332,2,170.67,18176.89,43321,43324
54591,1,512,512,512.00,0.00,43323,43324
54592,1,512,512,512.00,0.00,43323,43324
54593,1,512,512,512.00,0.00,43323,43324
54594,1,512,512,512.00,0.00,43323,43324
54595,4,309,7,128.00,12305.00,43323,43327
54596,3,224,121,170.67,1774.89,43326,43329
54597,2,277,235,256.00,441.00,43328,43330
54598,1,512,512,512.00,0.00,43329,43330
54599,6,209,10,85.33,4828.56,43329,43335
54600,2,405,107,256.00,22201.00,43334,43336
54601,1,512,512,512.00,0.00,43335,43336
54602,3,297,40,170.67,11017.56,43335,43338
54603,2,298,214,256.00,1764.00,43337,43339
54604,1,512,512,512.00,0.00,43338,43339
54605,1,512,512,512.00,0.00,43338,43339
54606,1,512,512,512.00,0.00,43338,43339
54607,3,297,35,170.67,11484.22,43338,43341
54608,1,512,512,512.00,0.00,43340,43341
54609,1,512,512,512.00,0.00,43340,43341
54610,1,512,512,512.00,0.00,43340,43341
54611,1,512,512,512.00,0.00,43340,43341
54612,1,512,512,512.00,0.00,43340,43341
54613,1,512,512,512.00,0.00,43340,43341
54614,1,512,512,512.00,0.00,43340,43341
54615,3,370,22,170.67,21467.56,43340,43343
54616,2,372,140,256.00,13456.00,43342,43344
54617,1,512,512,512.00,0.00,43343,43344
54618,1,512,512,512.00,0.00,43343,43344
54619,1,512,512,512.00,0.00,43343,43344
54620,1,512,512,512.00,0.00,43343,43344
54621,2,436,76,256.00,32400.00,43343,43345
54622,1,512,512,512.00,0.00,43344,43345
54623,3,413,17,170.67,30066.89,43344,43347
54624,1,512,512,512.00,0.00,43346,43347
54625,2,313,199,256.00,3249.00,43346,43348
54626,1,512,512,512.00,0.00,43347,43348
54627,6,202,23,85.33,3489.56,43347,43353
54628,1,512,512,512.00,0.00,43352,43353
54629,1,512,512,512.00,0.00,43352,43353
54630,1,512,512,512.00,0.00,43352,43353
54631,3,270,92,170.67,5494.22,43352,43355
54632,4,411,2,128.00,27892.50,43354,43358
54633,1,512,512,512.00,0.00,43357,43358
54634,1,512,512,512.00,0.00,43357,43358
54635,2,360,152,256.00,10816.00,43357,43359
54636,1,512,512,512.00,0.00,43358,43359
54637,2,272,240,256.00,256.00,43358,43360
54638,1,512,512,512.00,0.00,43359,43360
54639,1,512,512,512.00,0.00,43359,43360
54640,1,512,512,512.00,0.00,43359,43360
54641,3,251,38,170.67,8930.89,43359,43362
54642,2,479,33,256.00,49729.00,43361,43363
54643,1,512,512,512.00,0.00,43362,43363
54644,5,303,1,102.40,13167.44,43362,43367
54645,1,512,512,512.00,0.00,43366,43367
54646,5,168,4,102.40,3929.84,43366,43371
54647,2,457,55,256.00,40401.00,43370,43372
54648,2,456,56,256.00,40000.00,43371,43373
54649,1,512,512,512.00,0.00,43372,43373
54650,5,193,12,102.40,5811.04,43372,43377
54651,2,326,186,256.00,4900.00,43376,43378
54652,1,512,512,512.00,0.00,43377,43378
54653,1,512,512,512.00,0.00,43377,43378
54654,1,512,512,512.00,0.00,43377,43378
54655,1,512,512,512.00,0.00,43377,43378
54656,2,506,6,256.00,62500.00,43377,43379
54657,1,512,512,512.00,0.00,43378,43379
54658,2,408,104,256.00,23104.00,43378,43380
54659,2,278,234,256.00,484.00,43379,43381
54660,2,412,100,256.00,24336.00,43380,43382
54661,1,512,512,512.00,0.00,43381,43382
54662,3,317,1,170.67,16914.89,43381,43384
54663,5,280,19,102.40,9006.64,43383,43388
54664,2,499,13,256.00,59049.00,43387,43389
54665,3,404,42,170.67,27318.22,43388,43391
54666,1,512,512,512.00,0.00,43390,43391
54667,4,481,1,128.00,41581.50,43390,43394
54668,1,512,512,512.00,0.00,43393,43394
54669,1,512,512,512.00,0.00,43393,43394
54670,2,488,24,256.00,53824.00,43393,43395
54671,1,512,512,512.00,0.00,43394,43395
54672,1,512,512,512.00,0.00,43394,43395
54673,2,440,72,256.00,33856.00,43394,43396
54674,1,512,512,512.00,0.00,43395,43396
54675,1,512,512,512.00,0.00,43395,43396
54676,4,234,47,128.00,5905.50,43395,43399
54677,2,470,42,256.00,45796.00,43398,43400
54678,1,512,512,512.00,0.00,43399,43400
54679,1,512,512,512.00,0.00,43399,43400
54680,3,237,90,170.67,3704.22,43399,43402
54681,7,261,1,73.14,7171.84,43401,43408
54682,1,512,512,512.00,0.00,43407,43408
54683,2,475,37,256.00,47961.00,43407,43409
54684,4,380,1,128.00,21939.50,43408,43412
54685,5,217,24,102.40,7305.04,43411,43416
54686,4,261,1,128.00,10979.50,43415,43419
54687,2,434,78,256.00,31684.00,43418,43420
54688,3,339,50,170.67,15056.22,43419,43422
54689,1,512,512,512.00,0.00,43421,43422
54690,2,351,161,256.00,9025.00,43421,43423
54691,1,512,512,512.00,0.00,43422,43423
54692,1,512,512,512.00,0.00,43422,43423
54693,4,266,24,128.00,9594.00,43422,43426
54694,1,512,512,512.00,0.00,43425,43426
54695,1,512,512,512.00,0.00,43425,43426
54696,1,512,512,512.00,0.00,43425,43426
54697,5,322,1,102.40,16151.44,43425,43430
54698,2,264,248,256.00,64.00,43429,43431
54699,1,512,512,512.00,0.00,43430,43431
54700,1,512,512,512.00,0.00,43430,43431
54701,3,321,48,170.67,12804.22,43430,43433
54702,1,512,512,512.00,0.00,43432,43433
54703,1,512,512,512.00,0.00,43432,43433
54704,2,271,241,256.00,225.00,43432,43434
54705,1,512,512,512.00,0.00,43433,43434
54706,1,512,512,512.00,0.00,43433,43434
54707,1,512,512,512.00,0.00,43433,43434
54708,1,512,512,512.00,0.00,43433,43434
54709,3,195,123,170.67,1136.22,43433,43436
54710,1,512,512,512.00,0.00,43435,43436
54711,1,512,512,512.00,0.00,43435,43436
54712,1,512,512,512.00,0.00,43435,43436
54713,2,314,198,256.00,3364.00,43435,43437
54714,1,512,512,512.00,0.00,43436,43437
54715,1,512,512,512.00,0.00,43436,43437
54716,1,512,512,512.00,0.00,43436,43437
54717,3,305,6,170.67,15360.22,43436,43439
54718,6,252,1,85.33,8009.22,43438,43444
54719,1,512,512,512.00,0.00,43443,43444
54720,1,512,512,512.00,0.00,43443,43444
54721,2,398,114,256.00,20164.00,43443,43445
54722,1,512,512,512.00,0.00,43444,43445
54723,1,512,512,512.00,0.00,43444,43445
54724,4,254,2,128.00,14666.00,43444,43448
54725,1,512,512,512.00,0.00,43447,43448
54726,2,453,59,256.00,38809.00,43447,43449
54727,3,411,9,170.67,30028.22,43448,43451
54728,1,512,512,512.00,0.00,43450,43451
54729,1,512,512,512.00,0.00,43450,43451
54730,1,512,512,512.00,0.00,43450,43451
54731,1,512,512,512.00,0.00,43450,43451
54732,3,269,121,170.67,4834.89,43450,43453
54733,1,512,512,512.00,0.00,43452,43453
54734,1,512,512,512.00,0.00,43452,43453
54735,1,512,512,512.00,0.00,43452,43453
54736,4,294,6,128.00,11364.00,43452,43456
54737,1,512,512,512.00,0.00,43455,43456
54738,1,512,512,512.00,0.00,43455,43456
54739,2,468,44,256.00,44944.00,43455,43457
54740,1,512,512,512.00,0.00,43456,43457
54741,1,512,512,512.00,0.00,43456,43457
54742,6,260,3,85.33,7634.22,43456,43462
54743,2,351,161,256.00,9025.00,43461,43463
54744,2,311,201,256.00,3025.00,43462,43464
54745,1,512,512,512.00,0.00,43463,43464
54746,5,455,1,102.40,31150.24,43463,43468
54747,1,512,512,512.00,0.00,43467,43468
54748,1,512,512,512.00,0.00,43467,43468
54749,1,512,512,512.00,0.00,43467,43468
54750,1,512,512,512.00,0.00,43467,43468
54751,1,512,512,512.00,0.00,43467,43468
54752,1,512,512,512.00,0.00,43467,43468
54753,1,512,512,512.00,0.00,43467,43468
54754,3,506,3,170.67,56224.22,43467,43470
54755,1,512,512,512.00,0.00,43469,43470
54756,4,306,3,128.00,12431.50,43469,43473
54757,1,512,512,512.00,0.00,43472,43473
54758,1,512,512,512.00,0.00,43472,43473
54759,3,231,126,170.67,1960.22,43472,43475
54760,1,512,512,512.00,0.00,43474,43475
54761,1,512,512,512.00,0.00,43474,43475
54762,2,511,1,256.00,65025.00,43474,43476
54763,1,512,512,512.00,0.00,43475,43476
54764,1,512,512,512.00,0.00,43475,43476
54765,1,512,512,512.00,0.00,43475,43476
54766,5,377,2,102.40,19801.04,43475,43480
54767,1,512,512,512.00,0.00,43479,43480
54768,1,512,512,512.00,0.00,43479,43480
54769,5,347,1,102.40,18059.04,43479,43484
54770,2,499,13,256.00,59049.00,43483,43485
54771,1,512,512,512.00,0.00,43484,43485
54772,2,392,120,256.00,18496.00,43484,43486
54773,1,512,512,512.00,0.00,43485,43486
54774,1,512,512,512.00,0.00,43485,43486
54775,2,475,37,256.00,47961.00,43485,43487
54776,1,512,512,512.00,0.00,43486,43487
54777,1,512,512,512.00,0.00,43486,43487
54778,1,512,512,512.00,0.00,43486,43487
54779,2,477,35,256.00,48841.00,43486,43488
54780,3,326,77,170.67,12234.89,43487,43490
54781,2,363,149,256.00,11449.00,43489,43491
54782,2,259,253,256.00,9.00,43490,43492
54783,6,290,1,85.33,11796.56,43491,43497
54784,4,256,1,128.00,8428.50,43496,43500
54785,1,512,512,512.00,0.00,43499,43500
54786,3,468,7,170.67,44353.56,43499,43502
54787,5,313,12,102.40,12297.04,43501,43506
54788,1,512,512,512.00,0.00,43505,43506
54789,1,512,512,512.00,0.00,43505,43506
54790,1,512,512,512.00,0.00,43505,43506
54791,1,512,512,512.00,0.00,43505,43506
54792,2,454,58,256.00,39204.00,43505,43507
54793,1,512,512,512.00,0.00,43506,43507
54794,1,512,512,512.00,0.00,43506,43507
54795,1,512,512,512.00,0.00,43506,43507
54796,4,242,3,128.00,9315.50,43506,43510
54797,6,345,2,85.33,15348.89,43509,43515
54798,5,299,6,102.40,11439.44,43514,43519
54799,1,512,512,512.00,0.00,43518,43519
54800,1,512,512,512.00,0.00,43518,43519
54801,2,277,235,256.00,441.00,43518,43520
54802,2,406,106,256.00,22500.00,43519,43521
54803,2,455,57,256.00,39601.00,43520,43522
54804,4,348,37,128.00,16403.50,43521,43525
54805,6,475,1,85.33,30467.22,43524,43530
54806,1,512,512,512.00,0.00,43529,43530
54807,1,512,512,512.00,0.00,43529,43530
54808,3,393,16,170.67,25977.56,43529,43532
54809,1,512,512,512.00,0.00,43531,43532
54810,2,293,219,256.00,1369.00,43531,43533
54811,3,245,86,170.67,4266.89,43532,43535
54812,2,435,77,256.00,32041.00,43534,43536
54813,5,199,6,102.40,6173.04,43535,43540
54814,1,512,512,512.00,0.00,43539,43540
54815,1,512,512,512.00,0.00,43539,43540
54816,5,281,2,102.40,10129.04,43539,43544
54817,1,512,512,512.00,0.00,43543,43544
54818,1,512,512,512.00,0.00,43543,43544
54819,2,369,143,256.00,12769.00,43543,43545
54820,2,461,51,256.00,42025.00,43544,43546
54821,1,512,512,512.00,0.00,43545,43546
54822,1,512,512,512.00,0.00,43545,43546
54823,1,512,512,512.00,0.00,43545,43546
54824,1,512,512,512.00,0.00,43545,43546
54825,4,333,2,128.00,16795.50,43545,43549
54826,5,320,1,102.40,13729.44,43548,43553
54827,1,512,512,512.00,0.00,43552,43553
54828,1,512,512,512.00,0.00,43552,43553
54829,1,512,512,512.00,0.00,43552,43553
54830,1,512,512,512.00,0.00,43552,43553
54831,2,274,238,256.00,324.00,43552,43554
54832,2,281,231,256.00,625.00,43553,43555
54833,3,263,124,170.67,4262.89,43554,43557
54834,3,329,66,170.67,12968.22,43556,43559
54835,1,512,512,512.00,0.00,43558,43559
54836,1,512,512,512.00,0.00,43558,43559
54837,1,512,512,512.00,0.00,43558,43559
54838,1,512,512,512.00,0.00,43558,43559
54839,2,486,26,256.00,52900.00,43558,43560
54840,5,319,1,102.40,13788.64,43559,43564
54841,1,512,512,512.00,0.00,43563,43564
54842,1,512,512,512.00,0.00,43563,43564
54843,1,512,512,512.00,0.00,43563,43564
54844,4,307,8,128.00,12321.50,43563,43567
54845,1,512,512,512.00,0.00,43566,43567
54846,1,512,512,512.00,0.00,43566,43567
54847,3,316,2,170.67,16704.89,43566,43569
54848,1,512,512,512.00,0.00,43568,43569
54849,1,512,512,512.00,0.00,43568,43569
54850,1,512,512,512.00,0.00,43568,43569
54851,3,302,104,170.67,8624.89,43568,43571
54852,2,295,217,256.00,1521.00,43570,43572
54853,1,512,512,512.00,0.00,43571,43572
54854,3,500,6,170.67,54230.22,43571,43574
54855,3,404,3,170.67,28956.22,43573,43576
54856,2,504,8,256.00,61504.00,43575,43577
54857,1,512,512,512.00,0.00,43576,43577
54858,1,512,512,512.00,0.00,43576,43577
54859,1,512,512,512.00,0.00,43576,43577
54860,3,263,3,170.67,14104.22,43576,43579
54861,1,512,512,512.00,0.00,43578,43579
54862,1,512,512,512.00,0.00,43578,43579
54863,1,512,512,512.00,0.00,43578,43579
54864,2,452,60,256.00,38416.00,43578,43580
54865,10,191,1,51.20,3801.16,43579,43589
54866,1,512,512,512.00,0.00,43588,43589
54867,1,512,512,512.00,0.00,43588,43589
54868,2,481,31,256.00,50625.00,43588,43590
54869,1,512,512,512.00,0.00,43589,43590
54870,1,512,512,512.00,0.00,43589,43590
54871,3,310,60,170.67,10827.56,43589,43592
54872,2,506,6,256.00,62500.00,43591,43593
54873,1,512,512,512.00,0.00,43592,43593
54874,3,408,4,170.67,29699.56,43592,43595
54875,9,187,5,56.89,3219.88,43594,43603
54876,1,512,512,512.00,0.00,43602,43603
54877,2,447,65,256.00,36481.00,43602,43604
54878,5,315,1,102.40,13124.24,43603,43608
54879,1,512,512,512.00,0.00,43607,43608
54880,2,372,140,256.00,13456.00,43607,43609
54881,1,512,512,512.00,0.00,43608,43609
54882,1,512,512,512.00,0.00,43608,43609
54883,1,512,512,512.00,0.00,43608,43609
54884,1,512,512,512.00,0.00,43608,43609
54885,1,512,512,512.00,0.00,43608,43609
54886,4,245,10,128.00,6906.50,43608,43612
54887,5,411,4,102.40,24699.04,43611,43616
54888,1,512,512,512.00,0.00,43615,43616
54889,1,512,512,512.00,0.00,43615,43616
54890,1,512,512,512.00,0.00,43615,43616
54891,2,349,163,256.00,8649.00,43615,43617
54892,1,512,512,512.00,0.00,43616,43617
54893,1,512,512,512.00,0.00,43616,43617
54894,1,512,512,512.00,0.00,43616,43617
54895,2,437,75,256.00,32761.00,43616,43618
54896,1,512,512,512.00,0.00,43617,43618
54897,1,512,512,512.00,0.00,43617,43618
54898,3,341,61,170.67,14906.89,43617,43620
54899,1,512,512,512.00,0.00,43619,43620
54900,1,512,512,512.00,0.00,43619,43620
54901,1,512,512,512.00,0.00,43619,43620
54902,1,512,512,512.00,0.00,43619,43620
54903,1,512,512,512.00,0.00,43619,43620
54904,1,512,512,512.00,0.00,43619,43620
54905,3,241,85,170.67,4173.56,43619,43622
54906,2,375,137,256.00,14161.00,43621,43623
54907,7,262,6,73.14,6577.55,43622,43629
54908,1,512,512,512.00,0.00,43628,43629
54909,1,512,512,512.00,0.00,43628,43629
54910,3,372,1,170.67,23441.56,43628,43631
54911,1,512,512,512.00,0.00,43630,43631
54912,1,512,512,512.00,0.00,43630,43631
54913,1,512,512,512.00,0.00,43630,43631
54914,1,512,512,512.00,0.00,43630,43631
54915,1,512,512,512.00,0.00,43630,43631
54916,4,368,30,128.00,19521.50,43630,43634
54917,1,512,512,512.00,0.00,43633,43634
54918,3,239,42,170.67,8288.22,43633,43636
54919,1,512,512,512.00,0.00,43635,43636
54920,2,317,195,256.00,3721.00,43635,43637
54921,1,512,512,512.00,0.00,43636,43637
54922,3,255,5,170.67,13724.22,43636,43639
54923,1,512,512,512.00,0.00,43638,43639
54924,1,512,512,512.00,0.00,43638,43639
54925,6,133,21,85.33,2101.89,43638,43644
54926,4,308,20,128.00,13016.00,43643,43647
54927,3,390,37,170.67,24437.56,43646,43649
54928,1,512,512,512.00,0.00,43648,43649
54929,1,512,512,512.00,0.00,43648,43649
54930,1,512,512,512.00,0.00,43648,43649
54931,5,282,2,102.40,8909.84,43648,43653
54932,1,512,512,512.00,0.00,43652,43653
54933,3,251,12,170.67,12588.22,43652,43655
54934,1,512,512,512.00,0.00,43654,43655
54935,1,512,512,512.00,0.00,43654,43655
54936,1,512,512,512.00,0.00,43654,43655
54937,3,303,64,170.67,9849.56,43654,43657
54938,1,512,512,512.00,0.00,43656,43657
54939,4,388,19,128.00,22726.50,43656,43660
54940,1,512,512,512.00,0.00,43659,43660
54941,1,512,512,512.00,0.00,43659,43660
54942,1,512,512,512.00,0.00,43659,43660
54943,2,415,97,256.00,25281.00,43659,43661
54944,1,512,512,512.00,0.00,43660,43661
54945,4,410,5,128.00,26914.50,43660,43664
54946,1,512,512,512.00,0.00,43663,43664
54947,1,512,512,512.00,0.00,43663,43664
54948,1,512,512,512.00,0.00,43663,43664
54949,2,416,96,256.00,25600.00,43663,43665
54950,1,512,512,512.00,0.00,43664,43665
54951,2,391,121,256.00,18225.00,43664,43666
54952,6,178,1,85.33,3454.56,43665,43671
54953,1,512,512,512.00,0.00,43670,43671
54954,3,355,28,170.67,18689.56,43670,43673
54955,1,512,512,512.00,0.00,43672,43673
54956,1,512,512,512.00,0.00,43672,43673
54957,1,512,512,512.00,0.00,43672,43673
54958,1,512,512,512.00,0.00,43672,43673
54959,1,512,512,512.00,0.00,43672,43673
54960,2,404,108,256.00,21904.00,43672,43674
54961,1,512,512,512.00,0.00,43673,43674
54962,2,300,212,256.00,1936.00,43673,43675
54963,1,512,512,512.00,0.00,43674,43675
54964,3,486,1,170.67,49813.56,43674,43677
54965,1,512,512,512.00,0.00,43676,43677
54966,1,512,512,512.00,0.00,43676,43677
54967,8,176,2,64.00,3828.25,43676,43684
54968,2,510,2,256.00,64516.00,43683,43685
54969,2,411,101,256.00,24025.00,43684,43686
54970,1,512,512,512.00,0.00,43685,43686
54971,1,512,512,512.00,0.00,43685,43686
54972,1,512,512,512.00,0.00,43685,43686
54973,1,512,512,512.00,0.00,43685,43686
54974,1,512,512,512.00,0.00,43685,43686
54975,1,512,512,512.00,0.00,43685,43686
54976,1,512,512,512.00,0.00,43685,43686
54977,1,512,512,512.00,0.00,43685,43686
54978,1,512,512,512.00,0.00,43685,43686
54979,3,190,148,170.67,299.56,43685,43688
54980,3,336,74,170.67,13798.22,43687,43690
54981,1,512,512,512.00,0.00,43689,43690
54982,1,512,512,512.00,0.00,43689,43690
54983,4,332,20,128.00,15016.50,43689,43693
54984,1,512,512,512.00,0.00,43692,43693
54985,1,512,512,512.00,0.00,43692,43693
54986,1,512,512,512.00,0.00,43692,43693
54987,5,250,1,102.40,14435.44,43692,43697
54988,1,512,512,512.00,0.00,43696,43697
54989,1,512,512,512.00,0.00,43696,43697
54990,3,269,72,170.67,6468.22,43696,43699
54991,1,512,512,512.00,0.00,43698,43699
54992,1,512,512,512.00,0.00,43698,43699
54993,5,376,29,102.40,18742.64,43698,43703
54994,1,512,512,512.00,0.00,43702,43703
54995,1,512,512,512.00,0.00,43702,43703
54996,1,512,512,512.00,0.00,43702,43703
54997,1,512,512,512.00,0.00,43702,43703
54998,2,361,151,256.00,11025.00,43702,43704
54999,5,199,1,102.40,4884.64,43703,43708
55000,1,512,512,512.00,0.00,43707,43708
55001,7,163,12,73.14,3002.41,43707,43714
55002,2,450,62,256.00,37636.00,43713,43715
55003,2,309,203,256.00,2809.00,43714,43716
55004,1,512,512,512.00,0.00,43715,43716
55005,2,263,249,256.00,49.00,43715,43717
55006,1,512,512,512.00,0.00,43716,43717
55007,1,512,512,512.00,0.00,43716,43717
55008,1,512,512,512.00,0.00,43716,43717
55009,3,281,42,170.67,9688.22,43716,43719
55010,1,512,512,512.00,0.00,43718,43719
55011,1,512,512,512.00,0.00,43718,43719
55012,1,512,512,512.00,0.00,43718,43719
55013,3,268,2,170.67,14336.89,43718,43721
55014,2,376,136,256.00,14400.00,43720,43722
55015,1,512,512,512.00,0.00,43721,43722
55016,2,375,137,256.00,14161.00,43721,43723
55017,1,512,512,512.00,0.00,43722,43723
55018,1,512,512,512.00,0.00,43722,43723
55019,1,512,512,512.00,0.00,43722,43723
55020,1,512,512,512.00,0.00,43722,43723
55021,1,512,512,512.00,0.00,43722,43723
55022,1,512,512,512.00,0.00,43722,43723
55023,2,443,69,256.00,34969.00,43722,43724
55024,1,512,512,512.00,0.00,43723,43724
55025,1,512,512,512.00,0.00,43723,43724
55026,3,414,10,170.67,30619.56,43723,43726
55027,1,512,512,512.00,0.00,43725,43726
55028,1,512,512,512.00,0.00,43725,43726
55029,1,512,512,512.00,0.00,43725,43726
55030,2,385,127,256.00,16641.00,43725,43727
55031,5,325,7,102.40,13422.24,43726,43731
55032,2,498,14,256.00,58564.00,43730,43732
55033,6,262,7,85.33,8708.56,43731,43737
55034,1,512,512,512.00,0.00,43736,43737
55035,1,512,512,512.00,0.00,43736,43737
55036,1,512,512,512.00,0.00,43736,43737
55037,1,512,512,512.00,0.00,43736,43737
55038,1,512,512,512.00,0.00,43736,43737
55039,1,512,512,512.00,0.00,43736,43737
55040,1,512,512,512.00,0.00,43736,43737
55041,1,512,512,512.00,0.00,43736,43737
55042,1,512,512,512.00,0.00,43736,43737
55043,2,257,255,256.00,1.00,43736,43738
55044,1,512,512,512.00,0.00,43737,43738
55045,1,512,512,512.00,0.00,43737,43738
55046,1,512,512,512.00,0.00,43737,43738
55047,1,512,512,512.00,0.00,43737,43738
55048,2,382,130,256.00,15876.00,43737,43739
55049,7,175,2,73.14,3571.55,43738,43745
55050,2,405,107,256.00,22201.00,43744,43746
55051,1,512,512,512.00,0.00,43745,43746
55052,1,512,512,512.00,0.00,43745,43746
55053,1,512,512,512.00,0.00,43745,43746
55054,1,512,512,512.00,0.00,43745,43746
55055,1,512,512,512.00,0.00,43745,43746
55056,4,410,2,128.00,27020.00,43745,43749
55057,2,459,53,256.00,41209.00,43748,43750
55058,1,512,512,512.00,0.00,43749,43750
55059,1,512,512,512.00,0.00,43749,43750
55060,1,512,512,512.00,0.00,43749,43750
55061,1,512,512,512.00,0.00,43749,43750
55062,1,512,512,512.00,0.00,43749,43750
55063,2,261,251,256.00,25.00,43749,43751
55064,2,375,137,256.00,14161.00,43750,43752
55065,1,512,512,512.00,0.00,43751,43752
55066,1,512,512,512.00,0.00,43751,43752
55067,3,485,1,170.67,49506.89,43751,43754
55068,1,512,512,512.00,0.00,43754,43755
55069,1,512,512,512.00,0.00,43754,43755
55070,4,376,2,128.00,21686.00,43754,43758
55071,1,512,512,512.00,0.00,43757,43758
55072,1,512,512,512.00,0.00,43757,43758
55073,1,512,512,512.00,0.00,43757,43758
55074,1,512,512,512.00,0.00,43757,43758
55075,1,512,512,512.00,0.00,43757,43758
55076,1,512,512,512.00,0.00,43757,43758
55077,1,512,512,512.00,0.00,43757,43758
55078,1,512,512,512.00,0.00,43757,43758
55079,4,300,8,128.00,12846.50,43757,43761
55080,2,495,17,256.00,57121.00,43760,43762
55081,2,440,72,256.00,33856.00,43761,43763
55082,1,512,512,512.00,0.00,43762,43763
55083,2,326,186,256.00,4900.00,43762,43764
55084,1,512,512,512.00,0.00,43763,43764
55085,2,449,63,256.00,37249.00,43763,43765
55086,2,506,6,256.00,62500.00,43764,43766
55087,4,210,56,128.00,5167.50,43765,43769
55088,1,512,512,512.00,0.00,43768,43769
55089,1,512,512,512.00,0.00,43768,43769
55090,1,512,512,512.00,0.00,43768,43769
55091,1,512,512,512.00,0.00,43768,43769
55092,1,512,512,512.00,0.00,43768,43769
55093,4,187,52,128.00,2980.50,43768,43772
55094,1,512,512,512.00,0.00,43771,43772
55095,1,512,512,512.00,0.00,43771,43772
55096,1,512,512,512.00,0.00,43771,43772
55097,1,512,512,512.00,0.00,43771,43772
55098,1,512,512,512.00,0.00,43771,43772
55099,1,512,512,512.00,0.00,43771,43772
55100,2,455,57,256.00,39601.00,43771,43773
55101,3,364,1,170.67,22241.56,43772,43775
55102,3,298,104,170.67,8112.89,43774,43777
55103,1,512,512,512.00,0.00,43776,43777
55104,3,359,6,170.67,21048.22,43776,43779
55105,3,238,84,170.67,4139.56,43778,43781
55106,1,512,512,512.00,0.00,43780,43781
55107,1,512,512,512.00,0.00,43780,43781
55108,1,512,512,512.00,0.00,43780,43781
55109,2,440,72,256.00,33856.00,43780,43782
55110,2,355,157,256.00,9801.00,43781,43783
55111,1,512,512,512.00,0.00,43782,43783
55112,1,512,512,512.00,0.00,43782,43783
55113,1,512,512,512.00,0.00,43782,43783
55114,1,512,512,512.00,0.00,43782,43783
55115,1,512,512,512.00,0.00,43782,43783
55116,2,318,194,256.00,3844.00,43782,43784
55117,1,512,512,512.00,0.00,43783,43784
55118,1,512,512,512.00,0.00,43783,43784
55119,2,378,134,256.00,14884.00,43783,43785
55120,2,330,182,256.00,5476.00,43784,43786
55121,3,410,41,170.67,28706.89,43785,43788
55122,2,380,132,256.00,15376.00,43787,43789
55123,1,512,512,512.00,0.00,43788,43789
55124,1,512,512,512.00,0.00,43788,43789
55125,2,420,92,256.00,26896.00,43788,43790
55126,2,259,253,256.00,9.00,43789,43791
55127,2,497,15,256.00,58081.00,43790,43792
55128,2,347,165,256.00,8281.00,43791,43793
55129,3,364,18,170.67,20779.56,43792,43795
55130,1,512,512,512.00,0.00,43794,43795
55131,1,512,512,512.00,0.00,43794,43795
55132,1,512,512,512.00,0.00,43794,43795
55133,1,512,512,512.00,0.00,43794,43795
55134,3,428,5,170.67,34022.89,43794,43797
55135,4,411,1,128.00,28248.50,43796,43800
55136,1,512,512,512.00,0.00,43799,43800
55137,1,512,512,512.00,0.00,43799,43800
55138,1,512,512,512.00,0.00,43799,43800
55139,1,512,512,512.00,0.00,43799,43800
55140,1,512,512,512.00,0.00,43799,43800
55141,1,512,512,512.00,0.00,43799,43800
55142,2,454,58,256.00,39204.00,43799,43801
55143,6,313,2,85.33,12079.89,43800,43806
55144,1,512,512,512.00,0.00,43805,43806
55145,2,426,86,256.00,28900.00,43805,43807
55146,5,297,2,102.40,15409.04,43806,43811
55147,2,368,144,256.00,12544.00,43810,43812
55148,1,512,512,512.00,0.00,43811,43812
55149,2,431,81,256.00,30625.00,43811,43813
55150,1,512,512,512.00,0.00,43812,43813
55151,3,361,30,170.67,19493.56,43812,43815
55152,1,512,512,512.00,0.00,43814,43815
55153,1,512,512,512.00,0.00,43814,43815
55154,1,512,512,512.00,0.00,43814,43815
55155,2,504,8,256.00,61504.00,43814,43816
55156,2,503,9,256.00,61009.00,43815,43817
55157,1,512,512,512.00,0.00,43816,43817
55158,1,512,512,512.00,0.00,43816,43817
55159,5,261,1,102.40,8810.24,43816,43821
55160,1,512,512,512.00,0.00,43820,43821
55161,1,512,512,512.00,0.00,43820,43821
55162,2,276,236,256.00,400.00,43820,43822
55163,1,512,512,512.00,0.00,43821,43822
55164,4,382,6,128.00,22420.00,43821,43825
55165,1,512,512,512.00,0.00,43824,43825
55166,1,512,512,512.00,0.00,43824,43825
55167,1,512,512,512.00,0.00,43824,43825
55168,1,512,512,512.00,0.00,43824,43825
55169,3,376,47,170.67,21374.89,43824,43827
55170,3,389,14,170.67,25338.89,43826,43829
55171,1,512,512,512.00,0.00,43828,43829
55172,1,512,512,512.00,0.00,43828,43829
55173,1,512,512,512.00,0.00,43828,43829
55174,1,512,512,512.00,0.00,43828,43829
55175,2,495,17,256.00,57121.00,43828,43830
55176,1,512,512,512.00,0.00,43829,43830
55177,1,512,512,512.00,0.00,43829,43830
55178,1,512,512,512.00,0.00,43829,43830
55179,2,503,9,256.00,61009.00,43829,43831
55180,4,254,18,128.00,7268.00,43830,43834
55181,1,512,512,512.00,0.00,43833,43834
55182,1,512,512,512.00,0.00,43833,43834
55183,1,512,512,512.00,0.00,43833,43834
55184,2,487,25,256.00,53361.00,43833,43835
55185,1,512,512,512.00,0.00,43834,43835
55186,1,512,512,512.00,0.00,43834,43835
55187,1,512,512,512.00,0.00,43834,43835
55188,1,512,512,512.00,0.00,43834,43835
55189,1,512,512,512.00,0.00,43834,43835
55190,1,512,512,512.00,0.00,43834,43835
55191,3,377,1,170.67,24234.89,43834,43837
55192,1,512,512,512.00,0.00,43836,43837
55193,1,512,512,512.00,0.00,43836,43837
55194,1,512,512,512.00,0.00,43836,43837
55195,2,279,233,256.00,529.00,43836,43838
55196,3,321,11,170.67,16060.22,43837,43840
55197,1,512,512,512.00,0.00,43839,43840
55198,4,458,1,128.00,36561.50,43839,43843
55199,2,507,5,256.00,63001.00,43842,43844
55200,1,512,512,512.00,0.00,43843,43844
55201,2,477,35,256.00,48841.00,43843,43845
55202,2,438,74,256.00,33124.00,43844,43846
55203,2,465,47,256.00,43681.00,43845,43847
55204,4,272,59,128.00,7087.50,43846,43850
55205,7,324,1,73.14,11173.55,43849,43856
55206,4,395,3,128.00,25401.00,43855,43859
55207,1,512,512,512.00,0.00,43858,43859
55208,1,512,512,512.00,0.00,43858,43859
55209,1,512,512,512.00,0.00,43858,43859
55210,1,512,512,512.00,0.00,43858,43859
55211,2,328,184,256.00,5184.00,43858,43860
55212,4,454,2,128.00,35636.00,43859,43863
55213,1,512,512,512.00,0.00,43862,43863
55214,4,361,38,128.00,18159.50,43862,43866
55215,1,512,512,512.00,0.00,43865,43866
55216,1,512,512,512.00,0.00,43865,43866
55217,4,288,8,128.00,10400.00,43865,43869
55218,1,512,512,512.00,0.00,43868,43869
55219,1,512,512,512.00,0.00,43868,43869
55220,1,512,512,512.00,0.00,43868,43869
55221,1,512,512,512.00,0.00,43868,43869
55222,1,512,512,512.00,0.00,43868,43869
55223,1,512,512,512.00,0.00,43868,43869
55224,1,512,512,512.00,0.00,43868,43869
55225,2,482,30,256.00,51076.00,43868,43870
55226,1,512,512,512.00,0.00,43869,43870
55227,1,512,512,512.00,0.00,43869,43870
55228,1,512,512,512.00,0.00,43869,43870
55229,1,512,512,512.00,0.00,43869,43870
55230,1,512,512,512.00,0.00,43869,43870
55231,4,251,11,128.00,7521.50,43869,43873
55232,1,512,512,512.00,0.00,43872,43873
55233,1,512,512,512.00,0.00,43872,43873
55234,1,512,512,512.00,0.00,43872,43873
55235,1,512,512,512.00,0.00,43872,43873
55236,1,512,512,512.00,0.00,43872,43873
55237,2,416,96,256.00,25600.00,43872,43874
55238,1,512,512,512.00,0.00,43873,43874
55239,1,512,512,512.00,0.00,43873,43874
55240,3,354,10,170.67,19979.56,43873,43876
55241,1,512,512,512.00,0.00,43875,43876
55242,4,491,2,128.00,43942.50,43875,43879
55243,2,272,240,256.00,256.00,43878,43880
55244,1,512,512,512.00,0.00,43879,43880
55245,5,336,8,102.40,15500.24,43879,43884
55246,6,255,1,85.33,8794.89,43883,43889
55247,3,294,43,170.67,10509.56,43888,43891
55248,1,512,512,512.00,0.00,43890,43891
55249,3,397,22,170.67,26453.56,43890,43893
55250,1,512,512,512.00,0.00,43892,43893
55251,7,164,1,73.14,3730.41,43892,43899
55252,3,494,1,170.67,52314.89,43898,43901
55253,8,372,1,64.00,14446.25,43900,43908
55254,1,512,512,512.00,0.00,43907,43908
55255,1,512,512,512.00,0.00,43907,43908
55256,4,444,9,128.00,33355.50,43907,43911
55257,4,404,34,128.00,25394.00,43910,43914
55258,3,412,2,170.67,30656.89,43913,43916
55259,1,512,512,512.00,0.00,43915,43916
55260,1,512,512,512.00,0.00,43915,43916
55261,2,350,162,256.00,8836.00,43915,43917
55262,1,512,512,512.00,0.00,43916,43917
55263,5,279,1,102.40,9495.04,43916,43921
55264,2,277,235,256.00,441.00,43920,43922
55265,3,467,2,170.67,44186.89,43921,43924
55266,4,365,33,128.00,18819.50,43923,43927
55267,1,512,512,512.00,0.00,43926,43927
55268,1,512,512,512.00,0.00,43926,43927
55269,1,512,512,512.00,0.00,43926,43927
55270,1,512,512,512.00,0.00,43926,43927
55271,1,512,512,512.00,0.00,43926,43927
55272,1,512,512,512.00,0.00,43926,43927
55273,1,512,512,512.00,0.00,43926,43927
55274,5,351,1,102.40,17906.24,43926,43931
55275,3,253,46,170.67,8037.56,43930,43933
55276,1,512,512,512.00,0.00,43932,43933
55277,2,481,31,256.00,50625.00,43932,43934
55278,2,387,125,256.00,17161.00,43933,43935
55279,1,512,512,512.00,0.00,43934,43935
55280,1,512,512,512.00,0.00,43934,43935
55281,2,331,181,256.00,5625.00,43934,43936
55282,5,302,18,102.40,10549.04,43935,43940
55283,2,505,7,256.00,62001.00,43939,43941
55284,1,512,512,512.00,0.00,43940,43941
55285,1,512,512,512.00,0.00,43940,43941
55286,1,512,512,512.00,0.00,43940,43941
55287,1,512,512,512.00,0.00,43940,43941
55288,1,512,512,512.00,0.00,43940,43941
55289,3,223,133,170.67,1457.56,43940,43943
55290,3,250,87,170.67,4437.56,43942,43945
55291,6,426,1,85.33,23861.56,43944,43950
55292,1,512,512,512.00,0.00,43949,43950
55293,1,512,512,512.00,0.00,43949,43950
55294,1,512,512,512.00,0.00,43949,43950
55295,1,512,512,512.00,0.00,43949,43950
55296,1,512,512,512.00,0.00,43949,43950
55297,1,512,512,512.00,0.00,43949,43950
55298,1,512,512,512.00,0.00,43949,43950
55299,2,317,195,256.00,3721.00,43949,43951
55300,1,512,512,512.00,0.00,43950,43951
55301,1,512,512,512.00,0.00,43950,43951
55302,1,512,512,512.00,0.00,43950,43951
55303,1,512,512,512.00,0.00,43950,43951
55304,1,512,512,512.00,0.00,43950,43951
55305,1,512,512,512.00,0.00,43950,43951
55306,1,512,512,512.00,0.00,43950,43951
55307,1,512,512,512.00,0.00,43950,43951
55308,1,512,512,512.00,0.00,43950,43951
55309,1,512,512,512.00,0.00,43950,43951
55310,1,512,512,512.00,0.00,43950,43951
55311,4,343,34,128.00,16060.50,43950,43954
55312,2,465,47,256.00,43681.00,43953,43955
55313,1,512,512,512.00,0.00,43954,43955
55314,2,420,92,256.00,26896.00,43954,43956
55315,1,512,512,512.00,0.00,43955,43956
55316,4,330,1,128.00,18257.50,43955,43959
55317,1,512,512,512.00,0.00,43958,43959
55318,2,509,3,256.00,64009.00,43958,43960
55319,1,512,512,512.00,0.00,43959,43960
55320,3,377,50,170.67,21490.89,43959,43962
55321,1,512,512,512.00,0.00,43961,43962
55322,3,276,1,170.67,14673.56,43961,43964
55323,3,252,31,170.67,9841.56,43963,43966
55324,3,256,2,170.67,14224.89,43965,43968
55325,1,512,512,512.00,0.00,43967,43968
55326,1,512,512,512.00,0.00,43967,43968
55327,2,408,104,256.00,23104.00,43967,43969
55328,1,512,512,512.00,0.00,43968,43969
55329,1,512,512,512.00,0.00,43968,43969
55330,1,512,512,512.00,0.00,43968,43969
55331,1,512,512,512.00,0.00,43968,43969
55332,1,512,512,512.00,0.00,43968,43969
55333,1,512,512,512.00,0.00,43968,43969
55334,2,369,143,256.00,12769.00,43968,43970
55335,2,355,157,256.00,9801.00,43969,43971
55336,4,488,1,128.00,43263.50,43970,43974
55337,2,371,141,256.00,13225.00,43973,43975
55338,3,421,35,170.67,31406.89,43974,43977
55339,2,395,117,256.00,19321.00,43976,43978
55340,2,449,63,256.00,37249.00,43977,43979
55341,1,512,512,512.00,0.00,43978,43979
55342,2,297,215,256.00,1681.00,43978,43980
55343,2,474,38,256.00,47524.00,43979,43981
55344,1,512,512,512.00,0.00,43980,43981
55345,1,512,512,512.00,0.00,43980,43981
55346,1,512,512,512.00,0.00,43980,43981
55347,1,512,512,512.00,0.00,43980,43981
55348,3,367,2,170.67,22586.89,43980,43983
55349,1,512,512,512.00,0.00,43982,43983
55350,4,271,3,128.00,9119.50,43982,43986
55351,1,512,512,512.00,0.00,43985,43986
55352,3,398,36,170.67,26134.22,43985,43988
55353,4,347,19,128.00,16485.50,43987,43991
55354,1,512,512,512.00,0.00,43990,43991
55355,1,512,512,512.00,0.00,43990,43991
55356,1,512,512,512.00,0.00,43990,43991
55357,2,390,122,256.00,17956.00,43990,43992
55358,1,512,512,512.00,0.00,43991,43992
55359,2,388,124,256.00,17424.00,43991,43993
55360,1,512,512,512.00,0.00,43992,43993
55361,1,512,512,512.00,0.00,43992,43993
55362,1,512,512,512.00,0.00,43992,43993
55363,1,512,512,512.00,0.00,43992,43993
55364,2,395,117,256.00,19321.00,43992,43994
55365,2,434,78,256.00,31684.00,43993,43995
55366,1,512,512,512.00,0.00,43994,43995
55367,1,512,512,512.00,0.00,43994,43995
55368,1,512,512,512.00,0.00,43994,43995
55369,1,512,512,512.00,0.00,43994,43995
55370,3,296,65,170.67,9086.89,43994,43997
55371,4,378,11,128.00,21489.50,43996,44000
55372,2,508,4,256.00,63504.00,43999,44001
55373,2,310,202,256.00,2916.00,44000,44002
55374,4,262,7,128.00,13735.50,44001,44005
55375,1,512,512,512.00,0.00,44004,44005
55376,2,461,51,256.00,42025.00,44004,44006
55377,1,512,512,512.00,0.00,44005,44006
55378,1,512,512,512.00,0.00,44005,44006
55379,4,283,3,128.00,12009.50,44005,44009
55380,1,512,512,512.00,0.00,44008,44009
55381,1,512,512,512.00,0.00,44008,44009
55382,2,455,57,256.00,39601.00,44008,44010
55383,3,312,6,170.67,15878.22,44009,44012
55384,1,512,512,512.00,0.00,44011,44012
55385,1,512,512,512.00,0.00,44011,44012
55386,1,512,512,512.00,0.00,44011,44012
55387,3,320,31,170.67,13966.89,44011,44014
55388,1,512,512,512.00,0.00,44013,44014
55389,1,512,512,512.00,0.00,44013,44014
55390,3,416,44,170.67,30104.89,44013,44016
55391,1,512,512,512.00,0.00,44015,44016
55392,1,512,512,512.00,0.00,44015,44016
55393,1,512,512,512.00,0.00,44015,44016
55394,3,423,7,170.67,32773.56,44015,44018
55395,3,277,95,170.67,5990.89,44017,44020
55396,2,269,243,256.00,169.00,44019,44021
55397,3,460,26,170.67,41856.89,44020,44023
55398,1,512,512,512.00,0.00,44022,44023
55399,1,512,512,512.00,0.00,44022,44023
55400,1,512,512,512.00,0.00,44022,44023
55401,1,512,512,512.00,0.00,44022,44023
55402,1,512,512,512.00,0.00,44022,44023
55403,3,354,28,170.67,18539.56,44022,44025
55404,1,512,512,512.00,0.00,44024,44025
55405,1,512,512,512.00,0.00,44024,44025
55406,4,311,30,128.00,12579.50,44024,44028
55407,1,512,512,512.00,0.00,44027,44028
55408,2,435,77,256.00,32041.00,44027,44029
55409,2,339,173,256.00,6889.00,44028,44030
55410,1,512,512,512.00,0.00,44029,44030
55411,1,512,512,512.00,0.00,44029,44030
55412,1,512,512,512.00,0.00,44029,44030
55413,1,512,512,512.00,0.00,44029,44030
55414,1,512,512,512.00,0.00,44029,44030
55415,1,512,512,512.00,0.00,44029,44030
55416,1,512,512,512.00,0.00,44029,44030
55417,1,512,512,512.00,0.00,44029,44030
55418,1,512,512,512.00,0.00,44029,44030
55419,3,302,38,170.67,11616.89,44029,44032
55420,1,512,512,512.00,0.00,44031,44032
55421,2,509,3,256.00,64009.00,44031,44033
55422,2,312,200,256.00,3136.00,44032,44034
55423,1,512,512,512.00,0.00,44033,44034
55424,4,242,26,128.00,10286.00,44033,44037
55425,2,333,179,256.00,5929.00,44036,44038
55426,1,512,512,512.00,0.00,44037,44038
55427,1,512,512,512.00,0.00,44037,44038
55428,1,512,512,512.00,0.00,44037,44038
55429,2,345,167,256.00,7921.00,44037,44039
55430,1,512,512,512.00,0.00,44038,44039
55431,2,357,155,256.00,10201.00,44038,44040
55432,1,512,512,512.00,0.00,44039,44040
55433,1,512,512,512.00,0.00,44039,44040
55434,1,512,512,512.00,0.00,44039,44040
55435,1,512,512,512.00,0.00,44039,44040
55436,1,512,512,512.00,0.00,44039,44040
55437,1,512,512,512.00,0.00,44039,44040
55438,5,352,1,102.40,17151.84,44039,44044
55439,1,512,512,512.00,0.00,44043,44044
55440,1,512,512,512.00,0.00,44043,44044
55441,1,512,512,512.00,0.00,44043,44044
55442,1,512,512,512.00,0.00,44043,44044
55443,1,512,512,512.00,0.00,44043,44044
55444,1,512,512,512.00,0.00,44043,44044
55445,1,512,512,512.00,0.00,44043,44044
55446,2,338,174,256.00,6724.00,44043,44045
55447,2,465,47,256.00,43681.00,44044,44046
55448,1,512,512,512.00,0.00,44045,44046
55449,1,512,512,512.00,0.00,44045,44046
55450,1,512,512,512.00,0.00,44045,44046
55451,1,512,512,512.00,0.00,44045,44046
55452,2,267,245,256.00,121.00,44045,44047
55453,1,512,512,512.00,0.00,44046,44047
55454,1,512,512,512.00,0.00,44046,44047
55455,1,512,512,512.00,0.00,44046,44047
55456,2,282,230,256.00,676.00,44046,44048
55457,1,512,512,512.00,0.00,44047,44048
55458,1,512,512,512.00,0.00,44047,44048
55459,4,393,8,128.00,24084.50,44047,44051
55460,2,380,132,256.00,15376.00,44050,44052
55461,2,356,156,256.00,10000.00,44051,44053
55462,2,270,242,256.00,196.00,44052,44054
55463,1,512,512,512.00,0.00,44053,44054
55464,3,320,46,170.67,12816.89,44053,44056
55465,4,168,103,128.00,620.50,44055,44059
55466,1,512,512,512.00,0.00,44058,44059
55467,1,512,512,512.00,0.00,44058,44059
55468,2,456,56,256.00,40000.00,44058,44060
55469,1,512,512,512.00,0.00,44059,44060
55470,2,409,103,256.00,23409.00,44059,44061
55471,1,512,512,512.00,0.00,44060,44061
55472,1,512,512,512.00,0.00,44060,44061
55473,1,512,512,512.00,0.00,44060,44061
55474,1,512,512,512.00,0.00,44060,44061
55475,1,512,512,512.00,0.00,44060,44061
55476,2,273,239,256.00,289.00,44060,44062
55477,2,322,190,256.00,4356.00,44061,44063
55478,1,512,512,512.00,0.00,44062,44063
55479,1,512,512,512.00,0.00,44062,44063
55480,1,512,512,512.00,0.00,44062,44063
55481,3,329,84,170.67,12572.22,44062,44065
55482,2,487,25,256.00,53361.00,44064,44066
55483,3,363,1,170.67,22097.56,44065,44068
55484,1,512,512,512.00,0.00,44067,44068
55485,1,512,512,512.00,0.00,44067,44068
55486,1,512,512,512.00,0.00,44067,44068
55487,1,512,512,512.00,0.00,44067,44068
55488,1,512,512,512.00,0.00,44067,44068
55489,1,512,512,512.00,0.00,44067,44068
55490,1,512,512,512.00,0.00,44067,44068
55491,1,512,512,512.00,0.00,44067,44068
55492,1,512,512,512.00,0.00,44067,44068
55493,1,512,512,512.00,0.00,44067,44068
55494,4,308,7,128.00,13141.50,44067,44071
55495,1,512,512,512.00,0.00,44070,44071
55496,1,512,512,512.00,0.00,44070,44071
55497,2,406,106,256.00,22500.00,44070,44072
55498,3,383,36,170.67,23084.22,44071,44074
55499,1,512,512,512.00,0.00,44073,44074
55500,1,512,512,512.00,0.00,44073,44074
55501,1,512,512,512.00,0.00,44073,44074
55502,1,512,512,512.00,0.00,44073,44074
55503,1,512,512,512.00,0.00,44073,44074
55504,1,512,512,512.00,0.00,44073,44074
55505,1,512,512,512.00,0.00,44073,44074
55506,4,358,29,128.00,17848.50,44073,44077
55507,4,254,62,128.00,5520.50,44076,44080
55508,1,512,512,512.00,0.00,44079,44080
55509,1,512,512,512.00,0.00,44079,44080
55510,3,282,56,170.67,8518.22,44079,44082
55511,2,381,131,256.00,15625.00,44081,44083
55512,2,504,8,256.00,61504.00,44082,44084
55513,4,323,2,128.00,16845.50,44083,44087
55514,1,512,512,512.00,0.00,44086,44087
55515,1,512,512,512.00,0.00,44086,44087
55516,1,512,512,512.00,0.00,44086,44087
55517,3,381,7,170.67,24401.56,44086,44089
55518,1,512,512,512.00,0.00,44088,44089
55519,2,344,168,256.00,7744.00,44088,44090
55520,1,512,512,512.00,0.00,44089,44090
55521,1,512,512,512.00,0.00,44089,44090
55522,2,446,66,256.00,36100.00,44089,44091
55523,3,321,34,170.67,13821.56,44090,44093
55524,1,512,512,512.00,0.00,44092,44093
55525,2,445,67,256.00,35721.00,44092,44094
55526,1,512,512,512.00,0.00,44093,44094
55527,1,512,512,512.00,0.00,44093,44094
55528,1,512,512,512.00,0.00,44093,44094
55529,1,512,512,512.00,0.00,44093,44094
55530,4,366,3,128.00,21941.50,44093,44097
55531,1,512,512,512.00,0.00,44096,44097
55532,1,512,512,512.00,0.00,44096,44097
55533,1,512,512,512.00,0.00,44096,44097
55534,1,512,512,512.00,0.00,44096,44097
55535,2,422,90,256.00,27556.00,44096,44098
55536,1,512,512,512.00,0.00,44097,44098
55537,3,446,1,170.67,38586.89,44097,44100
55538,2,505,7,256.00,62001.00,44099,44101
55539,1,512,512,512.00,0.00,44100,44101
55540,1,512,512,512.00,0.00,44100,44101
55541,1,512,512,512.00,0.00,44100,44101
55542,2,309,203,256.00,2809.00,44100,44102
55543,1,512,512,512.00,0.00,44101,44102
55544,1,512,512,512.00,0.00,44101,44102
55545,1,512,512,512.00,0.00,44101,44102
55546,2,307,205,256.00,2601.00,44101,44103
55547,2,424,88,256.00,28224.00,44102,44104
55548,2,367,145,256.00,12321.00,44103,44105
55549,2,465,47,256.00,43681.00,44104,44106
55550,1,512,512,512.00,0.00,44105,44106
55551,2,403,109,256.00,21609.00,44105,44107
55552,1,512,512,512.00,0.00,44106,44107
55553,1,512,512,512.00,0.00,44106,44107
55554,1,512,512,512.00,0.00,44106,44107
55555,1,512,512,512.00,0.00,44106,44107
55556,1,512,512,512.00,0.00,44106,44107
55557,1,512,512,512.00,0.00,44106,44107
55558,1,512,512,512.00,0.00,44106,44107
55559,1,512,512,512.00,0.00,44106,44107
55560,5,263,2,102.40,12544.64,44106,44111
55561,1,512,512,512.00,0.00,44110,44111
55562,1,512,512,512.00,0.00,44110,44111
55563,7,191,8,73.14,4247.84,44110,44117
55564,7,357,1,73.14,13841.84,44116,44123
55565,1,512,512,512.00,0.00,44122,44123
55566,1,512,512,512.00,0.00,44122,44123
55567,1,512,512,512.00,0.00,44122,44123
55568,1,512,512,512.00,0.00,44122,44123
55569,1,512,512,512.00,0.00,44122,44123
55570,1,512,512,512.00,0.00,44122,44123
55571,3,248,17,170.67,11806.89,44122,44125
55572,1,512,512,512.00,0.00,44124,44125
55573,2,298,214,256.00,1764.00,44124,44126
55574,1,512,512,512.00,0.00,44125,44126
55575,1,512,512,512.00,0.00,44125,44126
55576,2,482,30,256.00,51076.00,44125,44127
55577,1,512,512,512.00,0.00,44126,44127
55578,1,512,512,512.00,0.00,44126,44127
55579,2,460,52,256.00,41616.00,44126,44128
55580,2,339,173,256.00,6889.00,44127,44129
55581,1,512,512,512.00,0.00,44128,44129
55582,2,307,205,256.00,2601.00,44128,44130
55583,1,512,512,512.00,0.00,44129,44130
55584,1,512,512,512.00,0.00,44129,44130
55585,7,255,1,73.14,7633.27,44129,44136
55586,5,369,1,102.40,19591.04,44135,44140
55587,1,512,512,512.00,0.00,44139,44140
55588,1,512,512,512.00,0.00,44139,44140
55589,1,512,512,512.00,0.00,44139,44140
55590,1,512,512,512.00,0.00,44139,44140
55591,1,512,512,512.00,0.00,44139,44140
55592,1,512,512,512.00,0.00,44139,44140
55593,1,512,512,512.00,0.00,44139,44140
55594,1,512,512,512.00,0.00,44139,44140
55595,3,366,21,170.67,20880.22,44139,44142
55596,1,512,512,512.00,0.00,44141,44142
55597,1,512,512,512.00,0.00,44141,44142
55598,1,512,512,512.00,0.00,44141,44142
55599,1,512,512,512.00,0.00,44141,44142
55600,2,390,122,256.00,17956.00,44141,44143
55601,1,512,512,512.00,0.00,44142,44143
55602,1,512,512,512.00,0.00,44142,44143
55603,1,512,512,512.00,0.00,44142,44143
55604,5,182,7,102.40,5789.04,44142,44147
55605,2,310,202,256.00,2916.00,44146,44148
55606,3,435,15,170.67,35304.22,44147,44150
55607,1,512,512,512.00,0.00,44149,44150
55608,1,512,512,512.00,0.00,44149,44150
55609,1,512,512,512.00,0.00,44149,44150
55610,1,512,512,512.00,0.00,44149,44150
55611,3,446,12,170.67,38198.22,44149,44152
55612,3,423,24,170.67,32116.22,44151,44154
55613,8,309,1,64.00,9754.25,44153,44161
55614,1,512,512,512.00,0.00,44160,44161
55615,2,350,162,256.00,8836.00,44160,44162
55616,1,512,512,512.00,0.00,44161,44162
55617,2,410,102,256.00,23716.00,44161,44163
55618,3,314,9,170.67,15672.22,44162,44165
55619,3,351,41,170.67,17300.22,44164,44167
55620,1,512,512,512.00,0.00,44166,44167
55621,1,512,512,512.00,0.00,44166,44167
55622,1,512,512,512.00,0.00,44166,44167
55623,1,512,512,512.00,0.00,44166,44167
55624,2,303,209,256.00,2209.00,44166,44168
55625,7,278,7,73.14,8095.55,44167,44174
55626,2,468,44,256.00,44944.00,44173,44175
55627,1,512,512,512.00,0.00,44174,44175
55628,1,512,512,512.00,0.00,44174,44175
55629,1,512,512,512.00,0.00,44174,44175
55630,4,261,1,128.00,8971.00,44174,44178
55631,1,512,512,512.00,0.00,44177,44178
55632,2,448,64,256.00,36864.00,44177,44179
55633,4,481,3,128.00,41606.50,44178,44182
55634,2,511,1,256.00,65025.00,44181,44183
55635,1,512,512,512.00,0.00,44182,44183
55636,1,512,512,512.00,0.00,44182,44183
55637,1,512,512,512.00,0.00,44182,44183
55638,1,512,512,512.00,0.00,44182,44183
55639,1,512,512,512.00,0.00,44182,44183
55640,1,512,512,512.00,0.00,44182,44183
55641,1,512,512,512.00,0.00,44182,44183
55642,1,512,512,512.00,0.00,44182,44183
55643,2,383,129,256.00,16129.00,44182,44184
55644,3,471,6,170.67,45240.22,44183,44186
55645,1,512,512,512.00,0.00,44185,44186
55646,2,284,228,256.00,784.00,44185,44187
55647,1,512,512,512.00,0.00,44186,44187
55648,1,512,512,512.00,0.00,44186,44187
55649,1,512,512,512.00,0.00,44186,44187
55650,1,512,512,512.00,0.00,44186,44187
55651,1,512,512,512.00,0.00,44186,44187
55652,1,512,512,512.00,0.00,44186,44187
55653,2,341,171,256.00,7225.00,44186,44188
55654,2,420,92,256.00,26896.00,44187,44189
55655,4,408,1,128.00,27261.50,44188,44192
55656,1,512,512,512.00,0.00,44191,44192
55657,1,512,512,512.00,0.00,44191,44192
55658,1,512,512,512.00,0.00,44191,44192
55659,2,374,138,256.00,13924.00,44191,44193
55660,1,512,512,512.00,0.00,44192,44193
55661,1,512,512,512.00,0.00,44192,44193
55662,1,512,512,512.00,0.00,44192,44193
55663,2,316,196,256.00,3600.00,44192,44194
55664,1,512,512,512.00,0.00,44193,44194
55665,1,512,512,512.00,0.00,44193,44194
55666,2,350,162,256.00,8836.00,44193,44195
55667,1,512,512,512.00,0.00,44194,44195
55668,1,512,512,512.00,0.00,44194,44195
55669,3,279,76,170.67,6961.56,44194,44197
55670,1,512,512,512.00,0.00,44196,44197
55671,1,512,512,512.00,0.00,44196,44197
55672,1,512,512,512.00,0.00,44196,44197
55673,1,512,512,512.00,0.00,44196,44197
55674,4,436,3,128.00,31944.50,44197,44201
55675,1,512,512,512.00,0.00,44200,44201
55676,1,512,512,512.00,0.00,44200,44201
55677,4,311,19,128.00,12155.00,44200,44204
55678,1,512,512,512.00,0.00,44203,44204
55679,2,495,17,256.00,57121.00,44203,44205
55680,3,309,45,170.67,11696.22,44204,44207
55681,1,512,512,512.00,0.00,44206,44207
55682,3,236,110,170.67,2656.89,44206,44209
55683,1,512,512,512.00,0.00,44208,44209
55684,2,333,179,256.00,5929.00,44208,44210
55685,4,326,2,128.00,18116.00,44209,44213
55686,2,395,117,256.00,19321.00,44212,44214
55687,3,204,113,170.67,1676.22,44213,44216
55688,5,235,8,102.40,6517.04,44215,44220
55689,1,512,512,512.00,0.00,44219,44220
55690,1,512,512,512.00,0.00,44219,44220
55691,1,512,512,512.00,0.00,44219,44220
55692,1,512,512,512.00,0.00,44219,44220
55693,2,298,214,256.00,1764.00,44219,44221
55694,3,401,7,170.67,28094.89,44220,44223
55695,1,512,512,512.00,0.00,44222,44223
55696,1,512,512,512.00,0.00,44222,44223
55697,1,512,512,512.00,0.00,44222,44223
55698,5,230,4,102.40,5511.44,44222,44227
55699,2,423,89,256.00,27889.00,44226,44228
55700,1,512,512,512.00,0.00,44227,44228
55701,1,512,512,512.00,0.00,44227,44228
55702,2,483,29,256.00,51529.00,44227,44229
55703,3,500,5,170.67,54230.89,44228,44231
55704,1,512,512,512.00,0.00,44230,44231
55705,3,445,1,170.67,38333.56,44230,44233
55706,4,256,9,128.00,8276.50,44232,44236
55707,9,254,2,56.89,5622.54,44235,44244
55708,2,361,151,256.00,11025.00,44243,44245
55709,3,494,2,170.67,52304.89,44244,44247
55710,1,512,512,512.00,0.00,44246,44247
55711,1,512,512,512.00,0.00,44246,44247
55712,4,283,1,128.00,11818.50,44246,44250
55713,3,214,113,170.67,1802.89,44249,44252
55714,2,490,22,256.00,54756.00,44251,44253
55715,1,512,512,512.00,0.00,44252,44253
55716,1,512,512,512.00,0.00,44252,44253
55717,1,512,512,512.00,0.00,44252,44253
55718,2,296,216,256.00,1600.00,44252,44254
55719,2,294,218,256.00,1444.00,44253,44255
55720,1,512,512,512.00,0.00,44254,44255
55721,1,512,512,512.00,0.00,44254,44255
55722,1,512,512,512.00,0.00,44254,44255
55723,3,250,17,170.67,11810.89,44254,44257
55724,2,506,6,256.00,62500.00,44256,44258
55725,3,326,4,170.67,17344.89,44257,44260
55726,3,271,3,170.67,14237.56,44259,44262
55727,1,512,512,512.00,0.00,44261,44262
55728,1,512,512,512.00,0.00,44261,44262
55729,4,273,8,128.00,9600.50,44261,44265
55730,2,277,235,256.00,441.00,44264,44266
55731,4,268,1,128.00,9073.50,44265,44269
55732,1,512,512,512.00,0.00,44268,44269
55733,2,345,167,256.00,7921.00,44268,44270
55734,1,512,512,512.00,0.00,44269,44270
55735,1,512,512,512.00,0.00,44269,44270
55736,1,512,512,512.00,0.00,44269,44270
55737,4,307,50,128.00,10809.50,44269,44273
55738,6,281,10,85.33,8564.56,44272,44278
55739,2,470,42,256.00,45796.00,44277,44279
55740,2,289,223,256.00,1089.00,44278,44280
55741,2,332,180,256.00,5776.00,44279,44281
55742,2,504,8,256.00,61504.00,44280,44282
55743,2,465,47,256.00,43681.00,44281,44283
55744,2,445,67,256.00,35721.00,44282,44284
55745,1,512,512,512.00,0.00,44283,44284
55746,1,512,512,512.00,0.00,44283,44284
55747,2,418,94,256.00,26244.00,44283,44285
55748,2,480,32,256.00,50176.00,44284,44286
55749,2,278,234,256.00,484.00,44285,44287
55750,3,375,41,170.67,21380.22,44286,44289
55751,1,512,512,512.00,0.00,44288,44289
55752,2,283,229,256.00,729.00,44288,44290
55753,1,512,512,512.00,0.00,44289,44290
55754,1,512,512,512.00,0.00,44289,44290
55755,1,512,512,512.00,0.00,44289,44290
55756,1,512,512,512.00,0.00,44289,44290
55757,1,512,512,512.00,0.00,44289,44290
55758,1,512,512,512.00,0.00,44289,44290
55759,2,345,167,256.00,7921.00,44289,44291
55760,2,319,193,256.00,3969.00,44290,44292
55761,1,512,512,512.00,0.00,44291,44292
55762,1,512,512,512.00,0.00,44291,44292
55763,1,512,512,512.00,0.00,44291,44292
55764,2,471,41,256.00,46225.00,44291,44293
55765,1,512,512,512.00,0.00,44292,44293
55766,1,512,512,512.00,0.00,44292,44293
55767,3,259,1,170.67,14401.56,44292,44295
55768,3,277,1,170.67,14701.56,44294,44297
55769,4,213,8,128.00,6505.50,44296,44300
55770,1,512,512,512.00,0.00,44299,44300
55771,2,310,202,256.00,2916.00,44299,44301
55772,1,512,512,512.00,0.00,44300,44301
55773,1,512,512,512.00,0.00,44300,44301
55774,4,220,7,128.00,5882.50,44300,44304
55775,1,512,512,512.00,0.00,44303,44304
55776,3,279,1,170.67,14761.56,44303,44306
55777,1,512,512,512.00,0.00,44305,44306
55778,3,308,79,170.67,9782.89,44305,44308
55779,1,512,512,512.00,0.00,44307,44308
55780,3,231,61,170.67,6033.56,44307,44310
55781,1,512,512,512.00,0.00,44309,44310
55782,4,385,4,128.00,23945.50,44309,44313
55783,1,512,512,512.00,0.00,44312,44313
55784,4,350,2,128.00,20484.00,44312,44316
55785,2,330,182,256.00,5476.00,44315,44317
55786,3,413,5,170.67,30682.89,44316,44319
55787,1,512,512,512.00,0.00,44318,44319
55788,2,496,16,256.00,57600.00,44318,44320
55789,1,512,512,512.00,0.00,44319,44320
55790,1,512,512,512.00,0.00,44319,44320
55791,3,443,5,170.67,37662.89,44319,44322
55792,2,387,125,256.00,17161.00,44321,44323
55793,2,271,241,256.00,225.00,44322,44324
55794,1,512,512,512.00,0.00,44323,44324
55795,1,512,512,512.00,0.00,44323,44324
55796,2,433,79,256.00,31329.00,44323,44325
55797,1,512,512,512.00,0.00,44324,44325
55798,1,512,512,512.00,0.00,44324,44325
55799,1,512,512,512.00,0.00,44324,44325
55800,4,267,19,128.00,9961.00,44324,44328
55801,2,375,137,256.00,14161.00,44327,44329
55802,2,442,70,256.00,34596.00,44328,44330
55803,3,299,24,170.67,12772.22,44329,44332
55804,2,501,11,256.00,60025.00,44331,44333
55805,2,341,171,256.00,7225.00,44332,44334
55806,2,346,166,256.00,8100.00,44333,44335
55807,1,512,512,512.00,0.00,44334,44335
55808,1,512,512,512.00,0.00,44334,44335
55809,2,271,241,256.00,225.00,44334,44336
55810,3,368,1,170.67,22830.89,44335,44338
55811,2,405,107,256.00,22201.00,44337,44339
55812,2,463,49,256.00,42849.00,44338,44340
55813,1,512,512,512.00,0.00,44339,44340
55814,1,512,512,512.00,0.00,44339,44340
55815,1,512,512,512.00,0.00,44339,44340
55816,1,512,512,512.00,0.00,44339,44340
55817,1,512,512,512.00,0.00,44339,44340
55818,2,422,90,256.00,27556.00,44339,44341
55819,1,512,512,512.00,0.00,44340,44341
55820,3,290,17,170.67,13010.89,44340,44343
55821,2,419,93,256.00,26569.00,44342,44344
55822,3,308,8,170.67,15320.89,44343,44346
55823,1,512,512,512.00,0.00,44345,44346
55824,1,512,512,512.00,0.00,44345,44346
55825,1,512,512,512.00,0.00,44345,44346
55826,2,415,97,256.00,25281.00,44345,44347
55827,1,512,512,512.00,0.00,44346,44347
55828,3,233,98,170.67,3090.89,44346,44349
55829,1,512,512,512.00,0.00,44348,44349
55830,1,512,512,512.00,0.00,44348,44349
55831,1,512,512,512.00,0.00,44348,44349
55832,3,230,114,170.67,2246.22,44348,44351
55833,1,512,512,512.00,0.00,44350,44351
55834,1,512,512,512.00,0.00,44350,44351
55835,2,300,212,256.00,1936.00,44350,44352
55836,1,512,512,512.00,0.00,44351,44352
55837,3,499,3,170.67,53909.56,44351,44354
55838,1,512,512,512.00,0.00,44353,44354
55839,1,512,512,512.00,0.00,44353,44354
55840,2,433,79,256.00,31329.00,44353,44355
55841,2,268,244,256.00,144.00,44354,44356
55842,4,352,36,128.00,16838.50,44355,44359
55843,1,512,512,512.00,0.00,44358,44359
55844,1,512,512,512.00,0.00,44358,44359
55845,1,512,512,512.00,0.00,44358,44359
55846,2,482,30,256.00,51076.00,44358,44360
55847,2,360,152,256.00,10816.00,44359,44361
55848,1,512,512,512.00,0.00,44360,44361
55849,1,512,512,512.00,0.00,44360,44361
55850,2,273,239,256.00,289.00,44360,44362
55851,1,512,512,512.00,0.00,44361,44362
55852,1,512,512,512.00,0.00,44361,44362
55853,1,512,512,512.00,0.00,44361,44362
55854,1,512,512,512.00,0.00,44361,44362
55855,1,512,512,512.00,0.00,44361,44362
55856,1,512,512,512.00,0.00,44361,44362
55857,1,512,512,512.00,0.00,44361,44362
55858,1,512,512,512.00,0.00,44361,44362
55859,1,512,512,512.00,0.00,44361,44362
55860,1,512,512,512.00,0.00,44361,44362
55861,2,481,31,256.00,50625.00,44361,44363
55862,2,362,150,256.00,11236.00,44362,44364
55863,4,372,2,128.00,21561.50,44363,44367
55864,1,512,512,512.00,0.00,44366,44367
55865,1,512,512,512.00,0.00,44366,44367
55866,3,359,47,170.67,18314.89,44366,44369
55867,3,287,40,170.67,10270.89,44368,44371
55868,2,393,119,256.00,18769.00,44370,44372
55869,3,378,49,170.67,21709.56,44371,44374
55870,1,512,512,512.00,0.00,44373,44374
55871,7,363,1,73.14,14479.84,44373,44380
55872,2,459,53,256.00,41209.00,44379,44381
55873,3,402,23,170.67,27440.22,44380,44383
55874,3,253,92,170.67,4326.89,44382,44385
55875,4,227,1,128.00,10025.00,44384,44388
55876,1,512,512,512.00,0.00,44387,44388
55877,4,453,1,128.00,35703.50,44387,44391
55878,3,424,12,170.67,32771.56,44390,44393
55879,1,512,512,512.00,0.00,44392,44393
55880,1,512,512,512.00,0.00,44392,44393
55881,1,512,512,512.00,0.00,44392,44393
55882,2,300,212,256.00,1936.00,44392,44394
55883,2,392,120,256.00,18496.00,44393,44395
55884,1,512,512,512.00,0.00,44394,44395
55885,3,321,28,170.67,14337.56,44394,44397
55886,4,321,1,128.00,16777.00,44396,44400
55887,5,208,54,102.40,3175.44,44399,44404
55888,4,332,1,128.00,17007.50,44403,44407
55889,2,281,231,256.00,625.00,44406,44408
55890,5,360,2,102.40,17542.64,44407,44412
55891,6,368,2,85.33,17371.56,44411,44417
55892,1,512,512,512.00,0.00,44416,44417
55893,1,512,512,512.00,0.00,44416,44417
55894,1,512,512,512.00,0.00,44416,44417
55895,3,358,13,170.67,20277.56,44416,44419
55896,3,263,90,170.67,5056.22,44418,44421
55897,3,280,14,170.67,12912.89,44420,44423
55898,1,512,512,512.00,0.00,44422,44423
55899,2,503,9,256.00,61009.00,44422,44424
55900,3,264,21,170.67,11428.22,44423,44426
55901,3,284,2,170.67,14784.89,44425,44428
55902,1,512,512,512.00,0.00,44427,44428
55903,1,512,512,512.00,0.00,44427,44428
55904,3,480,3,170.67,47956.22,44427,44430
55905,1,512,512,512.00,0.00,44429,44430
55906,3,419,31,170.67,30994.89,44429,44432
55907,1,512,512,512.00,0.00,44431,44432
55908,1,512,512,512.00,0.00,44431,44432
55909,1,512,512,512.00,0.00,44431,44432
55910,2,280,232,256.00,576.00,44431,44433
55911,1,512,512,512.00,0.00,44432,44433
55912,1,512,512,512.00,0.00,44432,44433
55913,2,393,119,256.00,18769.00,44432,44434
55914,1,512,512,512.00,0.00,44433,44434
55915,1,512,512,512.00,0.00,44433,44434
55916,1,512,512,512.00,0.00,44433,44434
55917,1,512,512,512.00,0.00,44433,44434
55918,1,512,512,512.00,0.00,44433,44434
55919,5,317,5,102.40,14774.24,44433,44438
55920,3,348,30,170.67,17526.22,44437,44440
55921,3,405,15,170.67,28444.22,44439,44442
55922,3,229,111,170.67,2321.56,44441,44444
55923,2,427,85,256.00,29241.00,44443,44445
55924,2,323,189,256.00,4489.00,44444,44446
55925,4,196,5,128.00,5641.50,44445,44449
55926,2,266,246,256.00,100.00,44448,44450
55927,3,422,35,170.67,31650.89,44449,44452
55928,1,512,512,512.00,0.00,44451,44452
55929,2,443,69,256.00,34969.00,44451,44453
55930,1,512,512,512.00,0.00,44452,44453
55931,1,512,512,512.00,0.00,44452,44453
55932,3,400,1,170.67,28313.56,44452,44455
55933,1,512,512,512.00,0.00,44454,44455
55934,6,395,2,85.33,19675.56,44454,44460
55935,1,512,512,512.00,0.00,44459,44460
55936,3,359,13,170.67,20422.89,44459,44462
55937,4,259,1,128.00,13126.50,44461,44465
55938,3,250,19,170.67,11509.56,44464,44467
55939,3,289,17,170.67,12954.89,44466,44469
55940,6,322,9,85.33,11695.89,44468,44474
55941,3,316,6,170.67,16203.56,44473,44476
55942,1,512,512,512.00,0.00,44475,44476
55943,1,512,512,512.00,0.00,44475,44476
55944,5,227,1,102.40,9829.44,44475,44480
55945,3,504,2,170.67,55558.22,44479,44482
55946,1,512,512,512.00,0.00,44481,44482
55947,1,512,512,512.00,0.00,44481,44482
55948,1,512,512,512.00,0.00,44481,44482
55949,3,449,3,170.67,39276.22,44481,44484
55950,5,461,1,102.40,32195.84,44483,44488
55951,2,496,16,256.00,57600.00,44487,44489
55952,1,512,512,512.00,0.00,44488,44489
55953,1,512,512,512.00,0.00,44488,44489
55954,3,475,17,170.67,46310.89,44488,44491
55955,1,512,512,512.00,0.00,44490,44491
55956,1,512,512,512.00,0.00,44490,44491
55957,2,480,32,256.00,50176.00,44490,44492
55958,1,512,512,512.00,0.00,44491,44492
55959,1,512,512,512.00,0.00,44491,44492
55960,1,512,512,512.00,0.00,44491,44492
55961,7,267,1,73.14,9484.12,44491,44498
55962,2,318,194,256.00,3844.00,44497,44499
55963,1,512,512,512.00,0.00,44498,44499
55964,1,512,512,512.00,0.00,44498,44499
55965,2,396,116,256.00,19600.00,44498,44500
55966,3,246,94,170.67,3851.56,44499,44502
55967,5,190,3,102.40,6233.84,44501,44506
55968,1,512,512,512.00,0.00,44505,44506
55969,3,374,5,170.67,23402.89,44505,44508
55970,1,512,512,512.00,0.00,44507,44508
55971,1,512,512,512.00,0.00,44507,44508
55972,4,286,40,128.00,9589.50,44507,44511
55973,3,426,3,170.67,33664.22,44510,44513
55974,2,382,130,256.00,15876.00,44512,44514
55975,1,512,512,512.00,0.00,44513,44514
55976,1,512,512,512.00,0.00,44513,44514
55977,7,346,2,73.14,13632.69,44513,44520
55978,5,424,1,102.40,26177.44,44519,44524
55979,1,512,512,512.00,0.00,44523,44524
55980,1,512,512,512.00,0.00,44523,44524
55981,1,512,512,512.00,0.00,44523,44524
55982,2,503,9,256.00,61009.00,44523,44525
55983,1,512,512,512.00,0.00,44524,44525
55984,3,297,1,170.67,15541.56,44524,44527
55985,1,512,512,512.00,0.00,44526,44527
55986,6,348,1,85.33,14487.22,44526,44532
55987,2,504,8,256.00,61504.00,44531,44533
55988,1,512,512,512.00,0.00,44532,44533
55989,1,512,512,512.00,0.00,44532,44533
55990,1,512,512,512.00,0.00,44532,44533
55991,2,491,21,256.00,55225.00,44532,44534
55992,1,512,512,512.00,0.00,44533,44534
55993,1,512,512,512.00,0.00,44533,44534
55994,4,220,40,128.00,7666.50,44533,44537
55995,2,467,45,256.00,44521.00,44536,44538
55996,1,512,512,512.00,0.00,44537,44538
55997,5,319,1,102.40,16157.44,44537,44542
55998,1,512,512,512.00,0.00,44541,44542
55999,1,512,512,512.00,0.00,44541,44542
56000,1,512,512,512.00,0.00,44541,44542
56001,1,512,512,512.00,0.00,44541,44542
56002,1,512,512,512.00,0.00,44541,44542
56003,2,474,38,256.00,47524.00,44541,44543
56004,1,512,512,512.00,0.00,44542,44543
56005,1,512,512,512.00,0.00,44542,44543
56006,2,330,182,256.00,5476.00,44542,44544
56007,1,512,512,512.00,0.00,44543,44544
56008,1,512,512,512.00,0.00,44543,44544
56009,6,182,1,85.33,5739.22,44543,44549
56010,4,446,1,128.00,34308.50,44548,44552
56011,1,512,512,512.00,0.00,44551,44552
56012,1,512,512,512.00,0.00,44551,44552
56013,2,257,255,256.00,1.00,44551,44553
56014,1,512,512,512.00,0.00,44552,44553
56015,1,512,512,512.00,0.00,44552,44553
56016,1,512,512,512.00,0.00,44552,44553
56017,1,512,512,512.00,0.00,44552,44553
56018,1,512,512,512.00,0.00,44552,44553
56019,1,512,512,512.00,0.00,44552,44553
56020,1,512,512,512.00,0.00,44552,44553
56021,1,512,512,512.00,0.00,44552,44553
56022,1,512,512,512.00,0.00,44552,44553
56023,1,512,512,512.00,0.00,44552,44553
56024,4,261,2,128.00,15900.50,44552,44556
56025,1,512,512,512.00,0.00,44555,44556
56026,1,512,512,512.00,0.00,44555,44556
56027,2,392,120,256.00,18496.00,44555,44557
56028,2,423,89,256.00,27889.00,44556,44558
56029,1,512,512,512.00,0.00,44557,44558
56030,3,357,39,170.67,18348.22,44557,44560
56031,1,512,512,512.00,0.00,44559,44560
56032,1,512,512,512.00,0.00,44559,44560
56033,4,262,7,128.00,14056.50,44559,44563
56034,1,512,512,512.00,0.00,44562,44563
56035,1,512,512,512.00,0.00,44562,44563
56036,1,512,512,512.00,0.00,44562,44563
56037,1,512,512,512.00,0.00,44562,44563
56038,2,494,18,256.00,56644.00,44562,44564
56039,8,183,2,64.00,2756.50,44563,44571
56040,1,512,512,512.00,0.00,44570,44571
56041,1,512,512,512.00,0.00,44570,44571
56042,7,210,1,73.14,6653.55,44571,44578
56043,1,512,512,512.00,0.00,44577,44578
56044,1,512,512,512.00,0.00,44577,44578
56045,1,512,512,512.00,0.00,44577,44578
56046,4,287,49,128.00,8681.00,44577,44581
56047,1,512,512,512.00,0.00,44580,44581
56048,2,277,235,256.00,441.00,44580,44582
56049,4,402,12,128.00,25901.50,44581,44585
56050,1,512,512,512.00,0.00,44584,44585
56051,1,512,512,512.00,0.00,44584,44585
56052,1,512,512,512.00,0.00,44584,44585
56053,1,512,512,512.00,0.00,44584,44585
56054,1,512,512,512.00,0.00,44584,44585
56055,2,316,196,256.00,3600.00,44584,44586
56056,3,483,1,170.67,48897.56,44585,44588
56057,1,512,512,512.00,0.00,44587,44588
56058,2,469,43,256.00,45369.00,44587,44589
56059,1,512,512,512.00,0.00,44588,44589
56060,1,512,512,512.00,0.00,44588,44589
56061,1,512,512,512.00,0.00,44588,44589
56062,2,420,92,256.00,26896.00,44588,44590
56063,7,255,1,73.14,8105.27,44589,44596
56064,6,225,1,85.33,5263.22,44595,44601
56065,1,512,512,512.00,0.00,44600,44601
56066,1,512,512,512.00,0.00,44600,44601
56067,3,430,2,170.67,34640.89,44600,44603
56068,1,512,512,512.00,0.00,44602,44603
56069,4,312,23,128.00,14016.50,44602,44606
56070,1,512,512,512.00,0.00,44605,44606
56071,4,419,6,128.00,28464.50,44605,44609
56072,1,512,512,512.00,0.00,44608,44609
56073,1,512,512,512.00,0.00,44608,44609
56074,3,189,156,170.67,188.22,44608,44611
56075,1,512,512,512.00,0.00,44610,44611
56076,1,512,512,512.00,0.00,44610,44611
56077,1,512,512,512.00,0.00,44610,44611
56078,2,325,187,256.00,4761.00,44610,44612
56079,1,512,512,512.00,0.00,44611,44612
56080,1,512,512,512.00,0.00,44611,44612
56081,2,450,62,256.00,37636.00,44611,44613
56082,1,512,512,512.00,0.00,44612,44613
56083,4,339,2,128.00,17598.50,44612,44616
56084,1,512,512,512.00,0.00,44615,44616
56085,1,512,512,512.00,0.00,44615,44616
56086,1,512,512,512.00,0.00,44615,44616
56087,1,512,512,512.00,0.00,44615,44616
56088,3,288,27,170.67,11700.22,44615,44618
56089,3,264,15,170.67,12276.22,44617,44620
56090,1,512,512,512.00,0.00,44619,44620
56091,3,262,97,170.67,4693.56,44619,44622
56092,1,512,512,512.00,0.00,44621,44622
56093,2,501,11,256.00,60025.00,44621,44623
56094,1,512,512,512.00,0.00,44622,44623
56095,1,512,512,512.00,0.00,44622,44623
56096,3,248,28,170.67,10200.89,44622,44625
56097,5,244,1,102.40,10578.64,44624,44629
56098,2,342,170,256.00,7396.00,44628,44630
56099,1,512,512,512.00,0.00,44629,44630
56100,1,512,512,512.00,0.00,44629,44630
56101,1,512,512,512.00,0.00,44629,44630
56102,1,512,512,512.00,0.00,44629,44630
56103,1,512,512,512.00,0.00,44629,44630
56104,1,512,512,512.00,0.00,44629,44630
56105,1,512,512,512.00,0.00,44629,44630
56106,1,512,512,512.00,0.00,44629,44630
56107,2,329,183,256.00,5329.00,44629,44631
56108,1,512,512,512.00,0.00,44630,44631
56109,1,512,512,512.00,0.00,44630,44631
56110,1,512,512,512.00,0.00,44630,44631
56111,1,512,512,512.00,0.00,44630,44631
56112,1,512,512,512.00,0.00,44630,44631
56113,1,512,512,512.00,0.00,44630,44631
56114,1,512,512,512.00,0.00,44630,44631
56115,3,428,18,170.67,33494.22,44630,44633
56116,1,512,512,512.00,0.00,44632,44633
56117,1,512,512,512.00,0.00,44632,44633
56118,6,210,7,85.33,6781.22,44632,44638
56119,1,512,512,512.00,0.00,44637,44638
56120,1,512,512,512.00,0.00,44637,44638
56121,2,435,77,256.00,32041.00,44637,44639
56122,1,512,512,512.00,0.00,44638,44639
56123,4,346,28,128.00,16182.00,44638,44642
56124,2,494,18,256.00,56644.00,44641,44643
56125,1,512,512,512.00,0.00,44642,44643
56126,1,512,512,512.00,0.00,44642,44643
56127,4,281,3,128.00,13056.50,44642,44646
56128,1,512,512,512.00,0.00,44645,44646
56129,1,512,512,512.00,0.00,44645,44646
56130,2,321,191,256.00,4225.00,44645,44647
56131,1,512,512,512.00,0.00,44646,44647
56132,1,512,512,512.00,0.00,44646,44647
56133,2,402,110,256.00,21316.00,44646,44648
56134,2,357,155,256.00,10201.00,44647,44649
56135,3,356,3,170.67,20924.22,44648,44651
56136,4,378,1,128.00,21593.50,44650,44654
56137,2,449,63,256.00,37249.00,44653,44655
56138,1,512,512,512.00,0.00,44654,44655
56139,2,497,15,256.00,58081.00,44654,44656
56140,5,235,1,102.40,7223.44,44655,44660
56141,1,512,512,512.00,0.00,44659,44660
56142,1,512,512,512.00,0.00,44659,44660
56143,2,330,182,256.00,5476.00,44659,44661
56144,3,355,67,170.67,17077.56,44660,44663
56145,1,512,512,512.00,0.00,44662,44663
56146,1,512,512,512.00,0.00,44662,44663
56147,2,304,208,256.00,2304.00,44662,44664
56148,12,151,1,42.67,2203.22,44663,44675
56149,5,467,1,102.40,33364.64,44674,44679
56150,2,454,58,256.00,39204.00,44678,44680
56151,1,512,512,512.00,0.00,44679,44680
56152,2,359,153,256.00,10609.00,44679,44681
56153,1,512,512,512.00,0.00,44680,44681
56154,1,512,512,512.00,0.00,44680,44681
56155,1,512,512,512.00,0.00,44680,44681
56156,1,512,512,512.00,0.00,44680,44681
56157,2,431,81,256.00,30625.00,44680,44682
56158,1,512,512,512.00,0.00,44681,44682
56159,1,512,512,512.00,0.00,44681,44682
56160,1,512,512,512.00,0.00,44681,44682
56161,1,512,512,512.00,0.00,44681,44682
56162,1,512,512,512.00,0.00,44681,44682
56163,1,512,512,512.00,0.00,44681,44682
56164,1,512,512,512.00,0.00,44681,44682
56165,3,307,4,170.67,15761.56,44681,44684
56166,1,512,512,512.00,0.00,44683,44684
56167,1,512,512,512.00,0.00,44683,44684
56168,4,228,52,128.00,4408.00,44683,44687
56169,1,512,512,512.00,0.00,44686,44687
56170,1,512,512,512.00,0.00,44686,44687
56171,1,512,512,512.00,0.00,44686,44687
56172,6,301,1,85.33,10229.56,44686,44692
56173,3,405,3,170.67,29156.22,44691,44694
56174,1,512,512,512.00,0.00,44693,44694
56175,1,512,512,512.00,0.00,44693,44694
56176,2,392,120,256.00,18496.00,44693,44695
56177,1,512,512,512.00,0.00,44694,44695
56178,4,284,9,128.00,9873.50,44694,44698
56179,1,512,512,512.00,0.00,44697,44698
56180,5,293,2,102.40,11510.64,44697,44702
56181,4,377,1,128.00,23017.50,44701,44705
56182,1,512,512,512.00,0.00,44704,44705
56183,2,376,136,256.00,14400.00,44704,44706
56184,1,512,512,512.00,0.00,44705,44706
56185,1,512,512,512.00,0.00,44705,44706
56186,1,512,512,512.00,0.00,44705,44706
56187,2,272,240,256.00,256.00,44705,44707
56188,1,512,512,512.00,0.00,44706,44707
56189,2,355,157,256.00,9801.00,44706,44708
56190,1,512,512,512.00,0.00,44707,44708
56191,2,352,160,256.00,9216.00,44707,44709
56192,1,512,512,512.00,0.00,44708,44709
56193,1,512,512,512.00,0.00,44708,44709
56194,3,464,1,170.67,43374.89,44708,44711
56195,1,512,512,512.00,0.00,44710,44711
56196,1,512,512,512.00,0.00,44710,44711
56197,2,427,85,256.00,29241.00,44710,44712
56198,2,466,46,256.00,44100.00,44711,44713
56199,1,512,512,512.00,0.00,44712,44713
56200,1,512,512,512.00,0.00,44712,44713
56201,1,512,512,512.00,0.00,44712,44713
56202,4,417,1,128.00,28253.50,44712,44716
56203,1,512,512,512.00,0.00,44715,44716
56204,2,494,18,256.00,56644.00,44715,44717
56205,1,512,512,512.00,0.00,44716,44717
56206,5,208,3,102.40,6147.44,44716,44721
56207,1,512,512,512.00,0.00,44720,44721
56208,3,296,10,170.67,14256.89,44720,44723
56209,4,322,5,128.00,16902.50,44722,44726
56210,1,512,512,512.00,0.00,44725,44726
56211,1,512,512,512.00,0.00,44725,44726
56212,2,377,135,256.00,14641.00,44725,44727
56213,5,248,18,102.40,7110.64,44726,44731
56214,1,512,512,512.00,0.00,44730,44731
56215,1,512,512,512.00,0.00,44730,44731
56216,1,512,512,512.00,0.00,44730,44731
56217,2,506,6,256.00,62500.00,44730,44732
56218,4,439,1,128.00,32989.00,44731,44735
56219,1,512,512,512.00,0.00,44734,44735
56220,1,512,512,512.00,0.00,44734,44735
56221,7,331,3,73.14,12845.55,44734,44741
56222,3,283,5,170.67,14302.89,44740,44743
56223,3,327,57,170.67,13060.22,44742,44745
56224,1,512,512,512.00,0.00,44744,44745
56225,2,499,13,256.00,59049.00,44744,44746
56226,4,197,2,128.00,5818.50,44745,44749
56227,1,512,512,512.00,0.00,44748,44749
56228,1,512,512,512.00,0.00,44748,44749
56229,1,512,512,512.00,0.00,44748,44749
56230,2,509,3,256.00,64009.00,44748,44750
56231,2,364,148,256.00,11664.00,44749,44751
56232,2,257,255,256.00,1.00,44750,44752
56233,1,512,512,512.00,0.00,44751,44752
56234,4,314,1,128.00,17772.50,44751,44755
56235,1,512,512,512.00,0.00,44754,44755
56236,1,512,512,512.00,0.00,44754,44755
56237,2,336,176,256.00,6400.00,44754,44756
56238,1,512,512,512.00,0.00,44755,44756
56239,1,512,512,512.00,0.00,44755,44756
56240,4,286,1,128.00,10889.50,44755,44759
56241,1,512,512,512.00,0.00,44758,44759
56242,1,512,512,512.00,0.00,44758,44759
56243,2,311,201,256.00,3025.00,44758,44760
56244,1,512,512,512.00,0.00,44759,44760
56245,1,512,512,512.00,0.00,44759,44760
56246,1,512,512,512.00,0.00,44759,44760
56247,3,294,104,170.67,7622.22,44759,44762
56248,3,305,2,170.67,15890.89,44761,44764
56249,1,512,512,512.00,0.00,44763,44764
56250,1,512,512,512.00,0.00,44763,44764
56251,1,512,512,512.00,0.00,44763,44764
56252,2,300,212,256.00,1936.00,44763,44765
56253,3,440,35,170.67,36270.89,44764,44767
56254,3,465,12,170.67,43404.22,44766,44769
56255,1,512,512,512.00,0.00,44768,44769
56256,1,512,512,512.00,0.00,44768,44769
56257,2,347,165,256.00,8281.00,44768,44770
56258,1,512,512,512.00,0.00,44769,44770
56259,1,512,512,512.00,0.00,44769,44770
56260,4,261,15,128.00,8464.50,44769,44773
56261,1,512,512,512.00,0.00,44772,44773
56262,1,512,512,512.00,0.00,44772,44773
56263,4,323,32,128.00,13266.50,44772,44776
56264,9,277,1,56.89,6900.99,44775,44784
56265,1,512,512,512.00,0.00,44783,44784
56266,1,512,512,512.00,0.00,44783,44784
56267,1,512,512,512.00,0.00,44783,44784
56268,1,512,512,512.00,0.00,44783,44784
56269,1,512,512,512.00,0.00,44783,44784
56270,1,512,512,512.00,0.00,44783,44784
56271,5,226,5,102.40,5058.24,44783,44788
56272,1,512,512,512.00,0.00,44787,44788
56273,5,304,12,102.40,10641.84,44787,44792
56274,2,277,235,256.00,441.00,44791,44793
56275,1,512,512,512.00,0.00,44792,44793
56276,1,512,512,512.00,0.00,44792,44793
56277,1,512,512,512.00,0.00,44792,44793
56278,1,512,512,512.00,0.00,44792,44793
56279,3,487,12,170.67,50033.56,44792,44795
56280,2,288,224,256.00,1024.00,44794,44796
56281,4,356,2,128.00,18630.00,44795,44799
56282,4,228,11,128.00,6948.50,44798,44802
56283,1,512,512,512.00,0.00,44801,44802
56284,4,329,2,128.00,16663.50,44801,44805
56285,1,512,512,512.00,0.00,44804,44805
56286,1,512,512,512.00,0.00,44804,44805
56287,1,512,512,512.00,0.00,44804,44805
56288,3,277,76,170.67,6801.56,44804,44807
56289,1,512,512,512.00,0.00,44806,44807
56290,4,268,1,128.00,14518.50,44806,44810
56291,1,512,512,512.00,0.00,44809,44810
56292,1,512,512,512.00,0.00,44809,44810
56293,2,370,142,256.00,12996.00,44809,44811
56294,1,512,512,512.00,0.00,44810,44811
56295,3,415,17,170.67,30510.89,44810,44813
56296,2,412,100,256.00,24336.00,44812,44814
56297,1,512,512,512.00,0.00,44813,44814
56298,1,512,512,512.00,0.00,44813,44814
56299,2,396,116,256.00,19600.00,44813,44815
56300,7,285,1,73.14,9245.55,44814,44821
56301,2,402,110,256.00,21316.00,44820,44822
56302,2,416,96,256.00,25600.00,44821,44823
56303,7,246,1,73.14,6278.69,44822,44829
56304,1,512,512,512.00,0.00,44828,44829
56305,1,512,512,512.00,0.00,44828,44829
56306,1,512,512,512.00,0.00,44828,44829
56307,1,512,512,512.00,0.00,44828,44829
56308,3,316,14,170.67,15264.89,44828,44831
56309,1,512,512,512.00,0.00,44830,44831
56310,3,304,70,170.67,9659.56,44830,44833
56311,1,512,512,512.00,0.00,44832,44833
56312,1,512,512,512.00,0.00,44832,44833
56313,1,512,512,512.00,0.00,44832,44833
56314,8,251,1,64.00,7633.50,44832,44840
56315,2,282,230,256.00,676.00,44839,44841
56316,1,512,512,512.00,0.00,44840,44841
56317,2,281,231,256.00,625.00,44840,44842
56318,1,512,512,512.00,0.00,44841,44842
56319,3,355,13,170.67,19849.56,44841,44844
56320,1,512,512,512.00,0.00,44843,44844
56321,10,231,1,51.20,4273.36,44843,44853
56322,2,350,162,256.00,8836.00,44852,44854
56323,4,430,7,128.00,31021.50,44853,44857
56324,1,512,512,512.00,0.00,44856,44857
56325,1,512,512,512.00,0.00,44856,44857
56326,2,506,6,256.00,62500.00,44856,44858
56327,1,512,512,512.00,0.00,44857,44858
56328,1,512,512,512.00,0.00,44857,44858
56329,4,295,1,128.00,12662.50,44857,44861
56330,3,367,49,170.67,19641.56,44860,44863
56331,1,512,512,512.00,0.00,44862,44863
56332,3,462,9,170.67,42608.22,44862,44865
56333,2,498,14,256.00,58564.00,44864,44866
56334,1,512,512,512.00,0.00,44865,44866
56335,1,512,512,512.00,0.00,44865,44866
56336,1,512,512,512.00,0.00,44865,44866
56337,1,512,512,512.00,0.00,44865,44866
56338,6,381,2,85.33,17889.22,44865,44871
56339,1,512,512,512.00,0.00,44870,44871
56340,1,512,512,512.00,0.00,44870,44871
56341,6,443,5,85.33,25756.89,44870,44876
56342,4,300,5,128.00,13893.50,44875,44879
56343,2,369,143,256.00,12769.00,44878,44880
56344,1,512,512,512.00,0.00,44879,44880
56345,1,512,512,512.00,0.00,44879,44880
56346,1,512,512,512.00,0.00,44879,44880
56347,2,346,166,256.00,8100.00,44879,44881
56348,3,415,38,170.67,29922.89,44880,44883
56349,8,272,3,64.00,6795.75,44882,44890
56350,1,512,512,512.00,0.00,44889,44890
56351,2,371,141,256.00,13225.00,44889,44891
56352,3,471,1,170.67,45353.56,44890,44893
56353,1,512,512,512.00,0.00,44892,44893
56354,1,512,512,512.00,0.00,44892,44893
56355,3,205,139,170.67,729.56,44892,44895
56356,2,455,57,256.00,39601.00,44894,44896
56357,1,512,512,512.00,0.00,44895,44896
56358,1,512,512,512.00,0.00,44895,44896
56359,1,512,512,512.00,0.00,44895,44896
56360,3,245,90,170.67,4024.22,44895,44898
56361,3,437,2,170.67,36306.89,44897,44900
56362,1,512,512,512.00,0.00,44899,44900
56363,1,512,512,512.00,0.00,44899,44900
56364,4,486,1,128.00,42764.50,44899,44903
56365,1,512,512,512.00,0.00,44902,44903
56366,1,512,512,512.00,0.00,44902,44903
56367,3,359,73,170.67,17742.89,44902,44905
56368,3,357,25,170.67,19197.56,44904,44907
56369,4,299,4,128.00,12133.50,44906,44910
56370,1,512,512,512.00,0.00,44909,44910
56371,6,393,4,85.33,19326.22,44909,44915
56372,1,512,512,512.00,0.00,44914,44915
56373,1,512,512,512.00,0.00,44914,44915
56374,1,512,512,512.00,0.00,44914,44915
56375,3,486,8,170.67,49734.22,44914,44917
56376,2,370,142,256.00,12996.00,44916,44918
56377,1,512,512,512.00,0.00,44917,44918
56378,1,512,512,512.00,0.00,44917,44918
56379,1,512,512,512.00,0.00,44917,44918
56380,1,512,512,512.00,0.00,44917,44918
56381,3,348,4,170.67,19779.56,44917,44920
56382,1,512,512,512.00,0.00,44919,44920
56383,1,512,512,512.00,0.00,44919,44920
56384,1,512,512,512.00,0.00,44919,44920
56385,1,512,512,512.00,0.00,44919,44920
56386,5,313,2,102.40,12976.64,44919,44924
56387,4,305,12,128.00,12126.50,44923,44927
56388,1,512,512,512.00,0.00,44926,44927
56389,3,450,21,170.67,39080.22,44926,44929
56390,4,287,8,128.00,12456.50,44928,44932
56391,1,512,512,512.00,0.00,44931,44932
56392,1,512,512,512.00,0.00,44931,44932
56393,5,414,1,102.40,24494.64,44931,44936
56394,1,512,512,512.00,0.00,44935,44936
56395,1,512,512,512.00,0.00,44935,44936
56396,3,260,76,170.67,5656.89,44935,44938
56397,2,274,238,256.00,324.00,44937,44939
56398,4,335,2,128.00,18351.50,44938,44942
56399,3,266,43,170.67,8810.89,44941,44944
56400,1,512,512,512.00,0.00,44943,44944
56401,2,265,247,256.00,81.00,44943,44945
56402,1,512,512,512.00,0.00,44944,44945
56403,7,440,1,73.14,22520.12,44944,44951
56404,1,512,512,512.00,0.00,44950,44951
56405,1,512,512,512.00,0.00,44950,44951
56406,1,512,512,512.00,0.00,44950,44951
56407,2,315,197,256.00,3481.00,44950,44952
56408,1,512,512,512.00,0.00,44951,44952
56409,1,512,512,512.00,0.00,44951,44952
56410,2,426,86,256.00,28900.00,44951,44953
56411,1,512,512,512.00,0.00,44952,44953
56412,1,512,512,512.00,0.00,44952,44953
56413,1,512,512,512.00,0.00,44952,44953
56414,2,481,31,256.00,50625.00,44952,44954
56415,1,512,512,512.00,0.00,44953,44954
56416,1,512,512,512.00,0.00,44953,44954
56417,1,512,512,512.00,0.00,44953,44954
56418,1,512,512,512.00,0.00,44953,44954
56419,1,512,512,512.00,0.00,44953,44954
56420,5,267,1,102.40,10814.24,44953,44958
56421,1,512,512,512.00,0.00,44957,44958
56422,1,512,512,512.00,0.00,44957,44958
56423,3,451,14,170.67,39474.89,44957,44960
56424,2,364,148,256.00,11664.00,44959,44961
56425,6,319,16,85.33,11692.89,44960,44966
56426,1,512,512,512.00,0.00,44965,44966
56427,2,339,173,256.00,6889.00,44965,44967
56428,1,512,512,512.00,0.00,44966,44967
56429,2,506,6,256.00,62500.00,44966,44968
56430,1,512,512,512.00,0.00,44967,44968
56431,1,512,512,512.00,0.00,44967,44968
56432,1,512,512,512.00,0.00,44967,44968
56433,3,317,88,170.67,10766.89,44967,44970
56434,5,273,5,102.40,9440.24,44969,44974
56435,1,512,512,512.00,0.00,44973,44974
56436,7,246,1,73.14,6905.27,44973,44980
56437,3,343,2,170.67,19386.89,44979,44982
56438,8,271,2,64.00,10116.50,44981,44989
56439,1,512,512,512.00,0.00,44988,44989
56440,1,512,512,512.00,0.00,44988,44989
56441,1,512,512,512.00,0.00,44988,44989
56442,2,460,52,256.00,41616.00,44988,44990
56443,1,512,512,512.00,0.00,44989,44990
56444,1,512,512,512.00,0.00,44989,44990
56445,1,512,512,512.00,0.00,44989,44990
56446,1,512,512,512.00,0.00,44989,44990
56447,1,512,512,512.00,0.00,44989,44990
56448,4,252,5,128.00,14296.50,44989,44993
56449,1,512,512,512.00,0.00,44992,44993
56450,1,512,512,512.00,0.00,44992,44993
56451,1,512,512,512.00,0.00,44992,44993
56452,1,512,512,512.00,0.00,44992,44993
56453,1,512,512,512.00,0.00,44992,44993
56454,1,512,512,512.00,0.00,44992,44993
56455,3,366,11,170.67,21640.22,44992,44995
56456,6,240,6,85.33,6341.22,44994,45000
56457,1,512,512,512.00,0.00,44999,45000
56458,1,512,512,512.00,0.00,44999,45000
56459,6,359,1,85.33,15849.56,44999,45005
56460,2,311,201,256.00,3025.00,45004,45006
56461,1,512,512,512.00,0.00,45005,45006
56462,1,512,512,512.00,0.00,45005,45006
56463,1,512,512,512.00,0.00,45005,45006
56464,1,512,512,512.00,0.00,45005,45006
56465,1,512,512,512.00,0.00,45005,45006
56466,3,318,18,170.67,15014.22,45005,45008
56467,4,279,15,128.00,10933.50,45007,45011
56468,3,260,124,170.67,3992.89,45010,45013
56469,1,512,512,512.00,0.00,45012,45013
56470,1,512,512,512.00,0.00,45012,45013
56471,2,477,35,256.00,48841.00,45012,45014
56472,1,512,512,512.00,0.00,45013,45014
56473,1,512,512,512.00,0.00,45013,45014
56474,2,339,173,256.00,6889.00,45013,45015
56475,1,512,512,512.00,0.00,45014,45015
56476,5,351,2,102.40,17137.04,45014,45019
56477,1,512,512,512.00,0.00,45018,45019
56478,2,482,30,256.00,51076.00,45018,45020
56479,1,512,512,512.00,0.00,45019,45020
56480,1,512,512,512.00,0.00,45019,45020
56481,1,512,512,512.00,0.00,45019,45020
56482,2,501,11,256.00,60025.00,45019,45021
56483,1,512,512,512.00,0.00,45020,45021
56484,1,512,512,512.00,0.00,45020,45021
56485,1,512,512,512.00,0.00,45020,45021
56486,4,285,3,128.00,12374.50,45020,45024
56487,1,512,512,512.00,0.00,45023,45024
56488,1,512,512,512.00,0.00,45023,45024
56489,1,512,512,512.00,0.00,45023,45024
56490,1,512,512,512.00,0.00,45023,45024
56491,5,328,13,102.40,13357.84,45023,45028
56492,1,512,512,512.00,0.00,45027,45028
56493,1,512,512,512.00,0.00,45027,45028
56494,1,512,512,512.00,0.00,45027,45028
56495,1,512,512,512.00,0.00,45027,45028
56496,1,512,512,512.00,0.00,45027,45028
56497,2,374,138,256.00,13924.00,45027,45029
56498,3,320,23,170.67,14702.89,45028,45031
56499,3,309,25,170.67,13469.56,45030,45033
56500,1,512,512,512.00,0.00,45032,45033
56501,1,512,512,512.00,0.00,45032,45033
56502,2,280,232,256.00,576.00,45032,45034
56503,4,269,65,128.00,6943.50,45033,45037
56504,1,512,512,512.00,0.00,45036,45037
56505,3,262,11,170.67,12834.89,45036,45039
56506,1,512,512,512.00,0.00,45038,45039
56507,2,298,214,256.00,1764.00,45038,45040
56508,1,512,512,512.00,0.00,45039,45040
56509,1,512,512,512.00,0.00,45039,45040
56510,1,512,512,512.00,0.00,45039,45040
56511,1,512,512,512.00,0.00,45039,45040
56512,1,512,512,512.00,0.00,45039,45040
56513,1,512,512,512.00,0.00,45039,45040
56514,5,232,17,102.40,8355.04,45039,45044
56515,1,512,512,512.00,0.00,45043,45044
56516,1,512,512,512.00,0.00,45043,45044
56517,1,512,512,512.00,0.00,45043,45044
56518,1,512,512,512.00,0.00,45043,45044
56519,3,318,91,170.67,10877.56,45043,45046
56520,1,512,512,512.00,0.00,45045,45046
56521,2,305,207,256.00,2401.00,45045,45047
56522,3,387,58,170.67,23413.56,45046,45049
56523,3,410,23,170.67,29162.89,45048,45051
56524,1,512,512,512.00,0.00,45050,45051
56525,1,512,512,512.00,0.00,45050,45051
56526,1,512,512,512.00,0.00,45050,45051
56527,1,512,512,512.00,0.00,45050,45051
56528,2,442,70,256.00,34596.00,45050,45052
56529,3,297,37,170.67,11293.56,45051,45054
56530,1,512,512,512.00,0.00,45053,45054
56531,1,512,512,512.00,0.00,45053,45054
56532,1,512,512,512.00,0.00,45053,45054
56533,1,512,512,512.00,0.00,45053,45054
56534,3,302,28,170.67,12576.89,45053,45056
56535,2,318,194,256.00,3844.00,45055,45057
56536,1,512,512,512.00,0.00,45056,45057
56537,1,512,512,512.00,0.00,45056,45057
56538,3,274,51,170.67,8421.56,45056,45059
56539,1,512,512,512.00,0.00,45058,45059
56540,1,512,512,512.00,0.00,45058,45059
56541,2,445,67,256.00,35721.00,45058,45060
56542,2,444,68,256.00,35344.00,45059,45061
56543,1,512,512,512.00,0.00,45060,45061
56544,1,512,512,512.00,0.00,45060,45061
56545,1,512,512,512.00,0.00,45060,45061
56546,3,309,92,170.67,9628.22,45060,45063
56547,3,427,3,170.67,33893.56,45062,45065
56548,3,330,87,170.67,12704.22,45064,45067
56549,1,512,512,512.00,0.00,45066,45067
56550,3,321,11,170.67,16060.22,45066,45069
56551,1,512,512,512.00,0.00,45068,45069
56552,2,488,24,256.00,53824.00,45068,45070
56553,1,512,512,512.00,0.00,45069,45070
56554,1,512,512,512.00,0.00,45069,45070
56555,5,282,16,102.40,9618.24,45069,45074
56556,1,512,512,512.00,0.00,45073,45074
56557,1,512,512,512.00,0.00,45073,45074
56558,1,512,512,512.00,0.00,45073,45074
56559,1,512,512,512.00,0.00,45073,45074
56560,3,394,44,170.67,25088.89,45073,45076
56561,1,512,512,512.00,0.00,45075,45076
56562,5,408,5,102.40,23674.64,45075,45080
56563,6,335,1,85.33,15559.22,45079,45085
56564,2,312,200,256.00,3136.00,45084,45086
56565,2,307,205,256.00,2601.00,45085,45087
56566,1,512,512,512.00,0.00,45086,45087
56567,1,512,512,512.00,0.00,45086,45087
56568,2,477,35,256.00,48841.00,45086,45088
56569,6,471,1,85.33,29801.56,45087,45093
56570,1,512,512,512.00,0.00,45092,45093
56571,2,420,92,256.00,26896.00,45092,45094
56572,1,512,512,512.00,0.00,45093,45094
56573,2,275,237,256.00,361.00,45093,45095
56574,2,427,85,256.00,29241.00,45094,45096
56575,2,427,85,256.00,29241.00,45095,45097
56576,5,331,3,75.80,16370.96,45096,45101
