tile_id,n_reduce_rows_num,max_row_length,min_row_length,avg_row_length,variance,start_row,end_row
0,11,70,13,46.55,330.07,0,11
1,10,70,5,51.20,358.96,10,20
2,10,65,2,51.20,288.96,19,29
3,9,70,40,56.89,59.21,28,37
4,13,60,13,39.38,317.78,36,49
5,17,40,21,30.12,36.93,48,65
6,12,65,9,42.67,278.22,64,76
7,10,80,16,51.20,386.16,75,85
8,10,63,34,51.20,63.56,84,94
9,9,85,7,56.89,416.32,93,102
10,9,70,40,56.89,84.10,102,111
11,12,60,3,42.67,222.06,110,122
12,10,70,26,51.20,122.76,121,131
13,11,60,13,46.55,258.98,130,141
14,11,60,20,46.55,107.52,140,151
15,10,65,12,51.20,247.96,150,160
16,10,70,14,51.20,252.56,159,169
17,11,55,31,46.55,54.61,168,179
18,11,60,34,46.55,58.98,178,189
19,10,70,12,51.20,242.96,188,198
20,10,65,22,51.20,116.96,198,208
21,9,75,39,56.89,94.77,207,216
22,10,65,11,51.20,210.76,215,225
23,12,50,14,42.67,152.06,224,236
24,9,75,27,56.89,241.88,235,244
25,10,60,40,51.20,69.96,244,254
26,10,70,23,51.20,173.56,253,263
27,9,70,21,56.89,204.99,262,271
28,11,70,4,46.55,258.98,270,281
29,11,70,12,46.55,269.34,280,291
30,10,75,25,51.20,159.96,290,300
31,10,75,13,51.20,288.56,299,309
32,10,60,31,51.20,72.76,308,318
33,11,60,19,46.55,120.79,317,328
34,11,60,12,46.55,173.88,327,338
35,11,60,32,46.55,76.61,338,349
36,12,55,3,42.67,196.22,348,360
37,11,65,11,46.55,248.25,359,370
38,11,60,3,46.55,222.61,369,380
39,11,55,30,46.55,47.52,379,390
40,10,70,20,51.20,190.96,389,399
41,12,65,19,42.67,145.39,398,410
42,11,55,40,46.55,39.16,409,420
43,10,80,9,51.20,300.56,419,429
44,10,65,7,51.20,245.96,428,438
45,12,55,5,42.67,245.72,437,449
46,11,65,34,46.55,88.98,448,459
47,11,70,16,46.55,257.34,458,469
48,11,60,4,46.55,272.61,468,479
49,11,65,7,46.55,344.79,478,489
50,10,65,37,51.20,52.96,488,498
51,10,65,18,51.20,154.56,497,507
52,12,65,1,42.67,327.22,506,518
53,11,65,13,46.55,178.98,517,528
54,11,65,27,46.55,129.34,527,538
55,11,60,25,46.55,101.16,537,548
56,11,65,8,46.55,192.61,547,558
57,11,65,16,46.55,230.07,557,568
58,11,75,3,46.55,277.16,567,578
59,9,62,50,56.89,12.99,577,586
60,9,72,20,56.89,200.77,586,595
61,9,70,32,56.89,138.54,594,603
62,10,70,38,51.20,71.56,602,612
63,10,85,11,51.20,448.76,611,621
64,10,65,8,51.20,275.56,620,630
65,9,70,50,56.89,44.10,629,638
66,9,80,17,56.89,304.10,638,647
67,10,70,14,51.20,262.56,646,656
68,10,70,26,51.20,114.76,655,665
69,11,63,19,46.55,136.25,664,675
70,12,70,6,42.67,351.72,674,686
71,10,65,40,51.20,62.56,685,695
72,11,70,2,46.55,315.70,694,705
73,10,70,18,51.20,320.56,704,714
74,11,55,37,46.55,32.98,713,724
75,10,70,10,51.20,323.96,723,733
76,11,62,7,46.55,222.79,732,743
77,10,70,9,51.20,298.56,742,752
78,11,55,31,46.55,46.43,751,762
79,11,70,23,46.55,134.43,761,772
80,9,75,25,56.89,169.65,771,780
81,11,60,2,46.55,288.43,779,790
82,10,70,29,51.20,118.56,789,799
83,11,70,1,46.55,364.61,798,809
84,11,60,8,46.55,178.98,808,819
85,10,70,30,51.20,185.96,818,828
86,11,75,2,46.55,420.25,827,838
87,10,75,35,51.20,102.56,837,847
88,11,65,21,46.55,222.79,846,857
89,11,75,18,46.55,224.43,856,867
90,10,60,32,51.20,60.96,866,876
91,11,60,5,46.55,205.70,875,886
92,11,65,9,46.55,295.34,885,896
93,10,65,11,51.20,220.76,895,905
94,10,65,34,51.20,141.56,904,914
95,11,75,5,46.55,414.79,913,924
96,10,60,45,51.20,23.96,923,933
97,11,70,10,46.55,301.70,932,943
98,9,75,45,56.89,72.99,942,951
99,10,65,23,51.20,127.36,950,960
100,10,75,7,51.20,407.16,959,969
101,11,60,3,46.55,283.52,968,979
102,9,85,10,56.89,364.10,978,987
103,15,70,22,34.13,138.12,986,1001
104,11,64,27,46.55,162.98,1000,1011
105,11,76,12,46.55,356.98,1010,1021
106,12,60,12,42.67,160.06,1020,1032
107,11,75,26,46.55,170.07,1031,1042
108,11,65,15,46.55,255.52,1041,1052
109,11,70,21,46.55,188.25,1051,1062
110,12,65,2,42.67,359.06,1061,1073
111,12,70,12,42.67,233.22,1072,1084
112,9,80,14,56.89,351.43,1083,1092
113,9,75,16,56.89,304.99,1091,1100
114,9,85,13,56.89,413.65,1099,1108
115,10,85,37,51.20,182.96,1107,1117
116,11,65,20,46.55,186.61,1116,1127
117,11,65,14,46.55,220.79,1126,1137
118,11,70,11,46.55,229.16,1136,1147
119,11,65,28,46.55,150.79,1146,1157
120,10,75,17,51.20,264.96,1156,1166
121,9,80,10,56.89,486.32,1165,1174
122,8,75,55,64.00,40.25,1173,1181
123,9,80,11,56.89,493.88,1180,1189
124,10,70,8,51.20,268.56,1188,1198
125,10,70,15,51.20,191.96,1197,1207
126,10,75,22,51.20,201.96,1206,1216
127,10,75,28,51.20,203.56,1215,1225
128,12,60,6,42.67,187.22,1224,1236
129,11,75,19,46.55,202.61,1235,1246
130,10,70,10,51.20,399.96,1245,1255
131,8,95,37,64.00,253.25,1254,1262
132,10,75,4,51.20,489.56,1261,1271
133,9,70,36,56.89,103.88,1270,1279
134,9,75,24,56.89,231.43,1278,1287
135,9,85,2,56.89,619.65,1286,1295
136,9,75,12,56.89,301.88,1294,1303
137,8,85,39,64.00,205.25,1302,1310
138,9,85,26,56.89,267.21,1309,1318
139,10,75,14,51.20,370.56,1317,1327
140,9,75,42,56.89,98.54,1326,1335
141,9,80,5,56.89,584.10,1334,1343
142,9,80,28,56.89,233.65,1342,1351
143,10,80,16,51.20,374.76,1350,1360
144,9,90,29,56.89,270.32,1359,1368
145,10,70,15,51.20,301.96,1367,1377
146,10,70,12,51.20,247.96,1376,1386
147,10,75,19,51.20,266.56,1385,1395
148,10,70,1,51.20,328.76,1394,1404
149,9,80,18,56.89,254.77,1403,1412
150,11,70,15,46.55,230.25,1411,1422
151,10,70,12,51.20,227.96,1421,1431
152,11,60,9,46.55,186.25,1430,1441
153,11,65,1,46.55,289.16,1440,1451
154,10,70,18,51.20,228.56,1450,1460
155,10,65,27,51.20,183.96,1459,1469
156,10,75,35,51.20,152.96,1469,1479
157,12,60,8,42.67,310.39,1478,1490
158,10,70,1,51.20,346.76,1489,1499
159,10,64,40,51.20,41.56,1498,1508
160,11,70,7,46.55,262.98,1507,1518
161,10,70,5,51.20,390.96,1517,1527
162,9,75,18,56.89,236.99,1526,1535
163,10,75,11,51.20,307.76,1534,1544
164,10,70,19,51.20,184.56,1543,1553
165,9,75,22,56.89,250.77,1552,1561
166,8,105,45,64.00,339.50,1561,1569
167,9,75,18,56.89,243.65,1568,1577
168,10,65,16,51.20,182.76,1576,1586
169,11,60,8,46.55,329.88,1585,1596
170,10,75,31,51.20,114.16,1595,1605
171,10,70,34,51.20,118.56,1604,1614
172,9,75,22,56.89,306.32,1613,1622
173,10,75,7,51.20,405.96,1621,1631
174,8,80,39,64.00,134.00,1630,1638
175,9,70,21,56.89,214.99,1637,1646
176,10,75,9,51.20,291.56,1645,1655
177,10,75,7,51.20,326.16,1654,1664
178,10,80,15,51.20,431.76,1663,1673
179,9,75,32,56.89,127.43,1672,1681
180,9,80,28,56.89,215.88,1680,1689
181,9,80,21,56.89,290.54,1688,1697
182,10,75,14,51.20,276.36,1696,1706
183,10,75,2,51.20,503.96,1705,1715
184,8,73,55,64.00,27.75,1714,1722
185,10,75,6,51.20,488.76,1721,1731
186,10,70,8,51.20,253.56,1730,1740
187,9,75,45,56.89,72.99,1739,1748
188,9,70,20,56.89,228.54,1747,1756
189,9,70,18,56.89,215.88,1755,1764
190,11,65,3,46.55,423.88,1763,1774
191,10,75,16,51.20,260.16,1773,1783
192,11,75,5,46.55,289.88,1782,1793
193,9,75,42,56.89,92.99,1792,1801
194,10,80,3,51.20,350.96,1800,1810
195,10,80,7,51.20,359.76,1809,1819
196,9,75,45,56.89,78.54,1819,1828
197,11,75,15,46.55,270.07,1827,1838
198,11,65,14,46.55,189.52,1837,1848
199,11,70,14,46.55,180.79,1847,1858
200,11,60,10,46.55,181.70,1857,1868
201,11,65,12,46.55,241.88,1867,1878
202,12,60,13,42.67,240.72,1877,1889
203,12,75,11,42.67,225.39,1888,1900
204,12,60,3,42.67,190.39,1899,1911
205,11,75,20,46.55,267.52,1910,1921
206,10,70,22,51.20,156.96,1920,1930
207,11,60,23,46.55,121.70,1929,1940
208,9,75,1,56.89,452.77,1939,1948
209,9,90,13,56.89,411.43,1947,1956
210,9,65,40,56.89,79.65,1955,1964
211,9,75,20,56.89,349.65,1963,1972
212,11,65,14,46.55,184.43,1971,1982
213,10,80,16,51.20,274.76,1981,1991
214,11,70,3,46.55,300.79,1990,2001
215,11,75,32,46.55,131.16,2000,2011
216,11,70,30,46.55,144.79,2011,2022
217,10,85,18,51.20,474.56,2021,2031
218,9,85,21,56.89,310.54,2030,2039
219,9,75,8,56.89,385.88,2038,2047
220,8,75,50,64.00,77.00,2046,2054
221,11,65,12,46.55,255.70,2053,2064
222,10,60,38,51.20,55.56,2063,2073
223,11,70,1,46.55,331.88,2072,2083
224,11,75,13,46.55,359.88,2082,2093
225,11,70,27,46.55,152.07,2092,2103
226,10,75,5,51.20,545.96,2102,2112
227,9,75,24,56.89,232.54,2111,2120
228,9,80,31,56.89,207.21,2119,2128
229,10,85,8,51.20,433.56,2127,2137
230,9,65,40,56.89,72.99,2136,2145
231,8,75,55,64.00,47.00,2145,2153
232,9,84,8,56.89,371.43,2152,2161
233,9,90,6,56.89,751.65,2160,2169
234,9,70,38,56.89,85.88,2168,2177
235,9,80,20,56.89,307.43,2176,2185
236,9,80,12,56.89,462.99,2184,2193
237,10,70,19,51.20,203.56,2192,2202
238,8,85,40,64.00,225.50,2201,2209
239,10,75,4,51.20,445.56,2208,2218
240,9,70,27,56.89,169.65,2217,2226
241,10,80,10,51.20,477.96,2225,2235
242,10,70,9,51.20,281.56,2234,2244
243,9,80,36,56.89,242.77,2243,2252
244,10,80,9,51.20,498.56,2251,2261
245,9,75,25,56.89,208.54,2260,2269
246,11,55,25,46.55,115.70,2268,2279
247,9,65,48,56.89,38.10,2278,2287
248,11,65,21,46.55,218.25,2286,2297
249,11,70,23,46.55,195.34,2296,2307
250,9,70,40,56.89,92.99,2306,2315
251,11,65,5,46.55,334.79,2314,2325
252,11,65,19,46.55,156.25,2324,2335
253,10,65,26,51.20,122.76,2334,2344
254,11,70,3,46.55,412.61,2343,2354
255,10,75,20,51.20,232.96,2353,2363
256,11,75,20,46.55,164.79,2362,2373
257,12,65,4,42.67,271.22,2372,2384
258,9,70,36,56.89,90.54,2383,2392
259,9,75,19,56.89,241.43,2391,2400
260,9,80,7,56.89,394.10,2399,2408
261,9,70,15,56.89,278.54,2407,2416
262,10,70,3,51.20,341.56,2415,2425
263,9,75,21,56.89,379.43,2424,2433
264,10,70,8,51.20,290.56,2432,2442
265,9,65,45,56.89,41.88,2441,2450
266,11,75,5,46.55,362.07,2449,2460
267,10,85,5,51.20,450.56,2459,2469
268,9,80,37,56.89,129.65,2468,2477
269,9,70,23,56.89,172.54,2476,2485
270,10,75,1,51.20,743.76,2484,2494
271,9,80,18,56.89,253.65,2493,2502
272,9,90,20,56.89,348.54,2501,2510
273,9,80,21,56.89,248.77,2509,2518
274,11,65,13,46.55,197.16,2517,2528
275,9,75,40,56.89,120.77,2527,2536
276,10,75,13,51.20,412.56,2535,2545
277,9,70,40,56.89,85.21,2544,2553
278,10,70,22,51.20,236.96,2552,2562
279,10,70,25,51.20,171.76,2561,2571
280,10,65,17,51.20,269.96,2570,2580
281,9,70,45,56.89,52.54,2579,2588
282,11,65,1,46.55,403.70,2587,2598
283,9,70,34,56.89,116.99,2597,2606
284,10,70,7,51.20,470.96,2605,2615
285,9,75,22,56.89,217.43,2614,2623
286,10,70,24,51.20,247.76,2622,2632
287,10,70,20,51.20,182.76,2631,2641
288,10,75,8,51.20,343.56,2640,2650
289,10,65,30,51.20,104.96,2649,2659
290,10,65,11,51.20,238.96,2658,2668
291,12,60,6,42.67,278.72,2667,2679
292,10,65,23,51.20,138.56,2678,2688
293,11,70,25,46.55,181.16,2687,2698
294,10,70,25,51.20,152.96,2697,2707
295,11,60,13,46.55,179.88,2706,2717
296,11,65,10,46.55,203.88,2716,2727
297,11,70,3,46.55,328.07,2726,2737
298,12,75,6,42.67,339.72,2736,2748
299,12,65,17,42.67,159.89,2747,2759
300,11,75,28,46.55,194.43,2758,2769
301,12,55,16,42.67,113.06,2768,2780
302,10,75,12,51.20,327.96,2780,2790
303,10,65,34,51.20,81.56,2789,2799
304,11,70,30,46.55,141.88,2798,2809
305,14,50,4,36.57,127.53,2808,2822
306,13,69,2,39.38,302.39,2821,2834
307,10,66,9,51.20,310.76,2833,2843
308,9,75,31,56.89,158.32,2842,2851
309,10,65,11,51.20,306.16,2850,2860
310,9,80,39,56.89,137.88,2859,2868
311,10,70,31,51.20,123.16,2867,2877
312,12,60,20,42.67,173.06,2876,2888
313,12,60,22,42.67,94.89,2887,2899
314,13,55,7,39.38,196.85,2898,2911
315,12,60,12,42.67,154.06,2910,2922
316,11,65,19,46.55,196.25,2921,2932
317,9,70,41,56.89,120.54,2931,2940
318,10,70,3,51.20,414.56,2939,2949
319,10,60,35,51.20,38.96,2948,2958
320,11,70,2,46.55,424.79,2957,2968
321,11,55,34,46.55,56.25,2967,2978
322,10,75,21,51.20,326.76,2977,2987
323,12,70,8,42.67,206.22,2986,2998
324,11,70,15,46.55,208.43,2997,3008
325,13,60,2,39.38,176.08,3007,3020
326,11,75,10,46.55,414.43,3019,3030
327,9,70,37,56.89,90.77,3029,3038
328,10,85,4,51.20,530.56,3037,3047
329,9,81,43,56.89,118.10,3046,3055
330,10,70,25,51.20,193.96,3054,3064
331,9,75,22,56.89,345.21,3063,3072
332,9,90,25,56.89,296.32,3071,3080
333,9,74,45,56.89,85.88,3079,3088
334,9,85,13,56.89,386.99,3087,3096
335,9,95,1,56.89,889.43,3095,3104
336,9,85,35,56.89,238.10,3103,3112
337,11,80,5,46.55,442.07,3111,3122
338,8,80,50,64.00,85.75,3121,3129
339,10,80,13,51.20,334.56,3128,3138
340,10,70,5,51.20,293.96,3137,3147
341,9,80,33,56.89,189.21,3146,3155
342,11,60,23,46.55,134.61,3154,3165
343,10,70,37,51.20,112.96,3164,3174
344,10,85,20,51.20,378.56,3173,3183
345,11,70,10,46.55,189.34,3182,3193
346,11,55,35,46.55,48.43,3192,3203
347,11,65,4,46.55,335.34,3202,3213
348,12,70,1,42.67,255.56,3212,3224
349,11,60,3,46.55,261.70,3223,3234
350,10,65,37,51.20,87.96,3233,3243
351,11,72,20,46.55,159.34,3243,3254
352,10,70,30,51.20,147.96,3253,3263
353,11,80,8,46.55,297.34,3262,3273
354,11,69,23,46.55,196.25,3272,3283
355,13,55,5,39.38,141.47,3282,3295
356,12,60,13,42.67,153.72,3294,3306
357,11,70,11,46.55,375.52,3305,3316
358,9,85,18,56.89,279.21,3315,3324
359,9,75,27,56.89,175.21,3323,3332
360,10,75,12,51.20,392.96,3331,3341
361,9,85,29,56.89,191.43,3340,3349
362,10,75,26,51.20,160.76,3348,3358
363,9,70,44,56.89,74.77,3357,3366
364,10,80,2,51.20,368.96,3365,3375
365,10,80,27,51.20,148.96,3375,3385
366,10,65,24,51.20,167.56,3384,3394
367,9,85,31,56.89,240.54,3393,3402
368,10,80,14,51.20,326.56,3401,3411
369,9,75,25,56.89,215.21,3410,3419
370,10,70,12,51.20,362.96,3418,3428
371,9,70,40,56.89,102.77,3427,3436
372,11,70,3,46.55,532.98,3435,3446
373,9,75,35,56.89,116.32,3445,3454
374,10,80,14,51.20,462.56,3453,3463
375,9,75,33,56.89,191.43,3462,3471
376,10,65,21,51.20,121.76,3470,3480
377,11,70,3,46.55,473.52,3479,3490
378,10,80,5,51.20,365.96,3489,3499
379,9,70,30,56.89,132.99,3498,3507
380,11,70,11,46.55,236.43,3506,3517
381,11,60,5,46.55,303.52,3516,3527
382,9,70,45,56.89,61.88,3526,3535
383,10,75,1,51.20,428.76,3534,3544
384,11,60,2,46.55,310.43,3543,3554
385,11,70,9,46.55,262.61,3553,3564
386,11,65,8,46.55,236.98,3563,3574
387,11,80,5,46.55,279.34,3573,3584
388,11,60,34,46.55,63.52,3583,3594
389,11,60,21,46.55,160.07,3593,3604
390,11,70,24,46.55,210.79,3603,3614
391,11,75,7,46.55,290.25,3613,3624
392,11,60,15,46.55,221.16,3623,3634
393,12,70,23,42.67,136.56,3633,3645
394,12,60,12,42.67,249.89,3644,3656
395,12,65,10,42.67,199.89,3655,3667
396,12,60,30,42.67,93.39,3666,3678
397,13,60,3,39.38,225.78,3677,3690
398,10,65,21,51.20,136.76,3689,3699
399,11,70,28,46.55,145.34,3698,3709
400,10,85,2,51.20,538.96,3708,3718
401,9,95,20,56.89,410.77,3717,3726
402,10,80,3,51.20,425.56,3725,3735
403,11,70,11,46.55,212.79,3734,3745
404,11,65,4,46.55,279.88,3744,3755
405,12,55,2,42.67,188.22,3754,3766
406,13,75,7,39.38,254.54,3765,3778
407,10,80,18,51.20,380.56,3777,3787
408,9,75,21,56.89,351.65,3786,3795
409,9,75,18,56.89,316.99,3794,3803
410,10,65,30,51.20,101.96,3802,3812
411,11,65,17,46.55,162.07,3811,3822
412,12,60,18,42.67,163.72,3821,3833
413,12,60,6,42.67,238.89,3832,3844
414,11,60,29,46.55,69.88,3843,3854
415,13,60,7,39.38,243.01,3853,3866
416,9,85,32,56.89,232.99,3865,3874
417,9,85,23,56.89,295.88,3873,3882
418,11,60,11,46.55,243.70,3881,3892
419,9,75,38,56.89,169.21,3891,3900
420,10,70,22,51.20,251.96,3899,3909
421,11,70,2,46.55,311.16,3908,3919
422,9,75,14,56.89,341.43,3918,3927
423,9,85,11,56.89,362.77,3926,3935
424,9,80,35,56.89,161.43,3934,3943
425,10,80,7,51.20,535.96,3942,3952
426,9,75,7,56.89,421.88,3951,3960
427,10,70,9,51.20,240.56,3959,3969
428,10,70,30,51.20,139.76,3968,3978
429,9,75,34,56.89,186.99,3977,3986
430,10,65,17,51.20,154.96,3985,3995
431,9,75,30,56.89,152.99,3995,4004
432,10,75,3,51.20,413.56,4003,4013
433,10,85,26,51.20,255.76,4012,4022
434,9,80,33,56.89,203.65,4021,4030
435,11,65,7,46.55,235.70,4029,4040
436,11,65,15,46.55,222.98,4039,4050
437,11,70,23,46.55,158.07,4049,4060
438,11,65,21,46.55,134.61,4059,4070
439,11,60,14,46.55,149.88,4069,4080
440,10,70,2,51.20,368.96,4079,4089
441,12,60,2,42.67,334.06,4088,4100
442,10,70,29,51.20,113.56,4099,4109
443,11,60,6,46.55,209.16,4108,4119
444,12,60,14,42.67,206.22,4118,4130
445,12,70,12,42.67,254.06,4129,4141
446,13,60,25,39.38,126.08,4140,4153
447,10,65,23,51.20,152.56,4152,4162
448,11,70,6,46.55,462.79,4161,4172
449,10,65,40,51.20,50.56,4171,4181
450,10,70,7,51.20,305.96,4180,4190
451,11,70,12,46.55,328.43,4189,4200
452,10,65,28,51.20,121.56,4199,4209
453,11,70,11,46.55,188.25,4208,4219
454,11,60,14,46.55,139.88,4218,4229
455,11,60,17,46.55,202.98,4228,4239
456,10,65,30,51.20,140.96,4238,4248
457,10,65,28,51.20,163.56,4247,4257
458,10,75,6,51.20,409.76,4256,4266
459,9,75,45,56.89,111.43,4265,4274
460,10,75,7,51.20,325.56,4273,4283
461,9,80,7,56.89,377.43,4283,4292
462,10,65,16,51.20,184.96,4291,4301
463,10,70,31,51.20,146.76,4300,4310
464,11,65,9,46.55,307.52,4309,4320
465,10,70,25,51.20,188.96,4319,4329
466,10,60,35,51.20,40.96,4328,4338
467,11,75,3,46.55,344.79,4337,4348
468,10,70,34,51.20,118.56,4347,4357
469,10,75,22,51.20,201.96,4356,4366
470,11,57,10,46.55,162.98,4365,4376
471,12,65,8,42.67,268.72,4375,4387
472,10,65,34,51.20,107.16,4386,4396
473,10,65,23,51.20,175.96,4395,4405
474,10,70,20,51.20,182.96,4404,4414
475,10,65,35,51.20,80.56,4413,4423
476,11,70,1,46.55,289.52,4422,4433
477,11,70,13,46.55,214.43,4432,4443
478,10,70,16,51.20,190.76,4442,4452
479,11,70,14,46.55,216.25,4451,4462
480,10,75,17,51.20,274.96,4461,4471
481,11,60,2,46.55,224.79,4471,4482
482,11,70,24,46.55,159.88,4481,4492
483,10,80,21,51.20,239.76,4491,4501
484,10,65,19,51.20,135.56,4500,4510
485,12,60,2,42.67,310.22,4509,4521
486,11,65,26,46.55,126.61,4520,4531
487,11,65,19,46.55,150.79,4530,4541
488,11,70,7,46.55,283.16,4540,4551
489,11,70,9,46.55,231.70,4550,4561
490,13,60,2,39.38,192.54,4560,4573
491,13,50,14,39.38,116.24,4572,4585
492,11,60,24,46.55,105.34,4584,4595
493,11,65,16,46.55,225.52,4594,4605
494,12,55,3,42.67,287.06,4604,4616
495,11,65,15,46.55,166.61,4615,4626
496,11,65,2,46.55,233.88,4625,4636
497,10,68,35,51.20,78.56,4635,4645
498,11,70,11,46.55,337.34,4644,4655
499,10,65,23,51.20,149.56,4654,4664
500,11,55,15,46.55,140.25,4663,4674
501,10,65,25,51.20,154.96,4673,4683
502,11,70,4,46.55,370.79,4682,4693
503,11,60,6,46.55,189.16,4692,4703
504,11,65,38,46.55,68.98,4702,4713
505,12,55,2,42.67,238.22,4712,4724
506,11,65,12,46.55,278.43,4723,4734
507,10,70,43,51.20,69.56,4733,4743
508,10,70,11,51.20,279.76,4742,4752
509,12,65,3,42.67,371.22,4751,4763
510,11,65,30,46.55,116.61,4762,4773
511,11,60,15,46.55,143.88,4772,4783
512,10,80,3,51.20,413.56,4782,4792
513,11,65,21,46.55,165.52,4791,4802
514,10,75,24,51.20,148.56,4801,4811
515,10,65,12,51.20,197.96,4810,4820
516,11,70,22,46.55,136.61,4820,4831
517,12,60,23,42.67,79.56,4830,4842
518,12,60,1,42.67,302.22,4841,4853
519,12,60,30,42.67,73.72,4852,4864
520,11,65,17,46.55,221.16,4863,4874
521,10,60,40,51.20,33.96,4873,4883
522,12,65,14,42.67,235.39,4882,4894
523,11,55,16,46.55,141.88,4893,4904
524,11,58,29,46.55,58.98,4903,4914
525,13,65,2,39.38,226.08,4913,4926
526,11,70,7,46.55,240.25,4925,4936
527,11,60,9,46.55,175.34,4935,4946
528,11,55,21,46.55,94.61,4945,4956
529,12,60,3,42.67,251.22,4955,4967
530,11,55,30,46.55,52.07,4966,4977
531,12,65,12,42.67,254.06,4976,4988
532,10,70,28,51.20,130.56,4987,4997
533,13,65,1,39.38,342.08,4996,5009
534,10,60,40,51.20,46.56,5008,5018
535,12,60,2,42.67,217.39,5017,5029
536,12,65,7,42.67,277.39,5028,5040
537,10,65,34,51.20,95.56,5039,5049
538,11,70,1,46.55,355.52,5048,5059
539,11,71,10,46.55,242.25,5058,5069
540,10,76,14,51.20,241.76,5068,5078
541,13,63,16,39.38,125.01,5077,5090
542,13,65,14,39.38,188.70,5089,5102
543,12,60,32,42.67,58.72,5101,5113
544,15,45,5,34.13,106.78,5112,5127
545,12,61,22,42.67,77.72,5126,5138
546,13,51,7,39.38,115.31,5137,5150
547,12,60,14,42.67,128.56,5149,5161
548,13,56,29,39.38,54.39,5160,5173
549,14,52,4,36.57,183.10,5172,5186
550,15,48,15,34.13,77.05,5185,5200
551,14,48,17,36.57,54.67,5199,5213
552,15,52,4,34.13,118.12,5212,5227
553,14,50,15,36.57,91.10,5226,5240
554,15,48,9,34.13,124.38,5239,5254
555,17,48,7,30.12,89.99,5253,5270
556,18,38,4,28.44,60.58,5269,5287
557,13,52,17,39.38,137.16,5286,5299
558,12,57,29,42.67,84.72,5298,5310
559,14,49,13,36.57,87.10,5309,5323
560,12,60,3,42.67,214.06,5322,5334
561,14,51,7,36.57,165.24,5333,5347
562,14,61,23,36.57,76.10,5346,5360
563,15,59,10,34.13,121.45,5359,5374
564,9,85,6,56.89,711.65,5373,5382
565,7,95,43,73.14,221.55,5381,5388
566,8,90,22,64.00,394.25,5387,5395
567,8,85,38,64.00,206.75,5394,5402
568,6,130,38,85.33,1019.89,5401,5407
569,9,80,12,56.89,568.54,5406,5415
570,7,95,19,73.14,701.55,5414,5421
571,7,105,36,73.14,601.84,5420,5427
572,8,95,18,64.00,685.25,5426,5434
573,7,105,40,73.14,512.12,5433,5440
574,7,90,30,73.14,380.69,5439,5446
575,7,105,18,73.14,702.98,5445,5452
576,8,90,16,64.00,501.00,5451,5459
577,7,100,26,73.14,523.84,5458,5465
578,9,78,6,56.89,670.77,5464,5473
579,7,85,65,73.14,50.12,5472,5479
580,8,95,10,64.00,912.00,5478,5486
581,6,145,32,85.33,1147.22,5485,5491
582,8,90,24,64.00,510.25,5490,5498
583,7,100,55,73.14,234.69,5497,5504
584,9,85,4,56.89,641.43,5503,5512
585,7,95,37,73.14,306.41,5511,5518
586,7,105,40,73.14,391.55,5517,5524
587,7,90,37,73.14,308.98,5523,5530
588,8,90,13,64.00,654.00,5529,5537
589,9,95,8,56.89,635.21,5536,5545
590,7,90,55,73.14,189.27,5544,5551
591,9,75,20,56.89,430.77,5550,5559
592,7,94,60,73.14,104.41,5558,5565
593,8,100,27,64.00,392.00,5564,5572
594,7,90,65,73.14,73.55,5571,5578
595,8,85,18,64.00,344.00,5577,5585
596,8,92,10,64.00,680.75,5584,5592
597,8,95,30,64.00,387.00,5591,5599
598,9,85,1,56.89,578.10,5598,5607
599,8,85,23,64.00,387.75,5606,5614
600,7,100,30,73.14,550.69,5613,5620
601,8,85,18,64.00,415.25,5619,5627
602,9,90,1,56.89,952.77,5626,5635
603,8,80,13,64.00,399.00,5634,5642
604,8,77,12,64.00,403.00,5641,5649
605,8,80,2,64.00,609.25,5648,5656
606,7,90,54,73.14,197.27,5655,5662
607,8,84,18,64.00,373.50,5661,5669
608,7,90,57,73.14,114.12,5668,5675
609,8,90,9,64.00,719.00,5674,5682
610,7,95,17,73.14,591.84,5681,5688
611,9,105,27,56.89,425.21,5687,5696
612,7,92,30,73.14,423.55,5695,5702
613,8,95,20,64.00,417.00,5701,5709
614,8,90,18,64.00,457.50,5708,5716
615,7,105,18,73.14,834.41,5715,5722
616,8,95,4,64.00,849.50,5721,5729
617,8,105,8,64.00,692.00,5728,5736
618,7,105,30,73.14,464.98,5735,5742
619,8,90,22,64.00,389.50,5741,5749
620,9,80,5,56.89,408.10,5748,5757
621,8,85,50,64.00,135.75,5756,5764
622,8,84,8,64.00,506.50,5763,5771
623,8,120,4,64.00,920.00,5770,5778
624,9,100,5,56.89,976.10,5777,5786
625,7,90,47,73.14,176.41,5785,5792
626,8,85,28,64.00,269.50,5791,5799
627,7,109,34,73.14,439.84,5798,5805
628,8,105,26,64.00,632.25,5804,5812
629,9,85,5,56.89,580.32,5811,5820
630,6,115,47,85.33,432.22,5819,5825
631,8,90,13,64.00,499.50,5824,5832
632,9,75,19,56.89,275.88,5831,5840
633,7,115,32,73.14,796.41,5839,5846
634,9,75,7,56.89,416.32,5845,5854
635,9,75,7,56.89,380.10,5853,5862
636,7,85,64,73.14,54.41,5861,5868
637,9,85,16,56.89,530.99,5867,5876
638,8,75,31,64.00,171.75,5875,5883
639,8,95,24,64.00,624.75,5882,5890
640,8,105,39,64.00,525.25,5889,5897
641,8,90,29,64.00,399.75,5896,5904
642,7,120,21,73.14,960.41,5903,5910
643,7,101,48,73.14,237.55,5909,5916
644,8,80,22,64.00,295.75,5915,5923
645,7,100,35,73.14,492.12,5922,5929
646,8,95,18,64.00,419.00,5928,5936
647,9,90,1,56.89,800.54,5935,5944
648,8,85,40,64.00,222.00,5943,5951
649,8,95,28,64.00,490.75,5950,5958
650,8,95,11,64.00,548.50,5957,5965
651,8,74,40,64.00,103.75,5964,5972
652,7,100,21,73.14,536.41,5971,5978
653,7,135,20,73.14,1036.41,5977,5984
654,9,75,3,56.89,486.32,5983,5992
655,7,90,39,73.14,322.98,5991,5998
656,9,94,12,56.89,690.77,5997,6006
657,8,85,26,64.00,388.00,6005,6013
658,8,95,15,64.00,562.00,6012,6020
659,7,95,52,73.14,150.69,6019,6026
660,8,101,13,64.00,660.75,6025,6033
661,8,105,5,64.00,768.25,6032,6040
662,8,80,23,64.00,358.00,6039,6047
663,8,80,30,64.00,325.25,6046,6054
664,8,90,15,64.00,520.75,6053,6061
665,8,90,25,64.00,397.00,6060,6068
666,7,90,42,73.14,237.84,6067,6074
667,7,95,40,73.14,395.84,6073,6080
668,8,90,21,64.00,436.75,6079,6087
669,9,90,4,56.89,819.88,6086,6095
670,7,90,56,73.14,132.12,6094,6101
671,8,105,18,64.00,867.75,6100,6108
672,8,100,26,64.00,567.75,6107,6115
673,8,95,35,64.00,277.50,6114,6122
674,8,90,1,64.00,665.50,6121,6129
675,8,85,32,64.00,236.00,6128,6136
676,7,95,43,73.14,364.41,6135,6142
677,8,105,5,64.00,1125.00,6141,6149
678,8,88,40,64.00,272.50,6148,6156
679,9,80,17,56.89,342.54,6155,6164
680,8,95,26,64.00,493.00,6163,6171
681,9,95,31,56.89,327.65,6170,6179
682,7,95,40,73.14,310.69,6178,6185
683,8,90,4,64.00,691.50,6184,6192
684,7,117,42,73.14,440.69,6191,6198
685,9,90,8,56.89,576.99,6197,6206
686,7,95,41,73.14,404.69,6205,6212
687,9,95,22,56.89,450.10,6211,6220
688,8,120,33,64.00,577.75,6219,6227
689,8,90,46,64.00,149.00,6226,6234
690,7,95,42,73.14,209.27,6234,6241
691,8,85,28,64.00,305.25,6240,6248
692,8,85,15,64.00,420.75,6247,6255
693,9,80,12,56.89,490.77,6254,6263
694,8,95,21,64.00,470.75,6262,6270
695,8,95,42,64.00,210.00,6269,6277
696,8,85,4,64.00,656.50,6276,6284
697,9,80,17,56.89,320.54,6283,6292
698,8,93,3,64.00,674.75,6291,6299
699,8,95,17,64.00,552.25,6298,6306
700,9,85,4,56.89,861.88,6305,6314
701,8,95,5,64.00,623.00,6313,6321
702,8,80,2,64.00,579.50,6320,6328
703,8,78,33,64.00,197.25,6327,6335
704,8,90,32,64.00,327.25,6334,6342
705,8,95,40,64.00,304.25,6341,6349
706,9,80,9,56.89,383.65,6348,6357
707,9,80,17,56.89,448.54,6356,6365
708,8,80,45,64.00,128.25,6364,6372
709,9,75,13,56.89,396.32,6371,6380
710,9,85,20,56.89,355.21,6379,6388
711,8,85,42,64.00,143.25,6387,6395
712,8,95,10,64.00,905.75,6394,6402
713,8,85,12,64.00,459.50,6401,6409
714,8,80,55,64.00,94.00,6408,6416
715,9,75,21,56.89,390.54,6415,6424
716,9,70,2,56.89,444.32,6423,6432
717,8,85,49,64.00,161.50,6431,6439
718,10,65,11,51.20,315.76,6438,6448
719,8,80,29,64.00,269.00,6447,6455
720,9,80,14,56.89,363.65,6454,6463
721,9,90,2,56.89,550.99,6462,6471
722,9,85,28,56.89,306.32,6470,6479
723,8,100,5,64.00,719.50,6478,6486
724,8,105,7,64.00,763.25,6485,6493
725,8,85,14,64.00,437.75,6492,6500
726,8,95,46,64.00,185.50,6499,6507
727,9,95,14,56.89,643.65,6506,6515
728,8,80,55,64.00,78.50,6514,6522
729,9,90,18,56.89,452.54,6521,6530
730,8,75,46,64.00,139.75,6529,6537
731,9,80,19,56.89,355.65,6536,6545
732,9,85,16,56.89,426.10,6544,6553
733,8,80,20,64.00,350.75,6552,6560
734,8,95,5,64.00,647.00,6559,6567
735,8,94,28,64.00,381.50,6566,6574
736,10,80,1,51.20,718.76,6573,6583
737,8,80,8,64.00,502.75,6582,6590
738,8,91,29,64.00,323.50,6589,6597
739,8,80,21,64.00,370.50,6596,6604
740,8,95,39,64.00,261.75,6603,6611
741,9,75,21,56.89,250.54,6610,6619
742,8,95,4,64.00,660.25,6618,6626
743,9,90,20,56.89,522.99,6625,6634
744,8,110,1,64.00,925.50,6633,6641
745,7,95,64,73.14,124.41,6640,6647
746,9,80,7,56.89,677.43,6646,6655
747,8,95,45,64.00,284.75,6654,6662
748,8,80,36,64.00,220.75,6661,6669
749,10,90,10,51.20,477.16,6668,6678
750,8,85,38,64.00,217.00,6677,6685
751,8,105,21,64.00,861.00,6684,6692
752,7,100,38,73.14,301.55,6691,6698
753,8,95,28,64.00,529.00,6697,6705
754,9,80,35,56.89,182.77,6704,6713
755,8,85,17,64.00,443.25,6712,6720
756,7,95,21,73.14,522.12,6719,6726
757,8,90,13,64.00,607.75,6725,6733
758,8,100,15,64.00,500.75,6732,6740
759,8,100,45,64.00,277.00,6739,6747
760,9,80,16,56.89,324.99,6746,6755
761,9,82,19,56.89,327.65,6754,6763
762,8,95,40,64.00,229.25,6762,6770
763,9,75,11,56.89,456.32,6769,6778
764,8,85,37,64.00,209.50,6777,6785
765,7,105,37,73.14,406.41,6785,6792
766,9,95,1,56.89,604.10,6791,6800
767,7,85,53,73.14,87.84,6799,6806
768,9,90,17,56.89,504.10,6805,6814
769,8,90,24,64.00,456.50,6813,6821
770,8,90,19,64.00,405.50,6820,6828
771,8,85,46,64.00,141.75,6827,6835
772,9,85,9,56.89,713.65,6834,6843
773,8,80,55,64.00,71.00,6842,6850
774,9,80,6,56.89,585.88,6849,6858
775,8,90,27,64.00,355.50,6857,6865
776,8,85,38,64.00,230.25,6864,6872
777,8,100,29,64.00,548.50,6871,6879
778,8,84,29,64.00,297.50,6878,6886
779,8,105,17,64.00,828.50,6885,6893
780,8,85,41,64.00,220.25,6892,6900
781,8,90,24,64.00,395.25,6899,6907
782,8,90,20,64.00,407.00,6906,6914
783,7,84,60,73.14,61.55,6913,6920
784,8,105,9,64.00,827.25,6919,6927
785,7,105,48,73.14,314.98,6926,6933
786,8,80,42,64.00,130.75,6932,6940
787,7,110,58,73.14,284.41,6940,6947
788,7,115,1,73.14,1266.12,6946,6953
789,8,85,30,64.00,249.50,6952,6960
790,8,86,10,64.00,575.50,6959,6967
791,8,95,29,64.00,532.25,6966,6974
792,8,76,31,64.00,177.50,6973,6981
793,8,100,39,64.00,342.75,6980,6988
794,8,93,2,64.00,996.75,6987,6995
795,8,90,14,64.00,425.25,6994,7002
796,8,70,51,64.00,51.75,7001,7009
797,8,100,4,64.00,749.00,7008,7016
798,8,85,40,64.00,224.50,7015,7023
799,9,80,23,56.89,368.54,7022,7031
800,8,80,43,64.00,113.50,7030,7038
801,9,85,10,56.89,652.54,7037,7046
802,7,100,50,73.14,231.55,7045,7052
803,8,90,16,64.00,418.00,7051,7059
804,8,85,10,64.00,475.25,7058,7066
805,9,75,6,56.89,456.10,7065,7074
806,8,92,20,64.00,361.00,7073,7081
807,8,105,10,64.00,784.00,7080,7088
808,8,90,32,64.00,363.25,7087,7095
809,9,80,10,56.89,604.10,7094,7103
810,8,80,38,64.00,160.75,7102,7110
811,8,90,29,64.00,330.25,7109,7117
812,9,70,10,56.89,351.88,7116,7125
813,8,90,20,64.00,437.75,7124,7132
814,8,95,2,64.00,660.75,7131,7139
815,8,95,10,64.00,532.00,7138,7146
816,10,75,12,51.20,306.76,7145,7155
817,8,80,29,64.00,220.25,7154,7162
818,9,100,8,56.89,770.32,7161,7170
819,8,85,18,64.00,395.00,7169,7177
820,7,99,42,73.14,375.27,7176,7183
821,9,80,14,56.89,316.54,7182,7191
822,8,91,14,64.00,910.50,7190,7198
823,7,107,36,73.14,538.69,7197,7204
824,8,100,19,64.00,623.50,7203,7211
825,8,85,33,64.00,350.25,7210,7218
826,8,95,26,64.00,466.75,7217,7225
827,9,80,4,56.89,707.65,7224,7233
828,8,75,27,64.00,214.75,7232,7240
829,8,90,39,64.00,229.00,7239,7247
830,9,75,26,56.89,211.65,7246,7255
831,8,90,29,64.00,467.25,7254,7262
832,7,95,29,73.14,507.27,7261,7268
833,8,80,7,64.00,482.00,7267,7275
834,8,90,17,64.00,462.00,7274,7282
835,7,98,50,73.14,322.12,7281,7288
836,8,85,9,64.00,527.75,7287,7295
837,8,83,22,64.00,283.00,7294,7302
838,9,75,13,56.89,374.77,7301,7310
839,8,90,26,64.00,319.25,7309,7317
840,9,70,4,56.89,392.54,7316,7325
841,9,80,7,56.89,410.77,7324,7333
842,8,115,17,64.00,812.00,7332,7340
843,8,85,26,64.00,284.50,7339,7347
844,8,104,19,64.00,486.25,7346,7354
845,9,80,43,56.89,126.77,7353,7362
846,9,86,20,56.89,487.43,7361,7370
847,8,87,50,64.00,134.50,7369,7377
848,8,83,21,64.00,330.50,7376,7384
849,9,90,12,56.89,612.10,7383,7392
850,8,80,44,64.00,90.00,7391,7399
851,9,113,23,56.89,665.88,7398,7407
852,8,85,34,64.00,331.00,7406,7414
853,8,90,11,64.00,525.50,7413,7421
854,8,95,13,64.00,524.00,7420,7428
855,8,90,20,64.00,452.00,7427,7435
856,8,85,39,64.00,245.25,7434,7442
857,8,90,40,64.00,265.75,7441,7449
858,8,90,22,64.00,452.00,7448,7456
859,9,70,29,56.89,226.77,7455,7464
860,9,90,21,56.89,458.54,7463,7472
861,8,85,27,64.00,335.75,7471,7479
862,9,90,5,56.89,482.99,7478,7487
863,8,80,16,64.00,429.25,7486,7494
864,8,95,9,64.00,585.50,7493,7501
865,8,80,15,64.00,380.50,7500,7508
866,10,80,1,51.20,655.56,7507,7517
867,8,99,7,64.00,598.50,7516,7524
868,8,80,19,64.00,327.75,7523,7531
869,7,100,51,73.14,194.69,7530,7537
870,8,90,29,64.00,298.00,7536,7544
871,9,85,8,56.89,556.99,7543,7552
872,8,75,47,64.00,74.25,7551,7559
873,7,101,23,73.14,524.98,7558,7565
874,9,80,2,56.89,641.65,7564,7573
875,8,100,20,64.00,816.50,7572,7580
876,8,85,39,64.00,189.00,7579,7587
877,8,110,17,64.00,760.50,7586,7594
878,8,95,13,64.00,742.75,7593,7601
879,7,120,41,73.14,563.27,7600,7607
880,8,95,4,64.00,1124.00,7606,7614
881,8,90,24,64.00,362.25,7613,7621
882,9,85,21,56.89,440.54,7620,7629
883,8,90,26,64.00,443.25,7628,7636
884,8,75,41,64.00,107.75,7635,7643
885,9,85,26,56.89,320.99,7642,7651
886,9,75,41,56.89,147.43,7650,7659
887,8,98,22,64.00,475.50,7658,7666
888,8,85,28,64.00,330.25,7665,7673
889,9,87,11,56.89,480.77,7672,7681
890,9,80,24,56.89,286.54,7680,7689
891,7,90,60,73.14,87.55,7688,7695
892,8,80,40,64.00,167.00,7695,7703
893,8,85,18,64.00,400.25,7702,7710
894,8,90,6,64.00,535.50,7709,7717
895,8,95,12,64.00,681.75,7716,7724
896,7,105,59,73.14,248.41,7723,7730
897,8,120,21,64.00,731.50,7729,7737
898,8,98,8,64.00,825.75,7736,7744
899,7,120,10,73.14,989.27,7743,7750
900,8,95,32,64.00,275.75,7749,7757
901,9,85,18,56.89,496.99,7756,7765
902,9,85,34,56.89,222.54,7764,7773
903,9,80,26,56.89,270.54,7772,7781
904,9,75,12,56.89,306.77,7780,7789
905,8,75,49,64.00,59.00,7788,7796
906,8,90,11,64.00,519.50,7795,7803
907,9,80,7,56.89,449.88,7802,7811
908,9,80,16,56.89,446.54,7810,7819
909,9,75,24,56.89,211.43,7818,7827
910,7,100,41,73.14,312.12,7826,7833
911,9,95,11,56.89,549.43,7832,7841
912,9,80,9,56.89,362.32,7840,7849
913,9,80,24,56.89,239.88,7848,7857
914,8,85,46,64.00,176.75,7856,7864
915,9,80,21,56.89,340.99,7863,7872
916,8,90,18,64.00,582.75,7871,7879
917,8,85,19,64.00,438.50,7878,7886
918,9,85,4,56.89,483.65,7885,7894
919,8,90,18,64.00,427.75,7893,7901
920,7,100,49,73.14,330.12,7900,7907
921,9,80,21,56.89,400.54,7906,7915
922,8,95,24,64.00,403.75,7914,7922
923,8,95,41,64.00,294.25,7921,7929
924,9,75,18,56.89,293.65,7928,7937
925,8,70,42,64.00,93.25,7936,7944
926,8,85,10,64.00,558.25,7943,7951
927,9,88,11,56.89,599.65,7950,7959
928,8,84,26,64.00,339.75,7958,7966
929,9,75,28,56.89,272.54,7965,7974
930,9,75,16,56.89,406.10,7973,7982
931,7,105,34,73.14,450.12,7981,7988
932,8,100,7,64.00,686.75,7987,7995
933,9,75,17,56.89,275.43,7994,8003
934,8,95,9,64.00,659.00,8002,8010
935,9,72,39,56.89,85.43,8009,8018
936,8,95,16,64.00,538.00,8017,8025
937,7,110,24,73.14,867.27,8024,8031
938,7,110,30,73.14,806.41,8030,8037
939,9,80,7,56.89,466.32,8036,8045
940,8,80,45,64.00,111.50,8044,8052
941,10,70,11,51.20,272.76,8051,8061
942,8,82,46,64.00,128.50,8060,8068
943,8,94,6,64.00,983.75,8067,8075
944,7,100,35,73.14,401.55,8074,8081
945,8,95,2,64.00,979.50,8080,8088
946,7,100,7,73.14,776.12,8087,8094
947,7,95,49,73.14,335.84,8093,8100
948,9,80,16,56.89,402.77,8099,8108
949,9,80,33,56.89,169.21,8107,8116
950,7,113,7,73.14,1100.41,8115,8122
951,7,100,43,73.14,347.84,8121,8128
952,9,95,7,56.89,621.88,8127,8136
953,7,100,27,73.14,529.27,8135,8142
954,8,80,49,64.00,99.00,8141,8149
955,8,80,36,64.00,182.00,8148,8156
956,9,80,8,56.89,384.10,8155,8164
957,8,89,2,64.00,623.50,8163,8171
958,9,81,5,56.89,624.32,8170,8179
959,7,90,42,73.14,230.69,8178,8185
960,8,75,28,64.00,227.50,8184,8192
961,8,97,8,64.00,819.25,8191,8199
962,8,95,26,64.00,313.50,8198,8206
963,9,85,24,56.89,270.10,8205,8214
964,7,115,31,73.14,727.55,8213,8220
965,7,120,37,73.14,699.84,8219,8226
966,9,95,7,56.89,864.77,8225,8234
967,8,75,42,64.00,98.75,8233,8241
968,8,125,10,64.00,1088.00,8240,8248
969,8,85,10,64.00,521.50,8247,8255
970,7,85,62,73.14,56.41,8254,8261
971,9,90,26,56.89,434.99,8260,8269
972,7,115,33,73.14,610.12,8268,8275
973,8,95,34,64.00,351.00,8274,8282
974,9,85,16,56.89,510.54,8281,8290
975,7,115,39,73.14,552.98,8289,8296
976,7,120,12,73.14,1842.12,8295,8302
977,8,80,38,64.00,182.75,8301,8309
978,8,90,40,64.00,207.00,8308,8316
979,7,95,40,73.14,404.41,8315,8322
980,8,125,16,64.00,1015.50,8321,8329
981,8,85,24,64.00,336.50,8328,8336
982,9,80,12,56.89,565.65,8335,8344
983,8,80,30,64.00,245.25,8343,8351
984,8,95,5,64.00,655.25,8350,8358
985,7,120,16,73.14,1177.55,8357,8364
986,8,100,8,64.00,790.25,8363,8371
987,9,90,5,56.89,515.21,8370,8379
988,8,85,30,64.00,235.75,8378,8386
989,8,85,39,64.00,167.50,8385,8393
990,9,95,1,56.89,927.43,8392,8401
991,8,75,50,64.00,84.00,8400,8408
992,7,120,7,73.14,1224.98,8407,8414
993,9,110,10,56.89,815.21,8413,8422
994,8,93,25,64.00,382.00,8421,8429
995,8,90,3,64.00,686.50,8428,8436
996,8,90,46,64.00,202.25,8435,8443
997,8,115,15,64.00,1111.75,8442,8450
998,8,85,40,64.00,255.75,8449,8457
999,8,80,43,64.00,132.75,8456,8464
1000,9,85,6,56.89,576.10,8463,8472
1001,8,85,44,64.00,223.75,8471,8479
1002,9,85,1,56.89,614.99,8478,8487
1003,7,110,30,73.14,551.55,8486,8493
1004,8,90,38,64.00,292.75,8492,8500
1005,10,75,1,51.20,688.76,8499,8509
1006,8,95,28,64.00,325.25,8508,8516
1007,9,75,40,56.89,207.65,8515,8524
1008,8,90,29,64.00,384.00,8523,8531
1009,8,80,37,64.00,218.75,8530,8538
1010,10,80,2,51.20,545.96,8537,8547
1011,8,96,37,64.00,318.25,8546,8554
1012,8,105,23,64.00,548.25,8553,8561
1013,9,80,7,56.89,727.43,8560,8569
1014,8,85,7,64.00,588.25,8568,8576
1015,8,95,19,64.00,392.75,8575,8583
1016,8,90,5,64.00,638.25,8582,8590
1017,8,95,5,64.00,657.00,8589,8597
1018,7,140,42,73.14,937.84,8596,8603
1019,9,75,23,56.89,237.43,8602,8611
1020,8,85,39,64.00,253.75,8610,8618
1021,8,92,29,64.00,422.00,8617,8625
1022,8,100,30,64.00,451.75,8624,8632
1023,7,95,30,73.14,424.98,8631,8638
1024,8,88,12,64.00,718.00,8637,8645
1025,7,88,60,73.14,110.69,8644,8651
1026,8,95,19,64.00,558.50,8650,8658
1027,8,105,18,64.00,729.00,8657,8665
1028,9,75,35,56.89,216.10,8664,8673
1029,8,85,22,64.00,339.50,8672,8680
1030,9,90,9,56.89,493.65,8679,8688
1031,8,85,24,64.00,330.25,8687,8695
1032,9,80,21,56.89,450.54,8694,8703
1033,8,90,23,64.00,440.25,8702,8710
1034,8,105,42,64.00,334.75,8709,8717
1035,8,125,29,64.00,802.75,8716,8724
1036,8,90,12,64.00,534.50,8723,8731
1037,9,85,5,56.89,740.77,8730,8739
1038,7,105,54,73.14,250.12,8738,8745
1039,8,92,20,64.00,374.50,8744,8752
1040,9,85,23,56.89,337.43,8751,8760
1041,9,76,36,56.89,163.65,8759,8768
1042,7,105,14,73.14,787.27,8767,8774
1043,8,100,17,64.00,526.00,8773,8781
1044,8,95,29,64.00,449.00,8780,8788
1045,8,85,45,64.00,229.50,8787,8795
1046,7,110,15,73.14,917.27,8794,8801
1047,9,130,17,56.89,975.21,8800,8809
1048,9,90,33,56.89,353.65,8808,8817
1049,8,100,11,64.00,943.00,8816,8824
1050,8,100,18,64.00,550.25,8823,8831
1051,8,95,30,64.00,424.50,8830,8838
1052,8,90,35,64.00,240.75,8837,8845
1053,8,80,18,64.00,374.00,8844,8852
1054,8,98,11,64.00,548.00,8851,8859
1055,8,105,6,64.00,673.00,8858,8866
1056,8,90,19,64.00,573.00,8865,8873
1057,9,75,19,56.89,286.99,8872,8881
1058,7,90,55,73.14,123.27,8880,8887
1059,9,90,4,56.89,770.32,8886,8895
1060,7,100,60,73.14,180.69,8894,8901
1061,8,90,7,64.00,707.00,8900,8908
1062,8,85,26,64.00,474.25,8907,8915
1063,8,85,3,64.00,681.50,8914,8922
1064,8,80,50,64.00,105.75,8921,8929
1065,8,100,7,64.00,782.00,8928,8936
1066,8,85,4,64.00,561.50,8935,8943
1067,8,110,21,64.00,555.50,8942,8950
1068,8,100,3,64.00,716.50,8949,8957
1069,8,95,30,64.00,345.75,8956,8964
1070,7,105,58,73.14,224.41,8963,8970
1071,8,90,21,64.00,472.00,8969,8977
1072,7,95,13,73.14,650.12,8976,8983
1073,8,80,35,64.00,209.50,8982,8990
1074,8,102,15,64.00,618.00,8989,8997
1075,8,100,18,64.00,494.50,8996,9004
1076,9,85,2,56.89,641.88,9003,9012
1077,8,90,12,64.00,690.75,9011,9019
1078,8,90,16,64.00,463.25,9018,9026
1079,8,90,34,64.00,338.75,9025,9033
1080,8,85,31,64.00,321.75,9032,9040
1081,9,95,3,56.89,956.99,9039,9048
1082,8,75,45,64.00,82.00,9047,9055
1083,9,105,10,56.89,715.21,9054,9063
1084,9,74,43,56.89,87.88,9062,9071
1085,8,85,15,64.00,493.25,9071,9079
1086,8,100,17,64.00,512.00,9078,9086
1087,8,95,44,64.00,182.75,9085,9093
1088,8,85,26,64.00,368.00,9092,9100
1089,8,80,36,64.00,198.50,9099,9107
1090,8,85,23,64.00,550.25,9106,9114
1091,9,85,36,56.89,224.99,9113,9122
1092,8,80,26,64.00,331.00,9121,9129
1093,8,95,39,64.00,369.75,9128,9136
1094,10,65,19,51.20,181.56,9135,9145
1095,9,80,36,56.89,187.21,9144,9153
1096,8,95,15,64.00,537.00,9152,9160
1097,7,100,17,73.14,1030.69,9159,9166
1098,7,95,9,73.14,790.12,9165,9172
1099,8,76,21,64.00,290.50,9171,9179
1100,7,105,29,73.14,676.98,9178,9185
1101,8,80,41,64.00,123.25,9184,9192
1102,7,100,17,73.14,652.12,9191,9198
1103,9,75,20,56.89,366.32,9197,9206
1104,8,90,49,64.00,211.00,9205,9213
1105,8,95,6,64.00,696.75,9212,9220
1106,8,85,24,64.00,505.00,9219,9227
1107,8,100,11,64.00,650.50,9226,9234
1108,8,85,45,64.00,226.50,9233,9241
1109,9,90,5,56.89,555.21,9240,9249
1110,8,85,28,64.00,269.00,9248,9256
1111,8,100,5,64.00,627.00,9255,9263
1112,8,90,13,64.00,450.25,9262,9270
1113,9,80,1,56.89,513.21,9269,9278
1114,9,85,13,56.89,600.32,9277,9286
1115,7,95,65,73.14,99.27,9285,9292
1116,8,85,22,64.00,321.75,9291,9299
1117,8,85,43,64.00,184.25,9298,9306
1118,8,95,28,64.00,477.00,9305,9313
1119,7,111,34,73.14,705.27,9312,9319
1120,7,100,41,73.14,309.55,9318,9325
1121,8,75,38,64.00,162.75,9324,9332
1122,8,90,36,64.00,365.75,9331,9339
1123,8,95,17,64.00,655.75,9338,9346
1124,7,105,42,73.14,380.69,9345,9352
1125,7,100,48,73.14,322.98,9351,9358
1126,8,110,12,64.00,861.75,9357,9365
1127,7,101,42,73.14,506.69,9364,9371
1128,8,87,12,64.00,472.00,9370,9378
1129,9,85,5,56.89,611.65,9377,9386
1130,6,100,75,85.33,63.89,9385,9391
1131,8,102,17,64.00,658.00,9390,9398
1132,8,90,9,64.00,611.50,9397,9405
1133,8,85,20,64.00,324.50,9404,9412
1134,7,95,42,73.14,259.27,9411,9418
1135,8,105,11,64.00,736.00,9417,9425
1136,9,75,20,56.89,370.54,9424,9433
1137,8,80,40,64.00,214.25,9432,9440
1138,9,82,4,56.89,740.10,9439,9448
1139,7,90,50,73.14,202.12,9447,9454
1140,8,80,25,64.00,316.50,9453,9461
1141,8,100,2,64.00,809.25,9460,9468
1142,8,100,18,64.00,646.50,9467,9475
1143,8,85,42,64.00,193.50,9474,9482
1144,8,100,24,64.00,636.50,9481,9489
1145,7,105,26,73.14,690.41,9488,9495
1146,8,85,44,64.00,218.00,9494,9502
1147,8,95,12,64.00,617.75,9501,9509
1148,10,90,4,51.20,451.36,9508,9518
1149,8,95,31,64.00,451.25,9517,9525
1150,8,78,28,64.00,219.50,9524,9532
1151,8,100,7,64.00,813.25,9531,9539
1152,7,100,35,73.14,407.55,9538,9545
1153,7,97,34,73.14,398.12,9544,9551
1154,8,100,13,64.00,544.50,9550,9558
1155,9,75,29,56.89,198.10,9557,9566
1156,8,105,12,64.00,572.00,9565,9573
1157,8,95,40,64.00,281.50,9573,9581
1158,7,110,26,73.14,1021.84,9580,9587
1159,7,95,28,73.14,485.84,9586,9593
1160,8,90,10,64.00,553.25,9592,9600
1161,7,90,55,73.14,136.41,9599,9606
1162,8,85,18,64.00,459.00,9605,9613
1163,9,75,21,56.89,351.65,9612,9621
1164,8,85,46,64.00,166.75,9620,9628
1165,8,90,5,64.00,590.75,9627,9635
1166,7,100,23,73.14,601.55,9634,9641
1167,9,75,31,56.89,167.43,9640,9649
1168,8,105,13,64.00,657.75,9648,9656
1169,8,100,26,64.00,506.75,9655,9663
1170,7,90,39,73.14,231.55,9662,9669
1171,8,85,12,64.00,468.50,9668,9676
1172,8,83,19,64.00,329.00,9675,9683
1173,8,90,2,64.00,673.25,9682,9690
1174,9,95,14,56.89,588.10,9689,9698
1175,8,85,9,64.00,548.50,9697,9705
1176,8,95,6,64.00,644.25,9704,9712
1177,7,94,43,73.14,272.12,9711,9718
1178,7,110,19,73.14,877.27,9717,9724
1179,9,80,22,56.89,321.65,9723,9732
1180,8,85,27,64.00,293.00,9731,9739
1181,9,80,14,56.89,418.99,9738,9747
1182,8,100,41,64.00,354.50,9746,9754
1183,8,85,31,64.00,358.00,9753,9761
1184,9,105,2,56.89,952.99,9760,9769
1185,8,85,24,64.00,318.00,9768,9776
1186,8,94,15,64.00,444.75,9775,9783
1187,7,85,53,73.14,104.41,9782,9789
1188,8,100,11,64.00,955.50,9788,9796
1189,7,104,18,73.14,677.27,9795,9802
1190,7,100,59,73.14,153.84,9801,9808
1191,8,80,33,64.00,234.00,9807,9815
1192,8,85,40,64.00,250.75,9814,9822
1193,9,80,15,56.89,408.54,9821,9830
1194,8,95,22,64.00,513.00,9829,9837
1195,8,100,48,64.00,217.75,9836,9844
1196,8,80,10,64.00,501.50,9843,9851
1197,8,95,11,64.00,929.25,9850,9858
1198,8,86,5,64.00,609.75,9857,9865
1199,9,85,9,56.89,394.32,9864,9873
1200,8,90,43,64.00,218.25,9872,9880
1201,9,90,7,56.89,760.54,9879,9888
1202,8,80,50,64.00,111.50,9887,9895
1203,10,90,1,51.20,758.96,9894,9904
1204,8,100,44,64.00,257.75,9903,9911
1205,8,90,31,64.00,431.75,9910,9918
1206,9,80,44,56.89,129.21,9917,9926
1207,7,105,41,73.14,404.41,9925,9932
1208,9,80,12,56.89,497.21,9931,9940
1209,9,75,32,56.89,228.99,9939,9948
1210,8,120,6,64.00,1006.75,9947,9955
1211,9,85,8,56.89,400.10,9954,9963
1212,8,87,53,64.00,105.00,9962,9970
1213,9,80,1,56.89,514.77,9969,9978
1214,8,100,9,64.00,703.50,9977,9985
1215,9,80,13,56.89,566.32,9984,9993
1216,9,75,29,56.89,273.21,9992,10001
1217,9,75,36,56.89,209.43,10000,10009
1218,9,85,17,56.89,537.65,10008,10017
1219,9,85,24,56.89,272.54,10016,10025
1220,8,90,15,64.00,525.75,10024,10032
1221,8,80,13,64.00,565.50,10031,10039
1222,9,85,13,56.89,628.10,10038,10047
1223,8,88,40,64.00,236.50,10046,10054
1224,9,80,12,56.89,525.43,10053,10062
1225,8,95,40,64.00,248.50,10061,10069
1226,8,90,25,64.00,309.00,10068,10076
1227,9,85,2,56.89,519.88,10075,10084
1228,9,85,12,56.89,546.32,10083,10092
1229,8,80,52,64.00,60.75,10091,10099
1230,9,75,13,56.89,367.43,10098,10107
1231,9,100,9,56.89,735.43,10106,10115
1232,9,95,17,56.89,391.65,10114,10123
1233,8,90,32,64.00,388.25,10122,10130
1234,9,85,21,56.89,419.43,10129,10138
1235,8,90,38,64.00,283.75,10137,10145
1236,9,85,8,56.89,585.88,10144,10153
1237,10,78,33,51.20,228.36,10152,10162
1238,9,90,22,56.89,457.65,10161,10170
1239,9,90,1,56.89,860.54,10169,10178
1240,8,75,38,64.00,156.50,10177,10185
1241,9,85,15,56.89,517.43,10184,10193
1242,8,70,50,64.00,40.75,10192,10200
1243,9,75,3,56.89,530.32,10199,10208
1244,8,85,46,64.00,215.50,10207,10215
1245,10,80,4,51.20,379.36,10214,10224
1246,9,80,16,56.89,290.54,10223,10232
1247,10,70,14,51.20,309.76,10231,10241
1248,10,70,13,51.20,237.56,10240,10250
1249,8,75,55,64.00,44.50,10249,10257
1250,9,80,10,56.89,351.88,10256,10265
1251,10,75,4,51.20,546.56,10264,10274
1252,9,80,26,56.89,234.99,10273,10282
1253,9,70,48,56.89,50.32,10281,10290
1254,8,95,47,64.00,258.25,10289,10297
1255,10,75,10,51.20,448.56,10296,10306
1256,10,85,6,51.20,561.76,10305,10315
1257,8,85,19,64.00,450.00,10314,10322
1258,8,115,31,64.00,707.00,10321,10329
1259,9,80,17,56.89,304.99,10328,10337
1260,8,87,50,64.00,134.50,10336,10344
1261,8,85,18,64.00,474.00,10344,10352
1262,8,85,30,64.00,317.00,10351,10359
1263,8,90,35,64.00,303.25,10358,10366
1264,9,90,20,56.89,461.65,10365,10374
1265,8,85,43,64.00,136.75,10373,10381
1266,9,85,2,56.89,750.54,10380,10389
1267,7,85,47,73.14,149.84,10388,10395
1268,9,80,5,56.89,509.65,10394,10403
1269,9,85,22,56.89,295.21,10402,10411
1270,8,80,48,64.00,145.25,10410,10418
1271,8,85,36,64.00,224.75,10417,10425
1272,8,90,28,64.00,459.00,10424,10432
1273,9,80,21,56.89,246.10,10431,10440
1274,9,70,14,56.89,264.77,10439,10448
1275,9,85,17,56.89,375.43,10447,10456
1276,9,85,21,56.89,463.21,10455,10464
1277,8,80,44,64.00,105.25,10463,10471
1278,10,80,17,51.20,286.16,10470,10480
1279,9,90,8,56.89,605.88,10479,10488
1280,8,100,14,64.00,705.25,10487,10495
1281,10,75,40,51.20,97.76,10494,10504
1282,10,75,20,51.20,301.96,10503,10513
1283,9,95,14,56.89,585.88,10512,10521
1284,9,85,18,56.89,357.43,10520,10529
1285,9,70,44,56.89,89.88,10528,10537
1286,9,85,6,56.89,485.43,10536,10545
1287,9,105,6,56.89,911.65,10544,10553
1288,9,70,34,56.89,149.21,10552,10561
1289,9,90,22,56.89,334.32,10560,10569
1290,9,85,1,56.89,583.88,10568,10577
1291,9,70,14,56.89,263.43,10576,10585
1292,10,85,1,51.20,630.76,10584,10594
1293,13,65,2,39.38,291.47,10593,10606
1294,37,35,9,13.84,41.38,10605,10642
1295,25,27,8,20.48,18.97,10641,10666
1296,25,27,11,20.48,9.69,10665,10690
1297,24,27,7,21.33,21.22,10689,10713
1298,25,27,8,20.48,15.45,10712,10737
1299,25,23,12,20.48,6.81,10736,10761
1300,24,27,15,21.33,10.56,10761,10785
1301,25,23,8,20.48,10.33,10784,10809
1302,24,27,3,21.33,22.56,10809,10833
1303,23,27,19,22.26,4.89,10832,10855
1304,25,27,2,20.48,22.33,10854,10879
1305,25,27,5,20.48,25.21,10878,10903
1306,25,23,5,20.48,14.01,10902,10927
1307,25,27,10,20.48,13.37,10926,10951
1308,26,23,2,19.69,20.52,10950,10976
1309,25,27,10,20.48,14.01,10975,11000
1310,25,31,2,20.48,27.45,10999,11024
1311,24,23,15,21.33,5.56,11023,11047
1312,26,27,2,19.69,28.21,11046,11072
1313,25,27,6,20.48,16.89,11071,11096
1314,24,27,5,21.33,18.89,11095,11119
1315,23,27,18,22.26,6.80,11118,11141
1316,24,27,8,21.33,11.97,11140,11164
1317,25,27,1,20.48,36.09,11163,11188
1318,23,27,13,22.26,10.80,11187,11210
1319,23,27,10,22.26,13.06,11210,11233
1320,24,31,1,21.33,32.89,11232,11256
1321,25,27,9,20.48,11.77,11255,11280
1322,26,27,2,19.69,21.44,11279,11305
1323,25,27,6,20.48,14.97,11304,11329
1324,25,27,10,20.48,11.45,11328,11353
1325,24,27,16,21.33,6.47,11352,11376
1326,24,31,3,21.33,26.56,11375,11399
1327,24,27,7,21.33,14.56,11399,11423
1328,25,23,15,20.48,8.41,11422,11447
1329,25,27,4,20.48,26.65,11446,11471
1330,25,27,7,20.48,18.33,11470,11495
1331,24,23,15,21.33,7.31,11494,11518
1332,25,27,1,20.48,37.69,11517,11542
1333,24,23,13,21.33,6.22,11541,11565
1334,27,27,1,18.96,30.85,11564,11591
1335,25,31,3,20.48,28.81,11590,11615
1336,26,23,4,19.69,16.52,11614,11640
1337,38,22,8,13.47,17.30,11639,11677
1338,32,26,6,16.00,18.19,11676,11708
1339,33,26,8,15.52,14.73,11707,11740
1340,33,22,3,15.52,18.73,11739,11772
1341,31,22,8,16.52,10.44,11771,11802
1342,31,22,8,16.52,9.02,11801,11832
1343,32,22,9,16.00,7.06,11832,11864
1344,31,22,7,16.52,10.38,11863,11894
1345,32,22,3,16.00,11.56,11893,11925
1346,31,22,7,16.52,8.44,11924,11955
1347,33,22,7,15.52,8.67,11954,11987
1348,32,22,11,16.00,6.56,11986,12018
1349,33,18,1,15.52,14.01,12017,12050
1350,32,22,7,16.00,8.88,12049,12081
1351,35,18,4,14.63,13.09,12080,12115
1352,37,19,5,13.84,10.73,12114,12151
1353,38,18,2,13.47,13.83,12150,12188
1354,33,22,9,15.52,7.22,12187,12220
1355,33,18,5,15.52,8.67,12219,12252
1356,33,18,7,15.52,7.52,12251,12284
1357,35,18,6,14.63,10.23,12283,12318
1358,34,22,8,15.06,7.29,12317,12351
1359,33,26,5,15.52,13.76,12350,12383
1360,34,18,1,15.06,11.94,12382,12416
1361,32,22,4,16.00,11.06,12415,12447
1362,33,22,5,15.52,16.07,12446,12479
1363,32,22,2,16.00,13.50,12478,12510
1364,33,22,4,15.52,11.34,12509,12542
1365,32,22,8,16.00,8.94,12541,12573
1366,35,18,11,14.63,5.83,12572,12607
1367,33,22,7,15.52,10.01,12607,12640
1368,33,22,11,15.52,6.92,12639,12672
1369,34,18,10,15.06,5.88,12672,12706
1370,26,27,8,19.69,23.21,12705,12731
1371,23,31,11,22.26,14.37,12730,12753
1372,25,27,1,20.48,32.01,12752,12777
1373,24,27,11,21.33,16.31,12776,12800
1374,23,31,6,22.26,28.28,12799,12822
1375,26,31,4,19.69,28.98,12821,12847
1376,23,27,13,22.26,13.24,12846,12869
1377,24,27,19,21.33,6.56,12869,12893
1378,24,27,11,21.33,13.22,12893,12917
1379,25,27,3,20.48,20.89,12916,12941
1380,23,27,9,22.26,17.76,12940,12963
1381,22,31,14,23.27,17.11,12962,12984
1382,23,27,9,22.26,21.58,12983,13006
1383,22,27,15,23.27,11.02,13005,13027
1384,24,31,6,21.33,24.31,13026,13050
1385,25,27,4,20.48,24.09,13049,13074
1386,23,31,10,22.26,15.84,13073,13096
1387,24,27,1,21.33,28.22,13095,13119
1388,22,31,10,23.27,18.56,13118,13140
1389,22,27,7,23.27,26.29,13139,13161
1390,23,31,1,22.26,34.45,13160,13183
1391,24,31,12,21.33,12.31,13182,13206
1392,22,31,15,23.27,13.20,13205,13227
1393,22,31,6,23.27,29.83,13226,13248
1394,23,27,1,22.26,39.32,13247,13270
1395,23,31,10,22.26,18.63,13269,13292
1396,23,31,12,22.26,22.98,13291,13314
1397,24,31,3,21.33,27.89,13313,13337
1398,23,27,5,22.26,22.98,13336,13359
1399,23,31,11,22.26,15.15,13358,13381
1400,22,27,8,23.27,19.29,13380,13402
1401,24,27,7,21.33,23.89,13401,13425
1402,24,27,2,21.33,33.64,13424,13448
1403,23,27,16,22.26,10.80,13447,13470
1404,23,27,2,22.26,38.80,13469,13492
1405,21,31,19,24.38,13.19,13491,13512
1406,23,31,1,22.26,33.06,13511,13534
1407,23,31,11,22.26,16.19,13533,13556
1408,23,31,1,22.26,36.89,13555,13578
1409,23,27,6,22.26,30.11,13577,13600
1410,23,31,4,22.26,34.11,13599,13622
1411,22,27,17,23.27,11.02,13621,13643
1412,23,31,2,22.26,33.24,13642,13665
1413,22,31,4,23.27,33.11,13664,13686
1414,22,27,3,23.27,28.47,13685,13707
1415,22,31,2,23.27,30.93,13706,13728
1416,23,31,4,22.26,45.24,13727,13750
1417,21,31,16,24.38,19.47,13749,13770
1418,23,27,11,22.26,15.84,13769,13792
1419,24,27,1,21.33,47.56,13791,13815
1420,22,31,6,23.27,23.29,13814,13836
1421,22,31,17,23.27,12.47,13835,13857
1422,23,31,2,22.26,27.67,13857,13880
1423,23,27,4,22.26,23.67,13879,13902
1424,22,31,15,23.27,12.47,13901,13923
1425,23,31,2,22.26,45.76,13922,13945
1426,22,27,19,23.27,7.29,13944,13966
1427,24,27,3,21.33,21.22,13965,13989
1428,22,27,19,23.27,8.83,13989,14011
1429,22,27,13,23.27,14.74,14011,14033
1430,25,31,6,20.48,27.45,14032,14057
1431,24,27,10,21.33,23.89,14056,14080
1432,25,31,4,20.48,39.29,14079,14104
1433,22,31,9,23.27,16.83,14103,14125
1434,24,35,2,21.33,49.97,14124,14148
1435,23,27,9,22.26,18.89,14147,14170
1436,22,31,14,23.27,22.65,14169,14191
1437,24,31,5,21.33,33.97,14190,14214
1438,24,27,10,21.33,17.47,14213,14237
1439,23,27,10,22.26,18.63,14236,14259
1440,23,31,4,22.26,39.67,14258,14281
1441,24,27,3,21.33,24.31,14280,14304
1442,24,27,7,21.33,31.06,14303,14327
1443,23,31,1,22.26,32.02,14326,14349
1444,23,27,6,22.26,18.71,14348,14371
1445,22,27,19,23.27,8.83,14370,14392
1446,23,31,4,22.26,34.80,14391,14414
1447,23,31,10,22.26,36.19,14413,14436
1448,23,31,1,22.26,36.89,14435,14458
1449,23,27,14,22.26,15.50,14457,14480
1450,23,27,9,22.26,23.67,14479,14502
1451,21,27,16,24.38,10.33,14501,14522
1452,22,27,17,23.27,11.02,14522,14544
1453,25,27,2,20.48,36.01,14543,14568
1454,24,27,4,21.33,23.47,14567,14591
1455,21,31,16,24.38,13.38,14590,14611
1456,24,27,3,21.33,35.97,14610,14634
1457,22,35,11,23.27,20.74,14633,14655
1458,22,27,9,23.27,21.20,14655,14677
1459,23,31,14,22.26,15.58,14676,14699
1460,23,31,4,22.26,28.54,14698,14721
1461,22,27,6,23.27,23.29,14720,14742
1462,22,31,8,23.27,31.29,14741,14763
1463,23,27,11,22.26,23.93,14762,14785
1464,23,31,4,22.26,34.71,14784,14807
1465,24,27,2,21.33,38.64,14806,14830
1466,23,31,14,22.26,17.15,14829,14852
1467,23,31,1,22.26,34.45,14851,14874
1468,24,27,3,21.33,29.22,14873,14897
1469,22,31,19,23.27,16.02,14896,14918
1470,23,27,3,22.26,24.19,14917,14940
1471,23,27,5,22.26,27.84,14939,14962
1472,22,31,19,23.27,11.02,14961,14983
1473,23,31,2,22.26,41.58,14982,15005
1474,22,31,12,23.27,14.20,15004,15026
1475,24,27,3,21.33,22.56,15025,15049
1476,24,27,4,21.33,34.31,15048,15072
1477,23,31,17,22.26,13.93,15071,15094
1478,23,31,3,22.26,34.28,15093,15116
1479,24,31,1,21.33,48.89,15115,15139
1480,23,30,15,22.26,15.50,15138,15161
1481,23,27,8,22.26,19.15,15160,15183
1482,22,31,6,23.27,26.20,15182,15204
1483,24,31,1,21.33,51.56,15203,15227
1484,22,27,19,23.27,9.83,15226,15248
1485,25,27,1,20.48,40.25,15247,15272
1486,23,31,17,22.26,11.15,15271,15294
1487,22,31,3,23.27,35.74,15293,15315
1488,22,31,10,23.27,19.65,15314,15336
1489,22,27,1,23.27,34.29,15335,15357
1490,23,31,14,22.26,15.50,15357,15380
1491,23,27,5,22.26,24.37,15379,15402
1492,24,31,7,21.33,18.56,15401,15425
1493,23,31,6,22.26,23.15,15425,15448
1494,23,27,4,22.26,22.28,15447,15470
1495,23,27,10,22.26,15.84,15469,15492
1496,22,31,13,23.27,17.56,15491,15513
1497,23,31,4,22.26,34.11,15512,15535
1498,23,27,6,22.26,25.93,15534,15557
1499,22,35,12,23.27,30.56,15556,15578
1500,22,27,15,23.27,12.47,15577,15599
1501,23,31,7,22.26,28.37,15598,15621
1502,22,31,19,23.27,10.20,15620,15642
1503,23,31,6,22.26,35.67,15641,15664
1504,22,31,7,23.27,20.47,15663,15685
1505,22,27,16,23.27,8.38,15684,15706
1506,23,31,3,22.26,39.84,15705,15728
1507,22,31,17,23.27,11.02,15727,15749
1508,23,31,6,22.26,25.93,15749,15772
1509,22,31,17,23.27,12.47,15771,15793
1510,22,31,1,23.27,37.20,15793,15815
1511,22,31,10,23.27,21.11,15814,15836
1512,22,27,11,23.27,15.38,15835,15857
1513,23,27,12,22.26,13.24,15856,15879
1514,24,31,2,21.33,39.97,15878,15902
1515,23,31,2,22.26,33.24,15901,15924
1516,23,31,17,22.26,11.15,15923,15946
1517,24,27,3,21.33,21.22,15945,15969
1518,22,35,4,23.27,37.20,15968,15990
1519,24,27,5,21.33,32.64,15989,16013
1520,24,31,13,21.33,18.14,16012,16036
1521,24,31,9,21.33,24.64,16035,16059
1522,23,27,9,22.26,25.24,16058,16081
1523,24,27,2,21.33,32.31,16080,16104
1524,24,27,10,21.33,19.97,16103,16127
1525,25,27,5,20.48,25.93,16126,16151
1526,23,27,9,22.26,15.84,16150,16173
1527,23,31,4,22.26,35.24,16172,16195
1528,26,31,10,19.69,26.52,16194,16220
1529,24,27,5,21.33,26.89,16219,16243
1530,22,31,2,23.27,35.29,16242,16264
1531,23,27,4,22.26,25.76,16263,16286
1532,24,27,10,21.33,18.97,16285,16309
1533,24,27,7,21.33,16.47,16308,16332
1534,24,27,6,21.33,22.47,16331,16355
1535,23,31,7,22.26,26.63,16354,16377
1536,24,27,3,21.33,31.72,16376,16400
1537,22,27,8,23.27,19.65,16399,16421
1538,23,31,11,22.26,17.93,16420,16443
1539,22,31,8,23.27,27.83,16442,16464
1540,22,27,10,23.27,22.20,16463,16485
1541,23,27,4,22.26,33.41,16484,16507
1542,23,31,10,22.26,27.76,16506,16529
1543,23,27,12,22.26,13.24,16528,16551
1544,23,27,3,22.26,35.67,16550,16573
1545,24,31,11,21.33,18.31,16572,16596
1546,24,27,12,21.33,18.39,16595,16619
1547,22,31,5,23.27,26.29,16618,16640
1548,23,31,4,22.26,28.54,16639,16662
1549,23,31,10,22.26,26.71,16661,16684
1550,22,31,7,23.27,21.47,16683,16705
1551,23,31,1,22.26,33.06,16704,16727
1552,23,31,7,22.26,39.58,16726,16749
1553,24,27,9,21.33,23.89,16748,16772
1554,23,31,11,22.26,21.50,16771,16794
1555,24,31,6,21.33,27.06,16793,16817
1556,23,29,14,22.26,15.84,16816,16839
1557,25,27,2,20.48,31.93,16838,16863
1558,25,27,9,20.48,16.25,16862,16887
1559,25,31,1,20.48,31.93,16886,16911
1560,24,27,12,21.33,10.97,16910,16934
1561,25,31,4,20.48,30.49,16933,16958
1562,23,27,14,22.26,11.32,16957,16980
1563,24,27,1,21.33,38.22,16979,17003
1564,24,28,7,21.33,18.47,17002,17026
1565,22,30,16,23.27,15.02,17025,17047
1566,23,27,3,22.26,23.58,17046,17069
1567,24,27,3,21.33,39.31,17068,17092
1568,22,31,15,23.27,16.47,17091,17113
1569,24,31,1,21.33,29.56,17112,17136
1570,25,27,6,20.48,19.69,17135,17160
1571,24,31,5,21.33,33.56,17159,17183
1572,22,27,19,23.27,6.93,17182,17204
1573,24,27,1,21.33,22.89,17203,17227
1574,24,27,2,21.33,30.97,17226,17250
1575,24,27,15,21.33,10.56,17249,17273
1576,23,31,12,22.26,15.32,17272,17295
1577,25,31,6,20.48,24.57,17294,17319
1578,24,31,18,21.33,10.64,17318,17342
1579,23,27,3,22.26,28.37,17341,17364
1580,24,31,1,21.33,46.22,17363,17387
1581,23,27,3,22.26,25.93,17386,17409
1582,23,31,1,22.26,29.58,17408,17431
1583,24,27,16,21.33,7.64,17430,17454
1584,24,27,7,21.33,17.22,17453,17477
1585,24,27,4,21.33,31.64,17476,17500
1586,24,31,13,21.33,13.56,17499,17523
1587,24,31,2,21.33,36.31,17522,17546
1588,23,28,10,22.26,18.71,17545,17568
1589,23,30,13,22.26,13.50,17567,17590
1590,24,31,2,21.33,37.31,17589,17613
1591,22,31,14,23.27,22.20,17612,17634
1592,24,27,3,21.33,31.14,17633,17657
1593,24,27,10,21.33,10.97,17656,17680
1594,23,27,12,22.26,15.32,17679,17702
1595,23,35,7,22.26,32.54,17701,17724
1596,23,31,9,22.26,23.15,17723,17746
1597,23,27,10,22.26,22.54,17745,17768
1598,22,31,9,23.27,19.74,17767,17789
1599,23,31,4,22.26,30.89,17788,17811
1600,23,30,8,22.26,24.98,17810,17833
1601,24,27,5,21.33,21.56,17832,17856
1602,23,27,7,22.26,22.11,17855,17878
1603,23,31,1,22.26,36.19,17877,17900
1604,23,31,7,22.26,23.15,17899,17922
1605,24,27,10,21.33,17.31,17921,17945
1606,23,30,10,22.26,17.84,17944,17967
1607,24,27,5,21.33,28.22,17966,17990
1608,22,27,14,23.27,10.93,17989,18011
1609,24,31,1,21.33,45.47,18010,18034
1610,23,31,8,22.26,17.06,18033,18056
1611,24,31,15,21.33,13.22,18055,18079
1612,25,27,4,20.48,26.17,18078,18103
1613,24,27,4,21.33,34.22,18102,18126
1614,25,31,3,20.48,35.53,18125,18150
1615,23,27,10,22.26,14.54,18149,18172
1616,25,27,2,20.48,36.25,18171,18196
1617,24,31,11,21.33,17.97,18195,18219
1618,22,31,11,23.27,27.02,18218,18240
1619,25,27,10,20.48,18.41,18239,18264
1620,23,31,4,22.26,35.93,18263,18286
1621,23,31,6,22.26,23.58,18285,18308
1622,25,27,10,20.48,31.05,18308,18333
1623,23,27,1,22.26,26.80,18332,18355
1624,23,31,3,22.26,41.24,18354,18377
1625,23,31,5,22.26,30.80,18376,18399
1626,24,27,10,21.33,23.39,18398,18422
1627,24,31,1,21.33,32.47,18421,18445
1628,22,31,7,23.27,26.29,18444,18466
1629,23,31,10,22.26,22.80,18465,18488
1630,24,27,10,21.33,15.97,18487,18511
1631,23,27,17,22.26,12.98,18510,18533
1632,23,27,9,22.26,17.93,18532,18555
1633,24,31,3,21.33,26.47,18554,18578
1634,24,31,3,21.33,35.97,18577,18601
1635,23,31,15,22.26,14.89,18600,18623
1636,25,27,3,20.48,32.81,18622,18647
1637,23,31,11,22.26,18.28,18646,18669
1638,24,31,2,21.33,36.06,18668,18692
1639,22,31,15,23.27,18.29,18691,18713
1640,24,27,8,21.33,24.97,18712,18736
1641,23,27,4,22.26,27.15,18735,18758
1642,23,31,10,22.26,21.41,18757,18780
1643,22,31,9,23.27,18.29,18779,18801
1644,25,27,4,20.48,17.45,18800,18825
1645,23,27,7,22.26,17.58,18824,18847
1646,23,27,5,22.26,27.76,18846,18869
1647,25,27,2,20.48,24.25,18868,18893
1648,24,27,8,21.33,16.31,18892,18916
1649,24,27,1,21.33,30.89,18915,18939
1650,23,31,6,22.26,23.15,18938,18961
1651,25,27,4,20.48,26.65,18960,18985
1652,24,31,2,21.33,31.31,18984,19008
1653,24,27,9,21.33,13.56,19007,19031
1654,24,27,10,21.33,17.64,19030,19054
1655,24,27,11,21.33,13.22,19053,19077
1656,25,31,4,20.48,27.93,19076,19101
1657,23,31,9,22.26,22.98,19100,19123
1658,23,31,10,22.26,20.02,19122,19145
1659,24,27,8,21.33,17.64,19144,19168
1660,23,31,1,22.26,31.67,19167,19190
1661,26,27,3,19.69,23.67,19189,19215
1662,22,31,6,23.27,33.11,19214,19236
1663,23,31,16,22.26,12.19,19235,19258
1664,24,27,7,21.33,13.22,19257,19281
1665,23,27,18,22.26,10.98,19281,19304
1666,24,27,5,21.33,22.89,19303,19327
1667,24,27,6,21.33,29.31,19326,19350
1668,23,31,11,22.26,17.58,19349,19372
1669,24,27,1,21.33,28.89,19371,19395
1670,23,27,2,22.26,30.45,19394,19417
1671,24,31,4,21.33,24.97,19416,19440
1672,24,31,1,21.33,48.89,19439,19463
1673,24,27,8,21.33,14.64,19462,19486
1674,22,31,15,23.27,13.93,19485,19507
1675,23,27,6,22.26,24.54,19506,19529
1676,24,31,8,21.33,18.97,19528,19552
1677,24,27,1,21.33,30.89,19551,19575
1678,24,27,8,21.33,15.31,19574,19598
1679,23,31,6,22.26,25.93,19597,19620
1680,22,31,3,23.27,34.29,19619,19641
1681,23,27,13,22.26,9.41,19640,19663
1682,22,31,14,23.27,14.20,19662,19684
1683,23,31,1,22.26,51.50,19683,19706
1684,23,27,10,22.26,15.84,19705,19728
1685,22,27,15,23.27,12.47,19727,19749
1686,23,31,8,22.26,27.50,19748,19771
1687,23,31,14,22.26,16.89,19770,19793
1688,24,31,4,21.33,34.31,19792,19816
1689,23,27,16,22.26,6.63,19815,19838
1690,24,31,3,21.33,29.22,19837,19861
1691,23,31,12,22.26,19.50,19860,19883
1692,23,31,3,22.26,36.71,19882,19905
1693,24,31,2,21.33,28.97,19904,19928
1694,23,27,4,22.26,22.98,19927,19950
1695,24,27,11,21.33,10.56,19949,19973
1696,23,31,12,22.26,20.19,19972,19995
1697,24,31,6,21.33,31.97,19994,20018
1698,23,31,11,22.26,21.06,20017,20040
1699,24,27,8,21.33,22.14,20039,20063
1700,25,31,1,20.48,32.97,20062,20087
1701,24,31,5,21.33,27.47,20087,20111
1702,24,27,13,21.33,14.22,20110,20134
1703,24,31,11,21.33,18.64,20134,20158
1704,24,32,7,21.33,26.97,20157,20181
1705,25,31,1,20.48,44.73,20180,20205
1706,24,27,11,21.33,17.72,20204,20228
1707,24,35,2,21.33,41.31,20227,20251
1708,24,27,2,21.33,34.72,20250,20274
1709,25,27,10,20.48,14.41,20273,20298
1710,24,27,2,21.33,22.64,20297,20321
1711,24,27,4,21.33,24.31,20320,20344
1712,24,31,4,21.33,30.31,20343,20367
1713,23,27,19,22.26,7.67,20366,20389
1714,24,27,2,21.33,23.97,20388,20412
1715,24,27,7,21.33,21.47,20411,20435
1716,24,27,2,21.33,30.97,20434,20458
1717,24,27,11,21.33,13.97,20457,20481
1718,25,27,5,20.48,28.73,20480,20505
1719,24,27,10,21.33,18.64,20504,20528
1720,24,31,8,21.33,24.89,20527,20551
1721,25,27,11,20.48,16.49,20550,20575
1722,25,31,1,20.48,46.01,20574,20599
1723,23,31,18,22.26,10.98,20598,20621
1724,23,31,1,22.26,36.89,20620,20643
1725,24,27,7,21.33,14.56,20642,20666
1726,24,27,8,21.33,16.97,20665,20689
1727,24,27,13,21.33,10.89,20688,20712
1728,24,31,6,21.33,25.64,20711,20735
1729,23,31,10,22.26,20.02,20734,20757
1730,24,31,9,21.33,15.56,20756,20780
1731,23,27,10,22.26,14.45,20779,20802
1732,23,27,14,22.26,8.54,20802,20825
1733,24,27,11,21.33,14.47,20824,20848
1734,24,27,4,21.33,31.64,20847,20871
1735,22,31,12,23.27,20.74,20870,20892
1736,23,27,15,22.26,12.37,20891,20914
1737,25,27,5,20.48,19.13,20913,20938
1738,23,27,4,22.26,22.19,20938,20961
1739,25,27,14,20.48,12.49,20960,20985
1740,24,27,3,21.33,33.22,20984,21008
1741,23,27,13,22.26,12.89,21007,21030
1742,23,27,18,22.26,9.58,21029,21052
1743,23,27,4,22.26,26.45,21051,21074
1744,24,27,2,21.33,28.64,21073,21097
1745,22,31,13,23.27,19.02,21096,21118
1746,25,27,1,20.48,28.09,21117,21142
1747,23,27,11,22.26,13.41,21141,21164
1748,23,31,8,22.26,22.63,21163,21186
1749,23,27,3,22.26,38.45,21185,21208
1750,22,31,19,23.27,8.74,21207,21229
1751,24,27,3,21.33,30.56,21228,21252
1752,23,27,1,22.26,34.11,21251,21274
1753,22,31,18,23.27,11.65,21273,21295
1754,23,31,5,22.26,24.02,21294,21317
1755,23,27,7,22.26,21.06,21316,21339
1756,23,27,13,22.26,12.89,21338,21361
1757,23,27,7,22.26,21.06,21360,21383
1758,24,31,5,21.33,29.56,21382,21406
1759,23,31,7,22.26,33.24,21405,21428
1760,23,27,16,22.26,8.71,21427,21450
1761,25,27,2,20.48,33.21,21449,21474
1762,23,27,7,22.26,19.32,21473,21496
1763,24,27,2,21.33,26.31,21495,21519
1764,22,31,17,23.27,9.56,21518,21540
1765,23,27,2,22.26,27.67,21540,21563
1766,22,31,19,23.27,13.20,21562,21584
1767,23,35,14,22.26,16.89,21584,21607
1768,23,27,9,22.26,13.93,21606,21629
1769,23,27,3,22.26,26.28,21628,21651
1770,24,31,1,21.33,32.22,21650,21674
1771,22,27,10,23.27,15.65,21673,21695
1772,22,27,17,23.27,6.65,21694,21716
1773,23,27,14,22.26,11.32,21716,21739
1774,23,31,9,22.26,18.11,21738,21761
1775,23,31,3,22.26,30.80,21760,21783
1776,22,31,7,23.27,34.29,21782,21804
1777,24,27,6,21.33,20.31,21803,21827
1778,23,27,17,22.26,8.37,21826,21849
1779,24,27,3,21.33,29.22,21848,21872
1780,22,31,19,23.27,14.56,21871,21893
1781,24,31,7,21.33,29.22,21892,21916
1782,25,27,3,20.48,17.69,21915,21940
1783,24,27,6,21.33,19.64,21939,21963
1784,24,27,17,21.33,6.89,21962,21986
1785,23,31,6,22.26,24.54,21985,22008
1786,23,27,8,22.26,15.67,22007,22030
1787,23,27,2,22.26,29.06,22029,22052
1788,24,27,11,21.33,14.56,22052,22076
1789,23,31,12,22.26,25.06,22075,22098
1790,23,27,10,22.26,14.45,22097,22120
1791,23,27,8,22.26,16.37,22119,22142
1792,25,27,2,20.48,26.81,22141,22166
1793,24,27,6,21.33,19.31,22165,22189
1794,22,31,15,23.27,13.20,22188,22210
1795,25,27,6,20.48,19.45,22209,22234
1796,23,31,3,22.26,33.58,22233,22256
1797,23,31,13,22.26,14.63,22255,22278
1798,24,27,8,21.33,20.97,22277,22301
1799,22,31,15,23.27,13.93,22300,22322
1800,25,27,5,20.48,25.21,22321,22346
1801,23,31,11,22.26,19.32,22345,22368
1802,24,27,14,21.33,11.97,22367,22391
1803,24,27,5,21.33,20.89,22390,22414
1804,24,27,6,21.33,15.64,22413,22437
1805,24,27,3,21.33,21.22,22436,22460
1806,23,27,6,22.26,16.19,22460,22483
1807,25,27,2,20.48,21.69,22482,22507
1808,24,31,13,21.33,12.89,22506,22530
1809,24,27,4,21.33,31.64,22529,22553
1810,23,31,18,22.26,10.98,22552,22575
1811,24,27,1,21.33,28.22,22574,22598
1812,25,27,6,20.48,14.33,22597,22622
1813,23,27,2,22.26,29.06,22621,22644
1814,23,35,12,22.26,22.28,22643,22666
1815,23,31,2,22.26,30.45,22665,22688
1816,23,31,5,22.26,33.06,22687,22710
1817,24,31,4,21.33,20.97,22709,22733
1818,24,27,3,21.33,22.56,22732,22756
1819,22,31,12,23.27,13.83,22755,22777
1820,23,31,11,22.26,17.93,22776,22799
1821,24,31,1,21.33,46.22,22798,22822
1822,24,31,4,21.33,21.31,22821,22845
1823,24,27,4,21.33,20.31,22844,22868
1824,23,27,2,22.26,29.06,22867,22890
1825,23,31,12,22.26,16.71,22889,22912
1826,23,27,15,22.26,15.15,22911,22934
1827,24,27,1,21.33,47.56,22933,22957
1828,23,27,3,22.26,28.37,22956,22979
1829,22,27,4,23.27,27.29,22978,23000
1830,23,27,6,22.26,17.58,22999,23022
1831,23,27,12,22.26,11.15,23021,23044
1832,23,27,10,22.26,21.41,23043,23066
1833,24,27,1,21.33,34.22,23065,23089
1834,23,27,3,22.26,21.76,23088,23111
1835,21,31,19,24.38,11.09,23110,23131
1836,24,27,2,21.33,38.64,23130,23154
1837,23,31,4,22.26,24.37,23153,23176
1838,22,31,18,23.27,13.47,23175,23197
1839,25,31,1,20.48,48.89,23196,23221
1840,23,31,10,22.26,17.84,23220,23243
1841,23,35,3,22.26,46.19,23242,23265
1842,22,35,11,23.27,29.65,23264,23286
1843,22,35,18,23.27,16.74,23285,23307
1844,24,35,1,21.33,48.22,23306,23330
1845,21,31,17,24.38,9.38,23329,23350
1846,23,27,6,22.26,18.98,23349,23372
1847,23,27,8,22.26,19.41,23371,23394
1848,25,27,8,20.48,14.25,23393,23418
1849,25,27,2,20.48,31.93,23417,23442
1850,22,31,17,23.27,13.93,23441,23463
1851,24,31,4,21.33,29.97,23462,23486
1852,23,31,12,22.26,20.89,23485,23508
1853,23,27,11,22.26,16.19,23507,23530
1854,24,31,1,21.33,36.89,23529,23553
1855,23,27,11,22.26,14.80,23552,23575
1856,22,31,12,23.27,26.20,23574,23596
1857,23,31,2,22.26,34.63,23595,23618
1858,22,27,11,23.27,15.38,23617,23639
1859,23,31,1,22.26,30.63,23638,23661
1860,21,31,17,24.38,14.71,23660,23681
1861,24,27,6,21.33,25.31,23680,23704
1862,24,27,8,21.33,27.97,23703,23727
1863,24,27,4,21.33,26.06,23726,23750
1864,23,31,11,22.26,24.63,23749,23772
1865,23,31,1,22.26,44.71,23771,23794
1866,22,31,10,23.27,23.65,23793,23815
1867,21,31,5,24.38,27.28,23814,23835
1868,24,31,1,21.33,48.89,23834,23858
1869,22,27,6,23.27,21.47,23857,23879
1870,24,27,5,21.33,25.81,23878,23902
1871,23,27,18,22.26,6.89,23901,23924
1872,24,31,1,21.33,33.56,23923,23947
1873,25,27,5,20.48,19.45,23946,23971
1874,23,31,7,22.26,24.89,23970,23993
1875,24,27,2,21.33,25.31,23992,24016
1876,23,31,19,22.26,8.89,24015,24038
1877,25,27,1,20.48,41.53,24037,24062
1878,23,27,11,22.26,13.06,24061,24084
1879,23,31,9,22.26,27.15,24083,24106
1880,23,31,2,22.26,34.71,24105,24128
1881,23,27,9,22.26,16.19,24127,24150
1882,23,27,10,22.26,15.24,24149,24172
1883,23,31,3,22.26,33.58,24171,24194
1884,24,31,9,21.33,21.47,24193,24217
1885,23,31,13,22.26,25.41,24216,24239
1886,24,27,3,21.33,29.97,24238,24262
1887,25,31,5,20.48,31.69,24261,24286
1888,24,27,10,21.33,25.39,24285,24309
1889,23,27,4,22.26,26.45,24308,24331
1890,24,31,4,21.33,29.97,24330,24354
1891,23,31,7,22.26,25.58,24353,24376
1892,23,27,16,22.26,10.02,24375,24398
1893,24,27,5,21.33,26.97,24397,24421
1894,24,27,5,21.33,19.81,24420,24444
1895,23,27,14,22.26,9.93,24443,24466
1896,24,27,3,21.33,19.89,24466,24490
1897,23,31,5,22.26,22.98,24489,24512
1898,23,31,18,22.26,12.37,24511,24534
1899,24,27,11,21.33,14.56,24534,24558
1900,23,31,12,22.26,18.11,24557,24580
1901,24,27,6,21.33,21.64,24579,24603
1902,24,27,7,21.33,19.89,24602,24626
1903,24,27,2,21.33,26.31,24625,24649
1904,22,35,19,23.27,16.11,24648,24670
1905,24,31,4,21.33,28.64,24669,24693
1906,24,31,5,21.33,28.22,24692,24716
1907,23,27,11,22.26,13.41,24715,24738
1908,23,27,5,22.26,29.24,24737,24760
1909,24,27,8,21.33,16.31,24759,24783
1910,24,27,8,21.33,12.31,24782,24806
1911,24,27,11,21.33,25.31,24805,24829
1912,24,27,6,21.33,22.14,24828,24852
1913,23,31,2,22.26,35.93,24851,24874
1914,24,31,5,21.33,34.14,24873,24897
1915,23,31,12,22.26,14.19,24896,24919
1916,24,27,1,21.33,29.47,24918,24942
1917,22,27,19,23.27,10.20,24941,24963
1918,23,27,18,22.26,8.19,24963,24986
1919,24,27,1,21.33,35.56,24985,25009
1920,23,27,18,22.26,9.58,25008,25031
1921,23,27,14,22.26,9.93,25031,25054
1922,23,31,5,22.26,28.54,25053,25076
1923,23,27,7,22.26,22.80,25075,25098
1924,22,35,3,23.27,37.93,25097,25119
1925,24,27,2,21.33,23.97,25118,25142
1926,22,31,19,23.27,11.02,25141,25163
1927,24,31,2,21.33,37.64,25162,25186
1928,23,31,4,22.26,25.06,25185,25208
1929,22,31,9,23.27,18.29,25207,25229
1930,23,31,3,22.26,32.19,25228,25251
1931,24,31,10,21.33,16.31,25250,25274
1932,24,31,9,21.33,23.56,25273,25297
1933,23,27,18,22.26,9.58,25296,25319
1934,23,27,4,22.26,23.67,25318,25341
1935,24,27,6,21.33,24.31,25340,25364
1936,24,27,7,21.33,23.89,25363,25387
1937,24,31,10,21.33,19.97,25386,25410
1938,24,27,9,21.33,17.56,25409,25433
1939,24,27,4,21.33,24.64,25432,25456
1940,22,31,13,23.27,16.11,25455,25477
1941,25,27,10,20.48,9.77,25476,25501
1942,23,31,19,22.26,12.02,25501,25524
1943,26,27,1,19.69,28.60,25523,25549
1944,24,27,10,21.33,13.64,25548,25572
1945,23,31,13,22.26,17.06,25571,25594
1946,23,27,7,22.26,18.63,25593,25616
1947,25,27,1,20.48,28.09,25615,25640
1948,25,31,9,20.48,17.85,25639,25664
1949,26,27,7,19.69,17.52,25663,25689
1950,24,31,12,21.33,12.31,25688,25712
1951,26,31,1,19.69,34.75,25711,25737
1952,25,27,7,20.48,16.09,25736,25761
1953,24,31,16,21.33,14.31,25760,25784
1954,26,27,5,19.69,16.91,25783,25809
1955,24,31,12,21.33,15.81,25808,25832
1956,25,27,2,20.48,34.49,25831,25856
1957,25,27,5,20.48,14.97,25855,25880
1958,24,27,16,21.33,10.31,25879,25903
1959,23,31,7,22.26,20.71,25902,25925
1960,25,27,1,20.48,36.09,25924,25949
1961,23,27,17,22.26,11.50,25948,25971
1962,26,27,1,19.69,32.29,25970,25996
1963,24,27,4,21.33,21.31,25995,26019
1964,24,27,11,21.33,13.22,26018,26042
1965,23,27,8,22.26,19.84,26041,26064
1966,25,27,6,20.48,15.61,26063,26088
1967,24,27,2,21.33,29.97,26087,26111
1968,26,23,9,19.69,11.37,26110,26136
1969,23,27,14,22.26,11.32,26135,26158
1970,24,31,3,21.33,26.56,26158,26182
1971,26,27,5,19.69,13.67,26181,26207
1972,23,27,19,22.26,5.06,26206,26229
1973,23,27,14,22.26,11.32,26229,26252
1974,24,31,9,21.33,23.56,26251,26275
1975,24,27,14,21.33,9.97,26274,26298
1976,24,31,8,21.33,18.64,26298,26322
1977,24,27,19,21.33,7.89,26321,26345
1978,25,23,8,20.48,14.17,26344,26369
1979,25,27,7,20.48,21.85,26368,26393
1980,24,31,6,21.33,25.64,26392,26416
1981,25,27,13,20.48,9.21,26415,26440
1982,25,31,9,20.48,15.69,26439,26464
1983,25,27,9,20.48,16.57,26463,26488
1984,24,31,9,21.33,26.22,26487,26511
1985,24,27,8,21.33,17.97,26510,26534
1986,22,31,11,23.27,17.56,26533,26555
1987,24,31,2,21.33,26.31,26554,26578
1988,25,27,8,20.48,16.73,26577,26602
1989,24,27,15,21.33,9.22,26601,26625
1990,24,27,19,21.33,6.56,26625,26649
1991,24,27,7,21.33,17.22,26649,26673
1992,24,27,12,21.33,10.97,26672,26696
1993,24,31,1,21.33,29.47,26695,26719
1994,24,27,1,21.33,40.22,26718,26742
1995,24,27,12,21.33,10.97,26741,26765
1996,25,27,11,20.48,13.21,26764,26789
1997,26,27,5,19.69,14.44,26788,26814
1998,25,27,1,20.48,25.21,26813,26838
1999,25,27,1,20.48,20.73,26837,26862
2000,23,31,7,22.26,20.37,26861,26884
2001,24,27,14,21.33,12.89,26883,26907
2002,21,31,15,24.38,13.28,26907,26928
2003,23,31,2,22.26,43.41,26927,26950
2004,23,35,2,22.26,43.76,26949,26972
2005,22,31,11,23.27,24.11,26971,26993
2006,23,27,14,22.26,15.67,26992,27015
2007,23,35,5,22.26,40.80,27014,27037
2008,23,31,3,22.26,30.28,27036,27059
2009,23,27,5,22.26,26.54,27058,27081
2010,23,31,13,22.26,19.93,27080,27103
2011,24,27,5,21.33,30.14,27102,27126
2012,23,31,9,22.26,31.84,27125,27148
2013,23,31,5,22.26,27.32,27147,27170
2014,22,35,13,23.27,34.93,27169,27191
2015,23,31,3,22.26,35.24,27190,27213
2016,22,31,13,23.27,24.83,27212,27234
2017,23,31,4,22.26,36.28,27233,27256
2018,24,35,8,21.33,43.06,27255,27279
2019,22,31,6,23.27,35.29,27278,27300
2020,22,31,13,23.27,18.56,27299,27321
2021,23,31,1,22.26,35.84,27320,27343
2022,22,35,2,23.27,56.93,27342,27364
2023,20,34,7,25.60,38.74,27363,27383
2024,22,31,9,23.27,36.02,27382,27404
2025,21,31,14,24.38,21.47,27403,27424
2026,24,31,5,21.33,32.31,27423,27447
2027,24,27,2,21.33,36.14,27446,27470
2028,21,35,8,24.38,42.62,27470,27491
2029,23,31,10,22.26,35.58,27490,27513
2030,23,31,4,22.26,45.06,27512,27535
2031,23,31,6,22.26,31.58,27534,27557
2032,21,31,7,24.38,25.85,27556,27577
2033,23,31,12,22.26,26.89,27576,27599
2034,23,35,7,22.26,37.58,27598,27621
2035,23,31,7,22.26,34.63,27620,27643
2036,23,31,3,22.26,37.84,27642,27665
2037,21,35,13,24.38,20.52,27664,27685
2038,25,35,1,20.48,52.89,27684,27709
2039,24,31,7,21.33,21.97,27708,27732
2040,24,31,1,21.33,41.89,27731,27755
2041,23,31,11,22.26,22.80,27754,27777
2042,22,31,5,23.27,29.11,27776,27798
2043,24,31,5,21.33,33.97,27797,27821
2044,24,31,6,21.33,34.89,27820,27844
2045,21,31,11,24.38,24.14,27843,27864
2046,25,31,4,20.48,43.05,27863,27888
2047,23,31,7,22.26,23.15,27887,27910
2048,21,31,18,24.38,13.57,27909,27930
2049,22,39,1,23.27,76.38,27929,27951
2050,22,31,10,23.27,26.29,27950,27972
2051,22,31,5,23.27,39.02,27971,27993
2052,22,35,12,23.27,29.65,27992,28014
2053,23,39,6,22.26,44.45,28013,28036
2054,22,31,11,23.27,30.20,28035,28057
2055,25,27,7,20.48,35.85,28056,28081
2056,24,31,11,21.33,32.22,28080,28104
2057,25,27,1,20.48,39.61,28103,28128
2058,23,34,6,22.26,40.89,28127,28150
2059,23,31,6,22.26,23.76,28149,28172
2060,22,27,4,23.27,32.47,28171,28193
2061,22,31,8,23.27,25.56,28192,28214
2062,21,35,5,24.38,44.05,28213,28234
2063,22,35,2,23.27,43.20,28233,28255
2064,25,35,4,20.48,44.89,28254,28279
2065,23,31,4,22.26,50.89,28278,28301
2066,22,31,13,23.27,17.29,28300,28322
2067,22,32,7,23.27,34.65,28321,28343
2068,22,31,10,23.27,29.38,28342,28364
2069,23,31,13,22.26,25.50,28363,28386
2070,24,31,10,21.33,24.22,28385,28409
2071,24,31,3,21.33,35.97,28408,28432
2072,23,35,5,22.26,34.11,28431,28454
2073,22,31,13,23.27,22.11,28453,28475
2074,22,31,6,23.27,39.65,28474,28496
2075,25,31,8,20.48,39.61,28495,28520
2076,23,35,5,22.26,42.98,28519,28542
2077,21,35,14,24.38,27.95,28541,28562
2078,23,31,3,22.26,51.06,28561,28584
2079,22,36,8,23.27,40.47,28583,28605
2080,22,31,17,23.27,16.29,28604,28626
2081,23,31,3,22.26,30.98,28625,28648
2082,22,35,14,23.27,26.02,28647,28669
2083,23,31,2,22.26,33.84,28668,28691
2084,22,35,5,23.27,29.56,28690,28712
2085,23,35,6,22.26,37.32,28711,28734
2086,22,31,13,23.27,21.29,28733,28755
2087,23,31,3,22.26,51.67,28754,28777
2088,23,35,3,22.26,46.80,28776,28799
2089,24,31,3,21.33,31.64,28798,28822
2090,22,32,12,23.27,30.20,28821,28843
2091,23,31,2,22.26,50.98,28842,28865
2092,22,31,4,23.27,39.93,28864,28886
2093,23,35,2,22.26,48.45,28885,28908
2094,23,35,13,22.26,33.06,28907,28930
2095,25,31,5,20.48,48.01,28929,28954
2096,22,31,13,23.27,30.93,28953,28975
2097,23,31,2,22.26,36.98,28974,28997
2098,23,31,1,22.26,40.63,28996,29019
2099,22,31,16,23.27,16.74,29018,29040
2100,24,31,4,21.33,33.39,29039,29063
2101,22,31,9,23.27,23.02,29062,29084
2102,26,31,5,19.69,28.14,29083,29109
2103,22,35,5,23.27,45.74,29108,29130
2104,24,31,8,21.33,32.31,29129,29153
2105,22,31,11,23.27,25.56,29152,29174
2106,21,35,7,24.38,34.90,29173,29194
2107,25,31,8,20.48,31.05,29193,29218
2108,25,31,8,20.48,34.25,29217,29242
2109,24,27,12,21.33,19.39,29241,29265
2110,21,35,11,24.38,25.19,29264,29285
2111,23,35,6,22.26,46.54,29284,29307
2112,24,30,7,21.33,44.56,29306,29330
2113,23,31,11,22.26,23.24,29329,29352
2114,24,31,2,21.33,50.47,29351,29375
2115,25,27,6,20.48,40.25,29374,29399
2116,22,31,16,23.27,16.29,29398,29420
2117,23,31,3,22.26,38.54,29419,29442
2118,22,35,8,23.27,37.20,29441,29463
2119,23,31,4,22.26,41.84,29462,29485
2120,22,31,5,23.27,36.56,29484,29506
2121,23,31,7,22.26,26.28,29505,29528
2122,23,35,11,22.26,28.11,29527,29550
2123,23,31,1,22.26,58.98,29549,29572
2124,22,31,4,23.27,39.38,29571,29593
2125,22,27,17,23.27,11.02,29592,29614
2126,22,35,2,23.27,46.93,29613,29635
2127,23,31,3,22.26,58.02,29634,29657
2128,25,31,9,20.48,25.21,29656,29681
2129,23,35,11,22.26,36.54,29680,29703
2130,23,31,13,22.26,19.32,29702,29725
2131,24,31,3,21.33,41.56,29724,29748
2132,21,31,18,24.38,15.76,29747,29768
2133,23,35,7,22.26,42.11,29768,29791
2134,22,35,7,23.27,40.83,29790,29812
2135,23,35,10,22.26,37.76,29811,29834
2136,22,35,11,23.27,32.11,29833,29855
2137,23,35,12,22.26,32.54,29854,29877
2138,22,31,11,23.27,26.47,29877,29899
2139,25,27,1,20.48,54.41,29898,29923
2140,21,31,16,24.38,15.38,29922,29943
2141,22,31,2,23.27,52.74,29942,29964
2142,21,35,19,24.38,18.33,29963,29984
2143,21,31,8,24.38,32.71,29983,30004
2144,23,31,8,22.26,23.32,30003,30026
2145,23,31,4,22.26,32.02,30025,30048
2146,22,35,8,23.27,50.93,30047,30069
2147,22,35,14,23.27,21.56,30068,30090
2148,23,35,4,22.26,48.98,30089,30112
2149,21,31,11,24.38,33.95,30111,30132
2150,24,35,7,21.33,44.31,30131,30155
2151,24,31,3,21.33,42.31,30154,30178
2152,22,35,13,23.27,28.20,30177,30199
2153,23,35,10,22.26,27.24,30199,30222
2154,24,31,6,21.33,35.81,30221,30245
2155,25,30,13,20.48,18.17,30244,30269
2156,21,31,1,24.38,50.52,30268,30289
2157,22,35,2,23.27,54.65,30288,30310
2158,22,31,12,23.27,19.56,30309,30331
2159,22,31,2,23.27,66.20,30330,30352
2160,22,31,10,23.27,34.20,30351,30373
2161,23,27,10,22.26,17.32,30372,30395
2162,22,35,10,23.27,35.83,30394,30416
2163,23,32,11,22.26,24.45,30415,30438
2164,23,35,10,22.26,43.24,30437,30460
2165,25,31,2,20.48,56.89,30459,30484
2166,23,35,10,22.26,38.19,30483,30506
2167,23,35,9,22.26,43.93,30505,30528
2168,22,31,9,23.27,36.11,30527,30549
2169,23,31,13,22.26,23.15,30548,30571
2170,22,35,9,23.27,35.65,30570,30592
2171,23,31,2,22.26,40.71,30591,30614
2172,23,31,8,22.26,34.28,30613,30636
2173,22,35,3,23.27,31.29,30635,30657
2174,24,31,3,21.33,35.56,30656,30680
2175,22,31,1,23.27,58.11,30679,30701
2176,23,35,12,22.26,26.54,30700,30723
2177,21,35,5,24.38,37.19,30722,30743
2178,23,31,6,22.26,37.41,30742,30765
2179,23,31,3,22.26,41.06,30764,30787
2180,24,27,1,21.33,36.06,30786,30810
2181,23,35,11,22.26,37.15,30809,30832
2182,22,31,11,23.27,27.20,30831,30853
2183,21,35,8,24.38,37.38,30852,30873
2184,24,27,2,21.33,33.97,30872,30896
2185,25,28,7,20.48,38.97,30895,30920
2186,23,35,11,22.26,44.37,30919,30942
2187,22,31,1,23.27,39.56,30941,30963
2188,24,27,8,21.33,34.22,30962,30986
2189,23,31,12,22.26,18.71,30985,31008
2190,25,27,5,20.48,39.85,31007,31032
2191,22,31,11,23.27,25.56,31031,31053
2192,22,31,8,23.27,35.38,31052,31074
2193,22,31,11,23.27,23.65,31073,31095
2194,24,31,4,21.33,49.56,31094,31118
2195,23,35,4,22.26,60.54,31117,31140
2196,23,27,11,22.26,22.63,31139,31162
2197,20,31,20,25.60,9.34,31161,31181
2198,26,27,1,19.69,43.98,31180,31206
2199,23,35,13,22.26,32.63,31205,31228
2200,22,31,9,23.27,27.65,31227,31249
2201,23,35,1,22.26,36.37,31248,31271
2202,21,39,11,24.38,31.09,31270,31291
2203,24,39,1,21.33,67.14,31290,31314
2204,25,27,4,20.48,28.97,31313,31338
2205,24,31,1,21.33,40.14,31337,31361
2206,23,35,3,22.26,48.89,31360,31383
2207,22,39,4,23.27,61.20,31382,31404
2208,21,31,19,24.38,14.14,31403,31424
2209,23,28,2,22.26,32.71,31423,31446
2210,24,27,11,21.33,19.56,31446,31470
2211,21,35,8,24.38,29.85,31469,31490
2212,23,27,1,22.26,39.50,31489,31512
2213,23,27,3,22.26,29.93,31512,31535
2214,22,31,13,23.27,20.11,31534,31556
2215,24,31,2,21.33,37.72,31555,31579
2216,23,27,8,22.26,21.24,31578,31601
2217,22,35,12,23.27,40.83,31600,31622
2218,26,27,7,19.69,27.83,31621,31647
2219,22,35,10,23.27,32.56,31646,31668
2220,24,31,5,21.33,31.56,31667,31691
2221,22,35,14,23.27,25.38,31690,31712
2222,23,35,6,22.26,61.84,31711,31734
2223,22,35,3,23.27,55.29,31734,31756
2224,23,31,12,22.26,21.06,31755,31778
2225,22,35,2,23.27,59.29,31777,31799
2226,22,31,9,23.27,28.11,31798,31820
2227,23,31,2,22.26,48.63,31819,31842
2228,25,31,4,20.48,39.05,31841,31866
2229,22,31,12,23.27,36.20,31865,31887
2230,22,27,7,23.27,29.83,31886,31908
2231,23,35,5,22.26,65.76,31907,31930
2232,22,27,15,23.27,12.02,31929,31951
2233,23,35,4,22.26,46.63,31950,31973
2234,23,31,5,22.26,47.58,31972,31995
2235,22,31,11,23.27,31.29,31994,32016
2236,23,31,4,22.26,44.11,32015,32038
2237,22,31,11,23.27,17.20,32037,32059
2238,21,39,6,24.38,44.81,32059,32080
2239,22,35,15,23.27,24.11,32079,32101
2240,22,31,3,23.27,37.93,32101,32123
2241,24,35,8,21.33,30.06,32122,32146
2242,22,35,10,23.27,35.02,32145,32167
2243,23,35,6,22.26,43.06,32166,32189
2244,24,34,11,21.33,22.72,32188,32212
2245,22,31,5,23.27,45.20,32211,32233
2246,22,31,10,23.27,23.02,32232,32254
2247,24,31,9,21.33,28.56,32253,32277
2248,22,27,11,23.27,26.20,32276,32298
2249,22,39,16,23.27,26.02,32297,32319
2250,23,31,6,22.26,24.37,32318,32341
2251,24,31,5,21.33,39.64,32341,32365
2252,24,38,6,21.33,55.97,32364,32388
2253,24,31,4,21.33,40.81,32387,32411
2254,21,31,18,24.38,17.00,32410,32431
2255,23,31,6,22.26,38.71,32430,32453
2256,24,31,1,21.33,40.89,32452,32476
2257,22,31,9,23.27,17.38,32475,32497
2258,22,31,2,23.27,37.47,32496,32518
2259,23,31,3,22.26,37.24,32517,32540
2260,23,31,4,22.26,49.41,32539,32562
2261,21,39,8,24.38,35.47,32561,32582
2262,23,35,7,22.26,32.54,32581,32604
2263,22,34,9,23.27,28.29,32603,32625
2264,22,35,2,23.27,47.74,32624,32646
2265,22,31,4,23.27,40.11,32645,32667
2266,24,31,2,21.33,41.47,32666,32690
2267,23,31,2,22.26,40.98,32689,32712
2268,22,31,10,23.27,27.74,32711,32733
2269,24,31,7,21.33,27.56,32733,32757
2270,24,36,6,21.33,33.06,32756,32780
2271,25,31,6,20.48,37.53,32779,32804
2272,23,31,10,22.26,35.41,32803,32826
2273,23,31,2,22.26,48.11,32825,32848
2274,21,35,14,24.38,32.33,32847,32868
2275,22,39,1,23.27,70.11,32867,32889
2276,24,27,11,21.33,20.22,32888,32912
2277,23,31,3,22.26,52.89,32911,32934
2278,21,31,13,24.38,19.28,32933,32954
2279,24,27,1,21.33,33.39,32953,32977
2280,25,31,1,20.48,49.85,32976,33001
2281,23,32,9,22.26,21.41,33000,33023
2282,21,35,9,24.38,28.62,33022,33043
2283,22,35,3,23.27,46.02,33042,33064
2284,22,35,9,23.27,23.83,33063,33085
2285,22,35,3,23.27,41.65,33084,33106
2286,22,31,3,23.27,37.74,33105,33127
2287,22,35,2,23.27,44.65,33126,33148
2288,22,27,3,23.27,24.83,33147,33169
2289,22,31,2,23.27,40.74,33168,33190
2290,24,35,2,21.33,45.14,33189,33213
2291,23,31,13,22.26,27.24,33212,33235
2292,22,35,3,23.27,42.20,33234,33256
2293,24,27,5,21.33,28.47,33255,33279
2294,22,35,8,23.27,36.02,33278,33300
2295,22,31,14,23.27,17.83,33299,33321
2296,23,31,5,22.26,44.98,33320,33343
2297,22,35,8,23.27,31.11,33342,33364
2298,24,31,1,21.33,41.31,33363,33387
2299,23,35,5,22.26,50.63,33386,33409
2300,22,31,14,23.27,22.65,33408,33430
2301,23,31,11,22.26,41.76,33429,33452
2302,23,39,14,22.26,26.11,33451,33474
2303,24,28,11,21.33,19.89,33473,33497
2304,23,31,12,22.26,21.58,33496,33519
2305,22,31,15,23.27,21.65,33518,33540
2306,22,31,8,23.27,31.29,33539,33561
2307,23,31,10,22.26,26.19,33560,33583
2308,21,31,9,24.38,23.19,33583,33604
2309,23,31,4,22.26,36.89,33603,33626
2310,22,31,12,23.27,23.38,33625,33647
2311,21,39,5,24.38,45.38,33646,33667
2312,23,31,10,22.26,31.67,33666,33689
2313,22,31,15,23.27,16.02,33689,33711
2314,25,27,11,20.48,21.93,33710,33735
2315,23,31,4,22.26,51.76,33734,33757
2316,22,31,5,23.27,29.20,33756,33778
2317,22,35,5,23.27,41.02,33777,33799
2318,23,31,10,22.26,28.98,33798,33821
2319,24,31,5,21.33,43.22,33820,33844
2320,24,27,13,21.33,16.56,33843,33867
2321,22,31,14,23.27,15.65,33866,33888
2322,23,31,5,22.26,41.06,33887,33910
2323,24,27,2,21.33,37.06,33909,33933
2324,24,28,3,21.33,33.81,33932,33956
2325,22,35,4,23.27,30.56,33955,33977
2326,22,31,14,23.27,19.29,33976,33998
2327,22,31,7,23.27,33.74,33997,34019
2328,24,31,10,21.33,44.64,34018,34042
2329,22,31,3,23.27,32.11,34041,34063
2330,22,39,13,23.27,28.20,34062,34084
2331,24,27,5,21.33,36.97,34083,34107
2332,22,31,18,23.27,13.56,34106,34128
2333,21,31,9,24.38,23.09,34127,34148
2334,23,31,1,22.26,46.63,34147,34170
2335,22,31,7,23.27,36.47,34169,34191
2336,22,31,6,23.27,37.93,34190,34212
2337,21,35,9,24.38,30.33,34211,34232
2338,27,27,2,18.96,37.15,34231,34258
2339,20,35,14,25.60,35.24,34257,34277
2340,22,35,5,23.27,39.83,34276,34298
2341,22,35,5,23.27,30.65,34297,34319
2342,22,31,18,23.27,15.02,34318,34340
2343,23,31,5,22.26,34.45,34339,34362
2344,24,27,8,21.33,32.14,34361,34385
2345,23,31,6,22.26,38.28,34384,34407
2346,22,31,11,23.27,29.47,34406,34428
2347,22,31,4,23.27,34.02,34427,34449
2348,24,35,10,21.33,36.56,34448,34472
2349,23,31,6,22.26,27.41,34471,34494
2350,22,31,3,23.27,35.02,34493,34515
2351,22,35,14,23.27,21.93,34514,34536
2352,22,31,5,23.27,40.38,34535,34557
2353,24,31,11,21.33,35.31,34556,34580
2354,22,31,9,23.27,26.02,34579,34601
2355,25,27,5,20.48,30.25,34600,34625
2356,23,35,6,22.26,45.41,34624,34647
2357,23,31,6,22.26,35.93,34646,34669
2358,21,39,7,24.38,48.24,34668,34689
2359,23,28,7,22.26,19.32,34688,34711
2360,23,31,1,22.26,36.28,34710,34733
2361,23,31,7,22.26,25.50,34732,34755
2362,22,31,1,23.27,42.29,34754,34776
2363,22,27,3,23.27,30.47,34775,34797
2364,23,31,5,22.26,38.19,34796,34819
2365,21,31,18,24.38,13.09,34818,34839
2366,23,35,2,22.26,41.50,34838,34861
2367,23,31,6,22.26,47.15,34860,34883
2368,23,31,15,22.26,15.93,34882,34905
2369,24,35,4,21.33,49.72,34904,34928
2370,23,35,4,22.26,56.71,34927,34950
2371,23,27,15,22.26,12.98,34949,34972
2372,22,31,6,23.27,38.74,34971,34993
2373,22,27,4,23.27,27.65,34992,35014
2374,22,35,3,23.27,50.38,35013,35035
2375,22,35,9,23.27,40.93,35034,35056
2376,22,31,17,23.27,14.74,35055,35077
2377,23,31,2,22.26,37.32,35076,35099
2378,21,31,10,24.38,23.95,35098,35119
2379,23,31,3,22.26,32.11,35118,35141
2380,22,31,12,23.27,24.74,35140,35162
2381,24,31,6,21.33,25.72,35161,35185
2382,25,27,11,20.48,27.69,35184,35209
2383,22,31,13,23.27,28.02,35208,35230
2384,23,35,4,22.26,38.54,35229,35252
2385,24,31,1,21.33,47.14,35251,35275
2386,23,31,12,22.26,18.19,35274,35297
2387,22,31,13,23.27,17.56,35297,35319
2388,23,35,6,22.26,30.11,35319,35342
2389,23,27,13,22.26,17.67,35341,35364
2390,23,31,5,22.26,32.19,35363,35386
2391,24,31,6,21.33,36.47,35385,35409
2392,22,31,4,23.27,31.83,35408,35430
2393,23,35,12,22.26,20.80,35429,35452
2394,23,31,4,22.26,42.02,35451,35474
2395,23,31,11,22.26,28.71,35473,35496
2396,22,31,1,23.27,38.47,35495,35517
2397,23,31,9,22.26,21.67,35516,35539
2398,23,31,6,22.26,37.93,35538,35561
2399,21,31,18,24.38,11.66,35560,35581
2400,22,31,2,23.27,39.11,35580,35602
2401,23,35,9,22.26,41.24,35601,35624
2402,22,35,4,23.27,49.56,35623,35645
2403,22,35,14,23.27,24.74,35644,35666
2404,24,31,9,21.33,34.81,35665,35689
2405,23,31,9,22.26,25.84,35688,35711
2406,24,31,1,21.33,37.22,35710,35734
2407,21,35,13,24.38,26.90,35733,35754
2408,22,31,5,23.27,38.74,35753,35775
2409,25,31,9,20.48,39.29,35774,35799
2410,24,31,9,21.33,37.39,35798,35822
2411,23,27,11,22.26,23.93,35821,35844
2412,23,31,12,22.26,19.58,35843,35866
2413,22,31,2,23.27,50.65,35865,35887
2414,22,31,8,23.27,38.93,35886,35908
2415,22,31,19,23.27,14.65,35907,35929
2416,22,31,10,23.27,24.83,35929,35951
2417,23,31,14,22.26,18.11,35950,35973
2418,23,28,5,22.26,40.28,35972,35995
2419,22,31,19,23.27,11.74,35994,36016
2420,24,27,9,21.33,17.81,36016,36040
2421,22,31,15,23.27,15.38,36039,36061
2422,23,31,4,22.26,38.63,36060,36083
2423,22,31,2,23.27,38.56,36083,36105
2424,22,27,15,23.27,11.93,36104,36126
2425,22,30,7,23.27,22.11,36126,36148
2426,22,31,10,23.27,27.29,36147,36169
2427,23,31,3,22.26,41.58,36168,36191
2428,24,27,12,21.33,21.64,36190,36214
2429,24,31,1,21.33,39.89,36213,36237
2430,23,28,13,22.26,19.58,36236,36259
2431,23,31,5,22.26,27.50,36258,36281
2432,24,31,2,21.33,57.72,36280,36304
2433,24,31,2,21.33,41.72,36303,36327
2434,22,31,12,23.27,20.93,36326,36348
2435,24,28,1,21.33,37.89,36347,36371
2436,23,35,4,22.26,42.37,36370,36393
2437,23,35,1,22.26,45.84,36392,36415
2438,21,39,11,24.38,36.90,36414,36435
2439,23,31,10,22.26,21.50,36434,36457
2440,22,31,13,23.27,26.47,36456,36478
2441,25,27,1,20.48,37.77,36477,36502
2442,24,31,6,21.33,39.39,36501,36525
2443,23,27,13,22.26,16.45,36524,36547
2444,24,34,2,21.33,52.81,36546,36570
2445,22,35,11,23.27,26.38,36569,36591
2446,23,35,10,22.26,30.63,36591,36614
2447,24,27,10,21.33,22.89,36613,36637
2448,24,27,3,21.33,29.31,36636,36660
2449,23,31,5,22.26,27.67,36659,36682
2450,23,31,5,22.26,35.06,36681,36704
2451,22,39,3,23.27,61.20,36703,36725
2452,23,31,13,22.26,20.71,36724,36747
2453,23,35,5,22.26,48.98,36746,36769
2454,24,31,7,21.33,36.31,36768,36792
2455,23,28,1,22.26,31.32,36791,36814
2456,23,31,11,22.26,30.54,36813,36836
2457,23,31,4,22.26,46.54,36835,36858
2458,21,31,16,24.38,16.14,36857,36878
2459,21,35,10,24.38,33.28,36877,36898
2460,23,31,9,22.26,24.37,36897,36920
2461,23,31,2,22.26,45.76,36919,36942
2462,23,27,6,22.26,25.84,36942,36965
2463,23,35,14,22.26,20.28,36964,36987
2464,23,31,9,22.26,31.06,36986,37009
2465,23,31,8,22.26,41.58,37008,37031
2466,22,35,10,23.27,23.29,37030,37052
2467,27,31,3,18.96,47.89,37051,37078
2468,21,35,12,24.38,21.47,37077,37098
2469,25,31,3,20.48,46.57,37097,37122
2470,23,31,11,22.26,19.06,37121,37144
2471,24,35,4,21.33,55.47,37143,37167
2472,22,35,12,23.27,23.65,37166,37188
2473,24,35,1,21.33,45.56,37187,37211
2474,23,31,12,22.26,28.63,37210,37233
2475,23,27,7,22.26,20.19,37232,37255
2476,23,31,13,22.26,25.58,37255,37278
2477,23,31,10,22.26,28.02,37278,37301
2478,21,31,17,24.38,15.09,37300,37321
2479,25,27,8,20.48,32.57,37320,37345
2480,24,39,11,21.33,34.97,37344,37368
2481,23,31,4,22.26,28.11,37367,37390
2482,24,31,8,21.33,35.56,37390,37414
2483,21,35,14,24.38,31.57,37413,37434
2484,23,31,5,22.26,24.71,37433,37456
2485,23,27,4,22.26,27.15,37455,37478
2486,22,39,1,23.27,56.20,37477,37499
2487,22,35,5,23.27,39.56,37498,37520
2488,23,31,10,22.26,34.63,37519,37542
2489,25,31,2,20.48,47.77,37541,37566
2490,23,27,1,22.26,41.41,37565,37588
2491,23,31,12,22.26,20.54,37587,37610
2492,22,31,15,23.27,15.11,37610,37632
2493,24,31,2,21.33,48.97,37631,37655
2494,23,31,11,22.26,24.19,37654,37677
2495,22,31,10,23.27,30.47,37676,37698
2496,22,35,7,23.27,30.65,37698,37720
2497,23,31,8,22.26,35.41,37719,37742
2498,23,31,13,22.26,26.11,37741,37764
2499,23,31,6,22.26,34.37,37763,37786
2500,23,31,11,22.26,27.24,37785,37808
2501,24,31,1,21.33,45.47,37807,37831
2502,23,35,6,22.26,35.84,37830,37853
2503,22,35,3,23.27,46.20,37852,37874
2504,23,31,10,22.26,20.89,37873,37896
2505,23,31,13,22.26,27.24,37895,37918
2506,23,35,1,22.26,57.24,37917,37940
2507,23,35,10,22.26,39.32,37939,37962
2508,23,27,7,22.26,26.71,37961,37984
2509,23,31,7,22.26,35.06,37983,38006
2510,23,35,1,22.26,50.02,38005,38028
2511,23,31,13,22.26,21.84,38027,38050
2512,23,35,6,22.26,36.19,38049,38072
2513,23,27,10,22.26,28.45,38071,38094
2514,21,31,14,24.38,16.62,38093,38114
2515,23,31,7,22.26,42.63,38113,38136
2516,22,31,13,23.27,25.83,38136,38158
2517,23,35,5,22.26,31.84,38157,38180
2518,24,27,8,21.33,27.56,38179,38203
2519,24,31,9,21.33,20.97,38202,38226
2520,23,35,7,22.26,48.11,38225,38248
2521,24,31,9,21.33,26.56,38247,38271
2522,23,31,13,22.26,16.89,38270,38293
2523,23,31,5,22.26,36.19,38292,38315
2524,23,27,14,22.26,11.76,38314,38337
2525,25,31,2,20.48,50.17,38336,38361
2526,22,35,6,23.27,29.29,38360,38382
2527,22,31,14,23.27,15.65,38381,38403
2528,24,27,1,21.33,43.39,38402,38426
2529,24,31,3,21.33,46.22,38425,38449
2530,22,31,11,23.27,25.65,38448,38470
2531,23,27,8,22.26,24.28,38469,38492
2532,25,27,6,20.48,25.05,38491,38516
2533,23,31,10,22.26,22.80,38515,38538
2534,22,31,2,23.27,40.38,38537,38559
2535,24,31,8,21.33,30.72,38558,38582
2536,23,31,15,22.26,17.32,38581,38604
2537,22,31,1,23.27,45.02,38603,38625
2538,22,31,1,23.27,56.38,38624,38646
2539,22,32,14,23.27,21.74,38645,38667
2540,22,35,3,23.27,54.02,38666,38688
2541,24,35,2,21.33,51.39,38687,38711
2542,22,35,15,23.27,23.38,38710,38732
2543,22,31,7,23.27,35.11,38732,38754
2544,25,31,3,20.48,29.77,38753,38778
2545,20,31,14,25.60,17.44,38777,38797
2546,23,31,9,22.26,25.58,38796,38819
2547,22,35,12,23.27,39.38,38818,38840
2548,23,35,11,22.26,28.54,38839,38862
2549,24,27,5,21.33,27.56,38861,38885
2550,23,31,14,22.26,24.11,38884,38907
2551,24,27,11,21.33,17.97,38906,38930
2552,22,27,6,23.27,24.20,38929,38951
2553,23,35,3,22.26,74.80,38950,38973
2554,22,35,12,23.27,26.65,38972,38994
2555,23,30,14,22.26,19.15,38993,39016
2556,23,35,1,22.26,47.41,39015,39038
2557,25,31,1,20.48,41.53,39037,39062
2558,22,31,10,23.27,25.83,39061,39083
2559,22,31,13,23.27,18.93,39082,39104
2560,23,31,1,22.26,44.45,39103,39126
2561,22,35,14,23.27,20.02,39125,39147
2562,21,31,13,24.38,19.00,39146,39167
2563,22,35,5,23.27,41.47,39166,39188
2564,22,35,13,23.27,30.83,39187,39209
2565,24,31,1,21.33,51.22,39208,39232
2566,24,35,11,21.33,43.72,39231,39255
2567,22,35,6,23.27,37.83,39254,39276
2568,22,31,5,23.27,30.74,39275,39297
2569,23,31,1,22.26,40.37,39296,39319
2570,21,35,15,24.38,34.81,39318,39339
2571,24,27,4,21.33,31.81,39338,39362
2572,25,31,8,20.48,26.25,39361,39386
2573,24,27,7,21.33,29.97,39385,39409
2574,22,31,10,23.27,28.83,39408,39430
2575,23,31,8,22.26,24.63,39429,39452
2576,25,27,7,20.48,27.45,39451,39476
2577,23,31,10,22.26,34.02,39475,39498
2578,24,31,9,21.33,29.72,39497,39521
2579,25,35,8,20.48,41.45,39520,39545
2580,22,27,9,23.27,22.29,39544,39566
2581,22,31,14,23.27,20.65,39565,39587
2582,24,27,3,21.33,33.56,39586,39610
2583,23,35,9,22.26,33.50,39609,39632
2584,24,31,13,21.33,19.72,39631,39655
2585,22,35,1,23.27,48.56,39654,39676
2586,22,31,6,23.27,25.83,39675,39697
2587,24,31,7,21.33,36.97,39696,39720
2588,24,31,5,21.33,35.64,39719,39743
2589,23,27,11,22.26,15.15,39742,39765
2590,25,31,6,20.48,33.93,39764,39789
2591,23,31,8,22.26,19.15,39788,39811
2592,23,31,10,22.26,29.24,39810,39833
2593,23,31,7,22.26,49.93,39832,39855
2594,21,31,15,24.38,20.33,39854,39875
2595,22,31,8,23.27,38.56,39874,39896
2596,22,31,9,23.27,16.83,39895,39917
2597,22,35,6,23.27,37.11,39916,39938
2598,23,31,13,22.26,23.06,39937,39960
2599,22,31,7,23.27,44.93,39959,39981
2600,23,31,6,22.26,30.19,39980,40003
2601,23,31,2,22.26,42.45,40002,40025
2602,22,35,19,23.27,20.20,40024,40046
2603,23,35,1,22.26,44.19,40045,40068
2604,23,39,2,22.26,50.54,40067,40090
2605,24,27,6,21.33,22.97,40089,40113
2606,22,31,17,23.27,9.56,40112,40134
2607,23,35,4,22.26,30.63,40133,40156
2608,23,31,2,22.26,41.67,40155,40178
2609,22,31,13,23.27,22.38,40177,40199
2610,23,31,5,22.26,37.24,40198,40221
2611,22,27,15,23.27,12.47,40220,40242
2612,22,35,10,23.27,30.93,40241,40263
2613,25,28,5,20.48,41.13,40262,40287
2614,23,31,2,22.26,46.37,40286,40309
2615,23,31,2,22.26,37.76,40308,40331
2616,23,31,16,22.26,12.89,40330,40353
2617,25,27,9,20.48,26.49,40352,40377
2618,24,31,4,21.33,40.97,40376,40400
2619,22,30,5,23.27,27.11,40399,40421
2620,22,31,2,23.27,31.29,40420,40442
2621,23,27,13,22.26,17.41,40441,40464
2622,23,31,3,22.26,34.63,40463,40486
2623,22,31,4,23.27,31.11,40485,40507
2624,23,32,1,22.26,49.58,40506,40529
2625,21,35,19,24.38,21.19,40528,40549
2626,23,31,3,22.26,36.71,40548,40571
2627,23,31,14,22.26,13.93,40570,40593
2628,24,31,1,21.33,48.31,40592,40616
2629,20,35,19,25.60,19.74,40615,40635
2630,26,28,3,19.69,31.44,40634,40660
2631,22,35,14,23.27,25.83,40659,40681
2632,22,31,5,23.27,29.56,40680,40702
2633,22,31,2,23.27,35.65,40701,40723
2634,21,31,8,24.38,29.66,40722,40743
2635,23,31,3,22.26,34.98,40742,40765
2636,21,35,15,24.38,25.38,40764,40785
2637,22,31,9,23.27,22.65,40784,40806
2638,22,39,12,23.27,33.47,40805,40827
2639,23,31,3,22.26,42.45,40826,40849
2640,22,31,12,23.27,26.93,40848,40870
2641,23,35,3,22.26,34.98,40869,40892
2642,22,34,7,23.27,35.02,40891,40913
2643,23,35,1,22.26,44.80,40912,40935
2644,26,27,10,19.69,27.67,40934,40960
2645,24,27,2,21.33,32.14,40959,40983
2646,22,35,10,23.27,25.29,40982,41004
2647,20,35,17,25.60,23.24,41003,41023
2648,21,35,6,24.38,30.33,41022,41043
2649,24,27,6,21.33,28.81,41042,41066
2650,21,31,17,24.38,13.76,41065,41086
2651,23,31,3,22.26,38.11,41085,41108
2652,24,31,4,21.33,31.89,41107,41131
2653,25,31,10,20.48,33.77,41130,41155
2654,24,35,8,21.33,33.81,41154,41178
2655,22,31,8,23.27,24.74,41177,41199
2656,22,27,13,23.27,11.74,41198,41220
2657,23,31,1,22.26,42.11,41219,41242
2658,22,31,11,23.27,29.20,41241,41263
2659,24,27,13,21.33,17.97,41262,41286
2660,22,35,6,23.27,40.38,41285,41307
2661,23,31,4,22.26,34.11,41306,41329
2662,23,31,1,22.26,36.19,41328,41351
2663,25,31,8,20.48,25.85,41350,41375
2664,23,31,5,22.26,39.50,41374,41397
2665,22,31,2,23.27,39.65,41396,41418
2666,21,32,14,24.38,22.14,41417,41438
2667,23,31,8,22.26,19.06,41437,41460
2668,22,31,5,23.27,30.65,41459,41481
2669,24,31,4,21.33,28.81,41480,41504
2670,23,31,5,22.26,26.80,41503,41526
2671,23,31,7,22.26,34.71,41525,41548
2672,21,35,13,24.38,30.14,41547,41568
2673,24,31,3,21.33,34.64,41567,41591
2674,23,27,15,22.26,13.41,41590,41613
2675,23,31,1,22.26,36.89,41612,41635
2676,23,27,2,22.26,30.45,41634,41657
2677,22,31,15,23.27,16.93,41656,41678
2678,22,31,12,23.27,19.83,41677,41699
2679,22,31,9,23.27,18.29,41698,41720
2680,22,31,8,23.27,29.83,41719,41741
2681,22,31,4,23.27,46.83,41740,41762
2682,22,31,9,23.27,24.56,41761,41783
2683,23,27,11,22.26,18.28,41782,41805
2684,22,31,8,23.27,27.29,41804,41826
2685,22,27,19,23.27,9.56,41825,41847
2686,24,31,2,21.33,32.14,41846,41870
2687,21,31,14,24.38,19.66,41869,41890
2688,23,31,5,22.26,32.89,41889,41912
2689,23,31,3,22.26,34.89,41911,41934
2690,22,31,1,23.27,50.29,41933,41955
2691,22,31,6,23.27,25.11,41954,41976
2692,22,31,11,23.27,23.38,41975,41997
2693,24,31,9,21.33,32.89,41996,42020
2694,24,35,10,21.33,28.22,42019,42043
2695,23,35,4,22.26,45.15,42042,42065
2696,23,31,12,22.26,19.06,42064,42087
2697,23,31,4,22.26,28.54,42086,42109
2698,23,31,5,22.26,36.71,42108,42131
2699,24,36,1,21.33,49.22,42130,42154
2700,23,31,10,22.26,26.19,42153,42176
2701,22,31,13,23.27,19.02,42175,42197
2702,25,27,8,20.48,24.01,42196,42221
2703,21,35,15,24.38,26.33,42220,42241
2704,23,31,4,22.26,25.84,42240,42263
2705,23,35,1,22.26,55.67,42262,42285
2706,21,31,9,24.38,23.09,42284,42305
2707,24,35,10,21.33,29.47,42304,42328
2708,23,35,2,22.26,37.32,42327,42350
2709,24,31,2,21.33,44.81,42349,42373
2710,22,31,11,23.27,22.65,42372,42394
2711,23,27,12,22.26,18.37,42393,42416
2712,23,35,2,22.26,41.50,42415,42438
2713,23,31,9,22.26,24.37,42437,42460
2714,23,31,14,22.26,20.54,42459,42482
2715,25,27,11,20.48,25.93,42481,42506
2716,23,31,6,22.26,35.67,42505,42528
2717,22,35,15,23.27,26.11,42527,42549
2718,22,31,4,23.27,44.02,42548,42570
2719,23,27,2,22.26,30.45,42569,42592
2720,23,31,14,22.26,18.71,42591,42614
2721,23,31,2,22.26,39.76,42613,42636
2722,23,27,7,22.26,25.24,42635,42658
2723,23,31,1,22.26,44.54,42657,42680
2724,22,35,9,23.27,32.02,42679,42701
2725,25,31,12,20.48,20.25,42700,42725
2726,22,31,13,23.27,17.65,42724,42746
2727,22,31,10,23.27,23.83,42745,42767
2728,22,31,3,23.27,32.74,42766,42788
2729,22,35,1,23.27,38.65,42787,42809
2730,23,31,8,22.26,41.67,42808,42831
2731,23,27,10,22.26,17.24,42830,42853
2732,22,31,8,23.27,33.29,42852,42874
2733,22,31,7,23.27,29.83,42873,42895
2734,23,28,14,22.26,14.02,42894,42917
2735,24,28,5,21.33,37.97,42916,42940
2736,21,35,13,24.38,18.62,42939,42960
2737,23,27,8,22.26,20.54,42960,42983
2738,21,31,11,24.38,19.85,42982,43003
2739,23,31,9,22.26,26.02,43002,43025
2740,22,31,2,23.27,32.74,43024,43046
2741,23,29,3,22.26,27.15,43045,43068
2742,22,31,8,23.27,27.65,43067,43089
2743,22,27,17,23.27,11.02,43088,43110
2744,23,31,2,22.26,27.67,43109,43132
2745,22,35,8,23.27,26.47,43132,43154
2746,22,35,5,23.27,36.47,43153,43175
2747,22,35,10,23.27,35.74,43174,43196
2748,22,31,16,23.27,14.38,43195,43217
2749,22,31,1,23.27,38.65,43216,43238
2750,23,31,5,22.26,33.84,43237,43260
2751,22,31,18,23.27,13.47,43259,43281
2752,23,35,1,22.26,64.28,43280,43303
2753,23,31,3,22.26,29.06,43302,43325
2754,20,35,19,25.60,18.14,43324,43344
2755,22,31,3,23.27,48.11,43343,43365
2756,23,27,1,22.26,30.63,43364,43387
2757,22,27,19,23.27,9.83,43386,43408
2758,23,31,5,22.26,40.02,43407,43430
2759,21,31,11,24.38,18.71,43429,43450
2760,23,31,6,22.26,31.50,43449,43472
2761,23,27,12,22.26,16.02,43471,43494
2762,24,31,4,21.33,34.31,43493,43517
2763,22,35,9,23.27,38.65,43516,43538
2764,21,35,10,24.38,36.71,43537,43558
2765,23,31,5,22.26,44.71,43557,43580
2766,22,31,5,23.27,36.47,43579,43601
2767,22,35,8,23.27,38.93,43600,43622
2768,22,31,9,23.27,22.65,43621,43643
2769,21,35,18,24.38,23.85,43642,43663
2770,22,27,2,23.27,29.47,43662,43684
2771,22,31,1,23.27,38.65,43683,43705
2772,24,31,8,21.33,25.97,43704,43728
2773,22,31,5,23.27,43.47,43727,43749
2774,22,31,15,23.27,22.20,43748,43770
2775,24,27,5,21.33,30.81,43769,43793
2776,22,31,13,23.27,21.83,43792,43814
2777,22,35,3,23.27,35.74,43813,43835
2778,23,35,4,22.26,39.67,43834,43857
2779,25,31,13,20.48,25.61,43856,43881
2780,24,27,3,21.33,31.06,43880,43904
2781,22,31,5,23.27,28.74,43903,43925
2782,23,35,11,22.26,25.24,43924,43947
2783,22,31,8,23.27,29.47,43946,43968
2784,23,31,2,22.26,44.37,43967,43990
2785,21,31,17,24.38,16.24,43989,44010
2786,24,31,1,21.33,43.64,44009,44033
2787,23,31,3,22.26,25.93,44032,44055
2788,21,31,19,24.38,15.28,44054,44075
2789,22,31,4,23.27,50.93,44074,44096
2790,23,31,14,22.26,15.50,44095,44118
2791,21,31,8,24.38,23.28,44117,44138
2792,24,31,4,21.33,44.89,44137,44161
2793,24,31,11,21.33,26.56,44160,44184
2794,22,35,2,23.27,45.47,44183,44205
2795,23,31,9,22.26,19.15,44204,44227
2796,22,31,12,23.27,24.56,44226,44248
2797,22,35,13,23.27,23.38,44247,44269
2798,23,31,10,22.26,22.54,44268,44291
2799,23,31,16,22.26,14.98,44290,44313
2800,22,35,7,23.27,28.47,44312,44334
2801,23,31,13,22.26,28.37,44333,44356
2802,23,27,1,22.26,34.11,44355,44378
2803,22,35,10,23.27,38.20,44377,44399
2804,22,31,9,23.27,21.20,44398,44420
2805,21,35,4,24.38,35.76,44419,44440
2806,24,31,2,21.33,28.97,44439,44463
2807,23,31,7,22.26,22.54,44462,44485
2808,24,31,1,21.33,50.89,44484,44508
2809,23,31,7,22.26,26.28,44507,44530
2810,21,31,12,24.38,20.62,44529,44550
2811,23,27,10,22.26,15.84,44550,44573
2812,22,31,3,23.27,36.47,44572,44594
2813,21,35,19,24.38,15.28,44593,44614
2814,22,31,1,23.27,35.74,44614,44636
2815,22,27,15,23.27,9.83,44635,44657
2816,21,35,1,24.38,42.14,44656,44677
2817,23,35,1,22.26,57.06,44676,44699
2818,22,31,19,23.27,10.29,44698,44720
2819,24,31,2,21.33,36.39,44719,44743
2820,23,31,6,22.26,20.37,44742,44765
2821,20,39,19,25.60,30.44,44764,44784
2822,24,35,2,21.33,46.81,44783,44807
2823,23,31,13,22.26,22.11,44806,44829
2824,23,31,2,22.26,38.80,44828,44851
2825,22,31,18,23.27,12.74,44850,44872
2826,23,35,6,22.26,35.67,44871,44894
2827,23,27,4,22.26,23.67,44893,44916
2828,22,31,2,23.27,42.20,44915,44937
2829,21,31,17,24.38,9.47,44936,44957
2830,24,31,1,21.33,40.22,44956,44980
2831,24,31,8,21.33,23.47,44979,45003
2832,22,31,14,23.27,24.02,45002,45024
2833,22,31,1,23.27,59.47,45023,45045
2834,22,32,13,23.27,29.47,45044,45066
2835,23,31,3,22.26,40.19,45065,45088
2836,23,31,5,22.26,25.41,45087,45110
2837,22,31,11,23.27,14.93,45109,45131
2838,24,27,9,21.33,24.89,45130,45154
2839,23,35,7,22.26,30.80,45153,45176
2840,23,31,9,22.26,25.76,45175,45198
2841,22,31,14,23.27,16.74,45197,45219
2842,23,31,11,22.26,21.67,45218,45241
2843,22,31,11,23.27,21.20,45240,45262
2844,23,31,2,22.26,36.89,45261,45284
2845,22,31,7,23.27,24.11,45283,45305
2846,23,31,13,22.26,26.02,45304,45327
2847,23,27,1,22.26,47.76,45326,45349
2848,21,35,19,24.38,14.33,45348,45369
2849,22,31,2,23.27,40.74,45368,45390
2850,22,31,9,23.27,27.02,45389,45411
2851,22,31,4,23.27,44.02,45410,45432
2852,23,31,6,22.26,28.71,45431,45454
2853,25,31,2,20.48,52.01,45453,45478
2854,22,27,3,23.27,25.56,45477,45499
2855,22,31,11,23.27,17.47,45498,45520
2856,22,27,3,23.27,32.74,45519,45541
2857,23,27,12,22.26,15.41,45540,45563
2858,22,27,6,23.27,25.11,45562,45584
2859,25,31,6,20.48,35.93,45583,45608
2860,22,31,5,23.27,35.02,45607,45629
2861,22,35,10,23.27,29.93,45628,45650
2862,24,27,5,21.33,20.89,45649,45673
2863,22,31,15,23.27,13.47,45672,45694
2864,24,31,1,21.33,46.22,45693,45717
2865,23,35,12,22.26,22.54,45716,45739
2866,23,31,3,22.26,42.28,45738,45761
2867,23,27,5,22.26,23.32,45760,45783
2868,22,31,2,23.27,33.83,45782,45804
2869,23,31,13,22.26,14.28,45803,45826
2870,22,31,2,23.27,55.65,45825,45847
2871,22,31,13,23.27,19.02,45846,45868
2872,25,31,8,20.48,34.65,45867,45892
2873,22,31,9,23.27,30.20,45891,45913
2874,23,31,1,22.26,38.28,45912,45935
2875,23,27,3,22.26,25.58,45934,45957
2876,20,31,18,25.60,15.34,45956,45976
2877,23,27,13,22.26,9.06,45975,45998
2878,22,31,7,23.27,28.47,45997,46019
2879,22,31,7,23.27,35.65,46018,46040
2880,21,35,19,24.38,20.24,46039,46060
2881,22,31,8,23.27,34.20,46059,46081
2882,22,31,13,23.27,16.11,46080,46102
2883,23,31,7,22.26,28.37,46101,46124
2884,22,31,16,23.27,14.20,46123,46145
2885,24,27,3,21.33,29.22,46144,46168
2886,23,31,1,22.26,30.63,46167,46190
2887,24,28,3,21.33,31.31,46189,46213
2888,22,31,16,23.27,13.11,46212,46234
2889,26,31,7,19.69,31.06,46233,46259
2890,24,27,12,21.33,13.72,46258,46282
2891,23,31,1,22.26,57.24,46281,46304
2892,23,31,3,22.26,29.06,46303,46326
2893,24,27,2,21.33,23.97,46325,46349
2894,23,31,1,22.26,32.54,46348,46371
2895,22,31,2,23.27,29.47,46370,46392
2896,22,31,17,23.27,13.93,46391,46413
2897,23,31,4,22.26,29.93,46412,46435
2898,21,31,9,24.38,20.81,46434,46455
2899,23,31,4,22.26,31.93,46454,46477
2900,22,31,13,23.27,31.11,46476,46498
2901,24,31,10,21.33,21.97,46497,46521
2902,25,27,2,20.48,40.65,46520,46545
2903,22,29,3,23.27,26.02,46544,46566
2904,22,35,4,23.27,34.93,46565,46587
2905,22,31,13,23.27,14.65,46586,46608
2906,22,31,2,23.27,43.65,46607,46629
2907,22,31,10,23.27,24.65,46628,46650
2908,22,27,15,23.27,13.93,46649,46671
2909,22,31,8,23.27,31.65,46670,46692
2910,23,27,12,22.26,16.02,46691,46714
2911,23,31,2,22.26,34.63,46713,46736
2912,23,32,8,22.26,30.11,46735,46758
2913,23,31,1,22.26,36.54,46757,46780
2914,22,35,7,23.27,30.65,46779,46801
2915,22,31,2,23.27,33.47,46800,46822
2916,24,31,4,21.33,33.22,46821,46845
2917,22,35,10,23.27,23.29,46844,46866
2918,23,35,8,22.26,38.71,46865,46888
2919,22,27,15,23.27,12.47,46887,46909
2920,23,27,2,22.26,29.06,46908,46931
2921,24,27,8,21.33,20.64,46930,46954
2922,23,31,13,22.26,16.89,46953,46976
2923,22,31,11,23.27,27.74,46975,46997
2924,21,31,16,24.38,13.38,46996,47017
2925,22,31,12,23.27,22.56,47016,47038
2926,22,27,8,23.27,21.83,47037,47059
2927,24,27,3,21.33,29.22,47058,47082
2928,23,27,4,22.26,29.84,47081,47104
2929,22,31,9,23.27,22.65,47103,47125
2930,23,31,4,22.26,29.84,47124,47147
2931,22,27,15,23.27,8.20,47146,47168
2932,22,31,2,23.27,38.93,47167,47189
2933,22,31,13,23.27,13.20,47188,47210
2934,23,31,2,22.26,34.63,47210,47233
2935,23,35,1,22.26,46.98,47232,47255
2936,24,31,4,21.33,23.64,47254,47278
2937,23,31,6,22.26,24.37,47277,47300
2938,22,27,13,23.27,13.20,47299,47321
2939,24,31,6,21.33,29.31,47320,47344
2940,23,35,8,22.26,30.98,47343,47366
2941,23,27,4,22.26,21.84,47365,47388
2942,22,35,15,23.27,21.93,47387,47409
2943,23,27,2,22.26,28.63,47408,47431
2944,23,27,6,22.26,24.89,47430,47453
2945,22,35,6,23.27,32.74,47452,47474
2946,21,31,19,24.38,14.71,47473,47494
2947,22,31,5,23.27,30.02,47493,47515
2948,22,31,5,23.27,27.74,47514,47536
2949,23,31,14,22.26,25.32,47535,47558
2950,22,31,9,23.27,19.74,47557,47579
2951,22,35,19,23.27,17.56,47579,47601
2952,25,31,6,20.48,43.61,47600,47625
2953,23,31,11,22.26,21.06,47624,47647
2954,23,31,5,22.26,31.06,47646,47669
2955,23,31,2,22.26,47.15,47668,47691
2956,22,31,14,23.27,15.11,47690,47712
2957,22,35,9,23.27,29.93,47711,47733
2958,23,31,12,22.26,21.58,47732,47755
2959,23,31,2,22.26,41.58,47754,47777
2960,22,31,12,23.27,19.29,47776,47798
2961,23,27,14,22.26,16.98,47797,47820
2962,23,31,4,22.26,38.71,47819,47842
2963,24,31,6,21.33,28.47,47841,47865
2964,24,31,7,21.33,37.22,47864,47888
2965,22,35,10,23.27,27.65,47887,47909
2966,23,27,9,22.26,19.50,47908,47931
2967,23,31,3,22.26,30.80,47930,47953
2968,24,35,5,21.33,35.56,47952,47976
2969,24,27,16,21.33,10.31,47975,47999
2970,23,31,15,22.26,12.37,47998,48021
2971,24,27,1,21.33,30.89,48020,48044
2972,24,31,10,21.33,20.89,48043,48067
2973,24,31,8,21.33,16.97,48066,48090
2974,23,27,10,22.26,17.24,48089,48112
2975,25,27,10,20.48,23.21,48111,48136
2976,22,31,17,23.27,13.93,48135,48157
2977,23,31,4,22.26,35.50,48156,48179
2978,22,31,10,23.27,17.11,48178,48200
2979,24,31,5,21.33,36.81,48199,48223
2980,22,31,8,23.27,25.11,48222,48244
2981,22,31,15,23.27,18.29,48243,48265
2982,22,31,2,23.27,30.93,48264,48286
2983,23,31,2,22.26,30.19,48286,48309
2984,20,31,17,25.60,15.24,48308,48328
2985,23,31,6,22.26,24.54,48327,48350
2986,23,31,8,22.26,29.84,48349,48372
2987,23,31,3,22.26,37.24,48371,48394
2988,23,27,12,22.26,16.71,48393,48416
2989,22,27,6,23.27,25.56,48415,48437
2990,26,27,1,19.69,37.83,48436,48462
2991,23,27,18,22.26,6.37,48461,48484
2992,24,27,1,21.33,36.22,48483,48507
2993,22,31,14,23.27,20.02,48506,48528
2994,24,31,5,21.33,38.22,48527,48551
2995,22,27,15,23.27,11.74,48550,48572
2996,22,31,8,23.27,26.93,48571,48593
2997,22,31,6,23.27,26.56,48592,48614
2998,22,31,9,23.27,21.20,48613,48635
2999,22,35,5,23.27,39.38,48635,48657
3000,23,31,11,22.26,22.11,48656,48679
3001,22,31,10,23.27,41.38,48679,48701
3002,22,31,9,23.27,18.29,48701,48723
3003,23,31,7,22.26,23.84,48722,48745
3004,22,31,16,23.27,11.11,48744,48766
3005,22,31,6,23.27,26.93,48765,48787
3006,23,31,13,22.26,17.06,48786,48809
3007,22,31,8,23.27,31.38,48808,48830
3008,22,31,9,23.27,22.65,48829,48851
3009,23,31,6,22.26,23.15,48851,48874
3010,23,31,9,22.26,22.11,48873,48896
3011,23,27,14,22.26,14.11,48895,48918
3012,22,31,4,23.27,30.56,48917,48939
3013,23,31,3,22.26,24.54,48938,48961
3014,24,31,5,21.33,29.56,48960,48984
3015,25,31,5,20.48,34.65,48983,49008
3016,23,31,8,22.26,29.67,49007,49030
3017,24,31,11,21.33,18.97,49029,49053
3018,23,31,7,22.26,31.15,49052,49075
3019,22,31,9,23.27,25.56,49074,49096
3020,23,31,11,22.26,22.19,49095,49118
3021,24,27,7,21.33,27.06,49117,49141
3022,24,35,5,21.33,32.89,49140,49164
3023,22,31,14,23.27,20.02,49163,49185
3024,23,27,5,22.26,30.28,49184,49207
3025,25,27,5,20.48,32.65,49206,49231
3026,22,31,10,23.27,18.56,49230,49252
3027,25,27,3,20.48,31.29,49251,49276
3028,22,31,7,23.27,26.56,49275,49297
3029,23,31,14,22.26,14.89,49296,49319
3030,22,31,9,23.27,27.02,49318,49340
3031,25,31,8,20.48,41.13,49339,49364
3032,22,31,14,23.27,18.56,49363,49385
3033,23,27,9,22.26,21.93,49384,49407
3034,23,27,8,22.26,28.45,49406,49429
3035,22,31,5,23.27,36.47,49428,49450
3036,23,35,11,22.26,16.37,49449,49472
3037,23,31,12,22.26,24.37,49471,49494
3038,22,31,8,23.27,34.74,49493,49515
3039,23,31,7,22.26,29.76,49514,49537
3040,23,31,5,22.26,28.19,49536,49559
3041,23,31,7,22.26,31.32,49558,49581
3042,23,31,12,22.26,14.63,49580,49603
3043,22,31,10,23.27,21.47,49602,49624
3044,23,31,5,22.26,25.76,49623,49646
3045,26,31,3,19.69,37.67,49645,49671
3046,24,27,15,21.33,12.97,49670,49694
3047,23,31,1,22.26,40.54,49693,49716
3048,23,31,8,22.26,30.19,49715,49738
3049,22,31,13,23.27,24.83,49737,49759
3050,24,30,6,21.33,26.14,49758,49782
3051,23,35,13,22.26,25.24,49781,49804
3052,23,31,10,22.26,17.24,49803,49826
3053,24,27,12,21.33,13.39,49825,49849
3054,22,35,7,23.27,37.47,49848,49870
3055,24,31,1,21.33,35.97,49869,49893
3056,24,28,4,21.33,26.06,49892,49916
3057,22,29,19,23.27,7.38,49915,49937
3058,23,31,2,22.26,49.93,49936,49959
3059,22,31,16,23.27,16.74,49958,49980
3060,23,31,3,22.26,35.84,49979,50002
3061,24,27,5,21.33,31.56,50001,50025
3062,23,27,13,22.26,14.02,50024,50047
3063,24,27,3,21.33,31.89,50046,50070
3064,23,31,11,22.26,29.15,50069,50092
3065,24,31,5,21.33,29.97,50091,50115
3066,25,32,1,20.48,41.69,50114,50139
3067,23,31,4,22.26,31.58,50138,50161
3068,23,27,10,22.26,15.76,50160,50183
3069,25,27,9,20.48,16.49,50182,50207
3070,24,31,12,21.33,30.47,50206,50230
3071,23,31,6,22.26,26.71,50229,50252
3072,23,31,4,22.26,40.37,50251,50274
3073,27,27,10,18.96,20.70,50273,50300
3074,24,31,10,21.33,27.14,50299,50323
3075,24,27,1,21.33,33.47,50322,50346
3076,22,35,6,23.27,33.11,50345,50367
3077,25,31,11,20.48,24.41,50366,50391
3078,24,27,12,21.33,12.97,50390,50414
3079,24,27,6,21.33,15.72,50414,50438
3080,25,27,9,20.48,20.65,50437,50462
3081,24,27,12,21.33,15.64,50461,50485
3082,23,31,5,22.26,25.93,50484,50507
3083,24,31,2,21.33,34.14,50506,50530
3084,23,27,13,22.26,16.19,50529,50552
3085,23,35,4,22.26,48.11,50551,50574
3086,23,31,5,22.26,45.50,50573,50596
3087,27,28,1,18.96,30.26,50595,50622
3088,24,31,7,21.33,35.14,50621,50645
3089,23,31,11,22.26,22.02,50644,50667
3090,24,31,4,21.33,33.81,50666,50690
3091,23,35,13,22.26,29.15,50689,50712
3092,23,31,6,22.26,27.32,50711,50734
3093,22,35,12,23.27,30.93,50733,50755
3094,23,31,11,22.26,14.71,50754,50777
3095,25,27,2,20.48,31.29,50776,50801
3096,25,27,10,20.48,15.13,50800,50825
3097,24,31,1,21.33,40.89,50824,50848
3098,23,31,15,22.26,16.54,50847,50870
3099,23,31,5,22.26,34.45,50869,50892
3100,23,31,3,22.26,30.11,50891,50914
3101,24,31,2,21.33,29.31,50913,50937
3102,23,31,19,22.26,8.02,50936,50959
3103,25,27,5,20.48,26.81,50958,50983
3104,24,31,4,21.33,29.31,50982,51006
3105,24,27,3,21.33,29.31,51005,51029
3106,24,31,9,21.33,16.89,51028,51052
3107,24,31,14,21.33,17.64,51051,51075
3108,23,31,11,22.26,23.76,51074,51097
3109,25,27,9,20.48,20.49,51096,51121
3110,23,31,16,22.26,13.58,51120,51143
3111,23,31,6,22.26,27.06,51142,51165
3112,24,35,3,21.33,36.14,51164,51188
3113,25,27,13,20.48,16.81,51187,51212
3114,23,27,5,22.26,24.54,51211,51234
3115,25,27,6,20.48,20.49,51233,51258
3116,24,27,6,21.33,28.72,51257,51281
3117,25,27,6,20.48,17.53,51280,51305
3118,22,31,1,23.27,43.38,51304,51326
3119,23,31,13,22.26,17.58,51325,51348
3120,24,31,2,21.33,35.89,51347,51371
3121,24,31,5,21.33,25.47,51370,51394
3122,21,32,8,24.38,28.52,51393,51414
3123,25,35,6,20.48,39.53,51413,51438
3124,23,35,2,22.26,44.28,51437,51460
3125,21,31,14,24.38,17.38,51459,51480
3126,22,35,17,23.27,22.65,51480,51502
3127,24,31,2,21.33,56.56,51501,51525
3128,23,31,11,22.26,23.24,51524,51547
3129,24,31,5,21.33,21.97,51546,51570
3130,23,31,11,22.26,17.93,51569,51592
3131,24,31,1,21.33,47.89,51591,51615
3132,24,31,3,21.33,44.97,51614,51638
3133,23,31,7,22.26,29.15,51637,51660
3134,23,31,6,22.26,42.89,51660,51683
3135,24,31,2,21.33,31.39,51682,51706
3136,23,31,14,22.26,12.63,51705,51728
3137,24,31,3,21.33,42.97,51727,51751
3138,23,31,15,22.26,10.02,51750,51773
3139,24,27,12,21.33,15.22,51772,51796
3140,22,35,3,23.27,43.29,51795,51817
3141,23,27,3,22.26,27.76,51816,51839
3142,23,31,4,22.26,34.19,51838,51861
3143,24,31,1,21.33,39.72,51860,51884
3144,25,31,1,20.48,50.01,51883,51908
3145,23,27,11,22.26,16.89,51907,51930
3146,22,31,9,23.27,24.11,51929,51951
3147,24,31,4,21.33,27.97,51950,51974
3148,24,31,4,21.33,50.06,51973,51997
3149,23,31,11,22.26,22.98,51996,52019
3150,25,31,10,20.48,22.17,52018,52043
3151,23,31,2,22.26,34.54,52042,52065
3152,24,31,10,21.33,17.89,52064,52088
3153,23,31,12,22.26,22.11,52087,52110
3154,25,27,7,20.48,20.49,52109,52134
3155,22,36,7,23.27,26.56,52133,52155
3156,24,35,3,21.33,39.31,52154,52178
3157,23,31,14,22.26,12.80,52177,52200
3158,25,31,9,20.48,25.45,52199,52224
3159,24,27,2,21.33,35.72,52223,52247
3160,23,31,11,22.26,22.45,52246,52269
3161,24,35,6,21.33,42.31,52268,52292
3162,24,32,3,21.33,50.56,52291,52315
3163,23,27,11,22.26,17.41,52314,52337
3164,22,31,15,23.27,14.02,52336,52358
3165,25,27,6,20.48,19.21,52357,52382
3166,25,31,5,20.48,40.65,52381,52406
3167,23,31,14,22.26,24.02,52405,52428
3168,24,34,7,21.33,31.89,52427,52451
3169,24,31,5,21.33,29.97,52450,52474
3170,23,31,11,22.26,26.02,52473,52496
3171,23,31,12,22.26,19.76,52495,52518
3172,24,31,1,21.33,43.22,52517,52541
3173,23,31,10,22.26,29.93,52540,52563
3174,25,27,7,20.48,34.57,52562,52587
3175,26,27,1,19.69,31.44,52586,52612
3176,23,27,5,22.26,23.76,52611,52634
3177,22,34,6,23.27,31.20,52633,52655
3178,24,31,11,21.33,21.64,52654,52678
3179,24,31,1,21.33,30.31,52677,52701
3180,24,31,10,21.33,37.56,52700,52724
3181,25,27,7,20.48,18.81,52723,52748
3182,23,31,13,22.26,18.89,52748,52771
3183,23,27,14,22.26,12.98,52770,52793
3184,24,28,7,21.33,28.39,52792,52816
3185,25,27,1,20.48,29.13,52815,52840
3186,24,35,4,21.33,30.56,52839,52863
3187,24,27,13,21.33,14.22,52862,52886
3188,25,27,1,20.48,42.57,52885,52910
3189,23,31,13,22.26,26.28,52909,52932
3190,23,35,4,22.26,38.02,52931,52954
3191,24,27,4,21.33,31.97,52953,52977
3192,25,27,10,20.48,24.33,52976,53001
3193,25,27,5,20.48,24.73,53000,53025
3194,23,35,4,22.26,44.80,53024,53047
3195,25,27,13,20.48,11.53,53046,53071
3196,24,27,7,21.33,18.14,53070,53094
3197,24,31,2,21.33,40.14,53093,53117
3198,23,32,9,22.26,26.45,53116,53139
3199,23,31,13,22.26,27.06,53138,53161
3200,23,31,6,22.26,35.41,53160,53183
3201,23,31,7,22.26,28.28,53182,53205
3202,24,31,12,21.33,25.72,53204,53228
3203,26,27,2,19.69,33.21,53227,53253
3204,23,39,5,22.26,51.50,53252,53275
3205,24,31,8,21.33,20.97,53274,53298
3206,24,32,11,21.33,29.06,53297,53321
3207,23,31,13,22.26,19.84,53320,53343
3208,24,31,10,21.33,19.72,53342,53366
3209,24,31,1,21.33,44.81,53365,53389
3210,22,31,7,23.27,24.20,53388,53410
3211,24,31,4,21.33,50.14,53409,53433
3212,23,31,5,22.26,31.32,53432,53455
3213,23,31,13,22.26,21.41,53454,53477
3214,23,31,8,22.26,34.71,53476,53499
3215,23,31,6,22.26,33.41,53498,53521
3216,24,31,2,21.33,41.31,53520,53544
3217,23,35,14,22.26,19.93,53543,53566
3218,23,27,1,22.26,39.32,53565,53588
3219,22,31,15,23.27,15.38,53587,53609
3220,24,27,2,21.33,36.97,53608,53632
3221,25,31,13,20.48,18.41,53632,53657
3222,24,27,5,21.33,20.47,53656,53680
3223,25,35,1,20.48,43.21,53679,53704
3224,24,35,4,21.33,30.97,53703,53727
3225,23,27,5,22.26,31.67,53726,53749
3226,23,31,15,22.26,18.71,53748,53771
3227,23,31,1,22.26,42.54,53770,53793
3228,22,31,13,23.27,21.93,53792,53814
3229,25,31,7,20.48,30.01,53813,53838
3230,24,27,9,21.33,21.14,53837,53861
3231,23,31,7,22.26,40.63,53860,53883
3232,24,31,7,21.33,33.72,53882,53906
3233,23,31,9,22.26,22.02,53905,53928
3234,24,31,5,21.33,35.97,53927,53951
3235,23,31,8,22.26,40.11,53950,53973
3236,24,31,6,21.33,32.56,53972,53996
3237,25,39,2,20.48,55.77,53995,54020
3238,24,31,5,21.33,31.81,54019,54043
3239,25,31,8,20.48,26.81,54042,54067
3240,25,28,4,20.48,36.41,54066,54091
3241,25,31,8,20.48,20.89,54090,54115
3242,24,27,8,21.33,21.06,54114,54138
3243,25,31,1,20.48,36.09,54137,54162
3244,23,35,3,22.26,33.67,54161,54184
3245,25,28,6,20.48,22.81,54183,54208
3246,24,27,19,21.33,7.14,54207,54231
3247,25,31,2,20.48,45.37,54230,54255
3248,23,27,6,22.26,24.98,54254,54277
3249,24,28,6,21.33,26.06,54276,54300
3250,24,31,5,21.33,28.14,54299,54323
3251,23,31,14,22.26,20.45,54322,54345
3252,24,31,3,21.33,33.97,54344,54368
3253,24,31,10,21.33,23.97,54367,54391
3254,24,35,9,21.33,26.47,54390,54414
3255,24,27,5,21.33,27.14,54413,54437
3256,24,31,1,21.33,32.22,54436,54460
3257,24,27,12,21.33,12.56,54459,54483
3258,24,27,2,21.33,31.56,54482,54506
3259,26,31,2,19.69,32.75,54505,54531
3260,24,31,12,21.33,20.47,54530,54554
3261,24,35,9,21.33,29.39,54553,54577
3262,21,31,16,24.38,14.90,54577,54598
3263,23,31,11,22.26,30.89,54597,54620
3264,23,31,9,22.26,22.98,54619,54642
3265,22,31,14,23.27,21.47,54641,54663
3266,23,31,9,22.26,26.63,54662,54685
3267,22,39,5,23.27,43.56,54684,54706
3268,22,35,13,23.27,27.11,54705,54727
3269,24,31,4,21.33,35.39,54726,54750
3270,23,35,5,22.26,43.15,54749,54772
3271,23,31,14,22.26,12.11,54771,54794
3272,23,31,5,22.26,30.98,54793,54816
3273,24,35,7,21.33,34.14,54815,54839
3274,25,28,3,20.48,32.25,54838,54863
3275,24,31,10,21.33,14.06,54862,54886
3276,23,27,8,22.26,28.45,54885,54908
3277,23,31,10,22.26,21.41,54907,54930
3278,24,32,9,21.33,26.72,54929,54953
3279,25,31,6,20.48,28.49,54952,54977
3280,23,31,14,22.26,16.11,54976,54999
3281,22,31,14,23.27,17.83,54999,55021
3282,24,31,1,21.33,55.22,55020,55044
3283,24,27,7,21.33,17.39,55043,55067
3284,25,31,4,20.48,34.17,55066,55091
3285,23,31,5,22.26,27.84,55090,55113
3286,24,31,11,21.33,21.22,55112,55136
3287,22,31,12,23.27,19.29,55135,55157
3288,24,31,11,21.33,14.56,55156,55180
3289,24,31,8,21.33,22.97,55179,55203
3290,24,31,10,21.33,21.47,55202,55226
3291,25,31,4,20.48,39.69,55225,55250
3292,24,27,2,21.33,25.64,55249,55273
3293,22,31,6,23.27,30.38,55272,55294
3294,23,31,14,22.26,15.41,55293,55316
3295,23,31,5,22.26,38.45,55315,55338
3296,26,27,2,19.69,22.75,55337,55363
3297,23,31,6,22.26,27.67,55362,55385
3298,23,31,14,22.26,18.19,55384,55407
3299,22,31,7,23.27,25.56,55406,55428
3300,23,31,7,22.26,25.24,55427,55450
3301,24,31,10,21.33,21.97,55449,55473
3302,24,31,2,21.33,43.14,55472,55496
3303,23,35,9,22.26,27.67,55495,55518
3304,22,31,9,23.27,28.93,55517,55539
3305,23,31,10,22.26,18.63,55538,55561
3306,25,27,4,20.48,18.97,55560,55585
3307,22,31,5,23.27,29.20,55585,55607
3308,23,27,18,22.26,9.58,55606,55629
3309,23,31,10,22.26,18.63,55629,55652
3310,24,31,1,21.33,32.22,55651,55675
3311,24,27,8,21.33,17.31,55674,55698
3312,23,35,2,22.26,38.80,55697,55720
3313,22,31,16,23.27,17.93,55719,55741
3314,24,31,2,21.33,42.14,55740,55764
3315,22,31,10,23.27,25.29,55763,55785
3316,23,31,4,22.26,31.32,55784,55807
3317,23,27,13,22.26,17.93,55806,55829
3318,24,27,2,21.33,32.31,55828,55852
3319,22,35,13,23.27,20.47,55851,55873
3320,24,27,14,21.33,15.22,55872,55896
3321,23,31,2,22.26,49.93,55895,55918
3322,22,35,3,23.27,33.56,55917,55939
3323,23,31,9,22.26,19.50,55938,55961
3324,23,27,12,22.26,13.15,55960,55983
3325,22,31,13,23.27,19.02,55982,56004
3326,23,31,6,22.26,26.02,56003,56026
3327,24,31,1,21.33,31.47,56025,56049
3328,22,27,13,23.27,10.29,56048,56070
3329,24,27,4,21.33,25.31,56069,56093
3330,24,27,1,21.33,29.14,56092,56116
3331,23,28,1,22.26,27.15,56115,56138
3332,23,31,1,22.26,52.89,56137,56160
3333,23,31,10,22.26,32.02,56159,56182
3334,23,27,17,22.26,9.93,56181,56204
3335,22,31,2,23.27,30.56,56203,56225
3336,26,27,4,19.69,24.06,56224,56250
3337,24,31,10,21.33,24.14,56249,56273
3338,23,31,3,22.26,45.41,56272,56295
3339,23,31,5,22.26,33.41,56294,56317
3340,22,31,10,23.27,21.83,56316,56338
3341,24,35,1,21.33,34.89,56337,56361
3342,23,31,3,22.26,36.71,56360,56383
3343,23,31,2,22.26,38.28,56382,56405
3344,23,27,8,22.26,18.45,56404,56427
3345,22,27,5,23.27,26.29,56426,56448
3346,24,27,4,21.33,19.97,56447,56471
3347,24,31,10,21.33,24.31,56470,56494
3348,25,27,9,20.48,17.53,56493,56518
3349,23,27,4,22.26,26.02,56517,56540
3350,23,27,9,22.26,17.76,56539,56562
3351,24,27,7,21.33,19.64,56561,56585
3352,23,31,1,22.26,42.28,56584,56607
3353,23,31,10,22.26,24.28,56606,56629
3354,23,27,7,22.26,19.32,56628,56651
3355,23,31,5,22.26,25.41,56650,56673
3356,23,31,11,22.26,13.76,56672,56695
3357,24,27,13,21.33,12.97,56694,56718
3358,23,35,6,22.26,33.24,56717,56740
3359,24,31,2,21.33,42.31,56739,56763
3360,23,31,10,22.26,24.19,56762,56785
3361,23,31,1,22.26,41.06,56784,56807
3362,24,27,10,21.33,17.06,56806,56830
3363,23,31,4,22.26,33.41,56829,56852
3364,23,31,3,22.26,29.06,56851,56874
3365,23,31,5,22.26,29.93,56873,56896
3366,21,31,18,24.38,10.90,56895,56916
3367,24,31,2,21.33,26.64,56915,56939
3368,23,27,7,22.26,22.98,56938,56961
3369,24,27,3,21.33,25.22,56960,56984
3370,24,31,8,21.33,17.31,56983,57007
3371,25,31,1,20.48,37.61,57006,57031
3372,25,27,6,20.48,18.73,57030,57055
3373,25,31,4,20.48,31.45,57054,57079
3374,23,27,14,22.26,12.71,57078,57101
3375,26,27,9,19.69,18.98,57100,57126
3376,23,31,7,22.26,24.89,57125,57148
3377,23,27,19,22.26,7.67,57147,57170
3378,24,31,2,21.33,37.64,57169,57193
3379,24,27,15,21.33,10.56,57192,57216
3380,24,31,12,21.33,17.31,57215,57239
3381,24,28,7,21.33,21.72,57238,57262
3382,25,27,2,20.48,27.77,57261,57286
3383,24,39,7,21.33,35.56,57285,57309
3384,25,27,5,20.48,25.61,57308,57333
3385,23,27,13,22.26,15.76,57332,57355
3386,25,27,1,20.48,41.05,57354,57379
3387,24,31,13,21.33,19.22,57378,57402
3388,26,27,7,19.69,18.75,57401,57427
3389,24,31,12,21.33,24.64,57426,57450
3390,24,35,3,21.33,46.56,57449,57473
3391,24,27,8,21.33,21.47,57472,57496
3392,24,31,5,21.33,28.47,57495,57519
3393,25,27,6,20.48,19.45,57518,57543
3394,23,31,11,22.26,20.98,57542,57565
3395,23,31,10,22.26,24.63,57564,57587
3396,23,31,13,22.26,23.84,57586,57609
3397,24,27,7,21.33,22.47,57608,57632
3398,24,31,1,21.33,49.64,57631,57655
3399,24,27,7,21.33,20.81,57654,57678
3400,24,31,12,21.33,22.47,57677,57701
3401,24,31,7,21.33,30.89,57700,57724
3402,25,31,7,20.48,24.81,57723,57748
3403,23,35,4,22.26,40.11,57747,57770
3404,24,31,13,21.33,18.06,57769,57793
3405,24,31,3,21.33,49.47,57792,57816
3406,25,31,4,20.48,28.01,57815,57840
3407,25,28,4,20.48,28.25,57839,57864
3408,23,30,14,22.26,13.67,57863,57886
3409,25,31,5,20.48,37.21,57885,57910
3410,23,27,14,22.26,15.50,57909,57932
3411,23,35,5,22.26,44.71,57931,57954
3412,24,31,13,21.33,19.14,57953,57977
3413,24,27,6,21.33,28.81,57976,58000
3414,24,28,9,21.33,21.72,57999,58023
3415,24,27,6,21.33,23.47,58022,58046
3416,21,35,15,24.38,19.66,58046,58067
3417,25,31,1,20.48,40.81,58066,58091
3418,22,27,14,23.27,15.29,58090,58112
3419,23,31,13,22.26,12.02,58112,58135
3420,23,31,6,22.26,31.93,58134,58157
3421,24,35,2,21.33,60.22,58156,58180
3422,25,31,13,20.48,14.97,58179,58204
3423,22,31,12,23.27,23.29,58203,58225
3424,24,27,11,21.33,17.56,58224,58248
3425,24,27,12,21.33,12.31,58247,58271
3426,23,27,2,22.26,30.45,58270,58293
3427,23,31,8,22.26,44.54,58292,58315
3428,24,27,13,21.33,18.47,58314,58338
3429,23,31,6,22.26,28.80,58337,58360
3430,24,27,7,21.33,21.97,58359,58383
3431,24,27,3,21.33,30.97,58382,58406
3432,24,31,3,21.33,39.31,58405,58429
3433,23,31,10,22.26,19.06,58428,58451
3434,23,27,13,22.26,14.54,58450,58473
3435,23,31,1,22.26,30.45,58472,58495
3436,24,27,8,21.33,22.72,58494,58518
3437,22,31,17,23.27,15.83,58518,58540
3438,23,31,3,22.26,36.71,58539,58562
3439,23,31,9,22.26,22.80,58561,58584
3440,23,27,2,22.26,33.24,58583,58606
3441,24,27,8,21.33,23.97,58605,58629
3442,23,35,1,22.26,48.54,58628,58651
3443,22,31,15,23.27,18.38,58650,58672
3444,23,31,2,22.26,40.63,58671,58694
3445,24,27,8,21.33,20.31,58693,58717
3446,23,35,5,22.26,37.76,58716,58739
3447,24,27,14,21.33,12.72,58738,58762
3448,24,27,2,21.33,35.64,58761,58785
3449,24,31,8,21.33,31.81,58784,58808
3450,25,27,10,20.48,14.09,58807,58832
3451,26,35,1,19.69,50.14,58831,58857
3452,23,27,10,22.26,16.11,58856,58879
3453,24,27,3,21.33,23.81,58878,58902
3454,23,27,14,22.26,15.93,58901,58924
3455,23,31,13,22.26,23.41,58923,58946
3456,25,31,3,20.48,44.89,58945,58970
3457,25,27,6,20.48,24.33,58969,58994
3458,25,31,7,20.48,31.45,58993,59018
3459,23,31,2,22.26,33.67,59017,59040
3460,23,31,15,22.26,15.67,59039,59062
3461,26,27,2,19.69,41.60,59061,59087
3462,23,35,13,22.26,17.41,59086,59109
3463,23,31,10,22.26,28.89,59108,59131
3464,23,27,15,22.26,12.19,59130,59153
3465,25,27,10,20.48,17.13,59152,59177
3466,24,27,3,21.33,37.56,59176,59200
3467,24,31,7,21.33,27.47,59199,59223
3468,23,27,12,22.26,14.71,59222,59245
3469,25,35,1,20.48,41.77,59244,59269
3470,23,31,13,22.26,19.67,59268,59291
3471,24,27,3,21.33,35.64,59290,59314
3472,25,27,4,20.48,29.37,59313,59338
3473,23,27,13,22.26,15.15,59337,59360
3474,25,31,1,20.48,32.81,59359,59384
3475,24,27,9,21.33,18.97,59383,59407
3476,23,31,7,22.26,29.41,59406,59429
3477,23,27,13,22.26,15.67,59428,59451
3478,23,27,10,22.26,17.67,59450,59473
3479,23,31,8,22.26,28.19,59472,59495
3480,24,31,7,21.33,23.89,59494,59518
3481,23,31,7,22.26,34.45,59517,59540
3482,22,31,4,23.27,28.02,59539,59561
3483,22,31,9,23.27,19.74,59560,59582
3484,23,27,9,22.26,28.71,59581,59604
3485,23,31,10,22.26,28.80,59603,59626
3486,22,35,14,23.27,37.83,59625,59647
3487,22,35,12,23.27,27.65,59646,59668
3488,23,31,9,22.26,35.67,59667,59690
3489,22,31,18,23.27,11.65,59689,59711
3490,22,35,10,23.27,28.74,59711,59733
3491,23,31,1,22.26,38.28,59732,59755
3492,23,31,7,22.26,22.11,59754,59777
3493,24,31,6,21.33,21.97,59776,59800
3494,23,31,4,22.26,32.71,59799,59822
3495,22,35,14,23.27,23.29,59821,59843
3496,23,35,1,22.26,42.89,59842,59865
3497,23,31,3,22.26,34.98,59864,59887
3498,22,31,6,23.27,30.38,59886,59908
3499,23,31,13,22.26,17.32,59907,59930
3500,22,31,3,23.27,42.29,59929,59951
3501,23,31,3,22.26,29.41,59950,59973
3502,22,27,16,23.27,11.65,59972,59994
3503,22,31,7,23.27,28.47,59993,60015
3504,23,35,6,22.26,37.06,60014,60037
3505,23,27,9,22.26,18.11,60036,60059
3506,23,35,3,22.26,34.63,60058,60081
3507,22,31,4,23.27,29.47,60080,60102
3508,21,31,19,24.38,12.24,60101,60122
3509,23,31,3,22.26,44.71,60121,60144
3510,22,31,13,23.27,16.11,60143,60165
3511,23,27,14,22.26,12.11,60165,60188
3512,23,31,8,22.26,29.58,60187,60210
3513,24,31,7,21.33,22.56,60209,60233
3514,23,31,5,22.26,25.06,60232,60255
3515,23,35,11,22.26,25.24,60254,60277
3516,23,31,12,22.26,15.32,60276,60299
3517,23,31,10,22.26,17.24,60298,60321
3518,24,35,4,21.33,38.97,60320,60344
3519,22,31,13,23.27,17.56,60343,60365
3520,23,35,14,22.26,30.89,60364,60387
3521,25,27,5,20.48,23.85,60386,60411
3522,24,31,7,21.33,24.97,60410,60434
3523,22,31,8,23.27,31.65,60433,60455
3524,23,31,15,22.26,13.41,60454,60477
3525,24,27,4,21.33,21.31,60476,60500
3526,25,27,5,20.48,17.69,60499,60524
3527,23,27,6,22.26,28.71,60523,60546
3528,23,35,12,22.26,20.89,60545,60568
3529,24,35,2,21.33,49.31,60567,60591
3530,22,27,15,23.27,13.93,60590,60612
3531,24,31,8,21.33,30.89,60611,60635
3532,24,31,5,21.33,36.97,60634,60658
3533,23,31,7,22.26,22.11,60657,60680
3534,24,31,2,21.33,27.64,60679,60703
3535,23,31,2,22.26,33.58,60702,60725
3536,23,31,15,22.26,18.45,60724,60747
3537,23,31,7,22.26,24.19,60746,60769
3538,24,27,1,21.33,30.31,60768,60792
3539,23,35,2,22.26,56.89,60791,60814
3540,24,27,13,21.33,9.97,60813,60837
3541,24,27,1,21.33,37.56,60836,60860
3542,24,27,13,21.33,13.64,60859,60883
3543,24,35,2,21.33,35.64,60882,60906
3544,24,31,5,21.33,32.22,60905,60929
3545,23,27,6,22.26,26.54,60928,60951
3546,23,27,17,22.26,11.15,60950,60973
3547,24,31,3,21.33,34.56,60972,60996
3548,23,27,16,22.26,8.71,60995,61018
3549,24,31,2,21.33,34.31,61017,61041
3550,26,27,11,19.69,16.98,61040,61066
3551,24,27,11,21.33,14.56,61066,61090
3552,24,31,8,21.33,20.14,61089,61113
3553,25,27,3,20.48,24.57,61112,61137
3554,25,27,1,20.48,23.93,61136,61161
3555,24,31,2,21.33,31.47,61160,61184
3556,23,31,12,22.26,19.50,61183,61206
3557,23,31,11,22.26,18.98,61205,61228
3558,25,31,1,20.48,28.09,61227,61252
3559,23,31,10,22.26,20.02,61252,61275
3560,24,31,5,21.33,26.22,61274,61298
3561,25,27,1,20.48,29.05,61297,61322
3562,23,27,18,22.26,9.58,61321,61344
3563,23,27,14,22.26,12.71,61344,61367
3564,24,27,9,21.33,20.81,61366,61390
3565,24,27,6,21.33,21.97,61389,61413
3566,26,27,7,19.69,24.91,61412,61438
3567,24,31,7,21.33,25.64,61437,61461
3568,24,31,10,21.33,18.72,61461,61485
3569,25,27,1,20.48,25.69,61484,61509
3570,24,27,2,21.33,35.97,61508,61532
3571,23,31,8,22.26,20.54,61531,61554
3572,25,27,11,20.48,21.61,61553,61578
3573,25,31,11,20.48,19.13,61577,61602
3574,25,31,7,20.48,32.25,61601,61626
3575,26,27,9,19.69,27.83,61625,61651
3576,23,31,16,22.26,16.28,61650,61673
3577,23,31,12,22.26,22.98,61673,61696
3578,25,27,7,20.48,12.73,61695,61720
3579,25,27,2,20.48,30.65,61719,61744
3580,26,27,1,19.69,37.98,61743,61769
3581,26,27,9,19.69,19.21,61768,61794
3582,25,31,1,20.48,37.69,61793,61818
3583,24,31,3,21.33,39.97,61817,61841
3584,26,27,10,19.69,22.75,61840,61866
3585,25,31,10,20.48,29.37,61865,61890
3586,26,27,3,19.69,36.14,61889,61915
3587,25,27,2,20.48,28.97,61914,61939
3588,24,35,12,21.33,25.64,61938,61962
3589,26,27,3,19.69,27.44,61961,61987
3590,24,27,14,21.33,17.89,61986,62010
3591,24,35,4,21.33,44.06,62009,62033
3592,24,35,11,21.33,40.89,62032,62056
3593,26,31,7,19.69,30.44,62055,62081
3594,24,31,12,21.33,20.31,62080,62104
3595,25,27,10,20.48,19.37,62103,62128
3596,26,31,7,19.69,26.37,62127,62153
3597,25,27,6,20.48,30.41,62152,62177
3598,25,31,6,20.48,24.25,62176,62201
3599,26,31,4,19.69,32.44,62200,62226
3600,24,27,7,21.33,21.31,62225,62249
3601,26,27,9,19.69,18.75,62248,62274
3602,26,27,4,19.69,41.60,62273,62299
3603,24,31,1,21.33,33.22,62298,62322
3604,25,31,2,20.48,37.61,62321,62346
3605,23,27,13,22.26,14.28,62345,62368
3606,25,31,13,20.48,20.97,62368,62393
3607,25,27,7,20.48,19.37,62393,62418
3608,26,27,10,19.69,20.29,62417,62443
3609,24,27,9,21.33,25.31,62442,62466
3610,25,27,11,20.48,25.29,62465,62490
3611,25,27,5,20.48,24.25,62489,62514
3612,25,27,10,20.48,20.97,62513,62538
3613,25,27,4,20.48,20.57,62537,62562
3614,24,31,2,21.33,31.14,62561,62585
3615,26,27,5,19.69,24.98,62584,62610
3616,26,27,4,19.69,23.21,62609,62635
3617,25,31,5,20.48,25.69,62634,62659
3618,24,27,14,21.33,12.47,62658,62682
3619,26,27,3,19.69,25.60,62681,62707
3620,25,31,6,20.48,26.01,62706,62731
3621,24,29,11,21.33,19.89,62730,62754
3622,25,31,6,20.48,25.61,62753,62778
3623,26,27,3,19.69,27.37,62777,62803
3624,25,27,10,20.48,18.89,62802,62827
3625,25,27,8,20.48,19.85,62826,62851
3626,26,31,1,19.69,32.21,62850,62876
3627,26,31,4,19.69,36.60,62875,62901
3628,25,27,9,20.48,15.37,62900,62925
3629,25,31,13,20.48,17.61,62924,62949
3630,24,31,9,21.33,23.97,62948,62972
3631,25,27,7,20.48,18.81,62971,62996
3632,26,27,2,19.69,29.29,62995,63021
3633,25,27,11,20.48,17.61,63020,63045
3634,26,27,6,19.69,24.67,63044,63070
3635,25,27,11,20.48,19.21,63069,63094
3636,27,27,3,18.96,31.44,63093,63120
3637,26,27,4,19.69,29.91,63119,63145
3638,25,27,10,20.48,17.21,63144,63169
3639,24,31,4,21.33,30.81,63168,63192
3640,24,31,6,21.33,24.47,63191,63215
3641,27,27,2,18.96,33.67,63214,63241
3642,26,27,13,19.69,12.75,63240,63266
3643,24,27,5,21.33,19.81,63265,63289
3644,25,31,4,20.48,27.61,63288,63313
3645,25,23,12,20.48,9.45,63313,63338
3646,23,31,7,22.26,24.71,63337,63360
3647,25,31,3,20.48,28.41,63359,63384
3648,26,27,4,19.69,22.06,63383,63409
3649,24,35,8,21.33,38.64,63408,63432
3650,25,31,15,20.48,10.97,63431,63456
3651,26,27,6,19.69,25.14,63455,63481
3652,23,31,12,22.26,19.41,63480,63503
3653,23,31,5,22.26,33.24,63502,63525
3654,23,31,12,22.26,25.06,63525,63548
3655,25,31,7,20.48,19.13,63547,63572
3656,25,31,1,20.48,30.81,63571,63596
3657,25,31,4,20.48,29.21,63595,63620
3658,25,27,8,20.48,15.53,63619,63644
3659,23,31,2,22.26,41.93,63643,63666
3660,25,31,11,20.48,20.33,63665,63690
3661,24,31,10,21.33,23.97,63689,63713
3662,24,27,9,21.33,13.56,63712,63736
3663,26,31,2,19.69,36.52,63735,63761
3664,25,27,2,20.48,22.33,63760,63785
3665,25,27,5,20.48,19.61,63784,63809
3666,24,27,12,21.33,12.97,63808,63832
3667,25,27,11,20.48,11.29,63831,63856
3668,25,27,3,20.48,22.49,63855,63880
3669,24,27,3,21.33,26.56,63879,63903
3670,25,27,5,20.48,20.09,63903,63928
3671,23,31,3,22.26,27.32,63927,63950
3672,25,27,11,20.48,12.57,63949,63974
3673,27,23,7,18.96,13.52,63973,64000
3674,26,27,5,19.69,20.83,63999,64025
3675,25,27,8,20.48,14.57,64024,64049
3676,26,31,4,19.69,25.60,64048,64074
3677,27,27,10,18.96,11.00,64073,64100
3678,26,31,1,19.69,32.21,64099,64125
3679,24,35,3,21.33,34.81,64124,64148
3680,23,31,15,22.26,16.80,64147,64170
3681,24,31,1,21.33,36.97,64169,64193
3682,24,31,2,21.33,36.31,64192,64216
3683,23,35,11,22.26,25.93,64215,64238
3684,25,31,5,20.48,28.57,64237,64262
3685,24,31,13,21.33,33.06,64261,64285
3686,24,31,3,21.33,38.81,64284,64308
3687,24,27,13,21.33,11.81,64307,64331
3688,24,31,8,21.33,24.31,64330,64354
3689,25,27,8,20.48,23.45,64353,64378
3690,24,31,10,21.33,26.56,64377,64401
3691,25,35,5,20.48,32.01,64400,64425
3692,26,27,7,19.69,26.67,64424,64450
3693,24,31,16,21.33,11.64,64449,64473
3694,25,31,2,20.48,39.29,64472,64497
3695,24,31,13,21.33,17.81,64496,64520
3696,25,31,6,20.48,26.25,64519,64544
3697,26,27,4,19.69,28.37,64543,64569
3698,25,27,10,20.48,16.01,64568,64593
3699,24,27,1,21.33,28.89,64592,64616
3700,25,27,6,20.48,14.97,64615,64640
3701,25,31,2,20.48,30.01,64639,64664
3702,26,27,5,19.69,23.52,64663,64689
3703,26,31,2,19.69,24.60,64688,64714
3704,25,27,15,20.48,11.77,64713,64738
3705,24,31,1,21.33,36.22,64737,64761
3706,24,27,10,21.33,14.14,64760,64784
3707,26,27,1,19.69,26.14,64783,64809
3708,25,27,8,20.48,17.45,64808,64833
3709,25,27,4,20.48,27.61,64832,64857
3710,26,27,1,19.69,21.21,64856,64882
3711,25,27,15,20.48,9.21,64881,64906
3712,28,27,4,18.29,22.42,64905,64933
3713,22,35,10,23.27,33.93,64932,64954
3714,22,35,11,23.27,27.74,64953,64975
3715,21,39,13,24.38,31.95,64974,64995
3716,22,31,10,23.27,28.38,64994,65016
3717,22,31,5,23.27,32.02,65015,65037
3718,22,31,3,23.27,37.65,65036,65058
3719,22,32,14,23.27,22.47,65057,65079
3720,23,31,5,22.26,29.67,65078,65101
3721,23,31,4,22.26,28.45,65100,65123
3722,22,31,7,23.27,27.83,65122,65144
3723,22,31,16,23.27,12.56,65143,65165
3724,22,28,19,23.27,12.38,65165,65187
3725,24,31,7,21.33,28.81,65186,65210
3726,23,27,14,22.26,20.89,65209,65232
3727,22,27,7,23.27,18.20,65231,65253
3728,20,35,13,25.60,20.04,65253,65273
3729,22,31,10,23.27,31.29,65272,65294
3730,24,28,1,21.33,42.56,65293,65317
3731,21,31,15,24.38,15.28,65316,65337
3732,22,36,8,23.27,29.93,65336,65358
3733,22,31,11,23.27,28.02,65357,65379
3734,23,31,3,22.26,33.41,65378,65401
3735,23,31,6,22.26,35.06,65400,65423
3736,22,35,1,23.27,45.93,65422,65444
3737,22,31,12,23.27,20.83,65443,65465
3738,22,31,6,23.27,37.83,65464,65486
3739,23,27,14,22.26,17.41,65485,65508
3740,23,31,1,22.26,42.63,65507,65530
3741,23,31,2,22.26,34.71,65529,65552
3742,21,39,15,24.38,21.95,65551,65572
3743,22,35,1,23.27,51.65,65571,65593
3744,22,31,3,23.27,37.83,65592,65614
3745,22,31,5,23.27,38.47,65613,65635
3746,21,31,8,24.38,26.81,65634,65655
3747,22,31,13,23.27,20.20,65654,65676
3748,22,35,6,23.27,28.56,65676,65698
3749,23,32,9,22.26,31.50,65697,65720
3750,21,27,14,24.38,11.95,65719,65740
3751,23,31,3,22.26,49.76,65739,65762
3752,23,31,13,22.26,24.63,65761,65784
3753,23,28,7,22.26,27.24,65783,65806
3754,22,35,2,23.27,56.56,65805,65827
3755,22,31,15,23.27,19.29,65826,65848
3756,23,31,8,22.26,27.93,65847,65870
3757,24,27,5,21.33,32.06,65869,65893
3758,21,31,18,24.38,19.66,65892,65913
3759,21,31,13,24.38,20.43,65913,65934
3760,22,36,6,23.27,47.56,65933,65955
3761,21,35,4,24.38,67.85,65954,65975
3762,22,35,8,23.27,30.38,65974,65996
3763,22,31,10,23.27,34.20,65995,66017
3764,22,31,3,23.27,32.02,66016,66038
3765,23,31,12,22.26,27.67,66037,66060
3766,23,28,11,22.26,17.84,66059,66082
3767,21,31,11,24.38,35.09,66081,66102
3768,22,31,8,23.27,32.56,66102,66124
3769,21,35,2,24.38,47.76,66123,66144
3770,23,29,9,22.26,22.28,66143,66166
3771,21,34,17,24.38,23.38,66165,66186
3772,22,31,6,23.27,33.74,66185,66207
3773,24,27,1,21.33,34.56,66206,66230
3774,23,27,9,22.26,18.11,66229,66252
3775,21,31,16,24.38,18.43,66251,66272
3776,22,31,3,23.27,41.65,66271,66293
3777,23,35,8,22.26,31.58,66292,66315
3778,22,31,4,23.27,36.83,66314,66336
3779,21,35,13,24.38,24.05,66335,66356
3780,23,31,3,22.26,41.67,66355,66378
3781,24,31,2,21.33,46.22,66377,66401
3782,23,31,12,22.26,20.80,66400,66423
3783,24,27,8,21.33,22.14,66422,66446
3784,22,31,14,23.27,19.02,66445,66467
3785,23,31,8,22.26,21.67,66466,66489
3786,22,31,6,23.27,31.47,66488,66510
3787,23,31,5,22.26,31.76,66509,66532
3788,23,31,1,22.26,37.32,66531,66554
3789,22,31,5,23.27,31.83,66553,66575
3790,22,35,2,23.27,40.02,66574,66596
3791,22,31,4,23.27,36.74,66595,66617
3792,23,31,2,22.26,39.06,66616,66639
3793,22,34,8,23.27,34.47,66638,66660
3794,22,35,10,23.27,31.83,66659,66681
3795,23,31,13,22.26,30.63,66680,66703
3796,23,31,8,22.26,20.11,66702,66725
3797,24,31,3,21.33,41.22,66724,66748
3798,24,35,8,21.33,33.56,66747,66771
3799,22,31,8,23.27,29.56,66770,66792
3800,24,31,10,21.33,27.06,66791,66815
3801,23,31,12,22.26,24.37,66814,66837
3802,24,31,11,21.33,26.22,66836,66860
3803,23,35,6,22.26,39.24,66859,66882
3804,24,31,3,21.33,26.31,66881,66905
3805,22,31,10,23.27,25.02,66904,66926
3806,22,31,9,23.27,34.65,66925,66947
3807,22,34,1,23.27,57.65,66946,66968
3808,23,31,2,22.26,44.54,66967,66990
3809,23,35,7,22.26,30.54,66989,67012
3810,22,31,13,23.27,19.56,67011,67033
3811,23,31,6,22.26,30.11,67032,67055
3812,23,28,13,22.26,12.89,67054,67077
3813,22,31,3,23.27,50.29,67076,67098
3814,23,31,5,22.26,28.28,67097,67120
3815,24,27,13,21.33,19.56,67119,67143
3816,23,31,5,22.26,42.37,67142,67165
3817,23,35,13,22.26,16.11,67164,67187
3818,24,35,2,21.33,40.31,67186,67210
3819,24,27,6,21.33,25.89,67209,67233
3820,23,27,4,22.26,27.15,67232,67255
3821,23,27,10,22.26,19.41,67254,67277
3822,22,35,2,23.27,45.83,67276,67298
3823,22,27,6,23.27,25.65,67297,67319
3824,20,35,19,25.60,13.54,67318,67338
3825,23,30,5,22.26,31.06,67337,67360
3826,22,35,4,23.27,44.02,67359,67381
3827,22,35,2,23.27,41.93,67380,67402
3828,21,31,17,24.38,13.38,67401,67422
3829,23,31,11,22.26,36.45,67421,67444
3830,21,31,12,24.38,21.66,67443,67464
3831,23,31,10,22.26,17.24,67463,67486
3832,22,35,8,23.27,33.93,67485,67507
3833,23,31,6,22.26,34.37,67506,67529
3834,22,31,17,23.27,11.02,67528,67550
3835,23,31,7,22.26,26.28,67549,67572
3836,22,27,9,23.27,23.56,67571,67593
3837,23,31,9,22.26,29.67,67592,67615
3838,23,31,5,22.26,28.89,67614,67637
3839,24,27,4,21.33,37.47,67636,67660
3840,23,31,13,22.26,23.41,67659,67682
3841,22,31,11,23.27,18.29,67681,67703
3842,23,31,6,22.26,34.02,67702,67725
3843,23,31,11,22.26,27.41,67724,67747
3844,23,31,11,22.26,31.93,67746,67769
3845,23,27,12,22.26,20.98,67768,67791
3846,21,31,5,24.38,28.81,67790,67811
3847,22,35,5,23.27,38.20,67810,67832
3848,24,30,2,21.33,36.89,67831,67855
3849,23,31,3,22.26,48.98,67854,67877
3850,22,31,14,23.27,19.65,67876,67898
3851,22,32,5,23.27,28.02,67897,67919
3852,24,31,6,21.33,29.06,67918,67942
3853,23,27,6,22.26,32.71,67941,67964
3854,21,39,2,24.38,48.33,67963,67984
3855,22,31,19,23.27,13.29,67983,68005
3856,23,31,1,22.26,42.54,68004,68027
3857,23,35,3,22.26,44.98,68026,68049
3858,22,31,9,23.27,24.11,68048,68070
3859,22,32,12,23.27,32.02,68069,68091
3860,23,31,12,22.26,24.45,68090,68113
3861,22,35,13,23.27,35.38,68112,68134
3862,23,31,7,22.26,29.15,68133,68156
3863,23,35,12,22.26,26.45,68155,68178
3864,24,30,3,21.33,33.97,68178,68202
3865,22,35,13,23.27,20.20,68201,68223
3866,23,31,8,22.26,28.19,68222,68245
3867,23,31,12,22.26,18.89,68244,68267
3868,23,31,5,22.26,30.37,68266,68289
3869,23,27,11,22.26,17.41,68288,68311
3870,22,31,3,23.27,39.29,68310,68332
3871,23,27,9,22.26,22.37,68331,68354
3872,24,31,3,21.33,35.89,68353,68377
3873,22,31,12,23.27,21.38,68376,68398
3874,24,31,4,21.33,34.64,68397,68421
3875,21,31,15,24.38,19.47,68420,68441
3876,24,27,2,21.33,33.56,68440,68464
3877,22,31,10,23.27,21.74,68463,68485
3878,26,27,4,19.69,30.06,68484,68510
3879,22,31,2,23.27,34.20,68509,68531
3880,23,35,5,22.26,48.28,68530,68553
3881,21,31,16,24.38,15.38,68552,68573
3882,23,31,2,22.26,46.19,68572,68595
3883,23,27,14,22.26,13.84,68594,68617
3884,24,31,6,21.33,37.97,68616,68640
3885,22,35,15,23.27,20.65,68639,68661
3886,24,31,3,21.33,42.89,68660,68684
3887,21,32,11,24.38,26.05,68683,68704
3888,24,28,3,21.33,32.47,68703,68727
3889,22,39,12,23.27,31.93,68726,68748
3890,23,31,1,22.26,42.28,68747,68770
3891,24,31,2,21.33,39.81,68769,68793
3892,23,27,10,22.26,21.67,68792,68815
3893,22,31,13,23.27,27.83,68814,68836
3894,23,31,6,22.26,41.32,68835,68858
3895,22,31,14,23.27,16.11,68857,68879
3896,23,31,9,22.26,28.11,68878,68901
3897,23,35,2,22.26,46.98,68900,68923
3898,20,35,19,25.60,28.34,68922,68942
3899,22,35,3,23.27,42.02,68941,68963
3900,23,27,10,22.26,21.41,68962,68985
3901,22,31,12,23.27,30.47,68984,69006
3902,22,31,6,23.27,47.93,69005,69027
3903,20,35,19,25.60,19.24,69026,69046
3904,22,31,6,23.27,31.38,69045,69067
3905,23,28,11,22.26,19.50,69066,69089
3906,23,31,13,22.26,14.71,69088,69111
3907,22,31,5,23.27,29.47,69110,69132
3908,23,31,1,22.26,55.15,69131,69154
3909,22,39,3,23.27,41.11,69153,69175
3910,23,31,13,22.26,23.67,69174,69197
3911,23,31,10,22.26,16.45,69196,69219
3912,22,31,5,23.27,30.65,69218,69240
3913,23,31,6,22.26,37.41,69239,69262
3914,22,31,5,23.27,26.74,69261,69283
3915,23,28,5,22.26,31.84,69282,69305
3916,23,31,11,22.26,26.89,69304,69327
3917,24,31,7,21.33,25.47,69326,69350
3918,22,31,4,23.27,30.74,69349,69371
3919,23,28,8,22.26,27.06,69370,69393
3920,22,31,13,23.27,21.93,69392,69414
3921,22,31,8,23.27,30.29,69413,69435
3922,23,31,4,22.26,31.50,69434,69457
3923,24,27,4,21.33,32.14,69456,69480
3924,24,31,6,21.33,21.72,69479,69503
3925,22,31,17,23.27,13.20,69502,69524
3926,24,35,1,21.33,43.22,69523,69547
3927,22,31,9,23.27,24.11,69546,69568
3928,22,35,9,23.27,33.65,69567,69589
3929,23,31,9,22.26,36.98,69588,69611
3930,22,35,10,23.27,21.47,69610,69632
3931,23,32,11,22.26,29.84,69631,69654
3932,23,31,12,22.26,21.32,69653,69676
3933,23,31,9,22.26,34.19,69675,69698
3934,21,32,13,24.38,23.66,69697,69718
3935,23,31,3,22.26,42.54,69717,69740
3936,22,31,12,23.27,21.83,69739,69761
3937,23,27,4,22.26,35.76,69760,69783
3938,22,35,8,23.27,31.74,69782,69804
3939,23,31,14,22.26,18.71,69803,69826
3940,24,31,2,21.33,40.39,69825,69849
3941,24,31,7,21.33,34.56,69848,69872
3942,24,28,13,21.33,23.56,69871,69895
3943,24,35,1,21.33,63.89,69894,69918
3944,23,31,7,22.26,32.63,69917,69940
3945,22,31,12,23.27,19.29,69939,69961
3946,22,31,11,23.27,19.29,69961,69983
3947,24,27,6,21.33,27.72,69982,70006
3948,23,31,14,22.26,14.02,70005,70028
3949,22,35,9,23.27,31.20,70027,70049
3950,24,31,1,21.33,43.22,70048,70072
3951,23,31,9,22.26,30.45,70071,70094
3952,22,31,2,23.27,43.74,70093,70115
3953,21,31,16,24.38,14.81,70114,70135
3954,22,31,3,23.27,33.11,70134,70156
3955,23,32,4,22.26,38.71,70155,70178
3956,21,31,15,24.38,18.71,70177,70198
3957,22,35,3,23.27,54.20,70197,70219
3958,24,31,5,21.33,28.72,70218,70242
3959,22,31,14,23.27,21.93,70241,70263
3960,24,27,6,21.33,24.31,70262,70286
3961,22,35,14,23.27,22.74,70285,70307
3962,24,35,3,21.33,55.22,70306,70330
3963,24,27,11,21.33,18.97,70329,70353
3964,22,35,7,23.27,29.93,70352,70374
3965,23,31,12,22.26,24.02,70373,70396
3966,23,31,3,22.26,24.89,70395,70418
3967,22,31,5,23.27,28.93,70417,70439
3968,22,35,1,23.27,45.83,70438,70460
3969,23,31,3,22.26,32.54,70459,70482
3970,22,31,10,23.27,24.11,70481,70503
3971,22,31,2,23.27,34.02,70502,70524
3972,24,35,1,21.33,51.97,70523,70547
3973,21,35,14,24.38,18.81,70546,70567
3974,24,31,5,21.33,38.39,70566,70590
3975,21,31,12,24.38,15.47,70589,70610
3976,24,31,9,21.33,28.72,70609,70633
3977,24,31,11,21.33,32.22,70632,70656
3978,21,31,8,24.38,24.14,70655,70676
3979,24,31,7,21.33,36.47,70675,70699
3980,24,27,15,21.33,9.97,70698,70722
3981,23,31,1,22.26,44.11,70721,70744
3982,22,31,13,23.27,19.02,70743,70765
3983,23,31,13,22.26,20.45,70765,70788
3984,23,31,2,22.26,38.80,70787,70810
3985,22,36,8,23.27,26.65,70809,70831
3986,23,31,5,22.26,27.50,70830,70853
3987,23,31,3,22.26,34.11,70852,70875
3988,21,31,14,24.38,19.19,70874,70895
3989,23,35,1,22.26,45.06,70894,70917
3990,24,32,6,21.33,38.14,70916,70940
3991,24,27,7,21.33,27.47,70939,70963
3992,22,31,12,23.27,23.65,70962,70984
3993,22,35,1,23.27,48.83,70983,71005
3994,23,31,13,22.26,22.80,71004,71027
3995,23,27,1,22.26,34.80,71026,71049
3996,24,31,2,21.33,49.81,71048,71072
3997,23,31,13,22.26,16.02,71071,71094
3998,21,28,17,24.38,7.95,71094,71115
3999,23,27,4,22.26,38.28,71114,71137
4000,22,31,14,23.27,22.38,71136,71158
4001,23,27,4,22.26,36.80,71157,71180
4002,22,43,13,23.27,32.56,71179,71201
4003,22,31,4,23.27,28.20,71200,71222
4004,22,31,11,23.27,20.74,71222,71244
4005,23,31,3,22.26,27.32,71243,71266
4006,23,27,9,22.26,20.54,71265,71288
4007,22,31,14,23.27,23.29,71287,71309
4008,23,31,13,22.26,21.41,71308,71331
4009,22,31,10,23.27,21.11,71330,71352
4010,24,31,1,21.33,37.97,71351,71375
4011,23,31,5,22.26,34.89,71374,71397
4012,22,35,5,23.27,37.93,71396,71418
4013,23,31,3,22.26,45.41,71417,71440
4014,22,31,16,23.27,12.47,71439,71461
4015,23,27,7,22.26,26.80,71460,71483
4016,23,31,6,22.26,37.50,71482,71505
4017,23,27,8,22.26,18.71,71504,71527
4018,23,27,1,22.26,37.24,71526,71549
4019,22,27,13,23.27,11.83,71549,71571
4020,23,31,4,22.26,34.63,71570,71593
4021,22,31,10,23.27,23.38,71592,71614
4022,22,31,12,23.27,23.74,71613,71635
4023,22,35,11,23.27,19.74,71634,71656
4024,23,31,2,22.26,45.15,71655,71678
4025,22,39,13,23.27,27.74,71677,71699
4026,23,31,8,22.26,38.89,71698,71721
4027,22,35,10,23.27,26.38,71720,71742
4028,24,31,4,21.33,36.97,71741,71765
4029,23,31,8,22.26,27.50,71764,71787
4030,22,31,13,23.27,21.11,71786,71808
4031,23,31,7,22.26,33.06,71807,71830
4032,22,27,8,23.27,20.38,71829,71851
4033,23,35,8,22.26,30.98,71850,71873
4034,22,31,5,23.27,33.02,71872,71894
4035,23,39,10,22.26,41.41,71893,71916
4036,21,31,7,24.38,30.24,71915,71936
4037,23,27,5,22.26,39.06,71935,71958
4038,23,31,14,22.26,16.89,71957,71980
4039,23,31,4,22.26,34.71,71979,72002
4040,24,27,1,21.33,36.64,72001,72025
4041,23,28,14,22.26,10.11,72024,72047
4042,23,31,12,22.26,22.28,72047,72070
4043,24,32,5,21.33,34.97,72069,72093
4044,22,31,10,23.27,27.56,72092,72114
4045,23,31,1,22.26,36.89,72113,72136
4046,22,35,8,23.27,36.29,72135,72157
4047,23,35,6,22.26,39.06,72156,72179
4048,25,27,8,20.48,20.65,72178,72203
4049,22,27,15,23.27,8.83,72202,72224
4050,24,27,10,21.33,23.22,72223,72247
4051,24,31,7,21.33,21.81,72246,72270
4052,24,31,3,21.33,45.31,72269,72293
4053,23,31,8,22.26,25.32,72292,72315
4054,22,31,13,23.27,20.93,72314,72336
4055,23,27,3,22.26,46.11,72335,72358
4056,23,31,13,22.26,26.19,72357,72380
4057,23,31,5,22.26,33.06,72379,72402
4058,24,31,13,21.33,20.89,72401,72425
4059,22,35,8,23.27,30.93,72424,72446
4060,23,34,1,22.26,54.45,72445,72468
4061,21,35,14,24.38,19.57,72467,72488
4062,23,31,3,22.26,36.19,72487,72510
4063,23,31,2,22.26,30.19,72509,72532
4064,21,34,15,24.38,16.24,72531,72552
4065,23,32,1,22.26,43.76,72551,72574
4066,23,31,6,22.26,27.41,72573,72596
4067,22,35,4,23.27,46.38,72595,72617
4068,23,27,14,22.26,15.24,72616,72639
4069,23,34,1,22.26,40.89,72639,72662
4070,23,31,14,22.26,18.37,72661,72684
4071,22,31,8,23.27,25.74,72683,72705
4072,23,27,2,22.26,33.24,72704,72727
4073,23,35,7,22.26,35.84,72726,72749
4074,24,31,5,21.33,27.97,72748,72772
4075,24,27,9,21.33,23.22,72771,72795
4076,22,31,8,23.27,31.29,72794,72816
4077,24,31,13,21.33,19.14,72815,72839
4078,22,31,12,23.27,24.83,72838,72860
4079,24,28,1,21.33,36.31,72859,72883
4080,22,28,17,23.27,10.02,72882,72904
4081,24,31,8,21.33,28.81,72903,72927
4082,23,31,2,22.26,44.89,72926,72949
4083,22,31,4,23.27,26.11,72948,72970
4084,21,35,9,24.38,31.57,72969,72990
4085,24,27,10,21.33,26.06,72989,73013
4086,23,31,4,22.26,33.67,73012,73035
4087,23,31,8,22.26,27.67,73034,73057
4088,21,31,19,24.38,14.14,73056,73077
4089,23,31,4,22.26,37.50,73076,73099
4090,23,31,10,22.26,29.58,73098,73121
4091,21,31,17,24.38,16.71,73120,73141
4092,23,31,5,22.26,27.50,73140,73163
4093,22,39,9,23.27,30.02,73162,73184
4094,23,31,8,22.26,29.67,73183,73206
4095,23,31,7,22.26,26.28,73205,73228
4096,23,27,11,22.26,18.63,73227,73250
4097,22,31,6,23.27,44.11,73249,73271
4098,23,27,14,22.26,12.98,73270,73293
4099,23,31,3,22.26,37.50,73292,73315
4100,22,31,16,23.27,17.38,73314,73336
4101,22,35,9,23.27,35.74,73335,73357
4102,23,31,2,22.26,45.76,73356,73379
4103,23,31,9,22.26,16.28,73378,73401
4104,22,31,18,23.27,11.74,73400,73422
4105,25,31,3,20.48,30.01,73421,73446
4106,23,31,6,22.26,36.45,73445,73468
4107,24,27,7,21.33,18.89,73467,73491
4108,24,27,9,21.33,20.64,73490,73514
4109,24,27,12,21.33,14.31,73513,73537
4110,22,27,15,23.27,11.02,73536,73558
4111,24,35,6,21.33,44.81,73557,73581
4112,22,35,15,23.27,19.02,73580,73602
4113,24,31,5,21.33,39.64,73601,73625
4114,23,31,10,22.26,21.24,73624,73647
4115,24,31,13,21.33,23.39,73646,73670
4116,25,30,7,20.48,32.25,73669,73694
4117,23,31,10,22.26,25.24,73693,73716
4118,23,31,9,22.26,23.84,73715,73738
4119,24,31,5,21.33,37.72,73737,73761
4120,21,31,19,24.38,13.57,73760,73781
4121,24,31,9,21.33,27.72,73780,73804
4122,25,27,9,20.48,21.21,73803,73828
4123,24,28,3,21.33,34.22,73827,73851
4124,21,31,18,24.38,11.19,73850,73871
4125,22,35,5,23.27,39.29,73870,73892
4126,23,35,5,22.26,41.50,73891,73914
4127,23,30,13,22.26,18.19,73913,73936
4128,24,27,1,21.33,31.81,73936,73960
4129,24,27,10,21.33,23.06,73959,73983
4130,24,31,2,21.33,37.72,73982,74006
4131,24,35,1,21.33,44.64,74005,74029
4132,23,31,4,22.26,28.63,74028,74051
4133,23,35,10,22.26,24.28,74050,74073
4134,23,31,5,22.26,42.71,74072,74095
4135,22,31,16,23.27,19.02,74094,74116
4136,25,27,5,20.48,31.53,74115,74140
4137,24,27,10,21.33,25.39,74139,74163
4138,24,31,2,21.33,42.06,74162,74186
4139,24,31,3,21.33,41.47,74185,74209
4140,22,31,12,23.27,27.02,74208,74230
4141,22,35,12,23.27,26.74,74229,74251
4142,22,31,8,23.27,24.93,74251,74273
4143,21,31,14,24.38,21.95,74272,74293
4144,23,27,2,22.26,30.19,74292,74315
4145,22,31,14,23.27,21.02,74314,74336
4146,24,31,5,21.33,29.39,74335,74359
4147,24,27,5,21.33,33.31,74358,74382
4148,25,27,1,20.48,43.53,74381,74406
4149,24,28,13,21.33,17.64,74405,74429
4150,24,31,6,21.33,24.64,74428,74452
4151,24,31,6,21.33,27.64,74451,74475
4152,22,31,12,23.27,21.93,74474,74496
4153,24,31,8,21.33,23.31,74495,74519
4154,24,31,1,21.33,48.97,74518,74542
4155,25,27,2,20.48,28.81,74541,74566
4156,21,27,17,24.38,10.71,74565,74586
4157,23,35,10,22.26,25.93,74585,74608
4158,23,31,7,22.26,40.98,74607,74630
4159,23,27,13,22.26,10.71,74629,74652
4160,23,31,5,22.26,29.93,74651,74674
4161,23,31,7,22.26,26.28,74673,74696
4162,22,31,16,23.27,18.83,74695,74717
4163,23,27,13,22.26,19.58,74717,74740
4164,24,27,3,21.33,24.97,74739,74763
4165,22,31,11,23.27,31.38,74763,74785
4166,23,32,11,22.26,30.02,74784,74807
4167,24,31,3,21.33,34.64,74806,74830
4168,23,28,13,22.26,16.98,74829,74852
4169,23,27,8,22.26,24.54,74851,74874
4170,23,31,6,22.26,35.58,74873,74896
4171,24,35,10,21.33,28.81,74895,74919
4172,22,31,3,23.27,32.11,74918,74940
4173,23,31,13,22.26,18.19,74939,74962
4174,23,27,6,22.26,24.89,74961,74984
4175,22,35,2,23.27,38.93,74983,75005
4176,24,31,2,21.33,34.64,75004,75028
4177,23,39,7,22.26,47.06,75027,75050
4178,24,27,9,21.33,20.56,75049,75073
4179,24,31,6,21.33,33.31,75072,75096
4180,22,31,7,23.27,23.38,75095,75117
4181,21,31,3,24.38,32.43,75116,75137
4182,22,31,19,23.27,7.65,75136,75158
4183,24,31,3,21.33,40.81,75157,75181
4184,24,35,5,21.33,34.97,75180,75204
4185,23,31,10,22.26,20.11,75203,75226
4186,23,31,13,22.26,28.28,75225,75248
4187,23,31,11,22.26,26.71,75247,75270
4188,23,27,14,22.26,15.41,75269,75292
4189,25,31,3,20.48,32.73,75291,75316
4190,23,35,3,22.26,56.45,75315,75338
4191,24,30,2,21.33,38.89,75337,75361
4192,24,28,13,21.33,17.56,75360,75384
4193,23,31,4,22.26,32.71,75383,75406
4194,21,35,12,24.38,38.43,75405,75426
4195,23,31,2,22.26,38.89,75425,75448
4196,25,27,11,20.48,20.89,75447,75472
4197,24,31,5,21.33,40.14,75471,75495
4198,23,31,3,22.26,27.67,75494,75517
4199,21,35,7,24.38,35.47,75516,75537
4200,24,31,6,21.33,28.56,75536,75560
4201,22,31,8,23.27,29.02,75559,75581
4202,22,31,19,23.27,8.83,75580,75602
4203,23,31,6,22.26,27.76,75601,75624
4204,25,28,2,20.48,41.53,75623,75648
4205,23,31,6,22.26,32.80,75647,75670
4206,23,31,13,22.26,20.54,75669,75692
4207,22,31,9,23.27,29.65,75691,75713
4208,23,31,10,22.26,18.45,75712,75735
4209,24,31,3,21.33,47.64,75734,75758
4210,22,31,13,23.27,27.11,75757,75779
4211,24,31,5,21.33,43.31,75778,75802
4212,23,31,13,22.26,20.98,75801,75824
4213,25,27,6,20.48,31.53,75823,75848
4214,23,27,15,22.26,13.84,75847,75870
4215,23,31,6,22.26,35.76,75869,75892
4216,23,31,13,22.26,20.11,75891,75914
4217,21,35,3,24.38,47.00,75913,75934
4218,24,27,9,21.33,20.06,75933,75957
4219,24,27,8,21.33,31.14,75956,75980
4220,26,31,2,19.69,37.21,75979,76005
4221,23,31,3,22.26,32.71,76004,76027
4222,22,32,3,23.27,36.20,76026,76048
4223,24,30,7,21.33,25.56,76047,76071
4224,24,31,7,21.33,28.39,76070,76094
4225,24,31,1,21.33,38.22,76093,76117
4226,23,31,4,22.26,27.67,76116,76139
4227,22,31,15,23.27,14.83,76138,76160
4228,23,31,3,22.26,27.76,76159,76182
4229,25,28,8,20.48,22.17,76181,76206
4230,24,27,6,21.33,28.31,76205,76229
4231,23,27,11,22.26,14.89,76228,76251
4232,23,31,3,22.26,39.84,76250,76273
4233,23,31,13,22.26,20.54,76272,76295
4234,22,31,14,23.27,23.02,76294,76316
4235,24,31,2,21.33,41.39,76315,76339
4236,22,31,13,23.27,18.56,76338,76360
4237,24,30,5,21.33,34.14,76359,76383
4238,23,31,3,22.26,26.98,76382,76405
4239,23,27,9,22.26,13.93,76404,76427
4240,23,31,7,22.26,19.76,76426,76449
4241,22,32,11,23.27,34.29,76448,76470
4242,23,31,9,22.26,24.28,76469,76492
4243,22,31,15,23.27,16.56,76491,76513
4244,23,35,4,22.26,41.06,76512,76535
4245,23,31,12,22.26,13.84,76534,76557
4246,25,27,1,20.48,44.73,76556,76581
4247,23,27,13,22.26,12.02,76580,76603
4248,23,31,9,22.26,22.37,76602,76625
4249,24,35,6,21.33,35.39,76624,76648
4250,23,31,2,22.26,33.41,76647,76670
4251,22,31,8,23.27,22.74,76669,76691
4252,22,31,9,23.27,22.65,76690,76712
4253,23,35,4,22.26,32.98,76711,76734
4254,23,27,15,22.26,12.37,76733,76756
4255,23,27,10,22.26,17.67,76755,76778
4256,22,34,9,23.27,38.02,76777,76799
4257,23,35,3,22.26,45.06,76798,76821
4258,22,31,18,23.27,12.20,76820,76842
4259,23,31,5,22.26,24.71,76841,76864
4260,22,31,3,23.27,30.65,76863,76885
4261,23,31,10,22.26,26.98,76884,76907
4262,22,31,16,23.27,12.38,76906,76928
4263,23,27,10,22.26,20.02,76927,76950
4264,22,27,11,23.27,19.02,76949,76971
4265,23,27,1,22.26,30.28,76970,76993
4266,23,30,6,22.26,26.54,76992,77015
4267,23,27,13,22.26,14.80,77014,77037
4268,22,31,11,23.27,23.38,77036,77058
4269,23,31,7,22.26,25.76,77057,77080
4270,22,31,13,23.27,15.83,77079,77101
4271,23,31,4,22.26,35.84,77100,77123
4272,21,31,19,24.38,8.62,77122,77143
4273,22,31,1,23.27,38.65,77142,77164
4274,21,27,8,24.38,18.05,77163,77184
4275,23,31,3,22.26,46.80,77183,77206
4276,22,31,17,23.27,11.02,77205,77227
4277,23,31,11,22.26,19.67,77227,77250
4278,24,27,7,21.33,23.14,77249,77273
4279,24,31,7,21.33,29.39,77272,77296
4280,23,31,5,22.26,30.98,77295,77318
4281,21,31,18,24.38,11.47,77317,77338
4282,24,35,1,21.33,45.56,77337,77361
4283,22,27,19,23.27,11.29,77360,77382
4284,22,31,1,23.27,50.02,77381,77403
4285,20,31,19,25.60,13.34,77402,77422
4286,23,31,3,22.26,29.06,77421,77444
4287,23,31,1,22.26,51.84,77443,77466
4288,24,31,15,21.33,19.22,77465,77489
4289,21,35,2,24.38,50.52,77489,77510
4290,22,31,3,23.27,33.56,77509,77531
4291,21,35,19,24.38,16.62,77530,77551
4292,23,31,4,22.26,43.84,77550,77573
4293,23,27,13,22.26,19.41,77572,77595
4294,23,36,6,22.26,33.32,77594,77617
4295,23,31,9,22.26,26.11,77616,77639
4296,23,31,7,22.26,25.24,77638,77661
4297,21,31,7,24.38,27.28,77660,77681
4298,24,27,2,21.33,35.31,77680,77704
4299,23,31,13,22.26,19.06,77703,77726
4300,25,27,6,20.48,28.81,77725,77750
4301,23,31,14,22.26,19.76,77749,77772
4302,23,27,4,22.26,32.02,77771,77794
4303,23,31,6,22.26,23.15,77793,77816
4304,24,31,11,21.33,23.56,77815,77839
4305,23,31,13,22.26,20.71,77838,77861
4306,23,31,5,22.26,31.06,77860,77883
4307,23,27,8,22.26,22.80,77882,77905
4308,22,27,5,23.27,21.93,77904,77926
4309,23,27,2,22.26,27.67,77926,77949
4310,22,35,11,23.27,19.02,77948,77970
4311,22,35,8,23.27,33.83,77969,77991
4312,23,31,1,22.26,35.50,77990,78013
4313,24,27,7,21.33,24.14,78012,78036
4314,23,31,5,22.26,22.98,78035,78058
4315,23,30,4,22.26,25.41,78057,78080
4316,22,31,13,23.27,13.20,78079,78101
4317,23,31,10,22.26,24.89,78100,78123
4318,24,27,2,21.33,31.39,78122,78146
4319,23,30,7,22.26,25.32,78145,78168
4320,23,31,13,22.26,16.02,78167,78190
4321,23,27,8,22.26,17.06,78189,78212
4322,24,31,4,21.33,28.64,78211,78235
4323,22,31,14,23.27,14.93,78234,78256
4324,24,31,1,21.33,45.47,78255,78279
4325,24,27,16,21.33,7.81,78278,78302
4326,23,27,10,22.26,18.19,78301,78324
4327,24,35,1,21.33,33.56,78324,78348
4328,23,27,4,22.26,27.41,78347,78370
4329,24,31,11,21.33,15.89,78369,78393
4330,21,27,12,24.38,13.00,78392,78413
4331,23,31,8,22.26,23.67,78413,78436
4332,24,31,4,21.33,21.81,78435,78459
4333,23,35,4,22.26,32.98,78458,78481
4334,23,31,2,22.26,39.84,78480,78503
4335,23,27,12,22.26,16.02,78502,78525
4336,24,27,3,21.33,27.47,78524,78548
4337,24,31,6,21.33,24.47,78547,78571
4338,23,31,7,22.26,33.32,78570,78593
4339,24,31,2,21.33,29.97,78592,78616
4340,23,31,13,22.26,20.02,78615,78638
4341,24,27,3,21.33,23.89,78638,78662
4342,22,31,10,23.27,22.02,78661,78683
4343,24,31,2,21.33,39.97,78682,78706
4344,24,27,4,21.33,24.22,78705,78729
4345,23,31,7,22.26,24.71,78728,78751
4346,24,27,13,21.33,13.56,78750,78774
4347,23,31,10,22.26,25.76,78773,78796
4348,23,31,3,22.26,39.84,78795,78818
4349,24,27,5,21.33,27.22,78817,78841
4350,24,27,1,21.33,30.81,78840,78864
4351,23,31,9,22.26,26.37,78863,78886
4352,23,31,18,22.26,10.80,78885,78908
4353,23,35,7,22.26,36.71,78907,78930
4354,23,31,5,22.26,27.93,78929,78952
4355,23,27,14,22.26,14.71,78951,78974
4356,25,27,5,20.48,26.25,78973,78998
4357,24,27,8,21.33,20.22,78997,79021
4358,24,31,2,21.33,37.39,79020,79044
4359,24,35,4,21.33,42.72,79043,79067
4360,22,31,15,23.27,17.47,79066,79088
4361,24,27,4,21.33,33.97,79087,79111
4362,23,31,11,22.26,27.06,79110,79133
4363,23,35,4,22.26,34.19,79132,79155
4364,23,31,9,22.26,19.06,79154,79177
4365,23,31,10,22.26,29.50,79176,79199
4366,25,31,1,20.48,35.37,79198,79223
4367,23,31,10,22.26,18.71,79222,79245
4368,23,27,13,22.26,14.11,79244,79267
4369,23,31,10,22.26,20.45,79266,79289
4370,24,27,4,21.33,21.14,79288,79312
4371,24,27,4,21.33,31.22,79311,79335
4372,24,31,1,21.33,41.56,79334,79358
4373,23,31,13,22.26,21.41,79357,79380
4374,25,35,4,20.48,37.45,79379,79404
4375,23,31,6,22.26,34.54,79403,79426
4376,24,35,13,21.33,17.81,79425,79449
4377,23,27,8,22.26,25.41,79448,79471
4378,25,31,7,20.48,27.05,79470,79495
4379,24,28,9,21.33,18.39,79494,79518
4380,23,31,11,22.26,24.45,79517,79540
4381,24,27,13,21.33,15.47,79540,79564
4382,23,36,1,22.26,40.45,79563,79586
4383,24,27,7,21.33,25.39,79585,79609
4384,24,27,1,21.33,27.14,79608,79632
4385,24,31,5,21.33,28.64,79631,79655
4386,23,27,13,22.26,15.24,79654,79677
4387,25,23,14,20.48,5.93,79677,79702
4388,24,27,7,21.33,25.14,79701,79725
4389,23,27,13,22.26,14.37,79724,79747
4390,24,27,9,21.33,18.81,79746,79770
4391,23,27,2,22.26,32.37,79769,79792
4392,24,27,2,21.33,27.47,79791,79815
4393,23,30,13,22.26,22.19,79814,79837
4394,25,27,1,20.48,36.41,79836,79861
4395,24,27,3,21.33,26.89,79860,79884
4396,26,27,4,19.69,31.29,79883,79909
4397,22,34,10,23.27,26.47,79908,79930
4398,23,35,13,22.26,29.06,79929,79952
4399,23,31,11,22.26,23.24,79951,79974
4400,23,31,2,22.26,35.58,79973,79996
4401,23,27,17,22.26,10.63,79995,80018
4402,24,27,1,21.33,41.64,80017,80041
4403,24,31,6,21.33,23.31,80040,80064
4404,24,31,3,21.33,37.22,80063,80087
4405,23,31,8,22.26,26.19,80086,80109
4406,24,27,15,21.33,10.56,80108,80132
4407,24,27,3,21.33,32.89,80131,80155
4408,24,27,14,21.33,7.06,80154,80178
4409,24,35,7,21.33,30.97,80177,80201
4410,25,27,10,20.48,23.53,80200,80225
4411,23,31,13,22.26,13.58,80224,80247
4412,25,31,4,20.48,29.61,80246,80271
4413,25,27,3,20.48,22.09,80270,80295
4414,23,31,5,22.26,30.37,80295,80318
4415,23,27,8,22.26,18.71,80317,80340
4416,24,31,12,21.33,17.06,80339,80363
4417,25,27,7,20.48,25.77,80362,80387
4418,23,27,9,22.26,18.63,80386,80409
4419,24,28,9,21.33,20.89,80408,80432
4420,25,31,3,20.48,43.69,80431,80456
4421,24,27,13,21.33,13.31,80455,80479
4422,24,27,8,21.33,26.06,80478,80502
4423,24,31,9,21.33,35.06,80501,80525
4424,23,27,7,22.26,19.06,80524,80547
4425,25,28,3,20.48,25.29,80546,80571
4426,25,27,5,20.48,25.61,80570,80595
4427,24,27,13,21.33,14.22,80594,80618
4428,25,31,9,20.48,22.65,80617,80642
4429,25,31,1,20.48,37.85,80641,80666
4430,23,27,9,22.26,20.71,80665,80688
4431,23,31,13,22.26,19.32,80687,80710
4432,24,31,3,21.33,46.72,80709,80733
4433,24,31,14,21.33,19.89,80732,80756
4434,25,27,1,20.48,27.53,80755,80780
4435,24,27,5,21.33,32.64,80779,80803
4436,25,27,3,20.48,40.97,80802,80827
4437,24,28,11,21.33,17.47,80826,80850
4438,26,31,2,19.69,31.67,80849,80875
4439,26,27,4,19.69,27.60,80874,80900
4440,24,31,13,21.33,20.72,80899,80923
4441,24,31,10,21.33,19.64,80922,80946
4442,25,27,3,20.48,24.17,80946,80971
4443,23,31,6,22.26,21.84,80970,80993
4444,23,31,5,22.26,29.76,80992,81015
4445,24,27,9,21.33,15.39,81014,81038
4446,26,31,4,19.69,30.21,81037,81063
4447,23,31,3,22.26,39.50,81062,81085
4448,23,31,14,22.26,16.89,81084,81107
4449,25,31,1,20.48,33.45,81106,81131
4450,25,31,4,20.48,30.25,81130,81155
4451,23,31,7,22.26,22.80,81154,81177
4452,25,30,6,20.48,34.01,81176,81201
4453,24,28,4,21.33,29.22,81200,81224
4454,25,27,5,20.48,25.29,81223,81248
4455,24,31,13,21.33,17.56,81247,81271
4456,25,31,2,20.48,49.53,81270,81295
4457,23,31,15,22.26,13.67,81294,81317
4458,24,31,7,21.33,35.72,81316,81340
4459,24,28,3,21.33,23.47,81339,81363
4460,23,27,15,22.26,8.89,81362,81385
4461,23,35,4,22.26,36.71,81384,81407
4462,24,30,9,21.33,21.56,81406,81430
4463,25,31,1,20.48,42.97,81429,81454
4464,25,27,9,20.48,15.77,81453,81478
4465,24,31,2,21.33,38.81,81477,81501
4466,24,31,1,21.33,28.22,81500,81524
4467,24,27,8,21.33,12.97,81523,81547
4468,23,27,15,22.26,13.06,81546,81569
4469,25,27,1,20.48,41.53,81568,81593
4470,23,31,11,22.26,14.89,81592,81615
4471,25,27,5,20.48,17.85,81614,81639
4472,24,31,1,21.33,33.14,81638,81662
4473,24,27,7,21.33,23.14,81661,81685
4474,23,31,14,22.26,21.67,81684,81707
4475,24,27,7,21.33,24.89,81706,81730
4476,25,31,6,20.48,23.29,81729,81754
4477,23,31,10,22.26,21.84,81753,81776
4478,24,27,12,21.33,20.97,81775,81799
4479,24,27,4,21.33,31.64,81798,81822
4480,24,31,13,21.33,14.89,81821,81845
4481,25,27,6,20.48,18.41,81844,81869
4482,24,27,4,21.33,21.72,81868,81892
4483,24,35,1,21.33,39.47,81891,81915
4484,23,35,11,22.26,25.24,81914,81937
4485,27,27,6,18.96,13.15,81936,81963
4486,26,27,5,19.69,24.14,81962,81988
4487,25,27,14,20.48,9.77,81987,82012
4488,24,27,8,21.33,19.06,82011,82035
4489,25,27,2,20.48,37.77,82034,82059
4490,24,27,6,21.33,24.14,82058,82082
4491,25,27,7,20.48,17.45,82081,82106
4492,25,27,12,20.48,15.45,82105,82130
4493,23,31,13,22.26,26.54,82129,82152
4494,24,31,1,21.33,39.47,82151,82175
4495,25,31,6,20.48,31.37,82174,82199
4496,25,27,8,20.48,21.69,82198,82223
4497,23,31,10,22.26,19.06,82222,82245
4498,24,27,13,21.33,11.31,82244,82268
4499,25,27,2,20.48,30.89,82267,82292
4500,24,31,1,21.33,32.81,82291,82315
4501,24,31,3,21.33,30.31,82314,82338
4502,26,31,1,19.69,32.98,82337,82363
4503,25,27,2,20.48,26.73,82362,82387
4504,24,27,9,21.33,14.89,82386,82410
4505,24,31,4,21.33,40.89,82409,82433
4506,25,31,8,20.48,26.25,82432,82457
4507,24,27,13,21.33,10.47,82456,82480
4508,25,27,1,20.48,25.37,82479,82504
4509,25,31,1,20.48,38.01,82503,82528
4510,24,27,10,21.33,19.47,82527,82551
4511,26,27,3,19.69,28.44,82550,82576
4512,24,31,13,21.33,12.31,82575,82599
4513,27,27,1,18.96,41.15,82598,82625
4514,23,27,15,22.26,14.80,82624,82647
4515,25,31,3,20.48,34.25,82646,82671
4516,23,31,16,22.26,12.54,82670,82693
4517,25,27,2,20.48,29.29,82692,82717
4518,25,27,2,20.48,32.33,82716,82741
4519,26,27,6,19.69,27.14,82740,82766
4520,24,27,1,21.33,26.22,82765,82789
4521,22,31,19,23.27,6.65,82788,82810
4522,26,30,1,19.69,32.14,82809,82835
4523,25,27,3,20.48,29.21,82834,82859
4524,25,27,4,20.48,22.09,82858,82883
4525,23,27,15,22.26,10.98,82882,82905
4526,24,35,13,21.33,19.64,82905,82929
4527,25,27,1,20.48,33.53,82928,82953
4528,24,27,13,21.33,9.56,82952,82976
4529,25,31,4,20.48,38.89,82975,83000
4530,25,27,9,20.48,16.25,82999,83024
4531,24,31,7,21.33,28.14,83023,83047
4532,25,31,12,20.48,18.33,83046,83071
4533,25,27,4,20.48,25.29,83070,83095
4534,26,31,2,19.69,32.52,83094,83120
4535,25,27,10,20.48,25.13,83119,83144
4536,26,27,3,19.69,28.37,83143,83169
4537,24,35,7,21.33,30.06,83168,83192
4538,25,31,14,20.48,19.85,83191,83216
4539,25,27,5,20.48,25.29,83215,83240
4540,23,31,5,22.26,29.24,83239,83262
4541,23,31,5,22.26,34.28,83261,83284
4542,25,27,4,20.48,24.97,83283,83308
4543,24,31,5,21.33,25.56,83307,83331
4544,24,30,5,21.33,24.47,83330,83354
4545,24,31,3,21.33,35.64,83353,83377
4546,23,31,15,22.26,16.37,83376,83399
4547,26,27,12,19.69,20.14,83398,83424
4548,24,27,9,21.33,18.64,83423,83447
4549,25,27,8,20.48,20.33,83446,83471
4550,25,23,3,20.48,18.65,83470,83495
4551,25,27,4,20.48,24.33,83494,83519
4552,26,31,4,19.69,21.91,83518,83544
4553,25,27,9,20.48,13.37,83543,83568
4554,25,31,9,20.48,19.29,83567,83592
4555,25,31,6,20.48,25.61,83591,83616
4556,23,31,1,22.26,34.98,83615,83638
4557,24,27,12,21.33,11.72,83637,83661
4558,24,31,11,21.33,18.97,83660,83684
4559,26,31,8,19.69,24.67,83683,83709
4560,24,31,10,21.33,18.06,83708,83732
4561,24,31,5,21.33,21.56,83731,83755
4562,24,31,1,21.33,48.81,83754,83778
4563,23,31,14,22.26,17.15,83777,83800
4564,25,27,1,20.48,33.21,83799,83824
4565,24,27,13,21.33,12.47,83824,83848
4566,26,27,5,19.69,26.06,83847,83873
4567,24,27,13,21.33,18.47,83872,83896
4568,26,27,2,19.69,37.67,83895,83921
4569,24,27,14,21.33,14.47,83920,83944
4570,26,27,2,19.69,32.83,83943,83969
4571,23,31,17,22.26,10.98,83968,83991
4572,23,31,17,22.26,12.54,83991,84014
4573,25,27,10,20.48,16.49,84013,84038
4574,25,27,6,20.48,25.21,84037,84062
4575,24,31,13,21.33,19.06,84061,84085
4576,25,27,3,20.48,31.93,84084,84109
4577,24,27,14,21.33,7.39,84108,84132
4578,26,31,2,19.69,36.98,84131,84157
4579,24,27,11,21.33,15.14,84156,84180
4580,25,27,8,20.48,17.05,84179,84204
4581,23,27,12,22.26,21.67,84204,84227
4582,25,27,3,20.48,24.25,84226,84251
4583,24,27,16,21.33,9.14,84251,84275
4584,24,27,4,21.33,26.72,84274,84298
4585,25,27,3,20.48,38.89,84297,84322
4586,25,27,8,20.48,13.77,84321,84346
4587,22,27,11,23.27,13.11,84345,84367
4588,27,27,2,18.96,27.29,84366,84393
4589,25,27,8,20.48,17.29,84392,84417
4590,25,27,8,20.48,18.09,84416,84441
4591,26,27,9,19.69,21.29,84440,84466
4592,25,27,10,20.48,17.61,84465,84490
4593,26,27,11,19.69,15.44,84489,84515
4594,25,27,3,20.48,39.21,84514,84539
4595,25,27,5,20.48,18.17,84538,84563
4596,25,27,5,20.48,21.93,84562,84587
4597,25,31,9,20.48,31.93,84586,84611
4598,23,27,14,22.26,12.28,84610,84633
4599,25,27,2,20.48,28.17,84632,84657
4600,25,27,1,20.48,32.41,84656,84681
4601,26,31,13,19.69,14.60,84680,84706
4602,26,27,2,19.69,30.83,84705,84731
4603,26,23,13,19.69,8.83,84730,84756
4604,27,27,4,18.96,24.11,84755,84782
4605,26,27,13,19.69,15.52,84781,84807
4606,27,27,2,18.96,25.52,84807,84834
4607,25,27,13,20.48,15.53,84833,84858
4608,26,27,7,19.69,17.91,84857,84883
4609,27,27,6,18.96,20.92,84882,84909
4610,25,27,13,20.48,10.17,84908,84933
4611,27,27,6,18.96,28.41,84932,84959
4612,24,27,6,21.33,27.47,84958,84982
4613,26,27,1,19.69,24.29,84981,85007
4614,26,27,4,19.69,27.67,85007,85033
4615,25,31,13,20.48,16.25,85032,85057
4616,27,27,9,18.96,14.26,85057,85084
4617,26,27,10,19.69,11.14,85083,85109
4618,26,27,7,19.69,15.14,85109,85135
4619,26,27,12,19.69,13.60,85134,85160
4620,26,27,1,19.69,32.37,85159,85185
4621,27,27,13,18.96,8.41,85184,85211
4622,26,27,3,19.69,18.91,85210,85236
4623,25,31,5,20.48,34.65,85235,85260
4624,27,27,13,18.96,9.37,85259,85286
4625,24,31,6,21.33,20.47,85285,85309
4626,25,27,2,20.48,31.93,85308,85333
4627,26,27,13,19.69,9.29,85332,85358
4628,26,27,5,19.69,29.60,85357,85383
4629,25,27,15,20.48,7.45,85382,85407
4630,27,27,2,18.96,32.55,85406,85433
4631,24,31,5,21.33,24.89,85432,85456
4632,26,31,12,19.69,19.21,85455,85481
4633,28,23,7,18.29,12.28,85480,85508
4634,27,23,7,18.96,19.74,85507,85534
4635,27,27,11,18.96,17.15,85533,85560
4636,26,27,2,19.69,27.29,85559,85585
4637,25,27,1,20.48,27.53,85584,85609
4638,15,27,17,19.53,5.45,85608,85623
