tile_id,n_reduce_rows_num,max_row_length,min_row_length,avg_row_length,variance,start_row,end_row
0,80,22,0,6.40,34.37,0,80
1,77,24,0,6.65,36.57,79,156
2,86,26,0,5.95,32.84,155,241
3,103,32,0,4.97,32.51,240,343
4,94,20,0,5.45,27.42,342,436
5,105,20,0,4.88,22.89,436,541
6,93,53,0,5.51,54.12,540,633
7,102,29,0,5.02,39.35,632,734
8,105,33,0,4.88,39.14,733,838
9,107,24,0,4.79,25.50,837,944
10,101,27,0,5.07,25.63,943,1044
11,111,37,0,4.61,33.53,1043,1154
12,88,26,0,5.82,30.63,1153,1241
13,101,26,0,5.07,36.60,1240,1341
14,92,20,0,5.57,28.48,1340,1432
15,91,23,0,5.63,37.27,1431,1522
16,82,35,0,6.24,36.11,1521,1603
17,80,31,0,6.40,39.67,1602,1682
18,65,36,0,7.88,49.74,1681,1746
19,111,19,0,4.61,23.66,1745,1856
20,102,24,0,5.02,39.45,1855,1957
21,89,26,0,5.75,32.01,1956,2045
22,103,24,0,4.97,33.19,2044,2147
23,98,28,0,5.22,28.83,2146,2244
24,97,30,0,5.28,36.37,2244,2341
25,73,39,0,7.01,49.08,2340,2413
26,97,31,0,5.28,41.97,2413,2510
27,95,20,0,5.39,31.61,2509,2604
28,103,42,0,4.97,42.98,2603,2706
29,92,30,0,5.57,35.66,2705,2797
30,98,22,0,5.22,34.21,2796,2894
31,97,21,0,5.28,34.28,2893,2990
32,72,62,0,7.11,84.82,2989,3061
33,102,22,0,5.02,31.74,3060,3162
34,91,21,0,5.63,31.31,3161,3252
35,81,34,0,6.32,45.77,3251,3332
36,79,54,0,6.48,57.77,3331,3410
37,93,21,0,5.51,27.33,3410,3503
38,98,29,0,5.22,35.34,3502,3600
39,80,23,0,6.40,28.54,3599,3679
40,80,21,0,6.40,44.22,3678,3758
41,107,25,0,4.79,28.73,3757,3864
42,92,43,0,5.57,47.33,3863,3955
43,86,26,0,5.95,34.11,3954,4040
44,95,21,0,5.39,27.25,4039,4134
45,93,24,0,5.51,28.27,4133,4226
46,114,35,0,4.49,33.13,4225,4339
47,94,58,0,5.45,63.40,4338,4432
48,93,24,0,5.51,30.74,4431,4524
49,103,22,0,4.97,26.69,4523,4626
50,78,32,0,6.56,49.81,4625,4703
51,105,27,0,4.88,24.11,4703,4808
52,90,34,0,5.69,51.21,4807,4897
53,118,20,0,4.34,27.09,4896,5014
54,101,21,0,5.07,30.20,5014,5115
55,124,22,0,4.13,24.52,5115,5239
56,89,26,0,5.75,38.95,5239,5328
57,89,32,0,5.75,40.50,5327,5416
58,84,20,0,6.10,30.75,5415,5499
59,74,38,0,6.92,49.43,5498,5572
60,92,21,0,5.57,30.31,5571,5663
61,114,20,0,4.49,23.57,5662,5776
62,91,37,0,5.63,42.78,5775,5866
63,112,30,0,4.57,30.67,5865,5977
64,92,59,0,5.57,67.55,5976,6068
65,85,27,0,6.02,41.51,6068,6153
66,88,35,0,5.82,46.24,6152,6240
67,82,23,0,6.24,39.36,6239,6321
68,74,28,0,6.92,51.37,6320,6394
69,108,23,0,4.74,30.27,6393,6501
70,91,19,0,5.63,31.62,6501,6592
71,100,29,0,5.12,32.17,6591,6691
72,111,27,0,4.61,25.64,6690,6801
73,115,16,0,4.45,18.65,6800,6915
74,100,21,0,5.12,23.37,6915,7015
75,101,29,0,5.07,28.32,7014,7115
76,89,45,0,5.75,53.60,7115,7204
77,92,22,0,5.57,31.03,7203,7295
78,104,29,0,4.92,33.36,7294,7398
79,101,17,0,5.07,27.75,7397,7498
80,94,22,0,5.45,33.57,7497,7591
81,86,32,0,5.95,41.21,7590,7676
82,96,29,0,5.33,31.70,7675,7771
83,101,29,0,5.07,33.37,7771,7872
84,112,19,0,4.57,24.53,7871,7983
85,119,20,0,4.30,22.75,7983,8102
86,105,34,0,4.88,29.14,8101,8206
87,120,19,0,4.27,22.15,8205,8325
88,72,54,0,7.11,77.38,8324,8396
89,113,32,0,4.53,30.27,8395,8508
90,86,26,0,5.95,43.32,8508,8594
91,111,20,0,4.61,23.93,8593,8704
92,81,22,0,6.32,31.72,8703,8784
93,90,32,0,5.69,52.70,8783,8873
94,96,21,0,5.33,28.01,8872,8968
95,81,53,0,6.32,55.48,8968,9049
96,86,25,0,5.95,40.28,9048,9134
97,100,22,0,5.12,26.49,9134,9234
98,70,78,0,7.31,120.36,9233,9303
99,67,21,0,7.64,33.90,9302,9369
100,101,32,0,5.07,34.76,9368,9469
101,93,48,0,5.51,59.54,9468,9561
102,83,21,0,6.17,31.95,9560,9643
103,80,27,0,6.40,38.52,9643,9723
104,107,20,0,4.79,24.26,9723,9830
105,102,27,0,5.02,30.73,9830,9932
106,90,25,0,5.69,34.41,9931,10021
107,78,66,0,6.56,73.02,10020,10098
108,104,34,0,4.92,31.59,10097,10201
109,96,46,0,5.33,43.14,10200,10296
110,90,21,0,5.69,31.86,10295,10385
111,91,37,0,5.63,42.41,10384,10475
112,71,68,0,7.21,126.79,10474,10545
113,80,40,0,6.40,38.42,10544,10624
114,82,80,0,6.24,100.33,10623,10705
115,94,27,0,5.45,33.50,10704,10798
116,106,19,0,4.83,27.03,10797,10903
117,94,27,0,5.45,31.10,10902,10996
118,80,19,0,6.40,30.34,10995,11075
119,83,42,0,6.17,44.60,11074,11157
120,100,27,0,5.12,27.53,11156,11256
121,88,26,0,5.82,31.97,11255,11343
122,103,21,0,4.97,26.18,11342,11445
123,93,59,0,5.51,57.71,11444,11537
124,76,36,0,6.74,49.35,11536,11612
125,96,26,0,5.33,34.20,11611,11707
126,94,20,0,5.45,27.35,11706,11800
127,103,39,0,4.97,40.67,11799,11902
128,100,21,0,5.12,28.39,11901,12001
129,85,31,0,6.02,42.26,12000,12085
130,88,25,0,5.82,30.58,12084,12172
131,101,26,0,5.07,36.66,12171,12272
132,99,24,0,5.17,33.56,12271,12370
133,78,29,0,6.56,44.50,12369,12447
134,91,24,0,5.63,29.84,12447,12538
135,98,22,0,5.22,31.93,12537,12635
136,77,22,0,6.65,34.05,12634,12711
137,88,29,0,5.82,39.26,12710,12798
138,101,20,0,5.07,27.11,12797,12898
139,106,23,0,4.83,27.10,12897,13003
140,88,58,0,5.82,60.76,13003,13091
141,97,24,0,5.28,26.78,13090,13187
142,92,27,0,5.57,35.57,13186,13278
143,85,22,0,6.02,37.83,13277,13362
144,109,26,0,4.70,24.67,13361,13470
145,89,22,0,5.75,35.80,13469,13558
146,84,31,0,6.10,37.13,13557,13641
147,91,38,0,5.63,41.40,13640,13731
148,71,82,0,7.21,110.53,13730,13801
149,84,61,0,6.10,63.61,13800,13884
150,113,22,0,4.53,24.60,13884,13997
151,80,20,0,6.40,34.17,13996,14076
152,96,21,0,5.33,27.47,14075,14171
153,90,33,0,5.69,40.17,14170,14260
154,103,22,0,4.97,25.91,14259,14362
155,93,20,0,5.51,28.40,14361,14454
156,84,34,0,6.10,42.51,14453,14537
157,82,41,0,6.24,49.87,14536,14618
158,75,33,0,6.83,47.56,14617,14692
159,93,21,0,5.51,35.00,14691,14784
160,72,34,0,7.11,49.46,14783,14855
161,96,22,0,5.33,27.81,14855,14951
162,87,32,0,5.89,42.63,14950,15037
163,95,26,0,5.39,32.24,15036,15131
164,107,22,0,4.79,25.29,15130,15237
165,91,22,0,5.63,27.03,15236,15327
166,109,26,0,4.70,33.64,15326,15435
167,99,18,0,5.17,22.40,15435,15534
168,98,24,0,5.22,28.97,15533,15631
169,95,29,0,5.39,31.99,15630,15725
170,110,18,0,4.65,22.35,15725,15835
171,83,23,0,6.17,36.41,15834,15917
172,74,34,0,6.92,52.62,15916,15990
173,65,82,0,7.88,121.00,15989,16054
174,114,22,0,4.49,22.76,16054,16168
175,93,23,0,5.51,30.40,16167,16260
176,97,24,0,5.28,33.97,16259,16356
177,107,46,0,4.79,42.62,16355,16462
178,110,24,0,4.65,24.28,16461,16571
179,108,20,0,4.74,27.75,16570,16678
180,74,21,0,6.92,37.48,16677,16751
181,92,28,0,5.57,39.83,16750,16842
182,60,32,0,8.53,54.08,16842,16902
183,91,20,0,5.63,31.93,16901,16992
184,80,34,0,6.40,32.89,16991,17071
185,85,34,0,6.02,45.20,17070,17155
186,92,23,0,5.57,32.38,17154,17246
187,89,25,0,5.75,27.47,17245,17334
188,101,27,0,5.07,34.48,17333,17434
189,98,52,0,5.22,51.58,17433,17531
190,73,33,0,7.01,52.01,17531,17604
191,85,28,0,6.02,40.47,17603,17688
192,85,71,0,6.02,79.72,17687,17772
193,80,25,0,6.40,38.77,17771,17851
194,82,21,0,6.24,34.92,17850,17932
195,98,21,0,5.22,28.52,17932,18030
196,93,37,0,5.51,38.47,18029,18122
197,84,66,0,6.10,77.99,18121,18205
198,91,23,0,5.63,28.32,18204,18295
199,81,34,0,6.32,47.80,18294,18375
200,79,24,0,6.48,29.90,18374,18453
201,86,37,0,5.95,52.70,18452,18538
202,93,20,0,5.51,24.36,18537,18630
203,101,22,0,5.07,26.36,18629,18730
204,105,38,0,4.88,44.68,18729,18834
205,60,77,0,8.53,178.85,18833,18893
206,72,65,0,7.11,94.21,18892,18964
207,106,20,0,4.83,25.61,18963,19069
208,111,22,0,4.61,28.72,19069,19180
209,102,20,0,5.02,23.80,19179,19281
210,94,20,0,5.45,31.89,19280,19374
211,95,33,0,5.39,42.95,19373,19468
212,84,70,0,6.10,82.42,19468,19552
213,74,27,0,6.92,44.26,19552,19626
214,90,19,0,5.69,27.86,19625,19715
215,95,34,0,5.39,36.07,19714,19809
216,106,26,0,4.83,26.84,19808,19914
217,101,26,0,5.07,32.80,19914,20015
218,97,28,0,5.28,31.38,20014,20111
219,108,21,0,4.74,31.38,20110,20218
220,92,24,0,5.57,37.42,20217,20309
221,83,30,0,6.17,46.77,20308,20391
222,78,23,0,6.56,35.99,20391,20469
223,84,20,0,6.10,28.63,20468,20552
224,93,20,0,5.51,34.74,20551,20644
225,101,23,0,5.07,27.93,20644,20745
226,100,20,0,5.12,26.07,20744,20844
227,86,22,0,5.95,29.09,20843,20929
228,92,21,0,5.57,33.64,20928,21020
229,74,23,0,6.92,27.13,21019,21093
230,110,21,0,4.65,23.03,21092,21202
231,79,49,0,6.48,69.84,21201,21280
232,92,22,0,5.57,28.77,21279,21371
233,106,23,0,4.83,29.16,21370,21476
234,104,49,0,4.92,42.07,21475,21579
235,82,36,0,6.24,43.14,21578,21660
236,79,59,0,6.48,72.45,21659,21738
237,82,30,0,6.24,38.70,21737,21819
238,100,20,0,5.12,28.81,21818,21918
239,97,46,0,5.28,47.91,21917,22014
240,100,34,0,5.12,37.67,22013,22113
241,92,38,0,5.57,37.40,22112,22204
242,65,60,0,7.88,97.28,22203,22268
243,80,32,0,6.40,40.37,22267,22347
244,100,30,0,5.12,30.05,22346,22446
245,92,21,0,5.57,26.68,22446,22538
246,85,26,0,6.02,32.71,22537,22622
247,104,19,0,4.92,25.80,22621,22725
248,92,22,0,5.57,32.33,22724,22816
249,102,20,0,5.02,23.65,22816,22918
250,90,74,0,5.69,79.28,22918,23008
251,99,28,0,5.17,31.21,23007,23106
252,100,19,0,5.12,28.51,23106,23206
253,81,21,0,6.32,36.37,23205,23286
254,107,59,0,4.79,56.84,23285,23392
255,95,26,0,5.39,35.21,23392,23487
256,123,22,0,4.16,24.20,23486,23609
257,86,25,0,5.95,34.35,23608,23694
258,78,38,0,6.56,48.30,23693,23771
259,88,20,0,5.82,31.47,23770,23858
260,78,26,0,6.56,43.22,23857,23935
261,68,111,0,7.53,203.87,23935,24003
262,96,20,0,5.33,25.72,24003,24099
263,96,70,0,5.33,77.20,24098,24194
264,74,73,0,6.92,90.80,24194,24268
265,117,19,0,4.38,21.81,24267,24384
266,88,23,0,5.82,33.63,24384,24472
267,101,19,0,5.07,23.97,24472,24573
268,105,29,0,4.88,26.45,24572,24677
269,97,37,0,5.28,40.72,24676,24773
270,97,31,0,5.28,32.68,24772,24869
271,97,20,0,5.28,25.75,24868,24965
272,108,28,0,4.74,27.54,24964,25072
273,64,35,0,8.00,49.72,25071,25135
274,93,20,0,5.51,27.86,25134,25227
275,89,20,0,5.75,29.87,25226,25315
276,106,61,0,4.83,56.41,25315,25421
277,76,20,0,6.74,37.38,25420,25496
278,76,66,0,6.74,84.56,25495,25571
279,101,31,0,5.07,33.73,25570,25671
280,86,46,0,5.95,55.42,25670,25756
281,94,25,0,5.45,28.63,25755,25849
282,73,45,0,7.01,55.00,25848,25921
283,110,20,0,4.65,25.72,25920,26030
284,97,32,0,5.28,38.84,26029,26126
285,91,60,0,5.63,60.08,26125,26216
286,108,20,0,4.74,30.08,26215,26323
287,87,48,0,5.89,47.99,26323,26410
288,83,22,0,6.17,35.78,26409,26492
289,88,53,0,5.82,53.99,26492,26580
290,100,20,0,5.12,26.55,26579,26679
291,124,18,0,4.13,18.52,26678,26802
292,113,18,0,4.53,21.84,26801,26914
293,83,39,0,6.17,43.35,26913,26996
294,66,28,0,7.76,46.30,26995,27061
295,90,36,0,5.69,44.24,27060,27150
296,106,20,0,4.83,24.22,27149,27255
297,90,28,0,5.69,37.75,27254,27344
298,106,40,0,4.83,36.86,27344,27450
299,86,31,0,5.95,46.58,27449,27535
300,93,33,0,5.51,38.92,27534,27627
301,99,18,0,5.17,24.73,27627,27726
302,118,20,0,4.34,25.58,27725,27843
303,108,22,0,4.74,27.66,27842,27950
304,73,50,0,7.01,90.18,27949,28022
305,103,26,0,4.97,29.17,28021,28124
306,92,26,0,5.57,31.96,28123,28215
307,82,24,0,6.24,34.77,28215,28297
308,101,40,0,5.07,40.58,28296,28397
309,87,22,0,5.89,35.00,28396,28483
310,88,39,0,5.82,49.76,28482,28570
311,96,39,0,5.33,40.72,28569,28665
312,104,19,0,4.92,22.74,28665,28769
313,105,21,0,4.88,27.94,28768,28873
314,118,24,0,4.34,22.41,28873,28991
315,102,19,0,5.02,27.49,28990,29092
316,90,24,0,5.69,29.15,29091,29181
317,91,30,0,5.63,40.17,29180,29271
318,92,23,0,5.57,33.01,29271,29363
319,97,32,0,5.28,32.82,29362,29459
320,100,39,0,5.12,39.89,29458,29558
321,100,20,0,5.12,25.63,29557,29657
322,90,86,0,5.69,94.97,29656,29746
323,92,25,0,5.57,38.83,29745,29837
324,59,81,0,8.68,162.29,29836,29895
325,88,28,0,5.82,41.26,29894,29982
326,80,22,0,6.40,37.39,29981,30061
327,85,25,0,6.02,41.79,30060,30145
328,89,21,0,5.75,32.59,30145,30234
329,118,21,0,4.34,24.78,30233,30351
330,100,31,0,5.12,32.73,30350,30450
331,109,20,0,4.70,25.28,30449,30558
332,100,22,0,5.12,27.25,30557,30657
333,89,23,0,5.75,30.82,30656,30745
334,94,42,0,5.45,44.20,30744,30838
335,93,45,0,5.51,46.08,30838,30931
336,55,162,0,9.31,468.69,30930,30985
337,93,20,0,5.51,24.87,30984,31077
338,86,27,0,5.95,37.90,31076,31162
339,75,24,0,6.83,43.56,31161,31236
340,97,22,0,5.28,29.17,31235,31332
341,100,22,0,5.12,30.51,31331,31431
342,105,20,0,4.88,22.41,31430,31535
343,97,36,0,5.28,36.78,31534,31631
344,73,27,0,7.01,46.97,31630,31703
345,114,21,0,4.49,23.57,31702,31816
346,116,21,0,4.41,18.93,31815,31931
347,91,22,0,5.63,33.14,31930,32021
348,85,36,0,6.02,43.15,32020,32105
349,79,32,0,6.48,46.55,32104,32183
350,96,30,0,5.33,40.33,32182,32278
351,85,33,0,6.02,35.98,32277,32362
352,91,23,0,5.63,30.76,32361,32452
353,107,31,0,4.79,21.89,32451,32558
354,105,20,0,4.88,29.88,32557,32662
355,86,49,0,5.95,50.42,32661,32747
356,85,34,0,6.02,42.05,32746,32831
357,107,32,0,4.79,28.84,32831,32938
358,92,30,0,5.57,42.64,32937,33029
359,103,22,0,4.97,27.47,33028,33131
360,100,49,0,5.12,45.55,33130,33230
361,92,41,0,5.57,42.12,33229,33321
362,90,24,0,5.69,34.79,33320,33410
363,81,41,0,6.32,52.56,33409,33490
364,96,22,0,5.33,34.93,33489,33585
365,92,20,0,5.57,27.12,33585,33677
366,107,21,0,4.79,25.42,33676,33783
367,102,19,0,5.02,23.90,33782,33884
368,93,20,0,5.51,30.12,33884,33977
369,80,27,0,6.40,41.87,33976,34056
370,95,30,0,5.39,37.71,34055,34150
371,90,20,0,5.69,26.39,34150,34240
372,96,25,0,5.33,37.37,34239,34335
373,94,28,0,5.45,46.72,34334,34428
374,97,23,0,5.28,31.75,34428,34525
375,93,28,0,5.51,28.66,34524,34617
376,114,39,0,4.49,34.99,34616,34730
377,101,33,0,5.07,32.58,34730,34831
378,91,71,0,5.63,70.12,34831,34922
379,104,30,0,4.92,29.55,34921,35025
380,106,27,0,4.83,28.56,35024,35130
381,93,21,0,5.51,30.68,35129,35222
382,87,23,0,5.89,32.47,35221,35308
383,83,29,0,6.17,41.08,35307,35390
384,83,26,0,6.17,42.74,35389,35472
385,80,20,0,6.40,34.26,35471,35551
386,78,19,0,6.56,29.63,35550,35628
387,90,38,0,5.69,46.70,35627,35717
388,67,45,0,7.64,64.77,35716,35783
389,88,21,0,5.82,33.08,35782,35870
390,91,22,0,5.63,36.32,35869,35960
391,112,20,0,4.57,24.33,35959,36071
392,81,28,0,6.32,37.58,36071,36152
393,102,37,0,5.02,35.57,36151,36253
394,107,31,0,4.79,36.41,36252,36359
395,78,38,0,6.56,49.53,36358,36436
396,87,65,0,5.89,79.69,36435,36522
397,96,34,0,5.33,40.60,36521,36617
398,84,22,0,6.10,33.09,36616,36700
399,73,24,0,7.01,41.68,36699,36772
400,93,19,0,5.51,27.82,36771,36864
401,91,46,0,5.63,46.63,36863,36954
402,86,33,0,5.95,35.44,36953,37039
403,110,33,0,4.65,34.08,37038,37148
404,93,22,0,5.51,35.41,37147,37240
405,73,31,0,7.01,51.03,37239,37312
406,89,24,0,5.75,36.50,37311,37400
407,94,24,0,5.45,31.72,37399,37493
408,91,20,0,5.63,31.20,37492,37583
409,101,25,0,5.07,35.37,37582,37683
410,101,19,0,5.07,24.90,37682,37783
411,77,37,0,6.65,45.47,37782,37859
412,93,49,0,5.51,56.92,37858,37951
413,90,28,0,5.69,38.97,37950,38040
414,95,28,0,5.39,32.70,38039,38134
415,87,26,0,5.89,31.07,38133,38220
416,72,28,0,7.11,46.13,38220,38292
417,76,57,0,6.74,77.96,38291,38367
418,99,34,0,5.17,41.21,38366,38465
419,93,21,0,5.51,32.72,38464,38557
420,93,24,0,5.51,36.49,38557,38650
421,106,24,0,4.83,26.73,38649,38755
422,76,76,0,6.74,105.59,38754,38830
423,83,26,0,6.17,38.77,38829,38912
424,71,50,0,7.21,74.59,38911,38982
425,89,19,0,5.75,31.00,38981,39070
426,93,22,0,5.51,29.22,39069,39162
427,89,38,0,5.75,42.46,39161,39250
428,62,84,0,8.26,138.58,39249,39311
429,85,36,0,6.02,31.41,39310,39395
430,82,74,0,6.24,96.50,39394,39476
431,93,20,0,5.51,29.28,39475,39568
432,67,54,0,7.64,74.02,39567,39634
433,96,27,0,5.33,33.66,39634,39730
434,86,75,0,5.95,83.44,39730,39816
435,97,28,0,5.28,35.85,39815,39912
436,73,67,0,7.01,107.19,39911,39984
437,100,22,0,5.12,31.83,39983,40083
438,79,66,0,6.48,121.67,40082,40161
439,105,24,0,4.88,32.26,40161,40266
440,99,21,0,5.17,30.63,40265,40364
441,93,25,0,5.51,29.54,40363,40456
442,76,32,0,6.74,45.17,40455,40531
443,93,49,0,5.51,52.27,40530,40623
444,95,52,0,5.39,46.85,40622,40717
445,86,21,0,5.95,39.86,40716,40802
446,97,25,0,5.28,31.62,40801,40898
447,106,22,0,4.83,27.84,40897,41003
448,98,18,0,5.22,26.07,41002,41100
449,100,44,0,5.12,38.23,41099,41199
450,69,25,0,7.42,41.40,41198,41267
451,61,206,0,8.39,681.39,41266,41327
452,96,23,0,5.33,29.33,41326,41422
453,83,25,0,6.17,37.85,41421,41504
454,90,24,0,5.69,31.01,41503,41593
455,107,30,0,4.79,25.53,41592,41699
456,106,20,0,4.83,25.88,41699,41805
457,61,57,0,8.39,92.93,41804,41865
458,97,34,0,5.28,37.89,41864,41961
459,83,31,0,6.17,43.54,41960,42043
460,89,21,0,5.75,33.56,42042,42131
461,98,23,0,5.22,33.97,42131,42229
462,89,21,0,5.75,32.70,42229,42318
463,69,45,0,7.42,76.10,42317,42386
464,84,22,0,6.10,30.25,42385,42469
465,95,26,0,5.39,36.95,42468,42563
466,91,19,0,5.63,28.50,42562,42653
467,105,29,0,4.88,25.92,42652,42757
468,92,30,0,5.57,42.92,42756,42848
469,66,42,0,7.76,66.91,42847,42913
470,84,38,0,6.10,37.78,42912,42996
471,84,30,0,6.10,45.78,42995,43079
472,83,22,0,6.17,32.41,43078,43161
473,98,28,0,5.22,34.95,43160,43258
474,89,36,0,5.75,46.32,43257,43346
475,85,23,0,6.02,42.87,43345,43430
476,86,44,0,5.95,46.18,43430,43516
477,92,41,0,5.57,45.42,43515,43607
478,84,35,0,6.10,48.49,43606,43690
479,105,29,0,4.88,34.76,43689,43794
480,109,27,0,4.70,24.39,43793,43902
481,76,35,0,6.74,46.48,43901,43977
482,98,30,0,5.22,38.34,43976,44074
483,90,27,0,5.69,36.90,44073,44163
484,101,22,0,5.07,27.39,44162,44263
485,100,27,0,5.12,35.87,44262,44362
486,69,91,0,7.42,138.56,44361,44430
487,93,23,0,5.51,31.33,44430,44523
488,75,65,0,6.83,79.98,44522,44597
489,96,25,0,5.33,32.22,44596,44692
490,79,138,0,6.48,247.36,44691,44770
491,100,19,0,5.12,28.43,44769,44869
492,79,29,0,6.48,38.02,44869,44948
493,69,39,0,7.42,72.10,44948,45017
494,100,22,0,5.12,29.71,45016,45116
495,104,20,0,4.92,23.21,45115,45219
496,89,49,0,5.75,63.83,45218,45307
497,96,40,0,5.33,37.66,45306,45402
498,111,23,0,4.61,22.90,45401,45512
499,89,18,0,5.75,29.85,45511,45600
500,86,20,0,5.95,30.04,45599,45685
501,81,32,0,6.32,51.28,45684,45765
502,92,26,0,5.57,34.03,45764,45856
503,100,28,0,5.12,39.09,45855,45955
504,120,18,0,4.27,24.08,45954,46074
505,76,61,0,6.74,70.27,46073,46149
506,97,63,0,5.28,59.71,46148,46245
507,97,22,0,5.28,23.64,46244,46341
508,102,38,0,5.02,32.82,46341,46443
509,99,21,0,5.17,28.47,46442,46541
510,77,38,0,6.65,45.94,46540,46617
511,95,23,0,5.39,29.21,46616,46711
512,73,24,0,7.01,37.66,46710,46783
513,84,59,0,6.10,70.25,46783,46867
514,95,19,0,5.39,30.26,46866,46961
515,87,61,0,5.89,68.70,46960,47047
516,72,22,0,7.11,37.77,47046,47118
517,79,24,0,6.48,36.33,47117,47196
518,87,21,0,5.89,28.63,47195,47282
519,83,52,0,6.17,60.19,47281,47364
520,79,60,0,6.48,69.82,47363,47442
521,102,25,0,5.02,28.47,47442,47544
522,90,20,0,5.69,33.35,47543,47633
523,84,31,0,6.10,47.01,47632,47716
524,86,24,0,5.95,36.23,47715,47801
525,66,103,0,7.76,301.70,47800,47866
526,106,33,0,4.83,27.99,47865,47971
527,59,36,0,8.68,50.32,47970,48029
528,118,18,0,4.34,20.58,48028,48146
529,112,21,0,4.57,26.99,48145,48257
530,55,57,0,9.31,106.80,48257,48312
531,107,30,0,4.79,28.43,48311,48418
532,101,28,0,5.07,31.23,48417,48518
533,84,20,0,6.10,38.28,48517,48601
534,72,52,0,7.11,66.24,48600,48672
535,95,21,0,5.39,35.52,48671,48766
536,103,40,0,4.97,32.65,48765,48868
537,100,23,0,5.12,32.17,48867,48967
538,85,22,0,6.02,35.95,48966,49051
539,85,69,0,6.02,79.08,49050,49135
540,103,31,0,4.97,26.71,49134,49237
541,106,23,0,4.83,32.73,49236,49342
542,98,21,0,5.22,33.99,49341,49439
543,81,18,0,6.32,28.69,49438,49519
544,86,36,0,5.95,41.79,49519,49605
545,94,32,0,5.45,39.74,49604,49698
546,99,20,0,5.17,24.87,49697,49796
547,124,23,0,4.13,21.52,49795,49919
548,88,35,0,5.82,37.97,49919,50007
549,67,142,0,7.64,363.42,50006,50073
550,93,21,0,5.51,28.25,50073,50166
551,73,29,0,7.01,39.71,50165,50238
552,108,20,0,4.74,25.25,50238,50346
553,82,39,0,6.24,47.14,50345,50427
554,100,22,0,5.12,30.37,50426,50526
555,102,34,0,5.02,37.55,50525,50627
556,107,25,0,4.79,29.37,50626,50733
557,62,20,0,8.26,35.45,50732,50794
558,99,23,0,5.17,23.19,50793,50892
559,79,48,0,6.48,51.44,50892,50971
560,71,189,0,7.21,499.35,50971,51042
561,91,20,0,5.63,32.28,51042,51133
562,100,37,0,5.12,35.05,51132,51232
563,100,21,0,5.12,28.37,51231,51331
564,69,93,0,7.42,147.35,51330,51399
565,96,32,0,5.33,39.89,51398,51494
566,91,35,0,5.63,48.74,51493,51584
567,96,26,0,5.33,29.53,51583,51679
568,109,26,0,4.70,29.73,51678,51787
569,102,20,0,5.02,27.25,51786,51888
570,96,19,0,5.33,28.85,51887,51983
571,73,69,0,7.01,106.56,51982,52055
572,80,50,0,6.40,54.04,52054,52134
573,81,23,0,6.32,44.91,52133,52214
574,97,36,0,5.28,37.33,52214,52311
575,72,29,0,7.11,49.77,52310,52382
576,106,30,0,4.83,39.07,52382,52488
577,85,38,0,6.02,53.58,52488,52573
578,98,21,0,5.22,31.07,52572,52670
579,89,22,0,5.75,32.48,52669,52758
580,82,49,0,6.24,48.26,52757,52839
581,103,21,0,4.97,26.13,52838,52941
582,95,42,0,5.39,42.66,52940,53035
583,103,22,0,4.97,31.06,53035,53138
584,72,22,0,7.11,34.65,53137,53209
585,105,39,0,4.88,33.23,53208,53313
586,98,20,0,5.22,30.30,53312,53410
587,96,24,0,5.33,34.18,53410,53506
588,90,40,0,5.69,39.19,53505,53595
589,95,20,0,5.39,25.31,53594,53689
590,94,23,0,5.45,34.25,53688,53782
591,101,24,0,5.07,31.71,53781,53882
592,94,20,0,5.45,29.80,53881,53975
593,102,35,0,5.02,35.41,53974,54076
594,73,24,0,7.01,45.22,54075,54148
595,99,21,0,5.17,24.14,54147,54246
596,89,28,0,5.75,33.42,54245,54334
597,77,95,0,6.65,129.11,54334,54411
598,101,31,0,5.07,34.74,54411,54512
599,96,21,0,5.33,26.20,54512,54608
600,105,18,0,4.88,27.77,54607,54712
601,109,20,0,4.70,24.52,54711,54820
602,106,33,0,4.83,36.42,54819,54925
603,95,32,0,5.39,34.55,54924,55019
604,94,53,0,5.45,51.12,55018,55112
605,68,25,0,7.53,38.78,55111,55179
606,97,25,0,5.28,35.60,55178,55275
607,87,32,0,5.89,41.18,55274,55361
608,89,24,0,5.75,32.03,55360,55449
609,78,22,0,6.56,37.94,55449,55527
610,80,18,0,6.40,30.47,55526,55606
611,99,47,0,5.17,43.46,55606,55705
612,87,44,0,5.89,44.61,55704,55791
613,93,38,0,5.51,47.48,55791,55884
614,116,27,0,4.41,30.59,55884,56000
615,94,25,0,5.45,29.50,55999,56093
616,88,25,0,5.82,33.10,56092,56180
617,87,32,0,5.89,39.09,56179,56266
618,105,27,0,4.88,34.98,56266,56371
619,95,68,0,5.39,66.43,56370,56465
620,88,37,0,5.82,49.76,56464,56552
621,71,25,0,7.21,47.46,56551,56622
622,85,35,0,6.02,43.81,56621,56706
623,80,24,0,6.40,40.14,56705,56785
624,89,21,0,5.75,28.70,56784,56873
625,118,19,0,4.34,25.43,56872,56990
626,116,22,0,4.41,24.98,56989,57105
627,87,31,0,5.89,50.72,57104,57191
628,94,20,0,5.45,28.67,57190,57284
629,90,23,0,5.69,34.13,57283,57373
630,108,23,0,4.74,29.34,57372,57480
631,85,48,0,6.02,57.25,57479,57564
632,83,47,0,6.17,48.33,57564,57647
633,118,19,0,4.34,25.31,57646,57764
634,97,28,0,5.28,28.37,57763,57860
635,107,20,0,4.79,28.43,57859,57966
636,87,29,0,5.89,42.86,57965,58052
637,81,37,0,6.32,42.88,58051,58132
638,104,20,0,4.92,26.90,58131,58235
639,88,82,0,5.82,100.79,58234,58322
640,101,23,0,5.07,28.22,58321,58422
641,97,26,0,5.28,30.92,58421,58518
642,95,32,0,5.39,45.33,58517,58612
643,84,20,0,6.10,27.11,58611,58695
644,106,45,0,4.83,35.67,58694,58800
645,106,32,0,4.83,26.78,58799,58905
646,101,22,0,5.07,28.48,58904,59005
647,102,22,0,5.02,29.45,59004,59106
648,112,23,0,4.57,23.01,59105,59217
649,80,19,0,6.40,35.87,59216,59296
650,95,39,0,5.39,38.60,59296,59391
651,77,20,0,6.65,32.80,59390,59467
652,82,41,0,6.24,51.75,59466,59548
653,67,141,0,7.64,297.04,59547,59614
654,88,22,0,5.82,34.24,59613,59701
655,105,23,0,4.88,28.20,59700,59805
656,107,20,0,4.79,28.62,59804,59911
657,99,20,0,5.17,26.59,59910,60009
658,104,21,0,4.92,24.72,60009,60113
659,101,29,0,5.07,36.36,60112,60213
660,69,61,0,7.42,67.90,60212,60281
661,83,34,0,6.17,44.31,60280,60363
662,92,55,0,5.57,56.16,60362,60454
663,100,20,0,5.12,27.81,60453,60553
664,93,22,0,5.51,32.81,60552,60645
665,88,26,0,5.82,35.44,60645,60733
666,92,19,0,5.57,31.77,60732,60824
667,85,28,0,6.02,33.76,60823,60908
668,88,25,0,5.82,34.40,60907,60995
669,101,20,0,5.07,31.91,60994,61095
670,79,49,0,6.48,67.95,61094,61173
671,84,20,0,6.10,31.49,61173,61257
672,91,24,0,5.63,30.92,61256,61347
673,108,21,0,4.74,30.97,61346,61454
674,75,43,0,6.83,60.17,61453,61528
675,88,22,0,5.82,36.15,61527,61615
676,80,28,0,6.40,42.62,61615,61695
677,94,22,0,5.45,28.84,61694,61788
678,94,20,0,5.45,33.18,61787,61881
679,101,27,0,5.07,33.83,61880,61981
680,83,29,0,6.17,36.65,61980,62063
681,99,29,0,5.17,34.26,62062,62161
682,97,24,0,5.28,31.64,62160,62257
683,91,64,0,5.63,76.72,62256,62347
684,82,22,0,6.24,35.16,62346,62428
685,89,26,0,5.75,30.97,62427,62516
686,93,43,0,5.51,48.92,62515,62608
687,95,41,0,5.39,39.04,62608,62703
688,73,30,0,7.01,42.07,62702,62775
689,82,20,0,6.24,30.84,62774,62856
690,96,22,0,5.33,35.10,62855,62951
691,103,20,0,4.97,29.99,62950,63053
692,84,30,0,6.10,40.21,63052,63136
693,84,31,0,6.10,40.28,63135,63219
694,114,21,0,4.49,23.95,63218,63332
695,96,23,0,5.33,28.51,63331,63427
696,79,24,0,6.48,37.41,63426,63505
697,109,22,0,4.70,25.64,63504,63613
698,88,26,0,5.82,34.81,63612,63700
699,94,20,0,5.45,32.61,63699,63793
700,89,29,0,5.75,38.43,63792,63881
701,99,22,0,5.17,28.99,63880,63979
702,50,55,0,10.24,138.02,63978,64028
703,102,22,0,5.02,23.73,64027,64129
704,92,33,0,5.57,35.85,64128,64220
705,101,41,0,5.07,41.57,64219,64320
706,100,23,0,5.12,29.33,64319,64419
707,75,29,0,6.83,47.02,64418,64493
708,82,32,0,6.24,43.75,64493,64575
709,101,23,0,5.07,30.58,64575,64676
710,89,21,0,5.75,33.02,64675,64764
711,98,44,0,5.22,37.26,64763,64861
712,92,91,0,5.57,109.68,64860,64952
713,78,33,0,6.56,41.35,64951,65029
714,93,32,0,5.51,33.67,65028,65121
715,111,21,0,4.61,26.67,65120,65231
716,106,22,0,4.83,25.03,65230,65336
717,90,20,0,5.69,34.19,65335,65425
718,102,25,0,5.02,37.71,65424,65526
719,127,20,0,4.03,25.73,65525,65652
720,93,17,0,5.51,26.90,65651,65744
721,91,54,0,5.63,52.50,65743,65834
722,102,25,0,5.02,23.27,65833,65935
723,100,18,0,5.12,20.09,65934,66034
724,73,72,0,7.01,97.14,66033,66106
725,81,20,0,6.32,30.39,66105,66186
726,94,45,0,5.45,43.40,66185,66279
727,90,29,0,5.69,32.04,66278,66368
728,74,29,0,6.92,39.02,66367,66441
729,100,68,0,5.12,63.57,66440,66540
730,84,115,0,6.10,165.28,66539,66623
731,95,29,0,5.39,39.08,66622,66717
732,84,20,0,6.10,29.56,66716,66800
733,89,30,0,5.75,43.89,66799,66888
734,97,24,0,5.28,33.99,66888,66985
735,105,26,0,4.88,27.59,66984,67089
736,87,19,0,5.89,32.49,67089,67176
737,93,25,0,5.51,36.92,67175,67268
738,98,27,0,5.22,30.01,67267,67365
739,83,30,0,6.17,44.16,67364,67447
740,79,19,0,6.48,34.20,67447,67526
741,91,30,0,5.63,42.83,67525,67616
742,106,22,0,4.83,25.95,67615,67721
743,107,19,0,4.79,23.78,67720,67827
744,98,21,0,5.22,29.09,67826,67924
745,99,22,0,5.17,23.21,67924,68023
746,101,19,0,5.07,24.16,68022,68123
747,62,27,0,8.26,41.55,68123,68185
748,86,59,0,5.95,62.95,68184,68270
749,96,28,0,5.33,32.01,68269,68365
750,76,28,0,6.74,35.72,68364,68440
751,90,20,0,5.69,26.15,68439,68529
752,82,24,0,6.24,31.36,68528,68610
753,91,31,0,5.63,39.77,68609,68700
754,89,28,0,5.75,32.95,68699,68788
755,102,18,0,5.02,24.18,68787,68889
756,98,22,0,5.22,28.62,68888,68986
757,100,23,0,5.12,29.55,68985,69085
758,116,27,0,4.41,29.95,69084,69200
759,100,21,0,5.12,27.95,69199,69299
760,83,20,0,6.17,37.03,69298,69381
761,91,20,0,5.63,31.77,69380,69471
762,85,21,0,6.02,40.02,69470,69555
763,103,20,0,4.97,30.88,69554,69657
764,91,48,0,5.63,49.97,69656,69747
765,113,18,0,4.53,22.11,69746,69859
766,86,23,0,5.95,33.79,69859,69945
767,98,24,0,5.22,34.19,69945,70043
768,97,33,0,5.28,33.62,70042,70139
769,70,35,0,7.31,47.56,70138,70208
770,106,20,0,4.83,27.20,70208,70314
771,82,40,0,6.24,52.72,70313,70395
772,100,22,0,5.12,32.95,70394,70494
773,111,21,0,4.61,26.24,70493,70604
774,90,23,0,5.69,37.97,70603,70693
775,88,24,0,5.82,35.31,70692,70780
776,78,28,0,6.56,44.09,70779,70857
777,74,31,0,6.92,43.78,70856,70930
778,110,18,0,4.65,24.83,70929,71039
779,90,19,0,5.69,28.66,71038,71128
780,90,35,0,5.69,36.61,71127,71217
781,100,44,0,5.12,39.25,71216,71316
782,72,26,0,7.11,39.18,71315,71387
783,83,28,0,6.17,38.67,71386,71469
784,118,30,0,4.34,27.95,71469,71587
785,89,24,0,5.75,32.05,71586,71675
786,105,24,0,4.88,27.59,71674,71779
787,99,20,0,5.17,30.12,71778,71877
788,79,35,0,6.48,46.20,71876,71955
789,77,20,0,6.65,35.47,71954,72031
790,86,20,0,5.95,28.77,72030,72116
791,108,20,0,4.74,23.41,72115,72223
792,106,31,0,4.83,38.25,72223,72329
793,85,22,0,6.02,33.13,72328,72413
794,109,32,0,4.70,33.94,72412,72521
795,106,19,0,4.83,25.05,72520,72626
796,88,20,0,5.82,36.33,72625,72713
797,80,21,0,6.40,36.71,72712,72792
798,90,22,0,5.69,24.04,72791,72881
799,98,48,0,5.22,46.48,72880,72978
800,98,27,0,5.22,30.15,72978,73076
801,104,32,0,4.92,34.47,73075,73179
802,77,23,0,6.65,36.23,73178,73255
803,99,32,0,5.17,35.78,73254,73353
804,93,33,0,5.51,37.88,73352,73445
805,94,21,0,5.45,32.27,73444,73538
806,93,30,0,5.51,34.72,73537,73630
807,82,35,0,6.24,47.55,73629,73711
808,91,22,0,5.63,28.92,73710,73801
809,85,24,0,6.02,36.07,73800,73885
810,108,22,0,4.74,30.84,73884,73992
811,97,52,0,5.28,50.90,73991,74088
812,98,22,0,5.22,27.13,74087,74185
813,106,25,0,4.83,30.88,74184,74290
814,109,25,0,4.70,30.47,74289,74398
815,87,22,0,5.89,36.56,74397,74484
816,95,23,0,5.39,37.37,74484,74579
817,91,38,0,5.63,36.50,74578,74669
818,85,21,0,6.02,31.03,74668,74753
819,87,32,0,5.89,44.22,74752,74839
820,83,31,0,6.17,48.43,74838,74921
821,78,21,0,6.56,33.86,74920,74998
822,93,27,0,5.51,38.96,74998,75091
823,102,20,0,5.02,28.10,75090,75192
824,87,47,0,5.89,48.65,75191,75278
825,103,77,0,4.97,73.06,75277,75380
826,110,22,0,4.65,27.84,75380,75490
827,85,49,0,6.02,64.63,75489,75574
828,85,20,0,6.02,30.40,75573,75658
829,96,34,0,5.33,36.35,75657,75753
830,113,19,0,4.53,22.62,75752,75865
831,87,21,0,5.89,29.02,75865,75952
832,77,49,0,6.65,74.07,75951,76028
833,103,43,0,4.97,39.83,76027,76130
834,102,23,0,5.02,29.69,76130,76232
835,111,22,0,4.61,28.45,76231,76342
836,90,58,0,5.69,57.66,76341,76431
837,108,22,0,4.74,27.84,76430,76538
838,86,30,0,5.95,42.63,76537,76623
839,104,25,0,4.92,29.86,76622,76726
840,102,36,0,5.02,35.71,76725,76827
841,78,43,0,6.56,56.76,76826,76904
842,96,37,0,5.33,36.39,76903,76999
843,100,24,0,5.12,28.33,76999,77099
844,79,65,0,6.48,75.09,77098,77177
845,88,24,0,5.82,36.31,77176,77264
846,87,24,0,5.89,38.84,77263,77350
847,103,50,0,4.97,43.76,77349,77452
848,81,38,0,6.32,43.35,77451,77532
849,80,87,0,6.40,118.61,77531,77611
850,102,29,0,5.02,30.98,77611,77713
851,84,21,0,6.10,33.94,77712,77796
852,95,22,0,5.39,27.77,77795,77890
853,92,28,0,5.57,32.29,77890,77982
854,98,23,0,5.22,31.13,77981,78079
855,83,27,0,6.17,35.78,78078,78161
856,112,26,0,4.57,26.89,78160,78272
857,99,25,0,5.17,28.89,78271,78370
858,73,25,0,7.01,47.63,78369,78442
859,102,22,0,5.02,26.20,78441,78543
860,89,22,0,5.75,31.71,78542,78631
861,105,25,0,4.88,32.64,78630,78735
862,98,22,0,5.22,27.26,78734,78832
863,96,19,0,5.33,26.83,78831,78927
864,75,42,0,6.83,49.42,78926,79001
865,92,21,0,5.57,30.20,79000,79092
866,101,20,0,5.07,25.05,79091,79192
867,103,21,0,4.97,32.82,79191,79294
868,96,21,0,5.33,35.68,79293,79389
869,97,21,0,5.28,26.55,79388,79485
870,93,36,0,5.51,40.92,79484,79577
871,93,20,0,5.51,32.29,79577,79670
872,98,38,0,5.22,37.68,79669,79767
873,91,23,0,5.63,36.87,79766,79857
874,100,33,0,5.12,37.97,79856,79956
875,93,20,0,5.51,25.97,79955,80048
876,88,26,0,5.82,33.88,80048,80136
877,96,22,0,5.33,28.97,80136,80232
878,88,48,0,5.82,50.15,80231,80319
879,104,18,0,4.92,22.65,80319,80423
880,97,69,0,5.28,64.82,80422,80519
881,93,23,0,5.51,31.48,80518,80611
882,75,25,0,6.83,40.46,80610,80685
883,105,22,0,4.88,25.52,80684,80789
884,98,20,0,5.22,29.83,80789,80887
885,98,23,0,5.22,31.99,80887,80985
886,102,20,0,5.02,27.14,80984,81086
887,97,26,0,5.28,32.80,81085,81182
888,88,47,0,5.82,57.06,81181,81269
889,90,27,0,5.69,35.75,81269,81359
890,96,27,0,5.33,31.12,81358,81454
891,84,27,0,6.10,32.61,81453,81537
892,97,21,0,5.28,30.92,81537,81634
893,99,22,0,5.17,27.94,81633,81732
894,92,27,0,5.57,32.77,81731,81823
895,80,33,0,6.40,42.59,81822,81902
896,97,20,0,5.28,31.87,81901,81998
897,109,31,0,4.70,31.46,81997,82106
898,104,58,0,4.92,55.07,82105,82209
899,91,20,0,5.63,29.29,82208,82299
900,97,24,0,5.28,31.15,82298,82395
901,111,21,0,4.61,28.44,82394,82505
902,102,19,0,5.02,22.98,82505,82607
903,84,32,0,6.10,39.56,82606,82690
904,123,23,0,4.16,22.48,82689,82812
905,85,23,0,6.02,36.45,82811,82896
906,86,32,0,5.95,33.46,82896,82982
907,95,24,0,5.39,32.24,82981,83076
908,92,24,0,5.57,31.53,83075,83167
909,86,39,0,5.95,40.81,83166,83252
910,79,51,0,6.48,58.30,83251,83330
911,108,25,0,4.74,32.58,83329,83437
912,87,21,0,5.89,31.25,83436,83523
913,74,23,0,6.92,45.34,83522,83596
914,88,122,0,5.82,186.26,83595,83683
915,95,21,0,5.39,30.55,83682,83777
916,77,21,0,6.65,37.24,83776,83853
917,89,20,0,5.75,27.85,83852,83941
918,85,20,0,6.02,34.38,83940,84025
919,100,20,0,5.12,24.87,84024,84124
920,95,24,0,5.39,31.88,84123,84218
921,90,21,0,5.69,27.97,84217,84307
922,86,20,0,5.95,35.44,84306,84392
923,64,62,0,8.00,88.22,84392,84456
924,93,24,0,5.51,32.87,84455,84548
925,100,22,0,5.12,27.33,84547,84647
926,98,20,0,5.22,33.01,84646,84744
927,88,38,0,5.82,37.24,84743,84831
928,85,27,0,6.02,33.11,84830,84915
929,84,50,0,6.10,56.80,84914,84998
930,92,30,0,5.57,39.46,84997,85089
931,104,24,0,4.92,28.05,85088,85192
932,99,22,0,5.17,23.86,85191,85290
933,99,20,0,5.17,32.49,85290,85389
934,61,61,0,8.39,82.86,85388,85449
935,82,23,0,6.24,31.06,85448,85530
936,99,20,0,5.17,26.40,85529,85628
937,90,44,0,5.69,47.88,85627,85717
938,108,45,0,4.74,41.19,85716,85824
939,91,27,0,5.63,25.18,85823,85914
940,99,24,0,5.17,28.95,85913,86012
941,84,19,0,6.10,32.68,86011,86095
942,76,32,0,6.74,43.98,86094,86170
943,69,25,0,7.42,49.75,86169,86238
944,82,25,0,6.24,40.79,86237,86319
945,102,32,0,5.02,32.88,86318,86420
946,98,22,0,5.22,34.32,86419,86517
947,89,23,0,5.75,32.32,86516,86605
948,102,20,0,5.02,28.33,86604,86706
949,107,27,0,4.79,29.53,86705,86812
950,121,19,0,4.23,23.45,86811,86932
951,87,31,0,5.89,38.54,86931,87018
952,104,28,0,4.92,25.97,87017,87121
953,79,21,0,6.48,35.09,87120,87199
954,77,57,0,6.65,75.73,87198,87275
955,95,19,0,5.39,34.68,87275,87370
956,103,26,0,4.97,27.25,87370,87473
957,92,28,0,5.57,40.25,87472,87564
958,119,19,0,4.30,21.56,87563,87682
959,110,28,0,4.65,34.12,87681,87791
960,90,27,0,5.69,37.95,87790,87880
961,96,19,0,5.33,20.87,87879,87975
962,88,30,0,5.82,37.90,87974,88062
963,82,36,0,6.24,44.77,88062,88144
964,75,22,0,6.83,38.89,88143,88218
965,94,36,0,5.45,40.08,88217,88311
966,103,27,0,4.97,26.77,88311,88414
967,90,23,0,5.69,28.44,88413,88503
968,101,25,0,5.07,29.37,88502,88603
969,81,26,0,6.32,30.69,88602,88683
970,87,27,0,5.89,28.63,88682,88769
971,80,31,0,6.40,35.89,88768,88848
972,88,29,0,5.82,38.83,88847,88935
973,70,48,0,7.31,60.96,88934,89004
974,96,20,0,5.33,29.08,89003,89099
975,77,20,0,6.65,32.20,89098,89175
976,95,52,0,5.39,59.75,89175,89270
977,94,22,0,5.45,30.33,89269,89363
978,81,25,0,6.32,37.40,89362,89443
979,94,37,0,5.45,37.18,89443,89537
980,84,70,0,6.10,75.54,89536,89620
981,91,23,0,5.63,32.98,89619,89710
982,89,34,0,5.75,48.16,89709,89798
983,100,25,0,5.12,28.89,89797,89897
984,108,25,0,4.74,33.25,89896,90004
985,101,22,0,5.07,32.02,90003,90104
986,98,21,0,5.22,29.87,90103,90201
987,107,20,0,4.79,23.18,90200,90307
988,109,21,0,4.70,28.43,90307,90416
989,98,21,0,5.22,31.44,90415,90513
990,91,44,0,5.63,46.32,90512,90603
991,81,29,0,6.32,43.60,90602,90683
992,80,66,0,6.40,75.84,90682,90762
993,78,26,0,6.56,37.84,90761,90839
994,104,25,0,4.92,26.97,90838,90942
995,92,23,0,5.57,29.55,90941,91033
996,95,27,0,5.39,34.49,91032,91127
997,103,28,0,4.97,32.98,91126,91229
998,66,29,0,7.76,55.58,91229,91295
999,86,20,0,5.95,30.63,91294,91380
1000,97,27,0,5.28,38.98,91379,91476
1001,80,31,0,6.40,38.27,91476,91556
1002,85,20,0,6.02,31.22,91555,91640
1003,94,24,0,5.45,32.57,91639,91733
1004,85,95,0,6.02,123.55,91732,91817
1005,100,22,0,5.12,32.79,91816,91916
1006,85,51,0,6.02,56.35,91915,92000
1007,99,21,0,5.17,29.56,91999,92098
1008,99,24,0,5.17,31.88,92097,92196
1009,82,52,0,6.24,71.53,92195,92277
1010,91,30,0,5.63,33.46,92276,92367
1011,99,25,0,5.17,27.17,92367,92466
1012,78,24,0,6.56,37.19,92465,92543
1013,91,44,0,5.63,43.66,92542,92633
1014,100,93,0,5.12,102.55,92632,92732
1015,110,21,0,4.65,23.95,92731,92841
1016,92,25,0,5.57,39.70,92840,92932
1017,72,31,0,7.11,47.04,92931,93003
1018,105,21,0,4.88,28.55,93002,93107
1019,101,31,0,5.07,27.99,93106,93207
1020,96,18,0,5.33,27.33,93206,93302
1021,95,56,0,5.39,58.36,93301,93396
1022,96,40,0,5.33,46.24,93395,93491
1023,101,35,0,5.07,44.96,93490,93591
1024,80,25,0,6.40,43.69,93590,93670
1025,84,31,0,6.10,42.21,93669,93753
1026,74,52,0,6.92,73.29,93752,93826
1027,84,52,0,6.10,60.56,93825,93909
1028,92,23,0,5.57,34.53,93908,94000
1029,90,22,0,5.69,28.86,93999,94089
1030,86,26,0,5.95,36.32,94088,94174
1031,106,21,0,4.83,27.10,94173,94279
1032,82,53,0,6.24,65.28,94279,94361
1033,96,46,0,5.33,44.06,94361,94457
1034,103,27,0,4.97,32.07,94456,94559
1035,109,19,0,4.70,28.38,94558,94667
1036,97,26,0,5.28,37.48,94666,94763
1037,76,27,0,6.74,35.35,94762,94838
1038,86,33,0,5.95,39.90,94837,94923
1039,113,21,0,4.53,27.97,94922,95035
1040,97,27,0,5.28,33.42,95034,95131
1041,100,23,0,5.12,28.87,95131,95231
1042,83,74,0,6.17,88.74,95231,95314
1043,109,20,0,4.70,25.42,95313,95422
1044,66,37,0,7.76,61.09,95421,95487
1045,105,19,0,4.88,24.79,95486,95591
1046,94,25,0,5.45,29.06,95590,95684
1047,98,24,0,5.22,33.26,95683,95781
1048,99,20,0,5.17,26.83,95781,95880
1049,98,30,0,5.22,41.34,95879,95977
1050,89,39,0,5.75,43.62,95977,96066
1051,84,29,0,6.10,38.51,96065,96149
1052,101,22,0,5.07,31.69,96148,96249
1053,115,33,0,4.45,35.03,96248,96363
1054,82,32,0,6.24,43.72,96362,96444
1055,96,20,0,5.33,26.68,96443,96539
1056,104,21,0,4.92,28.42,96538,96642
1057,106,32,0,4.83,31.33,96642,96748
1058,96,25,0,5.33,33.18,96748,96844
1059,83,30,0,6.17,39.49,96843,96926
1060,104,24,0,4.92,29.09,96926,97030
1061,115,21,0,4.45,24.33,97029,97144
1062,120,18,0,4.27,27.26,97143,97263
1063,88,20,0,5.82,28.04,97262,97350
1064,92,27,0,5.57,36.44,97349,97441
1065,109,21,0,4.70,27.20,97440,97549
1066,95,23,0,5.39,31.50,97548,97643
1067,83,58,0,6.17,67.95,97642,97725
1068,92,22,0,5.57,32.27,97724,97816
1069,110,21,0,4.65,24.55,97815,97925
1070,84,23,0,6.10,31.25,97924,98008
1071,86,28,0,5.95,37.23,98007,98093
1072,105,58,0,4.88,65.18,98092,98197
1073,102,23,0,5.02,30.57,98196,98298
1074,104,20,0,4.92,32.76,98297,98401
1075,103,22,0,4.97,28.13,98400,98503
1076,84,36,0,6.10,39.49,98502,98586
1077,74,25,0,6.92,36.05,98585,98659
1078,101,25,0,5.07,34.10,98658,98759
1079,96,26,0,5.33,27.18,98759,98855
1080,89,32,0,5.75,37.20,98855,98944
1081,91,20,0,5.63,33.27,98943,99034
1082,71,30,0,7.21,36.19,99033,99104
1083,103,20,0,4.97,29.52,99103,99206
1084,86,22,0,5.95,28.53,99205,99291
1085,111,24,0,4.61,22.42,99290,99401
1086,91,59,0,5.63,61.75,99400,99491
1087,107,32,0,4.79,31.53,99491,99598
1088,87,19,0,5.89,29.60,99597,99684
1089,80,23,0,6.40,35.34,99683,99763
1090,83,41,0,6.17,47.66,99763,99846
1091,96,34,0,5.33,40.99,99845,99941
1092,100,30,0,5.12,33.59,99940,100040
1093,78,20,0,6.56,38.53,100039,100117
1094,89,20,0,5.75,27.80,100116,100205
1095,73,49,0,7.01,62.42,100204,100277
1096,94,30,0,5.45,33.29,100276,100370
1097,98,19,0,5.22,28.54,100369,100467
1098,88,28,0,5.82,33.31,100466,100554
1099,99,39,0,5.17,47.88,100553,100652
1100,101,24,0,5.07,26.98,100651,100752
1101,95,21,0,5.39,28.79,100751,100846
1102,89,48,0,5.75,49.71,100846,100935
1103,87,25,0,5.89,39.85,100934,101021
1104,96,24,0,5.33,31.51,101020,101116
1105,99,22,0,5.17,30.24,101115,101214
1106,93,22,0,5.51,28.66,101214,101307
1107,72,37,0,7.11,52.10,101306,101378
1108,90,30,0,5.69,38.75,101377,101467
1109,95,30,0,5.39,36.51,101466,101561
1110,91,25,0,5.63,36.83,101560,101651
1111,87,20,0,5.89,31.89,101650,101737
1112,88,56,0,5.82,63.85,101736,101824
1113,85,21,0,6.02,31.95,101823,101908
1114,79,48,0,6.48,51.34,101907,101986
1115,95,23,0,5.39,26.24,101986,102081
1116,79,23,0,6.48,40.63,102081,102160
1117,116,22,0,4.41,23.57,102159,102275
1118,84,27,0,6.10,38.92,102274,102358
1119,96,27,0,5.33,32.31,102357,102453
1120,87,42,0,5.89,47.48,102452,102539
1121,98,21,0,5.22,27.17,102538,102636
1122,76,22,0,6.74,38.64,102635,102711
1123,94,24,0,5.45,38.72,102711,102805
1124,110,20,0,4.65,20.77,102804,102914
1125,83,21,0,6.17,32.45,102913,102996
1126,112,19,0,4.57,27.12,102995,103107
1127,101,26,0,5.07,36.54,103106,103207
1128,86,41,0,5.95,41.42,103206,103292
1129,82,37,0,6.24,56.26,103291,103373
1130,105,32,0,4.88,30.43,103372,103477
1131,90,20,0,5.69,35.90,103476,103566
1132,92,28,0,5.57,31.46,103565,103657
1133,74,25,0,6.92,35.51,103656,103730
1134,98,28,0,5.22,34.11,103729,103827
1135,97,20,0,5.28,23.62,103826,103923
1136,107,22,0,4.79,28.80,103922,104029
1137,107,48,0,4.79,43.46,104029,104136
1138,95,26,0,5.39,33.42,104135,104230
1139,100,23,0,5.12,30.31,104229,104329
1140,100,23,0,5.12,36.17,104328,104428
1141,69,32,0,7.42,40.04,104427,104496
1142,91,49,0,5.63,60.61,104495,104586
1143,107,27,0,4.79,30.94,104585,104692
1144,92,20,0,5.57,31.85,104692,104784
1145,96,27,0,5.33,37.35,104783,104879
1146,82,41,0,6.24,40.23,104878,104960
1147,101,21,0,5.07,33.65,104959,105060
1148,67,110,0,7.64,211.33,105059,105126
1149,99,32,0,5.17,35.62,105125,105224
1150,97,20,0,5.28,29.97,105223,105320
1151,108,26,0,4.74,27.08,105319,105427
1152,67,87,0,7.64,166.74,105426,105493
1153,88,60,0,5.82,67.88,105492,105580
1154,95,30,0,5.39,31.82,105579,105674
1155,109,20,0,4.70,25.57,105673,105782
1156,83,21,0,6.17,27.06,105782,105865
1157,90,23,0,5.69,34.10,105864,105954
1158,96,32,0,5.33,38.18,105953,106049
1159,103,24,0,4.97,32.86,106049,106152
1160,71,57,0,7.21,70.25,106151,106222
1161,85,49,0,6.02,61.46,106221,106306
1162,95,20,0,5.39,32.09,106305,106400
1163,104,20,0,4.92,23.82,106399,106503
1164,72,54,0,7.11,52.57,106502,106574
1165,108,39,0,4.74,34.84,106573,106681
1166,106,25,0,4.83,30.22,106680,106786
1167,85,18,0,6.02,32.23,106786,106871
1168,110,19,0,4.65,28.24,106870,106980
1169,114,20,0,4.49,26.16,106979,107093
1170,83,20,0,6.17,37.51,107092,107175
1171,86,85,0,5.95,116.84,107174,107260
1172,92,30,0,5.57,38.79,107259,107351
1173,93,24,0,5.51,29.07,107350,107443
1174,111,25,0,4.61,27.12,107442,107553
1175,102,20,0,5.02,26.16,107552,107654
1176,101,26,0,5.07,33.99,107653,107754
1177,97,33,0,5.28,38.30,107753,107850
1178,91,26,0,5.63,31.84,107849,107940
1179,96,28,0,5.33,39.08,107939,108035
1180,92,38,0,5.57,46.62,108034,108126
1181,108,19,0,4.74,23.25,108125,108233
1182,108,23,0,4.74,24.49,108232,108340
1183,98,48,0,5.22,51.34,108339,108437
1184,78,24,0,6.56,40.02,108436,108514
1185,86,42,0,5.95,53.88,108513,108599
1186,105,18,0,4.88,27.69,108598,108703
1187,103,57,0,4.97,47.25,108702,108805
1188,111,17,0,4.61,20.42,108804,108915
1189,97,27,0,5.28,33.19,108915,109012
1190,78,22,0,6.56,37.09,109011,109089
1191,86,42,0,5.95,46.18,109089,109175
1192,83,41,0,6.17,46.21,109174,109257
1193,85,45,0,6.02,57.53,109256,109341
1194,81,39,0,6.32,64.98,109340,109421
1195,82,41,0,6.24,60.09,109420,109502
1196,99,23,0,5.17,31.64,109501,109600
1197,89,56,0,5.75,57.26,109599,109688
1198,101,19,0,5.07,24.82,109687,109788
1199,90,25,0,5.69,30.59,109787,109877
1200,101,21,0,5.07,33.69,109876,109977
1201,119,50,0,4.30,35.34,109976,110095
1202,95,36,0,5.39,40.20,110094,110189
1203,86,27,0,5.95,33.21,110188,110274
1204,79,26,0,6.48,35.44,110273,110352
1205,90,20,0,5.69,28.68,110351,110441
1206,86,24,0,5.95,36.81,110441,110527
1207,111,19,0,4.61,28.08,110526,110637
1208,71,41,0,7.21,67.80,110636,110707
1209,89,109,0,5.75,149.80,110706,110795
1210,101,22,0,5.07,28.72,110794,110895
1211,110,20,0,4.65,24.90,110894,111004
1212,84,53,0,6.10,61.99,111003,111087
1213,90,20,0,5.69,27.88,111086,111176
1214,108,19,0,4.74,26.77,111176,111284
1215,98,25,0,5.22,28.44,111284,111382
1216,95,26,0,5.39,31.37,111381,111476
1217,115,19,0,4.45,20.91,111475,111590
1218,99,20,0,5.17,34.40,111589,111688
1219,81,21,0,6.32,34.02,111687,111768
1220,94,22,0,5.45,29.25,111767,111861
1221,99,18,0,5.17,26.77,111860,111959
1222,94,20,0,5.45,34.25,111958,112052
1223,95,19,0,5.39,23.02,112051,112146
1224,110,33,0,4.65,30.48,112146,112256
1225,99,25,0,5.17,31.76,112256,112355
1226,106,19,0,4.83,27.14,112355,112461
1227,110,33,0,4.65,30.14,112460,112570
1228,83,23,0,6.17,34.81,112569,112652
1229,107,19,0,4.79,26.56,112651,112758
1230,96,35,0,5.33,37.20,112757,112853
1231,97,32,0,5.28,34.55,112852,112949
1232,59,40,0,8.68,73.10,112948,113007
1233,93,20,0,5.51,29.93,113007,113100
1234,99,41,0,5.17,43.64,113100,113199
1235,103,27,0,4.97,28.44,113198,113301
1236,74,66,0,6.92,93.59,113300,113374
1237,78,31,0,6.56,31.96,113374,113452
1238,93,21,0,5.51,27.65,113451,113544
1239,105,21,0,4.88,28.74,113543,113648
1240,96,22,0,5.33,31.76,113647,113743
1241,100,24,0,5.12,31.67,113742,113842
1242,99,20,0,5.17,31.54,113842,113941
1243,99,24,0,5.17,39.46,113940,114039
1244,71,58,0,7.21,87.07,114038,114109
1245,89,32,0,5.75,41.92,114108,114197
1246,102,21,0,5.02,25.39,114196,114298
1247,100,17,0,5.12,26.15,114297,114397
1248,80,57,0,6.40,69.62,114396,114476
1249,74,32,0,6.92,45.99,114475,114549
1250,84,28,0,6.10,34.75,114548,114632
1251,91,43,0,5.63,57.44,114631,114722
1252,92,23,0,5.57,30.27,114721,114813
1253,82,66,0,6.24,77.82,114812,114894
1254,78,70,0,6.56,84.91,114893,114971
1255,80,29,0,6.40,45.62,114970,115050
1256,87,101,0,5.89,137.50,115050,115137
1257,98,19,0,5.22,28.21,115136,115234
1258,78,60,0,6.56,72.58,115233,115311
1259,108,30,0,4.74,32.66,115310,115418
1260,95,20,0,5.39,28.51,115417,115512
1261,82,25,0,6.24,41.60,115511,115593
1262,106,21,0,4.83,34.16,115592,115698
1263,111,19,0,4.61,24.36,115697,115808
1264,71,69,0,7.21,95.46,115807,115878
1265,95,23,0,5.39,30.43,115877,115972
1266,83,24,0,6.17,37.27,115971,116054
1267,98,25,0,5.22,34.70,116053,116151
1268,85,23,0,6.02,39.34,116150,116235
1269,93,38,0,5.51,41.02,116235,116328
1270,111,23,0,4.61,25.05,116327,116438
1271,87,20,0,5.89,28.95,116438,116525
1272,99,23,0,5.17,27.41,116525,116624
1273,93,23,0,5.51,31.24,116623,116716
1274,74,24,0,6.92,39.51,116715,116789
1275,115,17,0,4.45,19.67,116789,116904
1276,93,23,0,5.51,31.15,116903,116996
1277,100,21,0,5.12,28.07,116995,117095
1278,117,21,0,4.38,22.58,117094,117211
1279,83,29,0,6.17,37.42,117210,117293
1280,100,22,0,5.12,29.25,117292,117392
1281,106,15,0,4.83,19.65,117392,117498
1282,90,23,0,5.69,38.30,117497,117587
1283,100,25,0,5.12,28.41,117586,117686
1284,89,71,0,5.75,81.40,117685,117774
1285,98,29,0,5.22,33.62,117773,117871
1286,76,20,0,6.74,37.72,117870,117946
1287,79,26,0,6.48,36.50,117946,118025
1288,105,26,0,4.88,27.25,118024,118129
1289,109,17,0,4.70,21.18,118128,118237
1290,92,31,0,5.57,38.90,118236,118328
1291,106,23,0,4.83,26.93,118327,118433
1292,87,35,0,5.89,46.93,118432,118519
1293,112,20,0,4.57,23.01,118518,118630
1294,102,22,0,5.02,27.23,118629,118731
1295,101,27,0,5.07,29.11,118731,118832
1296,77,21,0,6.65,39.76,118831,118908
1297,88,25,0,5.82,29.90,118907,118995
1298,90,56,0,5.69,58.30,118994,119084
1299,79,113,0,6.48,178.98,119083,119162
1300,101,19,0,5.07,31.37,119162,119263
1301,88,21,0,5.82,31.22,119262,119350
1302,106,29,0,4.83,28.74,119350,119456
1303,95,27,0,5.39,31.00,119455,119550
1304,92,23,0,5.57,36.16,119549,119641
1305,99,26,0,5.17,34.30,119640,119739
1306,96,36,0,5.33,32.68,119739,119835
1307,76,34,0,6.74,49.96,119834,119910
1308,77,29,0,6.65,41.42,119909,119986
1309,97,47,0,5.28,48.18,119986,120083
1310,103,27,0,4.97,30.53,120082,120185
1311,86,26,0,5.95,31.93,120184,120270
1312,92,20,0,5.57,31.98,120269,120361
1313,65,62,0,7.88,123.77,120361,120426
1314,101,20,0,5.07,25.57,120425,120526
1315,94,24,0,5.45,28.25,120525,120619
1316,98,26,0,5.22,36.48,120618,120716
1317,86,45,0,5.95,51.74,120715,120801
1318,130,23,0,3.94,27.80,120800,120930
1319,82,20,0,6.24,35.06,120929,121011
1320,88,19,0,5.82,29.79,121010,121098
1321,83,20,0,6.17,30.48,121097,121180
1322,105,19,0,4.88,30.43,121179,121284
1323,94,27,0,5.45,27.31,121283,121377
1324,63,45,0,8.13,80.17,121376,121439
1325,99,25,0,5.17,33.62,121439,121538
1326,93,20,0,5.51,28.47,121538,121631
1327,90,41,0,5.69,43.19,121630,121720
1328,105,20,0,4.88,28.38,121720,121825
1329,99,21,0,5.17,35.11,121824,121923
1330,95,24,0,5.39,29.92,121922,122017
1331,87,19,0,5.89,26.40,122016,122103
1332,102,46,0,5.02,51.57,122102,122204
1333,82,20,0,6.24,26.79,122203,122285
1334,114,23,0,4.49,28.99,122284,122398
1335,89,37,0,5.75,36.46,122397,122486
1336,101,20,0,5.07,25.91,122485,122586
1337,98,20,0,5.22,26.36,122585,122683
1338,100,20,0,5.12,30.07,122682,122782
1339,69,20,0,7.42,36.74,122781,122850
1340,101,78,0,5.07,79.89,122849,122950
1341,99,21,0,5.17,31.62,122950,123049
1342,84,39,0,6.10,40.66,123048,123132
1343,111,28,0,4.61,28.42,123131,123242
1344,97,36,0,5.28,32.82,123241,123338
1345,104,31,0,4.92,32.90,123338,123442
1346,69,177,0,7.42,459.17,123441,123510
1347,93,24,0,5.51,26.34,123510,123603
1348,100,19,0,5.12,23.41,123602,123702
1349,72,46,0,7.11,78.46,123701,123773
1350,88,21,0,5.82,31.97,123772,123860
1351,108,25,0,4.74,29.73,123860,123968
1352,97,19,0,5.28,22.88,123967,124064
1353,107,20,0,4.79,27.48,124063,124170
1354,115,19,0,4.45,23.52,124169,124284
1355,69,57,0,7.42,75.92,124283,124352
1356,96,51,0,5.33,54.53,124351,124447
1357,91,23,0,5.63,36.23,124446,124537
1358,92,23,0,5.57,32.57,124537,124629
1359,81,35,0,6.32,47.06,124629,124710
1360,90,22,0,5.69,36.37,124709,124799
1361,87,52,0,5.89,73.64,124798,124885
1362,97,21,0,5.28,30.80,124884,124981
1363,96,20,0,5.33,25.97,124980,125076
1364,99,19,0,5.17,28.53,125075,125174
1365,97,24,0,5.28,32.86,125173,125270
1366,83,34,0,6.17,45.42,125269,125352
1367,88,20,0,5.82,33.22,125351,125439
1368,82,36,0,6.24,47.99,125438,125520
1369,92,55,0,5.57,58.14,125519,125611
1370,100,75,0,5.12,73.45,125610,125710
1371,93,23,0,5.51,30.59,125709,125802
1372,102,20,0,5.02,29.57,125801,125903
1373,96,22,0,5.33,21.43,125902,125998
1374,92,19,0,5.57,27.81,125997,126089
1375,73,77,0,7.01,111.47,126088,126161
1376,91,27,0,5.63,31.95,126160,126251
1377,92,33,0,5.57,48.57,126250,126342
1378,91,21,0,5.63,30.59,126341,126432
1379,101,35,0,5.07,41.85,126432,126533
1380,81,33,0,6.32,40.61,126532,126613
1381,99,18,0,5.17,24.40,126613,126712
1382,96,19,0,5.33,23.64,126711,126807
1383,92,22,0,5.57,34.48,126806,126898
1384,94,20,0,5.45,25.76,126897,126991
1385,91,19,0,5.63,26.06,126990,127081
1386,104,24,0,4.92,28.86,127080,127184
1387,93,23,0,5.51,36.19,127183,127276
1388,77,30,0,6.65,44.41,127275,127352
1389,66,57,0,7.76,73.64,127351,127417
1390,102,20,0,5.02,25.47,127416,127518
1391,91,30,0,5.63,34.92,127517,127608
1392,104,27,0,4.92,36.94,127607,127711
1393,88,31,0,5.82,33.99,127710,127798
1394,99,30,0,5.17,36.36,127797,127896
1395,97,22,0,5.28,29.46,127895,127992
1396,88,28,0,5.82,35.10,127991,128079
1397,75,50,0,6.83,53.72,128078,128153
1398,95,26,0,5.39,29.59,128152,128247
1399,90,29,0,5.69,40.84,128246,128336
1400,105,21,0,4.88,26.68,128335,128440
1401,100,20,0,5.12,23.49,128439,128539
1402,108,21,0,4.74,28.66,128539,128647
1403,75,27,0,6.83,38.04,128646,128721
1404,91,28,0,5.63,29.22,128720,128811
1405,99,25,0,5.17,33.39,128810,128909
1406,87,47,0,5.89,50.75,128908,128995
1407,93,35,0,5.51,35.35,128994,129087
1408,97,26,0,5.28,33.56,129086,129183
1409,92,22,0,5.57,31.88,129182,129274
1410,96,46,0,5.33,49.18,129273,129369
1411,92,55,0,5.57,65.51,129368,129460
1412,114,24,0,4.49,27.78,129459,129573
1413,109,20,0,4.70,26.67,129572,129681
1414,95,25,0,5.39,29.06,129680,129775
1415,89,20,0,5.75,27.26,129774,129863
1416,103,23,0,4.97,28.22,129862,129965
1417,69,101,0,7.42,170.30,129964,130033
1418,89,23,0,5.75,35.58,130033,130122
1419,96,20,0,5.33,30.76,130122,130218
1420,75,21,0,6.83,40.44,130217,130292
1421,64,23,0,8.00,40.62,130291,130355
1422,96,20,0,5.33,32.78,130354,130450
1423,100,30,0,5.12,28.05,130449,130549
1424,101,19,0,5.07,24.18,130548,130649
1425,93,20,0,5.51,25.88,130648,130741
1426,76,33,0,6.74,44.11,130740,130816
1427,97,25,0,5.28,29.62,130815,130912
1428,94,28,0,5.45,41.03,130911,131005
1429,89,27,0,5.75,31.38,131004,131093
1430,94,25,0,5.45,34.31,131092,131186
1431,88,27,0,5.82,42.56,131185,131273
1432,98,20,0,5.22,28.95,131272,131370
1433,91,26,0,5.63,37.38,131370,131461
1434,105,24,0,4.88,26.17,131460,131565
1435,96,21,0,5.33,29.26,131564,131660
1436,111,21,0,4.61,31.19,131659,131770
1437,78,23,0,6.56,43.14,131769,131847
1438,72,43,0,7.11,53.82,131847,131919
1439,85,25,0,6.02,35.25,131918,132003
1440,102,26,0,5.02,33.84,132002,132104
1441,101,21,0,5.07,31.11,132103,132204
1442,96,26,0,5.33,40.85,132203,132299
1443,96,42,0,5.33,42.68,132298,132394
1444,89,20,0,5.75,24.37,132393,132482
1445,94,24,0,5.45,31.37,132481,132575
1446,91,19,0,5.63,30.74,132574,132665
1447,85,32,0,6.02,39.95,132664,132749
1448,81,22,0,6.32,34.09,132749,132830
1449,86,30,0,5.95,30.28,132829,132915
1450,74,53,0,6.92,69.86,132914,132988
1451,73,38,0,7.01,59.25,132987,133060
1452,90,20,0,5.69,29.35,133059,133149
1453,63,47,0,8.13,68.59,133148,133211
1454,97,23,0,5.28,32.04,133210,133307
1455,97,22,0,5.28,25.87,133306,133403
1456,80,22,0,6.40,36.19,133402,133482
1457,95,44,0,5.39,57.92,133481,133576
1458,99,28,0,5.17,27.64,133575,133674
1459,104,28,0,4.92,32.76,133673,133777
1460,96,20,0,5.33,30.68,133776,133872
1461,99,35,0,5.17,35.23,133871,133970
1462,98,27,0,5.22,32.44,133969,134067
1463,93,21,0,5.51,29.22,134067,134160
1464,83,21,0,6.17,32.36,134160,134243
1465,90,31,0,5.69,38.30,134242,134332
1466,75,112,0,6.83,180.46,134331,134406
1467,93,23,0,5.51,42.34,134405,134498
1468,88,34,0,5.82,39.56,134497,134585
1469,90,22,0,5.69,28.95,134584,134674
1470,92,26,0,5.57,34.33,134673,134765
1471,84,39,0,6.10,45.85,134764,134848
1472,95,19,0,5.39,24.66,134847,134942
1473,92,47,0,5.57,41.94,134941,135033
1474,75,27,0,6.83,41.42,135032,135107
1475,105,33,0,4.88,34.20,135106,135211
1476,86,23,0,5.95,33.30,135210,135296
1477,91,35,0,5.63,35.31,135296,135387
1478,95,22,0,5.39,24.24,135386,135481
1479,93,23,0,5.51,36.38,135480,135573
1480,121,22,0,4.23,19.47,135572,135693
1481,105,37,0,4.88,34.03,135692,135797
1482,95,20,0,5.39,32.68,135796,135891
1483,72,27,0,7.11,36.02,135891,135963
1484,99,38,0,5.17,40.49,135962,136061
1485,105,20,0,4.88,23.98,136061,136166
1486,84,50,0,6.10,69.73,136166,136250
1487,112,26,0,4.57,31.26,136249,136361
1488,98,27,0,5.22,38.70,136360,136458
1489,109,22,0,4.70,27.07,136458,136567
1490,110,29,0,4.65,34.55,136566,136676
1491,82,22,0,6.24,25.84,136675,136757
1492,92,19,0,5.57,25.88,136756,136848
1493,97,21,0,5.28,32.14,136847,136944
1494,103,23,0,4.97,29.54,136943,137046
1495,86,29,0,5.95,34.07,137045,137131
1496,90,38,0,5.69,42.15,137131,137221
1497,93,19,0,5.51,28.70,137221,137314
1498,105,19,0,4.88,24.15,137314,137419
1499,79,27,0,6.48,38.58,137419,137498
1500,86,30,0,5.95,43.30,137497,137583
1501,90,25,0,5.69,35.46,137582,137672
1502,99,23,0,5.17,29.05,137671,137770
1503,87,22,0,5.89,36.86,137769,137856
1504,108,20,0,4.74,26.82,137855,137963
1505,83,22,0,6.17,34.00,137962,138045
1506,111,32,0,4.61,29.59,138044,138155
1507,81,73,0,6.32,82.46,138154,138235
1508,102,22,0,5.02,23.98,138234,138336
1509,101,26,0,5.07,35.53,138335,138436
1510,72,112,0,7.11,184.96,138435,138507
1511,102,21,0,5.02,31.23,138506,138608
1512,57,125,0,8.98,273.03,138607,138664
1513,101,38,0,5.07,38.52,138663,138764
1514,83,19,0,6.17,26.91,138763,138846
1515,110,27,0,4.65,25.57,138845,138955
1516,108,31,0,4.74,31.25,138954,139062
1517,102,21,0,5.02,23.84,139061,139163
1518,114,22,0,4.49,26.55,139162,139276
1519,95,20,0,5.39,24.26,139275,139370
1520,69,32,0,7.42,48.42,139369,139438
1521,92,31,0,5.57,45.72,139438,139530
1522,107,26,0,4.79,26.65,139530,139637
1523,118,19,0,4.34,20.95,139636,139754
1524,93,30,0,5.51,35.67,139754,139847
1525,93,29,0,5.51,32.49,139846,139939
1526,84,78,0,6.10,101.06,139938,140022
1527,101,27,0,5.07,34.12,140021,140122
1528,97,23,0,5.28,29.48,140121,140218
1529,92,21,0,5.57,27.27,140217,140309
1530,87,23,0,5.89,30.58,140308,140395
1531,113,26,0,4.53,27.22,140394,140507
1532,77,63,0,6.65,82.85,140506,140583
1533,60,120,0,8.53,297.65,140582,140642
1534,96,54,0,5.33,52.64,140641,140737
1535,97,20,0,5.28,32.37,140737,140834
1536,96,37,0,5.33,40.33,140833,140929
1537,91,22,0,5.63,26.30,140928,141019
1538,94,51,0,5.45,56.78,141018,141112
1539,89,36,0,5.75,42.14,141111,141200
1540,81,41,0,6.32,46.59,141200,141281
1541,103,29,0,4.97,33.15,141280,141383
1542,95,25,0,5.39,32.68,141382,141477
1543,94,40,0,5.45,36.16,141476,141570
1544,92,58,0,5.57,67.16,141569,141661
1545,96,22,0,5.33,33.64,141660,141756
1546,77,25,0,6.65,37.11,141755,141832
1547,95,32,0,5.39,34.72,141831,141926
1548,86,45,0,5.95,52.18,141925,142011
1549,102,22,0,5.02,28.73,142010,142112
1550,94,20,0,5.45,27.76,142111,142205
1551,95,47,0,5.39,46.36,142204,142299
1552,95,40,0,5.39,36.03,142298,142393
1553,89,29,0,5.75,34.12,142393,142482
1554,85,50,0,6.02,47.95,142481,142566
1555,66,67,0,7.76,90.52,142565,142631
1556,100,26,0,5.12,36.33,142630,142730
1557,112,19,0,4.57,25.37,142729,142841
1558,82,88,0,6.24,113.53,142840,142922
1559,60,31,0,8.53,50.88,142921,142981
1560,97,25,0,5.28,34.32,142980,143077
1561,80,24,0,6.40,33.44,143076,143156
1562,96,55,0,5.33,50.37,143155,143251
1563,73,57,0,7.01,61.19,143250,143323
1564,83,100,0,6.17,138.24,143322,143405
1565,75,59,0,6.83,69.32,143404,143479
1566,99,42,0,5.17,34.77,143478,143577
1567,95,22,0,5.39,30.76,143577,143672
1568,115,22,0,4.45,24.46,143671,143786
1569,92,23,0,5.57,33.55,143785,143877
1570,82,20,0,6.24,31.82,143876,143958
1571,74,22,0,6.92,37.34,143958,144032
1572,94,30,0,5.45,35.20,144031,144125
1573,93,25,0,5.51,35.28,144124,144217
1574,75,22,0,6.83,35.93,144216,144291
1575,87,20,0,5.89,29.55,144290,144377
1576,98,31,0,5.22,34.01,144376,144474
1577,98,23,0,5.22,30.64,144473,144571
1578,93,44,0,5.51,52.14,144570,144663
1579,63,86,0,8.13,129.79,144662,144725
1580,86,51,0,5.95,55.53,144724,144810
1581,107,19,0,4.79,19.55,144809,144916
1582,106,27,0,4.83,27.24,144915,145021
1583,77,33,0,6.65,44.88,145020,145097
1584,104,19,0,4.92,26.88,145096,145200
1585,89,33,0,5.75,42.93,145199,145288
1586,106,21,0,4.83,21.61,145287,145393
1587,103,29,0,4.97,33.87,145392,145495
1588,78,27,0,6.56,31.35,145494,145572
1589,102,22,0,5.02,26.06,145571,145673
1590,111,23,0,4.61,27.35,145673,145784
1591,71,27,0,7.21,51.97,145784,145855
1592,87,22,0,5.89,31.55,145854,145941
1593,82,38,0,6.24,45.60,145940,146022
1594,100,20,0,5.12,25.77,146021,146121
1595,101,20,0,5.07,30.42,146120,146221
1596,95,26,0,5.39,38.15,146220,146315
1597,104,30,0,4.92,36.24,146315,146419
1598,89,21,0,5.75,28.93,146418,146507
1599,87,24,0,5.89,39.96,146506,146593
1600,92,25,0,5.57,32.01,146592,146684
1601,100,20,0,5.12,29.41,146684,146784
1602,91,29,0,5.63,41.07,146783,146874
1603,93,20,0,5.51,27.65,146874,146967
1604,113,20,0,4.53,24.89,146966,147079
1605,88,45,0,5.82,45.04,147078,147166
1606,67,42,0,7.64,54.14,147165,147232
1607,105,25,0,4.88,31.69,147231,147336
1608,99,18,0,5.17,22.00,147335,147434
1609,96,21,0,5.33,28.91,147433,147529
1610,99,22,0,5.17,27.54,147528,147627
1611,102,20,0,5.02,28.04,147626,147728
1612,97,26,0,5.28,38.28,147728,147825
1613,92,24,0,5.57,25.55,147824,147916
1614,81,19,0,6.32,32.54,147915,147996
1615,86,48,0,5.95,63.39,147995,148081
1616,122,24,0,4.20,22.60,148080,148202
1617,93,24,0,5.51,35.58,148201,148294
1618,94,31,0,5.45,34.12,148293,148387
1619,101,28,0,5.07,33.99,148387,148488
1620,83,48,0,6.17,52.96,148487,148570
1621,100,19,0,5.12,28.59,148569,148669
1622,87,31,0,5.89,37.80,148668,148755
1623,85,50,0,6.02,52.49,148755,148840
1624,93,34,0,5.51,43.33,148840,148933
1625,85,24,0,6.02,39.79,148932,149017
1626,98,21,0,5.22,27.99,149016,149114
1627,77,33,0,6.65,50.25,149113,149190
1628,106,19,0,4.83,33.29,149189,149295
1629,84,25,0,6.10,37.40,149294,149378
1630,97,27,0,5.28,32.45,149377,149474
1631,86,35,0,5.95,45.63,149473,149559
1632,100,20,0,5.12,31.31,149558,149658
1633,73,31,0,7.01,40.62,149657,149730
1634,97,20,0,5.28,29.40,149729,149826
1635,81,34,0,6.32,46.49,149825,149906
1636,85,20,0,6.02,29.93,149905,149990
1637,97,19,0,5.28,26.98,149989,150086
1638,92,24,0,5.57,29.29,150085,150177
1639,78,25,0,6.56,41.71,150176,150254
1640,88,32,0,5.82,42.42,150253,150341
1641,112,26,0,4.57,28.08,150340,150452
1642,96,28,0,5.33,31.45,150451,150547
1643,67,90,0,7.64,135.66,150546,150613
1644,86,25,0,5.95,36.56,150612,150698
1645,87,32,0,5.89,45.48,150697,150784
1646,90,28,0,5.69,36.19,150783,150873
1647,94,48,0,5.45,51.74,150872,150966
1648,89,33,0,5.75,41.67,150965,151054
1649,81,39,0,6.32,60.84,151053,151134
1650,80,22,0,6.40,32.94,151133,151213
1651,96,19,0,5.33,31.89,151212,151308
1652,109,34,0,4.70,33.37,151307,151416
1653,92,23,0,5.57,36.40,151416,151508
1654,69,36,0,7.42,59.26,151507,151576
1655,94,21,0,5.45,28.80,151575,151669
1656,92,30,0,5.57,37.46,151668,151760
1657,91,115,0,5.63,157.29,151759,151850
1658,89,27,0,5.75,34.14,151849,151938
1659,81,40,0,6.32,43.95,151938,152019
1660,89,33,0,5.75,33.85,152018,152107
1661,101,23,0,5.07,29.13,152106,152207
1662,85,25,0,6.02,36.71,152206,152291
1663,101,40,0,5.07,47.25,152291,152392
1664,100,25,0,5.12,33.53,152391,152491
1665,94,23,0,5.45,29.40,152490,152584
1666,88,21,0,5.82,29.31,152583,152671
1667,86,21,0,5.95,34.09,152671,152757
1668,105,22,0,4.88,25.18,152756,152861
1669,94,20,0,5.45,32.61,152860,152954
1670,91,32,0,5.63,41.53,152953,153044
1671,78,29,0,6.56,40.53,153043,153121
1672,98,23,0,5.22,32.93,153120,153218
1673,93,20,0,5.51,30.92,153217,153310
1674,100,20,0,5.12,26.57,153309,153409
1675,97,19,0,5.28,31.77,153408,153505
1676,80,22,0,6.40,32.47,153504,153584
1677,73,48,0,7.01,60.40,153583,153656
1678,111,20,0,4.61,26.26,153655,153766
1679,95,21,0,5.39,30.30,153765,153860
1680,107,34,0,4.79,34.00,153859,153966
1681,97,21,0,5.28,34.35,153965,154062
1682,87,20,0,5.89,32.47,154061,154148
1683,69,32,0,7.42,46.50,154147,154216
1684,101,20,0,5.07,27.89,154215,154316
1685,81,42,0,6.32,53.87,154315,154396
1686,94,19,0,5.45,32.74,154395,154489
1687,100,26,0,5.12,31.59,154489,154589
1688,80,36,0,6.40,42.67,154589,154669
1689,93,24,0,5.51,35.60,154668,154761
1690,96,22,0,5.33,30.43,154760,154856
1691,102,21,0,5.02,26.73,154855,154957
1692,94,35,0,5.45,36.80,154956,155050
1693,112,20,0,4.57,20.37,155049,155161
1694,87,78,0,5.89,90.88,155161,155248
1695,101,15,0,5.07,20.18,155247,155348
1696,84,73,0,6.10,79.68,155347,155431
1697,108,22,0,4.74,30.62,155431,155539
1698,57,152,0,8.98,450.65,155538,155595
1699,79,53,0,6.48,61.01,155594,155673
1700,81,20,0,6.32,32.12,155672,155753
1701,68,31,0,7.53,58.46,155752,155820
1702,92,44,0,5.57,48.01,155819,155911
1703,100,24,0,5.12,35.81,155910,156010
1704,94,20,0,5.45,34.74,156009,156103
1705,98,62,0,5.22,56.44,156102,156200
1706,101,19,0,5.07,21.09,156200,156301
1707,85,52,0,6.02,53.58,156300,156385
1708,102,44,0,5.02,45.74,156384,156486
1709,103,34,0,4.97,32.79,156486,156589
1710,58,191,0,8.83,622.52,156588,156646
1711,92,35,0,5.57,44.68,156645,156737
1712,106,22,0,4.83,31.27,156736,156842
1713,62,32,0,8.26,45.39,156841,156903
1714,49,253,0,10.45,1275.96,156902,156951
1715,104,23,0,4.92,28.19,156950,157054
1716,94,20,0,5.45,29.61,157053,157147
1717,93,27,0,5.51,36.03,157146,157239
1718,82,23,0,6.24,36.40,157238,157320
1719,80,21,0,6.40,24.69,157319,157399
1720,103,28,0,4.97,34.20,157398,157501
1721,95,25,0,5.39,36.41,157500,157595
1722,78,33,0,6.56,39.53,157595,157673
1723,102,23,0,5.02,32.27,157672,157774
1724,87,31,0,5.89,35.41,157773,157860
1725,96,23,0,5.33,34.45,157859,157955
1726,100,25,0,5.12,30.09,157954,158054
1727,117,25,0,4.38,28.05,158053,158170
1728,89,51,0,5.75,64.39,158170,158259
1729,87,47,0,5.89,49.85,158258,158345
1730,89,21,0,5.75,29.87,158344,158433
1731,101,22,0,5.07,30.14,158432,158533
1732,102,20,0,5.02,24.18,158532,158634
1733,90,43,0,5.69,44.53,158633,158723
1734,93,31,0,5.51,37.67,158722,158815
1735,88,20,0,5.82,30.97,158814,158902
1736,109,24,0,4.70,26.58,158901,159010
1737,111,22,0,4.61,29.08,159009,159120
1738,123,24,0,4.16,25.70,159119,159242
1739,121,20,0,4.23,24.79,159241,159362
1740,89,41,0,5.75,46.32,159361,159450
1741,96,40,0,5.33,39.66,159449,159545
1742,90,26,0,5.69,39.50,159544,159634
1743,81,50,0,6.32,62.19,159634,159715
1744,86,34,0,5.95,43.74,159714,159800
1745,86,34,0,5.95,39.44,159799,159885
1746,82,88,0,6.24,116.16,159884,159966
1747,73,31,0,7.01,38.34,159965,160038
1748,91,19,0,5.63,30.39,160037,160128
1749,107,22,0,4.79,27.42,160128,160235
1750,105,22,0,4.88,25.02,160234,160339
1751,98,34,0,5.22,36.05,160338,160436
1752,96,27,0,5.33,36.14,160435,160531
1753,85,20,0,6.02,34.92,160530,160615
1754,91,30,0,5.63,43.27,160615,160706
1755,80,23,0,6.40,33.89,160705,160785
1756,79,42,0,6.48,48.43,160784,160863
1757,92,20,0,5.57,34.94,160862,160954
1758,81,32,0,6.32,40.93,160953,161034
1759,117,21,0,4.38,23.43,161033,161150
1760,93,26,0,5.51,32.51,161150,161243
1761,66,97,0,7.76,160.21,161243,161309
1762,96,28,0,5.33,29.56,161308,161404
1763,87,22,0,5.89,31.53,161403,161490
1764,111,28,0,4.61,32.20,161489,161600
1765,97,40,0,5.28,48.88,161599,161696
1766,100,25,0,5.12,33.17,161695,161795
1767,90,22,0,5.69,38.10,161795,161885
1768,92,44,0,5.57,42.98,161884,161976
1769,71,33,0,7.21,48.53,161975,162046
1770,92,75,0,5.57,79.88,162045,162137
1771,95,23,0,5.39,32.24,162136,162231
1772,70,51,0,7.31,85.59,162231,162301
1773,70,84,0,7.31,127.19,162300,162370
1774,83,34,0,6.17,40.89,162369,162452
1775,90,32,0,5.69,40.48,162451,162541
1776,94,24,0,5.45,28.52,162540,162634
1777,93,39,0,5.51,54.94,162633,162726
1778,90,24,0,5.69,31.06,162725,162815
1779,82,27,0,6.24,38.57,162814,162896
1780,87,25,0,5.89,33.62,162895,162982
1781,78,42,0,6.56,52.71,162981,163059
1782,54,79,0,9.48,158.73,163058,163112
1783,98,20,0,5.22,28.87,163111,163209
1784,84,104,0,6.10,137.78,163209,163293
1785,86,41,0,5.95,47.58,163292,163378
1786,78,22,0,6.56,41.19,163378,163456
1787,84,34,0,6.10,41.78,163455,163539
1788,114,19,0,4.49,22.64,163538,163652
1789,93,19,0,5.51,29.07,163651,163744
1790,80,37,0,6.40,51.17,163743,163823
1791,104,37,0,4.92,34.09,163822,163926
1792,97,36,0,5.28,41.09,163925,164022
1793,102,21,0,5.02,28.59,164021,164123
1794,57,46,0,8.98,75.63,164122,164179
1795,98,20,0,5.22,25.89,164178,164276
1796,79,72,0,6.48,89.64,164276,164355
1797,95,22,0,5.39,30.76,164354,164449
1798,93,26,0,5.51,33.93,164449,164542
1799,96,27,0,5.33,31.58,164541,164637
1800,76,51,0,6.74,65.11,164636,164712
1801,98,29,0,5.22,37.89,164711,164809
1802,92,22,0,5.57,33.51,164808,164900
1803,94,21,0,5.45,25.29,164899,164993
1804,82,22,0,6.24,34.50,164992,165074
1805,99,53,0,5.17,55.52,165073,165172
1806,82,33,0,6.24,47.70,165172,165254
1807,88,34,0,5.82,38.81,165254,165342
1808,83,60,0,6.17,62.89,165341,165424
1809,84,25,0,6.10,37.18,165423,165507
1810,91,20,0,5.63,29.25,165506,165597
1811,95,20,0,5.39,27.88,165596,165691
1812,107,22,0,4.79,26.97,165690,165797
1813,93,44,0,5.51,50.92,165796,165889
1814,88,26,0,5.82,34.99,165888,165976
1815,84,26,0,6.10,32.99,165975,166059
1816,100,20,0,5.12,29.35,166058,166158
1817,103,18,0,4.97,26.30,166157,166260
1818,78,35,0,6.56,46.40,166260,166338
1819,94,20,0,5.45,26.18,166337,166431
1820,100,22,0,5.12,27.27,166430,166530
1821,109,20,0,4.70,21.37,166530,166639
1822,104,24,0,4.92,28.51,166638,166742
1823,70,34,0,7.31,49.87,166741,166811
1824,92,24,0,5.57,38.96,166810,166902
1825,94,33,0,5.45,33.72,166901,166995
1826,98,20,0,5.22,26.97,166994,167092
1827,116,22,0,4.41,24.14,167092,167208
1828,104,24,0,4.92,28.49,167207,167311
1829,96,27,0,5.33,32.06,167310,167406
1830,75,76,0,6.83,98.49,167406,167481
1831,100,22,0,5.12,24.41,167480,167580
1832,98,31,0,5.22,34.46,167579,167677
1833,91,23,0,5.63,33.42,167676,167767
1834,86,34,0,5.95,39.32,167766,167852
1835,97,26,0,5.28,35.17,167852,167949
1836,98,29,0,5.22,33.68,167948,168046
1837,82,40,0,6.24,44.28,168045,168127
1838,80,35,0,6.40,46.74,168126,168206
1839,99,27,0,5.17,32.97,168205,168304
1840,91,23,0,5.63,36.39,168303,168394
1841,102,17,0,5.02,25.84,168393,168495
1842,100,20,0,5.12,30.49,168494,168594
1843,92,21,0,5.57,32.68,168594,168686
1844,94,21,0,5.45,31.89,168686,168780
1845,91,21,0,5.63,27.38,168779,168870
1846,117,19,0,4.38,19.52,168869,168986
1847,103,19,0,4.97,24.73,168986,169089
1848,111,22,0,4.61,32.69,169088,169199
1849,110,21,0,4.65,23.28,169198,169308
1850,112,38,0,4.57,38.49,169307,169419
1851,111,20,0,4.61,23.71,169418,169529
1852,77,50,0,6.65,70.02,169528,169605
1853,87,39,0,5.89,42.10,169604,169691
1854,101,36,0,5.07,41.21,169690,169791
1855,90,22,0,5.69,34.93,169790,169880
1856,90,38,0,5.69,43.06,169879,169969
1857,100,24,0,5.12,29.95,169968,170068
1858,105,26,0,4.88,26.93,170067,170172
1859,58,41,0,8.83,57.25,170171,170229
1860,101,60,0,5.07,54.94,170228,170329
1861,82,22,0,6.24,33.33,170328,170410
1862,102,36,0,5.02,34.31,170409,170511
1863,86,26,0,5.95,34.46,170511,170597
1864,96,25,0,5.33,29.97,170596,170692
1865,92,27,0,5.57,36.53,170691,170783
1866,84,45,0,6.10,55.25,170782,170866
1867,96,31,0,5.33,35.53,170865,170961
1868,82,69,0,6.24,90.06,170960,171042
1869,77,40,0,6.65,56.54,171041,171118
1870,78,22,0,6.56,35.40,171117,171195
1871,83,69,0,6.17,71.63,171195,171278
1872,90,21,0,5.69,35.26,171277,171367
1873,73,37,0,7.01,41.71,171366,171439
1874,100,22,0,5.12,32.79,171438,171538
1875,91,20,0,5.63,29.60,171537,171628
1876,108,20,0,4.74,28.10,171627,171735
1877,89,21,0,5.75,29.24,171734,171823
1878,99,44,0,5.17,42.59,171822,171921
1879,104,33,0,4.92,33.84,171920,172024
1880,107,22,0,4.79,26.99,172023,172130
1881,92,23,0,5.57,42.66,172129,172221
1882,92,21,0,5.57,30.98,172220,172312
1883,86,42,0,5.95,51.35,172311,172397
1884,100,23,0,5.12,34.29,172396,172496
1885,120,18,0,4.27,17.90,172496,172616
1886,93,27,0,5.51,38.83,172615,172708
1887,84,27,0,6.10,36.51,172707,172791
1888,102,19,0,5.02,26.43,172791,172893
1889,95,39,0,5.39,48.47,172892,172987
1890,92,20,0,5.57,31.75,172986,173078
1891,106,22,0,4.83,24.80,173078,173184
1892,87,27,0,5.89,37.34,173183,173270
1893,107,35,0,4.79,35.12,173269,173376
1894,127,20,0,4.03,20.46,173375,173502
1895,91,46,0,5.63,51.57,173501,173592
1896,89,49,0,5.75,52.41,173591,173680
1897,94,21,0,5.45,31.35,173679,173773
1898,80,30,0,6.40,40.66,173772,173852
1899,110,27,0,4.65,29.46,173851,173961
1900,75,26,0,6.83,39.74,173960,174035
1901,92,22,0,5.57,40.96,174034,174126
1902,89,22,0,5.75,32.23,174126,174215
1903,96,22,0,5.33,32.43,174214,174310
1904,95,27,0,5.39,34.32,174309,174404
1905,71,63,0,7.21,79.91,174403,174474
1906,78,35,0,6.56,39.43,174474,174552
1907,105,27,0,4.88,28.62,174551,174656
1908,94,19,0,5.45,29.59,174655,174749
1909,85,34,0,6.02,39.55,174748,174833
1910,113,43,0,4.53,32.36,174832,174945
1911,91,42,0,5.63,48.94,174944,175035
1912,98,48,0,5.22,45.62,175034,175132
1913,103,22,0,4.97,28.22,175131,175234
1914,75,32,0,6.83,38.57,175233,175308
1915,115,26,0,4.45,25.74,175307,175422
1916,70,43,0,7.31,52.93,175421,175491
1917,83,80,0,6.17,101.78,175490,175573
1918,91,23,0,5.63,26.96,175572,175663
1919,107,24,0,4.79,26.37,175663,175770
1920,110,20,0,4.65,25.15,175770,175880
1921,108,20,0,4.74,24.90,175879,175987
1922,99,19,0,5.17,30.12,175986,176085
1923,102,23,0,5.02,30.84,176084,176186
1924,93,71,0,5.51,68.74,176185,176278
1925,84,26,0,6.10,44.40,176277,176361
1926,81,23,0,6.32,43.45,176360,176441
1927,81,60,0,6.32,66.19,176440,176521
1928,102,49,0,5.02,45.96,176520,176622
1929,89,27,0,5.75,30.41,176621,176710
1930,119,25,0,4.30,24.58,176709,176828
1931,80,21,0,6.40,34.97,176827,176907
1932,95,36,0,5.39,40.85,176907,177002
1933,92,20,0,5.57,32.20,177001,177093
1934,112,21,0,4.57,27.92,177092,177204
1935,86,54,0,5.95,69.65,177204,177290
1936,68,28,0,7.53,54.46,177289,177357
1937,105,19,0,4.88,25.10,177356,177461
1938,93,28,0,5.51,38.40,177460,177553
1939,81,33,0,6.32,41.43,177552,177633
1940,87,26,0,5.89,36.75,177632,177719
1941,96,21,0,5.33,30.58,177719,177815
1942,99,37,0,5.17,36.47,177814,177913
1943,84,27,0,6.10,40.32,177912,177996
1944,75,50,0,6.83,78.65,177996,178071
1945,96,29,0,5.33,31.20,178070,178166
1946,98,21,0,5.22,31.48,178165,178263
1947,88,19,0,5.82,28.44,178262,178350
1948,94,24,0,5.45,34.52,178349,178443
1949,68,23,0,7.53,37.07,178442,178510
1950,93,59,0,5.51,76.14,178509,178602
1951,104,31,0,4.92,30.71,178601,178705
1952,103,21,0,4.97,25.58,178704,178807
1953,96,54,0,5.33,59.41,178806,178902
1954,73,29,0,7.01,44.01,178901,178974
1955,88,20,0,5.82,31.88,178973,179061
1956,96,32,0,5.33,34.35,179061,179157
1957,90,25,0,5.69,35.53,179156,179246
1958,83,20,0,6.17,29.15,179246,179329
1959,106,22,0,4.83,28.90,179328,179434
1960,91,22,0,5.63,31.05,179433,179524
1961,97,22,0,5.28,29.75,179523,179620
1962,101,27,0,5.07,33.21,179619,179720
1963,89,49,0,5.75,50.52,179719,179808
1964,87,29,0,5.89,38.01,179807,179894
1965,82,23,0,6.24,33.21,179893,179975
1966,79,27,0,6.48,37.01,179974,180053
1967,91,24,0,5.63,36.17,180052,180143
1968,93,23,0,5.51,32.68,180142,180235
1969,70,121,0,7.31,223.10,180234,180304
1970,86,27,0,5.95,31.28,180304,180390
1971,101,75,0,5.07,82.38,180389,180490
1972,89,75,0,5.75,85.94,180489,180578
1973,104,27,0,4.92,28.19,180577,180681
1974,84,27,0,6.10,35.75,180680,180764
1975,108,20,0,4.74,26.71,180763,180871
1976,100,27,0,5.12,28.23,180870,180970
1977,61,108,0,8.39,217.75,180969,181030
1978,79,35,0,6.48,43.72,181029,181108
1979,93,35,0,5.51,36.66,181107,181200
1980,99,21,0,5.17,31.05,181199,181298
1981,105,40,0,4.88,47.40,181297,181402
1982,99,20,0,5.17,25.54,181401,181500
1983,89,37,0,5.75,35.20,181499,181588
1984,104,32,0,4.92,32.88,181587,181691
1985,87,19,0,5.89,31.69,181690,181777
1986,127,20,0,4.03,18.77,181776,181903
1987,83,38,0,6.17,44.81,181902,181985
1988,88,21,0,5.82,33.40,181984,182072
1989,79,69,0,6.48,95.03,182071,182150
1990,102,26,0,5.02,26.06,182149,182251
1991,87,22,0,5.89,41.57,182251,182338
1992,84,24,0,6.10,31.54,182337,182421
1993,101,19,0,5.07,25.69,182420,182521
1994,82,24,0,6.24,36.67,182520,182602
1995,89,61,0,5.75,67.92,182601,182690
1996,90,20,0,5.69,29.88,182689,182779
1997,93,32,0,5.51,38.90,182778,182871
1998,77,26,0,6.65,36.64,182870,182947
1999,113,21,0,4.53,27.49,182946,183059
2000,84,20,0,6.10,33.35,183058,183142
2001,73,36,0,7.01,58.04,183142,183215
2002,107,24,0,4.79,23.70,183214,183321
2003,86,38,0,5.95,42.56,183320,183406
2004,105,25,0,4.88,32.57,183405,183510
2005,93,21,0,5.51,29.45,183510,183603
2006,88,36,0,5.82,42.92,183602,183690
2007,104,28,0,4.92,31.03,183689,183793
2008,78,22,0,6.56,36.53,183792,183870
2009,84,44,0,6.10,60.56,183869,183953
2010,100,37,0,5.12,37.09,183952,184052
2011,92,24,0,5.57,28.68,184051,184143
2012,103,24,0,4.97,28.69,184142,184245
2013,116,22,0,4.41,25.26,184244,184360
2014,61,64,0,8.39,97.75,184360,184421
2015,88,35,0,5.82,43.24,184420,184508
2016,84,22,0,6.10,32.01,184507,184591
2017,88,40,0,5.82,42.40,184590,184678
2018,98,70,0,5.22,68.58,184677,184775
2019,80,20,0,6.40,34.17,184774,184854
2020,95,21,0,5.39,30.83,184853,184948
2021,84,34,0,6.10,41.18,184948,185032
2022,103,31,0,4.97,33.81,185031,185134
2023,76,84,0,6.74,114.59,185133,185209
2024,97,31,0,5.28,32.45,185209,185306
2025,104,20,0,4.92,25.01,185305,185409
2026,89,20,0,5.75,33.04,185408,185497
2027,69,50,0,7.42,69.37,185496,185565
2028,76,136,0,6.74,249.67,185564,185640
2029,74,19,0,6.92,30.62,185639,185713
2030,74,25,0,6.92,47.80,185712,185786
2031,96,26,0,5.33,30.24,185786,185882
2032,97,40,0,5.28,45.33,185881,185978
2033,87,55,0,5.89,58.91,185977,186064
2034,96,20,0,5.33,27.70,186063,186159
2035,93,30,0,5.51,36.38,186158,186251
2036,87,43,0,5.89,51.94,186250,186337
2037,84,36,0,6.10,53.80,186336,186420
2038,92,18,0,5.57,29.72,186419,186511
2039,92,39,0,5.57,39.75,186510,186602
2040,107,21,0,4.79,28.21,186601,186708
2041,83,21,0,6.17,32.12,186707,186790
2042,104,26,0,4.92,31.47,186789,186893
2043,77,27,0,6.65,35.99,186892,186969
2044,103,28,0,4.97,36.36,186968,187071
2045,76,29,0,6.74,44.38,187070,187146
2046,78,43,0,6.56,50.19,187145,187223
2047,75,28,0,6.83,49.56,187222,187297
2048,73,58,0,7.01,73.82,187296,187369
2049,90,31,0,5.69,40.08,187368,187458
2050,97,28,0,5.28,31.97,187457,187554
2051,89,54,0,5.75,55.67,187554,187643
2052,102,21,0,5.02,28.69,187642,187744
2053,93,20,0,5.51,31.05,187743,187836
2054,84,24,0,6.10,37.21,187835,187919
2055,95,22,0,5.39,31.29,187918,188013
2056,105,20,0,4.88,22.43,188012,188117
2057,64,23,0,8.00,44.59,188117,188181
2058,101,26,0,5.07,34.12,188180,188281
2059,83,27,0,6.17,41.37,188280,188363
2060,95,18,0,5.39,23.96,188363,188458
2061,105,32,0,4.88,34.09,188458,188563
2062,94,20,0,5.45,27.42,188562,188656
2063,84,37,0,6.10,46.04,188655,188739
2064,91,26,0,5.63,32.81,188739,188830
2065,88,20,0,5.82,35.44,188829,188917
2066,75,40,0,6.83,52.60,188916,188991
2067,89,26,0,5.75,34.88,188990,189079
2068,102,28,0,5.02,29.84,189078,189180
2069,92,21,0,5.57,31.09,189179,189271
2070,100,25,0,5.12,32.97,189270,189370
2071,100,23,0,5.12,28.53,189369,189469
2072,88,28,0,5.82,36.63,189469,189557
2073,98,22,0,5.22,33.34,189556,189654
2074,112,21,0,4.57,26.55,189653,189765
2075,84,20,0,6.10,32.85,189764,189848
2076,84,23,0,6.10,38.54,189847,189931
2077,112,21,0,4.57,26.82,189931,190043
2078,101,19,0,5.07,21.87,190043,190144
2079,91,28,0,5.63,40.54,190144,190235
2080,95,31,0,5.39,31.08,190234,190329
2081,90,27,0,5.69,34.75,190329,190419
2082,98,24,0,5.22,29.24,190418,190516
2083,99,20,0,5.17,29.25,190515,190614
2084,92,31,0,5.57,36.46,190613,190705
2085,102,20,0,5.02,26.47,190704,190806
2086,69,31,0,7.42,42.39,190805,190874
2087,100,23,0,5.12,30.43,190874,190974
2088,102,31,0,5.02,40.12,190973,191075
2089,92,28,0,5.57,30.98,191074,191166
2090,87,29,0,5.89,38.24,191165,191252
2091,118,23,0,4.34,25.65,191251,191369
2092,87,32,0,5.89,39.83,191368,191455
2093,78,49,0,6.56,58.07,191454,191532
2094,111,27,0,4.61,30.13,191531,191642
2095,73,24,0,7.01,40.75,191641,191714
2096,103,21,0,4.97,27.68,191713,191816
2097,94,25,0,5.45,33.65,191815,191909
2098,84,21,0,6.10,32.49,191908,191992
2099,117,20,0,4.38,25.40,191992,192109
2100,94,24,0,5.45,27.93,192109,192203
2101,78,60,0,6.56,87.37,192203,192281
2102,111,58,0,4.61,47.37,192280,192391
2103,94,18,0,5.45,25.10,192390,192484
2104,100,21,0,5.12,28.43,192483,192583
2105,94,19,0,5.45,29.84,192582,192676
2106,100,29,0,5.12,32.51,192675,192775
2107,73,35,0,7.01,40.26,192774,192847
2108,94,20,0,5.45,26.91,192846,192940
2109,93,22,0,5.51,31.39,192940,193033
2110,88,26,0,5.82,35.42,193032,193120
2111,81,24,0,6.32,43.38,193119,193200
2112,78,22,0,6.56,38.53,193200,193278
2113,78,23,0,6.56,35.81,193277,193355
2114,112,20,0,4.57,24.74,193354,193466
2115,98,23,0,5.22,31.28,193465,193563
2116,95,23,0,5.39,26.55,193562,193657
2117,115,23,0,4.45,24.30,193656,193771
2118,93,23,0,5.51,33.41,193770,193863
2119,97,22,0,5.28,28.39,193862,193959
2120,105,21,0,4.88,27.59,193958,194063
2121,82,100,0,6.24,137.77,194062,194144
2122,119,20,0,4.30,22.72,194143,194262
2123,105,33,0,4.88,34.72,194261,194366
2124,110,27,0,4.65,30.90,194365,194475
2125,114,20,0,4.49,21.65,194475,194589
2126,89,21,0,5.75,35.80,194588,194677
2127,100,31,0,5.12,32.03,194676,194776
2128,66,27,0,7.76,47.43,194775,194841
2129,87,20,0,5.89,35.37,194840,194927
2130,80,27,0,6.40,36.87,194926,195006
2131,89,20,0,5.75,27.31,195006,195095
2132,97,24,0,5.28,36.84,195094,195191
2133,87,34,0,5.89,41.27,195190,195277
2134,86,23,0,5.95,38.84,195276,195362
2135,97,20,0,5.28,24.35,195361,195458
2136,103,24,0,4.97,30.09,195457,195560
2137,85,55,0,6.02,54.61,195559,195644
2138,94,24,0,5.45,39.82,195643,195737
2139,91,45,0,5.63,44.67,195736,195827
2140,105,20,0,4.88,26.70,195826,195931
2141,98,21,0,5.22,27.05,195930,196028
2142,81,23,0,6.32,32.86,196027,196108
2143,87,37,0,5.89,44.06,196107,196194
2144,92,24,0,5.57,31.33,196193,196285
2145,98,22,0,5.22,32.79,196284,196382
2146,87,29,0,5.89,38.40,196381,196468
2147,91,21,0,5.63,29.55,196467,196558
2148,90,27,0,5.69,36.33,196558,196648
2149,107,22,0,4.79,21.91,196647,196754
2150,95,22,0,5.39,32.11,196753,196848
2151,104,19,0,4.92,26.19,196847,196951
2152,100,26,0,5.12,33.95,196950,197050
2153,94,38,0,5.45,39.91,197049,197143
2154,98,20,0,5.22,32.52,197142,197240
2155,91,24,0,5.63,32.61,197239,197330
2156,75,32,0,6.83,44.30,197329,197404
2157,94,23,0,5.45,29.31,197403,197497
2158,96,27,0,5.33,40.18,197496,197592
2159,90,24,0,5.69,39.55,197592,197682
2160,96,31,0,5.33,35.47,197681,197777
2161,97,48,0,5.28,46.65,197776,197873
2162,78,28,0,6.56,43.81,197872,197950
2163,99,19,0,5.17,30.02,197949,198048
2164,69,38,0,7.42,45.49,198047,198116
2165,91,26,0,5.63,31.25,198115,198206
2166,64,22,0,8.00,31.75,198205,198269
2167,94,26,0,5.45,32.69,198268,198362
2168,94,20,0,5.45,29.78,198362,198456
2169,112,19,0,4.57,24.57,198455,198567
2170,91,29,0,5.63,38.37,198566,198657
2171,98,32,0,5.22,30.48,198656,198754
2172,96,21,0,5.33,28.14,198753,198849
2173,95,20,0,5.39,33.73,198848,198943
2174,85,23,0,6.02,31.36,198942,199027
2175,85,37,0,6.02,39.20,199026,199111
2176,88,28,0,5.82,33.67,199110,199198
2177,103,30,0,4.97,35.78,199197,199300
2178,86,41,0,5.95,42.04,199299,199385
2179,96,22,0,5.33,28.47,199384,199480
2180,88,20,0,5.82,32.65,199479,199567
2181,103,25,0,4.97,31.17,199567,199670
2182,119,17,0,4.30,20.50,199669,199788
2183,86,27,0,5.95,37.60,199787,199873
2184,111,21,0,4.61,26.42,199872,199983
2185,100,28,0,5.12,31.05,199982,200082
2186,86,22,0,5.95,28.23,200082,200168
2187,70,29,0,7.31,41.79,200167,200237
2188,91,27,0,5.63,36.70,200236,200327
2189,83,66,0,6.17,81.15,200326,200409
2190,100,20,0,5.12,28.45,200408,200508
2191,64,39,0,8.00,53.94,200507,200571
2192,101,20,0,5.07,24.86,200571,200672
2193,108,19,0,4.74,23.56,200671,200779
2194,87,22,0,5.89,32.72,200778,200865
2195,107,20,0,4.79,24.45,200864,200971
2196,99,19,0,5.17,27.13,200970,201069
2197,85,62,0,6.02,63.48,201068,201153
2198,94,22,0,5.45,29.89,201152,201246
2199,89,29,0,5.75,42.66,201245,201334
2200,91,50,0,5.63,47.46,201333,201424
2201,105,20,0,4.88,26.03,201423,201528
2202,99,26,0,5.17,30.85,201527,201626
2203,93,26,0,5.51,37.45,201625,201718
2204,72,31,0,7.11,36.52,201718,201790
2205,86,24,0,5.95,31.21,201789,201875
2206,101,20,0,5.07,27.91,201874,201975
2207,90,21,0,5.69,34.73,201975,202065
2208,73,37,0,7.01,53.55,202064,202137
2209,77,86,0,6.65,117.97,202137,202214
2210,102,31,0,5.02,32.12,202213,202315
2211,99,20,0,5.17,32.06,202314,202413
2212,89,49,0,5.75,49.69,202412,202501
2213,85,30,0,6.02,39.13,202500,202585
2214,99,19,0,5.17,30.08,202584,202683
2215,88,31,0,5.82,43.31,202682,202770
2216,95,20,0,5.39,29.94,202769,202864
2217,70,20,0,7.31,38.99,202863,202933
2218,113,21,0,4.53,24.00,202933,203046
2219,91,67,0,5.63,69.51,203045,203136
2220,105,32,0,4.88,34.15,203135,203240
2221,92,21,0,5.57,32.48,203239,203331
2222,102,30,0,5.02,31.90,203330,203432
2223,96,36,0,5.33,39.35,203431,203527
2224,103,22,0,4.97,33.31,203526,203629
2225,110,21,0,4.65,23.59,203628,203738
2226,29,372,0,17.66,4508.85,203737,203766
2227,100,20,0,5.12,24.43,203765,203865
2228,86,28,0,5.95,44.02,203864,203950
2229,60,32,0,8.53,48.45,203949,204009
2230,100,28,0,5.12,33.41,204008,204108
2231,95,23,0,5.39,31.40,204107,204202
2232,101,21,0,5.07,27.45,204202,204303
2233,103,25,0,4.97,26.73,204302,204405
2234,86,54,0,5.95,50.58,204404,204490
2235,81,35,0,6.32,48.42,204489,204570
2236,92,48,0,5.57,52.68,204569,204661
2237,93,32,0,5.51,37.39,204660,204753
2238,91,29,0,5.63,36.28,204752,204843
2239,96,20,0,5.33,27.53,204842,204938
2240,97,20,0,5.28,28.51,204938,205035
2241,101,31,0,5.07,27.93,205034,205135
2242,87,30,0,5.89,34.58,205134,205221
2243,96,23,0,5.33,32.28,205220,205316
2244,82,36,0,6.24,35.72,205315,205397
2245,96,19,0,5.33,28.14,205396,205492
2246,102,22,0,5.02,36.18,205491,205593
2247,95,28,0,5.39,31.73,205592,205687
2248,106,36,0,4.83,37.14,205687,205793
2249,106,22,0,4.83,27.71,205792,205898
2250,74,27,0,6.92,44.72,205897,205971
2251,75,29,0,6.83,40.14,205970,206045
2252,98,41,0,5.22,48.46,206044,206142
2253,100,20,0,5.12,22.85,206141,206241
2254,96,28,0,5.33,29.22,206240,206336
2255,83,42,0,6.17,59.30,206336,206419
2256,111,23,0,4.61,26.38,206419,206530
2257,86,19,0,5.95,31.04,206529,206615
2258,84,102,0,6.10,136.90,206614,206698
2259,93,31,0,5.51,33.69,206697,206790
2260,88,45,0,5.82,47.31,206789,206877
2261,94,25,0,5.45,27.99,206876,206970
2262,67,28,0,7.64,47.66,206969,207036
2263,97,24,0,5.28,27.13,207035,207132
2264,108,33,0,4.74,33.58,207131,207239
2265,91,65,0,5.63,76.87,207238,207329
2266,83,36,0,6.17,39.25,207328,207411
2267,73,27,0,7.01,33.47,207410,207483
2268,93,32,0,5.51,34.83,207482,207575
2269,96,35,0,5.33,35.87,207574,207670
2270,108,42,0,4.74,39.14,207669,207777
2271,91,24,0,5.63,30.23,207776,207867
2272,93,24,0,5.51,37.60,207866,207959
2273,89,22,0,5.75,31.33,207958,208047
2274,93,50,0,5.51,54.16,208046,208139
2275,93,31,0,5.51,34.96,208139,208232
2276,88,35,0,5.82,39.92,208231,208319
2277,83,65,0,6.17,73.30,208318,208401
2278,69,69,0,7.42,83.23,208400,208469
2279,102,27,0,5.02,34.67,208469,208571
2280,92,21,0,5.57,32.42,208571,208663
2281,96,37,0,5.33,34.28,208662,208758
2282,93,26,0,5.51,27.37,208757,208850
2283,110,21,0,4.65,22.14,208849,208959
2284,107,27,0,4.79,28.30,208958,209065
2285,105,25,0,4.88,23.37,209064,209169
2286,85,66,0,6.02,67.65,209168,209253
2287,99,22,0,5.17,28.16,209252,209351
2288,87,21,0,5.89,30.01,209350,209437
2289,62,31,0,8.26,49.06,209436,209498
2290,84,72,0,6.10,84.44,209497,209581
2291,93,22,0,5.51,28.40,209580,209673
2292,83,30,0,6.17,44.62,209672,209755
2293,90,28,0,5.69,40.99,209754,209844
2294,92,25,0,5.57,32.09,209843,209935
2295,88,24,0,5.82,34.83,209934,210022
2296,110,29,0,4.65,33.37,210021,210131
2297,76,27,0,6.74,39.14,210130,210206
2298,110,20,0,4.65,22.88,210206,210316
2299,108,23,0,4.74,26.01,210315,210423
2300,88,40,0,5.82,40.94,210422,210510
2301,94,51,0,5.45,48.31,210509,210603
2302,81,34,0,6.32,43.13,210602,210683
2303,90,35,0,5.69,41.30,210682,210772
2304,114,22,0,4.49,22.78,210771,210885
2305,93,21,0,5.51,35.65,210884,210977
2306,93,38,0,5.51,42.59,210976,211069
2307,90,20,0,5.69,34.97,211069,211159
2308,99,23,0,5.17,24.34,211158,211257
2309,93,20,0,5.51,32.66,211256,211349
2310,95,21,0,5.39,32.03,211348,211443
2311,106,20,0,4.83,25.91,211442,211548
2312,80,31,0,6.40,37.29,211547,211627
2313,88,29,0,5.82,39.97,211626,211714
2314,91,20,0,5.63,32.39,211714,211805
2315,86,25,0,5.95,36.23,211804,211890
2316,86,25,0,5.95,37.95,211889,211975
2317,111,22,0,4.61,24.09,211974,212085
2318,90,30,0,5.69,34.88,212085,212175
2319,99,31,0,5.17,36.40,212175,212274
2320,102,18,0,5.02,27.61,212273,212375
2321,89,33,0,5.75,38.75,212374,212463
2322,91,37,0,5.63,51.82,212462,212553
2323,90,29,0,5.69,41.86,212552,212642
2324,80,49,0,6.40,56.32,212641,212721
2325,84,42,0,6.10,35.51,212720,212804
2326,96,33,0,5.33,36.06,212803,212899
2327,84,20,0,6.10,33.09,212898,212982
2328,106,20,0,4.83,26.29,212981,213087
2329,119,26,0,4.30,26.88,213086,213205
2330,100,21,0,5.12,29.37,213204,213304
2331,119,20,0,4.30,25.61,213303,213422
2332,96,30,0,5.33,31.91,213422,213518
2333,90,32,0,5.69,50.30,213517,213607
2334,90,25,0,5.69,28.01,213606,213696
2335,94,37,0,5.45,40.63,213695,213789
2336,77,21,0,6.65,32.62,213788,213865
2337,90,20,0,5.69,27.64,213864,213954
2338,94,35,0,5.45,43.61,213953,214047
2339,82,20,0,6.24,35.72,214046,214128
2340,91,28,0,5.63,34.43,214127,214218
2341,92,21,0,5.57,26.25,214217,214309
2342,80,21,0,6.40,33.29,214308,214388
2343,97,20,0,5.28,29.89,214387,214484
2344,91,24,0,5.63,36.30,214483,214574
2345,90,24,0,5.69,35.04,214573,214663
2346,94,21,0,5.45,22.82,214662,214756
2347,109,19,0,4.70,24.17,214755,214864
2348,71,71,0,7.21,143.52,214863,214934
2349,87,20,0,5.89,29.21,214933,215020
2350,108,21,0,4.74,25.60,215020,215128
2351,94,20,0,5.45,25.44,215127,215221
2352,90,23,0,5.69,33.37,215220,215310
2353,93,32,0,5.51,32.94,215309,215402
2354,87,32,0,5.89,37.50,215401,215488
2355,90,20,0,5.69,28.28,215487,215577
2356,97,20,0,5.28,29.19,215576,215673
2357,101,24,0,5.07,29.31,215672,215773
2358,97,26,0,5.28,30.22,215773,215870
2359,74,23,0,6.92,35.26,215869,215943
2360,86,37,0,5.95,41.11,215942,216028
2361,100,22,0,5.12,37.63,216028,216128
2362,83,24,0,6.17,35.32,216127,216210
2363,106,25,0,4.83,27.18,216209,216315
2364,118,22,0,4.34,25.65,216314,216432
2365,115,20,0,4.45,30.37,216431,216546
2366,97,29,0,5.28,34.24,216545,216642
2367,109,18,0,4.70,21.09,216641,216750
2368,93,23,0,5.51,36.66,216749,216842
2369,74,21,0,6.92,37.89,216841,216915
2370,95,36,0,5.39,37.37,216914,217009
2371,99,21,0,5.17,30.61,217008,217107
2372,93,26,0,5.51,30.59,217106,217199
2373,118,21,0,4.34,21.50,217199,217317
2374,89,24,0,5.75,33.98,217316,217405
2375,89,26,0,5.75,33.71,217404,217493
2376,102,27,0,5.02,34.67,217492,217594
2377,71,35,0,7.21,55.18,217593,217664
2378,89,56,0,5.75,57.53,217663,217752
2379,82,23,0,6.24,32.62,217751,217833
2380,99,31,0,5.17,33.70,217832,217931
2381,89,20,0,5.75,30.88,217930,218019
2382,89,35,0,5.75,45.76,218018,218107
2383,89,19,0,5.75,28.97,218106,218195
2384,103,21,0,4.97,33.15,218194,218297
2385,96,22,0,5.33,29.99,218296,218392
2386,91,21,0,5.63,28.28,218391,218482
2387,82,43,0,6.24,56.16,218482,218564
2388,94,19,0,5.45,23.18,218563,218657
2389,83,21,0,6.17,32.19,218656,218739
2390,103,28,0,4.97,33.56,218738,218841
2391,103,49,0,4.97,38.63,218840,218943
2392,85,66,0,6.02,76.56,218942,219027
2393,94,22,0,5.45,29.89,219027,219121
2394,92,28,0,5.57,34.68,219120,219212
2395,106,30,0,4.83,29.99,219211,219317
2396,87,88,0,5.89,105.71,219316,219403
2397,76,80,0,6.74,101.80,219402,219478
2398,88,39,0,5.82,46.83,219478,219566
2399,112,27,0,4.57,26.80,219565,219677
2400,102,20,0,5.02,26.35,219676,219778
2401,112,27,0,4.57,31.62,219777,219889
2402,99,23,0,5.17,32.53,219888,219987
2403,104,21,0,4.92,31.57,219986,220090
2404,98,29,0,5.22,33.73,220089,220187
2405,79,36,0,6.48,51.74,220186,220265
2406,88,34,0,5.82,42.29,220264,220352
2407,98,28,0,5.22,29.07,220351,220449
2408,87,20,0,5.89,28.88,220449,220536
2409,90,45,0,5.69,51.08,220535,220625
2410,99,20,0,5.17,27.94,220624,220723
2411,100,26,0,5.12,31.53,220722,220822
2412,105,22,0,4.88,32.17,220821,220926
2413,91,30,0,5.63,38.65,220926,221017
2414,85,20,0,6.02,31.39,221016,221101
2415,90,26,0,5.69,31.26,221100,221190
2416,104,21,0,4.92,27.15,221189,221293
2417,111,22,0,4.61,24.81,221292,221403
2418,81,28,0,6.32,42.17,221402,221483
2419,82,24,0,6.24,33.89,221482,221564
2420,96,22,0,5.33,30.14,221564,221660
2421,92,23,0,5.57,37.25,221659,221751
2422,94,25,0,5.45,33.35,221751,221845
2423,84,21,0,6.10,39.01,221845,221929
2424,87,21,0,5.89,37.14,221928,222015
2425,93,20,0,5.51,29.67,222015,222108
2426,97,22,0,5.28,32.68,222107,222204
2427,101,20,0,5.07,24.86,222203,222304
2428,102,20,0,5.02,30.53,222303,222405
2429,80,32,0,6.40,48.97,222404,222484
2430,103,24,0,4.97,27.17,222484,222587
2431,71,22,0,7.21,39.15,222586,222657
2432,99,26,0,5.17,34.53,222656,222755
2433,111,23,0,4.61,27.86,222754,222865
2434,108,27,0,4.74,32.40,222864,222972
2435,78,33,0,6.56,48.94,222971,223049
2436,96,25,0,5.33,32.47,223048,223144
2437,94,21,0,5.45,32.23,223143,223237
2438,54,45,0,9.48,77.43,223236,223290
2439,95,31,0,5.39,37.44,223289,223384
2440,113,20,0,4.53,22.89,223383,223496
2441,81,30,0,6.32,44.42,223495,223576
2442,100,32,0,5.12,36.55,223575,223675
2443,111,24,0,4.61,28.98,223674,223785
2444,79,38,0,6.48,52.81,223784,223863
2445,91,23,0,5.63,33.93,223863,223954
2446,100,20,0,5.12,28.99,223953,224053
2447,123,21,0,4.16,21.52,224052,224175
2448,89,22,0,5.75,41.33,224174,224263
2449,80,23,0,6.40,34.94,224262,224342
2450,101,26,0,5.07,30.12,224341,224442
2451,88,22,0,5.82,26.47,224441,224529
2452,90,33,0,5.69,33.01,224528,224618
2453,98,30,0,5.22,28.32,224617,224715
2454,87,74,0,5.89,80.49,224714,224801
2455,111,19,0,4.61,21.97,224800,224911
2456,84,25,0,6.10,31.23,224911,224995
2457,88,49,0,5.82,56.10,224994,225082
2458,96,19,0,5.33,26.41,225081,225177
2459,90,23,0,5.69,34.70,225176,225266
2460,91,40,0,5.63,48.59,225265,225356
2461,102,38,0,5.02,36.25,225356,225458
2462,97,30,0,5.28,35.17,225458,225555
2463,98,21,0,5.22,26.09,225554,225652
2464,91,27,0,5.63,34.43,225651,225742
2465,115,19,0,4.45,20.46,225742,225857
2466,90,26,0,5.69,36.50,225856,225946
2467,65,46,0,7.88,71.37,225945,226010
2468,117,19,0,4.38,20.30,226010,226127
2469,82,45,0,6.24,60.75,226126,226208
2470,95,38,0,5.39,43.06,226208,226303
2471,112,28,0,4.57,30.91,226302,226414
2472,106,23,0,4.83,27.78,226413,226519
2473,92,21,0,5.57,31.68,226518,226610
2474,91,86,0,5.63,107.22,226609,226700
2475,85,31,0,6.02,42.05,226699,226784
2476,86,71,0,5.95,78.67,226783,226869
2477,85,28,0,6.02,31.08,226868,226953
2478,102,24,0,5.02,31.29,226952,227054
2479,104,25,0,4.92,33.76,227054,227158
2480,81,23,0,6.32,35.43,227157,227238
2481,108,42,0,4.74,37.67,227237,227345
2482,87,60,0,5.89,60.42,227344,227431
2483,96,32,0,5.33,38.89,227430,227526
2484,86,36,0,5.95,46.67,227525,227611
2485,89,46,0,5.75,44.55,227610,227699
2486,84,25,0,6.10,37.42,227698,227782
2487,75,56,0,6.83,66.20,227781,227856
2488,104,20,0,4.92,23.86,227855,227959
2489,88,20,0,5.82,29.60,227958,228046
2490,98,31,0,5.22,32.54,228045,228143
2491,105,39,0,4.88,40.76,228142,228247
2492,93,25,0,5.51,33.99,228246,228339
2493,89,34,0,5.75,41.04,228339,228428
2494,91,20,0,5.63,31.03,228427,228518
2495,95,24,0,5.39,34.20,228517,228612
2496,102,23,0,5.02,30.23,228611,228713
2497,105,22,0,4.88,28.83,228712,228817
2498,90,20,0,5.69,27.93,228817,228907
2499,91,19,0,5.63,36.21,228906,228997
2500,99,34,0,5.17,35.92,228996,229095
2501,103,34,0,4.97,34.96,229094,229197
2502,97,23,0,5.28,30.24,229197,229294
2503,91,26,0,5.63,35.49,229294,229385
2504,86,31,0,5.95,39.00,229384,229470
2505,99,30,0,5.17,34.24,229469,229568
2506,99,26,0,5.17,36.38,229567,229666
2507,84,29,0,6.10,38.87,229665,229749
2508,97,20,0,5.28,29.46,229748,229845
2509,100,65,0,5.12,59.61,229844,229944
2510,105,23,0,4.88,25.33,229943,230048
2511,93,19,0,5.51,26.44,230047,230140
2512,99,34,0,5.17,38.16,230139,230238
2513,96,33,0,5.33,34.93,230238,230334
2514,71,56,0,7.21,96.67,230333,230404
2515,106,19,0,4.83,30.39,230403,230509
2516,81,25,0,6.32,37.90,230508,230589
2517,88,20,0,5.82,35.69,230588,230676
2518,58,26,0,8.83,38.49,230676,230734
2519,90,23,0,5.69,33.99,230733,230823
2520,96,42,0,5.33,37.14,230822,230918
2521,105,21,0,4.88,28.26,230918,231023
2522,79,21,0,6.48,34.68,231023,231102
2523,91,28,0,5.63,32.92,231101,231192
2524,106,33,0,4.83,35.08,231191,231297
2525,94,34,0,5.45,47.16,231296,231390
2526,96,22,0,5.33,33.35,231389,231485
2527,100,22,0,5.12,30.25,231484,231584
2528,94,20,0,5.45,27.14,231584,231678
2529,96,30,0,5.33,42.14,231677,231773
2530,96,23,0,5.33,33.58,231772,231868
2531,99,34,0,5.17,40.65,231867,231966
2532,90,20,0,5.69,33.84,231965,232055
2533,87,25,0,5.89,31.21,232054,232141
2534,94,23,0,5.45,36.06,232140,232234
2535,103,20,0,4.97,26.03,232233,232336
2536,106,21,0,4.83,30.10,232335,232441
2537,111,19,0,4.61,28.62,232440,232551
2538,90,26,0,5.69,36.04,232550,232640
2539,73,23,0,7.01,41.88,232639,232712
2540,88,22,0,5.82,35.22,232712,232800
2541,104,23,0,4.92,29.26,232799,232903
2542,86,26,0,5.95,35.97,232902,232988
2543,102,22,0,5.02,28.47,232987,233089
2544,82,31,0,6.24,46.79,233088,233170
2545,95,17,0,5.39,25.00,233169,233264
2546,112,19,0,4.57,23.99,233263,233375
2547,91,24,0,5.63,31.14,233374,233465
2548,64,94,0,8.00,196.19,233464,233528
2549,98,19,0,5.22,28.66,233528,233626
2550,91,26,0,5.63,34.65,233625,233716
2551,82,27,0,6.24,37.23,233715,233797
2552,107,20,0,4.79,23.79,233796,233903
2553,84,18,0,6.10,28.61,233902,233986
2554,90,20,0,5.69,29.01,233985,234075
2555,85,21,0,6.02,34.07,234074,234159
2556,78,120,0,6.56,193.86,234158,234236
2557,86,23,0,5.95,39.21,234235,234321
2558,89,24,0,5.75,35.20,234320,234409
2559,98,27,0,5.22,31.50,234408,234506
2560,103,19,0,4.97,28.26,234505,234608
2561,99,37,0,5.17,42.79,234607,234706
2562,92,56,0,5.57,51.59,234705,234797
2563,88,29,0,5.82,32.60,234796,234884
2564,78,91,0,6.56,124.43,234883,234961
2565,107,23,0,4.79,32.75,234960,235067
2566,97,19,0,5.28,29.40,235066,235163
2567,104,21,0,4.92,32.53,235162,235266
2568,70,32,0,7.31,50.07,235265,235335
2569,119,25,0,4.30,24.11,235334,235453
2570,93,25,0,5.51,28.72,235453,235546
2571,83,30,0,6.17,41.42,235545,235628
2572,83,27,0,6.17,39.15,235627,235710
2573,99,24,0,5.17,34.79,235710,235809
2574,77,30,0,6.65,43.50,235808,235885
2575,94,23,0,5.45,36.63,235884,235978
2576,91,34,0,5.63,38.45,235977,236068
2577,103,32,0,4.97,33.95,236067,236170
2578,93,22,0,5.51,34.01,236170,236263
2579,98,20,0,5.22,28.75,236262,236360
2580,107,18,0,4.79,22.45,236359,236466
2581,99,19,0,5.17,28.51,236465,236564
2582,95,69,0,5.39,68.13,236563,236658
2583,83,20,0,6.17,26.65,236657,236740
2584,94,39,0,5.45,38.76,236739,236833
2585,96,25,0,5.33,35.81,236832,236928
2586,86,43,0,5.95,43.79,236927,237013
2587,88,21,0,5.82,34.06,237012,237100
2588,81,32,0,6.32,54.74,237099,237180
2589,100,24,0,5.12,26.63,237179,237279
2590,87,35,0,5.89,41.18,237278,237365
2591,82,28,0,6.24,44.75,237364,237446
2592,78,81,0,6.56,120.63,237445,237523
2593,89,49,0,5.75,65.98,237522,237611
2594,98,22,0,5.22,25.95,237610,237708
2595,99,31,0,5.17,33.92,237707,237806
2596,107,64,0,4.79,56.30,237805,237912
2597,97,31,0,5.28,40.72,237912,238009
2598,80,21,0,6.40,32.76,238008,238088
2599,95,28,0,5.39,36.62,238087,238182
2600,100,38,0,5.12,35.31,238181,238281
2601,93,62,0,5.51,60.47,238280,238373
2602,80,94,0,6.40,128.11,238372,238452
2603,92,20,0,5.57,28.81,238451,238543
2604,87,56,0,5.89,64.84,238542,238629
2605,95,24,0,5.39,29.61,238628,238723
2606,93,30,0,5.51,36.06,238722,238815
2607,91,44,0,5.63,47.75,238814,238905
2608,82,28,0,6.24,50.45,238904,238986
2609,81,21,0,6.32,36.49,238985,239066
2610,90,24,0,5.69,29.19,239065,239155
2611,102,25,0,5.02,26.51,239154,239256
2612,102,24,0,5.02,30.49,239255,239357
2613,98,21,0,5.22,25.44,239356,239454
2614,85,23,0,6.02,39.34,239453,239538
2615,89,25,0,5.75,37.11,239537,239626
2616,90,40,0,5.69,43.75,239625,239715
2617,89,26,0,5.75,33.06,239714,239803
2618,86,21,0,5.95,36.65,239802,239888
2619,94,35,0,5.45,35.99,239887,239981
2620,91,19,0,5.63,26.48,239980,240071
2621,101,26,0,5.07,27.59,240071,240172
2622,91,27,0,5.63,35.29,240171,240262
2623,102,20,0,5.02,26.69,240261,240363
2624,84,23,0,6.10,34.11,240362,240446
2625,75,35,0,6.83,52.86,240445,240520
2626,94,22,0,5.45,28.06,240519,240613
2627,106,22,0,4.83,29.48,240612,240718
2628,105,20,0,4.88,28.76,240717,240822
2629,101,23,0,5.07,29.19,240821,240922
2630,106,29,0,4.83,32.01,240921,241027
2631,66,32,0,7.76,54.85,241026,241092
2632,102,20,0,5.02,27.25,241091,241193
2633,99,26,0,5.17,32.16,241192,241291
2634,102,25,0,5.02,28.02,241290,241392
2635,97,31,0,5.28,36.94,241391,241488
2636,98,27,0,5.22,29.54,241487,241585
2637,88,23,0,5.82,30.08,241584,241672
2638,84,31,0,6.10,41.90,241672,241756
2639,109,33,0,4.70,35.68,241755,241864
2640,93,25,0,5.51,33.28,241863,241956
2641,93,49,0,5.51,53.93,241955,242048
2642,95,44,0,5.39,42.74,242047,242142
2643,100,24,0,5.12,25.35,242142,242242
2644,98,20,0,5.22,30.91,242241,242339
2645,108,16,0,4.74,21.43,242338,242446
2646,100,25,0,5.12,37.09,242445,242545
2647,62,55,0,8.26,103.32,242545,242607
2648,91,19,0,5.63,28.23,242606,242697
2649,63,122,0,8.13,256.46,242696,242759
2650,71,32,0,7.21,48.59,242758,242829
2651,91,25,0,5.63,31.77,242828,242919
2652,103,27,0,4.97,30.14,242918,243021
2653,97,38,0,5.28,34.59,243020,243117
2654,103,25,0,4.97,30.05,243117,243220
2655,107,28,0,4.79,27.76,243219,243326
2656,79,33,0,6.48,46.38,243325,243404
2657,85,63,0,6.02,65.55,243403,243488
2658,96,31,0,5.33,37.89,243487,243583
2659,101,56,0,5.07,51.55,243582,243683
2660,91,31,0,5.63,40.72,243682,243773
2661,83,25,0,6.17,32.09,243772,243855
2662,81,64,0,6.32,71.97,243854,243935
2663,101,21,0,5.07,29.69,243934,244035
2664,97,37,0,5.28,44.30,244034,244131
2665,105,21,0,4.88,28.05,244130,244235
2666,87,28,0,5.89,36.88,244234,244321
2667,92,20,0,5.57,29.83,244320,244412
2668,92,19,0,5.57,30.40,244411,244503
2669,113,20,0,4.53,26.41,244503,244616
2670,89,33,0,5.75,42.05,244616,244705
2671,87,21,0,5.89,27.85,244704,244791
2672,96,30,0,5.33,37.97,244791,244887
2673,102,30,0,5.02,34.47,244886,244988
2674,84,22,0,6.10,29.49,244987,245071
2675,81,24,0,6.32,31.38,245071,245152
2676,75,27,0,6.83,47.34,245151,245226
2677,94,19,0,5.45,30.31,245225,245319
2678,106,19,0,4.83,23.59,245319,245425
2679,106,30,0,4.83,28.99,245424,245530
2680,100,22,0,5.12,37.11,245529,245629
2681,89,49,0,5.75,53.26,245628,245717
2682,98,36,0,5.22,48.83,245716,245814
2683,110,20,0,4.65,26.92,245813,245923
2684,101,22,0,5.07,26.30,245922,246023
2685,97,21,0,5.28,30.49,246023,246120
2686,89,54,0,5.75,56.59,246119,246208
2687,103,20,0,4.97,27.12,246207,246310
2688,103,19,0,4.97,24.80,246309,246412
2689,94,28,0,5.45,35.31,246412,246506
2690,94,22,0,5.45,30.69,246506,246600
2691,70,21,0,7.31,32.47,246599,246669
2692,88,30,0,5.82,40.13,246668,246756
2693,87,30,0,5.89,36.70,246755,246842
2694,66,60,0,7.76,87.00,246841,246907
2695,75,52,0,6.83,81.96,246906,246981
2696,97,27,0,5.28,32.02,246981,247078
2697,107,22,0,4.79,29.63,247077,247184
2698,91,28,0,5.63,33.22,247184,247275
2699,104,36,0,4.92,37.86,247274,247378
2700,73,20,0,7.01,36.70,247377,247450
2701,84,30,0,6.10,43.06,247450,247534
2702,98,48,0,5.22,46.09,247533,247631
2703,102,22,0,5.02,26.90,247631,247733
2704,97,41,0,5.28,43.23,247732,247829
2705,98,27,0,5.22,35.38,247828,247926
2706,79,24,0,6.48,34.53,247926,248005
2707,92,31,0,5.57,37.75,248004,248096
2708,101,32,0,5.07,32.64,248095,248196
2709,103,20,0,4.97,25.08,248195,248298
2710,70,90,0,7.31,142.42,248297,248367
2711,79,29,0,6.48,47.95,248367,248446
2712,102,36,0,5.02,40.61,248445,248547
2713,97,51,0,5.28,45.23,248547,248644
2714,89,20,0,5.75,29.06,248643,248732
2715,95,28,0,5.39,31.10,248731,248826
2716,80,67,0,6.40,79.89,248825,248905
2717,80,58,0,6.40,62.42,248904,248984
2718,98,23,0,5.22,26.46,248983,249081
2719,97,23,0,5.28,32.70,249080,249177
2720,92,27,0,5.57,42.70,249177,249269
2721,84,46,0,6.10,55.59,249268,249352
2722,72,29,0,7.11,42.38,249351,249423
2723,90,39,0,5.69,38.70,249422,249512
2724,102,40,0,5.02,38.61,249511,249613
2725,92,41,0,5.57,38.85,249612,249704
2726,92,54,0,5.57,57.90,249703,249795
2727,103,18,0,4.97,23.31,249794,249897
2728,104,20,0,4.92,24.94,249896,250000
2729,92,29,0,5.57,36.79,250000,250092
2730,96,43,0,5.33,51.64,250092,250188
2731,84,33,0,6.10,43.13,250187,250271
2732,111,24,0,4.61,23.91,250271,250382
2733,92,24,0,5.57,32.70,250382,250474
2734,97,59,0,5.28,61.13,250473,250570
2735,81,86,0,6.32,119.06,250569,250650
2736,89,35,0,5.75,40.95,250649,250738
2737,92,22,0,5.57,33.57,250737,250829
2738,89,28,0,5.75,33.40,250828,250917
2739,92,68,0,5.57,68.70,250916,251008
2740,110,18,0,4.65,21.54,251007,251117
2741,92,19,0,5.57,31.55,251116,251208
2742,102,55,0,5.02,44.98,251207,251309
2743,77,28,0,6.65,46.98,251308,251385
2744,98,19,0,5.22,22.77,251384,251482
2745,106,22,0,4.83,30.03,251481,251587
2746,111,22,0,4.61,24.54,251586,251697
2747,105,23,0,4.88,27.71,251696,251801
2748,68,54,0,7.53,85.04,251800,251868
2749,93,29,0,5.51,38.62,251867,251960
2750,97,27,0,5.28,35.77,251959,252056
2751,88,19,0,5.82,26.54,252055,252143
2752,87,28,0,5.89,36.38,252142,252229
2753,113,21,0,4.53,18.67,252228,252341
2754,74,29,0,6.92,41.37,252340,252414
2755,73,65,0,7.01,78.86,252414,252487
2756,104,21,0,4.92,27.05,252486,252590
2757,103,22,0,4.97,28.53,252589,252692
2758,98,25,0,5.22,34.42,252691,252789
2759,90,25,0,5.69,32.44,252788,252878
2760,93,20,0,5.51,25.95,252877,252970
2761,83,29,0,6.17,34.41,252969,253052
2762,105,28,0,4.88,37.29,253051,253156
2763,117,35,0,4.38,26.64,253156,253273
2764,104,27,0,4.92,30.90,253272,253376
2765,71,24,0,7.21,35.35,253376,253447
2766,65,114,0,7.88,208.85,253446,253511
2767,113,22,0,4.53,24.90,253510,253623
2768,77,92,0,6.65,195.89,253622,253699
2769,115,29,0,4.45,28.40,253698,253813
2770,97,20,0,5.28,30.26,253812,253909
2771,75,23,0,6.83,36.01,253908,253983
2772,115,21,0,4.45,23.19,253982,254097
2773,107,35,0,4.79,32.60,254096,254203
2774,99,43,0,5.17,41.07,254202,254301
2775,75,47,0,6.83,65.05,254301,254376
2776,87,30,0,5.89,47.89,254376,254463
2777,101,45,0,5.07,35.81,254462,254563
2778,96,21,0,5.33,30.26,254562,254658
2779,104,59,0,4.92,50.30,254657,254761
2780,73,22,0,7.01,31.11,254761,254834
2781,77,35,0,6.65,47.08,254833,254910
2782,106,18,0,4.83,26.12,254909,255015
2783,82,20,0,6.24,31.94,255014,255096
2784,96,19,0,5.33,25.58,255095,255191
2785,105,20,0,4.88,29.27,255190,255295
2786,64,75,0,8.00,110.03,255294,255358
2787,86,78,0,5.95,87.14,255357,255443
2788,99,17,0,5.17,20.87,255442,255541
2789,87,41,0,5.89,50.26,255540,255627
2790,90,32,0,5.69,37.90,255627,255717
2791,111,20,0,4.61,25.62,255717,255828
2792,83,22,0,6.17,35.08,255828,255911
2793,107,19,0,4.79,25.72,255910,256017
2794,105,19,0,4.88,21.44,256016,256121
2795,98,29,0,5.22,39.73,256120,256218
2796,84,22,0,6.10,34.73,256217,256301
2797,98,26,0,5.22,29.17,256300,256398
2798,94,24,0,5.45,27.50,256397,256491
2799,101,20,0,5.07,30.58,256490,256591
2800,95,32,0,5.39,44.85,256590,256685
2801,93,36,0,5.51,35.37,256684,256777
2802,79,28,0,6.48,36.76,256776,256855
2803,74,35,0,6.92,44.94,256854,256928
2804,93,34,0,5.51,36.64,256928,257021
2805,87,24,0,5.89,32.79,257020,257107
2806,91,32,0,5.63,40.52,257106,257197
2807,114,27,0,4.49,29.09,257197,257311
2808,90,19,0,5.69,26.70,257310,257400
2809,94,21,0,5.45,30.37,257399,257493
2810,72,29,0,7.11,44.46,257492,257564
2811,98,23,0,5.22,28.87,257564,257662
2812,87,25,0,5.89,34.65,257661,257748
2813,73,19,0,7.01,27.66,257747,257820
2814,79,36,0,6.48,40.73,257819,257898
2815,96,41,0,5.33,36.51,257898,257994
2816,92,23,0,5.57,31.14,257993,258085
2817,64,67,0,8.00,106.34,258084,258148
2818,97,23,0,5.28,33.66,258147,258244
2819,87,22,0,5.89,32.65,258243,258330
2820,107,22,0,4.79,25.96,258329,258436
2821,91,19,0,5.63,27.16,258435,258526
2822,88,41,0,5.82,56.17,258525,258613
2823,80,74,0,6.40,100.69,258612,258692
2824,71,29,0,7.21,45.46,258691,258762
2825,104,44,0,4.92,41.67,258761,258865
2826,98,20,0,5.22,27.50,258864,258962
2827,95,24,0,5.39,28.57,258961,259056
2828,53,126,0,9.66,331.02,259055,259108
2829,84,41,0,6.10,49.42,259107,259191
2830,109,23,0,4.70,22.69,259190,259299
2831,90,28,0,5.69,34.33,259298,259388
2832,93,20,0,5.51,29.95,259387,259480
2833,86,18,0,5.95,30.14,259479,259565
2834,86,21,0,5.95,36.02,259564,259650
2835,101,19,0,5.07,22.06,259649,259750
2836,83,31,0,6.17,48.33,259749,259832
2837,92,45,0,5.57,45.53,259831,259923
2838,101,21,0,5.07,29.57,259922,260023
2839,91,27,0,5.63,34.67,260022,260113
2840,92,20,0,5.57,26.57,260112,260204
2841,116,20,0,4.41,28.48,260203,260319
2842,106,22,0,4.83,29.14,260318,260424
2843,78,41,0,6.56,48.53,260423,260501
2844,86,33,0,5.95,36.88,260500,260586
2845,91,34,0,5.63,41.93,260585,260676
2846,99,28,0,5.17,27.05,260675,260774
2847,82,39,0,6.24,46.09,260773,260855
2848,101,43,0,5.07,46.70,260854,260955
2849,102,28,0,5.02,26.63,260954,261056
2850,85,36,0,6.02,44.21,261055,261140
2851,107,26,0,4.79,34.13,261139,261246
2852,99,20,0,5.17,28.87,261246,261345
2853,116,17,0,4.41,19.45,261344,261460
2854,95,25,0,5.39,32.24,261459,261554
2855,97,20,0,5.28,30.06,261553,261650
2856,92,26,0,5.57,34.44,261649,261741
2857,84,28,0,6.10,40.80,261740,261824
2858,82,40,0,6.24,57.40,261823,261905
2859,78,68,0,6.56,94.32,261904,261982
2860,72,24,0,7.11,48.96,261981,262053
2861,88,21,0,5.82,27.85,262052,262140
2862,94,28,0,5.45,35.97,262139,262233
2863,103,22,0,4.97,31.31,262232,262335
2864,101,28,0,5.07,31.69,262334,262435
2865,75,49,0,6.83,64.73,262434,262509
2866,84,19,0,6.10,31.47,262509,262593
2867,94,30,0,5.45,28.33,262592,262686
2868,101,23,0,5.07,28.34,262685,262786
2869,93,23,0,5.51,34.12,262785,262878
2870,76,21,0,6.74,35.35,262877,262953
2871,85,27,0,6.02,33.51,262953,263038
2872,112,28,0,4.57,28.87,263037,263149
2873,90,29,0,5.69,39.90,263148,263238
2874,89,42,0,5.75,46.48,263237,263326
2875,86,28,0,5.95,40.35,263325,263411
2876,91,21,0,5.63,31.75,263411,263502
2877,93,33,0,5.51,40.68,263501,263594
2878,104,26,0,4.92,29.53,263593,263697
2879,91,44,0,5.63,44.41,263696,263787
2880,83,20,0,6.17,27.44,263786,263869
2881,89,24,0,5.75,38.16,263868,263957
2882,76,35,0,6.74,58.90,263956,264032
2883,100,25,0,5.12,30.27,264031,264131
2884,98,50,0,5.22,50.05,264130,264228
2885,97,21,0,5.28,28.63,264228,264325
2886,108,29,0,4.74,31.77,264324,264432
2887,89,30,0,5.75,33.02,264431,264520
2888,66,100,0,7.76,164.09,264519,264585
2889,113,20,0,4.53,26.92,264584,264697
2890,105,20,0,4.88,29.82,264696,264801
2891,95,22,0,5.39,29.75,264800,264895
2892,86,47,0,5.95,50.25,264895,264981
2893,91,24,0,5.63,34.08,264980,265071
2894,77,35,0,6.65,40.10,265071,265148
2895,68,34,0,7.53,42.31,265147,265215
2896,100,56,0,5.12,52.75,265214,265314
2897,87,26,0,5.89,33.07,265313,265400
2898,66,26,0,7.76,46.49,265399,265465
2899,87,26,0,5.89,36.68,265464,265551
2900,94,20,0,5.45,27.72,265550,265644
2901,97,25,0,5.28,31.73,265643,265740
2902,65,62,0,7.88,81.18,265739,265804
2903,94,21,0,5.45,30.46,265804,265898
2904,96,42,0,5.33,37.28,265897,265993
2905,86,29,0,5.95,46.35,265992,266078
2906,89,55,0,5.75,60.95,266077,266166
2907,72,30,0,7.11,38.35,266165,266237
2908,82,35,0,6.24,40.18,266236,266318
2909,94,46,0,5.45,49.78,266317,266411
2910,106,22,0,4.83,27.59,266410,266516
2911,81,22,0,6.32,36.24,266515,266596
2912,86,30,0,5.95,50.09,266595,266681
2913,100,25,0,5.12,40.87,266680,266780
2914,99,24,0,5.17,32.00,266779,266878
2915,94,25,0,5.45,33.03,266877,266971
2916,70,55,0,7.31,70.59,266970,267040
2917,85,21,0,6.02,31.86,267039,267124
2918,81,56,0,6.32,80.74,267123,267204
2919,82,34,0,6.24,42.94,267203,267285
2920,74,36,0,6.92,57.10,267284,267358
2921,88,23,0,5.82,38.22,267357,267445
2922,114,25,0,4.49,30.55,267444,267558
2923,94,22,0,5.45,35.31,267557,267651
2924,95,20,0,5.39,30.62,267650,267745
2925,85,31,0,6.02,39.22,267744,267829
2926,105,20,0,4.88,29.50,267828,267933
2927,76,78,0,6.74,109.72,267933,268009
2928,98,21,0,5.22,22.62,268008,268106
2929,89,44,0,5.75,48.61,268105,268194
2930,98,20,0,5.22,29.64,268193,268291
2931,89,38,0,5.75,43.87,268291,268380
2932,78,29,0,6.56,39.37,268379,268457
2933,96,45,0,5.33,43.31,268456,268552
2934,90,33,0,5.69,42.28,268551,268641
2935,75,44,0,6.83,54.65,268640,268715
2936,80,22,0,6.40,40.42,268714,268794
2937,114,18,0,4.49,21.48,268794,268908
2938,86,59,0,5.95,79.21,268907,268993
2939,76,43,0,6.74,67.54,268992,269068
2940,106,20,0,4.83,24.95,269067,269173
2941,99,68,0,5.17,66.55,269172,269271
2942,84,20,0,6.10,30.49,269270,269354
2943,72,25,0,7.11,38.65,269353,269425
2944,96,26,0,5.33,34.53,269424,269520
2945,97,29,0,5.28,32.63,269520,269617
2946,89,77,0,5.75,88.70,269616,269705
2947,90,34,0,5.69,31.30,269704,269794
2948,86,24,0,5.95,40.63,269794,269880
2949,99,20,0,5.17,29.86,269879,269978
2950,97,27,0,5.28,30.08,269977,270074
2951,105,20,0,4.88,26.53,270073,270178
2952,75,26,0,6.83,36.36,270177,270252
2953,82,30,0,6.24,41.21,270251,270333
2954,91,81,0,5.63,93.25,270332,270423
2955,102,21,0,5.02,22.10,270422,270524
2956,87,20,0,5.89,26.47,270523,270610
2957,79,36,0,6.48,43.77,270609,270688
2958,111,38,0,4.61,35.30,270688,270799
2959,71,131,0,7.21,249.46,270798,270869
2960,82,27,0,6.24,43.40,270868,270950
2961,78,20,0,6.56,39.22,270949,271027
2962,91,51,0,5.63,47.35,271026,271117
2963,83,31,0,6.17,39.47,271116,271199
2964,100,47,0,5.12,54.27,271198,271298
2965,88,38,0,5.82,39.63,271297,271385
2966,104,25,0,4.92,27.97,271385,271489
2967,100,28,0,5.12,33.15,271488,271588
2968,95,76,0,5.39,100.95,271587,271682
2969,89,24,0,5.75,31.35,271681,271770
2970,117,19,0,4.38,23.23,271770,271887
2971,94,43,0,5.45,54.61,271886,271980
2972,89,18,0,5.75,25.02,271979,272068
2973,105,24,0,4.88,30.32,272067,272172
2974,92,23,0,5.57,29.31,272171,272263
2975,68,48,0,7.53,69.40,272262,272330
2976,70,108,0,7.31,304.44,272329,272399
2977,111,19,0,4.61,25.79,272398,272509
2978,94,45,0,5.45,49.48,272508,272602
2979,92,25,0,5.57,37.51,272601,272693
2980,96,21,0,5.33,26.76,272692,272788
2981,77,46,0,6.65,51.53,272787,272864
2982,103,24,0,4.97,24.40,272863,272966
2983,91,22,0,5.63,28.61,272966,273057
2984,72,27,0,7.11,41.90,273056,273128
2985,71,36,0,7.21,52.14,273127,273198
2986,79,77,0,6.48,87.21,273197,273276
2987,81,62,0,6.32,67.80,273275,273356
2988,94,31,0,5.45,39.50,273356,273450
2989,89,107,0,5.75,142.16,273449,273538
2990,78,22,0,6.56,35.55,273537,273615
2991,90,20,0,5.69,27.13,273614,273704
2992,93,50,0,5.51,52.59,273703,273796
2993,74,22,0,6.92,36.32,273795,273869
2994,91,34,0,5.63,34.06,273869,273960
2995,96,20,0,5.33,26.78,273959,274055
2996,102,24,0,5.02,31.00,274054,274156
2997,84,69,0,6.10,75.71,274155,274239
2998,79,30,0,6.48,41.90,274238,274317
2999,81,25,0,6.32,38.66,274317,274398
3000,97,41,0,5.28,41.05,274397,274494
3001,84,19,0,6.10,26.44,274493,274577
3002,106,20,0,4.83,24.57,274576,274682
3003,97,46,0,5.28,48.90,274681,274778
3004,100,19,0,5.12,25.21,274777,274877
3005,90,27,0,5.69,38.50,274876,274966
3006,98,43,0,5.22,42.38,274965,275063
3007,105,19,0,4.88,21.58,275062,275167
3008,100,34,0,5.12,37.13,275166,275266
3009,81,20,0,6.32,37.25,275265,275346
3010,67,70,0,7.64,124.17,275345,275412
3011,83,25,0,6.17,36.28,275411,275494
3012,101,23,0,5.07,33.41,275493,275594
3013,77,71,0,6.65,108.12,275593,275670
3014,98,72,0,5.22,68.83,275669,275767
3015,98,28,0,5.22,33.58,275767,275865
3016,96,20,0,5.33,29.47,275864,275960
3017,117,20,0,4.38,24.56,275959,276076
3018,110,22,0,4.65,28.61,276075,276185
3019,86,23,0,5.95,35.44,276184,276270
3020,91,28,0,5.63,42.43,276269,276360
3021,102,25,0,5.02,29.69,276359,276461
3022,106,20,0,4.83,25.29,276460,276566
3023,105,18,0,4.88,25.69,276565,276670
3024,105,22,0,4.88,28.01,276669,276774
3025,95,21,0,5.39,27.44,276773,276868
3026,76,77,0,6.74,101.67,276867,276943
3027,99,18,0,5.17,21.19,276942,277041
3028,89,20,0,5.75,32.66,277040,277129
3029,82,35,0,6.24,43.96,277128,277210
3030,103,19,0,4.97,27.17,277209,277312
3031,90,19,0,5.69,24.35,277311,277401
3032,90,35,0,5.69,43.33,277401,277491
3033,89,27,0,5.75,37.85,277490,277579
3034,92,20,0,5.57,27.25,277578,277670
3035,104,40,0,4.92,36.94,277669,277773
3036,95,21,0,5.39,32.13,277773,277868
3037,77,23,0,6.65,36.44,277868,277945
3038,114,26,0,4.49,29.88,277944,278058
3039,91,36,0,5.63,43.66,278057,278148
3040,95,23,0,5.39,32.07,278148,278243
3041,100,19,0,5.12,27.21,278242,278342
3042,97,25,0,5.28,33.00,278341,278438
3043,81,34,0,6.32,53.11,278437,278518
3044,82,20,0,6.24,38.82,278518,278600
3045,111,20,0,4.61,22.09,278599,278710
3046,103,26,0,4.97,34.01,278709,278812
3047,98,23,0,5.22,32.36,278811,278909
3048,105,21,0,4.88,26.62,278909,279014
3049,97,43,0,5.28,46.22,279013,279110
3050,96,23,0,5.33,30.08,279110,279206
3051,93,42,0,5.51,46.90,279205,279298
3052,99,20,0,5.17,27.33,279297,279396
3053,115,20,0,4.45,21.85,279395,279510
3054,94,21,0,5.45,32.14,279509,279603
3055,100,26,0,5.12,27.67,279602,279702
3056,84,46,0,6.10,47.63,279701,279785
3057,73,30,0,7.01,41.33,279784,279857
3058,89,20,0,5.75,30.79,279856,279945
3059,96,20,0,5.33,30.64,279944,280040
3060,86,21,0,5.95,33.86,280039,280125
3061,88,36,0,5.82,36.60,280125,280213
3062,88,45,0,5.82,53.51,280212,280300
3063,90,64,0,5.69,83.59,280299,280389
3064,97,28,0,5.28,31.62,280388,280485
3065,63,89,0,8.13,140.11,280484,280547
3066,93,19,0,5.51,27.73,280546,280639
3067,78,59,0,6.56,65.40,280638,280716
3068,104,22,0,4.92,29.24,280715,280819
3069,90,21,0,5.69,31.19,280818,280908
3070,81,24,0,6.32,37.25,280907,280988
3071,108,20,0,4.74,29.99,280987,281095
3072,93,50,0,5.51,46.10,281095,281188
3073,93,23,0,5.51,40.90,281187,281280
3074,93,20,0,5.51,32.49,281279,281372
3075,93,99,0,5.51,121.86,281371,281464
3076,93,22,0,5.51,31.07,281463,281556
3077,110,23,0,4.65,23.70,281555,281665
3078,101,20,0,5.07,26.90,281664,281765
3079,81,23,0,6.32,36.96,281764,281845
3080,89,61,0,5.75,62.68,281845,281934
3081,78,21,0,6.56,35.73,281933,282011
3082,105,20,0,4.88,28.24,282011,282116
3083,45,247,0,11.38,1292.32,282115,282160
3084,103,21,0,4.97,28.46,282159,282262
3085,82,33,0,6.24,47.33,282261,282343
3086,108,38,0,4.74,36.54,282342,282450
3087,103,22,0,4.97,31.52,282449,282552
3088,105,43,0,4.88,37.02,282551,282656
3089,103,40,0,4.97,38.14,282655,282758
3090,101,20,0,5.07,21.81,282758,282859
3091,64,58,0,8.00,76.88,282858,282922
3092,101,19,0,5.07,27.77,282921,283022
3093,101,20,0,5.07,28.06,283021,283122
3094,92,23,0,5.57,28.66,283122,283214
3095,103,25,0,4.97,26.65,283213,283316
3096,77,105,0,6.65,164.67,283316,283393
3097,84,106,0,6.10,149.54,283392,283476
3098,90,47,0,5.69,50.41,283476,283566
3099,98,85,0,5.22,86.52,283565,283663
3100,106,19,0,4.83,26.29,283662,283768
3101,82,25,0,6.24,44.92,283767,283849
3102,104,21,0,4.92,26.49,283849,283953
3103,105,25,0,4.88,37.67,283952,284057
3104,83,51,0,6.17,64.02,284056,284139
3105,68,52,0,7.53,70.31,284138,284206
3106,76,48,0,6.74,55.98,284205,284281
3107,94,64,0,5.45,64.12,284280,284374
3108,81,44,0,6.32,58.69,284373,284454
3109,91,26,0,5.63,33.95,284454,284545
3110,83,20,0,6.17,33.37,284544,284627
3111,93,20,0,5.51,28.68,284626,284719
3112,87,21,0,5.89,30.98,284718,284805
3113,92,25,0,5.57,33.96,284804,284896
3114,78,21,0,6.56,35.96,284896,284974
3115,96,30,0,5.33,30.47,284973,285069
3116,106,19,0,4.83,28.46,285068,285174
3117,111,19,0,4.61,26.02,285173,285284
3118,93,22,0,5.51,29.17,285283,285376
3119,94,20,0,5.45,25.97,285375,285469
3120,111,22,0,4.61,24.53,285468,285579
3121,87,114,0,5.89,169.94,285578,285665
3122,85,61,0,6.02,67.20,285665,285750
3123,66,205,0,7.76,655.40,285749,285815
3124,93,40,0,5.51,37.91,285814,285907
3125,96,19,0,5.33,33.03,285906,286002
3126,70,29,0,7.31,47.59,286001,286071
3127,110,19,0,4.65,25.84,286070,286180
3128,102,30,0,5.02,31.20,286179,286281
3129,86,48,0,5.95,55.44,286280,286366
3130,80,42,0,6.40,54.02,286365,286445
3131,98,24,0,5.22,32.07,286444,286542
3132,90,21,0,5.69,29.79,286542,286632
3133,88,103,0,5.82,130.26,286631,286719
3134,109,20,0,4.70,26.14,286718,286827
3135,96,83,0,5.33,81.47,286826,286922
3136,86,20,0,5.95,30.49,286921,287007
3137,95,21,0,5.39,34.22,287006,287101
3138,105,39,0,4.88,33.04,287100,287205
3139,87,64,0,5.89,69.23,287204,287291
3140,104,20,0,4.92,22.57,287290,287394
3141,64,74,0,8.00,117.44,287393,287457
3142,92,22,0,5.57,32.46,287457,287549
3143,112,35,0,4.57,31.33,287548,287660
3144,103,28,0,4.97,31.27,287659,287762
3145,94,20,0,5.45,31.46,287761,287855
3146,91,23,0,5.63,28.85,287854,287945
3147,108,19,0,4.74,27.14,287944,288052
3148,94,25,0,5.45,29.42,288051,288145
3149,83,28,0,6.17,38.26,288144,288227
3150,89,44,0,5.75,51.11,288227,288316
3151,80,82,0,6.40,98.46,288315,288395
3152,79,29,0,6.48,42.53,288394,288473
3153,99,34,0,5.17,35.82,288472,288571
3154,93,25,0,5.51,28.14,288570,288663
3155,101,23,0,5.07,31.47,288663,288764
3156,123,26,0,4.16,26.30,288763,288886
3157,98,38,0,5.22,38.46,288886,288984
3158,109,28,0,4.70,27.15,288983,289092
3159,92,32,0,5.57,39.72,289091,289183
3160,89,22,0,5.75,32.97,289182,289271
3161,96,21,0,5.33,27.68,289270,289366
3162,82,66,0,6.24,92.33,289365,289447
3163,61,100,0,8.39,178.21,289446,289507
3164,116,32,0,4.41,27.60,289506,289622
3165,86,25,0,5.95,26.11,289621,289707
3166,87,36,0,5.89,36.03,289706,289793
3167,95,30,0,5.39,28.68,289793,289888
3168,47,121,0,10.89,361.37,289887,289934
3169,95,20,0,5.39,27.10,289933,290028
3170,107,20,0,4.79,27.35,290027,290134
3171,98,22,0,5.22,37.95,290134,290232
3172,86,53,0,5.95,56.84,290231,290317
3173,86,20,0,5.95,32.07,290317,290403
3174,128,18,0,4.00,21.70,290402,290530
3175,113,23,0,4.53,25.74,290530,290643
3176,99,43,0,5.17,36.93,290642,290741
3177,101,19,0,5.07,26.10,290740,290841
3178,84,31,0,6.10,40.90,290840,290924
3179,103,23,0,4.97,31.70,290923,291026
3180,96,63,0,5.33,67.81,291025,291121
3181,85,22,0,6.02,35.22,291120,291205
3182,102,36,0,5.02,41.37,291204,291306
3183,72,31,0,7.11,53.04,291306,291378
3184,94,26,0,5.45,31.82,291377,291471
3185,108,29,0,4.74,28.27,291470,291578
3186,100,20,0,5.12,25.31,291577,291677
3187,94,48,0,5.45,55.27,291676,291770
3188,95,48,0,5.39,47.92,291769,291864
3189,86,29,0,5.95,40.95,291864,291950
3190,103,21,0,4.97,28.73,291949,292052
3191,89,25,0,5.75,31.67,292051,292140
3192,100,20,0,5.12,26.47,292139,292239
3193,101,19,0,5.07,22.66,292238,292339
3194,80,23,0,6.40,36.97,292338,292418
3195,100,35,0,5.12,42.21,292417,292517
3196,88,24,0,5.82,32.19,292516,292604
3197,80,27,0,6.40,36.94,292603,292683
3198,91,20,0,5.63,27.00,292682,292773
3199,105,19,0,4.88,31.25,292772,292877
3200,110,20,0,4.65,25.61,292876,292986
3201,91,23,0,5.63,34.41,292985,293076
3202,79,83,0,6.48,105.79,293075,293154
3203,73,72,0,7.01,117.36,293153,293226
3204,91,24,0,5.63,36.54,293225,293316
3205,102,26,0,5.02,32.55,293316,293418
3206,104,20,0,4.92,24.38,293418,293522
3207,99,29,0,5.17,30.67,293521,293620
3208,105,20,0,4.88,27.40,293620,293725
3209,89,28,0,5.75,39.51,293724,293813
3210,102,30,0,5.02,37.43,293812,293914
3211,96,30,0,5.33,36.14,293913,294009
3212,127,19,0,4.03,21.31,294008,294135
3213,85,24,0,6.02,33.95,294134,294219
3214,78,34,0,6.56,39.45,294218,294296
3215,79,71,0,6.48,83.79,294296,294375
3216,89,22,0,5.75,31.71,294374,294463
3217,88,71,0,5.82,83.92,294463,294551
3218,66,30,0,7.76,44.85,294551,294617
3219,92,20,0,5.57,32.14,294616,294708
3220,98,26,0,5.22,29.54,294707,294805
3221,108,20,0,4.74,25.95,294804,294912
3222,107,19,0,4.79,22.09,294911,295018
3223,55,106,0,9.31,248.03,295017,295072
3224,90,28,0,5.69,38.61,295071,295161
3225,98,43,0,5.22,34.46,295161,295259
3226,103,43,0,4.97,40.44,295258,295361
3227,47,89,0,10.89,181.37,295360,295407
3228,102,41,0,5.02,37.92,295406,295508
3229,91,20,0,5.63,27.66,295507,295598
3230,78,28,0,6.56,34.81,295597,295675
3231,97,32,0,5.28,33.99,295674,295771
3232,81,33,0,6.32,43.85,295770,295851
3233,106,19,0,4.83,22.86,295851,295957
3234,110,19,0,4.65,28.01,295956,296066
3235,81,39,0,6.32,47.92,296065,296146
3236,114,38,0,4.49,33.85,296145,296259
3237,92,23,0,5.57,33.25,296258,296350
3238,89,31,0,5.75,44.23,296349,296438
3239,75,26,0,6.83,38.89,296437,296512
3240,103,21,0,4.97,24.38,296511,296614
3241,95,28,0,5.39,31.33,296613,296708
3242,111,25,0,4.61,26.15,296707,296818
3243,92,25,0,5.57,27.83,296817,296909
3244,94,27,0,5.45,39.14,296909,297003
3245,84,28,0,6.10,39.78,297003,297087
3246,94,25,0,5.45,30.48,297086,297180
3247,107,18,0,4.79,28.21,297179,297286
3248,93,25,0,5.51,30.90,297285,297378
3249,87,28,0,5.89,36.38,297377,297464
3250,92,28,0,5.57,41.75,297463,297555
3251,96,25,0,5.33,31.47,297554,297650
3252,80,23,0,6.40,37.92,297649,297729
3253,96,20,0,5.33,30.45,297728,297824
3254,90,23,0,5.69,25.68,297823,297913
3255,99,21,0,5.17,30.87,297912,298011
3256,81,61,0,6.32,70.66,298011,298092
3257,83,53,0,6.17,56.77,298091,298174
3258,81,20,0,6.32,33.67,298173,298254
3259,81,32,0,6.32,41.95,298253,298334
3260,108,28,0,4.74,28.12,298333,298441
3261,72,57,0,7.11,94.74,298440,298512
3262,82,21,0,6.24,35.48,298511,298593
3263,106,19,0,4.83,29.24,298592,298698
3264,103,26,0,4.97,28.38,298697,298800
3265,82,24,0,6.24,38.99,298799,298881
3266,94,46,0,5.45,60.10,298880,298974
3267,96,26,0,5.33,28.22,298973,299069
3268,66,77,0,7.76,151.46,299068,299134
3269,99,24,0,5.17,33.33,299133,299232
3270,85,17,0,6.02,27.25,299231,299316
3271,95,39,0,5.39,36.15,299316,299411
3272,109,21,0,4.70,23.68,299410,299519
3273,89,33,0,5.75,34.28,299518,299607
3274,108,28,0,4.74,30.06,299606,299714
3275,100,19,0,5.12,28.51,299713,299813
3276,99,26,0,5.17,34.65,299812,299911
3277,88,22,0,5.82,38.13,299910,299998
3278,77,39,0,6.65,52.28,299998,300075
3279,90,30,0,5.69,33.53,300074,300164
3280,94,31,0,5.45,31.12,300163,300257
3281,87,41,0,5.89,54.40,300256,300343
3282,90,30,0,5.69,35.81,300342,300432
3283,114,20,0,4.49,25.69,300431,300545
3284,87,21,0,5.89,32.40,300545,300632
3285,91,20,0,5.63,31.49,300631,300722
3286,79,42,0,6.48,49.14,300721,300800
3287,93,22,0,5.51,28.64,300799,300892
3288,90,49,0,5.69,53.53,300892,300982
3289,89,22,0,5.75,32.52,300982,301071
3290,91,37,0,5.63,38.30,301070,301161
3291,112,20,0,4.57,23.51,301160,301272
3292,86,27,0,5.95,35.04,301272,301358
3293,81,21,0,6.32,33.80,301357,301438
3294,94,25,0,5.45,28.80,301437,301531
3295,97,27,0,5.28,26.90,301531,301628
3296,88,36,0,5.82,41.83,301627,301715
3297,62,30,0,8.26,48.13,301714,301776
3298,82,39,0,6.24,54.23,301775,301857
3299,89,34,0,5.75,40.84,301856,301945
3300,81,23,0,6.32,37.11,301944,302025
3301,89,32,0,5.75,35.98,302024,302113
3302,84,88,0,6.10,107.13,302112,302196
3303,107,23,0,4.79,25.79,302195,302302
3304,100,21,0,5.12,32.41,302301,302401
3305,89,26,0,5.75,27.87,302400,302489
3306,74,92,0,6.92,131.29,302488,302562
3307,85,31,0,6.02,49.41,302561,302646
3308,86,34,0,5.95,45.11,302645,302731
3309,46,216,0,11.13,964.64,302730,302776
3310,89,43,0,5.75,60.43,302775,302864
3311,100,33,0,5.12,35.79,302864,302964
3312,94,23,0,5.45,34.82,302963,303057
3313,109,19,0,4.70,26.16,303056,303165
3314,65,32,0,7.88,39.68,303164,303229
3315,89,26,0,5.75,37.78,303228,303317
3316,84,20,0,6.10,29.99,303316,303400
3317,93,22,0,5.51,32.79,303399,303492
3318,104,24,0,4.92,34.38,303491,303595
3319,71,28,0,7.21,43.41,303594,303665
3320,97,67,0,5.28,69.23,303665,303762
3321,76,23,0,6.74,38.35,303761,303837
3322,90,21,0,5.69,30.35,303836,303926
3323,89,26,0,5.75,41.44,303925,304014
3324,96,21,0,5.33,33.78,304013,304109
3325,105,20,0,4.88,26.49,304108,304213
3326,102,31,0,5.02,33.98,304212,304314
3327,107,30,0,4.79,33.57,304313,304420
3328,93,20,0,5.51,29.78,304419,304512
3329,83,22,0,6.17,29.44,304511,304594
3330,87,76,0,5.89,87.46,304593,304680
3331,102,26,0,5.02,30.65,304679,304781
3332,107,26,0,4.79,23.66,304780,304887
3333,92,27,0,5.57,35.22,304886,304978
3334,83,24,0,6.17,33.90,304977,305060
3335,74,23,0,6.92,32.26,305059,305133
3336,98,33,0,5.22,37.30,305132,305230
3337,31,364,0,16.52,4047.41,305229,305260
3338,106,33,0,4.83,35.88,305259,305365
3339,81,36,0,6.32,47.40,305365,305446
3340,98,18,0,5.22,24.56,305445,305543
3341,82,49,0,6.24,50.75,305542,305624
3342,73,44,0,7.01,57.38,305624,305697
3343,85,41,0,6.02,40.54,305696,305781
3344,93,28,0,5.51,36.51,305781,305874
3345,87,42,0,5.89,51.76,305873,305960
3346,82,21,0,6.24,32.26,305959,306041
3347,85,37,0,6.02,53.15,306040,306125
3348,101,20,0,5.07,29.75,306125,306226
3349,98,25,0,5.22,29.58,306225,306323
3350,98,20,0,5.22,28.97,306322,306420
3351,93,20,0,5.51,27.48,306419,306512
3352,93,21,0,5.51,31.48,306511,306604
3353,77,37,0,6.65,50.15,306603,306680
3354,79,37,0,6.48,62.53,306679,306758
3355,91,41,0,5.63,45.27,306757,306848
3356,100,22,0,5.12,31.67,306847,306947
3357,96,21,0,5.33,30.70,306946,307042
3358,72,28,0,7.11,46.68,307042,307114
3359,86,21,0,5.95,29.84,307113,307199
3360,93,54,0,5.51,47.76,307198,307291
3361,70,90,0,7.31,132.53,307290,307360
3362,68,24,0,7.53,36.75,307359,307427
3363,118,23,0,4.34,27.50,307426,307544
3364,107,22,0,4.79,29.87,307543,307650
3365,99,35,0,5.17,40.83,307649,307748
3366,91,38,0,5.63,39.22,307748,307839
3367,101,21,0,5.07,27.23,307838,307939
3368,91,19,0,5.63,29.93,307938,308029
3369,114,21,0,4.49,25.32,308028,308142
3370,94,20,0,5.45,31.57,308142,308236
3371,61,21,0,8.39,30.47,308235,308296
3372,91,23,0,5.63,33.77,308295,308386
3373,103,22,0,4.97,23.39,308385,308488
3374,103,22,0,4.97,30.55,308487,308590
3375,87,35,0,5.89,53.71,308589,308676
3376,105,23,0,4.88,30.07,308676,308781
3377,86,26,0,5.95,31.56,308780,308866
3378,113,23,0,4.53,27.98,308865,308978
3379,85,33,0,6.02,46.85,308977,309062
3380,124,22,0,4.13,24.26,309061,309185
3381,82,21,0,6.24,25.79,309184,309266
3382,97,28,0,5.28,31.56,309266,309363
3383,109,27,0,4.70,29.20,309362,309471
3384,95,26,0,5.39,33.52,309470,309565
3385,103,27,0,4.97,37.68,309564,309667
3386,83,34,0,6.17,44.55,309666,309749
3387,108,21,0,4.74,27.95,309748,309856
3388,79,25,0,6.48,42.12,309856,309935
3389,101,25,0,5.07,33.53,309934,310035
3390,81,46,0,6.32,64.19,310034,310115
3391,105,21,0,4.88,28.24,310114,310219
3392,106,23,0,4.83,33.52,310218,310324
3393,77,57,0,6.65,63.34,310323,310400
3394,110,21,0,4.65,21.37,310399,310509
3395,109,23,0,4.70,28.76,310508,310617
3396,60,69,0,8.53,103.28,310616,310676
3397,104,23,0,4.92,36.03,310676,310780
3398,91,23,0,5.63,32.43,310779,310870
3399,91,43,0,5.63,47.09,310869,310960
3400,96,24,0,5.33,28.45,310959,311055
3401,87,35,0,5.89,53.69,311054,311141
3402,85,21,0,6.02,30.78,311141,311226
3403,83,51,0,6.17,63.71,311225,311308
3404,112,34,0,4.57,35.94,311307,311419
3405,97,33,0,5.28,37.95,311418,311515
3406,90,34,0,5.69,39.61,311514,311604
3407,61,114,0,8.39,238.11,311603,311664
3408,84,35,0,6.10,51.11,311663,311747
3409,108,21,0,4.74,27.75,311746,311854
3410,94,20,0,5.45,36.67,311853,311947
3411,88,35,0,5.82,39.81,311947,312035
3412,87,31,0,5.89,37.44,312034,312121
3413,87,51,0,5.89,55.39,312121,312208
3414,101,24,0,5.07,28.36,312207,312308
3415,92,32,0,5.57,36.38,312307,312399
3416,105,20,0,4.88,23.21,312398,312503
3417,105,20,0,4.88,24.60,312503,312608
3418,86,20,0,5.95,27.42,312607,312693
3419,95,24,0,5.39,31.69,312693,312788
3420,96,22,0,5.33,26.74,312787,312883
3421,87,37,0,5.89,46.22,312882,312969
3422,100,23,0,5.12,29.97,312968,313068
3423,104,20,0,4.92,23.22,313067,313171
3424,98,20,0,5.22,32.44,313170,313268
3425,91,20,0,5.63,34.06,313267,313358
3426,90,20,0,5.69,29.08,313357,313447
3427,61,32,0,8.39,43.32,313446,313507
3428,84,26,0,6.10,39.49,313506,313590
3429,92,28,0,5.57,32.68,313589,313681
3430,118,21,0,4.34,23.77,313680,313798
3431,97,38,0,5.28,42.76,313797,313894
3432,78,37,0,6.56,44.58,313893,313971
3433,113,23,0,4.53,23.42,313970,314083
3434,89,31,0,5.75,36.12,314083,314172
3435,95,30,0,5.39,39.96,314171,314266
3436,107,20,0,4.79,23.83,314265,314372
3437,71,113,0,7.21,190.76,314371,314442
3438,92,21,0,5.57,32.20,314441,314533
3439,86,75,0,5.95,85.93,314532,314618
3440,107,25,0,4.79,27.94,314617,314724
3441,88,20,0,5.82,30.01,314724,314812
3442,92,33,0,5.57,37.09,314811,314903
3443,94,25,0,5.45,31.16,314902,314996
3444,75,23,0,6.83,40.54,314995,315070
3445,82,20,0,6.24,35.04,315070,315152
3446,102,26,0,5.02,32.22,315151,315253
3447,90,54,0,5.69,54.97,315252,315342
3448,93,27,0,5.51,28.92,315341,315434
3449,99,24,0,5.17,32.57,315433,315532
3450,113,21,0,4.53,23.10,315531,315644
3451,94,32,0,5.45,50.59,315644,315738
3452,105,20,0,4.88,28.55,315737,315842
3453,108,19,0,4.74,27.43,315841,315949
3454,80,25,0,6.40,35.64,315948,316028
3455,81,46,0,6.32,57.85,316027,316108
3456,93,20,0,5.51,32.19,316107,316200
3457,119,20,0,4.30,20.21,316199,316318
3458,107,19,0,4.79,29.91,316317,316424
3459,58,69,0,8.83,102.52,316423,316481
3460,106,22,0,4.83,23.88,316480,316586
3461,98,22,0,5.22,31.34,316585,316683
3462,90,22,0,5.69,35.79,316682,316772
3463,79,92,0,6.48,124.05,316771,316850
3464,71,33,0,7.21,40.56,316849,316920
3465,90,22,0,5.69,37.35,316919,317009
3466,112,23,0,4.57,27.26,317008,317120
3467,102,19,0,5.02,24.65,317119,317221
3468,98,55,0,5.22,70.66,317220,317318
3469,90,25,0,5.69,33.39,317317,317407
3470,93,21,0,5.51,27.80,317406,317499
3471,88,32,0,5.82,39.13,317498,317586
3472,76,105,0,6.74,159.69,317585,317661
3473,100,34,0,5.12,29.53,317660,317760
3474,89,25,0,5.75,37.56,317760,317849
3475,66,29,0,7.76,54.91,317849,317915
3476,106,26,0,4.83,29.99,317914,318020
3477,111,20,0,4.61,25.41,318019,318130
3478,101,22,0,5.07,28.90,318129,318230
3479,105,38,0,4.88,39.35,318229,318334
3480,105,57,0,4.88,48.17,318333,318438
3481,86,40,0,5.95,51.74,318437,318523
3482,73,48,0,7.01,74.56,318522,318595
3483,71,110,0,7.21,186.08,318594,318665
3484,90,19,0,5.69,31.08,318665,318755
3485,92,23,0,5.57,31.42,318754,318846
3486,98,41,0,5.22,37.05,318845,318943
3487,120,21,0,4.27,22.01,318943,319063
3488,96,22,0,5.33,31.72,319062,319158
3489,114,22,0,4.49,24.13,319157,319271
3490,115,22,0,4.45,29.17,319270,319385
3491,86,24,0,5.95,34.63,319384,319470
3492,107,32,0,4.79,37.27,319469,319576
3493,105,19,0,4.88,22.74,319575,319680
3494,95,20,0,5.39,33.84,319679,319774
3495,99,20,0,5.17,29.39,319773,319872
3496,98,47,0,5.22,42.52,319871,319969
3497,88,34,0,5.82,43.26,319968,320056
3498,79,21,0,6.48,30.22,320056,320135
3499,84,28,0,6.10,37.04,320134,320218
3500,74,22,0,6.92,33.18,320217,320291
3501,116,21,0,4.41,24.12,320290,320406
3502,93,27,0,5.51,30.40,320405,320498
3503,102,24,0,5.02,29.47,320497,320599
3504,89,24,0,5.75,36.12,320598,320687
3505,86,24,0,5.95,34.44,320686,320772
3506,81,28,0,6.32,39.50,320772,320853
3507,87,20,0,5.89,40.03,320852,320939
3508,103,40,0,4.97,41.27,320939,321042
3509,61,229,0,8.39,843.06,321041,321102
3510,105,20,0,4.88,20.91,321101,321206
3511,81,27,0,6.32,39.55,321205,321286
3512,117,25,0,4.38,23.93,321286,321403
3513,96,23,0,5.33,30.24,321402,321498
3514,117,21,0,4.38,25.81,321497,321614
3515,90,20,0,5.69,28.15,321613,321703
3516,98,20,0,5.22,28.87,321702,321800
3517,119,23,0,4.30,25.29,321799,321918
3518,81,92,0,6.32,120.09,321917,321998
3519,102,27,0,5.02,35.96,321997,322099
3520,93,27,0,5.51,39.86,322098,322191
3521,100,22,0,5.12,27.15,322190,322290
3522,91,22,0,5.63,27.38,322289,322380
3523,93,19,0,5.51,29.78,322379,322472
3524,84,22,0,6.10,37.49,322471,322555
3525,101,24,0,5.07,29.49,322554,322655
3526,110,24,0,4.65,23.50,322654,322764
3527,108,20,0,4.74,25.27,322763,322871
3528,91,52,0,5.63,52.72,322870,322961
3529,103,41,0,4.97,40.44,322961,323064
3530,110,23,0,4.65,29.15,323063,323173
3531,101,21,0,5.07,29.33,323173,323274
3532,110,25,0,4.65,29.61,323273,323383
3533,98,27,0,5.22,37.97,323382,323480
3534,61,59,0,8.39,94.40,323479,323540
3535,95,20,0,5.39,28.17,323539,323634
3536,87,22,0,5.89,32.12,323633,323720
3537,101,28,0,5.07,33.15,323719,323820
3538,96,22,0,5.33,33.87,323819,323915
3539,79,49,0,6.48,55.21,323914,323993
3540,85,37,0,6.02,40.82,323993,324078
3541,110,19,0,4.65,24.66,324077,324187
3542,106,31,0,4.83,38.84,324186,324292
3543,81,37,0,6.32,34.24,324291,324372
3544,76,21,0,6.74,33.64,324371,324447
3545,101,23,0,5.07,25.17,324446,324547
3546,95,37,0,5.39,37.80,324546,324641
3547,100,55,0,5.12,52.85,324640,324740
3548,84,29,0,6.10,40.28,324739,324823
3549,76,53,0,6.74,58.80,324822,324898
3550,96,18,0,5.33,25.78,324897,324993
3551,87,23,0,5.89,34.88,324993,325080
3552,92,28,0,5.57,35.72,325080,325172
3553,90,19,0,5.69,27.79,325171,325261
3554,107,54,0,4.79,45.96,325260,325367
3555,106,19,0,4.83,23.91,325366,325472
3556,98,21,0,5.22,29.62,325471,325569
3557,93,21,0,5.51,32.90,325568,325661
3558,74,36,0,6.92,40.78,325660,325734
3559,103,26,0,4.97,34.18,325733,325836
3560,91,23,0,5.63,38.12,325836,325927
3561,103,21,0,4.97,29.47,325926,326029
3562,100,30,0,5.12,30.71,326028,326128
3563,97,27,0,5.28,27.73,326127,326224
3564,101,23,0,5.07,29.99,326223,326324
3565,87,21,0,5.89,33.48,326323,326410
3566,81,35,0,6.32,45.45,326409,326490
3567,100,113,0,5.12,135.93,326489,326589
3568,92,53,0,5.57,50.70,326588,326680
3569,76,26,0,6.74,38.72,326679,326755
3570,95,34,0,5.39,33.00,326754,326849
3571,93,31,0,5.51,39.20,326848,326941
3572,92,25,0,5.57,35.09,326940,327032
3573,98,56,0,5.22,47.42,327031,327129
3574,85,59,0,6.02,67.25,327128,327213
3575,82,66,0,6.24,81.16,327212,327294
3576,105,20,0,4.88,27.71,327293,327398
3577,92,22,0,5.57,33.46,327397,327489
3578,103,26,0,4.97,27.06,327488,327591
3579,112,21,0,4.57,25.46,327590,327702
3580,94,21,0,5.45,31.82,327701,327795
3581,91,51,0,5.63,78.67,327794,327885
3582,88,22,0,5.82,32.99,327884,327972
3583,121,20,0,4.23,20.71,327971,328092
3584,52,149,0,9.85,436.36,328091,328143
3585,89,45,0,5.75,41.00,328142,328231
3586,74,27,0,6.92,47.18,328230,328304
3587,90,27,0,5.69,34.39,328303,328393
3588,87,44,0,5.89,56.93,328392,328479
3589,96,24,0,5.33,29.37,328478,328574
3590,96,30,0,5.33,36.16,328573,328669
3591,97,25,0,5.28,28.55,328669,328766
3592,83,23,0,6.17,33.73,328765,328848
3593,48,88,0,10.67,209.89,328847,328895
3594,104,20,0,4.92,23.51,328894,328998
3595,92,24,0,5.57,35.77,328998,329090
3596,103,21,0,4.97,28.22,329089,329192
3597,85,24,0,6.02,34.12,329191,329276
3598,90,22,0,5.69,31.01,329275,329365
3599,111,19,0,4.61,24.29,329364,329475
3600,87,27,0,5.89,32.42,329474,329561
3601,103,22,0,4.97,26.82,329560,329663
3602,102,23,0,5.02,28.92,329662,329764
3603,85,30,0,6.02,39.88,329763,329848
3604,101,49,0,5.07,43.45,329847,329948
3605,90,43,0,5.69,60.79,329948,330038
3606,76,22,0,6.74,38.80,330037,330113
3607,96,23,0,5.33,32.35,330112,330208
3608,111,19,0,4.61,24.65,330207,330318
3609,88,20,0,5.82,31.04,330317,330405
3610,81,53,0,6.32,58.02,330404,330485
3611,87,27,0,5.89,39.16,330485,330572
3612,88,25,0,5.82,38.94,330571,330659
3613,101,25,0,5.07,26.52,330659,330760
3614,113,25,0,4.53,26.18,330759,330872
3615,85,30,0,6.02,29.93,330871,330956
3616,90,34,0,5.69,36.15,330955,331045
3617,86,62,0,5.95,64.49,331044,331130
3618,78,28,0,6.56,43.68,331129,331207
3619,111,22,0,4.61,21.03,331206,331317
3620,75,29,0,6.83,41.61,331316,331391
3621,87,85,0,5.89,94.72,331391,331478
3622,95,21,0,5.39,32.41,331478,331573
3623,107,19,0,4.79,27.25,331572,331679
3624,91,55,0,5.63,60.41,331678,331769
3625,93,20,0,5.51,31.69,331769,331862
3626,109,25,0,4.70,30.54,331861,331970
3627,99,20,0,5.17,27.84,331969,332068
3628,81,27,0,6.32,35.63,332067,332148
3629,99,32,0,5.17,29.23,332147,332246
3630,86,26,0,5.95,37.79,332245,332331
3631,84,21,0,6.10,34.63,332330,332414
3632,96,20,0,5.33,27.18,332413,332509
3633,108,22,0,4.74,30.40,332508,332616
3634,97,26,0,5.28,29.75,332615,332712
3635,97,21,0,5.28,29.50,332712,332809
3636,93,23,0,5.51,33.82,332808,332901
3637,65,25,0,7.88,44.94,332900,332965
3638,90,34,0,5.69,42.88,332964,333054
3639,106,22,0,4.83,23.24,333053,333159
3640,102,20,0,5.02,31.33,333158,333260
3641,93,27,0,5.51,36.77,333259,333352
3642,96,24,0,5.33,27.31,333351,333447
3643,80,21,0,6.40,38.52,333446,333526
3644,121,21,0,4.23,22.97,333525,333646
3645,65,71,0,7.88,94.63,333646,333711
3646,72,24,0,7.11,40.54,333710,333782
3647,94,40,0,5.45,39.74,333781,333875
3648,92,21,0,5.57,36.94,333874,333966
3649,116,22,0,4.41,22.45,333965,334081
3650,82,30,0,6.24,36.72,334080,334162
3651,89,19,0,5.75,23.94,334162,334251
3652,87,21,0,5.89,30.12,334250,334337
3653,105,20,0,4.88,25.21,334336,334441
3654,101,46,0,5.07,43.49,334440,334541
3655,92,24,0,5.57,29.12,334540,334632
3656,80,20,0,6.40,29.57,334632,334712
3657,81,19,0,6.32,26.59,334712,334793
3658,86,37,0,5.95,39.23,334792,334878
3659,75,63,0,6.83,69.48,334877,334952
3660,77,30,0,6.65,47.08,334951,335028
3661,108,26,0,4.74,33.62,335027,335135
3662,89,26,0,5.75,40.73,335134,335223
3663,94,23,0,5.45,32.10,335223,335317
3664,77,46,0,6.65,54.12,335316,335393
3665,73,46,0,7.01,69.52,335392,335465
3666,95,20,0,5.39,29.50,335464,335559
3667,107,21,0,4.79,21.29,335558,335665
3668,90,28,0,5.69,37.24,335665,335755
3669,88,20,0,5.82,31.24,335754,335842
3670,82,19,0,6.24,29.21,335841,335923
3671,117,17,0,4.38,17.04,335922,336039
3672,97,31,0,5.28,46.94,336038,336135
3673,110,22,0,4.65,32.19,336134,336244
3674,87,20,0,5.89,32.88,336244,336331
3675,84,48,0,6.10,72.75,336330,336414
3676,87,22,0,5.89,36.77,336413,336500
3677,92,47,0,5.57,43.98,336499,336591
3678,104,26,0,4.92,29.99,336590,336694
3679,96,41,0,5.33,41.72,336693,336789
3680,84,63,0,6.10,93.85,336789,336873
3681,83,32,0,6.17,44.04,336873,336956
3682,105,21,0,4.88,28.38,336955,337060
3683,118,22,0,4.34,21.00,337059,337177
3684,87,32,0,5.89,46.01,337176,337263
3685,104,19,0,4.92,27.49,337262,337366
3686,90,70,0,5.69,74.77,337365,337455
3687,105,23,0,4.88,28.17,337454,337559
3688,68,25,0,7.53,45.72,337558,337626
3689,91,21,0,5.63,34.48,337625,337716
3690,89,19,0,5.75,27.83,337715,337804
3691,109,37,0,4.70,34.47,337803,337912
3692,93,30,0,5.51,39.78,337911,338004
3693,79,46,0,6.48,49.21,338003,338082
3694,103,20,0,4.97,24.65,338081,338184
3695,115,20,0,4.45,19.17,338183,338298
3696,95,31,0,5.39,46.22,338298,338393
3697,90,36,0,5.69,46.59,338392,338482
3698,108,21,0,4.74,25.54,338481,338589
3699,98,28,0,5.22,32.54,338588,338686
3700,82,25,0,6.24,35.62,338685,338767
3701,90,22,0,5.69,30.57,338766,338856
3702,95,26,0,5.39,32.32,338856,338951
3703,97,22,0,5.28,26.53,338950,339047
3704,93,58,0,5.51,62.08,339046,339139
3705,91,44,0,5.63,43.16,339138,339229
3706,80,39,0,6.40,45.84,339228,339308
3707,94,25,0,5.45,41.31,339307,339401
3708,96,20,0,5.33,30.72,339400,339496
3709,80,25,0,6.40,45.59,339495,339575
3710,92,23,0,5.57,32.40,339575,339667
3711,97,22,0,5.28,23.79,339666,339763
3712,64,58,0,8.00,102.03,339762,339826
3713,108,64,0,4.74,57.60,339825,339933
3714,103,20,0,4.97,28.09,339932,340035
3715,79,20,0,6.48,37.14,340034,340113
3716,98,25,0,5.22,30.15,340112,340210
3717,100,75,0,5.12,72.59,340209,340309
3718,102,30,0,5.02,34.35,340309,340411
3719,91,24,0,5.63,28.67,340410,340501
3720,66,42,0,7.76,60.27,340501,340567
3721,100,40,0,5.12,40.93,340566,340666
3722,93,41,0,5.51,40.92,340665,340758
3723,97,25,0,5.28,30.68,340757,340854
3724,95,25,0,5.39,31.65,340853,340948
3725,103,21,0,4.97,28.84,340947,341050
3726,93,22,0,5.51,31.93,341050,341143
3727,108,21,0,4.74,25.78,341142,341250
3728,98,28,0,5.22,31.50,341249,341347
3729,82,82,0,6.24,107.04,341346,341428
3730,87,29,0,5.89,33.94,341427,341514
3731,117,19,0,4.38,24.44,341513,341630
3732,87,20,0,5.89,31.71,341629,341716
3733,103,28,0,4.97,31.80,341715,341818
3734,106,19,0,4.83,19.93,341817,341923
3735,48,49,0,10.67,81.89,341923,341971
3736,104,46,0,4.92,44.21,341970,342074
3737,107,19,0,4.79,27.35,342073,342180
3738,101,22,0,5.07,26.88,342179,342280
3739,90,24,0,5.69,35.01,342279,342369
3740,65,62,0,7.88,96.17,342368,342433
3741,91,26,0,5.63,34.70,342432,342523
3742,93,21,0,5.51,34.36,342523,342616
3743,92,30,0,5.57,32.64,342615,342707
3744,103,21,0,4.97,30.40,342706,342809
3745,79,29,0,6.48,42.10,342808,342887
3746,97,22,0,5.28,31.03,342886,342983
3747,61,47,0,8.39,61.85,342982,343043
3748,107,26,0,4.79,30.62,343043,343150
3749,84,21,0,6.10,36.75,343149,343233
3750,107,26,0,4.79,32.86,343232,343339
3751,92,25,0,5.57,34.90,343338,343430
3752,110,20,0,4.65,24.43,343429,343539
3753,101,23,0,5.07,29.05,343538,343639
3754,82,21,0,6.24,32.38,343638,343720
3755,93,21,0,5.51,33.95,343719,343812
3756,111,21,0,4.61,22.42,343811,343922
3757,100,20,0,5.12,30.87,343921,344021
3758,106,25,0,4.83,26.44,344020,344126
3759,102,22,0,5.02,27.82,344125,344227
3760,108,20,0,4.74,25.41,344226,344334
3761,95,49,0,5.39,44.66,344333,344428
3762,79,23,0,6.48,39.16,344427,344506
3763,85,41,0,6.02,48.28,344505,344590
3764,111,18,0,4.61,21.66,344589,344700
3765,90,27,0,5.69,35.19,344699,344789
3766,102,21,0,5.02,25.49,344788,344890
3767,97,27,0,5.28,33.36,344889,344986
3768,88,34,0,5.82,41.94,344985,345073
3769,99,49,0,5.17,44.51,345072,345171
3770,76,28,0,6.74,46.80,345171,345247
3771,87,19,0,5.89,27.23,345246,345333
3772,82,60,0,6.24,70.55,345332,345414
3773,86,33,0,5.95,36.16,345413,345499
3774,90,25,0,5.69,47.86,345498,345588
3775,97,44,0,5.28,48.61,345587,345684
3776,76,49,0,6.74,70.43,345683,345759
3777,72,29,0,7.11,40.88,345758,345830
3778,80,28,0,6.40,45.99,345830,345910
3779,88,52,0,5.82,57.54,345909,345997
3780,91,81,0,5.63,90.15,345997,346088
3781,90,43,0,5.69,43.21,346087,346177
3782,101,27,0,5.07,34.62,346176,346277
3783,78,24,0,6.56,37.76,346277,346355
3784,93,20,0,5.51,29.09,346354,346447
3785,91,45,0,5.63,48.83,346447,346538
3786,96,35,0,5.33,35.78,346537,346633
3787,91,27,0,5.63,43.31,346632,346723
3788,87,36,0,5.89,32.84,346722,346809
3789,113,36,0,4.53,30.44,346808,346921
3790,93,22,0,5.51,28.23,346920,347013
3791,95,24,0,5.39,28.43,347012,347107
3792,101,27,0,5.07,33.31,347107,347208
3793,82,22,0,6.24,34.70,347207,347289
3794,81,26,0,6.32,32.86,347288,347369
3795,116,19,0,4.41,24.78,347368,347484
3796,88,66,0,5.82,66.31,347484,347572
3797,83,54,0,6.17,68.74,347571,347654
3798,91,22,0,5.63,31.75,347653,347744
3799,101,28,0,5.07,38.18,347743,347844
3800,100,20,0,5.12,31.41,347844,347944
3801,112,25,0,4.57,27.92,347943,348055
3802,112,37,0,4.57,39.24,348054,348166
3803,88,23,0,5.82,33.15,348165,348253
3804,93,19,0,5.51,30.59,348252,348345
3805,77,20,0,6.65,32.70,348344,348421
3806,86,23,0,5.95,36.09,348420,348506
3807,81,41,0,6.32,52.84,348505,348586
3808,102,18,0,5.02,21.90,348586,348688
3809,112,19,0,4.57,24.87,348688,348800
3810,116,28,0,4.41,28.62,348799,348915
3811,85,45,0,6.02,57.76,348914,348999
3812,108,24,0,4.74,29.30,348998,349106
3813,85,37,0,6.02,50.71,349105,349190
3814,103,26,0,4.97,35.29,349190,349293
3815,105,30,0,4.88,29.40,349292,349397
3816,85,24,0,6.02,32.78,349396,349481
3817,95,35,0,5.39,40.55,349480,349575
3818,113,22,0,4.53,27.98,349574,349687
3819,98,22,0,5.22,33.17,349687,349785
3820,97,22,0,5.28,25.17,349784,349881
3821,74,28,0,6.92,42.75,349881,349955
3822,100,21,0,5.12,25.63,349954,350054
3823,93,21,0,5.51,35.02,350053,350146
3824,108,22,0,4.74,25.38,350145,350253
3825,97,20,0,5.28,25.13,350252,350349
3826,101,25,0,5.07,24.78,350348,350449
3827,78,22,0,6.56,38.86,350448,350526
3828,82,40,0,6.24,45.50,350525,350607
3829,98,38,0,5.22,39.01,350606,350704
3830,92,20,0,5.57,28.42,350703,350795
3831,103,20,0,4.97,27.89,350794,350897
3832,89,30,0,5.75,33.94,350896,350985
3833,88,28,0,5.82,45.33,350984,351072
3834,84,20,0,6.10,30.13,351071,351155
3835,97,21,0,5.28,27.11,351154,351251
3836,67,40,0,7.64,63.16,351250,351317
3837,111,21,0,4.61,24.78,351316,351427
3838,86,21,0,5.95,32.07,351427,351513
3839,71,130,0,7.21,256.67,351512,351583
3840,107,28,0,4.79,32.34,351582,351689
3841,95,20,0,5.39,27.86,351688,351783
3842,88,30,0,5.82,38.19,351782,351870
3843,74,33,0,6.92,47.21,351869,351943
3844,93,20,0,5.51,27.45,351942,352035
3845,110,31,0,4.65,22.61,352034,352144
3846,86,44,0,5.95,45.30,352143,352229
3847,90,66,0,5.69,71.53,352229,352319
3848,91,20,0,5.63,27.73,352319,352410
3849,73,29,0,7.01,45.16,352409,352482
3850,94,41,0,5.45,41.61,352481,352575
3851,96,42,0,5.33,41.08,352575,352671
3852,98,49,0,5.22,46.42,352670,352768
3853,78,24,0,6.56,42.86,352767,352845
3854,109,22,0,4.70,26.10,352845,352954
3855,84,24,0,6.10,32.71,352953,353037
3856,84,51,0,6.10,58.11,353037,353121
3857,78,36,0,6.56,53.91,353120,353198
3858,102,21,0,5.02,26.92,353198,353300
3859,107,33,0,4.79,35.42,353300,353407
3860,78,43,0,6.56,44.94,353406,353484
3861,93,32,0,5.51,43.35,353483,353576
3862,92,23,0,5.57,26.94,353575,353667
3863,99,22,0,5.17,31.82,353666,353765
3864,90,22,0,5.69,31.06,353764,353854
3865,107,19,0,4.79,23.83,353853,353960
3866,80,29,0,6.40,42.59,353959,354039
3867,112,20,0,4.57,25.57,354039,354151
3868,101,26,0,5.07,29.61,354150,354251
3869,111,19,0,4.61,23.84,354250,354361
3870,49,160,0,10.45,497.55,354360,354409
3871,91,20,0,5.63,25.07,354408,354499
3872,81,25,0,6.32,39.40,354498,354579
3873,92,29,0,5.57,38.07,354578,354670
3874,93,21,0,5.51,28.42,354669,354762
3875,103,24,0,4.97,26.14,354761,354864
3876,91,21,0,5.63,31.97,354863,354954
3877,94,26,0,5.45,35.93,354954,355048
3878,107,22,0,4.79,26.92,355047,355154
3879,64,171,0,8.00,451.38,355154,355218
3880,92,24,0,5.57,35.79,355217,355309
3881,86,24,0,5.95,35.28,355308,355394
3882,81,28,0,6.32,40.39,355393,355474
3883,89,22,0,5.75,34.48,355474,355563
3884,106,23,0,4.83,27.88,355562,355668
3885,93,28,0,5.51,29.80,355667,355760
3886,91,30,0,5.63,38.54,355760,355851
3887,72,143,0,7.11,295.38,355850,355922
3888,95,25,0,5.39,34.72,355921,356016
3889,85,52,0,6.02,52.71,356015,356100
3890,71,29,0,7.21,41.12,356099,356170
3891,90,28,0,5.69,38.77,356169,356259
3892,97,58,0,5.28,54.14,356258,356355
3893,97,23,0,5.28,31.15,356354,356451
3894,119,22,0,4.30,21.71,356450,356569
3895,119,27,0,4.30,26.43,356568,356687
3896,90,41,0,5.69,53.33,356686,356776
3897,97,22,0,5.28,29.85,356775,356872
3898,89,42,0,5.75,46.91,356871,356960
3899,64,61,0,8.00,90.00,356959,357023
3900,89,43,0,5.75,43.15,357022,357111
3901,104,20,0,4.92,25.94,357110,357214
3902,104,21,0,4.92,28.82,357213,357317
3903,86,22,0,5.95,29.70,357316,357402
3904,84,47,0,6.10,48.37,357402,357486
3905,86,60,0,5.95,77.70,357486,357572
3906,99,22,0,5.17,30.53,357571,357670
3907,110,27,0,4.65,25.10,357669,357779
3908,82,37,0,6.24,44.84,357778,357860
3909,94,67,0,5.45,65.37,357859,357953
3910,78,44,0,6.56,70.07,357952,358030
3911,93,35,0,5.51,41.67,358029,358122
3912,98,28,0,5.22,27.46,358121,358219
3913,108,23,0,4.74,27.99,358218,358326
3914,92,51,0,5.57,50.98,358325,358417
3915,86,25,0,5.95,34.63,358417,358503
3916,75,37,0,6.83,44.97,358502,358577
3917,94,19,0,5.45,28.20,358576,358670
3918,95,22,0,5.39,32.72,358669,358764
3919,93,29,0,5.51,33.67,358763,358856
3920,108,21,0,4.74,26.10,358855,358963
3921,95,48,0,5.39,48.26,358963,359058
3922,102,20,0,5.02,26.08,359057,359159
3923,98,24,0,5.22,31.07,359158,359256
3924,90,21,0,5.69,32.10,359255,359345
3925,70,47,0,7.31,57.79,359344,359414
3926,97,36,0,5.28,40.16,359413,359510
3927,90,39,0,5.69,41.97,359509,359599
3928,109,24,0,4.70,31.44,359598,359707
3929,106,23,0,4.83,31.73,359706,359812
3930,86,23,0,5.95,38.42,359812,359898
3931,107,42,0,4.79,34.26,359897,360004
3932,102,30,0,5.02,35.53,360003,360105
3933,66,26,0,7.76,43.94,360104,360170
3934,87,24,0,5.89,33.46,360169,360256
3935,82,30,0,6.24,53.53,360255,360337
3936,102,20,0,5.02,23.84,360336,360438
3937,79,21,0,6.48,31.72,360437,360516
3938,87,19,0,5.89,38.15,360515,360602
3939,100,28,0,5.12,27.97,360601,360701
3940,98,30,0,5.22,34.81,360700,360798
3941,82,54,0,6.24,63.87,360797,360879
3942,93,40,0,5.51,45.58,360878,360971
3943,95,35,0,5.39,33.54,360971,361066
3944,93,27,0,5.51,41.00,361065,361158
3945,89,31,0,5.75,31.71,361157,361246
3946,90,32,0,5.69,36.84,361245,361335
3947,96,51,0,5.33,51.16,361334,361430
3948,107,20,0,4.79,26.62,361429,361536
3949,101,20,0,5.07,28.72,361535,361636
3950,82,19,0,6.24,33.75,361635,361717
3951,78,20,0,6.56,33.45,361716,361794
3952,91,20,0,5.63,29.66,361793,361884
3953,97,26,0,5.28,29.05,361883,361980
3954,116,36,0,4.41,28.66,361979,362095
3955,98,20,0,5.22,27.93,362094,362192
3956,75,21,0,6.83,30.38,362191,362266
3957,95,23,0,5.39,29.06,362266,362361
3958,102,29,0,5.02,31.76,362360,362462
3959,93,24,0,5.51,35.22,362462,362555
3960,94,21,0,5.45,34.20,362554,362648
3961,92,19,0,5.57,28.31,362647,362739
3962,88,53,0,5.82,50.83,362738,362826
3963,93,21,0,5.51,32.87,362826,362919
3964,94,40,0,5.45,38.86,362918,363012
3965,81,34,0,6.32,46.24,363012,363093
3966,103,28,0,4.97,34.38,363092,363195
3967,97,37,0,5.28,47.89,363194,363291
3968,92,25,0,5.57,33.35,363290,363382
3969,74,50,0,6.92,58.43,363381,363455
3970,91,28,0,5.63,30.48,363454,363545
3971,105,20,0,4.88,22.20,363544,363649
3972,79,27,0,6.48,51.69,363648,363727
3973,98,22,0,5.22,25.93,363726,363824
3974,89,35,0,5.75,43.65,363823,363912
3975,81,20,0,6.32,35.08,363911,363992
3976,91,35,0,5.63,42.08,363991,364082
3977,101,19,0,5.07,24.22,364081,364182
3978,94,25,0,5.45,33.37,364181,364275
3979,92,54,0,5.57,57.22,364274,364366
3980,106,19,0,4.83,21.82,364365,364471
3981,73,24,0,7.01,34.67,364470,364543
3982,81,32,0,6.32,43.21,364542,364623
3983,80,23,0,6.40,39.24,364622,364702
3984,110,20,0,4.65,23.84,364701,364811
3985,71,24,0,7.21,42.08,364810,364881
3986,101,29,0,5.07,29.17,364881,364982
3987,105,28,0,4.88,29.04,364981,365086
3988,90,19,0,5.69,26.75,365085,365175
3989,94,25,0,5.45,36.61,365174,365268
3990,95,23,0,5.39,33.82,365267,365362
3991,94,20,0,5.45,29.91,365361,365455
3992,76,31,0,6.74,51.33,365454,365530
3993,127,26,0,4.03,24.08,365529,365656
3994,92,22,0,5.57,30.59,365655,365747
3995,77,143,0,6.65,268.80,365746,365823
3996,85,44,0,6.02,47.60,365822,365907
3997,80,48,0,6.40,70.86,365906,365986
3998,109,18,0,4.70,27.02,365985,366094
3999,72,100,0,7.11,148.35,366093,366165
4000,89,22,0,5.75,34.10,366164,366253
4001,88,21,0,5.82,35.06,366252,366340
4002,85,45,0,6.02,61.62,366339,366424
4003,95,24,0,5.39,32.09,366423,366518
4004,103,20,0,4.97,23.35,366517,366620
4005,96,24,0,5.33,28.08,366619,366715
4006,112,25,0,4.57,25.71,366714,366826
4007,105,21,0,4.88,24.39,366825,366930
4008,93,26,0,5.51,34.36,366929,367022
4009,82,35,0,6.24,41.62,367022,367104
4010,105,25,0,4.88,28.95,367104,367209
4011,104,20,0,4.92,31.94,367208,367312
4012,106,50,0,4.83,44.18,367311,367417
4013,83,43,0,6.17,61.92,367416,367499
4014,94,20,0,5.45,29.20,367498,367592
4015,98,19,0,5.22,32.30,367591,367689
4016,76,73,0,6.74,86.22,367688,367764
4017,90,25,0,5.69,30.13,367763,367853
4018,108,33,0,4.74,30.66,367852,367960
4019,97,24,0,5.28,31.52,367959,368056
4020,90,34,0,5.69,42.73,368055,368145
4021,85,57,0,6.02,67.58,368144,368229
4022,70,92,0,7.31,154.24,368228,368298
4023,80,29,0,6.40,40.19,368297,368377
4024,109,29,0,4.70,30.05,368377,368486
4025,104,28,0,4.92,34.88,368485,368589
4026,100,21,0,5.12,27.61,368588,368688
4027,93,21,0,5.51,30.92,368687,368780
4028,102,25,0,5.02,25.88,368779,368881
4029,67,20,0,7.64,35.48,368880,368947
4030,124,20,0,4.13,24.08,368947,369071
4031,96,23,0,5.33,33.10,369070,369166
4032,111,19,0,4.61,25.88,369165,369276
4033,93,21,0,5.51,31.30,369275,369368
4034,105,25,0,4.88,32.41,369367,369472
4035,115,23,0,4.45,28.32,369471,369586
4036,102,37,0,5.02,30.67,369585,369687
4037,101,18,0,5.07,23.31,369686,369787
4038,84,44,0,6.10,48.44,369786,369870
4039,97,21,0,5.28,29.81,369869,369966
4040,102,39,0,5.02,37.33,369965,370067
4041,106,33,0,4.83,32.08,370066,370172
4042,113,20,0,4.53,25.84,370171,370284
4043,86,27,0,5.95,32.14,370283,370369
4044,77,30,0,6.65,50.72,370368,370445
4045,99,22,0,5.17,29.96,370444,370543
4046,83,44,0,6.17,43.61,370542,370625
4047,87,56,0,5.89,55.07,370624,370711
4048,103,21,0,4.97,27.83,370710,370813
4049,105,48,0,4.88,51.06,370812,370917
4050,95,46,0,5.39,44.93,370916,371011
4051,110,19,0,4.65,25.55,371011,371121
4052,90,20,0,5.69,30.15,371120,371210
4053,86,26,0,5.95,36.93,371209,371295
4054,87,46,0,5.89,49.04,371294,371381
4055,85,20,0,6.02,30.42,371381,371466
4056,90,20,0,5.69,32.39,371466,371556
4057,95,23,0,5.39,29.16,371556,371651
4058,113,21,0,4.53,24.16,371650,371763
4059,93,27,0,5.51,32.72,371762,371855
4060,95,36,0,5.39,42.05,371855,371950
4061,78,70,0,6.56,83.07,371949,372027
4062,95,26,0,5.39,33.59,372026,372121
4063,96,37,0,5.33,37.10,372120,372216
4064,103,24,0,4.97,28.92,372215,372318
4065,95,67,0,5.39,72.03,372317,372412
4066,100,30,0,5.12,35.21,372411,372511
4067,93,21,0,5.51,25.63,372510,372603
4068,98,19,0,5.22,28.52,372602,372700
4069,81,22,0,6.32,33.43,372699,372780
4070,91,28,0,5.63,35.33,372779,372870
4071,90,20,0,5.69,30.93,372869,372959
4072,92,23,0,5.57,27.68,372958,373050
4073,115,29,0,4.45,25.93,373050,373165
4074,91,21,0,5.63,32.48,373164,373255
4075,96,23,0,5.33,27.62,373254,373350
4076,101,21,0,5.07,31.97,373349,373450
4077,78,27,0,6.56,40.96,373449,373527
4078,110,19,0,4.65,25.04,373527,373637
4079,81,35,0,6.32,50.98,373636,373717
4080,120,20,0,4.27,18.08,373716,373836
4081,84,28,0,6.10,39.82,373835,373919
4082,124,20,0,4.13,22.43,373918,374042
4083,92,19,0,5.57,27.53,374041,374133
4084,114,20,0,4.49,20.81,374132,374246
4085,104,24,0,4.92,24.84,374245,374349
4086,98,20,0,5.22,31.15,374349,374447
4087,105,24,0,4.88,28.89,374446,374551
4088,103,24,0,4.97,27.64,374551,374654
4089,95,20,0,5.39,25.92,374654,374749
4090,100,20,0,5.12,31.17,374748,374848
4091,95,34,0,5.39,35.63,374847,374942
4092,105,28,0,4.88,39.77,374941,375046
4093,96,20,0,5.33,27.93,375045,375141
4094,89,22,0,5.75,30.23,375140,375229
4095,104,20,0,4.92,27.59,375228,375332
4096,102,18,0,5.02,22.94,375331,375433
4097,107,23,0,4.79,30.84,375432,375539
4098,143,18,0,3.58,16.57,375538,375681
4099,72,41,0,7.11,65.68,375680,375752
4100,85,24,0,6.02,32.49,375751,375836
4101,93,19,0,5.51,26.23,375835,375928
4102,112,20,0,4.57,25.55,375927,376039
4103,67,29,0,7.64,38.92,376038,376105
4104,119,26,0,4.30,22.56,376104,376223
4105,72,50,0,7.11,79.27,376222,376294
4106,98,19,0,5.22,25.62,376293,376391
4107,39,206,0,13.13,1247.96,376390,376429
4108,87,52,0,5.89,50.33,376428,376515
4109,86,32,0,5.95,37.60,376514,376600
4110,89,23,0,5.75,35.65,376599,376688
4111,75,42,0,6.83,53.82,376688,376763
4112,95,21,0,5.39,32.39,376762,376857
4113,96,28,0,5.33,35.01,376856,376952
4114,86,52,0,5.95,55.86,376951,377037
4115,98,26,0,5.22,31.42,377036,377134
4116,77,32,0,6.65,46.64,377133,377210
4117,100,24,0,5.12,36.53,377209,377309
4118,81,29,0,6.32,42.74,377308,377389
4119,108,23,0,4.74,25.67,377388,377496
4120,90,57,0,5.69,66.88,377495,377585
4121,100,20,0,5.12,31.61,377584,377684
4122,83,48,0,6.17,62.55,377683,377766
4123,102,18,0,5.02,26.59,377765,377867
4124,90,25,0,5.69,33.84,377866,377956
4125,80,36,0,6.40,53.92,377955,378035
4126,88,32,0,5.82,44.63,378034,378122
4127,96,50,0,5.33,47.93,378121,378217
4128,91,24,0,5.63,29.03,378216,378307
4129,96,21,0,5.33,27.01,378306,378402
4130,105,17,0,4.88,26.38,378401,378506
4131,103,28,0,4.97,30.30,378505,378608
4132,83,36,0,6.17,59.32,378608,378691
4133,64,85,0,8.00,140.72,378690,378754
4134,91,22,0,5.63,31.62,378754,378845
4135,97,30,0,5.28,33.42,378845,378942
4136,106,20,0,4.83,27.95,378942,379048
4137,81,30,0,6.32,44.34,379047,379128
4138,94,53,0,5.45,51.97,379127,379221
4139,76,40,0,6.74,51.56,379220,379296
4140,73,76,0,7.01,98.62,379296,379369
4141,106,23,0,4.83,26.73,379368,379474
4142,91,22,0,5.63,35.71,379473,379564
4143,103,19,0,4.97,22.13,379563,379666
4144,83,23,0,6.17,36.98,379665,379748
4145,93,23,0,5.51,35.24,379747,379840
4146,90,31,0,5.69,46.10,379839,379929
4147,99,20,0,5.17,29.58,379928,380027
4148,94,21,0,5.45,27.33,380026,380120
4149,109,19,0,4.70,26.06,380119,380228
4150,78,28,0,6.56,40.84,380227,380305
4151,100,23,0,5.12,32.97,380304,380404
4152,80,43,0,6.40,48.24,380403,380483
4153,95,20,0,5.39,27.08,380482,380577
4154,115,20,0,4.45,23.31,380576,380691
4155,91,21,0,5.63,31.82,380690,380781
4156,99,21,0,5.17,25.11,380780,380879
4157,109,20,0,4.70,25.57,380879,380988
4158,101,20,0,5.07,24.94,380987,381088
4159,111,21,0,4.61,23.86,381088,381199
4160,66,21,0,7.76,37.67,381198,381264
4161,94,28,0,5.45,41.10,381263,381357
4162,92,25,0,5.57,33.98,381356,381448
4163,93,27,0,5.51,39.80,381447,381540
4164,90,25,0,5.69,36.08,381539,381629
4165,76,31,0,6.74,43.22,381629,381705
4166,84,29,0,6.10,36.11,381705,381789
4167,102,19,0,5.02,27.00,381789,381891
4168,107,22,0,4.79,27.91,381890,381997
4169,99,23,0,5.17,37.09,381996,382095
4170,93,47,0,5.51,47.93,382094,382187
4171,94,64,0,5.45,65.40,382187,382281
4172,91,49,0,5.63,55.62,382280,382371
4173,94,20,0,5.45,29.52,382370,382464
4174,101,42,0,5.07,36.86,382464,382565
4175,84,51,0,6.10,57.47,382565,382649
4176,111,20,0,4.61,26.13,382648,382759
4177,81,40,0,6.32,51.53,382758,382839
4178,85,23,0,6.02,33.34,382838,382923
4179,95,20,0,5.39,34.39,382922,383017
4180,98,46,0,5.22,50.87,383016,383114
4181,96,24,0,5.33,37.72,383113,383209
4182,79,24,0,6.48,27.90,383208,383287
4183,105,24,0,4.88,30.87,383286,383391
4184,95,28,0,5.39,35.31,383390,383485
4185,88,26,0,5.82,33.90,383485,383573
4186,96,20,0,5.33,26.87,383572,383668
4187,98,21,0,5.22,30.77,383667,383765
4188,95,20,0,5.39,26.87,383764,383859
4189,77,26,0,6.65,38.85,383858,383935
4190,95,23,0,5.39,35.44,383934,384029
4191,91,46,0,5.63,47.22,384028,384119
4192,87,29,0,5.89,36.47,384119,384206
4193,83,97,0,6.17,124.53,384206,384289
4194,83,27,0,6.17,40.81,384288,384371
4195,106,37,0,4.83,39.46,384370,384476
4196,101,20,0,5.07,27.39,384475,384576
4197,113,22,0,4.53,30.28,384575,384688
4198,94,69,0,5.45,68.27,384687,384781
4199,90,21,0,5.69,33.26,384781,384871
4200,90,25,0,5.69,30.84,384871,384961
4201,101,22,0,5.07,30.94,384960,385061
4202,78,30,0,6.56,42.17,385061,385139
4203,72,55,0,7.11,75.68,385138,385210
4204,103,24,0,4.97,36.16,385209,385312
4205,100,19,0,5.12,24.95,385311,385411
4206,87,37,0,5.89,33.92,385411,385498
4207,101,39,0,5.07,33.07,385497,385598
4208,93,37,0,5.51,36.72,385597,385690
4209,98,33,0,5.22,36.75,385690,385788
4210,101,20,0,5.07,29.79,385787,385888
4211,94,31,0,5.45,46.78,385887,385981
4212,101,32,0,5.07,32.08,385980,386081
4213,99,36,0,5.17,31.74,386080,386179
4214,88,33,0,5.82,44.65,386178,386266
4215,105,23,0,4.88,29.25,386265,386370
4216,87,28,0,5.89,38.65,386369,386456
4217,94,20,0,5.45,28.44,386455,386549
4218,87,22,0,5.89,28.47,386548,386635
4219,82,20,0,6.24,34.45,386634,386716
4220,83,23,0,6.17,33.95,386715,386798
4221,90,37,0,5.69,46.88,386797,386887
4222,65,28,0,7.88,42.38,386886,386951
4223,86,45,0,5.95,50.04,386950,387036
4224,99,19,0,5.17,25.01,387035,387134
4225,99,20,0,5.17,29.21,387133,387232
4226,89,22,0,5.75,32.16,387231,387320
4227,112,21,0,4.57,21.92,387319,387431
4228,60,144,0,8.53,338.95,387430,387490
4229,89,25,0,5.75,35.02,387489,387578
4230,82,38,0,6.24,46.79,387577,387659
4231,89,30,0,5.75,45.33,387658,387747
4232,105,22,0,4.88,25.35,387747,387852
4233,115,23,0,4.45,27.52,387851,387966
4234,100,24,0,5.12,29.69,387965,388065
4235,99,21,0,5.17,30.89,388064,388163
4236,78,21,0,6.56,37.07,388162,388240
4237,92,27,0,5.57,36.70,388239,388331
4238,97,25,0,5.28,36.12,388330,388427
4239,100,19,0,5.12,25.55,388426,388526
4240,108,32,0,4.74,36.43,388525,388633
4241,105,21,0,4.88,27.14,388632,388737
4242,99,25,0,5.17,31.15,388737,388836
4243,95,22,0,5.39,31.67,388835,388930
4244,104,20,0,4.92,28.15,388930,389034
4245,107,25,0,4.79,31.10,389033,389140
4246,91,20,0,5.63,30.41,389139,389230
4247,86,28,0,5.95,44.04,389229,389315
4248,75,33,0,6.83,51.08,389314,389389
4249,84,74,0,6.10,96.01,389388,389472
4250,105,28,0,4.88,32.47,389471,389576
4251,96,19,0,5.33,28.87,389575,389671
4252,96,20,0,5.33,24.37,389670,389766
4253,71,62,0,7.21,82.90,389765,389836
4254,93,33,0,5.51,37.54,389835,389928
4255,92,20,0,5.57,25.46,389928,390020
4256,91,20,0,5.63,30.28,390019,390110
4257,73,22,0,7.01,30.26,390109,390182
4258,99,20,0,5.17,29.62,390182,390281
4259,100,26,0,5.12,30.65,390280,390380
4260,103,25,0,4.97,34.84,390379,390482
4261,82,49,0,6.24,64.60,390481,390563
4262,86,42,0,5.95,45.51,390562,390648
4263,77,29,0,6.65,42.07,390647,390724
4264,102,48,0,5.02,47.88,390723,390825
4265,98,19,0,5.22,21.05,390824,390922
4266,83,30,0,6.17,37.83,390922,391005
4267,90,28,0,5.69,31.24,391004,391094
4268,72,33,0,7.11,56.82,391093,391165
4269,80,39,0,6.40,52.22,391164,391244
4270,105,28,0,4.88,31.46,391243,391348
4271,102,21,0,5.02,27.90,391347,391449
4272,113,24,0,4.53,23.72,391448,391561
4273,89,53,0,5.75,58.16,391560,391649
4274,101,40,0,5.07,33.61,391648,391749
4275,83,80,0,6.17,97.71,391748,391831
4276,96,33,0,5.33,37.37,391830,391926
4277,69,42,0,7.42,60.88,391925,391994
4278,95,31,0,5.39,35.61,391993,392088
4279,98,37,0,5.22,32.40,392087,392185
4280,106,26,0,4.83,29.86,392184,392290
4281,91,38,0,5.63,38.98,392290,392381
4282,83,50,0,6.17,61.63,392380,392463
4283,92,38,0,5.57,42.42,392462,392554
4284,80,20,0,6.40,30.34,392553,392633
4285,100,19,0,5.12,25.61,392633,392733
4286,88,31,0,5.82,43.65,392732,392820
4287,91,33,0,5.63,43.35,392820,392911
4288,96,19,0,5.33,30.97,392910,393006
4289,76,24,0,6.74,32.96,393005,393081
4290,81,113,0,6.32,170.81,393080,393161
4291,102,23,0,5.02,31.84,393160,393262
4292,102,24,0,5.02,27.90,393261,393363
4293,81,22,0,6.32,29.92,393362,393443
4294,86,34,0,5.95,45.28,393442,393528
4295,76,71,0,6.74,88.11,393528,393604
4296,109,21,0,4.70,27.26,393603,393712
4297,85,24,0,6.02,35.74,393711,393796
4298,95,47,0,5.39,48.81,393795,393890
4299,94,35,0,5.45,38.37,393890,393984
4300,101,20,0,5.07,27.87,393983,394084
4301,93,23,0,5.51,29.97,394083,394176
4302,113,33,0,4.53,29.03,394175,394288
4303,120,19,0,4.27,20.33,394287,394407
4304,113,19,0,4.53,23.70,394406,394519
4305,102,20,0,5.02,22.47,394518,394620
4306,102,28,0,5.02,32.63,394619,394721
4307,101,22,0,5.07,39.75,394720,394821
4308,76,39,0,6.74,55.30,394820,394896
4309,90,36,0,5.69,42.90,394895,394985
4310,99,49,0,5.17,51.80,394984,395083
4311,99,24,0,5.17,29.46,395082,395181
4312,100,71,0,5.12,68.25,395180,395280
4313,98,40,0,5.22,35.38,395279,395377
4314,92,48,0,5.57,53.01,395377,395469
4315,92,43,0,5.57,42.77,395468,395560
4316,76,57,0,6.74,83.30,395559,395635
4317,93,37,0,5.51,41.39,395634,395727
4318,95,27,0,5.39,35.00,395726,395821
4319,104,23,0,4.92,31.03,395820,395924
4320,91,57,0,5.63,57.93,395923,396014
4321,92,21,0,5.57,28.22,396014,396106
4322,83,32,0,6.17,43.08,396105,396188
4323,78,25,0,6.56,38.37,396188,396266
4324,79,28,0,6.48,41.57,396265,396344
4325,94,21,0,5.45,33.93,396343,396437
4326,80,59,0,6.40,68.27,396436,396516
4327,84,54,0,6.10,63.47,396515,396599
4328,101,22,0,5.07,31.87,396598,396699
4329,86,23,0,5.95,35.30,396698,396784
4330,93,20,0,5.51,26.08,396783,396876
4331,97,31,0,5.28,31.15,396875,396972
4332,84,41,0,6.10,42.30,396971,397055
4333,91,27,0,5.63,36.92,397054,397145
4334,94,23,0,5.45,29.67,397144,397238
4335,120,41,0,4.27,36.51,397237,397357
4336,99,46,0,5.17,41.96,397357,397456
4337,98,21,0,5.22,29.85,397455,397553
4338,84,42,0,6.10,48.90,397552,397636
4339,104,23,0,4.92,30.63,397635,397739
4340,108,20,0,4.74,29.90,397738,397846
4341,113,22,0,4.53,28.09,397846,397959
4342,109,19,0,4.70,23.88,397958,398067
4343,75,64,0,6.83,97.88,398066,398141
4344,83,29,0,6.17,36.65,398140,398223
4345,94,19,0,5.45,23.01,398222,398316
4346,78,54,0,6.56,82.14,398315,398393
4347,80,21,0,6.40,41.37,398392,398472
4348,101,21,0,5.07,29.91,398471,398572
4349,100,37,0,5.12,38.35,398571,398671
4350,90,34,0,5.69,44.48,398670,398760
4351,99,20,0,5.17,25.88,398759,398858
4352,81,46,0,6.32,55.03,398857,398938
4353,87,26,0,5.89,31.11,398937,399024
4354,102,20,0,5.02,30.92,399023,399125
4355,91,26,0,5.63,33.38,399124,399215
4356,97,27,0,5.28,36.26,399214,399311
4357,79,61,0,6.48,72.05,399310,399389
4358,84,41,0,6.10,49.47,399388,399472
4359,72,22,0,7.11,35.04,399471,399543
4360,93,28,0,5.51,27.91,399542,399635
4361,101,19,0,5.07,23.11,399634,399735
4362,93,22,0,5.51,31.33,399734,399827
4363,99,23,0,5.17,32.61,399826,399925
4364,103,30,0,4.97,33.25,399924,400027
4365,81,23,0,6.32,34.61,400026,400107
4366,82,22,0,6.24,43.67,400106,400188
4367,97,23,0,5.28,32.43,400187,400284
4368,103,25,0,4.97,29.10,400283,400386
4369,101,28,0,5.07,31.51,400385,400486
4370,91,27,0,5.63,33.53,400485,400576
4371,105,21,0,4.88,28.97,400575,400680
4372,79,37,0,6.48,44.60,400679,400758
4373,99,25,0,5.17,28.24,400757,400856
4374,102,20,0,5.02,26.49,400855,400957
4375,82,49,0,6.24,56.16,400956,401038
4376,93,39,0,5.51,55.54,401038,401131
4377,102,30,0,5.02,36.02,401131,401233
4378,98,20,0,5.22,24.95,401232,401330
4379,97,41,0,5.28,47.29,401329,401426
4380,92,21,0,5.57,29.55,401426,401518
4381,88,49,0,5.82,58.56,401517,401605
4382,55,115,0,9.31,239.01,401604,401659
4383,80,69,0,6.40,114.21,401658,401738
4384,99,20,0,5.17,23.94,401737,401836
4385,86,28,0,5.95,40.72,401835,401921
4386,79,101,0,6.48,146.65,401920,401999
4387,112,28,0,4.57,31.44,401998,402110
4388,95,28,0,5.39,36.47,402109,402204
4389,100,24,0,5.12,30.97,402203,402303
4390,86,22,0,5.95,32.18,402302,402388
4391,102,25,0,5.02,30.25,402387,402489
4392,97,33,0,5.28,34.24,402488,402585
4393,90,26,0,5.69,32.46,402584,402674
4394,83,24,0,6.17,46.91,402673,402756
4395,103,27,0,4.97,41.64,402755,402858
4396,108,22,0,4.74,29.43,402857,402965
4397,91,26,0,5.63,28.61,402965,403056
4398,95,24,0,5.39,36.97,403055,403150
4399,97,24,0,5.28,31.17,403149,403246
4400,94,29,0,5.45,30.97,403245,403339
4401,75,22,0,6.83,35.21,403338,403413
4402,80,32,0,6.40,52.39,403412,403492
4403,88,26,0,5.82,39.33,403491,403579
4404,74,34,0,6.92,46.67,403579,403653
4405,101,25,0,5.07,32.04,403652,403753
4406,89,25,0,5.75,31.26,403752,403841
4407,85,23,0,6.02,35.13,403840,403925
4408,95,19,0,5.39,27.44,403924,404019
4409,103,33,0,4.97,36.22,404019,404122
4410,94,29,0,5.45,32.86,404121,404215
4411,86,20,0,5.95,25.14,404214,404300
4412,86,22,0,5.95,35.07,404299,404385
4413,91,22,0,5.63,32.37,404384,404475
4414,90,22,0,5.69,30.86,404474,404564
4415,86,33,0,5.95,43.39,404563,404649
4416,109,18,0,4.70,22.38,404648,404757
4417,85,25,0,6.02,36.12,404757,404842
4418,100,29,0,5.12,28.45,404841,404941
4419,121,24,0,4.23,24.62,404940,405061
4420,130,20,0,3.94,21.93,405060,405190
4421,99,25,0,5.17,32.93,405189,405288
4422,102,27,0,5.02,35.39,405287,405389
4423,100,22,0,5.12,27.59,405388,405488
4424,99,31,0,5.17,39.94,405487,405586
4425,85,29,0,6.02,39.39,405585,405670
4426,97,22,0,5.28,28.18,405669,405766
4427,115,21,0,4.45,26.30,405765,405880
4428,110,20,0,4.65,25.77,405879,405989
4429,83,41,0,6.17,52.98,405988,406071
4430,106,20,0,4.83,25.95,406070,406176
4431,94,24,0,5.45,30.06,406175,406269
4432,65,38,0,7.88,62.88,406268,406333
4433,91,22,0,5.63,39.11,406332,406423
4434,102,30,0,5.02,38.16,406422,406524
4435,106,21,0,4.83,30.33,406523,406629
4436,99,31,0,5.17,35.27,406629,406728
4437,90,31,0,5.69,39.97,406727,406817
4438,105,44,0,4.88,41.48,406817,406922
4439,97,22,0,5.28,31.19,406921,407018
4440,72,21,0,7.11,36.04,407018,407090
4441,95,36,0,5.39,41.23,407089,407184
4442,91,19,0,5.63,24.10,407183,407274
4443,95,20,0,5.39,30.28,407273,407368
4444,82,31,0,6.24,44.40,407367,407449
4445,98,24,0,5.22,32.42,407448,407546
4446,88,35,0,5.82,40.97,407545,407633
4447,103,23,0,4.97,30.65,407633,407736
4448,100,19,0,5.12,25.81,407735,407835
4449,85,47,0,6.02,67.58,407834,407919
4450,71,61,0,7.21,74.62,407919,407990
4451,100,21,0,5.12,27.53,407989,408089
4452,101,24,0,5.07,31.25,408088,408189
4453,93,25,0,5.51,30.83,408188,408281
4454,95,21,0,5.39,29.73,408280,408375
4455,89,20,0,5.75,34.21,408374,408463
4456,93,20,0,5.51,31.33,408462,408555
4457,73,26,0,7.01,41.93,408554,408627
4458,97,20,0,5.28,28.35,408626,408723
4459,91,25,0,5.63,35.51,408722,408813
4460,104,27,0,4.92,29.03,408812,408916
4461,99,27,0,5.17,36.89,408915,409014
4462,90,33,0,5.69,43.59,409013,409103
4463,86,22,0,5.95,27.65,409102,409188
4464,107,22,0,4.79,28.49,409187,409294
4465,99,44,0,5.17,45.33,409293,409392
4466,90,21,0,5.69,34.79,409391,409481
4467,97,20,0,5.28,30.49,409480,409577
4468,84,39,0,6.10,42.54,409576,409660
4469,98,42,0,5.22,44.44,409659,409757
4470,101,23,0,5.07,30.01,409756,409857
4471,103,30,0,4.97,36.26,409857,409960
4472,77,49,0,6.65,67.21,409959,410036
4473,90,106,0,5.69,140.61,410035,410125
4474,94,20,0,5.45,29.65,410124,410218
4475,92,40,0,5.57,47.59,410217,410309
4476,74,54,0,6.92,65.99,410308,410382
4477,77,26,0,6.65,44.70,410381,410458
4478,90,25,0,5.69,33.59,410457,410547
4479,102,36,0,5.02,31.43,410546,410648
4480,95,26,0,5.39,29.77,410647,410742
4481,101,19,0,5.07,27.53,410741,410842
4482,87,29,0,5.89,48.63,410841,410928
4483,91,20,0,5.63,26.39,410927,411018
4484,89,42,0,5.75,43.40,411017,411106
4485,86,70,0,5.95,75.65,411105,411191
4486,101,21,0,5.07,30.86,411190,411291
4487,61,32,0,8.39,49.81,411290,411351
4488,92,20,0,5.57,35.83,411350,411442
4489,92,21,0,5.57,30.25,411441,411533
4490,61,180,0,8.39,513.71,411533,411594
4491,85,51,0,6.02,55.13,411593,411678
4492,87,45,0,5.89,49.78,411677,411764
4493,114,23,0,4.49,23.99,411763,411877
4494,96,39,0,5.33,37.76,411876,411972
4495,106,28,0,4.83,31.27,411971,412077
4496,104,21,0,4.92,25.05,412076,412180
4497,86,58,0,5.95,67.65,412179,412265
4498,92,25,0,5.57,29.07,412264,412356
4499,58,268,0,8.83,1204.11,412355,412413
4500,97,108,0,5.28,131.36,412412,412509
4501,70,56,0,7.31,71.56,412508,412578
4502,94,20,0,5.45,29.63,412577,412671
4503,98,29,0,5.22,41.24,412671,412769
4504,104,21,0,4.92,28.42,412768,412872
4505,105,26,0,4.88,31.86,412871,412976
4506,103,26,0,4.97,32.86,412975,413078
4507,108,25,0,4.74,31.28,413077,413185
4508,87,22,0,5.89,38.03,413184,413271
4509,98,26,0,5.22,37.01,413271,413369
4510,98,29,0,5.22,36.11,413368,413466
4511,75,52,0,6.83,64.68,413465,413540
4512,99,26,0,5.17,34.67,413539,413638
4513,94,28,0,5.45,29.46,413637,413731
4514,98,61,0,5.22,59.42,413730,413828
4515,103,19,0,4.97,28.30,413828,413931
4516,98,20,0,5.22,30.44,413930,414028
4517,81,24,0,6.32,34.22,414027,414108
4518,83,34,0,6.17,39.61,414107,414190
4519,94,19,0,5.45,31.74,414189,414283
4520,89,24,0,5.75,37.11,414282,414371
4521,102,36,0,5.02,35.61,414370,414472
4522,74,30,0,6.92,31.26,414471,414545
4523,91,34,0,5.63,40.43,414544,414635
4524,84,37,0,6.10,41.59,414635,414719
4525,88,29,0,5.82,33.56,414718,414806
4526,87,69,0,5.89,86.08,414805,414892
4527,99,26,0,5.17,35.90,414891,414990
4528,82,24,0,6.24,29.96,414989,415071
4529,86,38,0,5.95,48.21,415070,415156
4530,86,22,0,5.95,33.72,415155,415241
4531,85,29,0,6.02,38.52,415240,415325
4532,103,21,0,4.97,27.39,415324,415427
4533,82,22,0,6.24,34.89,415426,415508
4534,95,28,0,5.39,31.86,415507,415602
4535,85,19,0,6.02,28.82,415601,415686
4536,106,25,0,4.83,28.74,415685,415791
4537,91,27,0,5.63,29.31,415791,415882
4538,93,23,0,5.51,33.71,415881,415974
4539,80,21,0,6.40,36.34,415973,416053
4540,98,29,0,5.22,33.73,416052,416150
4541,104,19,0,4.92,26.61,416149,416253
4542,112,22,0,4.57,28.41,416252,416364
4543,109,20,0,4.70,25.97,416363,416472
4544,101,72,0,5.07,72.92,416471,416572
4545,89,32,0,5.75,41.65,416571,416660
4546,93,30,0,5.51,37.35,416659,416752
4547,101,24,0,5.07,29.55,416751,416852
4548,58,79,0,8.83,153.14,416852,416910
4549,92,36,0,5.57,44.07,416909,417001
4550,104,20,0,4.92,24.65,417001,417105
4551,87,22,0,5.89,29.30,417104,417191
4552,78,27,0,6.56,37.17,417190,417268
4553,104,18,0,4.92,26.82,417267,417371
4554,107,24,0,4.79,26.71,417370,417477
4555,84,29,0,6.10,38.99,417477,417561
4556,84,40,0,6.10,45.23,417560,417644
4557,87,41,0,5.89,54.19,417643,417730
4558,94,37,0,5.45,45.42,417730,417824
4559,80,31,0,6.40,47.24,417824,417904
4560,73,98,0,7.01,150.42,417903,417976
4561,106,23,0,4.83,27.88,417975,418081
4562,101,25,0,5.07,31.89,418081,418182
4563,97,19,0,5.28,26.30,418182,418279
4564,77,23,0,6.65,39.40,418278,418355
4565,99,24,0,5.17,31.05,418354,418453
4566,83,34,0,6.17,44.33,418452,418535
4567,96,24,0,5.33,33.10,418534,418630
4568,94,44,0,5.45,45.84,418629,418723
4569,89,24,0,5.75,37.60,418723,418812
4570,96,26,0,5.33,37.12,418811,418907
4571,85,49,0,6.02,51.48,418906,418991
4572,43,177,0,11.91,690.97,418991,419034
4573,88,53,0,5.82,59.65,419033,419121
4574,98,33,0,5.22,35.97,419120,419218
4575,91,19,0,5.63,28.54,419217,419308
4576,93,26,0,5.51,31.65,419307,419400
4577,83,25,0,6.17,43.56,419399,419482
4578,65,117,0,7.88,230.11,419481,419546
4579,100,31,0,5.12,35.85,419545,419645
4580,92,34,0,5.57,52.03,419644,419736
4581,100,22,0,5.12,26.75,419735,419835
4582,109,23,0,4.70,29.02,419834,419943
4583,105,19,0,4.88,26.39,419942,420047
4584,94,37,0,5.45,36.14,420047,420141
4585,115,19,0,4.45,21.27,420140,420255
4586,112,22,0,4.57,25.23,420254,420366
4587,98,31,0,5.22,38.64,420365,420463
4588,91,25,0,5.63,33.77,420462,420553
4589,120,21,0,4.27,25.56,420552,420672
4590,79,35,0,6.48,46.33,420671,420750
4591,99,19,0,5.17,29.50,420749,420848
4592,102,36,0,5.02,37.69,420847,420949
4593,58,108,0,8.83,240.42,420949,421007
4594,86,42,0,5.95,52.32,421006,421092
4595,69,38,0,7.42,51.95,421091,421160
4596,84,33,0,6.10,45.13,421159,421243
4597,98,27,0,5.22,30.21,421242,421340
4598,97,34,0,5.28,37.07,421339,421436
4599,90,22,0,5.69,31.75,421435,421525
4600,99,27,0,5.17,33.19,421524,421623
4601,98,38,0,5.22,37.07,421622,421720
4602,97,39,0,5.28,41.15,421719,421816
4603,88,26,0,5.82,37.08,421815,421903
4604,104,26,0,4.92,31.07,421902,422006
4605,99,27,0,5.17,33.68,422005,422104
4606,99,31,0,5.17,33.31,422104,422203
4607,91,22,0,5.63,30.59,422202,422293
4608,103,22,0,4.97,32.46,422292,422395
4609,76,36,0,6.74,50.54,422395,422471
4610,70,103,0,7.31,165.59,422471,422541
4611,102,35,0,5.02,43.94,422541,422643
4612,106,20,0,4.83,25.08,422642,422748
4613,102,34,0,5.02,32.35,422747,422849
4614,98,20,0,5.22,28.13,422848,422946
4615,87,37,0,5.89,47.41,422945,423032
4616,78,31,0,6.56,36.58,423031,423109
4617,85,96,0,6.02,128.33,423108,423193
4618,89,44,0,5.75,42.66,423192,423281
4619,81,21,0,6.32,39.35,423280,423361
4620,82,29,0,6.24,40.99,423361,423443
4621,97,41,0,5.28,42.37,423442,423539
4622,88,24,0,5.82,32.47,423538,423626
4623,103,23,0,4.97,29.76,423625,423728
4624,98,20,0,5.22,24.77,423727,423825
4625,102,29,0,5.02,28.12,423824,423926
4626,94,23,0,5.45,29.23,423925,424019
4627,95,19,0,5.39,30.57,424018,424113
4628,88,25,0,5.82,27.85,424112,424200
4629,82,34,0,6.24,46.79,424199,424281
4630,88,29,0,5.82,38.29,424281,424369
4631,82,30,0,6.24,40.53,424368,424450
4632,92,51,0,5.57,50.66,424449,424541
4633,92,49,0,5.57,44.88,424540,424632
4634,72,57,0,7.11,66.96,424632,424704
4635,93,19,0,5.51,25.82,424704,424797
4636,83,38,0,6.17,52.02,424796,424879
4637,86,65,0,5.95,75.49,424878,424964
4638,78,52,0,6.56,63.17,424963,425041
4639,119,21,0,4.30,24.18,425040,425159
4640,86,37,0,5.95,43.39,425158,425244
4641,103,22,0,4.97,29.12,425243,425346
4642,87,71,0,5.89,97.30,425345,425432
4643,89,39,0,5.75,42.34,425432,425521
4644,101,25,0,5.07,29.55,425520,425621
4645,92,39,0,5.57,38.83,425620,425712
4646,93,28,0,5.51,32.96,425711,425804
4647,91,88,0,5.63,106.01,425803,425894
4648,100,24,0,5.12,33.53,425893,425993
4649,107,31,0,4.79,32.11,425993,426100
4650,78,29,0,6.56,41.02,426099,426177
4651,84,37,0,6.10,46.44,426177,426261
4652,78,38,0,6.56,54.53,426260,426338
4653,84,53,0,6.10,63.18,426337,426421
4654,101,27,0,5.07,24.28,426420,426521
4655,114,20,0,4.49,22.50,426520,426634
4656,72,25,0,7.11,37.04,426633,426705
4657,76,32,0,6.74,48.54,426704,426780
4658,107,19,0,4.79,23.48,426779,426886
4659,91,19,0,5.63,30.39,426885,426976
4660,126,20,0,4.06,20.66,426975,427101
4661,96,149,0,5.33,232.64,427100,427196
4662,74,20,0,6.92,37.97,427195,427269
4663,90,53,0,5.69,55.33,427269,427359
4664,102,35,0,5.02,42.08,427358,427460
4665,105,27,0,4.88,32.47,427459,427564
4666,107,19,0,4.79,22.99,427563,427670
4667,100,20,0,5.12,27.47,427669,427769
4668,87,21,0,5.89,32.77,427768,427855
4669,91,50,0,5.63,54.28,427855,427946
4670,117,19,0,4.38,24.01,427945,428062
4671,97,28,0,5.28,32.61,428061,428158
4672,99,23,0,5.17,35.84,428157,428256
4673,74,22,0,6.92,46.34,428255,428329
4674,103,24,0,4.97,31.00,428328,428431
4675,108,24,0,4.74,31.23,428431,428539
4676,103,28,0,4.97,29.39,428538,428641
4677,84,30,0,6.10,43.47,428640,428724
4678,105,63,0,4.88,64.68,428723,428828
4679,87,30,0,5.89,38.84,428827,428914
4680,90,26,0,5.69,35.01,428913,429003
4681,82,52,0,6.24,54.43,429002,429084
4682,80,22,0,6.40,39.44,429083,429163
4683,82,43,0,6.24,55.87,429162,429244
4684,92,32,0,5.57,43.27,429243,429335
4685,77,39,0,6.65,45.76,429335,429412
4686,100,21,0,5.12,30.03,429411,429511
4687,94,19,0,5.45,25.93,429510,429604
4688,92,23,0,5.57,33.77,429603,429695
4689,102,30,0,5.02,30.98,429695,429797
4690,77,57,0,6.65,88.57,429797,429874
4691,78,79,0,6.56,104.63,429873,429951
4692,104,23,0,4.92,26.99,429950,430054
4693,74,30,0,6.92,39.80,430053,430127
4694,96,24,0,5.33,33.53,430127,430223
4695,87,20,0,5.89,30.98,430222,430309
4696,78,23,0,6.56,40.43,430308,430386
4697,103,19,0,4.97,21.83,430386,430489
4698,108,24,0,4.74,25.30,430488,430596
4699,78,21,0,6.56,35.12,430596,430674
4700,91,43,0,5.63,43.20,430674,430765
4701,93,26,0,5.51,38.08,430764,430857
4702,95,28,0,5.39,33.10,430856,430951
4703,108,23,0,4.74,28.75,430950,431058
4704,86,38,0,5.95,46.44,431057,431143
4705,106,23,0,4.83,26.24,431142,431248
4706,97,21,0,5.28,28.98,431247,431344
4707,89,24,0,5.75,31.80,431343,431432
4708,108,31,0,4.74,33.88,431431,431539
4709,93,41,0,5.51,40.59,431538,431631
4710,114,23,0,4.49,24.25,431630,431744
4711,87,29,0,5.89,36.63,431743,431830
4712,96,29,0,5.33,32.24,431829,431925
4713,94,24,0,5.45,34.95,431925,432019
4714,87,68,0,5.89,73.09,432018,432105
4715,106,20,0,4.83,20.59,432104,432210
4716,97,37,0,5.28,41.36,432210,432307
4717,95,26,0,5.39,33.16,432306,432401
4718,99,18,0,5.17,24.28,432400,432499
4719,95,21,0,5.39,30.17,432498,432593
4720,104,23,0,4.92,31.40,432592,432696
4721,90,24,0,5.69,35.24,432695,432785
4722,73,37,0,7.01,42.78,432784,432857
4723,56,206,0,9.14,740.12,432856,432912
4724,93,26,0,5.51,33.86,432911,433004
4725,100,21,0,5.12,32.71,433003,433103
4726,70,23,0,7.31,38.27,433102,433172
4727,104,20,0,4.92,27.21,433171,433275
4728,82,52,0,6.24,58.36,433274,433356
4729,89,32,0,5.75,35.53,433355,433444
4730,88,24,0,5.82,36.15,433443,433531
4731,99,21,0,5.17,26.61,433531,433630
4732,102,28,0,5.02,29.73,433630,433732
4733,96,25,0,5.33,32.39,433731,433827
4734,83,41,0,6.17,52.12,433827,433910
4735,72,39,0,7.11,52.93,433910,433982
4736,80,22,0,6.40,35.52,433981,434061
4737,101,19,0,5.07,23.25,434060,434161
4738,98,23,0,5.22,30.56,434160,434258
4739,72,29,0,7.11,43.65,434257,434329
4740,95,42,0,5.39,45.56,434328,434423
4741,86,26,0,5.95,34.84,434422,434508
4742,113,25,0,4.53,28.90,434507,434620
4743,101,22,0,5.07,27.79,434620,434721
4744,116,24,0,4.41,27.64,434720,434836
4745,98,38,0,5.22,33.56,434835,434933
4746,101,28,0,5.07,33.39,434933,435034
4747,73,27,0,7.01,46.51,435034,435107
4748,97,31,0,5.28,34.80,435106,435203
4749,105,20,0,4.88,27.37,435202,435307
4750,103,30,0,4.97,35.19,435306,435409
4751,89,20,0,5.75,28.82,435408,435497
4752,87,52,0,5.89,55.96,435497,435584
4753,69,31,0,7.42,43.40,435583,435652
4754,82,35,0,6.24,38.04,435651,435733
4755,99,29,0,5.17,34.02,435732,435831
4756,81,56,0,6.32,61.82,435830,435911
4757,103,18,0,4.97,26.26,435910,436013
4758,92,18,0,5.57,27.33,436012,436104
4759,96,20,0,5.33,28.85,436103,436199
4760,93,26,0,5.51,35.39,436198,436291
4761,86,43,0,5.95,47.07,436290,436376
4762,90,18,0,5.69,27.28,436375,436465
4763,89,38,0,5.75,48.93,436464,436553
4764,124,21,0,4.13,21.03,436552,436676
4765,86,22,0,5.95,27.23,436675,436761
4766,88,30,0,5.82,49.04,436760,436848
4767,88,23,0,5.82,33.19,436847,436935
4768,101,25,0,5.07,28.86,436934,437035
4769,88,30,0,5.82,38.17,437035,437123
4770,115,20,0,4.45,25.40,437122,437237
4771,64,119,0,8.00,250.66,437237,437301
4772,91,20,0,5.63,31.35,437300,437391
4773,85,22,0,6.02,36.12,437390,437475
4774,101,21,0,5.07,28.28,437474,437575
4775,84,23,0,6.10,30.40,437574,437658
4776,112,32,0,4.57,27.91,437657,437769
4777,73,23,0,7.01,38.04,437769,437842
4778,100,18,0,5.12,22.69,437841,437941
4779,96,48,0,5.33,47.53,437940,438036
4780,75,45,0,6.83,54.62,438035,438110
4781,75,123,0,6.83,214.20,438110,438185
4782,106,24,0,4.83,28.08,438184,438290
4783,89,22,0,5.75,36.48,438289,438378
4784,92,42,0,5.57,38.85,438377,438469
4785,103,26,0,4.97,35.47,438468,438571
4786,118,20,0,4.34,24.87,438570,438688
4787,99,30,0,5.17,38.32,438687,438786
4788,91,24,0,5.63,28.76,438785,438876
4789,105,19,0,4.88,26.17,438875,438980
4790,92,42,0,5.57,51.38,438979,439071
4791,105,23,0,4.88,26.62,439070,439175
4792,96,33,0,5.33,36.24,439174,439270
4793,105,22,0,4.88,29.08,439269,439374
4794,103,21,0,4.97,30.84,439373,439476
4795,85,27,0,6.02,43.27,439476,439561
4796,93,49,0,5.51,48.55,439560,439653
4797,98,18,0,5.22,26.38,439652,439750
4798,109,19,0,4.70,23.44,439749,439858
4799,94,36,0,5.45,35.18,439857,439951
4800,102,41,0,5.02,40.92,439950,440052
4801,61,203,0,8.39,670.40,440051,440112
4802,95,26,0,5.39,38.09,440112,440207
4803,103,20,0,4.97,29.45,440206,440309
4804,76,33,0,6.74,42.48,440309,440385
4805,94,30,0,5.45,36.37,440384,440478
4806,95,39,0,5.39,43.42,440477,440572
4807,86,22,0,5.95,31.70,440571,440657
4808,89,46,0,5.75,45.58,440656,440745
4809,98,59,0,5.22,66.40,440744,440842
4810,97,62,0,5.28,57.91,440841,440938
4811,96,29,0,5.33,33.99,440937,441033
4812,103,32,0,4.97,28.84,441032,441135
4813,88,36,0,5.82,40.72,441135,441223
4814,96,25,0,5.33,32.74,441223,441319
4815,107,22,0,4.79,29.72,441318,441425
4816,83,31,0,6.17,45.35,441424,441507
4817,91,57,0,5.63,67.73,441506,441597
4818,71,23,0,7.21,44.56,441596,441667
4819,98,21,0,5.22,27.70,441666,441764
4820,91,31,0,5.63,42.87,441763,441854
4821,111,58,0,4.61,42.58,441853,441964
4822,104,23,0,4.92,28.82,441963,442067
4823,89,20,0,5.75,31.56,442066,442155
4824,114,20,0,4.49,25.32,442154,442268
4825,87,20,0,5.89,32.61,442267,442354
4826,84,69,0,6.10,76.56,442353,442437
4827,92,46,0,5.57,44.53,442436,442528
4828,99,19,0,5.17,30.38,442527,442626
4829,99,26,0,5.17,30.32,442625,442724
4830,94,20,0,5.45,29.65,442723,442817
4831,81,50,0,6.32,60.17,442816,442897
4832,81,21,0,6.32,31.45,442896,442977
4833,97,20,0,5.28,25.13,442977,443074
4834,86,46,0,5.95,51.23,443073,443159
4835,98,22,0,5.22,25.73,443158,443256
4836,98,21,0,5.22,29.83,443256,443354
4837,81,23,0,6.32,39.65,443353,443434
4838,99,19,0,5.17,27.82,443433,443532
4839,86,22,0,5.95,32.49,443531,443617
4840,112,20,0,4.57,25.99,443616,443728
4841,114,20,0,4.49,27.29,443727,443841
4842,92,22,0,5.57,37.18,443840,443932
4843,58,116,0,8.83,267.38,443931,443989
4844,97,21,0,5.28,27.79,443988,444085
4845,91,97,0,5.63,114.21,444084,444175
4846,101,22,0,5.07,27.75,444174,444275
4847,87,34,0,5.89,44.61,444274,444361
4848,94,22,0,5.45,33.52,444361,444455
4849,76,30,0,6.74,46.54,444454,444530
4850,94,23,0,5.45,36.03,444530,444624
4851,130,19,0,3.94,19.44,444623,444753
4852,81,34,0,6.32,51.97,444752,444833
4853,89,23,0,5.75,31.74,444832,444921
4854,103,20,0,4.97,29.48,444920,445023
4855,97,29,0,5.28,30.47,445022,445119
4856,99,41,0,5.17,43.44,445118,445217
4857,81,25,0,6.32,36.17,445216,445297
4858,83,23,0,6.17,34.79,445296,445379
4859,88,25,0,5.82,39.81,445378,445466
4860,97,19,0,5.28,25.11,445466,445563
4861,108,23,0,4.74,24.91,445562,445670
4862,80,23,0,6.40,40.12,445669,445749
4863,95,21,0,5.39,27.63,445748,445843
4864,96,21,0,5.33,32.06,445842,445938
4865,101,25,0,5.07,27.47,445937,446038
4866,89,21,0,5.75,31.47,446037,446126
4867,80,42,0,6.40,51.39,446125,446205
4868,70,25,0,7.31,44.44,446204,446274
4869,72,59,0,7.11,75.71,446273,446345
4870,91,27,0,5.63,32.96,446345,446436
4871,84,41,0,6.10,59.11,446435,446519
4872,80,26,0,6.40,39.72,446518,446598
4873,92,38,0,5.57,40.03,446597,446689
4874,97,20,0,5.28,35.09,446688,446785
4875,96,22,0,5.33,34.78,446784,446880
4876,84,21,0,6.10,36.90,446880,446964
4877,58,31,0,8.83,56.66,446963,447021
4878,99,33,0,5.17,36.89,447020,447119
4879,84,40,0,6.10,49.28,447119,447203
4880,113,24,0,4.53,24.44,447202,447315
4881,97,24,0,5.28,27.25,447314,447411
4882,96,21,0,5.33,28.33,447410,447506
4883,97,22,0,5.28,29.75,447505,447602
4884,105,20,0,4.88,22.79,447601,447706
4885,95,22,0,5.39,34.93,447705,447800
4886,84,24,0,6.10,39.92,447799,447883
4887,88,27,0,5.82,32.83,447882,447970
4888,90,19,0,5.69,29.57,447969,448059
4889,93,29,0,5.51,39.69,448058,448151
4890,84,20,0,6.10,37.61,448150,448234
4891,78,29,0,6.56,35.99,448233,448311
4892,87,23,0,5.89,37.94,448310,448397
4893,93,18,0,5.51,29.17,448396,448489
4894,103,21,0,4.97,26.24,448488,448591
4895,84,114,0,6.10,163.78,448590,448674
4896,90,25,0,5.69,35.68,448673,448763
4897,115,20,0,4.45,26.77,448762,448877
4898,88,38,0,5.82,39.54,448877,448965
4899,88,61,0,5.82,59.24,448964,449052
4900,102,30,0,5.02,35.61,449051,449153
4901,102,22,0,5.02,26.49,449152,449254
4902,82,51,0,6.24,52.21,449254,449336
4903,104,38,0,4.92,29.99,449335,449439
4904,71,56,0,7.21,71.24,449438,449509
4905,119,42,0,4.30,33.34,449508,449627
4906,100,19,0,5.12,23.41,449626,449726
4907,88,29,0,5.82,35.49,449725,449813
4908,73,31,0,7.01,42.45,449812,449885
4909,75,24,0,6.83,45.64,449884,449959
4910,99,33,0,5.17,47.29,449958,450057
4911,94,30,0,5.45,38.29,450057,450151
4912,75,19,0,6.83,36.62,450150,450225
4913,102,23,0,5.02,28.22,450224,450326
4914,87,23,0,5.89,29.60,450325,450412
4915,103,42,0,4.97,39.25,450411,450514
4916,100,23,0,5.12,27.79,450513,450613
4917,113,24,0,4.53,21.38,450612,450725
4918,95,20,0,5.39,24.49,450724,450819
4919,86,19,0,5.95,22.79,450818,450904
4920,89,31,0,5.75,41.02,450903,450992
4921,89,21,0,5.75,33.24,450991,451080
4922,113,25,0,4.53,27.59,451080,451193
4923,98,20,0,5.22,27.21,451192,451290
4924,101,47,0,5.07,42.70,451289,451390
4925,87,28,0,5.89,37.09,451389,451476
4926,95,22,0,5.39,34.74,451475,451570
4927,56,55,0,9.14,98.41,451569,451625
4928,91,21,0,5.63,30.96,451624,451715
4929,103,20,0,4.97,27.70,451714,451817
4930,90,29,0,5.69,36.48,451817,451907
4931,110,21,0,4.65,23.92,451906,452016
4932,96,39,0,5.33,43.37,452015,452111
4933,96,25,0,5.33,28.37,452110,452206
4934,92,28,0,5.57,37.62,452205,452297
4935,86,26,0,5.95,33.16,452296,452382
4936,111,22,0,4.61,25.70,452381,452492
4937,79,64,0,6.48,73.16,452491,452570
4938,86,43,0,5.95,47.21,452570,452656
4939,111,21,0,4.61,28.08,452655,452766
4940,62,52,0,8.26,73.87,452765,452827
4941,85,43,0,6.02,48.75,452826,452911
4942,100,20,0,5.12,23.15,452911,453011
4943,85,21,0,6.02,30.16,453010,453095
4944,118,20,0,4.34,22.72,453094,453212
4945,95,36,0,5.39,39.12,453212,453307
4946,81,23,0,6.32,41.23,453306,453387
4947,98,21,0,5.22,30.77,453386,453484
4948,99,24,0,5.17,37.64,453483,453582
4949,104,26,0,4.92,25.99,453581,453685
4950,90,30,0,5.69,31.35,453684,453774
4951,88,26,0,5.82,32.74,453773,453861
4952,84,25,0,6.10,37.42,453860,453944
4953,76,49,0,6.74,68.59,453943,454019
4954,94,26,0,5.45,35.01,454018,454112
4955,96,27,0,5.33,40.03,454111,454207
4956,82,21,0,6.24,32.33,454207,454289
4957,81,26,0,6.32,39.80,454288,454369
4958,94,43,0,5.45,39.10,454368,454462
4959,99,53,0,5.17,48.32,454461,454560
4960,91,30,0,5.63,35.53,454560,454651
4961,102,34,0,5.02,35.67,454650,454752
4962,79,33,0,6.48,43.31,454751,454830
4963,89,28,0,5.75,39.98,454829,454918
4964,87,24,0,5.89,37.02,454917,455004
4965,93,55,0,5.51,59.84,455003,455096
4966,87,53,0,5.89,55.00,455095,455182
4967,90,67,0,5.69,69.81,455181,455271
4968,89,22,0,5.75,32.68,455270,455359
4969,84,24,0,6.10,37.49,455358,455442
4970,75,21,0,6.83,36.25,455441,455516
4971,97,21,0,5.28,35.13,455515,455612
4972,107,27,0,4.79,25.46,455611,455718
4973,92,25,0,5.57,38.85,455718,455810
4974,109,24,0,4.70,28.12,455809,455918
4975,90,40,0,5.69,39.70,455918,456008
4976,103,20,0,4.97,25.29,456007,456110
4977,85,41,0,6.02,50.63,456109,456194
4978,100,21,0,5.12,32.87,456194,456294
4979,82,50,0,6.24,58.45,456294,456376
4980,102,18,0,5.02,25.88,456375,456477
4981,109,33,0,4.70,38.50,456476,456585
4982,106,23,0,4.83,28.44,456584,456690
4983,106,30,0,4.83,34.59,456689,456795
4984,65,42,0,7.88,49.00,456795,456860
4985,83,76,0,6.17,106.16,456859,456942
4986,90,22,0,5.69,29.88,456941,457031
4987,92,20,0,5.57,29.27,457030,457122
4988,82,26,0,6.24,35.48,457121,457203
4989,108,24,0,4.74,26.04,457203,457311
4990,79,33,0,6.48,45.14,457310,457389
4991,97,21,0,5.28,35.25,457388,457485
4992,102,31,0,5.02,32.84,457484,457586
4993,87,25,0,5.89,40.24,457585,457672
4994,83,19,0,6.17,29.15,457671,457754
4995,94,23,0,5.45,30.40,457753,457847
4996,113,20,0,4.53,26.28,457846,457959
4997,98,24,0,5.22,34.48,457958,458056
4998,103,21,0,4.97,30.22,458056,458159
4999,82,56,0,6.24,64.33,458158,458240
5000,94,48,0,5.45,44.46,458239,458333
5001,127,17,0,4.03,21.76,458332,458459
5002,82,26,0,6.24,34.33,458458,458540
5003,76,29,0,6.74,52.43,458539,458615
5004,103,20,0,4.97,23.29,458614,458717
5005,102,24,0,5.02,25.61,458716,458818
5006,76,118,0,6.74,209.88,458817,458893
5007,70,72,0,7.31,97.53,458892,458962
5008,114,19,0,4.49,24.25,458961,459075
5009,99,27,0,5.17,28.99,459074,459173
5010,85,47,0,6.02,44.05,459172,459257
5011,101,20,0,5.07,32.58,459256,459357
5012,92,20,0,5.57,31.48,459357,459449
5013,92,21,0,5.57,28.01,459448,459540
5014,82,21,0,6.24,38.48,459539,459621
5015,111,21,0,4.61,26.00,459620,459731
5016,86,43,0,5.95,42.35,459730,459816
5017,101,23,0,5.07,25.85,459815,459916
5018,95,22,0,5.39,25.80,459915,460010
5019,79,21,0,6.48,37.06,460009,460088
5020,107,25,0,4.79,33.08,460087,460194
5021,94,25,0,5.45,31.20,460193,460287
5022,97,29,0,5.28,32.47,460286,460383
5023,91,23,0,5.63,33.82,460383,460474
5024,88,25,0,5.82,34.54,460473,460561
5025,100,25,0,5.12,27.75,460560,460660
5026,83,20,0,6.17,32.36,460659,460742
5027,80,37,0,6.40,46.24,460741,460821
5028,117,20,0,4.38,25.31,460820,460937
5029,107,30,0,4.79,31.59,460936,461043
5030,94,20,0,5.45,27.46,461043,461137
5031,97,31,0,5.28,39.93,461136,461233
5032,91,79,0,5.63,79.42,461233,461324
5033,85,30,0,6.02,40.80,461323,461408
5034,88,23,0,5.82,37.22,461407,461495
5035,101,32,0,5.07,35.29,461494,461595
5036,106,22,0,4.83,27.01,461594,461700
5037,107,40,0,4.79,35.07,461699,461806
5038,111,20,0,4.61,26.53,461805,461916
5039,101,33,0,5.07,33.73,461916,462017
5040,87,20,0,5.89,30.35,462016,462103
5041,94,22,0,5.45,32.50,462102,462196
5042,92,32,0,5.57,34.09,462195,462287
5043,84,29,0,6.10,39.97,462286,462370
5044,96,21,0,5.33,36.08,462369,462465
5045,91,24,0,5.63,33.79,462464,462555
5046,100,23,0,5.12,30.85,462554,462654
5047,74,70,0,6.92,85.78,462653,462727
5048,82,41,0,6.24,51.01,462726,462808
5049,89,23,0,5.75,33.26,462808,462897
5050,84,23,0,6.10,35.47,462896,462980
5051,92,38,0,5.57,40.57,462979,463071
5052,94,22,0,5.45,36.06,463070,463164
5053,77,32,0,6.65,52.62,463164,463241
5054,73,43,0,7.01,58.31,463240,463313
5055,95,60,0,5.39,57.29,463312,463407
5056,98,26,0,5.22,33.54,463406,463504
5057,94,21,0,5.45,33.23,463503,463597
5058,90,34,0,5.69,52.68,463597,463687
5059,94,20,0,5.45,31.35,463686,463780
5060,93,28,0,5.51,33.60,463780,463873
5061,82,27,0,6.24,39.96,463872,463954
5062,93,39,0,5.51,40.96,463953,464046
5063,98,39,0,5.22,41.15,464045,464143
5064,98,22,0,5.22,30.38,464143,464241
5065,78,43,0,6.56,51.58,464240,464318
5066,92,29,0,5.57,37.81,464317,464409
5067,101,38,0,5.07,39.57,464408,464509
5068,96,20,0,5.33,26.43,464508,464604
5069,111,21,0,4.61,25.14,464603,464714
5070,94,20,0,5.45,30.27,464713,464807
5071,82,20,0,6.24,26.06,464806,464888
5072,106,23,0,4.83,23.88,464887,464993
5073,79,25,0,6.48,35.77,464992,465071
5074,91,21,0,5.63,29.55,465070,465161
5075,105,29,0,4.88,29.40,465160,465265
5076,114,18,0,4.49,22.97,465264,465378
5077,81,55,0,6.32,62.54,465377,465458
5078,97,21,0,5.28,30.04,465457,465554
5079,93,44,0,5.51,38.47,465553,465646
5080,88,27,0,5.82,34.38,465645,465733
5081,92,25,0,5.57,33.94,465732,465824
5082,91,23,0,5.63,34.63,465823,465914
5083,97,28,0,5.28,29.40,465913,466010
5084,91,20,0,5.63,29.18,466009,466100
5085,83,37,0,6.17,49.42,466099,466182
5086,83,23,0,6.17,35.66,466181,466264
5087,110,42,0,4.65,33.94,466263,466373
5088,84,29,0,6.10,36.90,466373,466457
5089,86,27,0,5.95,37.88,466456,466542
5090,106,30,0,4.83,32.73,466541,466647
5091,99,22,0,5.17,32.51,466646,466745
5092,80,21,0,6.40,36.02,466744,466824
5093,87,26,0,5.89,40.54,466824,466911
5094,96,23,0,5.33,27.85,466910,467006
5095,108,25,0,4.74,25.36,467005,467113
5096,94,23,0,5.45,34.48,467112,467206
5097,81,24,0,6.32,38.54,467205,467286
5098,110,20,0,4.65,25.43,467285,467395
5099,84,25,0,6.10,35.97,467394,467478
5100,95,61,0,5.39,58.81,467478,467573
5101,99,20,0,5.17,31.92,467572,467671
5102,101,29,0,5.07,28.28,467670,467771
5103,69,35,0,7.42,47.06,467770,467839
5104,99,21,0,5.17,32.24,467838,467937
5105,78,30,0,6.56,48.35,467936,468014
5106,99,27,0,5.17,32.55,468014,468113
5107,101,23,0,5.07,33.79,468112,468213
5108,88,50,0,5.82,50.94,468212,468300
5109,69,31,0,7.42,41.00,468299,468368
5110,79,45,0,6.48,60.55,468367,468446
5111,81,24,0,6.32,37.18,468445,468526
5112,93,24,0,5.51,30.14,468525,468618
5113,84,26,0,6.10,35.06,468617,468701
5114,88,20,0,5.82,29.69,468700,468788
5115,104,26,0,4.92,30.65,468787,468891
5116,89,42,0,5.75,43.15,468890,468979
5117,85,29,0,6.02,44.28,468978,469063
5118,95,25,0,5.39,30.51,469062,469157
5119,87,21,0,5.89,31.73,469156,469243
5120,100,21,0,5.12,28.05,469242,469342
5121,89,41,0,5.75,44.73,469341,469430
5122,85,20,0,6.02,30.07,469429,469514
5123,90,31,0,5.69,37.59,469513,469603
5124,88,21,0,5.82,29.44,469602,469690
5125,91,22,0,5.63,33.62,469689,469780
5126,96,39,0,5.33,44.89,469779,469875
5127,102,20,0,5.02,28.43,469874,469976
5128,72,28,0,7.11,44.96,469975,470047
5129,108,25,0,4.74,29.23,470046,470154
5130,92,23,0,5.57,37.12,470154,470246
5131,88,24,0,5.82,32.97,470245,470333
5132,87,39,0,5.89,54.17,470332,470419
5133,94,25,0,5.45,37.01,470418,470512
5134,86,26,0,5.95,35.56,470511,470597
5135,87,27,0,5.89,30.84,470596,470683
5136,92,20,0,5.57,28.94,470682,470774
5137,74,22,0,6.92,33.67,470773,470847
5138,108,25,0,4.74,23.62,470846,470954
5139,113,17,0,4.53,22.69,470953,471066
5140,107,20,0,4.79,27.59,471065,471172
5141,97,46,0,5.28,56.84,471171,471268
5142,93,36,0,5.51,36.01,471267,471360
5143,99,20,0,5.17,27.88,471359,471458
5144,90,45,0,5.69,43.21,471457,471547
5145,104,22,0,4.92,25.32,471546,471650
5146,72,22,0,7.11,32.65,471650,471722
5147,84,28,0,6.10,43.66,471721,471805
5148,102,20,0,5.02,25.73,471804,471906
5149,106,21,0,4.83,26.31,471905,472011
5150,101,53,0,5.07,48.26,472010,472111
5151,98,23,0,5.22,32.26,472110,472208
5152,89,29,0,5.75,36.84,472207,472296
5153,78,86,0,6.56,111.99,472295,472373
5154,108,19,0,4.74,23.73,472372,472480
5155,74,101,0,6.92,152.51,472480,472554
5156,103,34,0,4.97,32.16,472553,472656
5157,103,21,0,4.97,27.17,472655,472758
5158,56,82,0,9.14,155.37,472757,472813
5159,110,19,0,4.65,23.26,472813,472923
5160,98,20,0,5.22,30.73,472922,473020
5161,90,25,0,5.69,38.97,473019,473109
5162,94,21,0,5.45,27.63,473108,473202
5163,90,24,0,5.69,27.59,473202,473292
5164,109,27,0,4.70,31.06,473291,473400
5165,99,33,0,5.17,33.74,473399,473498
5166,106,21,0,4.83,25.48,473497,473603
5167,96,43,0,5.33,41.70,473602,473698
5168,94,31,0,5.45,37.59,473698,473792
5169,108,23,0,4.74,27.90,473791,473899
5170,92,24,0,5.57,32.27,473898,473990
5171,121,22,0,4.23,26.71,473989,474110
5172,69,25,0,7.42,35.11,474109,474178
5173,84,23,0,6.10,35.61,474177,474261
5174,88,32,0,5.82,40.01,474260,474348
5175,109,21,0,4.70,23.77,474347,474456
5176,81,30,0,6.32,40.05,474456,474537
5177,78,36,0,6.56,51.91,474536,474614
5178,95,26,0,5.39,31.42,474613,474708
5179,99,26,0,5.17,33.29,474707,474806
5180,115,21,0,4.45,28.27,474805,474920
5181,88,49,0,5.82,57.56,474919,475007
5182,101,30,0,5.07,30.16,475006,475107
5183,86,33,0,5.95,49.28,475106,475192
5184,90,32,0,5.69,31.06,475191,475281
5185,88,23,0,5.82,33.44,475280,475368
5186,97,19,0,5.28,29.46,475367,475464
5187,109,20,0,4.70,24.91,475464,475573
5188,89,20,0,5.75,25.71,475572,475661
5189,96,34,0,5.33,42.12,475660,475756
5190,98,19,0,5.22,29.66,475755,475853
5191,97,23,0,5.28,30.82,475852,475949
5192,105,21,0,4.88,29.37,475948,476053
5193,92,54,0,5.57,48.31,476052,476144
5194,73,53,0,7.01,65.60,476143,476216
5195,94,25,0,5.45,29.44,476215,476309
5196,98,56,0,5.22,53.81,476308,476406
5197,87,20,0,5.89,31.50,476405,476492
5198,111,20,0,4.61,22.89,476491,476602
5199,94,19,0,5.45,27.95,476601,476695
5200,92,34,0,5.57,34.25,476694,476786
5201,113,28,0,4.53,29.72,476785,476898
5202,88,28,0,5.82,38.72,476897,476985
5203,86,20,0,5.95,31.25,476984,477070
5204,88,22,0,5.82,30.83,477069,477157
5205,92,19,0,5.57,25.53,477156,477248
5206,91,21,0,5.63,26.28,477247,477338
5207,115,19,0,4.45,22.98,477338,477453
5208,96,20,0,5.33,34.16,477452,477548
5209,89,22,0,5.75,30.16,477547,477636
5210,95,20,0,5.39,27.94,477635,477730
5211,85,41,0,6.02,41.18,477729,477814
5212,87,51,0,5.89,51.30,477813,477900
5213,91,32,0,5.63,37.42,477899,477990
5214,95,42,0,5.39,49.08,477989,478084
5215,104,26,0,4.92,26.72,478083,478187
5216,87,24,0,5.89,33.73,478186,478273
5217,105,24,0,4.88,32.45,478272,478377
5218,110,28,0,4.65,26.43,478376,478486
5219,105,34,0,4.88,34.85,478485,478590
5220,101,40,0,5.07,37.01,478590,478691
5221,101,27,0,5.07,34.20,478690,478791
5222,88,35,0,5.82,42.38,478791,478879
5223,89,18,0,5.75,26.19,478879,478968
5224,109,24,0,4.70,24.14,478967,479076
5225,89,87,0,5.75,110.79,479075,479164
5226,110,17,0,4.65,19.59,479163,479273
5227,95,23,0,5.39,29.14,479272,479367
5228,93,22,0,5.51,30.21,479366,479459
5229,96,23,0,5.33,31.68,479458,479554
5230,81,34,0,6.32,41.16,479553,479634
5231,94,22,0,5.45,28.63,479633,479727
5232,95,20,0,5.39,36.68,479727,479822
5233,106,29,0,4.83,34.25,479821,479927
5234,104,21,0,4.92,34.28,479927,480031
5235,96,23,0,5.33,28.12,480030,480126
5236,100,27,0,5.12,28.21,480125,480225
5237,100,23,0,5.12,30.59,480224,480324
5238,91,20,0,5.63,33.79,480323,480414
5239,87,43,0,5.89,49.80,480414,480501
5240,74,42,0,6.92,48.32,480500,480574
5241,98,24,0,5.22,30.56,480574,480672
5242,85,43,0,6.02,55.22,480671,480756
5243,86,25,0,5.95,34.28,480755,480841
5244,90,37,0,5.69,41.13,480841,480931
5245,92,21,0,5.57,27.51,480931,481023
5246,78,41,0,6.56,44.25,481023,481101
5247,81,31,0,6.32,43.72,481100,481181
5248,101,21,0,5.07,21.95,481181,481282
5249,95,37,0,5.39,34.79,481281,481376
5250,81,22,0,6.32,36.71,481376,481457
5251,100,21,0,5.12,26.05,481456,481556
5252,80,42,0,6.40,54.39,481555,481635
5253,98,23,0,5.22,31.81,481634,481732
5254,112,18,0,4.57,21.05,481731,481843
5255,115,17,0,4.45,21.38,481842,481957
5256,91,33,0,5.63,32.34,481956,482047
5257,86,22,0,5.95,30.72,482046,482132
5258,97,50,0,5.28,49.11,482131,482228
5259,89,22,0,5.75,28.84,482227,482316
5260,87,26,0,5.89,46.10,482315,482402
5261,107,19,0,4.79,23.33,482401,482508
5262,119,27,0,4.30,31.64,482507,482626
5263,91,30,0,5.63,38.59,482625,482716
5264,117,27,0,4.38,26.71,482716,482833
5265,103,20,0,4.97,23.31,482832,482935
5266,91,28,0,5.63,34.87,482934,483025
5267,88,28,0,5.82,36.17,483024,483112
5268,76,23,0,6.74,34.56,483111,483187
5269,72,65,0,7.11,84.71,483186,483258
5270,99,28,0,5.17,30.12,483257,483356
5271,89,19,0,5.75,26.91,483355,483444
5272,110,21,0,4.65,23.68,483443,483553
5273,99,19,0,5.17,27.39,483552,483651
5274,91,38,0,5.63,40.63,483650,483741
5275,94,55,0,5.45,56.18,483740,483834
5276,81,34,0,6.32,41.97,483834,483915
5277,86,20,0,5.95,27.88,483914,484000
5278,95,21,0,5.39,25.99,483999,484094
5279,83,31,0,6.17,39.27,484094,484177
5280,93,19,0,5.51,29.07,484176,484269
5281,79,28,0,6.48,44.07,484269,484348
5282,86,20,0,5.95,28.86,484347,484433
5283,84,19,0,6.10,28.28,484432,484516
5284,101,24,0,5.07,28.70,484515,484616
5285,81,55,0,6.32,67.45,484615,484696
5286,83,29,0,6.17,44.28,484695,484778
5287,94,20,0,5.45,24.50,484777,484871
5288,99,32,0,5.17,35.94,484870,484969
5289,86,21,0,5.95,36.09,484968,485054
5290,83,23,0,6.17,40.26,485054,485137
5291,103,27,0,4.97,30.30,485136,485239
5292,95,32,0,5.39,36.45,485238,485333
5293,113,22,0,4.53,25.75,485332,485445
5294,91,39,0,5.63,38.85,485444,485535
5295,88,23,0,5.82,30.54,485534,485622
5296,106,20,0,4.83,26.46,485622,485728
5297,111,21,0,4.61,24.38,485727,485838
5298,108,20,0,4.74,26.97,485837,485945
5299,85,29,0,6.02,45.79,485944,486029
5300,98,21,0,5.22,32.26,486028,486126
5301,106,22,0,4.83,27.82,486125,486231
5302,85,46,0,6.02,55.72,486230,486315
5303,121,23,0,4.23,25.76,486314,486435
5304,103,72,0,4.97,70.40,486434,486537
5305,88,26,0,5.82,35.63,486536,486624
5306,84,21,0,6.10,30.25,486623,486707
5307,97,37,0,5.28,34.16,486706,486803
5308,77,42,0,6.65,54.62,486803,486880
5309,104,28,0,4.92,30.90,486879,486983
5310,93,19,0,5.51,30.21,486982,487075
5311,95,21,0,5.39,33.46,487074,487169
5312,74,50,0,6.92,63.53,487169,487243
5313,94,25,0,5.45,35.69,487242,487336
5314,98,22,0,5.22,27.24,487335,487433
5315,97,20,0,5.28,26.65,487432,487529
5316,100,36,0,5.12,36.69,487528,487628
5317,86,20,0,5.95,30.65,487628,487714
5318,101,20,0,5.07,29.17,487713,487814
5319,109,24,0,4.70,23.51,487813,487922
5320,87,65,0,5.89,75.83,487922,488009
5321,76,21,0,6.74,44.04,488008,488084
5322,102,20,0,5.02,26.25,488083,488185
5323,110,18,0,4.65,24.34,488184,488294
5324,96,21,0,5.33,28.31,488293,488389
5325,97,23,0,5.28,27.62,488388,488485
5326,117,28,0,4.38,30.54,488484,488601
5327,95,22,0,5.39,31.59,488600,488695
5328,87,19,0,5.89,29.76,488694,488781
5329,85,46,0,6.02,47.55,488780,488865
5330,98,28,0,5.22,33.26,488865,488963
5331,96,28,0,5.33,36.10,488962,489058
5332,71,70,0,7.21,99.60,489057,489128
5333,95,32,0,5.39,41.00,489127,489222
5334,94,21,0,5.45,31.31,489221,489315
5335,93,33,0,5.51,35.86,489314,489407
5336,53,92,0,9.66,166.34,489406,489459
5337,84,41,0,6.10,38.92,489459,489543
5338,86,49,0,5.95,58.28,489542,489628
5339,99,20,0,5.17,34.69,489627,489726
5340,88,33,0,5.82,41.88,489725,489813
5341,104,26,0,4.92,29.71,489812,489916
5342,87,22,0,5.89,37.14,489915,490002
5343,95,26,0,5.39,37.31,490001,490096
5344,85,35,0,6.02,41.27,490096,490181
5345,84,42,0,6.10,47.94,490180,490264
5346,100,22,0,5.12,28.95,490263,490363
5347,103,26,0,4.97,29.85,490362,490465
5348,97,21,0,5.28,29.64,490464,490561
5349,92,20,0,5.57,25.90,490560,490652
5350,95,27,0,5.39,32.87,490652,490747
5351,93,33,0,5.51,36.19,490747,490840
5352,108,25,0,4.74,28.56,490839,490947
5353,105,20,0,4.88,28.68,490947,491052
5354,96,20,0,5.33,31.31,491051,491147
5355,84,19,0,6.10,32.18,491146,491230
5356,90,30,0,5.69,41.46,491230,491320
5357,80,29,0,6.40,36.39,491319,491399
5358,64,133,0,8.00,301.47,491398,491462
5359,82,21,0,6.24,31.75,491461,491543
5360,96,23,0,5.33,32.78,491542,491638
5361,89,28,0,5.75,30.64,491637,491726
5362,88,43,0,5.82,43.97,491725,491813
5363,103,22,0,4.97,26.73,491812,491915
5364,90,29,0,5.69,36.81,491914,492004
5365,96,50,0,5.33,51.51,492003,492099
5366,105,23,0,4.88,26.32,492098,492203
5367,72,40,0,7.11,52.49,492202,492274
5368,96,19,0,5.33,34.95,492273,492369
5369,95,31,0,5.39,36.05,492368,492463
5370,86,20,0,5.95,23.53,492462,492548
5371,97,26,0,5.28,27.69,492548,492645
5372,82,23,0,6.24,36.94,492644,492726
5373,101,43,0,5.07,34.42,492726,492827
5374,72,109,0,7.11,196.65,492826,492898
5375,105,32,0,4.88,35.78,492897,493002
5376,77,50,0,6.65,58.67,493001,493078
5377,100,37,0,5.12,41.49,493077,493177
5378,99,28,0,5.17,30.73,493177,493276
5379,90,33,0,5.69,33.44,493275,493365
5380,91,24,0,5.63,38.15,493364,493455
5381,82,44,0,6.24,58.72,493455,493537
5382,78,21,0,6.56,38.43,493536,493614
5383,93,21,0,5.51,33.93,493613,493706
5384,94,21,0,5.45,29.01,493705,493799
5385,86,27,0,5.95,38.14,493798,493884
5386,119,24,0,4.30,27.66,493884,494003
5387,77,63,0,6.65,72.18,494003,494080
5388,88,69,0,5.82,80.10,494079,494167
5389,90,21,0,5.69,34.15,494166,494256
5390,84,87,0,6.10,114.30,494256,494340
5391,77,43,0,6.65,56.67,494339,494416
5392,91,21,0,5.63,33.11,494415,494506
5393,101,23,0,5.07,29.95,494505,494606
5394,110,23,0,4.65,27.35,494606,494716
5395,103,24,0,4.97,30.32,494715,494818
5396,87,20,0,5.89,35.23,494817,494904
5397,110,30,0,4.65,29.99,494903,495013
5398,103,24,0,4.97,29.47,495012,495115
5399,84,27,0,6.10,43.23,495115,495199
5400,96,45,0,5.33,43.91,495199,495295
5401,94,19,0,5.45,28.12,495294,495388
5402,89,20,0,5.75,27.92,495387,495476
5403,66,128,0,7.76,249.46,495476,495542
5404,83,66,0,6.17,75.49,495541,495624
5405,89,36,0,5.75,38.50,495623,495712
5406,101,35,0,5.07,31.67,495711,495812
5407,78,24,0,6.56,31.35,495811,495889
5408,84,30,0,6.10,40.11,495888,495972
5409,90,22,0,5.69,32.55,495972,496062
5410,95,26,0,5.39,36.66,496061,496156
5411,101,23,0,5.07,35.57,496155,496256
5412,88,31,0,5.82,42.63,496255,496343
5413,86,73,0,5.95,78.88,496342,496428
5414,86,38,0,5.95,41.79,496427,496513
5415,61,49,0,8.39,68.83,496513,496574
5416,69,47,0,7.42,65.20,496573,496642
5417,79,87,0,6.48,114.25,496642,496721
5418,88,26,0,5.82,37.72,496720,496808
5419,93,26,0,5.51,33.39,496807,496900
5420,85,23,0,6.02,34.85,496899,496984
5421,85,19,0,6.02,29.69,496983,497068
5422,89,24,0,5.75,28.75,497067,497156
5423,99,25,0,5.17,30.57,497155,497254
5424,93,56,0,5.51,55.07,497253,497346
5425,111,21,0,4.61,26.87,497345,497456
5426,81,30,0,6.32,41.06,497455,497536
5427,82,46,0,6.24,47.65,497536,497618
5428,108,22,0,4.74,28.67,497618,497726
5429,93,20,0,5.51,33.48,497725,497818
5430,94,23,0,5.45,34.35,497818,497912
5431,118,19,0,4.34,24.00,497912,498030
5432,99,26,0,5.17,30.99,498029,498128
5433,103,20,0,4.97,28.86,498127,498230
5434,92,20,0,5.57,33.88,498229,498321
5435,79,27,0,6.48,40.63,498321,498400
5436,111,21,0,4.61,26.17,498399,498510
5437,92,30,0,5.57,40.77,498509,498601
5438,100,34,0,5.12,37.73,498600,498700
5439,88,53,0,5.82,59.15,498699,498787
5440,110,26,0,4.65,28.99,498786,498896
5441,74,24,0,6.92,35.86,498895,498969
5442,96,46,0,5.33,51.49,498968,499064
5443,88,78,0,5.82,91.90,499063,499151
5444,78,50,0,6.56,59.86,499150,499228
5445,102,21,0,5.02,27.69,499227,499329
5446,100,63,0,5.12,59.91,499328,499428
5447,95,20,0,5.39,32.79,499427,499522
5448,73,44,0,7.01,66.70,499522,499595
5449,94,21,0,5.45,30.50,499594,499688
5450,88,68,0,5.82,82.94,499687,499775
5451,96,24,0,5.33,25.47,499774,499870
5452,94,27,0,5.45,31.33,499869,499963
5453,89,28,0,5.75,35.56,499962,500051
5454,86,21,0,5.95,31.28,500050,500136
5455,89,23,0,5.75,32.05,500135,500224
5456,94,21,0,5.45,33.27,500223,500317
5457,98,20,0,5.22,34.34,500316,500414
5458,67,91,0,7.64,163.51,500413,500480
5459,87,21,0,5.89,36.42,500480,500567
5460,102,21,0,5.02,25.82,500566,500668
5461,103,34,0,4.97,30.51,500667,500770
5462,86,36,0,5.95,47.23,500769,500855
5463,83,20,0,6.17,35.06,500854,500937
5464,104,20,0,4.92,23.05,500936,501040
5465,76,31,0,6.74,47.17,501039,501115
5466,95,27,0,5.39,28.22,501114,501209
5467,110,28,0,4.65,30.54,501208,501318
5468,90,42,0,5.69,40.55,501317,501407
5469,90,26,0,5.69,34.70,501406,501496
5470,75,38,0,6.83,45.61,501495,501570
5471,95,26,0,5.39,29.59,501569,501664
5472,101,27,0,5.07,35.99,501663,501764
5473,91,40,0,5.63,45.66,501763,501854
5474,94,20,0,5.45,22.52,501853,501947
5475,91,18,0,5.63,24.28,501946,502037
5476,69,31,0,7.42,41.26,502036,502105
5477,107,25,0,4.79,29.20,502104,502211
5478,106,21,0,4.83,28.95,502211,502317
5479,97,20,0,5.28,30.10,502316,502413
5480,85,21,0,6.02,30.78,502412,502497
5481,113,32,0,4.53,28.87,502496,502609
5482,108,26,0,4.74,25.75,502608,502716
5483,85,36,0,6.02,46.89,502716,502801
5484,80,28,0,6.40,49.79,502800,502880
5485,104,27,0,4.92,32.47,502879,502983
5486,93,21,0,5.51,37.17,502983,503076
5487,96,26,0,5.33,27.97,503075,503171
5488,76,42,0,6.74,46.80,503170,503246
5489,80,25,0,6.40,36.74,503245,503325
5490,92,27,0,5.57,41.33,503324,503416
5491,89,20,0,5.75,30.25,503415,503504
5492,95,41,0,5.39,44.85,503503,503598
5493,83,23,0,6.17,34.26,503597,503680
5494,73,42,0,7.01,54.53,503679,503752
5495,97,36,0,5.28,36.74,503752,503849
5496,95,35,0,5.39,40.28,503849,503944
5497,95,20,0,5.39,30.15,503943,504038
5498,107,20,0,4.79,30.71,504038,504145
5499,83,30,0,6.17,39.54,504144,504227
5500,94,21,0,5.45,28.72,504226,504320
5501,84,56,0,6.10,59.56,504319,504403
5502,100,21,0,5.12,29.19,504402,504502
5503,106,20,0,4.83,28.20,504501,504607
5504,98,19,0,5.22,24.13,504607,504705
5505,100,25,0,5.12,29.23,504705,504805
5506,103,27,0,4.97,32.36,504804,504907
5507,94,24,0,5.45,31.31,504906,505000
5508,83,21,0,6.17,37.01,504999,505082
5509,81,28,0,6.32,37.16,505081,505162
5510,94,33,0,5.45,46.86,505162,505256
5511,95,25,0,5.39,34.39,505255,505350
5512,96,21,0,5.33,26.31,505349,505445
5513,79,26,0,6.48,43.84,505444,505523
5514,74,38,0,6.92,54.67,505522,505596
5515,77,35,0,6.65,49.27,505596,505673
5516,92,19,0,5.57,28.31,505673,505765
5517,106,22,0,4.83,26.39,505764,505870
5518,113,20,0,4.53,29.08,505869,505982
5519,77,42,0,6.65,55.50,505982,506059
5520,107,20,0,4.79,28.30,506058,506165
5521,100,42,0,5.12,43.53,506164,506264
5522,72,37,0,7.11,57.35,506263,506335
5523,87,26,0,5.89,35.87,506334,506421
5524,113,21,0,4.53,23.72,506420,506533
5525,94,21,0,5.45,31.03,506532,506626
5526,99,24,0,5.17,34.00,506625,506724
5527,20,404,0,25.60,7557.34,506723,506743
5528,109,52,0,4.70,41.26,506742,506851
5529,87,61,0,5.89,86.12,506850,506937
5530,84,33,0,6.10,44.92,506936,507020
5531,97,21,0,5.28,21.46,507019,507116
5532,96,28,0,5.33,37.33,507115,507211
5533,107,24,0,4.79,24.80,507211,507318
5534,99,20,0,5.17,24.61,507317,507416
5535,87,30,0,5.89,33.07,507415,507502
5536,88,21,0,5.82,35.88,507501,507589
5537,73,31,0,7.01,53.49,507588,507661
5538,94,21,0,5.45,30.65,507660,507754
5539,95,38,0,5.39,40.15,507753,507848
5540,83,61,0,6.17,74.60,507847,507930
5541,106,21,0,4.83,27.07,507929,508035
5542,82,46,0,6.24,50.57,508034,508116
5543,100,29,0,5.12,44.05,508115,508215
5544,94,28,0,5.45,35.89,508214,508308
5545,103,25,0,4.97,31.45,508308,508411
5546,79,31,0,6.48,44.98,508410,508489
5547,112,21,0,4.57,25.07,508488,508600
5548,110,19,0,4.65,24.26,508599,508709
5549,102,26,0,5.02,27.16,508708,508810
5550,76,38,0,6.74,43.85,508809,508885
5551,103,29,0,4.97,38.49,508885,508988
5552,57,71,0,8.98,109.46,508988,509045
5553,106,22,0,4.83,31.71,509044,509150
5554,103,21,0,4.97,27.81,509150,509253
5555,82,20,0,6.24,37.62,509252,509334
5556,101,19,0,5.07,25.71,509333,509434
5557,126,20,0,4.06,24.95,509433,509559
5558,114,29,0,4.49,26.51,509559,509673
5559,100,20,0,5.12,26.07,509672,509772
5560,72,36,0,7.11,48.27,509772,509844
5561,76,37,0,6.74,53.38,509843,509919
5562,85,22,0,6.02,36.23,509918,510003
5563,119,22,0,4.30,27.07,510002,510121
5564,107,29,0,4.79,32.99,510120,510227
5565,93,27,0,5.51,31.22,510226,510319
5566,93,26,0,5.51,32.23,510318,510411
5567,100,24,0,5.12,30.89,510410,510510
5568,103,25,0,4.97,26.90,510510,510613
5569,88,30,0,5.82,34.81,510612,510700
5570,117,20,0,4.38,25.29,510699,510816
5571,72,84,0,7.11,120.10,510815,510887
5572,93,29,0,5.51,42.92,510886,510979
5573,79,38,0,6.48,45.41,510978,511057
5574,85,20,0,6.02,33.15,511057,511142
5575,93,19,0,5.51,28.38,511141,511234
5576,88,36,0,5.82,43.10,511233,511321
5577,100,20,0,5.12,27.33,511320,511420
5578,95,24,0,5.39,32.85,511419,511514
5579,89,50,0,5.75,47.69,511513,511602
5580,75,25,0,6.83,33.82,511602,511677
5581,96,17,0,5.33,24.49,511676,511772
5582,107,40,0,4.79,34.47,511771,511878
5583,105,27,0,4.88,31.00,511877,511982
5584,84,33,0,6.10,32.99,511981,512065
5585,116,21,0,4.41,23.81,512064,512180
5586,113,22,0,4.53,28.14,512179,512292
5587,76,73,0,6.74,99.90,512292,512368
5588,74,23,0,6.92,37.64,512367,512441
5589,101,18,0,5.07,19.67,512440,512541
5590,101,23,0,5.07,26.74,512540,512641
5591,107,23,0,4.79,26.88,512640,512747
5592,76,48,0,6.74,69.64,512746,512822
5593,71,129,0,7.21,239.63,512821,512892
5594,86,21,0,5.95,36.72,512892,512978
5595,99,24,0,5.17,32.34,512977,513076
5596,102,20,0,5.02,26.25,513075,513177
5597,97,38,0,5.28,37.29,513176,513273
5598,93,20,0,5.51,34.29,513272,513365
5599,77,26,0,6.65,38.23,513364,513441
5600,69,72,0,7.42,107.40,513440,513509
5601,85,27,0,6.02,34.99,513508,513593
5602,73,21,0,7.01,37.85,513592,513665
5603,68,35,0,7.53,63.60,513664,513732
5604,84,22,0,6.10,35.16,513731,513815
5605,89,31,0,5.75,34.14,513814,513903
5606,104,20,0,4.92,28.61,513903,514007
5607,85,39,0,6.02,51.27,514006,514091
5608,81,33,0,6.32,47.55,514090,514171
5609,88,40,0,5.82,44.83,514170,514258
5610,103,22,0,4.97,27.80,514257,514360
5611,79,27,0,6.48,41.57,514360,514439
5612,106,31,0,4.83,33.27,514438,514544
5613,81,30,0,6.32,42.91,514543,514624
5614,93,21,0,5.51,31.60,514623,514716
5615,106,25,0,4.83,25.84,514715,514821
5616,102,26,0,5.02,37.35,514820,514922
5617,110,31,0,4.65,30.81,514921,515031
5618,85,19,0,6.02,32.80,515030,515115
5619,87,25,0,5.89,39.34,515114,515201
5620,86,20,0,5.95,30.44,515200,515286
5621,95,50,0,5.39,50.49,515286,515381
5622,90,32,0,5.69,43.33,515380,515470
5623,78,42,0,6.56,54.35,515469,515547
5624,86,32,0,5.95,40.04,515547,515633
5625,99,22,0,5.17,29.21,515632,515731
5626,78,55,0,6.56,61.30,515731,515809
5627,98,89,0,5.22,91.03,515808,515906
5628,107,22,0,4.79,27.89,515905,516012
5629,105,26,0,4.88,27.08,516011,516116
5630,67,19,0,7.64,29.90,516115,516182
5631,102,23,0,5.02,30.23,516181,516283
5632,96,33,0,5.33,45.43,516283,516379
5633,89,24,0,5.75,41.65,516378,516467
5634,97,24,0,5.28,28.70,516466,516563
5635,93,26,0,5.51,32.77,516562,516655
5636,86,42,0,5.95,47.02,516654,516740
5637,92,49,0,5.57,65.57,516740,516832
5638,99,21,0,5.17,28.87,516831,516930
5639,89,46,0,5.75,44.66,516929,517018
5640,83,22,0,6.17,35.49,517017,517100
5641,95,22,0,5.39,29.42,517099,517194
5642,63,30,0,8.13,50.46,517193,517256
5643,80,20,0,6.40,31.99,517255,517335
5644,82,29,0,6.24,37.67,517334,517416
5645,106,27,0,4.83,23.54,517415,517521
5646,97,21,0,5.28,28.39,517521,517618
5647,76,24,0,6.74,37.43,517617,517693
5648,83,20,0,6.17,30.38,517692,517775
5649,80,28,0,6.40,36.49,517774,517854
5650,81,24,0,6.32,40.69,517853,517934
5651,94,20,0,5.45,27.82,517933,518027
5652,77,28,0,6.65,38.10,518026,518103
5653,91,20,0,5.63,32.12,518102,518193
5654,89,27,0,5.75,33.13,518192,518281
5655,96,28,0,5.33,37.35,518281,518377
5656,96,31,0,5.33,32.66,518376,518472
5657,99,19,0,5.17,26.77,518471,518570
5658,89,21,0,5.75,31.42,518569,518658
5659,90,22,0,5.69,29.97,518657,518747
5660,95,27,0,5.39,33.31,518746,518841
5661,92,21,0,5.57,32.31,518840,518932
5662,75,52,0,6.83,76.52,518931,519006
5663,107,37,0,4.79,37.12,519005,519112
5664,93,28,0,5.51,37.71,519111,519204
5665,78,49,0,6.56,56.91,519203,519281
5666,79,24,0,6.48,34.83,519280,519359
5667,85,22,0,6.02,35.36,519358,519443
5668,106,21,0,4.83,28.63,519442,519548
5669,98,26,0,5.22,33.75,519547,519645
5670,101,26,0,5.07,33.25,519644,519745
5671,106,20,0,4.83,30.69,519744,519850
5672,90,20,0,5.69,31.95,519849,519939
5673,77,38,0,6.65,52.59,519938,520015
5674,90,21,0,5.69,31.35,520014,520104
5675,80,27,0,6.40,37.24,520103,520183
5676,81,33,0,6.32,41.63,520183,520264
5677,82,53,0,6.24,64.26,520263,520345
5678,100,20,0,5.12,28.59,520344,520444
5679,102,25,0,5.02,28.25,520443,520545
5680,90,22,0,5.69,33.86,520544,520634
5681,107,19,0,4.79,24.97,520633,520740
5682,104,23,0,4.92,29.57,520739,520843
5683,112,33,0,4.57,35.91,520842,520954
5684,110,20,0,4.65,22.79,520953,521063
5685,100,39,0,5.12,42.73,521062,521162
5686,91,55,0,5.63,47.95,521161,521252
5687,86,32,0,5.95,35.77,521251,521337
5688,87,30,0,5.89,39.09,521336,521423
5689,85,23,0,6.02,35.03,521422,521507
5690,78,95,0,6.56,130.02,521506,521584
5691,81,54,0,6.32,59.95,521583,521664
5692,79,30,0,6.48,50.86,521663,521742
5693,90,26,0,5.69,39.46,521742,521832
5694,92,29,0,5.57,34.29,521831,521923
5695,96,28,0,5.33,37.89,521922,522018
5696,86,37,0,5.95,50.49,522018,522104
5697,86,52,0,5.95,53.37,522103,522189
5698,95,28,0,5.39,31.56,522188,522283
5699,79,20,0,6.48,31.57,522283,522362
5700,87,26,0,5.89,35.02,522362,522449
5701,110,29,0,4.65,30.79,522448,522558
5702,109,20,0,4.70,23.31,522557,522666
5703,90,30,0,5.69,36.68,522665,522755
5704,98,27,0,5.22,32.26,522754,522852
5705,81,28,0,6.32,42.12,522851,522932
5706,79,24,0,6.48,41.90,522931,523010
5707,75,71,0,6.83,93.45,523009,523084
5708,85,40,0,6.02,43.43,523083,523168
5709,80,89,0,6.40,130.79,523167,523247
5710,94,30,0,5.45,42.78,523246,523340
5711,78,41,0,6.56,54.14,523339,523417
5712,98,19,0,5.22,24.24,523417,523515
5713,94,38,0,5.45,47.57,523514,523608
5714,87,31,0,5.89,48.47,523607,523694
5715,109,22,0,4.70,26.80,523693,523802
5716,103,35,0,4.97,35.91,523802,523905
5717,96,34,0,5.33,39.87,523904,524000
5718,108,28,0,4.74,30.41,523999,524107
5719,80,73,0,6.40,93.62,524106,524186
5720,83,28,0,6.17,40.62,524185,524268
5721,104,26,0,4.92,28.17,524267,524371
5722,112,21,0,4.57,21.80,524370,524482
5723,102,18,0,5.02,24.35,524481,524583
5724,98,23,0,5.22,29.40,524583,524681
5725,93,34,0,5.51,37.56,524680,524773
5726,96,20,0,5.33,28.33,524772,524868
5727,94,38,0,5.45,38.86,524867,524961
5728,81,24,0,6.32,34.56,524960,525041
5729,67,47,0,7.64,66.65,525040,525107
5730,83,20,0,6.17,32.43,525106,525189
5731,93,42,0,5.51,44.36,525188,525281
5732,112,20,0,4.57,22.87,525280,525392
5733,87,26,0,5.89,34.31,525391,525478
5734,83,47,0,6.17,48.28,525477,525560
5735,87,21,0,5.89,27.50,525559,525646
5736,80,23,0,6.40,41.54,525645,525725
5737,94,24,0,5.45,31.03,525724,525818
5738,71,22,0,7.21,38.84,525817,525888
5739,100,25,0,5.12,27.13,525887,525987
5740,101,22,0,5.07,26.28,525986,526087
5741,116,23,0,4.41,27.35,526086,526202
5742,78,19,0,6.56,29.48,526201,526279
5743,111,22,0,4.61,26.92,526278,526389
5744,95,27,0,5.39,40.01,526388,526483
5745,105,20,0,4.88,23.61,526482,526587
5746,88,24,0,5.82,35.24,526587,526675
5747,101,19,0,5.07,27.97,526674,526775
5748,91,25,0,5.63,33.14,526774,526865
5749,85,37,0,6.02,44.23,526864,526949
5750,76,46,0,6.74,88.67,526949,527025
5751,78,38,0,6.56,52.53,527024,527102
5752,105,32,0,4.88,29.21,527101,527206
5753,126,22,0,4.06,22.49,527205,527331
5754,93,31,0,5.51,40.38,527330,527423
5755,106,20,0,4.83,23.88,527422,527528
5756,99,20,0,5.17,29.96,527527,527626
5757,96,22,0,5.33,26.89,527625,527721
5758,86,20,0,5.95,31.16,527720,527806
5759,84,30,0,6.10,46.23,527805,527889
5760,103,20,0,4.97,30.28,527888,527991
5761,90,24,0,5.69,40.33,527990,528080
5762,93,20,0,5.51,32.38,528079,528172
5763,97,28,0,5.28,35.03,528171,528268
5764,109,26,0,4.70,29.55,528267,528376
5765,118,32,0,4.34,30.95,528375,528493
5766,99,24,0,5.17,34.00,528492,528591
5767,65,73,0,7.88,107.80,528590,528655
5768,80,32,0,6.40,44.52,528654,528734
5769,93,47,0,5.51,40.72,528733,528826
5770,58,82,0,8.83,149.45,528825,528883
5771,90,58,0,5.69,58.93,528882,528972
5772,88,24,0,5.82,32.06,528971,529059
5773,91,31,0,5.63,39.31,529058,529149
5774,98,21,0,5.22,29.21,529148,529246
5775,90,26,0,5.69,35.06,529245,529335
5776,92,27,0,5.57,33.35,529334,529426
5777,98,21,0,5.22,28.21,529425,529523
5778,100,19,0,5.12,26.99,529523,529623
5779,90,25,0,5.69,36.44,529622,529712
5780,95,20,0,5.39,31.92,529711,529806
5781,82,31,0,6.24,45.04,529805,529887
5782,75,65,0,6.83,80.25,529886,529961
5783,114,25,0,4.49,28.06,529961,530075
5784,87,24,0,5.89,36.15,530074,530161
5785,115,21,0,4.45,23.36,530160,530275
5786,81,45,0,6.32,49.77,530274,530355
5787,86,20,0,5.95,32.97,530354,530440
5788,102,24,0,5.02,33.02,530439,530541
5789,98,21,0,5.22,28.73,530541,530639
5790,97,20,0,5.28,28.61,530638,530735
5791,111,26,0,4.61,24.51,530734,530845
5792,87,28,0,5.89,29.48,530844,530931
5793,87,43,0,5.89,42.03,530930,531017
5794,93,37,0,5.51,44.36,531016,531109
5795,82,20,0,6.24,25.89,531108,531190
5796,85,23,0,6.02,37.62,531189,531274
5797,89,36,0,5.75,46.46,531273,531362
5798,95,41,0,5.39,46.20,531361,531456
5799,110,24,0,4.65,25.24,531456,531566
5800,94,44,0,5.45,41.72,531565,531659
5801,89,25,0,5.75,35.87,531658,531747
5802,128,19,0,4.00,22.09,531746,531874
5803,96,23,0,5.33,27.41,531873,531969
5804,81,26,0,6.32,36.59,531968,532049
5805,91,42,0,5.63,45.57,532048,532139
5806,104,19,0,4.92,27.53,532139,532243
5807,95,27,0,5.39,31.31,532242,532337
5808,73,41,0,7.01,68.10,532336,532409
5809,80,89,0,6.40,112.11,532408,532488
5810,80,22,0,6.40,40.41,532487,532567
5811,91,29,0,5.63,36.10,532567,532658
5812,82,86,0,6.24,105.26,532657,532739
5813,89,25,0,5.75,31.15,532738,532827
5814,69,47,0,7.42,55.03,532826,532895
5815,81,51,0,6.32,54.42,532894,532975
5816,102,21,0,5.02,29.98,532974,533076
5817,85,31,0,6.02,44.09,533075,533160
5818,110,17,0,4.65,21.92,533160,533270
5819,89,24,0,5.75,35.47,533269,533358
5820,93,26,0,5.51,30.27,533357,533450
5821,55,67,0,9.31,101.12,533449,533504
5822,93,46,0,5.51,48.34,533503,533596
5823,110,24,0,4.65,23.30,533595,533705
5824,85,25,0,6.02,36.59,533704,533789
5825,78,27,0,6.56,40.55,533788,533866
5826,104,26,0,4.92,35.26,533865,533969
5827,104,35,0,4.92,26.97,533969,534073
5828,99,25,0,5.17,31.17,534072,534171
5829,64,49,0,8.00,67.94,534170,534234
5830,96,25,0,5.33,30.47,534234,534330
5831,90,23,0,5.69,39.84,534329,534419
5832,110,20,0,4.65,22.74,534419,534529
5833,101,21,0,5.07,28.76,534529,534630
5834,83,36,0,6.17,49.32,534629,534712
5835,95,19,0,5.39,28.89,534711,534806
5836,90,22,0,5.69,30.73,534805,534895
5837,78,33,0,6.56,43.32,534894,534972
5838,82,26,0,6.24,48.23,534971,535053
5839,96,21,0,5.33,31.43,535052,535148
5840,87,30,0,5.89,35.32,535147,535234
5841,101,21,0,5.07,31.95,535233,535334
5842,90,26,0,5.69,36.73,535333,535423
5843,111,49,0,4.61,38.71,535422,535533
5844,81,23,0,6.32,32.37,535532,535613
5845,97,24,0,5.28,28.02,535612,535709
5846,81,30,0,6.32,40.22,535709,535790
5847,95,21,0,5.39,30.79,535789,535884
5848,96,38,0,5.33,36.64,535883,535979
5849,104,52,0,4.92,46.59,535978,536082
5850,109,32,0,4.70,35.28,536081,536190
5851,98,24,0,5.22,29.15,536189,536287
5852,64,101,0,8.00,177.56,536286,536350
5853,96,21,0,5.33,29.87,536349,536445
5854,100,31,0,5.12,38.61,536444,536544
5855,98,20,0,5.22,33.34,536543,536641
5856,105,27,0,4.88,33.80,536640,536745
5857,94,19,0,5.45,30.63,536744,536838
5858,106,20,0,4.83,25.82,536837,536943
5859,84,43,0,6.10,53.51,536942,537026
5860,73,33,0,7.01,59.63,537025,537098
5861,106,19,0,4.83,28.25,537097,537203
5862,86,31,0,5.95,37.79,537202,537288
5863,90,31,0,5.69,39.19,537287,537377
5864,75,49,0,6.83,91.08,537376,537451
5865,106,25,0,4.83,29.54,537450,537556
5866,102,29,0,5.02,36.71,537555,537657
5867,102,25,0,5.02,31.53,537656,537758
5868,99,27,0,5.17,35.31,537757,537856
5869,101,21,0,5.07,34.38,537855,537956
5870,88,20,0,5.82,33.15,537956,538044
5871,93,29,0,5.51,33.93,538043,538136
5872,90,38,0,5.69,36.24,538135,538225
5873,111,25,0,4.61,29.66,538224,538335
5874,75,37,0,6.83,47.77,538334,538409
5875,94,27,0,5.45,34.18,538409,538503
5876,93,23,0,5.51,31.63,538502,538595
5877,96,18,0,5.33,25.22,538594,538690
5878,92,25,0,5.57,28.14,538689,538781
5879,83,21,0,6.17,27.73,538780,538863
5880,86,28,0,5.95,40.86,538862,538948
5881,99,22,0,5.17,29.09,538947,539046
5882,86,32,0,5.95,39.25,539045,539131
5883,47,74,0,10.89,138.52,539130,539177
5884,106,20,0,4.83,25.08,539176,539282
5885,99,19,0,5.17,26.77,539281,539380
5886,100,24,0,5.12,29.51,539379,539479
5887,75,20,0,6.83,34.62,539478,539553
5888,94,30,0,5.45,34.93,539552,539646
5889,111,18,0,4.61,23.80,539645,539756
5890,89,32,0,5.75,41.26,539755,539844
5891,91,22,0,5.63,33.75,539843,539934
5892,101,20,0,5.07,23.31,539933,540034
5893,97,21,0,5.28,30.51,540033,540130
5894,81,42,0,6.32,53.18,540129,540210
5895,79,34,0,6.48,46.73,540209,540288
5896,102,21,0,5.02,26.90,540287,540389
5897,81,40,0,6.32,42.14,540388,540469
5898,83,20,0,6.17,27.54,540468,540551
5899,74,26,0,6.92,41.16,540550,540624
5900,74,22,0,6.92,44.99,540623,540697
5901,93,36,0,5.51,42.47,540696,540789
5902,74,72,0,6.92,101.29,540789,540863
5903,114,23,0,4.49,25.64,540862,540976
5904,116,22,0,4.41,21.64,540975,541091
5905,76,19,0,6.74,33.77,541090,541166
5906,69,42,0,7.42,53.84,541165,541234
5907,103,20,0,4.97,27.50,541233,541336
5908,82,31,0,6.24,37.45,541335,541417
5909,98,24,0,5.22,30.15,541416,541514
5910,107,20,0,4.79,27.40,541513,541620
5911,95,27,0,5.39,29.48,541619,541714
5912,108,23,0,4.74,26.49,541714,541822
5913,91,22,0,5.63,34.26,541821,541912
5914,92,21,0,5.57,25.66,541911,542003
5915,91,36,0,5.63,34.87,542002,542093
5916,118,18,0,4.34,20.41,542092,542210
5917,80,26,0,6.40,37.16,542209,542289
5918,74,45,0,6.92,70.56,542288,542362
5919,107,23,0,4.79,26.99,542361,542468
5920,89,38,0,5.75,39.80,542467,542556
5921,96,22,0,5.33,27.28,542555,542651
5922,89,22,0,5.75,29.11,542650,542739
5923,94,27,0,5.45,30.74,542738,542832
5924,86,48,0,5.95,55.25,542831,542917
5925,91,23,0,5.63,36.10,542916,543007
5926,83,34,0,6.17,49.61,543006,543089
5927,98,22,0,5.22,22.56,543088,543186
5928,80,67,0,6.40,84.54,543185,543265
5929,90,21,0,5.69,34.77,543264,543354
5930,82,20,0,6.24,35.60,543353,543435
5931,99,19,0,5.17,27.03,543434,543533
5932,87,37,0,5.89,40.31,543532,543619
5933,92,30,0,5.57,35.07,543618,543710
5934,87,42,0,5.89,43.94,543709,543796
5935,93,29,0,5.51,33.78,543795,543888
5936,88,25,0,5.82,30.44,543887,543975
5937,74,34,0,6.92,45.29,543974,544048
5938,86,55,0,5.95,79.49,544047,544133
5939,101,32,0,5.07,32.66,544132,544233
5940,91,27,0,5.63,43.53,544232,544323
5941,99,22,0,5.17,28.10,544322,544421
5942,95,37,0,5.39,44.79,544420,544515
5943,85,26,0,6.02,40.19,544514,544599
5944,75,57,0,6.83,78.60,544598,544673
5945,91,21,0,5.63,25.55,544673,544764
5946,107,36,0,4.79,36.22,544763,544870
5947,76,23,0,6.74,40.67,544869,544945
5948,105,33,0,4.88,34.34,544944,545049
5949,95,29,0,5.39,40.91,545048,545143
5950,97,26,0,5.28,33.81,545142,545239
5951,95,25,0,5.39,36.39,545238,545333
5952,84,55,0,6.10,64.25,545332,545416
5953,96,20,0,5.33,26.16,545415,545511
5954,98,18,0,5.22,26.68,545510,545608
5955,91,39,0,5.63,50.94,545607,545698
5956,80,20,0,6.40,33.62,545697,545777
5957,89,33,0,5.75,38.75,545776,545865
5958,102,23,0,5.02,35.35,545865,545967
5959,97,26,0,5.28,36.37,545967,546064
5960,88,20,0,5.82,32.67,546063,546151
5961,101,24,0,5.07,30.52,546150,546251
5962,91,23,0,5.63,30.39,546250,546341
5963,97,19,0,5.28,28.92,546340,546437
5964,85,24,0,6.02,39.46,546437,546522
5965,88,37,0,5.82,49.92,546521,546609
5966,89,40,0,5.75,49.40,546608,546697
5967,109,34,0,4.70,35.51,546696,546805
5968,88,23,0,5.82,31.31,546804,546892
5969,93,21,0,5.51,30.01,546891,546984
5970,73,54,0,7.01,69.77,546984,547057
5971,95,24,0,5.39,40.13,547056,547151
5972,90,21,0,5.69,32.24,547150,547240
5973,82,28,0,6.24,37.60,547239,547321
5974,106,24,0,4.83,29.97,547320,547426
5975,56,45,0,9.14,64.59,547425,547481
5976,95,46,0,5.39,44.28,547480,547575
5977,104,20,0,4.92,21.84,547574,547678
5978,101,45,0,5.07,42.84,547677,547778
5979,89,23,0,5.75,41.76,547777,547866
5980,81,20,0,6.32,24.59,547865,547946
5981,89,24,0,5.75,31.49,547945,548034
5982,116,21,0,4.41,26.71,548033,548149
5983,128,19,0,4.00,18.61,548148,548276
5984,87,22,0,5.89,33.71,548275,548362
5985,112,20,0,4.57,25.03,548361,548473
5986,71,129,0,7.21,247.27,548473,548544
5987,112,44,0,4.57,33.76,548543,548655
5988,88,50,0,5.82,66.42,548654,548742
5989,87,20,0,5.89,31.76,548742,548829
5990,80,50,0,6.40,56.97,548828,548908
5991,80,102,0,6.40,142.06,548907,548987
5992,87,71,0,5.89,78.22,548986,549073
5993,89,42,0,5.75,45.92,549072,549161
5994,86,27,0,5.95,39.65,549160,549246
5995,93,25,0,5.51,36.70,549245,549338
5996,81,47,0,6.32,66.84,549337,549418
5997,91,31,0,5.63,42.43,549417,549508
5998,103,22,0,4.97,32.42,549507,549610
5999,84,34,0,6.10,42.61,549610,549694
6000,103,28,0,4.97,31.87,549693,549796
6001,89,39,0,5.75,48.10,549795,549884
6002,91,39,0,5.63,43.71,549883,549974
6003,84,27,0,6.10,39.73,549973,550057
6004,91,102,0,5.63,125.22,550056,550147
6005,99,21,0,5.17,32.26,550147,550246
6006,84,27,0,6.10,34.51,550245,550329
6007,103,26,0,4.97,27.52,550328,550431
6008,75,27,0,6.83,43.69,550430,550505
6009,94,25,0,5.45,31.08,550504,550598
6010,98,21,0,5.22,32.75,550597,550695
6011,100,26,0,5.12,34.63,550694,550794
6012,108,24,0,4.74,31.25,550794,550902
6013,93,36,0,5.51,39.15,550901,550994
6014,82,66,0,6.24,103.82,550993,551075
6015,111,19,0,4.61,22.35,551074,551185
6016,76,54,0,6.74,59.48,551184,551260
6017,111,20,0,4.61,21.12,551259,551370
6018,98,28,0,5.22,34.83,551369,551467
6019,78,34,0,6.56,42.78,551466,551544
6020,84,32,0,6.10,52.47,551544,551628
6021,83,28,0,6.17,35.20,551627,551710
6022,88,19,0,5.82,30.56,551709,551797
6023,96,18,0,5.33,28.43,551797,551893
6024,82,28,0,6.24,39.75,551892,551974
6025,104,31,0,4.92,29.90,551973,552077
6026,96,31,0,5.33,39.83,552076,552172
6027,95,27,0,5.39,29.08,552172,552267
6028,102,54,0,5.02,48.67,552266,552368
6029,79,58,0,6.48,63.77,552367,552446
6030,102,23,0,5.02,24.37,552445,552547
6031,85,21,0,6.02,36.87,552546,552631
6032,112,19,0,4.57,23.39,552630,552742
6033,87,23,0,5.89,33.39,552741,552828
6034,99,19,0,5.17,30.18,552827,552926
6035,107,22,0,4.79,25.50,552925,553032
6036,93,21,0,5.51,36.29,553031,553124
6037,99,44,0,5.17,40.06,553123,553222
6038,123,25,0,4.16,20.62,553221,553344
6039,90,40,0,5.69,43.15,553344,553434
6040,100,21,0,5.12,34.85,553433,553533
6041,93,23,0,5.51,32.27,553533,553626
6042,97,20,0,5.28,29.29,553625,553722
6043,87,24,0,5.89,38.26,553722,553809
6044,81,27,0,6.32,40.79,553808,553889
6045,98,33,0,5.22,36.26,553888,553986
6046,88,25,0,5.82,35.33,553985,554073
6047,101,18,0,5.07,26.12,554072,554173
6048,106,29,0,4.83,36.22,554173,554279
6049,89,23,0,5.75,39.83,554278,554367
6050,90,23,0,5.69,40.17,554366,554456
6051,88,20,0,5.82,39.29,554455,554543
6052,86,32,0,5.95,36.18,554542,554628
6053,97,20,0,5.28,39.36,554627,554724
6054,85,66,0,6.02,82.80,554723,554808
6055,86,24,0,5.95,31.81,554807,554893
6056,87,70,0,5.89,78.03,554892,554979
6057,96,22,0,5.33,34.70,554978,555074
6058,104,37,0,4.92,36.99,555073,555177
6059,91,30,0,5.63,34.37,555176,555267
6060,107,25,0,4.79,27.68,555266,555373
6061,92,41,0,5.57,43.44,555372,555464
6062,89,23,0,5.75,28.95,555463,555552
6063,92,23,0,5.57,37.25,555551,555643
6064,89,26,0,5.75,30.28,555642,555731
6065,113,19,0,4.53,21.43,555730,555843
6066,95,66,0,5.39,65.19,555842,555937
6067,102,18,0,5.02,21.27,555936,556038
6068,101,29,0,5.07,34.50,556037,556138
6069,70,34,0,7.31,48.16,556137,556207
6070,96,22,0,5.33,27.99,556206,556302
6071,102,21,0,5.02,26.23,556301,556403
6072,90,22,0,5.69,37.39,556403,556493
6073,98,19,0,5.22,21.79,556492,556590
6074,94,27,0,5.45,37.82,556589,556683
6075,104,28,0,4.92,30.63,556682,556786
6076,106,24,0,4.83,27.97,556785,556891
6077,98,27,0,5.22,28.36,556890,556988
6078,85,34,0,6.02,41.98,556987,557072
6079,85,36,0,6.02,39.67,557071,557156
6080,88,24,0,5.82,36.04,557155,557243
6081,96,20,0,5.33,23.39,557242,557338
6082,102,21,0,5.02,32.88,557337,557439
6083,99,24,0,5.17,30.02,557438,557537
6084,69,23,0,7.42,36.82,557536,557605
6085,127,23,0,4.03,21.65,557604,557731
6086,83,25,0,6.17,33.78,557730,557813
6087,83,23,0,6.17,33.27,557813,557896
6088,89,24,0,5.75,34.23,557895,557984
6089,105,22,0,4.88,24.13,557983,558088
6090,85,35,0,6.02,47.06,558087,558172
6091,98,36,0,5.22,38.64,558171,558269
6092,96,59,0,5.33,67.16,558268,558364
6093,105,20,0,4.88,26.74,558363,558468
6094,92,18,0,5.57,24.81,558467,558559
6095,81,33,0,6.32,43.25,558559,558640
6096,88,41,0,5.82,55.33,558639,558727
6097,87,38,0,5.89,43.02,558726,558813
6098,113,29,0,4.53,37.75,558812,558925
6099,95,22,0,5.39,35.86,558924,559019
6100,120,20,0,4.27,21.50,559018,559138
6101,72,43,0,7.11,54.99,559138,559210
6102,84,24,0,6.10,30.37,559209,559293
6103,99,21,0,5.17,32.51,559292,559391
6104,94,20,0,5.45,31.65,559391,559485
6105,102,23,0,5.02,29.73,559484,559586
6106,95,23,0,5.39,31.14,559585,559680
6107,103,25,0,4.97,23.83,559679,559782
6108,104,20,0,4.92,27.09,559781,559885
6109,88,21,0,5.82,34.42,559885,559973
6110,98,21,0,5.22,34.79,559972,560070
6111,95,26,0,5.39,35.02,560070,560165
6112,72,23,0,7.11,44.32,560164,560236
6113,96,39,0,5.33,37.76,560235,560331
6114,90,28,0,5.69,33.55,560330,560420
6115,87,29,0,5.89,35.99,560419,560506
6116,88,21,0,5.82,40.92,560505,560593
6117,88,47,0,5.82,43.81,560592,560680
6118,101,23,0,5.07,28.24,560679,560780
6119,76,127,0,6.74,218.69,560779,560855
6120,80,21,0,6.40,34.94,560854,560934
6121,91,32,0,5.63,38.81,560933,561024
6122,101,28,0,5.07,31.97,561023,561124
6123,107,19,0,4.79,22.90,561123,561230
6124,104,25,0,4.92,35.21,561230,561334
6125,102,20,0,5.02,27.74,561333,561435
6126,93,53,0,5.51,62.87,561434,561527
6127,68,23,0,7.53,34.48,561526,561594
6128,88,26,0,5.82,38.69,561593,561681
6129,101,31,0,5.07,33.79,561680,561781
6130,102,29,0,5.02,30.59,561780,561882
6131,100,29,0,5.12,32.59,561881,561981
6132,101,26,0,5.07,32.02,561980,562081
6133,111,21,0,4.61,21.57,562081,562192
6134,64,85,0,8.00,133.38,562191,562255
6135,93,23,0,5.51,33.60,562254,562347
6136,110,23,0,4.65,30.66,562346,562456
6137,93,21,0,5.51,32.31,562455,562548
6138,104,27,0,4.92,31.05,562548,562652
6139,100,32,0,5.12,39.91,562651,562751
6140,94,26,0,5.45,27.89,562750,562844
6141,71,27,0,7.21,41.12,562843,562914
6142,112,16,0,4.57,20.16,562913,563025
6143,87,33,0,5.89,37.76,563024,563111
6144,103,36,0,4.97,43.91,563110,563213
6145,107,23,0,4.79,26.43,563212,563319
6146,91,21,0,5.63,29.38,563318,563409
6147,81,40,0,6.32,50.29,563408,563489
6148,88,33,0,5.82,36.83,563488,563576
6149,98,22,0,5.22,29.30,563575,563673
6150,90,30,0,5.69,38.13,563672,563762
6151,86,91,0,5.95,114.04,563761,563847
6152,102,40,0,5.02,33.73,563846,563948
6153,78,27,0,6.56,38.89,563947,564025
6154,94,41,0,5.45,41.91,564025,564119
6155,76,102,0,6.74,149.33,564118,564194
6156,98,22,0,5.22,30.13,564193,564291
6157,78,103,0,6.56,172.66,564290,564368
6158,123,20,0,4.16,24.07,564367,564490
6159,81,23,0,6.32,35.58,564489,564570
6160,95,28,0,5.39,37.54,564570,564665
6161,87,56,0,5.89,69.18,564665,564752
6162,89,40,0,5.75,46.21,564751,564840
6163,67,23,0,7.64,37.13,564839,564906
6164,100,49,0,5.12,52.93,564905,565005
6165,101,50,0,5.07,47.73,565004,565105
6166,112,24,0,4.57,26.32,565104,565216
6167,97,19,0,5.28,26.39,565216,565313
6168,98,31,0,5.22,36.15,565312,565410
6169,87,22,0,5.89,30.52,565409,565496
6170,84,71,0,6.10,83.06,565495,565579
6171,81,39,0,6.32,48.14,565578,565659
6172,100,17,0,5.12,27.55,565658,565758
6173,88,32,0,5.82,37.26,565757,565845
6174,89,22,0,5.75,30.86,565844,565933
6175,100,22,0,5.12,26.45,565932,566032
6176,95,19,0,5.39,29.44,566031,566126
6177,93,19,0,5.51,26.12,566125,566218
6178,105,33,0,4.88,30.57,566218,566323
6179,94,29,0,5.45,30.31,566322,566416
6180,103,19,0,4.97,26.09,566416,566519
6181,127,21,0,4.03,22.47,566518,566645
6182,115,20,0,4.45,20.91,566644,566759
6183,90,21,0,5.69,38.68,566758,566848
6184,75,56,0,6.83,68.54,566847,566922
6185,103,20,0,4.97,27.66,566921,567024
6186,103,39,0,4.97,38.11,567024,567127
6187,94,24,0,5.45,31.37,567126,567220
6188,99,22,0,5.17,28.26,567219,567318
6189,98,25,0,5.22,32.17,567317,567415
6190,76,32,0,6.74,41.72,567414,567490
6191,86,40,0,5.95,48.53,567490,567576
6192,76,67,0,6.74,105.09,567575,567651
6193,103,30,0,4.97,33.72,567650,567753
6194,85,84,0,6.02,114.21,567752,567837
6195,93,21,0,5.51,39.63,567836,567929
6196,100,25,0,5.12,29.77,567928,568028
6197,108,26,0,4.74,32.53,568027,568135
6198,92,22,0,5.57,29.40,568134,568226
6199,99,18,0,5.17,29.31,568225,568324
6200,81,20,0,6.32,29.85,568323,568404
6201,96,24,0,5.33,30.85,568403,568499
6202,99,24,0,5.17,28.00,568498,568597
6203,104,21,0,4.92,22.36,568597,568701
6204,102,30,0,5.02,34.76,568700,568802
6205,101,21,0,5.07,30.62,568801,568902
6206,86,36,0,5.95,45.88,568902,568988
6207,90,27,0,5.69,35.06,568987,569077
6208,97,21,0,5.28,33.13,569076,569173
6209,92,25,0,5.57,32.81,569172,569264
6210,94,24,0,5.45,34.67,569263,569357
6211,86,23,0,5.95,32.81,569356,569442
6212,82,42,0,6.24,45.31,569441,569523
6213,89,31,0,5.75,41.92,569523,569612
6214,73,76,0,7.01,114.45,569611,569684
6215,100,35,0,5.12,27.49,569683,569783
6216,90,24,0,5.69,36.06,569782,569872
6217,96,43,0,5.33,43.81,569871,569967
6218,111,25,0,4.61,32.63,569966,570077
6219,78,29,0,6.56,40.30,570077,570155
6220,101,33,0,5.07,37.01,570154,570255
6221,109,26,0,4.70,32.06,570254,570363
6222,84,39,0,6.10,47.32,570362,570446
6223,109,50,0,4.70,47.20,570445,570554
6224,97,20,0,5.28,28.78,570554,570651
6225,108,29,0,4.74,34.17,570650,570758
6226,101,20,0,5.07,29.21,570758,570859
6227,95,20,0,5.39,30.11,570858,570953
6228,90,29,0,5.69,40.17,570952,571042
6229,86,35,0,5.95,39.65,571041,571127
6230,112,21,0,4.57,26.05,571126,571238
6231,91,31,0,5.63,35.07,571237,571328
6232,82,26,0,6.24,36.89,571327,571409
6233,99,33,0,5.17,31.78,571408,571507
6234,111,34,0,4.61,28.98,571506,571617
6235,103,21,0,4.97,29.70,571616,571719
6236,93,30,0,5.51,37.71,571718,571811
6237,81,29,0,6.32,38.00,571810,571891
6238,92,38,0,5.57,47.68,571890,571982
6239,91,40,0,5.63,51.73,571981,572072
6240,82,25,0,6.24,35.89,572071,572153
6241,100,44,0,5.12,50.47,572152,572252
6242,98,25,0,5.22,32.89,572251,572349
6243,105,30,0,4.88,33.69,572348,572453
6244,92,27,0,5.57,35.14,572452,572544
6245,102,28,0,5.02,39.00,572543,572645
6246,91,40,0,5.63,46.37,572644,572735
6247,95,30,0,5.39,43.12,572734,572829
6248,106,26,0,4.83,31.41,572828,572934
6249,82,25,0,6.24,40.62,572933,573015
6250,101,43,0,5.07,41.45,573014,573115
6251,109,22,0,4.70,24.12,573114,573223
6252,88,42,0,5.82,52.56,573222,573310
6253,104,21,0,4.92,30.09,573309,573413
6254,94,20,0,5.45,27.01,573412,573506
6255,101,55,0,5.07,49.31,573505,573606
6256,93,48,0,5.51,63.78,573605,573698
6257,105,28,0,4.88,32.30,573697,573802
6258,79,22,0,6.48,36.17,573801,573880
6259,86,20,0,5.95,30.51,573879,573965
6260,79,43,0,6.48,53.87,573964,574043
6261,116,32,0,4.41,30.41,574042,574158
6262,98,36,0,5.22,40.13,574157,574255
6263,92,31,0,5.57,33.92,574254,574346
6264,108,29,0,4.74,29.40,574345,574453
6265,106,22,0,4.83,23.84,574452,574558
6266,97,25,0,5.28,27.73,574557,574654
6267,85,32,0,6.02,34.66,574653,574738
6268,100,23,0,5.12,30.23,574737,574837
6269,96,24,0,5.33,29.45,574836,574932
6270,85,29,0,6.02,40.02,574931,575016
6271,75,21,0,6.83,37.29,575015,575090
6272,83,83,0,6.17,130.02,575089,575172
6273,79,133,0,6.48,231.34,575171,575250
6274,91,27,0,5.63,38.17,575249,575340
6275,74,46,0,6.92,54.64,575339,575413
6276,85,21,0,6.02,35.53,575412,575497
6277,101,26,0,5.07,29.87,575496,575597
6278,107,26,0,4.79,28.49,575597,575704
6279,82,23,0,6.24,40.50,575703,575785
6280,93,20,0,5.51,29.35,575785,575878
6281,95,23,0,5.39,31.31,575877,575972
6282,79,41,0,6.48,57.59,575971,576050
6283,86,66,0,5.95,74.37,576049,576135
6284,85,20,0,6.02,36.19,576134,576219
6285,100,26,0,5.12,28.99,576218,576318
6286,83,22,0,6.17,38.07,576317,576400
6287,93,22,0,5.51,28.03,576399,576492
6288,84,48,0,6.10,52.66,576492,576576
6289,88,26,0,5.82,37.22,576575,576663
6290,96,28,0,5.33,38.10,576663,576759
6291,107,18,0,4.79,27.20,576758,576865
6292,102,19,0,5.02,24.41,576864,576966
6293,103,18,0,4.97,24.67,576965,577068
6294,105,20,0,4.88,27.98,577068,577173
6295,104,20,0,4.92,25.67,577172,577276
6296,110,22,0,4.65,23.92,577275,577385
6297,98,19,0,5.22,25.52,577384,577482
6298,92,28,0,5.57,31.16,577481,577573
6299,84,26,0,6.10,38.68,577572,577656
6300,94,37,0,5.45,49.99,577655,577749
6301,82,31,0,6.24,41.70,577749,577831
6302,61,107,0,8.39,224.01,577830,577891
6303,96,42,0,5.33,42.95,577890,577986
6304,77,23,0,6.65,33.76,577985,578062
6305,74,39,0,6.92,63.13,578061,578135
6306,86,19,0,5.95,34.67,578134,578220
6307,105,33,0,4.88,28.79,578219,578324
6308,79,35,0,6.48,47.52,578323,578402
6309,89,20,0,5.75,25.11,578402,578491
6310,97,36,0,5.28,36.74,578490,578587
6311,102,26,0,5.02,29.04,578586,578688
6312,100,22,0,5.12,32.81,578687,578787
6313,95,23,0,5.39,33.23,578786,578881
6314,103,21,0,4.97,25.45,578880,578983
6315,96,20,0,5.33,27.37,578982,579078
6316,90,55,0,5.69,51.26,579077,579167
6317,81,30,0,6.32,35.65,579167,579248
6318,68,203,0,7.53,592.51,579247,579315
6319,106,41,0,4.83,39.41,579314,579420
6320,111,21,0,4.61,24.09,579419,579530
6321,103,42,0,4.97,36.90,579529,579632
6322,99,27,0,5.17,29.29,579631,579730
6323,100,19,0,5.12,22.23,579729,579829
6324,98,18,0,5.22,24.01,579828,579926
6325,81,27,0,6.32,35.87,579925,580006
6326,93,23,0,5.51,30.57,580005,580098
6327,99,27,0,5.17,30.06,580097,580196
6328,101,39,0,5.07,35.17,580195,580296
6329,89,66,0,5.75,76.12,580295,580384
6330,102,22,0,5.02,25.90,580383,580485
6331,103,21,0,4.97,25.72,580484,580587
6332,86,21,0,5.95,31.63,580586,580672
6333,84,45,0,6.10,58.21,580672,580756
6334,104,23,0,4.92,28.69,580755,580859
6335,112,20,0,4.57,24.60,580858,580970
6336,95,47,0,5.39,45.84,580969,581064
6337,64,24,0,8.00,41.88,581063,581127
6338,86,25,0,5.95,39.28,581126,581212
6339,82,82,0,6.24,111.82,581211,581293
6340,103,23,0,4.97,32.92,581292,581395
6341,91,24,0,5.63,35.86,581394,581485
6342,105,19,0,4.88,25.92,581484,581589
6343,81,49,0,6.32,53.50,581589,581670
6344,106,25,0,4.83,22.86,581669,581775
6345,90,20,0,5.69,32.26,581774,581864
6346,88,20,0,5.82,32.58,581863,581951
6347,106,25,0,4.83,30.33,581950,582056
6348,72,110,0,7.11,195.52,582055,582127
6349,78,49,0,6.56,59.37,582126,582204
6350,80,23,0,6.40,32.79,582203,582283
6351,114,20,0,4.49,27.76,582282,582396
6352,84,33,0,6.10,48.09,582395,582479
6353,72,39,0,7.11,54.04,582479,582551
6354,91,21,0,5.63,33.60,582550,582641
6355,78,27,0,6.56,41.50,582640,582718
6356,87,61,0,5.89,70.40,582717,582804
6357,91,34,0,5.63,48.72,582803,582894
6358,91,26,0,5.63,38.98,582893,582984
6359,94,20,0,5.45,26.93,582983,583077
6360,97,22,0,5.28,28.55,583076,583173
6361,90,30,0,5.69,41.35,583173,583263
6362,80,27,0,6.40,42.84,583262,583342
6363,73,22,0,7.01,34.81,583341,583414
6364,94,32,0,5.45,30.23,583413,583507
6365,82,29,0,6.24,42.06,583507,583589
6366,93,44,0,5.51,46.53,583588,583681
6367,64,35,0,8.00,64.56,583680,583744
6368,84,31,0,6.10,34.28,583743,583827
6369,108,22,0,4.74,36.67,583827,583935
6370,119,34,0,4.30,25.54,583934,584053
6371,96,22,0,5.33,33.74,584052,584148
6372,105,25,0,4.88,28.39,584147,584252
6373,87,19,0,5.89,30.29,584251,584338
6374,96,48,0,5.33,57.56,584337,584433
6375,81,20,0,6.32,30.98,584433,584514
6376,103,24,0,4.97,27.95,584513,584616
6377,92,22,0,5.57,33.27,584615,584707
6378,96,38,0,5.33,39.45,584706,584802
6379,87,21,0,5.89,36.19,584801,584888
6380,97,29,0,5.28,28.84,584887,584984
6381,87,34,0,5.89,34.88,584984,585071
6382,92,27,0,5.57,28.68,585070,585162
6383,115,26,0,4.45,27.80,585161,585276
6384,89,23,0,5.75,37.29,585275,585364
6385,94,18,0,5.45,25.95,585363,585457
6386,96,20,0,5.33,27.85,585456,585552
6387,103,20,0,4.97,28.57,585551,585654
6388,104,23,0,4.92,30.59,585654,585758
6389,77,23,0,6.65,40.44,585757,585834
6390,85,19,0,6.02,30.09,585833,585918
6391,88,117,0,5.82,181.29,585918,586006
6392,76,24,0,6.74,41.93,586005,586081
6393,94,22,0,5.45,35.48,586080,586174
6394,94,36,0,5.45,37.03,586173,586267
6395,85,45,0,6.02,57.18,586266,586351
6396,99,22,0,5.17,26.97,586350,586449
6397,108,18,0,4.74,24.60,586449,586557
6398,87,76,0,5.89,85.50,586556,586643
6399,75,30,0,6.83,53.61,586642,586717
6400,96,23,0,5.33,27.72,586716,586812
6401,107,20,0,4.79,27.33,586811,586918
6402,92,20,0,5.57,30.31,586917,587009
6403,104,20,0,4.92,24.07,587008,587112
6404,90,41,0,5.69,44.75,587111,587201
6405,83,31,0,6.17,52.89,587200,587283
6406,93,27,0,5.51,44.08,587282,587375
6407,72,59,0,7.11,82.04,587374,587446
6408,101,29,0,5.07,33.65,587445,587546
6409,81,33,0,6.32,56.69,587545,587626
6410,71,21,0,7.21,32.48,587625,587696
6411,90,22,0,5.69,32.84,587695,587785
6412,107,42,0,4.79,42.32,587784,587891
6413,94,26,0,5.45,36.93,587890,587984
6414,80,34,0,6.40,48.12,587983,588063
6415,86,20,0,5.95,28.09,588062,588148
6416,122,22,0,4.20,24.24,588147,588269
6417,95,22,0,5.39,35.94,588268,588363
6418,91,30,0,5.63,35.33,588362,588453
6419,97,31,0,5.28,35.75,588452,588549
6420,101,31,0,5.07,31.85,588548,588649
6421,84,31,0,6.10,35.59,588648,588732
6422,88,20,0,5.82,35.90,588731,588819
6423,90,32,0,5.69,45.35,588818,588908
6424,86,56,0,5.95,75.39,588907,588993
6425,96,19,0,5.33,32.58,588992,589088
6426,99,20,0,5.17,30.34,589088,589187
6427,77,40,0,6.65,46.38,589186,589263
6428,73,41,0,7.01,52.86,589262,589335
6429,99,49,0,5.17,53.78,589334,589433
6430,79,21,0,6.48,33.57,589433,589512
6431,86,24,0,5.95,39.63,589511,589597
6432,92,20,0,5.57,32.59,589596,589688
6433,80,62,0,6.40,75.89,589687,589767
6434,89,44,0,5.75,47.89,589766,589855
6435,86,33,0,5.95,38.90,589854,589940
6436,100,23,0,5.12,31.21,589939,590039
6437,81,65,0,6.32,73.58,590038,590119
6438,101,39,0,5.07,39.00,590118,590219
6439,97,25,0,5.28,32.57,590218,590315
6440,76,24,0,6.74,35.64,590314,590390
6441,83,65,0,6.17,73.49,590389,590472
6442,109,24,0,4.70,30.65,590471,590580
6443,74,35,0,6.92,44.53,590579,590653
6444,108,33,0,4.74,31.67,590652,590760
6445,99,30,0,5.17,34.38,590760,590859
6446,97,24,0,5.28,32.14,590858,590955
6447,106,29,0,4.83,30.93,590954,591060
6448,98,20,0,5.22,31.95,591059,591157
6449,100,38,0,5.12,30.13,591156,591256
6450,109,34,0,4.70,28.23,591255,591364
6451,96,21,0,5.33,27.47,591363,591459
6452,85,22,0,6.02,34.47,591458,591543
6453,105,21,0,4.88,26.87,591542,591647
6454,80,23,0,6.40,34.92,591646,591726
6455,96,27,0,5.33,37.33,591725,591821
6456,97,20,0,5.28,29.38,591820,591917
6457,94,28,0,5.45,36.42,591917,592011
6458,109,18,0,4.70,22.38,592010,592119
6459,104,20,0,4.92,26.76,592119,592223
6460,82,24,0,6.24,44.50,592222,592304
6461,88,32,0,5.82,38.44,592303,592391
6462,99,27,0,5.17,30.38,592390,592489
6463,88,31,0,5.82,38.29,592488,592576
6464,100,21,0,5.12,25.27,592575,592675
6465,100,54,0,5.12,50.45,592674,592774
6466,110,36,0,4.65,32.99,592773,592883
6467,79,19,0,6.48,30.33,592882,592961
6468,92,32,0,5.57,33.81,592960,593052
6469,120,19,0,4.27,23.91,593051,593171
6470,99,33,0,5.17,35.13,593171,593270
6471,87,64,0,5.89,71.83,593269,593356
6472,89,66,0,5.75,76.50,593355,593444
6473,106,20,0,4.83,28.07,593443,593549
6474,81,45,0,6.32,57.55,593548,593629
6475,81,33,0,6.32,47.21,593629,593710
6476,97,21,0,5.28,29.25,593709,593806
6477,102,38,0,5.02,38.65,593805,593907
6478,91,35,0,5.63,40.28,593907,593998
6479,97,24,0,5.28,28.63,593997,594094
6480,95,25,0,5.39,33.88,594093,594188
6481,90,54,0,5.69,71.13,594187,594277
6482,109,30,0,4.70,30.47,594276,594385
6483,99,18,0,5.17,24.81,594384,594483
6484,96,27,0,5.33,36.76,594482,594578
6485,96,26,0,5.33,31.33,594577,594673
6486,79,20,0,6.48,34.40,594672,594751
6487,90,20,0,5.69,32.33,594750,594840
6488,87,61,0,5.89,68.06,594839,594926
6489,91,32,0,5.63,36.34,594925,595016
6490,102,23,0,5.02,29.35,595016,595118
6491,99,23,0,5.17,30.43,595117,595216
6492,96,19,0,5.33,26.16,595215,595311
6493,80,29,0,6.40,55.52,595310,595390
6494,101,19,0,5.07,25.53,595389,595490
6495,100,29,0,5.12,38.73,595489,595589
6496,109,42,0,4.70,35.29,595588,595697
6497,83,30,0,6.17,39.63,595697,595780
6498,82,22,0,6.24,37.77,595780,595862
6499,77,35,0,6.65,39.76,595862,595939
6500,64,128,0,8.00,264.84,595938,596002
6501,85,20,0,6.02,32.14,596001,596086
6502,100,22,0,5.12,29.33,596085,596185
6503,96,34,0,5.33,40.91,596184,596280
6504,92,80,0,5.57,91.79,596280,596372
6505,101,28,0,5.07,36.10,596371,596472
6506,110,21,0,4.65,25.72,596471,596581
6507,105,21,0,4.88,25.44,596580,596685
6508,97,29,0,5.28,35.99,596684,596781
6509,89,26,0,5.75,34.25,596780,596869
6510,63,35,0,8.13,56.90,596868,596931
6511,81,45,0,6.32,67.11,596931,597012
6512,97,39,0,5.28,35.07,597012,597109
6513,90,28,0,5.69,30.15,597108,597198
6514,101,37,0,5.07,35.49,597197,597298
6515,87,49,0,5.89,64.01,597297,597384
6516,102,22,0,5.02,29.10,597383,597485
6517,92,33,0,5.57,39.03,597484,597576
6518,115,22,0,4.45,24.07,597575,597690
6519,112,23,0,4.57,29.89,597689,597801
6520,82,26,0,6.24,33.06,597800,597882
6521,73,99,0,7.01,164.26,597881,597954
6522,87,29,0,5.89,40.93,597954,598041
6523,78,72,0,6.56,109.30,598040,598118
6524,72,93,0,7.11,132.93,598117,598189
6525,72,152,0,7.11,317.60,598188,598260
6526,96,27,0,5.33,33.81,598259,598355
6527,86,20,0,5.95,33.95,598354,598440
6528,64,42,0,8.00,63.97,598439,598503
6529,119,36,0,4.30,29.08,598502,598621
6530,113,22,0,4.53,29.88,598621,598734
6531,98,20,0,5.22,25.24,598734,598832
6532,107,27,0,4.79,27.22,598831,598938
6533,72,49,0,7.11,55.77,598937,599009
6534,83,34,0,6.17,40.02,599008,599091
6535,94,29,0,5.45,41.59,599090,599184
6536,101,20,0,5.07,28.96,599183,599284
6537,96,32,0,5.33,34.49,599283,599379
6538,80,59,0,6.40,67.16,599378,599458
6539,90,47,0,5.69,47.81,599458,599548
6540,90,58,0,5.69,76.10,599547,599637
6541,89,60,0,5.75,59.08,599636,599725
6542,104,32,0,4.92,38.30,599724,599828
6543,69,20,0,7.42,37.49,599827,599896
6544,92,19,0,5.57,31.22,599895,599987
6545,93,38,0,5.51,41.84,599987,600080
6546,101,21,0,5.07,27.41,600079,600180
6547,86,20,0,5.95,31.09,600179,600265
6548,93,23,0,5.51,33.37,600264,600357
6549,94,24,0,5.45,38.55,600356,600450
6550,49,265,0,10.45,1383.84,600449,600498
6551,89,35,0,5.75,47.31,600497,600586
6552,86,46,0,5.95,52.97,600585,600671
6553,83,42,0,6.17,46.00,600670,600753
6554,92,39,0,5.57,40.53,600752,600844
6555,87,24,0,5.89,31.69,600843,600930
6556,105,21,0,4.88,27.96,600929,601034
6557,107,26,0,4.79,31.31,601033,601140
6558,104,35,0,4.92,37.17,601139,601243
6559,89,22,0,5.75,35.13,601242,601331
6560,83,24,0,6.17,36.19,601331,601414
6561,85,43,0,6.02,48.19,601414,601499
6562,92,28,0,5.57,38.51,601498,601590
6563,104,24,0,4.92,31.49,601589,601693
6564,85,35,0,6.02,44.71,601692,601777
6565,81,21,0,6.32,38.86,601776,601857
6566,71,118,0,7.21,209.86,601856,601927
6567,68,38,0,7.53,54.40,601926,601994
6568,94,18,0,5.45,22.78,601993,602087
6569,86,25,0,5.95,35.58,602086,602172
6570,98,20,0,5.22,28.26,602171,602269
6571,89,21,0,5.75,40.39,602268,602357
6572,84,23,0,6.10,28.30,602356,602440
6573,68,28,0,7.53,45.22,602439,602507
6574,97,23,0,5.28,31.36,602506,602603
6575,90,70,0,5.69,77.48,602602,602692
6576,86,23,0,5.95,38.58,602692,602778
6577,98,28,0,5.22,29.89,602777,602875
6578,84,21,0,6.10,37.94,602874,602958
6579,92,31,0,5.57,32.29,602958,603050
6580,103,31,0,4.97,40.09,603050,603153
6581,109,27,0,4.70,33.44,603153,603262
6582,100,19,0,5.12,26.65,603261,603361
6583,126,19,0,4.06,20.14,603360,603486
6584,83,29,0,6.17,46.09,603485,603568
6585,104,20,0,4.92,31.76,603567,603671
6586,94,20,0,5.45,32.52,603670,603764
6587,92,25,0,5.57,31.55,603763,603855
6588,92,20,0,5.57,28.72,603854,603946
6589,97,22,0,5.28,32.18,603945,604042
6590,71,65,0,7.21,82.05,604041,604112
6591,110,26,0,4.65,31.34,604111,604221
6592,98,40,0,5.22,40.64,604220,604318
6593,97,23,0,5.28,27.69,604317,604414
6594,89,60,0,5.75,63.29,604413,604502
6595,101,41,0,5.07,38.08,604501,604602
6596,83,20,0,6.17,33.10,604601,604684
6597,85,23,0,6.02,38.07,604683,604768
6598,103,22,0,4.97,30.49,604767,604870
6599,99,42,0,5.17,43.80,604869,604968
6600,92,37,0,5.57,30.55,604967,605059
6601,99,25,0,5.17,30.87,605058,605157
6602,82,40,0,6.24,45.60,605156,605238
6603,95,56,0,5.39,55.04,605238,605333
6604,106,19,0,4.83,25.10,605333,605439
6605,103,29,0,4.97,34.73,605438,605541
6606,83,72,0,6.17,86.50,605540,605623
6607,95,21,0,5.39,30.43,605623,605718
6608,77,39,0,6.65,60.07,605717,605794
6609,102,22,0,5.02,31.29,605793,605895
6610,116,20,0,4.41,21.41,605894,606010
6611,95,32,0,5.39,36.97,606010,606105
6612,92,17,0,5.57,23.31,606105,606197
6613,99,37,0,5.17,39.96,606196,606295
6614,97,25,0,5.28,29.66,606294,606391
6615,69,26,0,7.42,48.68,606391,606460
6616,88,60,0,5.82,62.72,606459,606547
6617,102,21,0,5.02,27.55,606546,606648
6618,117,19,0,4.38,23.28,606648,606765
6619,105,28,0,4.88,31.42,606765,606870
6620,108,23,0,4.74,22.86,606870,606978
6621,76,176,0,6.74,410.25,606977,607053
6622,78,39,0,6.56,43.48,607052,607130
6623,79,49,0,6.48,53.36,607130,607209
6624,87,30,0,5.89,45.21,607208,607295
6625,96,20,0,5.33,24.12,607294,607390
6626,107,22,0,4.79,26.41,607390,607497
6627,87,24,0,5.89,37.39,607496,607583
6628,73,24,0,7.01,43.79,607582,607655
6629,97,20,0,5.28,29.27,607655,607752
6630,90,21,0,5.69,37.21,607751,607841
6631,86,20,0,5.95,29.00,607840,607926
6632,81,31,0,6.32,45.58,607925,608006
6633,85,25,0,6.02,40.52,608005,608090
6634,118,45,0,4.34,34.72,608089,608207
6635,87,32,0,5.89,41.78,608206,608293
6636,96,38,0,5.33,41.24,608292,608388
6637,97,31,0,5.28,34.04,608388,608485
6638,78,20,0,6.56,32.07,608485,608563
6639,96,20,0,5.33,29.72,608562,608658
6640,87,40,0,5.89,46.33,608657,608744
6641,82,22,0,6.24,33.96,608743,608825
6642,79,27,0,6.48,38.00,608824,608903
6643,113,28,0,4.53,29.93,608902,609015
6644,101,27,0,5.07,34.76,609014,609115
6645,86,30,0,5.95,38.02,609114,609200
6646,81,23,0,6.32,35.80,609199,609280
6647,96,22,0,5.33,31.03,609279,609375
6648,103,41,0,4.97,41.10,609374,609477
6649,100,24,0,5.12,29.91,609477,609577
6650,97,35,0,5.28,36.80,609576,609673
6651,96,21,0,5.33,32.93,609672,609768
6652,99,36,0,5.17,41.80,609767,609866
6653,74,69,0,6.92,79.43,609865,609939
6654,84,35,0,6.10,51.28,609938,610022
6655,104,30,0,4.92,32.57,610021,610125
6656,109,26,0,4.70,27.70,610124,610233
6657,83,46,0,6.17,55.42,610232,610315
6658,82,30,0,6.24,34.65,610315,610397
6659,89,20,0,5.75,33.60,610396,610485
6660,95,28,0,5.39,39.40,610484,610579
6661,97,46,0,5.28,49.19,610578,610675
6662,87,80,0,5.89,94.35,610674,610761
6663,89,25,0,5.75,30.14,610760,610849
6664,96,28,0,5.33,30.78,610848,610944
6665,99,19,0,5.17,27.90,610943,611042
6666,93,21,0,5.51,27.65,611042,611135
6667,90,27,0,5.69,35.46,611134,611224
6668,92,30,0,5.57,44.85,611223,611315
6669,87,21,0,5.89,33.69,611314,611401
6670,82,67,0,6.24,76.55,611400,611482
6671,91,26,0,5.63,35.25,611481,611572
6672,91,22,0,5.63,27.60,611571,611662
6673,93,26,0,5.51,33.39,611661,611754
6674,99,22,0,5.17,20.61,611753,611852
6675,102,26,0,5.02,29.49,611851,611953
6676,111,22,0,4.61,23.80,611952,612063
6677,86,29,0,5.95,37.09,612062,612148
6678,90,17,0,5.69,25.53,612147,612237
6679,96,22,0,5.33,31.01,612236,612332
6680,93,43,0,5.51,39.88,612331,612424
6681,100,19,0,5.12,22.59,612423,612523
6682,106,20,0,4.83,26.97,612522,612628
6683,93,21,0,5.51,32.29,612627,612720
6684,85,32,0,6.02,34.61,612719,612804
6685,105,34,0,4.88,29.37,612803,612908
6686,110,29,0,4.65,26.26,612907,613017
6687,76,29,0,6.74,46.11,613016,613092
6688,110,21,0,4.65,25.19,613091,613201
6689,105,19,0,4.88,23.65,613200,613305
6690,95,22,0,5.39,24.83,613304,613399
6691,97,22,0,5.28,34.72,613398,613495
6692,89,60,0,5.75,61.53,613495,613584
6693,109,39,0,4.70,30.45,613584,613693
6694,108,38,0,4.74,38.90,613692,613800
6695,108,20,0,4.74,25.66,613800,613908
6696,96,70,0,5.33,69.70,613907,614003
6697,92,40,0,5.57,49.77,614002,614094
6698,96,41,0,5.33,39.68,614093,614189
6699,91,23,0,5.63,30.30,614188,614279
6700,97,29,0,5.28,25.29,614279,614376
6701,109,22,0,4.70,27.09,614375,614484
6702,91,21,0,5.63,31.51,614483,614574
6703,94,21,0,5.45,31.76,614574,614668
6704,84,38,0,6.10,40.16,614667,614751
6705,88,33,0,5.82,45.81,614751,614839
6706,95,26,0,5.39,28.89,614838,614933
6707,87,43,0,5.89,48.79,614932,615019
6708,114,22,0,4.49,26.37,615019,615133
6709,87,38,0,5.89,35.07,615132,615219
6710,97,19,0,5.28,26.12,615218,615315
6711,91,20,0,5.63,26.98,615315,615406
6712,89,26,0,5.75,35.80,615405,615494
6713,82,24,0,6.24,35.18,615493,615575
6714,96,29,0,5.33,38.24,615574,615670
6715,87,78,0,5.89,85.71,615669,615756
6716,96,23,0,5.33,29.33,615755,615851
6717,90,24,0,5.69,40.10,615850,615940
6718,110,19,0,4.65,25.75,615939,616049
6719,94,19,0,5.45,24.01,616048,616142
6720,99,20,0,5.17,29.01,616141,616240
6721,59,113,0,8.68,227.88,616240,616299
6722,97,25,0,5.28,24.49,616298,616395
6723,82,77,0,6.24,106.33,616394,616476
6724,108,25,0,4.74,27.80,616475,616583
6725,86,25,0,5.95,39.02,616582,616668
6726,106,22,0,4.83,30.42,616667,616773
6727,86,44,0,5.95,51.60,616772,616858
6728,96,25,0,5.33,29.24,616857,616953
6729,103,36,0,4.97,38.73,616952,617055
6730,88,36,0,5.82,44.97,617054,617142
6731,90,22,0,5.69,33.24,617142,617232
6732,86,36,0,5.95,46.25,617231,617317
6733,108,21,0,4.74,22.56,617316,617424
6734,70,40,0,7.31,62.64,617423,617493
6735,82,20,0,6.24,36.94,617492,617574
6736,110,22,0,4.65,21.23,617573,617683
6737,96,46,0,5.33,52.99,617683,617779
6738,87,24,0,5.89,33.34,617778,617865
6739,105,58,0,4.88,52.79,617864,617969
6740,86,26,0,5.95,42.04,617968,618054
6741,84,20,0,6.10,34.01,618053,618137
6742,97,22,0,5.28,28.84,618136,618233
6743,121,19,0,4.23,22.14,618232,618353
6744,74,37,0,6.92,60.18,618353,618427
6745,116,23,0,4.41,24.98,618426,618542
6746,107,19,0,4.79,25.91,618541,618648
6747,117,19,0,4.38,23.81,618647,618764
6748,95,23,0,5.39,32.74,618763,618858
6749,97,18,0,5.28,22.59,618857,618954
6750,96,42,0,5.33,38.78,618953,619049
6751,97,21,0,5.28,26.63,619048,619145
6752,98,20,0,5.22,29.11,619144,619242
6753,86,37,0,5.95,49.00,619241,619327
6754,106,21,0,4.83,22.59,619326,619432
6755,95,31,0,5.39,34.91,619431,619526
6756,93,23,0,5.51,36.49,619525,619618
6757,92,25,0,5.57,37.05,619617,619709
6758,107,20,0,4.79,26.26,619708,619815
6759,109,20,0,4.70,27.99,619814,619923
6760,86,35,0,5.95,38.39,619923,620009
6761,82,37,0,6.24,52.60,620008,620090
6762,93,24,0,5.51,34.44,620089,620182
6763,107,26,0,4.79,30.95,620181,620288
6764,100,27,0,5.12,33.89,620287,620387
6765,87,23,0,5.89,34.56,620387,620474
6766,86,20,0,5.95,29.00,620474,620560
6767,109,20,0,4.70,26.14,620560,620669
6768,94,30,0,5.45,39.78,620668,620762
6769,79,30,0,6.48,56.38,620762,620841
6770,104,31,0,4.92,33.97,620840,620944
6771,80,147,0,6.40,278.36,620943,621023
6772,96,25,0,5.33,35.74,621022,621118
6773,103,20,0,4.97,23.17,621117,621220
6774,103,37,0,4.97,35.50,621219,621322
6775,92,22,0,5.57,28.18,621321,621413
6776,81,31,0,6.32,44.96,621412,621493
6777,87,31,0,5.89,40.54,621492,621579
6778,109,24,0,4.70,26.83,621578,621687
6779,65,30,0,7.88,60.42,621687,621752
6780,129,23,0,3.97,23.58,621752,621881
6781,99,27,0,5.17,35.76,621880,621979
6782,106,32,0,4.83,28.18,621979,622085
6783,89,29,0,5.75,32.43,622084,622173
6784,77,20,0,6.65,33.32,622172,622249
6785,88,19,0,5.82,35.38,622248,622336
6786,89,21,0,5.75,32.70,622335,622424
6787,109,41,0,4.70,33.83,622423,622532
6788,94,71,0,5.45,70.67,622531,622625
6789,91,23,0,5.63,34.12,622624,622715
6790,82,63,0,6.24,84.11,622714,622796
6791,83,21,0,6.17,34.53,622795,622878
6792,75,39,0,6.83,51.37,622877,622952
6793,97,29,0,5.28,32.49,622951,623048
6794,100,21,0,5.12,32.97,623047,623147
6795,90,34,0,5.69,36.77,623147,623237
6796,105,20,0,4.88,26.89,623236,623341
6797,81,20,0,6.32,29.50,623340,623421
6798,102,25,0,5.02,31.74,623421,623523
6799,77,20,0,6.65,29.19,623522,623599
6800,83,107,0,6.17,154.43,623598,623681
6801,104,21,0,4.92,25.13,623680,623784
6802,99,27,0,5.17,27.74,623783,623882
6803,67,33,0,7.64,45.90,623881,623948
6804,89,32,0,5.75,38.79,623947,624036
6805,85,21,0,6.02,30.35,624035,624120
6806,108,20,0,4.74,24.08,624119,624227
6807,82,25,0,6.24,39.55,624226,624308
6808,106,23,0,4.83,23.78,624307,624413
6809,80,79,0,6.40,106.96,624412,624492
6810,83,43,0,6.17,61.54,624491,624574
6811,100,29,0,5.12,38.83,624573,624673
6812,95,21,0,5.39,33.44,624672,624767
6813,84,48,0,6.10,53.21,624766,624850
6814,115,28,0,4.45,31.45,624849,624964
6815,75,33,0,6.83,46.73,624963,625038
6816,91,34,0,5.63,32.56,625037,625128
6817,97,39,0,5.28,41.85,625127,625224
6818,101,33,0,5.07,33.03,625223,625324
6819,83,20,0,6.17,34.45,625323,625406
6820,79,36,0,6.48,42.98,625405,625484
6821,88,20,0,5.82,31.08,625483,625571
6822,87,26,0,5.89,37.50,625570,625657
6823,75,66,0,6.83,80.14,625656,625731
6824,88,29,0,5.82,39.69,625730,625818
6825,92,32,0,5.57,32.57,625817,625909
6826,91,24,0,5.63,38.15,625908,625999
6827,92,45,0,5.57,48.29,625998,626090
6828,97,24,0,5.28,28.86,626089,626186
6829,99,18,0,5.17,27.64,626185,626284
6830,72,46,0,7.11,50.85,626283,626355
6831,92,29,0,5.57,32.94,626354,626446
6832,117,19,0,4.38,20.11,626445,626562
6833,93,20,0,5.51,31.33,626561,626654
6834,93,55,0,5.51,57.78,626654,626747
6835,117,22,0,4.38,25.24,626746,626863
6836,66,37,0,7.76,50.70,626862,626928
6837,77,41,0,6.65,63.27,626927,627004
6838,100,63,0,5.12,54.69,627003,627103
6839,101,20,0,5.07,29.77,627102,627203
6840,93,38,0,5.51,46.36,627202,627295
6841,105,39,0,4.88,32.98,627295,627400
6842,79,31,0,6.48,40.05,627399,627478
6843,89,51,0,5.75,55.69,627477,627566
6844,91,42,0,5.63,58.08,627565,627656
6845,85,23,0,6.02,30.63,627656,627741
6846,83,69,0,6.17,82.45,627740,627823
6847,100,24,0,5.12,30.67,627822,627922
6848,92,20,0,5.57,34.03,627921,628013
6849,85,25,0,6.02,34.02,628012,628097
6850,84,26,0,6.10,31.71,628096,628180
6851,107,22,0,4.79,27.68,628179,628286
6852,110,23,0,4.65,26.35,628286,628396
6853,97,20,0,5.28,24.63,628396,628493
6854,91,19,0,5.63,30.45,628492,628583
6855,93,22,0,5.51,30.81,628582,628675
6856,93,27,0,5.51,37.37,628675,628768
6857,89,28,0,5.75,35.13,628767,628856
6858,86,27,0,5.95,38.25,628855,628941
6859,73,42,0,7.01,59.38,628940,629013
6860,106,24,0,4.83,32.44,629013,629119
6861,97,32,0,5.28,36.14,629119,629216
6862,116,17,0,4.41,20.71,629215,629331
6863,82,38,0,6.24,49.18,629330,629412
6864,100,28,0,5.12,33.63,629412,629512
6865,110,19,0,4.65,26.97,629511,629621
6866,98,26,0,5.22,33.95,629621,629719
6867,104,24,0,4.92,32.99,629719,629823
6868,97,24,0,5.28,33.23,629822,629919
6869,100,65,0,5.12,62.29,629918,630018
6870,105,19,0,4.88,28.26,630017,630122
6871,77,29,0,6.65,44.41,630121,630198
6872,112,28,0,4.57,27.14,630197,630309
6873,87,22,0,5.89,31.39,630308,630395
6874,93,39,0,5.51,35.02,630394,630487
6875,64,173,0,8.00,466.22,630487,630551
6876,94,20,0,5.45,29.97,630550,630644
6877,88,36,0,5.82,41.72,630643,630731
6878,86,28,0,5.95,39.79,630730,630816
6879,104,34,0,4.92,33.84,630815,630919
6880,88,24,0,5.82,36.26,630919,631007
6881,102,22,0,5.02,26.41,631006,631108
6882,99,31,0,5.17,30.57,631107,631206
6883,92,19,0,5.57,28.42,631205,631297
6884,105,27,0,4.88,30.18,631296,631401
6885,104,21,0,4.92,29.28,631400,631504
6886,74,21,0,6.92,28.24,631503,631577
6887,103,20,0,4.97,27.93,631576,631679
6888,87,24,0,5.89,32.26,631678,631765
6889,109,19,0,4.70,26.25,631764,631873
6890,84,50,0,6.10,56.51,631872,631956
6891,97,23,0,5.28,29.60,631955,632052
6892,104,44,0,4.92,38.30,632051,632155
6893,79,33,0,6.48,39.11,632154,632233
6894,83,23,0,6.17,31.83,632232,632315
6895,78,30,0,6.56,51.81,632314,632392
6896,71,56,0,7.21,63.80,632391,632462
6897,83,22,0,6.17,31.56,632461,632544
6898,78,22,0,6.56,31.71,632543,632621
6899,105,26,0,4.88,37.82,632620,632725
6900,106,19,0,4.83,26.05,632725,632831
6901,89,27,0,5.75,42.97,632830,632919
6902,99,20,0,5.17,24.93,632918,633017
6903,80,27,0,6.40,47.54,633016,633096
6904,121,26,0,4.23,27.52,633095,633216
6905,81,112,0,6.32,170.19,633216,633297
6906,100,25,0,5.12,26.83,633296,633396
6907,100,18,0,5.12,22.13,633395,633495
6908,118,18,0,4.34,22.14,633494,633612
6909,72,27,0,7.11,36.27,633611,633683
6910,76,29,0,6.74,48.27,633682,633758
6911,96,27,0,5.33,29.74,633757,633853
6912,91,69,0,5.63,72.59,633852,633943
6913,99,39,0,5.17,42.26,633942,634041
6914,112,31,0,4.57,29.42,634040,634152
6915,105,19,0,4.88,27.14,634151,634256
6916,102,21,0,5.02,31.90,634255,634357
6917,115,20,0,4.45,19.83,634356,634471
6918,91,20,0,5.63,35.20,634470,634561
6919,76,77,0,6.74,110.40,634560,634636
6920,84,22,0,6.10,38.37,634635,634719
6921,93,21,0,5.51,32.57,634718,634811
6922,106,27,0,4.83,30.56,634810,634916
6923,120,34,0,4.27,28.45,634915,635035
6924,89,21,0,5.75,31.92,635034,635123
6925,100,26,0,5.12,29.59,635122,635222
6926,77,25,0,6.65,40.64,635221,635298
6927,89,114,0,5.75,155.06,635297,635386
6928,79,26,0,6.48,46.96,635385,635464
6929,112,25,0,4.57,30.03,635463,635575
6930,88,23,0,5.82,37.13,635574,635662
6931,119,29,0,4.30,27.44,635662,635781
6932,103,19,0,4.97,25.14,635781,635884
6933,74,23,0,6.92,41.67,635883,635957
6934,83,32,0,6.17,39.39,635956,636039
6935,97,21,0,5.28,26.37,636038,636135
6936,106,43,0,4.83,40.84,636134,636240
6937,70,27,0,7.31,42.42,636239,636309
6938,106,31,0,4.83,32.74,636308,636414
6939,81,112,0,6.32,169.30,636413,636494
6940,86,25,0,5.95,34.93,636493,636579
6941,116,32,0,4.41,26.24,636578,636694
6942,91,21,0,5.63,33.79,636693,636784
6943,88,26,0,5.82,35.04,636783,636871
6944,94,38,0,5.45,50.95,636870,636964
6945,89,24,0,5.75,37.62,636963,637052
6946,110,24,0,4.65,27.97,637052,637162
6947,101,23,0,5.07,30.50,637161,637262
6948,101,30,0,5.07,32.60,637261,637362
6949,82,23,0,6.24,33.18,637361,637443
6950,99,21,0,5.17,26.18,637442,637541
6951,90,70,0,5.69,101.44,637541,637631
6952,90,20,0,5.69,34.81,637630,637720
6953,112,22,0,4.57,25.53,637719,637831
6954,107,21,0,4.79,29.87,637830,637937
6955,96,24,0,5.33,30.56,637936,638032
6956,86,22,0,5.95,32.37,638031,638117
6957,95,26,0,5.39,34.49,638117,638212
6958,97,20,0,5.28,33.66,638211,638308
6959,95,47,0,5.39,44.93,638307,638402
6960,94,53,0,5.45,53.18,638401,638495
6961,93,28,0,5.51,34.53,638494,638587
6962,107,19,0,4.79,26.65,638586,638693
6963,109,18,0,4.70,24.17,638692,638801
6964,95,35,0,5.39,31.82,638801,638896
6965,111,21,0,4.61,22.54,638895,639006
6966,97,22,0,5.28,27.87,639005,639102
6967,89,28,0,5.75,28.34,639101,639190
6968,103,29,0,4.97,29.60,639190,639293
6969,81,33,0,6.32,44.93,639292,639373
6970,96,47,0,5.33,43.66,639372,639468
6971,89,21,0,5.75,32.48,639467,639556
6972,96,26,0,5.33,31.56,639555,639651
6973,53,46,0,9.66,67.70,639651,639704
6974,90,25,0,5.69,31.30,639703,639793
6975,93,20,0,5.51,24.87,639792,639885
6976,100,22,0,5.12,29.49,639884,639984
6977,102,21,0,5.02,31.45,639983,640085
6978,98,60,0,5.22,62.11,640084,640182
6979,87,31,0,5.89,37.11,640182,640269
6980,112,22,0,4.57,26.23,640268,640380
6981,107,20,0,4.79,25.33,640380,640487
6982,113,21,0,4.53,27.97,640486,640599
6983,91,49,0,5.63,47.16,640598,640689
6984,86,29,0,5.95,38.97,640688,640774
6985,111,20,0,4.61,25.97,640773,640884
6986,83,21,0,6.17,38.60,640883,640966
6987,110,21,0,4.65,24.54,640965,641075
6988,82,58,0,6.24,75.70,641074,641156
6989,91,21,0,5.63,26.43,641155,641246
6990,110,18,0,4.65,20.30,641245,641355
6991,98,26,0,5.22,37.30,641354,641452
6992,83,34,0,6.17,46.09,641451,641534
6993,86,41,0,5.95,58.90,641533,641619
6994,101,25,0,5.07,29.97,641619,641720
6995,101,20,0,5.07,26.88,641719,641820
6996,86,22,0,5.95,31.44,641819,641905
6997,103,35,0,4.97,34.84,641904,642007
6998,71,47,0,7.21,63.01,642006,642077
6999,93,35,0,5.51,45.50,642076,642169
7000,96,24,0,5.33,29.85,642168,642264
7001,98,17,0,5.22,21.34,642263,642361
7002,109,17,0,4.70,18.23,642360,642469
7003,112,21,0,4.57,24.80,642468,642580
7004,92,72,0,5.57,82.90,642579,642671
7005,99,24,0,5.17,33.27,642671,642770
7006,81,61,0,6.32,70.54,642769,642850
7007,101,20,0,5.07,27.49,642849,642950
7008,79,31,0,6.48,40.91,642949,643028
7009,78,71,0,6.56,83.63,643027,643105
7010,72,41,0,7.11,57.77,643104,643176
7011,92,28,0,5.57,37.51,643175,643267
7012,93,23,0,5.51,32.51,643266,643359
7013,78,20,0,6.56,30.09,643358,643436
7014,101,58,0,5.07,58.76,643435,643536
7015,90,25,0,5.69,33.57,643535,643625
7016,95,23,0,5.39,30.09,643625,643720
7017,90,20,0,5.69,27.57,643720,643810
7018,110,27,0,4.65,27.68,643809,643919
7019,88,21,0,5.82,36.83,643918,644006
7020,86,22,0,5.95,30.51,644005,644091
7021,78,51,0,6.56,63.12,644090,644168
7022,106,24,0,4.83,31.56,644168,644274
7023,87,33,0,5.89,40.95,644274,644361
7024,66,51,0,7.76,60.03,644360,644426
7025,94,22,0,5.45,26.89,644425,644519
7026,107,20,0,4.79,26.06,644518,644625
7027,87,36,0,5.89,42.06,644625,644712
7028,90,24,0,5.69,38.30,644711,644801
7029,79,61,0,6.48,84.20,644800,644879
7030,62,153,0,8.26,370.51,644878,644940
7031,80,35,0,6.40,45.24,644939,645019
7032,114,24,0,4.49,31.20,645018,645132
7033,99,21,0,5.17,28.43,645131,645230
7034,85,103,0,6.02,149.03,645229,645314
7035,97,30,0,5.28,44.94,645313,645410
7036,78,30,0,6.56,43.14,645409,645487
7037,82,31,0,6.24,36.77,645486,645568
7038,82,30,0,6.24,46.18,645567,645649
7039,98,19,0,5.22,25.36,645648,645746
7040,62,78,0,8.26,117.74,645745,645807
7041,95,16,0,5.39,23.73,645806,645901
7042,97,23,0,5.28,31.87,645900,645997
7043,103,20,0,4.97,23.33,645996,646099
7044,73,65,0,7.01,95.03,646098,646171
7045,89,20,0,5.75,31.58,646170,646259
7046,100,22,0,5.12,28.99,646258,646358
7047,71,23,0,7.21,46.05,646358,646429
7048,106,20,0,4.83,26.80,646428,646534
7049,95,34,0,5.39,32.57,646533,646628
7050,95,28,0,5.39,31.46,646627,646722
7051,90,41,0,5.69,51.13,646721,646811
7052,117,19,0,4.38,26.17,646810,646927
7053,96,26,0,5.33,29.51,646926,647022
7054,93,20,0,5.51,28.72,647021,647114
7055,94,22,0,5.45,33.91,647113,647207
7056,127,20,0,4.03,23.38,647206,647333
7057,82,33,0,6.24,44.94,647332,647414
7058,81,55,0,6.32,73.90,647413,647494
7059,89,28,0,5.75,41.04,647494,647583
7060,102,19,0,5.02,28.20,647582,647684
7061,94,37,0,5.45,45.86,647683,647777
7062,111,21,0,4.61,28.36,647777,647888
7063,90,19,0,5.69,28.33,647887,647977
7064,93,25,0,5.51,36.14,647976,648069
7065,98,21,0,5.22,35.03,648068,648166
7066,92,32,0,5.57,30.64,648166,648258
7067,81,55,0,6.32,61.38,648257,648338
7068,117,20,0,4.38,22.41,648337,648454
7069,90,37,0,5.69,35.46,648453,648543
7070,75,108,0,6.83,164.84,648543,648618
7071,97,39,0,5.28,45.23,648617,648714
7072,80,24,0,6.40,45.69,648714,648794
7073,100,58,0,5.12,59.95,648793,648893
7074,87,22,0,5.89,27.39,648893,648980
7075,80,42,0,6.40,51.69,648979,649059
7076,78,20,0,6.56,31.76,649058,649136
7077,84,23,0,6.10,33.59,649135,649219
7078,104,19,0,4.92,26.94,649218,649322
7079,97,31,0,5.28,33.75,649321,649418
7080,75,70,0,6.83,86.33,649417,649492
7081,86,23,0,5.95,33.32,649491,649577
7082,90,31,0,5.69,37.35,649576,649666
7083,81,52,0,6.32,58.07,649666,649747
7084,98,34,0,5.22,39.17,649746,649844
7085,80,36,0,6.40,51.86,649843,649923
7086,90,21,0,5.69,32.59,649922,650012
7087,74,74,0,6.92,130.34,650011,650085
7088,114,21,0,4.49,24.04,650084,650198
7089,92,22,0,5.57,30.31,650197,650289
7090,93,74,0,5.51,75.93,650288,650381
7091,110,28,0,4.65,25.90,650380,650490
7092,82,22,0,6.24,37.01,650490,650572
7093,112,26,0,4.57,25.21,650571,650683
7094,101,44,0,5.07,42.42,650682,650783
7095,85,22,0,6.02,32.73,650782,650867
7096,63,111,0,8.13,210.62,650866,650929
7097,102,19,0,5.02,31.51,650929,651031
7098,87,55,0,5.89,60.56,651030,651117
7099,79,57,0,6.48,85.31,651116,651195
7100,106,20,0,4.83,25.95,651194,651300
7101,93,20,0,5.51,27.09,651300,651393
7102,109,33,0,4.70,30.30,651392,651501
7103,96,22,0,5.33,35.43,651500,651596
7104,99,22,0,5.17,25.80,651595,651694
7105,98,41,0,5.22,39.46,651693,651791
7106,90,20,0,5.69,31.30,651790,651880
7107,107,24,0,4.79,25.08,651879,651986
7108,83,28,0,6.17,29.39,651985,652068
7109,66,94,0,7.76,158.88,652068,652134
7110,109,19,0,4.70,23.11,652133,652242
7111,108,23,0,4.74,30.10,652241,652349
7112,99,24,0,5.17,31.27,652348,652447
7113,94,19,0,5.45,31.44,652446,652540
7114,92,61,0,5.57,58.46,652539,652631
7115,110,28,0,4.65,29.30,652630,652740
7116,83,30,0,6.17,38.84,652739,652822
7117,110,20,0,4.65,26.21,652821,652931
7118,78,20,0,6.56,39.14,652931,653009
7119,88,25,0,5.82,32.90,653008,653096
7120,101,32,0,5.07,31.67,653095,653196
7121,72,26,0,7.11,32.38,653195,653267
7122,85,22,0,6.02,36.59,653267,653352
7123,100,21,0,5.12,28.25,653351,653451
7124,102,32,0,5.02,37.18,653451,653553
7125,88,24,0,5.82,31.31,653552,653640
7126,98,23,0,5.22,29.70,653639,653737
7127,85,41,0,6.02,51.53,653736,653821
7128,83,20,0,6.17,32.72,653820,653903
7129,110,33,0,4.65,30.46,653902,654012
7130,92,17,0,5.57,26.62,654011,654103
7131,94,29,0,5.45,39.63,654102,654196
7132,75,24,0,6.83,41.00,654195,654270
7133,96,30,0,5.33,29.78,654269,654365
7134,88,23,0,5.82,34.67,654364,654452
7135,87,38,0,5.89,45.96,654451,654538
7136,92,71,0,5.57,91.92,654537,654629
7137,80,32,0,6.40,43.22,654628,654708
7138,99,36,0,5.17,35.09,654708,654807
7139,84,20,0,6.10,30.92,654806,654890
7140,80,36,0,6.40,50.29,654889,654969
7141,83,40,0,6.17,42.53,654968,655051
7142,106,22,0,4.83,30.08,655050,655156
7143,59,119,0,8.68,246.08,655155,655214
7144,88,39,0,5.82,38.83,655213,655301
7145,96,20,0,5.33,32.18,655300,655396
7146,99,26,0,5.17,28.87,655396,655495
7147,96,22,0,5.33,28.56,655494,655590
7148,71,70,0,7.21,108.31,655590,655661
7149,96,24,0,5.33,27.41,655661,655757
7150,93,29,0,5.51,37.05,655756,655849
7151,97,21,0,5.28,32.45,655849,655946
7152,76,46,0,6.74,61.48,655945,656021
7153,69,35,0,7.42,62.88,656020,656089
7154,94,20,0,5.45,30.80,656089,656183
7155,71,26,0,7.21,37.91,656182,656253
7156,89,21,0,5.75,28.28,656252,656341
7157,82,48,0,6.24,62.45,656340,656422
7158,84,42,0,6.10,40.61,656421,656505
7159,101,21,0,5.07,32.10,656504,656605
7160,91,90,0,5.63,105.75,656604,656695
7161,104,19,0,4.92,25.28,656694,656798
7162,82,41,0,6.24,43.70,656797,656879
7163,92,22,0,5.57,31.55,656878,656970
7164,94,50,0,5.45,44.40,656969,657063
7165,104,22,0,4.92,30.76,657063,657167
7166,104,21,0,4.92,25.46,657167,657271
7167,91,44,0,5.63,45.49,657270,657361
7168,83,29,0,6.17,41.39,657360,657443
7169,70,51,0,7.31,59.64,657442,657512
7170,96,24,0,5.33,37.24,657511,657607
7171,101,17,0,5.07,23.11,657606,657707
7172,96,24,0,5.33,38.74,657706,657802
7173,99,20,0,5.17,26.24,657801,657900
7174,101,24,0,5.07,28.36,657899,658000
7175,86,32,0,5.95,34.49,657999,658085
7176,84,19,0,6.10,29.37,658084,658168
7177,73,44,0,7.01,64.97,658167,658240
7178,76,55,0,6.74,64.72,658240,658316
7179,101,33,0,5.07,33.69,658316,658417
7180,99,31,0,5.17,31.25,658416,658515
7181,74,40,0,6.92,49.45,658515,658589
7182,85,21,0,6.02,32.66,658588,658673
7183,79,43,0,6.48,56.98,658673,658752
7184,86,25,0,5.95,35.81,658751,658837
7185,75,50,0,6.83,56.46,658836,658911
7186,102,26,0,5.02,29.59,658910,659012
7187,87,32,0,5.89,39.48,659011,659098
7188,100,23,0,5.12,28.23,659097,659197
7189,73,23,0,7.01,38.51,659196,659269
7190,107,28,0,4.79,29.22,659268,659375
7191,56,58,0,9.14,130.05,659374,659430
7192,95,33,0,5.39,34.15,659429,659524
7193,101,19,0,5.07,28.52,659523,659624
7194,85,20,0,6.02,30.89,659623,659708
7195,98,27,0,5.22,30.54,659707,659805
7196,114,20,0,4.49,25.20,659804,659918
7197,88,25,0,5.82,31.92,659917,660005
7198,86,27,0,5.95,34.32,660004,660090
7199,110,21,0,4.65,26.66,660089,660199
7200,79,88,0,6.48,130.71,660198,660277
7201,98,27,0,5.22,31.42,660276,660374
7202,76,49,0,6.74,53.11,660374,660450
7203,110,21,0,4.65,24.19,660450,660560
7204,122,21,0,4.20,19.03,660560,660682
7205,73,73,0,7.01,102.59,660681,660754
7206,80,43,0,6.40,53.39,660753,660833
7207,73,23,0,7.01,42.12,660832,660905
7208,62,55,0,8.26,81.03,660904,660966
7209,82,33,0,6.24,39.28,660965,661047
7210,107,24,0,4.79,28.73,661046,661153
7211,105,21,0,4.88,23.44,661152,661257
7212,99,20,0,5.17,29.88,661256,661355
7213,86,22,0,5.95,40.37,661354,661440
7214,99,37,0,5.17,42.59,661439,661538
7215,95,20,0,5.39,32.76,661537,661632
7216,90,20,0,5.69,31.01,661631,661721
7217,99,23,0,5.17,26.53,661720,661819
7218,104,28,0,4.92,34.36,661818,661922
7219,97,21,0,5.28,30.22,661922,662019
7220,101,20,0,5.07,24.24,662018,662119
7221,96,21,0,5.33,34.74,662118,662214
7222,102,26,0,5.02,34.31,662213,662315
7223,91,47,0,5.63,48.70,662314,662405
7224,69,27,0,7.42,46.77,662404,662473
7225,80,46,0,6.40,56.14,662472,662552
7226,103,23,0,4.97,35.31,662551,662654
7227,98,29,0,5.22,31.17,662653,662751
7228,96,31,0,5.33,32.97,662750,662846
7229,104,24,0,4.92,30.72,662845,662949
7230,105,49,0,4.88,44.47,662948,663053
7231,95,20,0,5.39,27.84,663052,663147
7232,98,24,0,5.22,28.50,663146,663244
7233,76,35,0,6.74,39.56,663243,663319
7234,100,22,0,5.12,33.37,663318,663418
7235,98,21,0,5.22,32.66,663417,663515
7236,103,35,0,4.97,37.81,663514,663617
7237,88,42,0,5.82,40.33,663616,663704
7238,95,20,0,5.39,28.79,663703,663798
7239,91,22,0,5.63,32.06,663797,663888
7240,79,35,0,6.48,45.14,663887,663966
7241,79,20,0,6.48,39.44,663965,664044
7242,102,52,0,5.02,48.96,664043,664145
7243,111,19,0,4.61,23.14,664144,664255
7244,86,20,0,5.95,38.30,664254,664340
7245,102,22,0,5.02,31.00,664339,664441
7246,102,19,0,5.02,27.39,664440,664542
7247,114,17,0,4.49,22.51,664541,664655
7248,75,32,0,6.83,50.60,664654,664729
7249,78,47,0,6.56,72.02,664728,664806
7250,93,23,0,5.51,26.06,664805,664898
7251,106,20,0,4.83,31.35,664897,665003
7252,88,28,0,5.82,38.81,665002,665090
7253,95,24,0,5.39,28.72,665089,665184
7254,104,23,0,4.92,32.13,665183,665287
7255,76,22,0,6.74,38.51,665286,665362
7256,96,20,0,5.33,32.24,665361,665457
7257,96,24,0,5.33,31.72,665456,665552
7258,104,18,0,4.92,22.36,665551,665655
7259,88,116,0,5.82,164.24,665654,665742
7260,125,23,0,4.10,25.00,665741,665866
7261,110,21,0,4.65,28.64,665865,665975
7262,92,31,0,5.57,32.92,665974,666066
7263,97,25,0,5.28,38.28,666065,666162
7264,87,59,0,5.89,69.89,666161,666248
7265,89,22,0,5.75,31.85,666247,666336
7266,92,17,0,5.57,21.27,666335,666427
7267,100,22,0,5.12,31.35,666426,666526
7268,91,34,0,5.63,47.00,666525,666616
7269,87,30,0,5.89,33.96,666615,666702
7270,114,43,0,4.49,38.83,666701,666815
7271,105,22,0,4.88,29.84,666814,666919
7272,109,19,0,4.70,24.21,666918,667027
7273,85,35,0,6.02,41.22,667026,667111
7274,91,21,0,5.63,31.49,667110,667201
7275,75,35,0,6.83,47.58,667200,667275
7276,97,31,0,5.28,34.04,667274,667371
7277,95,23,0,5.39,31.00,667370,667465
7278,101,22,0,5.07,26.01,667464,667565
7279,42,253,0,12.19,1444.73,667564,667606
7280,89,19,0,5.75,32.97,667605,667694
7281,103,22,0,4.97,31.39,667693,667796
7282,95,25,0,5.39,30.97,667795,667890
7283,103,22,0,4.97,33.62,667889,667992
7284,105,20,0,4.88,27.25,667991,668096
7285,90,22,0,5.69,32.97,668096,668186
7286,97,23,0,5.28,34.32,668185,668282
7287,89,19,0,5.75,34.25,668282,668371
7288,88,78,0,5.82,88.85,668370,668458
7289,89,23,0,5.75,33.26,668457,668546
7290,93,21,0,5.51,30.64,668546,668639
7291,91,19,0,5.63,32.39,668638,668729
7292,76,31,0,6.74,46.17,668728,668804
7293,119,24,0,4.30,21.44,668803,668922
7294,91,21,0,5.63,28.78,668921,669012
7295,109,20,0,4.70,25.18,669011,669120
7296,105,23,0,4.88,28.07,669119,669224
7297,91,27,0,5.63,35.93,669223,669314
7298,69,22,0,7.42,39.84,669313,669382
7299,77,19,0,6.65,27.76,669381,669458
7300,78,39,0,6.56,67.48,669457,669535
7301,98,22,0,5.22,30.89,669534,669632
7302,93,20,0,5.51,31.93,669631,669724
7303,85,49,0,6.02,69.39,669723,669808
7304,97,19,0,5.28,26.90,669807,669904
7305,103,19,0,4.97,22.05,669903,670006
7306,69,38,0,7.42,49.84,670005,670074
7307,94,38,0,5.45,42.63,670073,670167
7308,86,19,0,5.95,25.95,670166,670252
7309,84,30,0,6.10,40.21,670251,670335
7310,88,47,0,5.82,41.47,670334,670422
7311,93,20,0,5.51,33.86,670421,670514
7312,105,21,0,4.88,28.22,670513,670618
7313,98,20,0,5.22,23.32,670618,670716
7314,92,28,0,5.57,34.57,670715,670807
7315,95,42,0,5.39,43.04,670806,670901
7316,130,26,0,3.94,23.17,670900,671030
7317,87,20,0,5.89,32.45,671029,671116
7318,74,23,0,6.92,36.97,671115,671189
7319,102,32,0,5.02,36.41,671188,671290
7320,92,52,0,5.57,57.72,671290,671382
7321,87,23,0,5.89,31.89,671381,671468
7322,83,47,0,6.17,55.97,671468,671551
7323,83,24,0,6.17,29.68,671550,671633
7324,97,33,0,5.28,29.50,671632,671729
7325,100,21,0,5.12,26.03,671728,671828
7326,73,68,0,7.01,106.42,671827,671900
7327,93,24,0,5.51,31.00,671899,671992
7328,85,42,0,6.02,47.48,671991,672076
7329,97,59,0,5.28,56.59,672075,672172
7330,100,35,0,5.12,42.57,672171,672271
7331,102,27,0,5.02,27.25,672270,672372
7332,79,40,0,6.48,45.19,672371,672450
7333,90,20,0,5.69,23.84,672449,672539
7334,94,29,0,5.45,33.78,672538,672632
7335,82,51,0,6.24,65.70,672631,672713
7336,89,23,0,5.75,36.19,672712,672801
7337,95,20,0,5.39,31.80,672801,672896
7338,81,29,0,6.32,42.12,672895,672976
7339,114,27,0,4.49,30.13,672975,673089
7340,98,19,0,5.22,24.99,673088,673186
7341,89,46,0,5.75,46.64,673185,673274
7342,99,25,0,5.17,33.29,673273,673372
7343,77,21,0,6.65,39.27,673372,673449
7344,105,20,0,4.88,23.02,673448,673553
7345,82,67,0,6.24,93.77,673552,673634
7346,72,46,0,7.11,65.96,673633,673705
7347,88,29,0,5.82,41.97,673705,673793
7348,104,20,0,4.92,27.15,673792,673896
7349,115,21,0,4.45,30.35,673895,674010
7350,84,22,0,6.10,33.35,674009,674093
7351,96,30,0,5.33,34.31,674092,674188
7352,87,36,0,5.89,44.54,674187,674274
7353,85,23,0,6.02,36.56,674273,674358
7354,77,23,0,6.65,33.71,674357,674434
7355,104,34,0,4.92,29.65,674433,674537
7356,73,29,0,7.01,54.51,674536,674609
7357,93,35,0,5.51,34.98,674608,674701
7358,49,200,0,10.45,787.84,674700,674749
7359,82,69,0,6.24,80.21,674748,674830
7360,106,23,0,4.83,24.52,674829,674935
7361,106,23,0,4.83,27.33,674934,675040
7362,108,19,0,4.74,24.62,675039,675147
7363,63,20,0,8.13,41.03,675146,675209
7364,90,24,0,5.69,33.95,675208,675298
7365,78,31,0,6.56,44.73,675297,675375
7366,79,47,0,6.48,49.87,675374,675453
7367,117,22,0,4.38,22.18,675452,675569
7368,110,43,0,4.65,39.52,675568,675678
7369,84,22,0,6.10,32.66,675677,675761
7370,81,27,0,6.32,37.33,675760,675841
7371,98,21,0,5.22,32.44,675840,675938
7372,116,27,0,4.41,29.73,675937,676053
7373,88,24,0,5.82,34.49,676052,676140
7374,88,20,0,5.82,28.97,676139,676227
7375,87,23,0,5.89,29.25,676226,676313
7376,105,18,0,4.88,28.70,676312,676417
7377,84,29,0,6.10,36.04,676416,676500
7378,82,28,0,6.24,39.01,676499,676581
7379,81,30,0,6.32,43.70,676581,676662
7380,114,20,0,4.49,22.37,676662,676776
7381,90,39,0,5.69,47.19,676775,676865
7382,93,27,0,5.51,34.36,676864,676957
7383,92,19,0,5.57,33.92,676956,677048
7384,91,22,0,5.63,36.81,677047,677138
7385,108,32,0,4.74,37.06,677137,677245
7386,68,128,0,7.53,251.51,677244,677312
7387,100,44,0,5.12,39.99,677311,677411
7388,77,38,0,6.65,51.68,677411,677488
7389,94,21,0,5.45,36.23,677487,677581
7390,80,39,0,6.40,56.62,677580,677660
7391,94,21,0,5.45,30.84,677659,677753
7392,88,18,0,5.82,26.35,677752,677840
7393,96,50,0,5.33,42.45,677839,677935
7394,84,28,0,6.10,41.54,677934,678018
7395,87,45,0,5.89,50.88,678017,678104
7396,96,22,0,5.33,28.24,678103,678199
7397,99,24,0,5.17,31.41,678198,678297
7398,58,30,0,8.83,47.63,678296,678354
7399,72,72,0,7.11,105.02,678353,678425
7400,98,23,0,5.22,28.77,678424,678522
7401,111,23,0,4.61,28.13,678522,678633
7402,88,59,0,5.82,63.60,678632,678720
7403,95,22,0,5.39,34.64,678720,678815
7404,79,19,0,6.48,35.06,678814,678893
7405,96,20,0,5.33,27.68,678892,678988
7406,111,19,0,4.61,21.01,678987,679098
7407,97,29,0,5.28,30.35,679097,679194
7408,97,24,0,5.28,28.24,679193,679290
7409,91,25,0,5.63,37.60,679289,679380
7410,104,27,0,4.92,27.30,679379,679483
7411,76,28,0,6.74,44.83,679482,679558
7412,92,21,0,5.57,31.42,679557,679649
7413,87,30,0,5.89,32.81,679648,679735
7414,94,26,0,5.45,33.61,679734,679828
7415,89,25,0,5.75,33.35,679827,679916
7416,100,25,0,5.12,28.03,679915,680015
7417,94,30,0,5.45,36.67,680014,680108
7418,96,38,0,5.33,36.89,680107,680203
7419,97,20,0,5.28,27.21,680202,680299
7420,96,24,0,5.33,28.35,680299,680395
7421,92,35,0,5.57,38.33,680394,680486
7422,97,20,0,5.28,26.98,680485,680582
7423,100,42,0,5.12,47.43,680581,680681
7424,100,20,0,5.12,29.35,680681,680781
7425,96,23,0,5.33,28.20,680780,680876
7426,104,25,0,4.92,30.82,680876,680980
7427,78,47,0,6.56,52.48,680979,681057
7428,84,65,0,6.10,70.56,681057,681141
7429,94,28,0,5.45,38.93,681140,681234
7430,81,20,0,6.32,39.75,681233,681314
7431,64,99,0,8.00,166.78,681313,681377
7432,95,28,0,5.39,33.40,681376,681471
7433,93,34,0,5.51,40.96,681470,681563
7434,88,25,0,5.82,38.24,681562,681650
7435,94,22,0,5.45,32.23,681649,681743
7436,107,21,0,4.79,24.36,681743,681850
7437,92,19,0,5.57,29.77,681849,681941
7438,91,25,0,5.63,31.71,681941,682032
7439,91,37,0,5.63,36.70,682031,682122
7440,89,20,0,5.75,27.94,682121,682210
7441,103,23,0,4.97,33.21,682209,682312
7442,125,19,0,4.10,25.56,682311,682436
7443,113,31,0,4.53,27.58,682435,682548
7444,106,27,0,4.83,28.46,682547,682653
7445,86,22,0,5.95,37.39,682652,682738
7446,76,21,0,6.74,38.25,682737,682813
7447,91,31,0,5.63,52.19,682812,682903
7448,91,33,0,5.63,42.30,682902,682993
7449,94,30,0,5.45,32.27,682992,683086
7450,85,31,0,6.02,47.25,683085,683170
7451,98,21,0,5.22,30.91,683170,683268
7452,95,28,0,5.39,35.84,683267,683362
7453,102,22,0,5.02,29.98,683361,683463
7454,89,27,0,5.75,34.37,683462,683551
7455,106,22,0,4.83,27.16,683550,683656
7456,102,27,0,5.02,27.63,683655,683757
7457,85,38,0,6.02,45.51,683756,683841
7458,87,29,0,5.89,33.92,683840,683927
7459,77,32,0,6.65,47.58,683926,684003
7460,99,20,0,5.17,26.40,684002,684101
7461,82,28,0,6.24,35.33,684100,684182
7462,75,23,0,6.83,37.56,684181,684256
7463,78,26,0,6.56,37.58,684255,684333
7464,78,20,0,6.56,29.02,684332,684410
7465,107,31,0,4.79,29.53,684410,684517
7466,71,24,0,7.21,40.00,684516,684587
7467,105,19,0,4.88,25.02,684587,684692
7468,102,20,0,5.02,26.98,684691,684793
7469,75,50,0,6.83,78.70,684792,684867
7470,95,22,0,5.39,39.50,684867,684962
7471,81,43,0,6.32,57.23,684961,685042
7472,67,29,0,7.64,51.84,685041,685108
7473,84,25,0,6.10,32.16,685108,685192
7474,81,29,0,6.32,35.21,685191,685272
7475,99,23,0,5.17,32.49,685271,685370
7476,80,53,0,6.40,61.36,685370,685450
7477,103,20,0,4.97,28.69,685450,685553
7478,91,48,0,5.63,53.51,685552,685643
7479,58,248,0,8.83,1030.83,685643,685701
7480,64,99,0,8.00,197.44,685700,685764
7481,97,23,0,5.28,30.08,685763,685860
7482,97,20,0,5.28,34.02,685860,685957
7483,93,27,0,5.51,37.82,685956,686049
7484,112,42,0,4.57,44.17,686048,686160
7485,109,28,0,4.70,31.66,686159,686268
7486,80,36,0,6.40,57.74,686268,686348
7487,98,21,0,5.22,31.15,686348,686446
7488,96,21,0,5.33,35.72,686445,686541
7489,78,57,0,6.56,66.96,686540,686618
7490,96,17,0,5.33,22.18,686617,686713
7491,83,33,0,6.17,41.92,686712,686795
7492,108,24,0,4.74,30.75,686795,686903
7493,91,25,0,5.63,34.21,686902,686993
7494,81,21,0,6.32,35.50,686992,687073
7495,108,19,0,4.74,26.36,687072,687180
7496,104,27,0,4.92,35.78,687179,687283
7497,86,36,0,5.95,40.49,687282,687368
7498,107,23,0,4.79,29.33,687367,687474
7499,93,24,0,5.51,37.39,687473,687566
7500,78,72,0,6.56,93.17,687565,687643
7501,89,28,0,5.75,39.35,687642,687731
7502,87,21,0,5.89,30.03,687731,687818
7503,110,22,0,4.65,30.70,687817,687927
7504,103,22,0,4.97,24.80,687927,688030
7505,87,21,0,5.89,31.41,688029,688116
7506,96,38,0,5.33,41.66,688115,688211
7507,86,29,0,5.95,31.25,688210,688296
7508,89,21,0,5.75,31.06,688295,688384
7509,87,20,0,5.89,32.33,688383,688470
7510,82,35,0,6.24,44.65,688469,688551
7511,97,20,0,5.28,23.93,688550,688647
7512,63,60,0,8.13,115.92,688646,688709
7513,51,79,0,10.04,185.21,688708,688759
7514,111,25,0,4.61,24.44,688758,688869
7515,93,38,0,5.51,46.31,688868,688961
7516,108,20,0,4.74,25.67,688960,689068
7517,93,21,0,5.51,25.22,689067,689160
7518,121,19,0,4.23,23.60,689159,689280
7519,100,29,0,5.12,32.35,689279,689379
7520,108,20,0,4.74,27.14,689378,689486
7521,102,19,0,5.02,22.98,689485,689587
7522,75,23,0,6.83,41.26,689586,689661
7523,106,21,0,4.83,26.69,689660,689766
7524,102,20,0,5.02,27.98,689765,689867
7525,94,24,0,5.45,39.20,689866,689960
7526,97,20,0,5.28,31.46,689960,690057
7527,63,35,0,8.13,58.52,690056,690119
7528,72,75,0,7.11,94.77,690118,690190
7529,83,59,0,6.17,66.00,690189,690272
7530,78,23,0,6.56,35.94,690271,690349
7531,75,37,0,6.83,46.01,690348,690423
7532,100,21,0,5.12,29.79,690422,690522
7533,120,25,0,4.27,28.48,690521,690641
7534,108,26,0,4.74,34.56,690640,690748
7535,101,29,0,5.07,33.59,690747,690848
7536,100,21,0,5.12,28.49,690847,690947
7537,102,21,0,5.02,30.59,690946,691048
7538,108,24,0,4.74,26.84,691047,691155
7539,80,42,0,6.40,60.94,691154,691234
7540,91,27,0,5.63,35.71,691233,691324
7541,95,22,0,5.39,33.31,691323,691418
7542,103,21,0,4.97,21.68,691417,691520
7543,84,18,0,6.10,27.66,691519,691603
7544,92,33,0,5.57,34.20,691603,691695
7545,93,28,0,5.51,35.00,691694,691787
7546,80,38,0,6.40,52.97,691786,691866
7547,86,30,0,5.95,37.09,691865,691951
7548,110,23,0,4.65,25.63,691951,692061
7549,70,29,0,7.31,47.16,692060,692130
7550,95,25,0,5.39,30.97,692129,692224
7551,94,20,0,5.45,31.86,692223,692317
7552,116,27,0,4.41,27.47,692316,692432
7553,85,28,0,6.02,37.06,692431,692516
7554,92,30,0,5.57,39.53,692515,692607
7555,79,24,0,6.48,36.63,692606,692685
7556,100,37,0,5.12,44.01,692684,692784
7557,91,23,0,5.63,34.04,692783,692874
7558,93,21,0,5.51,34.36,692873,692966
7559,83,38,0,6.17,57.63,692966,693049
7560,97,26,0,5.28,31.25,693049,693146
7561,88,27,0,5.82,34.24,693145,693233
7562,82,19,0,6.24,33.06,693232,693314
7563,108,26,0,4.74,23.64,693314,693422
7564,94,21,0,5.45,33.37,693421,693515
7565,98,21,0,5.22,28.13,693514,693612
7566,86,23,0,5.95,37.67,693611,693697
7567,100,31,0,5.12,32.33,693697,693797
7568,95,34,0,5.39,37.90,693797,693892
7569,103,21,0,4.97,27.83,693891,693994
7570,92,23,0,5.57,32.46,693993,694085
7571,103,37,0,4.97,38.69,694084,694187
7572,88,21,0,5.82,28.65,694186,694274
7573,103,19,0,4.97,26.42,694273,694376
7574,102,25,0,5.02,34.96,694376,694478
7575,97,32,0,5.28,32.57,694477,694574
7576,92,21,0,5.57,28.31,694573,694665
7577,83,74,0,6.17,82.84,694664,694747
7578,91,23,0,5.63,33.86,694746,694837
7579,103,20,0,4.97,24.98,694836,694939
7580,89,19,0,5.75,25.96,694938,695027
7581,98,21,0,5.22,32.03,695026,695124
7582,94,26,0,5.45,32.50,695124,695218
7583,78,20,0,6.56,31.73,695217,695295
7584,94,20,0,5.45,25.35,695294,695388
7585,87,50,0,5.89,61.87,695387,695474
7586,95,27,0,5.39,29.27,695473,695568
7587,106,20,0,4.83,35.67,695567,695673
7588,90,38,0,5.69,39.37,695672,695762
7589,90,19,0,5.69,27.97,695761,695851
7590,97,22,0,5.28,31.07,695850,695947
7591,110,22,0,4.65,24.70,695946,696056
7592,94,27,0,5.45,42.18,696055,696149
7593,107,28,0,4.79,34.26,696148,696255
7594,85,23,0,6.02,31.01,696254,696339
7595,92,26,0,5.57,36.98,696338,696430
7596,93,78,0,5.51,78.42,696429,696522
7597,71,63,0,7.21,84.03,696521,696592
7598,95,36,0,5.39,37.16,696592,696687
7599,106,19,0,4.83,24.78,696686,696792
7600,88,43,0,5.82,50.76,696792,696880
7601,97,29,0,5.28,29.40,696880,696977
7602,88,23,0,5.82,35.10,696977,697065
7603,99,20,0,5.17,27.60,697064,697163
7604,105,28,0,4.88,31.16,697162,697267
7605,64,20,0,8.00,44.44,697267,697331
7606,97,24,0,5.28,33.93,697330,697427
7607,92,30,0,5.57,42.25,697426,697518
7608,93,29,0,5.51,39.60,697518,697611
7609,109,20,0,4.70,26.65,697610,697719
7610,94,25,0,5.45,33.84,697718,697812
7611,85,47,0,6.02,54.33,697811,697896
7612,117,30,0,4.38,27.11,697895,698012
7613,81,22,0,6.32,33.50,698011,698092
7614,92,26,0,5.57,27.09,698091,698183
7615,103,20,0,4.97,30.82,698182,698285
7616,99,20,0,5.17,25.41,698284,698383
7617,102,19,0,5.02,24.06,698382,698484
7618,109,51,0,4.70,43.13,698483,698592
7619,106,20,0,4.83,26.18,698591,698697
7620,111,25,0,4.61,28.83,698696,698807
7621,107,19,0,4.79,26.22,698806,698913
7622,104,30,0,4.92,28.97,698912,699016
7623,118,18,0,4.34,22.43,699015,699133
7624,83,26,0,6.17,37.88,699133,699216
7625,96,24,0,5.33,33.20,699215,699311
7626,76,36,0,6.74,51.19,699310,699386
7627,100,20,0,5.12,27.41,699385,699485
7628,80,26,0,6.40,41.57,699484,699564
7629,102,21,0,5.02,28.74,699563,699665
7630,97,23,0,5.28,29.00,699664,699761
7631,94,20,0,5.45,29.72,699760,699854
7632,82,36,0,6.24,49.99,699853,699935
7633,79,70,0,6.48,91.24,699934,700013
7634,102,49,0,5.02,42.47,700012,700114
7635,102,25,0,5.02,28.22,700113,700215
7636,124,20,0,4.13,22.60,700214,700338
7637,89,25,0,5.75,32.48,700337,700426
7638,92,20,0,5.57,27.35,700425,700517
7639,76,34,0,6.74,45.04,700516,700592
7640,95,23,0,5.39,34.03,700591,700686
7641,90,27,0,5.69,31.86,700685,700775
7642,87,83,0,5.89,98.47,700775,700862
7643,100,26,0,5.12,28.85,700862,700962
7644,104,21,0,4.92,24.28,700961,701065
7645,79,19,0,6.48,40.63,701064,701143
7646,93,19,0,5.51,27.67,701143,701236
7647,92,29,0,5.57,37.48,701235,701327
7648,92,54,0,5.57,56.01,701326,701418
7649,72,29,0,7.11,43.71,701417,701489
7650,136,19,0,3.76,18.90,701488,701624
7651,93,20,0,5.51,27.17,701623,701716
7652,118,29,0,4.34,20.83,701715,701833
7653,89,40,0,5.75,40.50,701832,701921
7654,81,22,0,6.32,36.00,701920,702001
7655,90,29,0,5.69,38.10,702001,702091
7656,98,21,0,5.22,29.13,702090,702188
7657,103,27,0,4.97,28.65,702188,702291
7658,93,21,0,5.51,33.07,702290,702383
7659,101,21,0,5.07,28.08,702382,702483
7660,101,18,0,5.07,26.78,702482,702583
7661,98,23,0,5.22,30.30,702582,702680
7662,94,28,0,5.45,39.40,702679,702773
7663,90,39,0,5.69,42.48,702773,702863
7664,78,28,0,6.56,36.09,702862,702940
7665,85,28,0,6.02,34.73,702939,703024
7666,105,25,0,4.88,32.45,703023,703128
7667,100,38,0,5.12,49.85,703127,703227
7668,91,21,0,5.63,30.28,703226,703317
7669,82,25,0,6.24,27.65,703316,703398
7670,96,27,0,5.33,32.16,703398,703494
7671,103,28,0,4.97,30.51,703493,703596
7672,93,39,0,5.51,51.35,703595,703688
7673,94,30,0,5.45,32.89,703687,703781
7674,84,22,0,6.10,26.75,703780,703864
7675,86,19,0,5.95,28.93,703864,703950
7676,89,34,0,5.75,39.65,703949,704038
7677,98,20,0,5.22,27.52,704037,704135
7678,83,20,0,6.17,32.31,704134,704217
7679,97,29,0,5.28,30.02,704216,704313
7680,96,38,0,5.33,39.51,704312,704408
7681,110,24,0,4.65,30.90,704407,704517
7682,111,23,0,4.61,27.68,704516,704627
7683,107,22,0,4.79,22.47,704626,704733
7684,86,20,0,5.95,26.44,704732,704818
7685,83,29,0,6.17,42.19,704817,704900
7686,86,19,0,5.95,32.28,704899,704985
7687,83,25,0,6.17,36.33,704984,705067
7688,103,19,0,4.97,24.30,705066,705169
7689,110,27,0,4.65,31.15,705168,705278
7690,94,25,0,5.45,38.37,705277,705371
7691,93,29,0,5.51,31.73,705371,705464
7692,81,31,0,6.32,43.53,705464,705545
7693,94,22,0,5.45,32.20,705544,705638
7694,100,30,0,5.12,31.11,705637,705737
7695,118,26,0,4.34,26.77,705736,705854
7696,85,33,0,6.02,44.07,705853,705938
7697,113,29,0,4.53,26.74,705937,706050
7698,84,19,0,6.10,32.44,706049,706133
7699,81,33,0,6.32,40.39,706132,706213
7700,89,22,0,5.75,30.32,706212,706301
7701,98,22,0,5.22,32.89,706300,706398
7702,97,19,0,5.28,25.46,706397,706494
7703,106,20,0,4.83,26.29,706493,706599
7704,88,58,0,5.82,62.60,706598,706686
7705,89,33,0,5.75,39.67,706685,706774
7706,106,26,0,4.83,34.18,706773,706879
7707,105,23,0,4.88,32.55,706878,706983
7708,81,25,0,6.32,36.46,706983,707064
7709,103,54,0,4.97,46.20,707064,707167
7710,83,28,0,6.17,38.77,707166,707249
7711,100,32,0,5.12,31.83,707248,707348
7712,91,34,0,5.63,34.19,707347,707438
7713,112,49,0,4.57,40.39,707437,707549
7714,88,47,0,5.82,55.49,707548,707636
7715,92,28,0,5.57,32.46,707635,707727
7716,96,27,0,5.33,38.58,707726,707822
7717,104,28,0,4.92,30.65,707821,707925
7718,109,25,0,4.70,26.96,707925,708034
7719,101,20,0,5.07,25.25,708033,708134
7720,90,36,0,5.69,43.10,708134,708224
7721,90,23,0,5.69,36.97,708223,708313
7722,85,28,0,6.02,43.15,708312,708397
7723,100,34,0,5.12,41.31,708396,708496
7724,101,23,0,5.07,34.86,708496,708597
7725,88,32,0,5.82,38.06,708596,708684
7726,83,28,0,6.17,37.25,708683,708766
7727,74,22,0,6.92,39.94,708765,708839
7728,90,26,0,5.69,29.55,708838,708928
7729,93,20,0,5.51,30.55,708927,709020
7730,103,22,0,4.97,30.26,709020,709123
7731,88,56,0,5.82,55.33,709122,709210
7732,63,34,0,8.13,47.98,709209,709272
7733,94,18,0,5.45,28.25,709271,709365
7734,102,22,0,5.02,27.53,709364,709466
7735,96,19,0,5.33,26.93,709465,709561
7736,93,20,0,5.51,33.13,709560,709653
7737,110,22,0,4.65,23.10,709652,709762
7738,93,24,0,5.51,34.44,709762,709855
7739,74,32,0,6.92,44.70,709854,709928
7740,107,20,0,4.79,27.83,709927,710034
7741,86,40,0,5.95,47.32,710033,710119
7742,82,25,0,6.24,35.04,710118,710200
7743,90,19,0,5.69,33.48,710199,710289
7744,88,20,0,5.82,29.33,710289,710377
7745,102,24,0,5.02,29.82,710376,710478
7746,93,42,0,5.51,48.25,710477,710570
7747,101,24,0,5.07,30.80,710569,710670
7748,92,32,0,5.57,41.12,710670,710762
7749,100,19,0,5.12,24.73,710761,710861
7750,109,28,0,4.70,30.06,710860,710969
7751,63,68,0,8.13,108.49,710968,711031
7752,81,20,0,6.32,29.90,711030,711111
7753,123,20,0,4.16,22.56,711110,711233
7754,99,41,0,5.17,39.78,711232,711331
7755,91,32,0,5.63,52.34,711330,711421
7756,106,24,0,4.83,33.01,711420,711526
7757,109,22,0,4.70,28.27,711525,711634
7758,93,24,0,5.51,34.19,711633,711726
7759,109,23,0,4.70,30.82,711725,711834
7760,93,36,0,5.51,41.54,711833,711926
7761,102,21,0,5.02,28.51,711926,712028
7762,85,19,0,6.02,27.91,712028,712113
7763,79,49,0,6.48,53.90,712112,712191
7764,102,19,0,5.02,19.92,712191,712293
7765,136,31,0,3.76,25.11,712292,712428
7766,75,39,0,6.83,61.85,712427,712502
7767,87,51,0,5.89,72.22,712502,712589
7768,85,30,0,6.02,41.43,712589,712674
7769,99,28,0,5.17,24.18,712673,712772
7770,72,25,0,7.11,41.90,712772,712844
7771,73,29,0,7.01,37.79,712843,712916
7772,88,114,0,5.82,171.22,712915,713003
7773,101,26,0,5.07,28.18,713002,713103
7774,82,28,0,6.24,37.18,713102,713184
7775,97,20,0,5.28,32.76,713183,713280
7776,91,25,0,5.63,33.99,713279,713370
7777,82,26,0,6.24,38.33,713369,713451
7778,92,33,0,5.57,41.48,713450,713542
7779,94,23,0,5.45,31.57,713541,713635
7780,92,36,0,5.57,44.03,713634,713726
7781,101,23,0,5.07,27.95,713725,713826
7782,82,23,0,6.24,30.60,713825,713907
7783,105,20,0,4.88,25.35,713907,714012
7784,96,39,0,5.33,37.87,714011,714107
7785,92,39,0,5.57,38.85,714106,714198
7786,98,22,0,5.22,30.79,714198,714296
7787,103,24,0,4.97,30.80,714295,714398
7788,105,21,0,4.88,23.63,714398,714503
7789,99,20,0,5.17,29.39,714502,714601
7790,89,27,0,5.75,36.10,714600,714689
7791,127,19,0,4.03,18.85,714688,714815
7792,90,22,0,5.69,27.04,714814,714904
7793,95,24,0,5.39,31.48,714903,714998
7794,106,19,0,4.83,19.90,714997,715103
7795,96,25,0,5.33,28.26,715102,715198
7796,79,43,0,6.48,46.71,715197,715276
7797,85,75,0,6.02,80.63,715275,715360
7798,103,20,0,4.97,25.10,715359,715462
7799,92,23,0,5.57,35.72,715461,715553
7800,83,25,0,6.17,39.75,715552,715635
7801,82,20,0,6.24,38.70,715634,715716
7802,82,36,0,6.24,43.11,715715,715797
7803,93,20,0,5.51,26.10,715796,715889
7804,94,21,0,5.45,25.84,715888,715982
7805,109,22,0,4.70,34.23,715981,716090
7806,108,49,0,4.74,38.43,716089,716197
7807,95,25,0,5.39,27.94,716196,716291
7808,112,20,0,4.57,25.49,716290,716402
7809,59,44,0,8.68,56.86,716401,716460
7810,102,20,0,5.02,24.12,716459,716561
7811,112,26,0,4.57,28.16,716560,716672
7812,84,33,0,6.10,46.56,716671,716755
7813,107,20,0,4.79,24.51,716755,716862
7814,96,22,0,5.33,30.45,716861,716957
7815,108,37,0,4.74,38.10,716956,717064
7816,74,26,0,6.92,42.32,717063,717137
7817,81,27,0,6.32,34.59,717137,717218
7818,120,21,0,4.27,22.66,717217,717337
7819,84,52,0,6.10,102.01,717336,717420
7820,112,25,0,4.57,26.64,717419,717531
7821,115,20,0,4.45,26.73,717530,717645
7822,88,33,0,5.82,34.67,717644,717732
7823,93,32,0,5.51,39.69,717731,717824
7824,86,19,0,5.95,35.07,717823,717909
7825,83,44,0,6.17,43.66,717909,717992
7826,94,20,0,5.45,26.89,717991,718085
7827,97,21,0,5.28,25.05,718085,718182
7828,98,22,0,5.22,31.13,718181,718279
7829,108,23,0,4.74,27.23,718278,718386
7830,102,31,0,5.02,27.49,718385,718487
7831,115,22,0,4.45,30.47,718486,718601
7832,98,20,0,5.22,27.24,718600,718698
7833,87,49,0,5.89,49.89,718698,718785
7834,88,62,0,5.82,62.22,718784,718872
7835,86,22,0,5.95,35.67,718871,718957
7836,83,29,0,6.17,34.26,718957,719040
7837,91,21,0,5.63,29.71,719039,719130
7838,101,30,0,5.07,30.54,719129,719230
7839,111,36,0,4.61,25.99,719229,719340
7840,100,20,0,5.12,23.33,719340,719440
7841,82,23,0,6.24,33.87,719439,719521
7842,82,25,0,6.24,37.89,719521,719603
7843,114,22,0,4.49,23.60,719603,719717
7844,110,23,0,4.65,22.88,719716,719826
7845,83,33,0,6.17,43.37,719825,719908
7846,112,23,0,4.57,26.16,719907,720019
7847,73,42,0,7.01,54.97,720018,720091
7848,67,45,0,7.64,58.02,720090,720157
7849,95,32,0,5.39,33.10,720156,720251
7850,89,34,0,5.75,39.53,720251,720340
7851,85,20,0,6.02,31.83,720339,720424
7852,100,32,0,5.12,32.85,720423,720523
7853,99,22,0,5.17,35.23,720522,720621
7854,97,39,0,5.28,47.69,720620,720717
7855,89,25,0,5.75,33.08,720716,720805
7856,105,37,0,4.88,31.90,720804,720909
7857,83,29,0,6.17,37.20,720908,720991
7858,83,21,0,6.17,32.91,720990,721073
7859,119,28,0,4.30,24.83,721072,721191
7860,92,27,0,5.57,34.01,721190,721282
7861,96,21,0,5.33,26.81,721281,721377
7862,90,57,0,5.69,61.21,721376,721466
7863,83,24,0,6.17,39.80,721465,721548
7864,91,26,0,5.63,33.33,721547,721638
7865,86,61,0,5.95,61.77,721637,721723
7866,87,45,0,5.89,47.78,721722,721809
7867,75,35,0,6.83,47.98,721808,721883
7868,97,39,0,5.28,47.95,721882,721979
7869,107,20,0,4.79,23.10,721978,722085
7870,93,20,0,5.51,30.40,722084,722177
7871,99,23,0,5.17,29.13,722176,722275
7872,99,21,0,5.17,33.70,722275,722374
7873,91,19,0,5.63,28.98,722373,722464
7874,90,40,0,5.69,43.97,722463,722553
7875,90,23,0,5.69,31.95,722552,722642
7876,123,19,0,4.16,20.90,722642,722765
7877,84,47,0,6.10,52.51,722764,722848
7878,106,19,0,4.83,24.99,722847,722953
7879,93,21,0,5.51,34.47,722952,723045
7880,109,20,0,4.70,28.82,723045,723154
7881,96,21,0,5.33,31.83,723154,723250
7882,99,26,0,5.17,34.97,723250,723349
7883,88,24,0,5.82,37.24,723348,723436
7884,75,49,0,6.83,59.50,723435,723510
7885,97,38,0,5.28,36.49,723509,723606
7886,89,49,0,5.75,51.56,723605,723694
7887,95,72,0,5.39,67.10,723693,723788
7888,111,35,0,4.61,34.29,723787,723898
7889,107,22,0,4.79,33.37,723897,724004
7890,102,31,0,5.02,32.88,724003,724105
7891,89,96,0,5.75,120.39,724104,724193
7892,92,21,0,5.57,29.53,724192,724284
7893,86,33,0,5.95,46.63,724283,724369
7894,80,20,0,6.40,32.89,724368,724448
7895,94,34,0,5.45,37.97,724447,724541
7896,80,94,0,6.40,121.04,724540,724620
7897,103,33,0,4.97,37.72,724619,724722
7898,67,29,0,7.64,50.41,724722,724789
7899,95,22,0,5.39,28.79,724789,724884
7900,95,108,0,5.39,138.51,724883,724978
7901,115,23,0,4.45,30.80,724977,725092
7902,91,26,0,5.63,35.66,725091,725182
7903,88,28,0,5.82,34.99,725181,725269
7904,91,45,0,5.63,46.23,725268,725359
7905,86,45,0,5.95,61.25,725358,725444
7906,108,19,0,4.74,25.43,725443,725551
7907,91,28,0,5.63,43.57,725550,725641
7908,93,20,0,5.51,29.60,725640,725733
7909,101,29,0,5.07,35.01,725732,725833
7910,78,22,0,6.56,32.53,725832,725910
7911,91,27,0,5.63,38.94,725909,726000
7912,92,26,0,5.57,33.18,725999,726091
7913,112,29,0,4.57,31.28,726090,726202
7914,111,20,0,4.61,24.63,726201,726312
7915,109,34,0,4.70,34.14,726311,726420
7916,94,30,0,5.45,40.03,726419,726513
7917,101,39,0,5.07,39.51,726512,726613
7918,99,19,0,5.17,22.71,726612,726711
7919,83,21,0,6.17,28.79,726710,726793
7920,78,23,0,6.56,38.89,726792,726870
7921,93,40,0,5.51,45.63,726869,726962
7922,113,28,0,4.53,27.42,726962,727075
7923,107,27,0,4.79,33.38,727074,727181
7924,92,20,0,5.57,28.59,727180,727272
7925,105,25,0,4.88,33.00,727271,727376
7926,93,24,0,5.51,35.28,727376,727469
7927,93,32,0,5.51,37.52,727468,727561
7928,111,20,0,4.61,27.89,727560,727671
7929,95,25,0,5.39,39.48,727671,727766
7930,86,25,0,5.95,37.63,727765,727851
7931,99,20,0,5.17,26.81,727850,727949
7932,104,20,0,4.92,26.84,727948,728052
7933,99,31,0,5.17,36.36,728051,728150
7934,78,31,0,6.56,40.32,728149,728227
7935,93,24,0,5.51,32.14,728226,728319
7936,104,25,0,4.92,31.40,728318,728422
7937,91,20,0,5.63,30.48,728421,728512
7938,94,31,0,5.45,40.37,728512,728606
7939,92,19,0,5.57,30.38,728605,728697
7940,77,35,0,6.65,47.42,728696,728773
7941,98,23,0,5.22,27.85,728772,728870
7942,96,19,0,5.33,32.31,728869,728965
7943,83,34,0,6.17,49.63,728964,729047
7944,101,24,0,5.07,27.19,729046,729147
7945,76,42,0,6.74,49.11,729146,729222
7946,104,27,0,4.92,28.80,729221,729325
7947,81,75,0,6.32,95.08,729324,729405
7948,95,24,0,5.39,28.07,729404,729499
7949,106,21,0,4.83,27.42,729499,729605
7950,99,45,0,5.17,43.66,729604,729703
7951,110,23,0,4.65,25.66,729702,729812
7952,94,20,0,5.45,26.03,729811,729905
7953,98,29,0,5.22,37.07,729904,730002
7954,100,33,0,5.12,33.59,730001,730101
7955,93,53,0,5.51,56.62,730100,730193
7956,111,20,0,4.61,28.09,730192,730303
7957,119,19,0,4.30,25.86,730302,730421
7958,99,29,0,5.17,35.60,730420,730519
7959,82,42,0,6.24,49.16,730519,730601
7960,92,53,0,5.57,52.90,730601,730693
7961,100,23,0,5.12,30.97,730692,730792
7962,101,46,0,5.07,44.32,730791,730892
7963,104,32,0,4.92,31.07,730891,730995
7964,80,35,0,6.40,42.59,730994,731074
7965,91,31,0,5.63,33.51,731073,731164
7966,100,28,0,5.12,40.99,731163,731263
7967,89,24,0,5.75,35.51,731262,731351
7968,111,23,0,4.61,22.51,731350,731461
7969,100,23,0,5.12,31.45,731460,731560
7970,99,35,0,5.17,37.54,731559,731658
7971,91,36,0,5.63,39.86,731657,731748
7972,111,20,0,4.61,28.47,731747,731858
7973,79,23,0,6.48,34.96,731858,731937
7974,87,33,0,5.89,38.84,731937,732024
7975,96,29,0,5.33,32.91,732023,732119
7976,90,39,0,5.69,37.75,732118,732208
7977,82,30,0,6.24,39.23,732207,732289
7978,84,20,0,6.10,31.44,732288,732372
7979,85,40,0,6.02,49.03,732372,732457
7980,96,20,0,5.33,23.99,732457,732553
7981,98,22,0,5.22,27.79,732552,732650
7982,91,43,0,5.63,44.78,732649,732740
7983,104,43,0,4.92,35.78,732739,732843
7984,101,20,0,5.07,32.58,732842,732943
7985,103,24,0,4.97,29.06,732942,733045
7986,107,18,0,4.79,25.40,733044,733151
7987,97,19,0,5.28,22.59,733151,733248
7988,84,28,0,6.10,36.63,733247,733331
7989,87,38,0,5.89,47.37,733330,733417
7990,79,105,0,6.48,147.69,733416,733495
7991,118,22,0,4.34,22.48,733494,733612
7992,94,33,0,5.45,42.84,733611,733705
7993,95,25,0,5.39,28.68,733704,733799
7994,110,24,0,4.65,32.63,733798,733908
7995,77,32,0,6.65,49.03,733907,733984
7996,83,38,0,6.17,38.07,733983,734066
7997,93,22,0,5.51,35.13,734065,734158
7998,95,71,0,5.39,67.65,734157,734252
7999,97,23,0,5.28,29.48,734251,734348
8000,86,25,0,5.95,35.25,734347,734433
8001,103,19,0,4.97,24.07,734432,734535
8002,116,27,0,4.41,25.45,734534,734650
8003,93,22,0,5.51,37.09,734649,734742
8004,104,21,0,4.92,28.30,734741,734845
8005,92,20,0,5.57,29.59,734844,734936
8006,85,21,0,6.02,36.21,734936,735021
8007,94,31,0,5.45,33.10,735020,735114
8008,74,22,0,6.92,36.70,735113,735187
8009,94,22,0,5.45,30.31,735186,735280
8010,83,21,0,6.17,33.30,735280,735363
8011,94,27,0,5.45,33.06,735362,735456
8012,105,28,0,4.88,33.96,735455,735560
8013,79,27,0,6.48,43.69,735559,735638
8014,118,20,0,4.34,19.82,735637,735755
8015,93,21,0,5.51,32.27,735755,735848
8016,89,38,0,5.75,53.06,735847,735936
8017,77,157,0,6.65,324.85,735935,736012
8018,91,20,0,5.63,29.71,736011,736102
8019,84,44,0,6.10,42.16,736101,736185
8020,116,19,0,4.41,21.76,736184,736300
8021,117,22,0,4.38,24.41,736299,736416
8022,104,25,0,4.92,27.71,736415,736519
8023,93,30,0,5.51,39.02,736518,736611
8024,98,23,0,5.22,25.30,736611,736709
8025,112,27,0,4.57,23.74,736708,736820
8026,99,21,0,5.17,30.06,736819,736918
8027,88,20,0,5.82,30.47,736917,737005
8028,95,34,0,5.39,33.06,737004,737099
8029,68,29,0,7.53,41.01,737098,737166
8030,94,66,0,5.45,69.27,737165,737259
8031,111,28,0,4.61,26.42,737258,737369
8032,76,71,0,6.74,83.22,737369,737445
8033,77,26,0,6.65,36.51,737444,737521
8034,89,28,0,5.75,40.03,737520,737609
8035,96,19,0,5.33,29.91,737609,737705
8036,87,26,0,5.89,34.72,737705,737792
8037,85,23,0,6.02,36.40,737791,737876
8038,86,38,0,5.95,46.11,737875,737961
8039,74,59,0,6.92,65.78,737960,738034
8040,91,25,0,5.63,33.07,738033,738124
8041,98,19,0,5.22,25.66,738124,738222
8042,90,51,0,5.69,55.01,738221,738311
8043,102,19,0,5.02,27.16,738311,738413
8044,91,25,0,5.63,34.30,738412,738503
8045,104,22,0,4.92,32.67,738502,738606
8046,105,19,0,4.88,23.54,738605,738710
8047,77,20,0,6.65,33.66,738709,738786
8048,97,19,0,5.28,31.31,738785,738882
8049,106,20,0,4.83,22.41,738881,738987
8050,66,163,0,7.76,435.21,738986,739052
8051,95,21,0,5.39,31.23,739052,739147
8052,83,23,0,6.17,38.50,739146,739229
8053,96,20,0,5.33,25.99,739228,739324
8054,98,20,0,5.22,27.15,739323,739421
8055,73,77,0,7.01,94.73,739420,739493
8056,91,25,0,5.63,39.33,739492,739583
8057,99,53,0,5.17,46.22,739582,739681
8058,120,18,0,4.27,20.90,739681,739801
8059,82,24,0,6.24,29.94,739800,739882
8060,85,55,0,6.02,61.43,739881,739966
8061,105,22,0,4.88,25.96,739965,740070
8062,87,24,0,5.89,30.68,740069,740156
8063,105,28,0,4.88,33.65,740156,740261
8064,86,57,0,5.95,58.21,740260,740346
8065,81,43,0,6.32,47.48,740345,740426
8066,91,24,0,5.63,40.63,740426,740517
8067,105,30,0,4.88,30.01,740516,740621
8068,95,23,0,5.39,28.93,740620,740715
8069,74,20,0,6.92,40.10,740714,740788
8070,98,37,0,5.22,35.44,740787,740885
8071,94,21,0,5.45,31.12,740884,740978
8072,86,21,0,5.95,31.23,740977,741063
8073,97,28,0,5.28,28.04,741062,741159
8074,85,22,0,6.02,32.12,741158,741243
8075,85,59,0,6.02,71.22,741242,741327
8076,95,20,0,5.39,28.05,741326,741421
8077,82,22,0,6.24,32.70,741420,741502
8078,89,27,0,5.75,33.49,741501,741590
8079,104,18,0,4.92,22.40,741589,741693
8080,86,32,0,5.95,38.09,741692,741778
8081,84,21,0,6.10,31.35,741778,741862
8082,100,20,0,5.12,30.99,741862,741962
8083,81,49,0,6.32,71.30,741961,742042
8084,82,23,0,6.24,38.06,742041,742123
8085,99,24,0,5.17,28.36,742122,742221
8086,88,21,0,5.82,30.83,742220,742308
8087,112,41,0,4.57,35.74,742307,742419
8088,120,23,0,4.27,25.55,742418,742538
8089,96,38,0,5.33,38.99,742537,742633
8090,98,21,0,5.22,27.50,742632,742730
8091,84,32,0,6.10,48.90,742729,742813
8092,118,31,0,4.34,25.92,742813,742931
8093,119,24,0,4.30,28.46,742930,743049
8094,108,25,0,4.74,29.45,743048,743156
8095,96,25,0,5.33,27.76,743156,743252
8096,85,36,0,6.02,41.74,743251,743336
8097,113,37,0,4.53,28.82,743335,743448
8098,84,21,0,6.10,34.30,743447,743531
8099,80,81,0,6.40,97.29,743530,743610
8100,97,29,0,5.28,25.56,743609,743706
8101,103,25,0,4.97,29.58,743705,743808
8102,108,24,0,4.74,34.36,743808,743916
8103,86,19,0,5.95,30.84,743915,744001
8104,108,53,0,4.74,48.12,744000,744108
8105,111,26,0,4.61,26.81,744107,744218
8106,119,22,0,4.30,19.05,744217,744336
8107,79,47,0,6.48,54.96,744335,744414
8108,105,24,0,4.88,29.35,744413,744518
8109,82,20,0,6.24,38.94,744518,744600
8110,97,42,0,5.28,52.78,744599,744696
8111,92,20,0,5.57,25.79,744696,744788
8112,98,32,0,5.22,38.09,744787,744885
8113,100,58,0,5.12,66.51,744884,744984
8114,84,25,0,6.10,35.71,744983,745067
8115,85,30,0,6.02,44.38,745067,745152
8116,82,79,0,6.24,89.14,745151,745233
8117,84,24,0,6.10,31.66,745232,745316
8118,79,33,0,6.48,42.33,745315,745394
8119,113,18,0,4.53,18.34,745393,745506
8120,82,28,0,6.24,37.43,745505,745587
8121,103,22,0,4.97,23.33,745586,745689
8122,90,24,0,5.69,34.66,745688,745778
8123,101,32,0,5.07,34.08,745777,745878
8124,96,24,0,5.33,29.72,745877,745973
8125,89,20,0,5.75,33.17,745972,746061
8126,92,23,0,5.57,32.85,746060,746152
8127,106,27,0,4.83,32.03,746151,746257
8128,81,42,0,6.32,52.51,746256,746337
8129,84,42,0,6.10,47.09,746336,746420
8130,81,51,0,6.32,66.24,746419,746500
8131,91,23,0,5.63,35.46,746499,746590
8132,96,30,0,5.33,33.35,746589,746685
8133,79,36,0,6.48,44.88,746684,746763
8134,70,24,0,7.31,46.79,746762,746832
8135,97,26,0,5.28,36.78,746832,746929
8136,92,22,0,5.57,36.68,746928,747020
8137,91,25,0,5.63,32.70,747019,747110
8138,82,20,0,6.24,28.92,747109,747191
8139,116,20,0,4.41,27.14,747190,747306
8140,104,22,0,4.92,24.71,747305,747409
8141,86,20,0,5.95,33.16,747408,747494
8142,96,21,0,5.33,29.70,747493,747589
8143,97,22,0,5.28,27.09,747588,747685
8144,99,25,0,5.17,32.55,747684,747783
8145,95,24,0,5.39,26.89,747782,747877
8146,91,24,0,5.63,32.59,747876,747967
8147,76,32,0,6.74,51.90,747967,748043
8148,82,31,0,6.24,45.62,748042,748124
8149,99,34,0,5.17,36.61,748124,748223
8150,84,22,0,6.10,36.87,748222,748306
8151,90,43,0,5.69,42.17,748305,748395
8152,105,23,0,4.88,31.25,748394,748499
8153,89,25,0,5.75,29.44,748498,748587
8154,81,35,0,6.32,45.50,748587,748668
8155,93,34,0,5.51,38.64,748667,748760
8156,116,24,0,4.41,28.21,748759,748875
8157,84,61,0,6.10,73.23,748874,748958
8158,89,49,0,5.75,51.38,748957,749046
8159,91,28,0,5.63,32.23,749045,749136
8160,97,20,0,5.28,29.00,749135,749232
8161,93,25,0,5.51,37.43,749231,749324
8162,100,18,0,5.12,24.63,749323,749423
8163,100,21,0,5.12,28.97,749422,749522
8164,118,19,0,4.34,22.19,749522,749640
8165,90,22,0,5.69,28.15,749639,749729
8166,106,27,0,4.83,27.37,749728,749834
8167,88,26,0,5.82,31.63,749833,749921
8168,92,35,0,5.57,48.33,749920,750012
8169,90,109,0,5.69,141.39,750012,750102
8170,101,20,0,5.07,26.58,750101,750202
8171,89,27,0,5.75,36.50,750201,750290
8172,90,30,0,5.69,38.75,750289,750379
8173,115,44,0,4.45,41.15,750378,750493
8174,86,24,0,5.95,33.86,750492,750578
8175,84,29,0,6.10,44.51,750577,750661
8176,105,19,0,4.88,22.72,750660,750765
8177,76,29,0,6.74,43.06,750764,750840
8178,95,23,0,5.39,30.26,750840,750935
8179,85,83,0,6.02,101.25,750934,751019
8180,101,21,0,5.07,20.68,751018,751119
8181,74,27,0,6.92,48.24,751119,751193
8182,100,30,0,5.12,34.97,751192,751292
8183,94,58,0,5.45,65.63,751291,751385
8184,87,27,0,5.89,40.03,751384,751471
8185,93,50,0,5.51,49.41,751470,751563
8186,78,57,0,6.56,67.04,751562,751640
8187,91,25,0,5.63,32.39,751639,751730
8188,93,19,0,5.51,28.27,751729,751822
8189,72,49,0,7.11,75.68,751821,751893
8190,88,38,0,5.82,44.38,751892,751980
8191,98,26,0,5.22,36.30,751979,752077
8192,81,44,0,6.32,54.29,752076,752157
8193,102,20,0,5.02,32.20,752156,752258
8194,104,25,0,4.92,30.15,752257,752361
8195,102,48,0,5.02,42.35,752360,752462
8196,76,43,0,6.74,51.75,752461,752537
8197,77,55,0,6.65,84.10,752536,752613
8198,88,41,0,5.82,56.01,752612,752700
8199,95,28,0,5.39,31.73,752699,752794
8200,72,27,0,7.11,42.27,752793,752865
8201,103,20,0,4.97,28.75,752864,752967
8202,98,28,0,5.22,27.40,752966,753064
8203,90,39,0,5.69,44.88,753063,753153
8204,83,29,0,6.17,39.85,753152,753235
8205,96,19,0,5.33,29.95,753234,753330
8206,87,25,0,5.89,38.77,753329,753416
8207,89,27,0,5.75,32.86,753416,753505
8208,81,41,0,6.32,49.30,753504,753585
8209,77,31,0,6.65,42.77,753584,753661
8210,88,25,0,5.82,37.72,753660,753748
8211,99,26,0,5.17,33.72,753747,753846
8212,92,34,0,5.57,37.46,753846,753938
8213,101,26,0,5.07,33.45,753938,754039
8214,105,30,0,4.88,30.20,754038,754143
8215,86,69,0,5.95,79.53,754142,754228
8216,111,20,0,4.61,26.54,754227,754338
8217,93,23,0,5.51,24.03,754337,754430
8218,97,51,0,5.28,47.77,754429,754526
8219,107,25,0,4.79,28.82,754526,754633
8220,100,50,0,5.12,44.89,754633,754733
8221,81,52,0,6.32,62.17,754732,754813
8222,80,25,0,6.40,43.57,754813,754893
8223,97,20,0,5.28,32.18,754893,754990
8224,98,24,0,5.22,31.66,754989,755087
8225,97,35,0,5.28,40.84,755086,755183
8226,100,21,0,5.12,33.33,755183,755283
8227,86,41,0,5.95,61.72,755282,755368
8228,107,37,0,4.79,38.80,755367,755474
8229,77,28,0,6.65,42.85,755474,755551
8230,90,69,0,5.69,82.50,755550,755640
8231,89,22,0,5.75,34.52,755639,755728
8232,91,24,0,5.63,32.50,755727,755818
8233,95,21,0,5.39,38.39,755817,755912
8234,85,52,0,6.02,52.73,755911,755996
8235,87,25,0,5.89,35.30,755996,756083
8236,105,40,0,4.88,38.20,756083,756188
8237,96,20,0,5.33,26.58,756187,756283
8238,71,22,0,7.21,37.94,756282,756353
8239,83,24,0,6.17,35.44,756352,756435
8240,92,26,0,5.57,34.22,756435,756527
8241,91,24,0,5.63,30.87,756526,756617
8242,96,24,0,5.33,37.97,756616,756712
8243,103,23,0,4.97,32.34,756711,756814
8244,97,19,0,5.28,27.03,756813,756910
8245,80,58,0,6.40,65.74,756910,756990
8246,85,20,0,6.02,33.51,756989,757074
8247,84,25,0,6.10,35.28,757073,757157
8248,100,19,0,5.12,24.11,757156,757256
8249,91,20,0,5.63,27.07,757255,757346
8250,98,27,0,5.22,33.66,757345,757443
8251,90,22,0,5.69,30.99,757442,757532
8252,115,19,0,4.45,22.14,757531,757646
8253,88,61,0,5.82,67.31,757645,757733
8254,83,35,0,6.17,49.80,757732,757815
8255,95,22,0,5.39,28.89,757814,757909
8256,92,29,0,5.57,38.62,757909,758001
8257,108,20,0,4.74,27.10,758000,758108
8258,96,23,0,5.33,32.35,758107,758203
8259,96,20,0,5.33,29.06,758202,758298
8260,97,20,0,5.28,29.79,758297,758394
8261,89,21,0,5.75,31.89,758393,758482
8262,106,20,0,4.83,22.99,758481,758587
8263,109,21,0,4.70,30.25,758586,758695
8264,117,19,0,4.38,23.12,758695,758812
8265,82,21,0,6.24,35.87,758811,758893
8266,89,20,0,5.75,34.21,758892,758981
8267,91,19,0,5.63,31.84,758980,759071
8268,79,32,0,6.48,54.43,759070,759149
8269,88,23,0,5.82,26.17,759148,759236
8270,104,16,0,4.92,23.22,759235,759339
8271,72,30,0,7.11,50.07,759338,759410
8272,101,26,0,5.07,28.54,759409,759510
8273,91,26,0,5.63,32.32,759510,759601
8274,105,22,0,4.88,30.45,759600,759705
8275,88,22,0,5.82,36.01,759704,759792
8276,85,21,0,6.02,33.67,759792,759877
8277,99,22,0,5.17,26.02,759876,759975
8278,88,20,0,5.82,35.33,759974,760062
8279,93,34,0,5.51,37.82,760061,760154
8280,95,24,0,5.39,36.72,760153,760248
8281,92,19,0,5.57,32.59,760247,760339
8282,108,17,0,4.74,23.99,760338,760446
8283,73,25,0,7.01,41.79,760445,760518
8284,102,29,0,5.02,29.23,760518,760620
8285,108,23,0,4.74,25.23,760619,760727
8286,89,34,0,5.75,40.61,760726,760815
8287,79,32,0,6.48,50.60,760814,760893
8288,92,56,0,5.57,57.46,760892,760984
8289,101,19,0,5.07,27.95,760984,761085
8290,112,19,0,4.57,21.35,761084,761196
8291,110,42,0,4.65,40.59,761195,761305
8292,95,19,0,5.39,31.50,761304,761399
8293,106,20,0,4.83,25.63,761398,761504
8294,91,30,0,5.63,33.51,761503,761594
8295,93,20,0,5.51,26.34,761593,761686
8296,79,33,0,6.48,44.63,761685,761764
8297,91,28,0,5.63,30.96,761763,761854
8298,86,23,0,5.95,33.25,761853,761939
8299,87,36,0,5.89,48.52,761938,762025
8300,79,36,0,6.48,45.90,762024,762103
8301,74,35,0,6.92,51.34,762102,762176
8302,89,20,0,5.75,30.32,762175,762264
8303,81,55,0,6.32,61.03,762264,762345
8304,82,26,0,6.24,37.36,762344,762426
8305,84,26,0,6.10,35.51,762425,762509
8306,98,20,0,5.22,29.26,762508,762606
8307,95,22,0,5.39,23.23,762606,762701
8308,96,45,0,5.33,46.64,762701,762797
8309,101,23,0,5.07,34.74,762796,762897
8310,97,20,0,5.28,31.42,762896,762993
8311,110,23,0,4.65,29.92,762992,763102
8312,87,22,0,5.89,33.85,763101,763188
8313,108,38,0,4.74,33.06,763187,763295
8314,110,20,0,4.65,19.17,763294,763404
8315,94,28,0,5.45,37.12,763403,763497
8316,96,96,0,5.33,111.66,763496,763592
8317,91,27,0,5.63,41.22,763591,763682
8318,105,25,0,4.88,33.12,763681,763786
8319,107,24,0,4.79,30.82,763785,763892
8320,109,29,0,4.70,29.11,763891,764000
8321,98,23,0,5.22,28.97,763999,764097
8322,92,20,0,5.57,27.44,764096,764188
8323,69,41,0,7.42,58.30,764187,764256
8324,100,24,0,5.12,43.21,764255,764355
8325,86,26,0,5.95,37.51,764354,764440
8326,98,20,0,5.22,28.11,764439,764537
8327,105,20,0,4.88,24.76,764536,764641
8328,98,29,0,5.22,30.87,764640,764738
8329,76,27,0,6.74,42.98,764737,764813
8330,99,33,0,5.17,40.65,764812,764911
8331,93,21,0,5.51,26.87,764910,765003
8332,99,38,0,5.17,39.74,765002,765101
8333,96,28,0,5.33,38.72,765101,765197
8334,89,22,0,5.75,35.00,765196,765285
8335,93,21,0,5.51,29.28,765285,765378
8336,96,36,0,5.33,42.83,765378,765474
8337,87,24,0,5.89,37.18,765473,765560
8338,90,45,0,5.69,41.48,765559,765649
8339,90,23,0,5.69,37.06,765648,765738
8340,91,24,0,5.63,38.17,765737,765828
8341,82,24,0,6.24,31.28,765828,765910
8342,99,25,0,5.17,31.54,765909,766008
8343,100,23,0,5.12,33.35,766007,766107
8344,96,45,0,5.33,44.03,766106,766202
8345,87,108,0,5.89,147.99,766201,766288
8346,67,26,0,7.64,44.65,766287,766354
8347,113,20,0,4.53,23.20,766354,766467
8348,111,22,0,4.61,26.09,766467,766578
8349,90,25,0,5.69,33.66,766577,766667
8350,78,30,0,6.56,52.86,766666,766744
8351,99,35,0,5.17,39.72,766743,766842
8352,91,26,0,5.63,36.37,766841,766932
8353,108,27,0,4.74,27.84,766931,767039
8354,63,56,0,8.13,80.21,767038,767101
8355,87,39,0,5.89,45.71,767101,767188
8356,93,19,0,5.51,26.29,767187,767280
8357,97,21,0,5.28,31.50,767279,767376
8358,84,65,0,6.10,77.37,767375,767459
8359,96,20,0,5.33,27.78,767458,767554
8360,63,27,0,8.13,53.22,767553,767616
8361,81,53,0,6.32,72.42,767615,767696
8362,101,25,0,5.07,30.98,767695,767796
8363,92,29,0,5.57,35.98,767795,767887
8364,90,20,0,5.69,25.17,767886,767976
8365,68,41,0,7.53,60.37,767975,768043
8366,49,292,0,10.45,1687.15,768043,768092
8367,101,38,0,5.07,38.26,768091,768192
8368,109,22,0,4.70,26.95,768191,768300
8369,103,30,0,4.97,32.03,768299,768402
8370,96,52,0,5.33,52.66,768401,768497
8371,105,26,0,4.88,33.21,768496,768601
8372,80,25,0,6.40,36.09,768601,768681
8373,104,20,0,4.92,28.47,768680,768784
8374,101,34,0,5.07,34.36,768783,768884
8375,73,29,0,7.01,40.81,768884,768957
8376,94,21,0,5.45,26.95,768956,769050
8377,81,42,0,6.32,64.17,769050,769131
8378,94,20,0,5.45,28.67,769130,769224
8379,97,22,0,5.28,29.31,769223,769320
8380,87,40,0,5.89,55.62,769319,769406
8381,80,54,0,6.40,54.64,769405,769485
8382,113,31,0,4.53,29.15,769484,769597
8383,123,40,0,4.16,30.40,769596,769719
8384,95,20,0,5.39,28.15,769718,769813
8385,105,20,0,4.88,26.78,769813,769918
8386,79,29,0,6.48,35.84,769917,769996
8387,86,54,0,5.95,53.37,769995,770081
8388,94,57,0,5.45,53.18,770080,770174
8389,68,28,0,7.53,49.16,770174,770242
8390,99,27,0,5.17,30.83,770241,770340
8391,78,24,0,6.56,42.78,770339,770417
8392,107,20,0,4.79,22.90,770416,770523
8393,95,26,0,5.39,39.61,770522,770617
8394,91,24,0,5.63,35.40,770616,770707
8395,92,20,0,5.57,28.98,770706,770798
8396,94,20,0,5.45,25.69,770797,770891
8397,72,45,0,7.11,65.93,770890,770962
8398,105,49,0,4.88,36.17,770962,771067
8399,92,85,0,5.57,96.85,771066,771158
8400,87,69,0,5.89,83.30,771157,771244
8401,89,34,0,5.75,52.59,771243,771332
8402,98,25,0,5.22,31.91,771332,771430
8403,74,20,0,6.92,33.29,771429,771503
8404,83,23,0,6.17,40.55,771502,771585
8405,102,34,0,5.02,36.61,771585,771687
8406,94,19,0,5.45,27.91,771686,771780
8407,87,20,0,5.89,36.72,771779,771866
8408,90,26,0,5.69,36.81,771866,771956
8409,64,32,0,8.00,47.28,771955,772019
8410,82,55,0,6.24,76.96,772018,772100
8411,93,20,0,5.51,31.13,772099,772192
8412,86,82,0,5.95,92.65,772191,772277
8413,92,20,0,5.57,29.92,772276,772368
8414,87,20,0,5.89,34.72,772367,772454
8415,82,30,0,6.24,48.23,772453,772535
8416,94,23,0,5.45,29.44,772534,772628
8417,84,26,0,6.10,36.71,772627,772711
8418,110,22,0,4.65,24.75,772710,772820
8419,96,19,0,5.33,29.53,772819,772915
8420,95,22,0,5.39,28.76,772914,773009
8421,104,34,0,4.92,33.13,773008,773112
8422,82,41,0,6.24,48.62,773111,773193
8423,88,22,0,5.82,35.72,773192,773280
8424,90,24,0,5.69,37.06,773280,773370
8425,85,29,0,6.02,34.94,773369,773454
8426,100,19,0,5.12,28.07,773453,773553
8427,84,66,0,6.10,75.56,773552,773636
8428,97,20,0,5.28,29.69,773635,773732
8429,96,44,0,5.33,47.06,773731,773827
8430,105,22,0,4.88,26.70,773826,773931
8431,109,22,0,4.70,30.21,773930,774039
8432,99,22,0,5.17,29.90,774038,774137
8433,106,20,0,4.83,28.93,774136,774242
8434,95,24,0,5.39,33.29,774241,774336
8435,98,20,0,5.22,29.56,774335,774433
8436,111,23,0,4.61,27.52,774433,774544
8437,113,18,0,4.53,20.71,774543,774656
8438,105,21,0,4.88,29.31,774655,774760
8439,101,25,0,5.07,31.65,774759,774860
8440,103,21,0,4.97,27.68,774859,774962
8441,110,19,0,4.65,23.55,774961,775071
8442,98,23,0,5.22,30.17,775070,775168
8443,96,23,0,5.33,28.70,775167,775263
8444,104,36,0,4.92,41.28,775262,775366
8445,83,29,0,6.17,36.07,775366,775449
8446,99,55,0,5.17,51.39,775449,775548
8447,87,34,0,5.89,46.10,775547,775634
8448,98,35,0,5.22,37.95,775634,775732
8449,112,20,0,4.57,25.10,775731,775843
8450,111,21,0,4.61,23.32,775842,775953
8451,115,23,0,4.45,27.03,775952,776067
8452,77,26,0,6.65,44.18,776067,776144
8453,106,25,0,4.83,29.93,776144,776250
8454,84,32,0,6.10,62.56,776249,776333
8455,86,23,0,5.95,35.37,776332,776418
8456,72,65,0,7.11,101.27,776417,776489
8457,89,53,0,5.75,63.33,776488,776577
8458,106,23,0,4.83,23.80,776576,776682
8459,117,23,0,4.38,22.58,776682,776799
8460,110,18,0,4.65,23.12,776798,776908
8461,109,27,0,4.70,27.22,776907,777016
8462,87,20,0,5.89,33.14,777015,777102
8463,80,41,0,6.40,57.57,777101,777181
8464,95,27,0,5.39,34.07,777180,777275
8465,114,26,0,4.49,25.55,777274,777388
8466,77,98,0,6.65,133.50,777387,777464
8467,89,34,0,5.75,37.44,777463,777552
8468,99,22,0,5.17,34.18,777551,777650
8469,94,30,0,5.45,41.08,777649,777743
8470,106,19,0,4.83,23.05,777742,777848
8471,91,29,0,5.63,42.12,777847,777938
8472,75,25,0,6.83,37.50,777937,778012
8473,86,32,0,5.95,34.90,778012,778098
8474,106,40,0,4.83,38.97,778097,778203
8475,88,21,0,5.82,34.33,778202,778290
8476,77,61,0,6.65,70.28,778289,778366
8477,87,25,0,5.89,34.86,778365,778452
8478,96,24,0,5.33,37.60,778451,778547
8479,122,22,0,4.20,21.08,778546,778668
8480,103,21,0,4.97,27.99,778667,778770
8481,91,24,0,5.63,30.92,778769,778860
8482,86,44,0,5.95,55.79,778859,778945
8483,94,24,0,5.45,36.40,778944,779038
8484,83,21,0,6.17,37.92,779037,779120
8485,89,38,0,5.75,40.95,779119,779208
8486,105,42,0,4.88,34.81,779207,779312
8487,73,29,0,7.01,44.04,779311,779384
8488,125,20,0,4.10,24.71,779383,779508
8489,89,27,0,5.75,35.83,779507,779596
8490,78,24,0,6.56,40.12,779596,779674
8491,106,19,0,4.83,24.99,779673,779779
8492,69,86,0,7.42,121.78,779779,779848
8493,108,21,0,4.74,23.36,779847,779955
8494,116,19,0,4.41,24.59,779954,780070
8495,99,20,0,5.17,27.27,780069,780168
8496,104,26,0,4.92,33.01,780167,780271
8497,105,20,0,4.88,24.78,780270,780375
8498,94,36,0,5.45,40.65,780375,780469
8499,96,36,0,5.33,34.99,780468,780564
8500,92,20,0,5.57,25.01,780563,780655
8501,104,20,0,4.92,29.19,780654,780758
8502,99,25,0,5.17,34.93,780757,780856
8503,66,36,0,7.76,48.43,780855,780921
8504,78,23,0,6.56,39.25,780920,780998
8505,85,23,0,6.02,41.74,780997,781082
8506,98,43,0,5.22,52.01,781081,781179
8507,79,27,0,6.48,41.62,781178,781257
8508,62,193,0,8.26,588.19,781256,781318
8509,101,23,0,5.07,32.94,781317,781418
8510,104,38,0,4.92,31.30,781417,781521
8511,91,20,0,5.63,33.60,781520,781611
8512,90,69,0,5.69,72.81,781610,781700
8513,67,54,0,7.64,88.80,781699,781766
8514,106,20,0,4.83,29.25,781765,781871
8515,83,27,0,6.17,46.02,781870,781953
8516,92,26,0,5.57,27.20,781953,782045
8517,105,27,0,4.88,27.37,782044,782149
8518,96,25,0,5.33,28.49,782148,782244
8519,110,23,0,4.65,26.04,782243,782353
8520,85,69,0,6.02,77.32,782352,782437
8521,86,48,0,5.95,54.02,782436,782522
8522,86,26,0,5.95,34.81,782521,782607
8523,79,33,0,6.48,39.97,782606,782685
8524,93,33,0,5.51,37.78,782684,782777
8525,104,24,0,4.92,27.17,782776,782880
8526,95,19,0,5.39,23.80,782880,782975
8527,77,46,0,6.65,50.51,782974,783051
8528,77,40,0,6.65,51.06,783050,783127
8529,91,21,0,5.63,28.48,783126,783217
8530,107,19,0,4.79,27.63,783217,783324
8531,101,20,0,5.07,30.52,783323,783424
8532,88,43,0,5.82,40.54,783423,783511
8533,106,27,0,4.83,26.93,783510,783616
8534,58,53,0,8.83,96.04,783615,783673
8535,93,25,0,5.51,32.34,783672,783765
8536,91,22,0,5.63,35.57,783764,783855
8537,100,23,0,5.12,30.91,783854,783954
8538,94,24,0,5.45,36.93,783953,784047
8539,92,20,0,5.57,30.51,784046,784138
8540,76,28,0,6.74,42.59,784137,784213
8541,104,25,0,4.92,31.44,784212,784316
8542,93,41,0,5.51,48.36,784315,784408
8543,70,25,0,7.31,44.36,784407,784477
8544,97,21,0,5.28,30.10,784476,784573
8545,109,27,0,4.70,31.61,784572,784681
8546,97,27,0,5.28,29.36,784680,784777
8547,89,23,0,5.75,38.28,784776,784865
8548,90,30,0,5.69,36.10,784864,784954
8549,99,21,0,5.17,29.80,784953,785052
8550,100,20,0,5.12,28.63,785051,785151
8551,93,26,0,5.51,37.13,785150,785243
8552,91,61,0,5.63,62.04,785242,785333
8553,86,31,0,5.95,40.04,785332,785418
8554,101,19,0,5.07,27.79,785417,785518
8555,122,19,0,4.20,21.08,785517,785639
8556,95,22,0,5.39,37.29,785639,785734
8557,61,33,0,8.39,60.44,785734,785795
8558,97,42,0,5.28,45.38,785794,785891
8559,90,24,0,5.69,40.04,785890,785980
8560,99,21,0,5.17,26.67,785979,786078
8561,111,18,0,4.61,21.64,786077,786188
8562,91,27,0,5.63,35.86,786187,786278
8563,104,31,0,4.92,30.17,786277,786381
8564,96,23,0,5.33,34.28,786380,786476
8565,100,21,0,5.12,34.19,786475,786575
8566,78,71,0,6.56,88.45,786574,786652
8567,86,30,0,5.95,41.14,786652,786738
8568,78,31,0,6.56,49.73,786738,786816
8569,108,24,0,4.74,25.23,786815,786923
8570,76,65,0,6.74,76.98,786922,786998
8571,95,24,0,5.39,33.69,786997,787092
8572,83,39,0,6.17,47.54,787091,787174
8573,84,27,0,6.10,37.78,787173,787257
8574,92,24,0,5.57,38.83,787256,787348
8575,97,26,0,5.28,24.72,787347,787444
8576,103,19,0,4.97,31.04,787443,787546
8577,96,20,0,5.33,32.20,787545,787641
8578,100,31,0,5.12,33.21,787640,787740
8579,78,22,0,6.56,43.45,787739,787817
8580,106,21,0,4.83,26.73,787816,787922
8581,97,38,0,5.28,47.33,787922,788019
8582,77,27,0,6.65,42.51,788018,788095
8583,107,20,0,4.79,27.74,788094,788201
8584,93,22,0,5.51,33.63,788200,788293
8585,83,57,0,6.17,64.07,788292,788375
8586,97,26,0,5.28,37.40,788374,788471
8587,100,24,0,5.12,27.01,788470,788570
8588,96,42,0,5.33,39.45,788569,788665
8589,107,20,0,4.79,24.30,788664,788771
8590,104,23,0,4.92,31.90,788770,788874
8591,80,33,0,6.40,49.52,788873,788953
8592,84,20,0,6.10,31.63,788952,789036
8593,102,22,0,5.02,32.04,789035,789137
8594,97,22,0,5.28,28.70,789136,789233
8595,112,37,0,4.57,32.83,789232,789344
8596,89,38,0,5.75,47.44,789343,789432
8597,104,26,0,4.92,27.61,789431,789535
8598,114,21,0,4.49,23.02,789534,789648
8599,105,35,0,4.88,30.70,789647,789752
8600,97,23,0,5.28,31.79,789751,789848
8601,71,52,0,7.21,64.36,789847,789918
8602,87,23,0,5.89,30.98,789917,790004
8603,90,26,0,5.69,39.84,790003,790093
8604,88,19,0,5.82,27.49,790092,790180
8605,91,24,0,5.63,37.82,790180,790271
8606,87,28,0,5.89,38.10,790270,790357
8607,96,26,0,5.33,27.74,790356,790452
8608,78,29,0,6.56,38.66,790451,790529
8609,80,26,0,6.40,43.42,790529,790609
8610,96,22,0,5.33,32.03,790608,790704
8611,104,20,0,4.92,31.90,790703,790807
8612,84,20,0,6.10,32.75,790806,790890
8613,83,24,0,6.17,37.13,790889,790972
8614,88,96,0,5.82,127.63,790971,791059
8615,91,19,0,5.63,28.01,791058,791149
8616,93,49,0,5.51,48.21,791149,791242
8617,106,25,0,4.83,30.35,791241,791347
8618,95,30,0,5.39,34.34,791347,791442
8619,94,22,0,5.45,27.55,791441,791535
8620,116,20,0,4.41,24.50,791535,791651
8621,86,45,0,5.95,43.18,791650,791736
8622,105,34,0,4.88,30.28,791735,791840
8623,94,20,0,5.45,29.59,791839,791933
8624,103,21,0,4.97,30.40,791932,792035
8625,100,20,0,5.12,27.23,792034,792134
8626,93,19,0,5.51,32.12,792133,792226
8627,88,29,0,5.82,33.24,792225,792313
8628,82,34,0,6.24,53.04,792312,792394
8629,84,20,0,6.10,36.54,792393,792477
8630,106,21,0,4.83,22.63,792476,792582
8631,106,43,0,4.83,36.76,792581,792687
8632,95,28,0,5.39,32.68,792686,792781
8633,86,22,0,5.95,34.84,792780,792866
8634,89,26,0,5.75,35.83,792865,792954
8635,101,21,0,5.07,30.70,792953,793054
8636,98,42,0,5.22,42.21,793053,793151
8637,112,22,0,4.57,28.35,793150,793262
8638,95,29,0,5.39,28.87,793261,793356
8639,93,30,0,5.51,35.43,793355,793448
8640,90,35,0,5.69,33.33,793448,793538
8641,93,21,0,5.51,28.87,793537,793630
8642,109,29,0,4.70,26.82,793630,793739
8643,116,22,0,4.41,25.14,793738,793854
8644,95,20,0,5.39,31.69,793853,793948
8645,99,32,0,5.17,35.01,793948,794047
8646,85,21,0,6.02,32.54,794046,794131
8647,83,74,0,6.17,86.09,794131,794214
8648,106,20,0,4.83,25.86,794214,794320
8649,64,36,0,8.00,49.38,794319,794383
8650,104,24,0,4.92,29.28,794382,794486
8651,98,19,0,5.22,23.70,794485,794583
8652,99,19,0,5.17,22.95,794582,794681
8653,101,48,0,5.07,52.08,794680,794781
8654,106,38,0,4.83,34.54,794780,794886
8655,63,20,0,8.13,35.76,794885,794948
8656,94,22,0,5.45,36.08,794947,795041
8657,114,21,0,4.49,30.14,795040,795154
8658,92,46,0,5.57,49.20,795153,795245
8659,95,33,0,5.39,37.33,795244,795339
8660,103,19,0,4.97,24.34,795338,795441
8661,99,22,0,5.17,30.95,795440,795539
8662,108,21,0,4.74,28.40,795538,795646
8663,96,31,0,5.33,39.24,795645,795741
8664,86,26,0,5.95,41.93,795740,795826
8665,89,20,0,5.75,33.78,795825,795914
8666,84,24,0,6.10,38.56,795913,795997
8667,94,34,0,5.45,43.82,795996,796090
8668,100,23,0,5.12,26.61,796089,796189
8669,63,39,0,8.13,50.87,796188,796251
8670,96,46,0,5.33,47.22,796250,796346
8671,118,25,0,4.34,25.22,796345,796463
8672,92,29,0,5.57,42.66,796463,796555
8673,92,35,0,5.57,39.77,796554,796646
8674,87,21,0,5.89,24.95,796645,796732
8675,85,39,0,6.02,48.71,796731,796816
8676,86,27,0,5.95,39.02,796816,796902
8677,83,76,0,6.17,121.51,796901,796984
8678,101,21,0,5.07,28.82,796983,797084
8679,55,54,0,9.31,88.69,797083,797138
8680,79,57,0,6.48,62.40,797137,797216
8681,99,41,0,5.17,49.62,797215,797314
8682,99,36,0,5.17,33.80,797314,797413
8683,107,19,0,4.79,25.05,797412,797519
8684,77,26,0,6.65,41.79,797518,797595
8685,70,24,0,7.31,35.44,797594,797664
8686,95,36,0,5.39,36.45,797663,797758
8687,103,19,0,4.97,23.58,797758,797861
8688,93,22,0,5.51,32.03,797861,797954
8689,98,22,0,5.22,31.62,797953,798051
8690,94,28,0,5.45,40.67,798050,798144
8691,113,34,0,4.53,35.15,798144,798257
8692,107,22,0,4.79,27.16,798256,798363
8693,99,21,0,5.17,31.48,798362,798461
8694,69,68,0,7.42,92.27,798460,798529
8695,92,27,0,5.57,38.05,798528,798620
8696,110,25,0,4.65,23.41,798620,798730
8697,117,19,0,4.38,23.28,798729,798846
8698,82,21,0,6.24,37.48,798845,798927
8699,108,22,0,4.74,26.64,798926,799034
8700,103,26,0,4.97,35.56,799033,799136
8701,97,69,0,5.28,68.82,799135,799232
8702,89,36,0,5.75,42.93,799231,799320
8703,118,19,0,4.34,25.77,799319,799437
8704,75,23,0,6.83,40.30,799436,799511
8705,79,36,0,6.48,46.25,799510,799589
8706,86,27,0,5.95,36.02,799588,799674
8707,92,21,0,5.57,27.83,799674,799766
8708,82,38,0,6.24,51.65,799766,799848
8709,79,46,0,6.48,61.21,799848,799927
8710,98,29,0,5.22,32.62,799926,800024
8711,99,31,0,5.17,31.19,800023,800122
8712,98,26,0,5.22,34.03,800121,800219
8713,108,22,0,4.74,26.32,800218,800326
8714,84,28,0,6.10,32.92,800326,800410
8715,107,33,0,4.79,30.94,800409,800516
8716,116,21,0,4.41,20.93,800516,800632
8717,93,26,0,5.51,27.65,800631,800724
8718,105,45,0,4.88,44.39,800724,800829
8719,105,36,0,4.88,32.17,800829,800934
8720,64,33,0,8.00,54.31,800933,800997
8721,100,20,0,5.12,24.27,800996,801096
8722,108,37,0,4.74,32.56,801095,801203
8723,112,24,0,4.57,27.01,801202,801314
8724,71,24,0,7.21,49.66,801313,801384
8725,90,46,0,5.69,48.77,801383,801473
8726,83,21,0,6.17,35.63,801472,801555
8727,101,27,0,5.07,27.29,801554,801655
8728,94,20,0,5.45,28.65,801654,801748
8729,91,29,0,5.63,31.82,801747,801838
8730,89,22,0,5.75,36.12,801837,801926
8731,83,69,0,6.17,75.95,801925,802008
8732,99,22,0,5.17,30.93,802007,802106
8733,66,23,0,7.76,45.91,802105,802171
8734,95,22,0,5.39,25.50,802170,802265
8735,80,47,0,6.40,56.29,802264,802344
8736,119,19,0,4.30,25.67,802343,802462
8737,100,27,0,5.12,28.37,802462,802562
8738,95,57,0,5.39,58.49,802561,802656
8739,105,17,0,4.88,24.43,802655,802760
8740,97,25,0,5.28,35.11,802760,802857
8741,99,21,0,5.17,30.97,802856,802955
8742,87,33,0,5.89,41.04,802954,803041
8743,90,22,0,5.69,34.84,803041,803131
8744,88,24,0,5.82,35.35,803130,803218
8745,106,20,0,4.83,24.01,803217,803323
8746,105,31,0,4.88,30.05,803322,803427
8747,103,24,0,4.97,25.89,803426,803529
8748,87,37,0,5.89,41.53,803528,803615
8749,90,58,0,5.69,73.53,803614,803704
8750,70,21,0,7.31,41.19,803703,803773
8751,96,31,0,5.33,33.91,803772,803868
8752,97,20,0,5.28,32.88,803868,803965
8753,108,23,0,4.74,24.43,803964,804072
8754,96,40,0,5.33,42.64,804071,804167
8755,89,35,0,5.75,40.19,804166,804255
8756,78,88,0,6.56,119.40,804254,804332
8757,101,27,0,5.07,29.61,804331,804432
8758,84,22,0,6.10,34.80,804431,804515
8759,101,28,0,5.07,34.80,804514,804615
8760,95,22,0,5.39,32.64,804614,804709
8761,76,31,0,6.74,36.80,804708,804784
8762,89,33,0,5.75,37.89,804783,804872
8763,102,26,0,5.02,27.06,804871,804973
8764,103,20,0,4.97,26.13,804972,805075
8765,91,33,0,5.63,41.86,805074,805165
8766,102,20,0,5.02,26.20,805164,805266
8767,89,35,0,5.75,50.57,805266,805355
8768,99,37,0,5.17,38.00,805354,805453
8769,96,29,0,5.33,25.62,805452,805548
8770,84,34,0,6.10,41.28,805547,805631
8771,95,20,0,5.39,31.12,805630,805725
8772,98,20,0,5.22,28.21,805724,805822
8773,78,59,0,6.56,72.07,805821,805899
8774,96,28,0,5.33,39.41,805898,805994
8775,96,24,0,5.33,33.81,805993,806089
8776,104,21,0,4.92,28.17,806088,806192
8777,87,31,0,5.89,37.69,806191,806278
8778,95,30,0,5.39,33.65,806277,806372
8779,112,30,0,4.57,26.14,806372,806484
8780,91,24,0,5.63,35.93,806483,806574
8781,115,21,0,4.45,24.39,806573,806688
8782,91,26,0,5.63,31.07,806687,806778
8783,87,30,0,5.89,43.39,806777,806864
8784,89,20,0,5.75,30.82,806863,806952
8785,101,25,0,5.07,29.15,806952,807053
8786,105,20,0,4.88,28.70,807052,807157
8787,94,20,0,5.45,32.20,807156,807250
8788,115,17,0,4.45,20.51,807250,807365
8789,79,23,0,6.48,39.26,807365,807444
8790,102,22,0,5.02,29.25,807443,807545
8791,96,21,0,5.33,34.95,807544,807640
8792,78,38,0,6.56,50.19,807639,807717
8793,82,29,0,6.24,44.92,807717,807799
8794,93,21,0,5.51,30.90,807798,807891
8795,87,33,0,5.89,42.68,807890,807977
8796,59,38,0,8.68,62.22,807976,808035
8797,108,20,0,4.74,22.88,808034,808142
8798,100,34,0,5.12,35.91,808141,808241
8799,91,36,0,5.63,44.72,808240,808331
8800,94,47,0,5.45,44.12,808330,808424
8801,97,23,0,5.28,28.49,808423,808520
8802,88,26,0,5.82,35.56,808519,808607
8803,38,224,0,13.47,1228.25,808606,808644
8804,90,53,0,5.69,55.10,808643,808733
8805,94,37,0,5.45,39.78,808732,808826
8806,107,21,0,4.79,22.79,808825,808932
8807,93,19,0,5.51,25.26,808931,809024
8808,105,33,0,4.88,35.59,809023,809128
8809,87,26,0,5.89,37.50,809128,809215
8810,67,32,0,7.64,46.77,809215,809282
8811,83,26,0,6.17,41.63,809281,809364
8812,93,25,0,5.51,35.33,809363,809456
8813,94,22,0,5.45,23.01,809455,809549
8814,87,27,0,5.89,39.09,809548,809635
8815,94,79,0,5.45,79.03,809634,809728
8816,91,26,0,5.63,33.90,809727,809818
8817,111,23,0,4.61,28.00,809817,809928
8818,98,26,0,5.22,29.73,809927,810025
8819,94,64,0,5.45,59.40,810024,810118
8820,106,24,0,4.83,28.82,810117,810223
8821,110,25,0,4.65,25.55,810222,810332
8822,77,23,0,6.65,36.75,810331,810408
8823,81,47,0,6.32,69.28,810408,810489
8824,101,26,0,5.07,30.90,810488,810589
8825,89,21,0,5.75,30.10,810589,810678
8826,103,55,0,4.97,58.09,810677,810780
8827,87,29,0,5.89,39.48,810779,810866
8828,104,28,0,4.92,33.09,810865,810969
8829,82,34,0,6.24,41.94,810968,811050
8830,76,32,0,6.74,54.54,811049,811125
8831,96,24,0,5.33,33.24,811124,811220
8832,96,38,0,5.33,44.83,811219,811315
8833,86,21,0,5.95,35.46,811314,811400
8834,97,27,0,5.28,33.69,811400,811497
8835,129,20,0,3.97,23.94,811496,811625
8836,98,28,0,5.22,31.34,811624,811722
8837,109,19,0,4.70,24.14,811722,811831
8838,83,40,0,6.17,47.37,811830,811913
8839,109,19,0,4.70,24.54,811912,812021
8840,89,28,0,5.75,36.34,812020,812109
8841,88,25,0,5.82,39.38,812108,812196
8842,94,24,0,5.45,31.01,812195,812289
8843,95,18,0,5.39,26.76,812288,812383
8844,80,23,0,6.40,43.34,812382,812462
8845,98,22,0,5.22,26.38,812461,812559
8846,76,60,0,6.74,93.04,812558,812634
8847,92,25,0,5.57,25.40,812634,812726
8848,97,18,0,5.28,23.60,812725,812822
8849,78,25,0,6.56,43.25,812822,812900
8850,106,28,0,4.83,37.74,812900,813006
8851,112,20,0,4.57,23.14,813005,813117
8852,95,26,0,5.39,28.47,813116,813211
8853,96,20,0,5.33,30.03,813210,813306
8854,86,52,0,5.95,56.56,813305,813391
8855,89,42,0,5.75,39.06,813390,813479
8856,101,23,0,5.07,30.06,813478,813579
8857,78,33,0,6.56,39.45,813578,813656
8858,96,22,0,5.33,28.85,813656,813752
8859,102,23,0,5.02,30.98,813751,813853
8860,107,23,0,4.79,27.94,813852,813959
8861,79,24,0,6.48,42.40,813958,814037
8862,101,22,0,5.07,29.49,814036,814137
8863,98,25,0,5.22,28.38,814136,814234
8864,101,25,0,5.07,37.97,814234,814335
8865,98,25,0,5.22,33.97,814334,814432
8866,95,30,0,5.39,35.02,814431,814526
8867,94,42,0,5.45,45.95,814525,814619
8868,88,26,0,5.82,38.15,814618,814706
8869,80,22,0,6.40,45.04,814706,814786
8870,77,70,0,6.65,85.32,814786,814863
8871,98,46,0,5.22,38.52,814862,814960
8872,88,43,0,5.82,41.51,814959,815047
8873,97,30,0,5.28,37.89,815046,815143
8874,91,19,0,5.63,28.50,815142,815233
8875,90,29,0,5.69,35.70,815232,815322
8876,105,20,0,4.88,27.56,815321,815426
8877,82,25,0,6.24,34.01,815426,815508
8878,105,20,0,4.88,26.70,815507,815612
8879,95,22,0,5.39,30.62,815611,815706
8880,96,23,0,5.33,28.31,815705,815801
8881,99,22,0,5.17,33.80,815800,815899
8882,55,47,0,9.31,87.16,815899,815954
8883,120,19,0,4.27,23.91,815953,816073
8884,111,23,0,4.61,27.08,816073,816184
8885,96,20,0,5.33,26.68,816183,816279
8886,97,22,0,5.28,30.53,816279,816376
8887,104,18,0,4.92,22.84,816375,816479
8888,104,25,0,4.92,28.61,816478,816582
8889,92,24,0,5.57,28.12,816581,816673
8890,95,21,0,5.39,32.41,816673,816768
8891,88,20,0,5.82,27.83,816768,816856
8892,85,21,0,6.02,40.66,816855,816940
8893,95,36,0,5.39,43.04,816939,817034
8894,111,20,0,4.61,21.71,817034,817145
8895,90,34,0,5.69,41.93,817144,817234
8896,86,31,0,5.95,37.79,817233,817319
8897,90,32,0,5.69,40.15,817318,817408
8898,88,28,0,5.82,43.67,817407,817495
8899,98,26,0,5.22,34.91,817494,817592
8900,73,28,0,7.01,42.95,817592,817665
8901,89,42,0,5.75,45.44,817664,817753
8902,110,23,0,4.65,26.86,817752,817862
8903,82,41,0,6.24,47.23,817861,817943
8904,82,24,0,6.24,34.82,817942,818024
8905,117,19,0,4.38,19.57,818023,818140
8906,109,26,0,4.70,30.03,818139,818248
8907,91,31,0,5.63,45.51,818247,818338
8908,78,35,0,6.56,53.45,818337,818415
8909,88,21,0,5.82,27.99,818414,818502
8910,71,145,0,7.21,297.80,818501,818572
8911,91,27,0,5.63,36.67,818571,818662
8912,88,20,0,5.82,26.24,818661,818749
8913,112,20,0,4.57,22.55,818748,818860
8914,90,31,0,5.69,36.39,818859,818949
8915,100,70,0,5.12,76.39,818948,819048
8916,105,35,0,4.88,38.91,819047,819152
8917,88,20,0,5.82,33.60,819151,819239
8918,101,45,0,5.07,38.68,819238,819339
8919,77,26,0,6.65,42.33,819338,819415
8920,80,22,0,6.40,37.41,819414,819494
8921,117,20,0,4.38,22.58,819493,819610
8922,99,22,0,5.17,30.18,819609,819708
8923,99,27,0,5.17,37.76,819707,819806
8924,101,20,0,5.07,27.33,819805,819906
8925,104,25,0,4.92,30.46,819905,820009
8926,99,42,0,5.17,47.39,820008,820107
8927,65,114,0,7.88,217.52,820106,820171
8928,93,31,0,5.51,34.03,820170,820263
8929,99,39,0,5.17,38.18,820262,820361
8930,98,20,0,5.22,35.79,820360,820458
8931,91,31,0,5.63,37.33,820457,820548
8932,100,28,0,5.12,32.71,820547,820647
8933,79,21,0,6.48,32.71,820646,820725
8934,87,29,0,5.89,38.58,820724,820811
8935,85,23,0,6.02,27.81,820810,820895
8936,108,19,0,4.74,25.06,820895,821003
8937,98,26,0,5.22,36.11,821002,821100
8938,81,22,0,6.32,40.61,821099,821180
8939,66,33,0,7.76,51.82,821179,821245
8940,85,24,0,6.02,41.65,821244,821329
8941,92,27,0,5.57,32.40,821328,821420
8942,109,34,0,4.70,32.36,821420,821529
8943,103,29,0,4.97,32.47,821528,821631
8944,103,19,0,4.97,24.22,821631,821734
8945,82,19,0,6.24,32.57,821733,821815
8946,106,22,0,4.83,28.67,821814,821920
8947,96,38,0,5.33,37.97,821919,822015
8948,92,21,0,5.57,37.42,822014,822106
8949,92,20,0,5.57,27.33,822105,822197
8950,94,93,0,5.45,115.08,822196,822290
8951,76,40,0,6.74,46.35,822289,822365
8952,94,20,0,5.45,29.20,822364,822458
8953,104,18,0,4.92,27.69,822458,822562
8954,110,21,0,4.65,29.77,822561,822671
8955,93,26,0,5.51,39.82,822670,822763
8956,82,39,0,6.24,48.94,822762,822844
8957,88,39,0,5.82,46.85,822843,822931
8958,86,28,0,5.95,41.81,822930,823016
8959,84,27,0,6.10,37.80,823016,823100
8960,106,20,0,4.83,30.05,823099,823205
8961,96,20,0,5.33,33.68,823204,823300
8962,104,23,0,4.92,28.78,823299,823403
8963,112,31,0,4.57,27.55,823402,823514
8964,90,21,0,5.69,34.39,823513,823603
8965,103,22,0,4.97,32.59,823602,823705
8966,101,22,0,5.07,28.50,823704,823805
8967,90,27,0,5.69,41.10,823804,823894
8968,99,24,0,5.17,31.56,823893,823992
8969,78,31,0,6.56,47.07,823992,824070
8970,80,95,0,6.40,141.89,824069,824149
8971,101,19,0,5.07,23.49,824148,824249
8972,103,21,0,4.97,23.87,824248,824351
8973,106,19,0,4.83,24.76,824350,824456
8974,112,20,0,4.57,26.98,824455,824567
8975,83,41,0,6.17,51.42,824566,824649
8976,99,20,0,5.17,33.23,824648,824747
8977,102,18,0,5.02,22.25,824746,824848
8978,107,20,0,4.79,31.70,824847,824954
8979,99,50,0,5.17,51.52,824953,825052
8980,75,49,0,6.83,68.06,825051,825126
8981,119,21,0,4.30,26.18,825126,825245
8982,67,57,0,7.64,77.27,825244,825311
8983,91,38,0,5.63,47.14,825311,825402
8984,92,21,0,5.57,37.46,825401,825493
8985,90,22,0,5.69,32.93,825492,825582
8986,85,120,0,6.02,178.40,825581,825666
8987,82,49,0,6.24,54.79,825666,825748
8988,98,21,0,5.22,28.28,825748,825846
8989,94,21,0,5.45,29.86,825845,825939
8990,96,23,0,5.33,30.93,825938,826034
8991,91,23,0,5.63,31.77,826033,826124
8992,83,22,0,6.17,33.35,826123,826206
8993,79,45,0,6.48,80.05,826205,826284
8994,116,26,0,4.41,26.71,826283,826399
8995,91,21,0,5.63,32.10,826398,826489
8996,98,24,0,5.22,27.56,826488,826586
8997,89,53,0,5.75,54.10,826586,826675
8998,96,28,0,5.33,31.78,826674,826770
8999,94,24,0,5.45,30.50,826769,826863
9000,98,25,0,5.22,36.03,826862,826960
9001,103,22,0,4.97,28.32,826959,827062
9002,85,20,0,6.02,31.81,827061,827146
9003,75,76,0,6.83,99.21,827145,827220
9004,89,20,0,5.75,33.38,827219,827308
9005,106,20,0,4.83,27.95,827307,827413
9006,108,23,0,4.74,32.73,827412,827520
9007,93,72,0,5.51,77.63,827519,827612
9008,99,30,0,5.17,33.54,827611,827710
9009,67,34,0,7.64,60.62,827709,827776
9010,77,98,0,6.65,142.98,827775,827852
9011,108,21,0,4.74,26.77,827851,827959
9012,92,19,0,5.57,32.81,827958,828050
9013,95,26,0,5.39,34.32,828049,828144
9014,88,24,0,5.82,36.44,828143,828231
9015,93,77,0,5.51,82.34,828230,828323
9016,92,19,0,5.57,25.79,828322,828414
9017,106,19,0,4.83,23.27,828413,828519
9018,106,19,0,4.83,27.93,828518,828624
9019,108,23,0,4.74,25.97,828623,828731
9020,83,32,0,6.17,35.92,828731,828814
9021,93,30,0,5.51,36.59,828813,828906
9022,104,29,0,4.92,29.94,828905,829009
9023,101,22,0,5.07,24.92,829008,829109
9024,99,27,0,5.17,28.49,829108,829207
9025,93,33,0,5.51,42.81,829206,829299
9026,76,46,0,6.74,55.14,829298,829374
9027,69,36,0,7.42,56.45,829373,829442
9028,103,19,0,4.97,26.26,829441,829544
9029,99,30,0,5.17,32.67,829543,829642
9030,94,23,0,5.45,28.97,829641,829735
9031,126,21,0,4.06,19.55,829734,829860
9032,91,25,0,5.63,37.66,829859,829950
9033,92,21,0,5.57,27.01,829949,830041
9034,88,19,0,5.82,25.83,830040,830128
9035,102,20,0,5.02,30.12,830127,830229
9036,103,20,0,4.97,24.49,830228,830331
9037,91,25,0,5.63,41.93,830330,830421
9038,108,23,0,4.74,29.47,830420,830528
9039,101,77,0,5.07,70.50,830527,830628
9040,66,50,0,7.76,55.40,830627,830693
9041,100,25,0,5.12,30.65,830692,830792
9042,97,21,0,5.28,35.07,830791,830888
9043,104,30,0,4.92,33.26,830887,830991
9044,93,19,0,5.51,24.72,830990,831083
9045,95,21,0,5.39,29.82,831082,831177
9046,83,20,0,6.17,32.77,831176,831259
9047,94,22,0,5.45,32.72,831258,831352
9048,94,22,0,5.45,32.76,831351,831445
9049,96,22,0,5.33,32.74,831444,831540
9050,102,52,0,5.02,51.49,831540,831642
9051,88,24,0,5.82,36.76,831641,831729
9052,73,32,0,7.01,50.07,831728,831801
9053,76,34,0,6.74,43.75,831800,831876
9054,102,20,0,5.02,25.20,831875,831977
9055,80,23,0,6.40,34.17,831976,832056
9056,93,20,0,5.51,34.51,832055,832148
9057,55,40,0,9.31,79.45,832148,832203
9058,82,20,0,6.24,36.26,832202,832284
9059,76,23,0,6.74,37.64,832283,832359
9060,81,24,0,6.32,29.55,832358,832439
9061,87,25,0,5.89,32.88,832439,832526
9062,89,51,0,5.75,58.70,832526,832615
9063,96,23,0,5.33,33.93,832615,832711
9064,95,22,0,5.39,30.20,832710,832805
9065,73,20,0,7.01,38.45,832804,832877
9066,80,26,0,6.40,36.87,832877,832957
9067,97,20,0,5.28,25.11,832956,833053
9068,105,25,0,4.88,26.66,833052,833157
9069,85,21,0,6.02,34.87,833156,833241
9070,109,45,0,4.70,39.33,833240,833349
9071,105,22,0,4.88,28.49,833349,833454
9072,112,26,0,4.57,28.91,833453,833565
9073,78,68,0,6.56,78.48,833565,833643
9074,84,20,0,6.10,30.23,833642,833726
9075,84,27,0,6.10,27.78,833725,833809
9076,103,20,0,4.97,25.06,833808,833911
9077,81,24,0,6.32,32.51,833910,833991
9078,87,31,0,5.89,42.84,833990,834077
9079,102,29,0,5.02,31.63,834076,834178
9080,90,49,0,5.69,55.48,834177,834267
9081,95,39,0,5.39,51.48,834266,834361
9082,75,22,0,6.83,37.29,834360,834435
9083,105,24,0,4.88,27.42,834434,834539
9084,98,26,0,5.22,32.89,834538,834636
9085,79,43,0,6.48,54.38,834636,834715
9086,80,55,0,6.40,63.62,834714,834794
9087,106,22,0,4.83,26.86,834793,834899
9088,99,22,0,5.17,33.86,834898,834997
9089,121,26,0,4.23,27.40,834996,835117
9090,79,31,0,6.48,36.83,835116,835195
9091,84,21,0,6.10,30.44,835195,835279
9092,80,46,0,6.40,48.24,835278,835358
9093,87,19,0,5.89,31.07,835357,835444
9094,75,58,0,6.83,78.09,835443,835518
9095,101,18,0,5.07,24.66,835517,835618
9096,88,59,0,5.82,70.31,835617,835705
9097,69,120,0,7.42,224.39,835704,835773
9098,88,38,0,5.82,47.10,835773,835861
9099,97,42,0,5.28,34.39,835860,835957
9100,91,23,0,5.63,26.23,835956,836047
9101,78,23,0,6.56,31.19,836046,836124
9102,99,26,0,5.17,28.81,836123,836222
9103,95,22,0,5.39,25.27,836221,836316
9104,110,24,0,4.65,25.95,836315,836425
9105,58,82,0,8.83,144.83,836424,836482
9106,98,30,0,5.22,40.73,836481,836579
9107,81,25,0,6.32,37.80,836578,836659
9108,69,46,0,7.42,57.35,836658,836727
9109,76,37,0,6.74,47.54,836726,836802
9110,99,21,0,5.17,28.06,836802,836901
9111,99,46,0,5.17,44.99,836900,836999
9112,93,27,0,5.51,40.19,836998,837091
9113,96,48,0,5.33,42.93,837090,837186
9114,91,21,0,5.63,30.96,837185,837276
9115,93,34,0,5.51,43.39,837275,837368
9116,105,27,0,4.88,34.93,837367,837472
9117,101,27,0,5.07,31.79,837471,837572
9118,65,22,0,7.88,45.77,837571,837636
9119,103,20,0,4.97,27.74,837635,837738
9120,91,32,0,5.63,37.18,837737,837828
9121,91,26,0,5.63,33.46,837827,837918
9122,77,36,0,6.65,51.19,837918,837995
9123,95,21,0,5.39,28.57,837994,838089
9124,70,29,0,7.31,44.56,838088,838158
9125,93,33,0,5.51,36.06,838157,838250
9126,59,225,0,8.68,828.59,838249,838308
9127,106,17,0,4.83,24.14,838307,838413
9128,105,43,0,4.88,34.93,838412,838517
9129,93,40,0,5.51,40.14,838516,838609
9130,68,23,0,7.53,43.96,838608,838676
9131,103,20,0,4.97,31.17,838675,838778
9132,104,35,0,4.92,32.78,838777,838881
9133,103,22,0,4.97,23.15,838880,838983
9134,97,23,0,5.28,29.40,838982,839079
9135,107,20,0,4.79,24.92,839078,839185
9136,111,20,0,4.61,25.19,839184,839295
9137,88,21,0,5.82,35.26,839294,839382
9138,73,24,0,7.01,46.53,839381,839454
9139,69,20,0,7.42,28.85,839453,839522
9140,111,20,0,4.61,26.40,839521,839632
9141,102,28,0,5.02,27.55,839631,839733
9142,100,45,0,5.12,40.87,839732,839832
9143,84,23,0,6.10,35.59,839832,839916
9144,106,20,0,4.83,25.01,839916,840022
9145,71,58,0,7.21,82.34,840021,840092
9146,103,33,0,4.97,35.81,840091,840194
9147,82,21,0,6.24,36.55,840194,840276
9148,95,20,0,5.39,28.01,840275,840370
9149,97,21,0,5.28,32.59,840369,840466
9150,99,21,0,5.17,26.12,840465,840564
9151,104,34,0,4.92,32.19,840563,840667
9152,92,21,0,5.57,30.20,840666,840758
9153,83,62,0,6.17,68.72,840757,840840
9154,98,25,0,5.22,33.99,840839,840937
9155,104,20,0,4.92,29.61,840936,841040
9156,94,25,0,5.45,35.08,841039,841133
9157,106,19,0,4.83,28.90,841132,841238
9158,116,30,0,4.41,26.97,841237,841353
9159,99,20,0,5.17,29.37,841352,841451
9160,88,20,0,5.82,32.26,841451,841539
9161,75,55,0,6.83,69.42,841538,841613
9162,115,29,0,4.45,29.59,841612,841727
9163,107,22,0,4.79,23.94,841726,841833
9164,103,20,0,4.97,30.98,841832,841935
9165,92,27,0,5.57,31.70,841934,842026
9166,94,22,0,5.45,30.65,842025,842119
9167,93,29,0,5.51,42.42,842118,842211
9168,117,21,0,4.38,25.38,842210,842327
9169,102,42,0,5.02,48.35,842326,842428
9170,110,16,0,4.65,22.84,842427,842537
9171,96,22,0,5.33,28.35,842537,842633
9172,111,21,0,4.61,23.59,842632,842743
9173,113,23,0,4.53,26.39,842742,842855
9174,92,20,0,5.57,27.16,842854,842946
9175,94,29,0,5.45,39.25,842945,843039
9176,88,27,0,5.82,40.49,843038,843126
9177,82,19,0,6.24,32.21,843125,843207
9178,83,34,0,6.17,41.85,843206,843289
9179,96,33,0,5.33,34.03,843288,843384
9180,76,170,0,6.74,372.85,843383,843459
9181,116,20,0,4.41,21.14,843458,843574
9182,97,20,0,5.28,27.48,843574,843671
9183,107,23,0,4.79,33.91,843670,843777
9184,94,28,0,5.45,33.82,843776,843870
9185,89,57,0,5.75,59.11,843869,843958
9186,104,21,0,4.92,21.96,843957,844061
9187,88,22,0,5.82,31.35,844060,844148
9188,108,20,0,4.74,25.32,844147,844255
9189,104,31,0,4.92,34.61,844254,844358
9190,108,19,0,4.74,21.73,844357,844465
9191,89,33,0,5.75,43.40,844464,844553
9192,106,20,0,4.83,27.50,844552,844658
9193,89,28,0,5.75,36.39,844657,844746
9194,88,59,0,5.82,72.99,844745,844833
9195,98,18,0,5.22,22.95,844833,844931
9196,78,23,0,6.56,30.45,844930,845008
9197,96,27,0,5.33,35.31,845008,845104
9198,81,90,0,6.32,114.76,845103,845184
9199,89,50,0,5.75,53.98,845183,845272
9200,92,23,0,5.57,33.57,845271,845363
9201,110,34,0,4.65,34.01,845362,845472
9202,112,31,0,4.57,31.17,845471,845583
9203,66,29,0,7.76,39.46,845582,845648
9204,87,19,0,5.89,35.87,845647,845734
9205,93,24,0,5.51,30.12,845734,845827
9206,79,61,0,6.48,81.14,845826,845905
9207,95,24,0,5.39,31.12,845904,845999
9208,70,28,0,7.31,47.47,845998,846068
9209,90,20,0,5.69,34.41,846067,846157
9210,111,40,0,4.61,34.81,846156,846267
9211,89,25,0,5.75,37.02,846267,846356
9212,103,24,0,4.97,28.73,846355,846458
9213,102,45,0,5.02,37.02,846457,846559
9214,85,28,0,6.02,38.05,846558,846643
9215,91,23,0,5.63,34.37,846642,846733
9216,99,24,0,5.17,24.04,846732,846831
9217,97,42,0,5.28,49.21,846830,846927
9218,65,73,0,7.88,145.12,846926,846991
9219,74,32,0,6.92,52.53,846990,847064
9220,108,22,0,4.74,32.45,847064,847172
9221,96,22,0,5.33,29.43,847171,847267
9222,93,36,0,5.51,34.40,847266,847359
9223,97,41,0,5.28,42.68,847358,847455
9224,92,21,0,5.57,34.77,847455,847547
9225,92,29,0,5.57,40.44,847547,847639
9226,73,21,0,7.01,35.99,847638,847711
9227,98,22,0,5.22,29.64,847710,847808
9228,99,27,0,5.17,27.19,847808,847907
9229,102,22,0,5.02,29.33,847906,848008
9230,99,20,0,5.17,27.58,848008,848107
9231,105,28,0,4.88,30.53,848106,848211
9232,97,30,0,5.28,31.66,848210,848307
9233,95,20,0,5.39,32.47,848306,848401
9234,102,24,0,5.02,33.69,848400,848502
9235,83,23,0,6.17,30.28,848501,848584
9236,84,85,0,6.10,113.13,848583,848667
9237,96,43,0,5.33,42.99,848666,848762
9238,103,29,0,4.97,33.87,848762,848865
9239,89,22,0,5.75,30.57,848865,848954
9240,71,41,0,7.21,57.21,848954,849025
9241,102,32,0,5.02,39.16,849024,849126
9242,106,20,0,4.83,24.80,849125,849231
9243,99,20,0,5.17,30.12,849230,849329
9244,109,28,0,4.70,33.73,849328,849437
9245,109,22,0,4.70,26.89,849437,849546
9246,95,48,0,5.39,47.63,849545,849640
9247,102,25,0,5.02,33.96,849639,849741
9248,112,20,0,4.57,26.21,849741,849853
9249,70,68,0,7.31,104.33,849852,849922
9250,109,28,0,4.70,27.62,849921,850030
9251,102,26,0,5.02,26.53,850029,850131
9252,85,24,0,6.02,38.28,850130,850215
9253,89,35,0,5.75,35.89,850214,850303
9254,104,24,0,4.92,37.19,850303,850407
9255,100,23,0,5.12,26.27,850406,850506
9256,63,49,0,8.13,94.59,850505,850568
9257,58,127,0,8.83,287.14,850567,850625
9258,99,21,0,5.17,34.28,850624,850723
9259,91,33,0,5.63,38.98,850722,850813
9260,90,21,0,5.69,35.88,850812,850902
9261,99,29,0,5.17,35.78,850901,851000
9262,84,22,0,6.10,32.85,851000,851084
9263,87,23,0,5.89,36.72,851083,851170
9264,104,32,0,4.92,31.19,851169,851273
9265,90,21,0,5.69,29.33,851272,851362
9266,96,25,0,5.33,30.81,851361,851457
9267,90,27,0,5.69,42.37,851457,851547
9268,94,21,0,5.45,28.59,851546,851640
9269,107,27,0,4.79,39.57,851639,851746
9270,63,61,0,8.13,94.27,851745,851808
9271,87,20,0,5.89,36.10,851808,851895
9272,95,34,0,5.39,38.66,851894,851989
9273,86,31,0,5.95,39.65,851988,852074
9274,72,23,0,7.11,41.68,852073,852145
9275,94,22,0,5.45,33.59,852144,852238
9276,95,19,0,5.39,32.41,852237,852332
9277,103,20,0,4.97,28.92,852331,852434
9278,107,20,0,4.79,29.85,852433,852540
9279,64,23,0,8.00,38.16,852539,852603
9280,81,25,0,6.32,32.29,852602,852683
9281,65,107,0,7.88,191.12,852682,852747
9282,102,30,0,5.02,33.12,852747,852849
9283,90,25,0,5.69,32.73,852848,852938
9284,95,22,0,5.39,26.39,852937,853032
9285,95,24,0,5.39,29.06,853031,853126
9286,91,34,0,5.63,45.05,853125,853216
9287,102,24,0,5.02,38.61,853216,853318
9288,73,27,0,7.01,43.60,853317,853390
9289,100,30,0,5.12,31.19,853389,853489
9290,99,42,0,5.17,40.34,853488,853587
9291,92,24,0,5.57,29.68,853586,853678
9292,90,21,0,5.69,27.01,853677,853767
9293,109,25,0,4.70,26.74,853766,853875
9294,91,21,0,5.63,23.57,853874,853965
9295,99,23,0,5.17,31.01,853964,854063
9296,72,61,0,7.11,114.29,854062,854134
9297,91,36,0,5.63,41.93,854133,854224
9298,79,70,0,6.48,85.14,854223,854302
9299,96,26,0,5.33,31.66,854301,854397
9300,108,27,0,4.74,28.88,854397,854505
9301,72,28,0,7.11,49.54,854504,854576
9302,116,20,0,4.41,24.81,854575,854691
9303,86,27,0,5.95,29.09,854690,854776
9304,105,21,0,4.88,27.33,854775,854880
9305,86,21,0,5.95,34.44,854879,854965
9306,96,21,0,5.33,23.81,854964,855060
9307,93,32,0,5.51,37.37,855059,855152
9308,89,55,0,5.75,55.65,855151,855240
9309,87,34,0,5.89,40.17,855239,855326
9310,63,29,0,8.13,45.73,855325,855388
9311,82,43,0,6.24,51.50,855387,855469
9312,78,20,0,6.56,33.30,855468,855546
9313,99,32,0,5.17,35.84,855545,855644
9314,87,22,0,5.89,31.87,855643,855730
9315,82,48,0,6.24,43.18,855729,855811
9316,83,20,0,6.17,36.36,855810,855893
9317,78,40,0,6.56,59.81,855892,855970
9318,67,184,0,7.64,501.57,855969,856036
9319,95,21,0,5.39,26.85,856035,856130
9320,111,19,0,4.61,24.56,856129,856240
9321,100,20,0,5.12,30.65,856239,856339
9322,93,36,0,5.51,44.85,856338,856431
9323,104,20,0,4.92,30.82,856430,856534
9324,87,25,0,5.89,37.50,856533,856620
9325,80,37,0,6.40,48.17,856619,856699
9326,87,31,0,5.89,41.71,856699,856786
9327,91,49,0,5.63,51.64,856786,856877
9328,87,32,0,5.89,46.15,856876,856963
9329,90,23,0,5.69,35.21,856962,857052
9330,92,24,0,5.57,34.64,857051,857143
9331,89,20,0,5.75,36.05,857142,857231
9332,91,29,0,5.63,39.86,857230,857321
9333,88,22,0,5.82,33.56,857320,857408
9334,79,116,0,6.48,187.79,857407,857486
9335,70,21,0,7.31,42.76,857485,857555
9336,99,23,0,5.17,27.25,857554,857653
9337,103,25,0,4.97,33.08,857652,857755
9338,97,20,0,5.28,29.91,857754,857851
9339,117,28,0,4.38,25.82,857850,857967
9340,101,41,0,5.07,39.13,857966,858067
9341,97,40,0,5.28,47.83,858066,858163
9342,89,48,0,5.75,50.91,858162,858251
9343,112,21,0,4.57,25.05,858250,858362
9344,89,33,0,5.75,37.44,858361,858450
9345,99,21,0,5.17,31.23,858449,858548
9346,105,20,0,4.88,24.87,858547,858652
9347,81,46,0,6.32,50.24,858651,858732
9348,91,24,0,5.63,33.25,858731,858822
9349,93,26,0,5.51,31.35,858821,858914
9350,84,33,0,6.10,38.66,858913,858997
9351,79,39,0,6.48,53.62,858996,859075
9352,69,20,0,7.42,40.82,859074,859143
9353,79,20,0,6.48,29.19,859142,859221
9354,84,29,0,6.10,38.16,859220,859304
9355,79,26,0,6.48,30.83,859303,859382
9356,97,25,0,5.28,27.05,859382,859479
9357,78,35,0,6.56,51.58,859479,859557
9358,91,27,0,5.63,36.26,859556,859647
9359,91,27,0,5.63,31.09,859646,859737
9360,97,34,0,5.28,29.62,859737,859834
9361,87,26,0,5.89,29.27,859833,859920
9362,102,29,0,5.02,33.14,859919,860021
9363,87,80,0,5.89,89.83,860020,860107
9364,96,27,0,5.33,32.53,860107,860203
9365,86,49,0,5.95,43.65,860202,860288
9366,107,40,0,4.79,31.46,860287,860394
9367,96,25,0,5.33,34.53,860393,860489
9368,91,34,0,5.63,33.35,860488,860579
9369,92,26,0,5.57,31.33,860579,860671
9370,76,25,0,6.74,38.77,860670,860746
9371,95,24,0,5.39,35.00,860745,860840
9372,104,22,0,4.92,31.28,860839,860943
9373,98,27,0,5.22,34.42,860942,861040
9374,88,30,0,5.82,38.54,861039,861127
9375,66,78,0,7.76,120.43,861126,861192
9376,106,32,0,4.83,31.73,861191,861297
9377,86,27,0,5.95,36.42,861296,861382
9378,97,27,0,5.28,30.37,861381,861478
9379,82,24,0,6.24,34.38,861477,861559
9380,108,19,0,4.74,22.69,861558,861666
9381,85,24,0,6.02,35.93,861665,861750
9382,85,42,0,6.02,50.99,861749,861834
9383,105,27,0,4.88,30.93,861833,861938
9384,101,33,0,5.07,34.36,861937,862038
9385,96,24,0,5.33,30.47,862037,862133
9386,108,28,0,4.74,31.25,862132,862240
9387,95,29,0,5.39,32.17,862239,862334
9388,72,83,0,7.11,112.57,862333,862405
9389,75,52,0,6.83,69.08,862404,862479
9390,97,27,0,5.28,29.19,862478,862575
9391,107,27,0,4.79,27.53,862574,862681
9392,91,19,0,5.63,27.29,862680,862771
9393,103,28,0,4.97,30.38,862770,862873
9394,94,24,0,5.45,30.27,862872,862966
9395,89,21,0,5.75,28.88,862965,863054
9396,105,24,0,4.88,28.13,863053,863158
9397,86,20,0,5.95,30.60,863157,863243
9398,82,25,0,6.24,41.79,863242,863324
9399,95,33,0,5.39,37.67,863323,863418
9400,92,23,0,5.57,28.75,863418,863510
9401,106,21,0,4.83,26.97,863509,863615
9402,102,26,0,5.02,32.20,863614,863716
9403,95,30,0,5.39,30.70,863715,863810
9404,98,23,0,5.22,31.21,863809,863907
9405,94,19,0,5.45,29.86,863906,864000
9406,92,25,0,5.57,33.35,863999,864091
9407,84,28,0,6.10,44.23,864090,864174
9408,93,41,0,5.51,41.91,864174,864267
9409,76,20,0,6.74,34.19,864266,864342
9410,93,26,0,5.51,36.85,864342,864435
9411,97,26,0,5.28,30.76,864434,864531
9412,69,21,0,7.42,33.95,864530,864599
9413,105,20,0,4.88,31.18,864598,864703
9414,92,21,0,5.57,28.75,864702,864794
9415,102,23,0,5.02,28.76,864794,864896
9416,103,30,0,4.97,35.62,864895,864998
9417,91,21,0,5.63,32.50,864997,865088
9418,88,70,0,5.82,72.15,865087,865175
9419,88,54,0,5.82,55.47,865174,865262
9420,99,21,0,5.17,31.48,865262,865361
9421,115,19,0,4.45,23.60,865360,865475
9422,111,20,0,4.61,25.14,865474,865585
9423,99,33,0,5.17,40.12,865584,865683
9424,99,21,0,5.17,31.58,865682,865781
9425,95,30,0,5.39,45.46,865781,865876
9426,103,20,0,4.97,27.47,865875,865978
9427,98,25,0,5.22,28.56,865977,866075
9428,85,32,0,6.02,43.83,866074,866159
9429,79,28,0,6.48,40.22,866158,866237
9430,105,30,0,4.88,27.52,866236,866341
9431,97,24,0,5.28,33.17,866340,866437
9432,113,24,0,4.53,22.82,866437,866550
9433,90,24,0,5.69,32.24,866549,866639
9434,95,19,0,5.39,31.40,866638,866733
9435,95,20,0,5.39,33.77,866733,866828
9436,82,34,0,6.24,50.84,866827,866909
9437,99,20,0,5.17,29.62,866908,867007
9438,100,41,0,5.12,39.43,867006,867106
9439,98,24,0,5.22,28.15,867105,867203
9440,65,56,0,7.88,71.22,867202,867267
9441,97,20,0,5.28,30.90,867266,867363
9442,89,76,0,5.75,80.61,867362,867451
9443,78,29,0,6.56,43.94,867450,867528
9444,81,69,0,6.32,81.28,867527,867608
9445,105,24,0,4.88,28.87,867608,867713
9446,106,28,0,4.83,26.33,867712,867818
9447,91,26,0,5.63,44.10,867817,867908
9448,95,39,0,5.39,36.91,867907,868002
9449,93,25,0,5.51,29.30,868001,868094
9450,97,26,0,5.28,31.19,868094,868191
9451,91,20,0,5.63,28.45,868190,868281
9452,125,48,0,4.10,32.63,868280,868405
9453,84,21,0,6.10,34.32,868404,868488
9454,100,21,0,5.12,26.57,868487,868587
9455,96,29,0,5.33,26.97,868586,868682
9456,72,74,0,7.11,96.07,868681,868753
9457,51,173,0,10.04,626.27,868752,868803
9458,98,38,0,5.22,41.05,868802,868900
9459,89,32,0,5.75,35.47,868899,868988
9460,68,24,0,7.53,36.81,868988,869056
9461,71,101,0,7.21,168.00,869055,869126
9462,100,54,0,5.12,46.83,869126,869226
9463,106,29,0,4.83,29.84,869225,869331
9464,92,24,0,5.57,36.94,869330,869422
9465,92,29,0,5.57,36.92,869421,869513
9466,86,25,0,5.95,29.60,869512,869598
9467,90,22,0,5.69,31.99,869597,869687
9468,104,23,0,4.92,33.74,869686,869790
9469,80,53,0,6.40,61.54,869790,869870
9470,102,31,0,5.02,33.10,869869,869971
9471,80,31,0,6.40,45.59,869970,870050
9472,100,20,0,5.12,26.17,870049,870149
9473,82,21,0,6.24,35.77,870148,870230
9474,79,28,0,6.48,46.20,870229,870308
9475,102,22,0,5.02,24.86,870307,870409
9476,87,43,0,5.89,50.42,870408,870495
9477,96,19,0,5.33,26.97,870495,870591
9478,89,45,0,5.75,45.29,870591,870680
9479,86,45,0,5.95,37.95,870679,870765
9480,93,37,0,5.51,40.72,870765,870858
9481,102,37,0,5.02,43.00,870857,870959
9482,101,19,0,5.07,26.01,870958,871059
9483,73,33,0,7.01,48.34,871058,871131
9484,81,21,0,6.32,33.90,871130,871211
9485,113,19,0,4.53,26.23,871211,871324
9486,91,31,0,5.63,38.43,871323,871414
9487,103,22,0,4.97,27.99,871414,871517
9488,95,24,0,5.39,35.48,871516,871611
9489,97,20,0,5.28,26.10,871610,871707
9490,87,29,0,5.89,33.39,871706,871793
9491,87,22,0,5.89,39.21,871792,871879
9492,83,41,0,6.17,47.68,871878,871961
9493,90,53,0,5.69,51.79,871960,872050
9494,92,44,0,5.57,46.90,872049,872141
9495,100,29,0,5.12,32.21,872140,872240
9496,100,19,0,5.12,23.67,872239,872339
9497,72,25,0,7.11,38.52,872338,872410
9498,81,23,0,6.32,43.77,872409,872490
9499,85,36,0,6.02,40.09,872489,872574
9500,87,24,0,5.89,35.37,872573,872660
9501,100,26,0,5.12,30.07,872659,872759
9502,95,22,0,5.39,31.37,872758,872853
9503,110,21,0,4.65,29.57,872853,872963
9504,90,33,0,5.69,34.21,872962,873052
9505,82,22,0,6.24,41.33,873051,873133
9506,93,27,0,5.51,33.80,873132,873225
9507,99,24,0,5.17,36.00,873224,873323
9508,103,21,0,4.97,24.80,873323,873426
9509,99,19,0,5.17,28.89,873426,873525
9510,92,25,0,5.57,37.40,873525,873617
9511,96,31,0,5.33,30.70,873616,873712
9512,77,24,0,6.65,40.15,873711,873788
9513,113,21,0,4.53,19.20,873787,873900
9514,111,25,0,4.61,29.61,873899,874010
9515,99,19,0,5.17,29.09,874009,874108
9516,98,29,0,5.22,33.32,874107,874205
9517,97,59,0,5.28,54.61,874205,874302
9518,92,21,0,5.57,29.07,874301,874393
9519,116,21,0,4.41,24.16,874393,874509
9520,90,24,0,5.69,32.73,874508,874598
9521,101,28,0,5.07,33.55,874597,874698
9522,95,26,0,5.39,29.65,874697,874792
9523,94,21,0,5.45,33.74,874791,874885
9524,87,66,0,5.89,81.00,874884,874971
9525,99,29,0,5.17,34.61,874970,875069
9526,117,21,0,4.38,24.41,875068,875185
9527,92,21,0,5.57,28.09,875184,875276
9528,93,20,0,5.51,33.69,875275,875368
9529,108,19,0,4.74,25.56,875367,875475
9530,100,26,0,5.12,29.41,875474,875574
9531,92,22,0,5.57,29.90,875573,875665
9532,85,18,0,6.02,34.89,875664,875749
9533,102,29,0,5.02,31.63,875748,875850
9534,102,24,0,5.02,33.82,875849,875951
9535,86,26,0,5.95,37.63,875951,876037
9536,97,29,0,5.28,38.30,876036,876133
9537,80,31,0,6.40,41.79,876132,876212
9538,86,19,0,5.95,29.74,876211,876297
9539,92,27,0,5.57,28.31,876296,876388
9540,99,23,0,5.17,32.85,876388,876487
9541,103,26,0,4.97,32.77,876486,876589
9542,102,22,0,5.02,25.49,876588,876690
9543,113,23,0,4.53,23.52,876689,876802
9544,78,22,0,6.56,33.22,876801,876879
9545,95,26,0,5.39,29.65,876878,876973
9546,84,67,0,6.10,78.23,876973,877057
9547,79,82,0,6.48,116.45,877056,877135
9548,91,25,0,5.63,31.93,877134,877225
9549,87,28,0,5.89,35.62,877224,877311
9550,93,30,0,5.51,41.73,877310,877403
9551,89,82,0,5.75,102.39,877402,877491
9552,87,42,0,5.89,47.27,877490,877577
9553,87,20,0,5.89,34.93,877576,877663
9554,100,28,0,5.12,33.21,877662,877762
9555,93,20,0,5.51,25.95,877761,877854
9556,84,36,0,6.10,42.30,877853,877937
9557,95,26,0,5.39,34.07,877937,878032
9558,98,42,0,5.22,44.73,878031,878129
9559,85,24,0,6.02,38.89,878128,878213
9560,80,58,0,6.40,86.42,878212,878292
9561,84,70,0,6.10,80.40,878291,878375
9562,99,33,0,5.17,30.22,878374,878473
9563,79,25,0,6.48,38.71,878472,878551
9564,72,39,0,7.11,56.38,878550,878622
9565,112,36,0,4.57,36.80,878621,878733
9566,95,32,0,5.39,32.17,878732,878827
9567,89,18,0,5.75,27.71,878826,878915
9568,89,29,0,5.75,45.51,878914,879003
9569,89,28,0,5.75,37.56,879003,879092
9570,99,25,0,5.17,32.04,879091,879190
9571,99,21,0,5.17,25.21,879190,879289
9572,106,25,0,4.83,30.90,879288,879394
9573,135,19,0,3.79,19.31,879393,879528
9574,71,33,0,7.21,52.34,879527,879598
9575,83,28,0,6.17,36.04,879597,879680
9576,111,32,0,4.61,30.00,879679,879790
9577,96,21,0,5.33,30.43,879789,879885
9578,89,38,0,5.75,52.21,879885,879974
9579,67,28,0,7.64,44.56,879973,880040
9580,93,35,0,5.51,41.00,880040,880133
9581,113,19,0,4.53,23.36,880132,880245
9582,80,29,0,6.40,40.79,880245,880325
9583,107,23,0,4.79,32.99,880324,880431
9584,92,52,0,5.57,56.62,880430,880522
9585,91,26,0,5.63,28.78,880521,880612
9586,95,29,0,5.39,42.20,880611,880706
9587,100,19,0,5.12,25.31,880705,880805
9588,110,20,0,4.65,27.55,880804,880914
9589,95,29,0,5.39,36.11,880913,881008
9590,103,20,0,4.97,30.57,881007,881110
9591,92,20,0,5.57,31.81,881109,881201
9592,86,37,0,5.95,41.32,881200,881286
9593,96,19,0,5.33,27.45,881285,881381
9594,79,30,0,6.48,33.77,881380,881459
9595,92,30,0,5.57,39.46,881458,881550
9596,94,25,0,5.45,32.80,881549,881643
9597,103,22,0,4.97,28.63,881642,881745
9598,102,22,0,5.02,28.74,881744,881846
9599,90,25,0,5.69,35.93,881846,881936
9600,80,105,0,6.40,152.61,881935,882015
9601,94,23,0,5.45,34.10,882014,882108
9602,107,20,0,4.79,25.46,882107,882214
9603,105,27,0,4.88,26.05,882213,882318
9604,82,40,0,6.24,45.36,882317,882399
9605,91,46,0,5.63,55.64,882398,882489
9606,85,41,0,6.02,60.96,882488,882573
9607,111,34,0,4.61,30.99,882572,882683
9608,59,55,0,8.68,99.85,882682,882741
9609,80,49,0,6.40,59.44,882741,882821
9610,110,37,0,4.65,34.77,882820,882930
9611,77,23,0,6.65,37.92,882929,883006
9612,99,20,0,5.17,27.11,883005,883104
9613,89,35,0,5.75,46.28,883103,883192
9614,90,18,0,5.69,32.15,883191,883281
9615,104,19,0,4.92,28.49,883280,883384
9616,81,29,0,6.32,43.23,883384,883465
9617,120,26,0,4.27,24.26,883464,883584
9618,92,29,0,5.57,36.42,883583,883675
9619,106,24,0,4.83,30.25,883674,883780
9620,84,27,0,6.10,38.18,883779,883863
9621,83,19,0,6.17,30.12,883862,883945
9622,84,23,0,6.10,39.85,883945,884029
9623,105,22,0,4.88,27.31,884028,884133
9624,99,31,0,5.17,33.64,884132,884231
9625,94,41,0,5.45,45.55,884230,884324
9626,87,34,0,5.89,41.04,884324,884411
9627,83,24,0,6.17,38.96,884410,884493
9628,91,21,0,5.63,31.82,884492,884583
9629,100,19,0,5.12,29.05,884582,884682
9630,99,21,0,5.17,29.03,884682,884781
9631,84,34,0,6.10,41.75,884780,884864
9632,86,20,0,5.95,30.51,884863,884949
9633,106,23,0,4.83,31.03,884948,885054
9634,107,20,0,4.79,25.68,885053,885160
9635,119,21,0,4.30,20.56,885159,885278
9636,97,28,0,5.28,36.14,885277,885374
9637,103,24,0,4.97,30.40,885373,885476
9638,111,21,0,4.61,25.25,885475,885586
9639,87,28,0,5.89,42.15,885585,885672
9640,58,232,0,8.83,901.80,885671,885729
9641,82,24,0,6.24,38.11,885728,885810
9642,91,31,0,5.63,34.21,885809,885900
9643,105,46,0,4.88,42.66,885899,886004
9644,94,43,0,5.45,52.18,886003,886097
9645,82,23,0,6.24,36.82,886096,886178
9646,110,25,0,4.65,23.39,886177,886287
9647,100,20,0,5.12,29.97,886286,886386
9648,96,24,0,5.33,33.43,886385,886481
9649,128,19,0,4.00,22.36,886480,886608
9650,78,53,0,6.56,63.60,886607,886685
9651,83,27,0,6.17,39.71,886684,886767
9652,99,33,0,5.17,41.74,886766,886865
9653,94,20,0,5.45,29.80,886864,886958
9654,101,22,0,5.07,28.34,886957,887058
9655,87,21,0,5.89,29.87,887057,887144
9656,95,26,0,5.39,34.26,887143,887238
9657,86,27,0,5.95,41.30,887237,887323
9658,94,21,0,5.45,33.37,887322,887416
9659,96,37,0,5.33,38.68,887416,887512
9660,108,23,0,4.74,26.21,887511,887619
9661,102,27,0,5.02,35.51,887618,887720
9662,94,35,0,5.45,38.23,887719,887813
9663,111,20,0,4.61,24.71,887813,887924
9664,99,24,0,5.17,30.38,887923,888022
9665,105,25,0,4.88,30.64,888021,888126
9666,84,23,0,6.10,36.32,888125,888209
9667,90,29,0,5.69,35.84,888208,888298
9668,93,27,0,5.51,38.03,888297,888390
9669,92,45,0,5.57,47.42,888389,888481
9670,104,23,0,4.92,32.03,888480,888584
9671,67,66,0,7.64,87.45,888583,888650
9672,83,23,0,6.17,43.85,888649,888732
9673,82,32,0,6.24,40.01,888731,888813
9674,85,33,0,6.02,42.75,888812,888897
9675,98,21,0,5.22,29.87,888896,888994
9676,94,31,0,5.45,42.25,888993,889087
9677,88,26,0,5.82,39.63,889086,889174
9678,84,21,0,6.10,32.40,889174,889258
9679,78,24,0,6.56,35.99,889257,889335
9680,108,19,0,4.74,22.86,889334,889442
9681,78,81,0,6.56,113.55,889441,889519
9682,65,70,0,7.88,111.68,889518,889583
9683,107,24,0,4.79,29.55,889582,889689
9684,117,20,0,4.38,24.61,889688,889805
9685,93,20,0,5.51,31.43,889804,889897
9686,89,21,0,5.75,29.13,889896,889985
9687,100,19,0,5.12,27.41,889984,890084
9688,109,25,0,4.70,33.86,890083,890192
9689,70,42,0,7.31,63.56,890191,890261
9690,82,24,0,6.24,37.18,890260,890342
9691,107,26,0,4.79,29.37,890341,890448
9692,94,21,0,5.45,33.42,890447,890541
9693,56,75,0,9.14,134.34,890540,890596
9694,85,21,0,6.02,34.80,890595,890680
9695,96,45,0,5.33,38.33,890679,890775
9696,113,18,0,4.53,24.20,890774,890887
9697,103,25,0,4.97,33.80,890886,890989
9698,88,76,0,5.82,81.42,890988,891076
9699,105,27,0,4.88,32.60,891075,891180
9700,74,41,0,6.92,52.24,891179,891253
9701,77,89,0,6.65,123.58,891253,891330
9702,94,23,0,5.45,38.37,891329,891423
9703,93,30,0,5.51,31.43,891422,891515
9704,101,26,0,5.07,34.32,891514,891615
9705,78,35,0,6.56,39.68,891615,891693
9706,69,45,0,7.42,54.21,891692,891761
9707,99,28,0,5.17,35.62,891760,891859
9708,83,30,0,6.17,40.84,891858,891941
9709,67,66,0,7.64,103.36,891940,892007
9710,98,25,0,5.22,34.38,892006,892104
9711,88,22,0,5.82,31.33,892103,892191
9712,102,46,0,5.02,44.65,892190,892292
9713,92,21,0,5.57,35.35,892292,892384
9714,61,85,0,8.39,164.60,892384,892445
9715,96,25,0,5.33,36.76,892444,892540
9716,109,31,0,4.70,30.80,892539,892648
9717,93,21,0,5.51,25.13,892647,892740
9718,105,27,0,4.88,33.33,892740,892845
9719,97,22,0,5.28,30.96,892844,892941
9720,80,28,0,6.40,41.97,892940,893020
9721,108,21,0,4.74,26.45,893019,893127
9722,98,27,0,5.22,37.28,893126,893224
9723,77,31,0,6.65,50.77,893223,893300
9724,92,22,0,5.57,34.94,893299,893391
9725,98,23,0,5.22,29.17,893390,893488
9726,87,26,0,5.89,38.19,893487,893574
9727,104,26,0,4.92,35.15,893573,893677
9728,108,27,0,4.74,26.97,893676,893784
9729,105,20,0,4.88,30.22,893784,893889
9730,77,36,0,6.65,60.51,893888,893965
9731,102,20,0,5.02,32.29,893964,894066
9732,96,42,0,5.33,45.99,894066,894162
9733,129,20,0,3.97,24.48,894161,894290
9734,105,25,0,4.88,26.78,894289,894394
9735,106,41,0,4.83,40.97,894394,894500
9736,100,24,0,5.12,32.55,894499,894599
9737,84,21,0,6.10,30.87,894599,894683
9738,77,26,0,6.65,37.50,894682,894759
9739,106,30,0,4.83,29.84,894758,894864
9740,98,28,0,5.22,34.13,894863,894961
9741,99,22,0,5.17,30.36,894961,895060
9742,87,33,0,5.89,44.95,895059,895146
9743,72,48,0,7.11,62.43,895146,895218
9744,107,22,0,4.79,33.14,895217,895324
9745,90,20,0,5.69,31.64,895323,895413
9746,92,38,0,5.57,36.64,895412,895504
9747,99,27,0,5.17,39.48,895503,895602
9748,105,22,0,4.88,29.48,895601,895706
9749,97,29,0,5.28,38.61,895705,895802
9750,117,19,0,4.38,26.90,895801,895918
9751,87,24,0,5.89,38.68,895917,896004
9752,92,30,0,5.57,40.14,896003,896095
9753,86,27,0,5.95,40.11,896094,896180
9754,96,24,0,5.33,35.22,896180,896276
9755,78,26,0,6.56,42.66,896275,896353
9756,95,47,0,5.39,44.39,896352,896447
9757,86,28,0,5.95,32.74,896446,896532
9758,103,23,0,4.97,30.14,896531,896634
9759,88,42,0,5.82,49.94,896633,896721
9760,97,33,0,5.28,38.86,896721,896818
9761,87,48,0,5.89,51.34,896817,896904
9762,109,24,0,4.70,30.85,896903,897012
9763,87,28,0,5.89,39.21,897011,897098
9764,92,21,0,5.57,31.57,897097,897189
9765,85,34,0,6.02,36.45,897188,897273
9766,93,38,0,5.51,55.73,897272,897365
9767,92,23,0,5.57,35.22,897364,897456
9768,108,26,0,4.74,32.71,897455,897563
9769,80,21,0,6.40,31.84,897562,897642
9770,105,23,0,4.88,31.82,897641,897746
9771,122,19,0,4.20,22.09,897745,897867
9772,76,22,0,6.74,41.35,897866,897942
9773,80,32,0,6.40,37.74,897941,898021
9774,111,20,0,4.61,26.65,898020,898131
9775,92,47,0,5.57,48.01,898130,898222
9776,73,35,0,7.01,48.37,898221,898294
9777,110,22,0,4.65,28.52,898293,898403
9778,82,23,0,6.24,39.01,898402,898484
9779,96,29,0,5.33,31.01,898483,898579
9780,85,25,0,6.02,36.59,898579,898664
9781,89,23,0,5.75,35.04,898663,898752
9782,106,19,0,4.83,20.61,898751,898857
9783,80,28,0,6.40,47.87,898856,898936
9784,85,26,0,6.02,37.43,898936,899021
9785,67,62,0,7.64,84.80,899020,899087
9786,112,20,0,4.57,23.37,899086,899198
9787,98,30,0,5.22,41.68,899197,899295
9788,72,160,0,7.11,366.27,899295,899367
9789,102,47,0,5.02,41.39,899366,899468
9790,85,38,0,6.02,39.51,899467,899552
9791,83,89,0,6.17,127.54,899551,899634
9792,100,21,0,5.12,28.47,899633,899733
9793,86,38,0,5.95,38.77,899732,899818
9794,102,24,0,5.02,29.27,899818,899920
9795,103,40,0,4.97,35.83,899919,900022
9796,106,29,0,4.83,27.78,900021,900127
9797,101,40,0,5.07,38.76,900126,900227
9798,95,17,0,5.39,24.30,900226,900321
9799,103,20,0,4.97,26.47,900320,900423
9800,91,29,0,5.63,33.68,900422,900513
9801,100,22,0,5.12,30.27,900513,900613
9802,91,20,0,5.63,24.63,900612,900703
9803,110,19,0,4.65,24.37,900702,900812
9804,86,21,0,5.95,31.97,900812,900898
9805,103,25,0,4.97,29.97,900897,901000
9806,110,22,0,4.65,28.14,900999,901109
9807,83,32,0,6.17,37.44,901108,901191
9808,100,23,0,5.12,32.31,901191,901291
9809,66,76,0,7.76,156.58,901290,901356
9810,82,20,0,6.24,30.55,901355,901437
9811,79,33,0,6.48,44.53,901436,901515
9812,104,21,0,4.92,30.22,901514,901618
9813,101,22,0,5.07,31.61,901617,901718
9814,96,20,0,5.33,27.76,901718,901814
9815,92,39,0,5.57,45.77,901813,901905
9816,121,23,0,4.23,24.23,901904,902025
9817,101,77,0,5.07,73.09,902024,902125
9818,74,83,0,6.92,116.10,902124,902198
9819,105,20,0,4.88,26.05,902197,902302
9820,75,21,0,6.83,34.36,902301,902376
9821,102,19,0,5.02,25.10,902375,902477
9822,90,51,0,5.69,59.61,902476,902566
9823,85,63,0,6.02,69.36,902565,902650
9824,116,20,0,4.41,24.21,902650,902766
9825,84,28,0,6.10,37.37,902765,902849
9826,77,34,0,6.65,51.11,902849,902926
9827,89,25,0,5.75,35.76,902926,903015
9828,102,48,0,5.02,60.98,903014,903116
9829,115,20,0,4.45,23.57,903115,903230
9830,92,49,0,5.57,47.22,903229,903321
9831,95,72,0,5.39,70.83,903320,903415
9832,104,33,0,4.92,35.34,903414,903518
9833,85,33,0,6.02,42.99,903517,903602
9834,90,24,0,5.69,34.70,903601,903691
9835,87,41,0,5.89,48.81,903690,903777
9836,88,26,0,5.82,36.74,903776,903864
9837,85,59,0,6.02,66.99,903863,903948
9838,92,63,0,5.57,65.18,903948,904040
9839,85,21,0,6.02,33.27,904039,904124
9840,90,76,0,5.69,88.59,904123,904213
9841,71,39,0,7.21,59.35,904212,904283
9842,83,18,0,6.17,27.59,904282,904365
9843,77,27,0,6.65,37.99,904364,904441
9844,94,26,0,5.45,31.18,904440,904534
9845,102,33,0,5.02,28.98,904533,904635
9846,91,24,0,5.63,38.39,904635,904726
9847,102,21,0,5.02,30.63,904726,904828
9848,92,19,0,5.57,35.51,904827,904919
9849,98,42,0,5.22,44.05,904918,905016
9850,90,52,0,5.69,52.50,905015,905105
9851,102,60,0,5.02,65.43,905104,905206
9852,108,20,0,4.74,26.06,905205,905313
9853,81,40,0,6.32,42.81,905312,905393
9854,82,26,0,6.24,36.82,905392,905474
9855,92,19,0,5.57,30.31,905473,905565
9856,100,22,0,5.12,31.55,905564,905664
9857,111,20,0,4.61,22.09,905663,905774
9858,100,25,0,5.12,27.01,905773,905873
9859,122,19,0,4.20,23.42,905873,905995
9860,106,23,0,4.83,25.61,905994,906100
9861,103,30,0,4.97,35.85,906099,906202
9862,74,35,0,6.92,42.24,906201,906275
9863,81,44,0,6.32,49.43,906274,906355
9864,101,20,0,5.07,27.39,906354,906455
9865,96,19,0,5.33,28.01,906454,906550
9866,85,34,0,6.02,41.20,906549,906634
9867,108,19,0,4.74,28.21,906633,906741
9868,95,51,0,5.39,43.10,906741,906836
9869,92,26,0,5.57,40.27,906835,906927
9870,99,18,0,5.17,22.18,906926,907025
9871,91,35,0,5.63,41.29,907024,907115
9872,90,42,0,5.69,47.81,907114,907204
9873,99,35,0,5.17,37.48,907203,907302
9874,107,28,0,4.79,31.01,907302,907409
9875,90,21,0,5.69,28.26,907408,907498
9876,80,35,0,6.40,49.39,907497,907577
9877,98,20,0,5.22,27.30,907576,907674
9878,87,27,0,5.89,46.03,907673,907760
9879,93,44,0,5.51,42.47,907759,907852
9880,90,26,0,5.69,40.44,907851,907941
9881,104,20,0,4.92,28.86,907941,908045
9882,78,22,0,6.56,38.32,908044,908122
9883,97,19,0,5.28,26.92,908121,908218
9884,106,20,0,4.83,27.76,908217,908323
9885,114,24,0,4.49,26.71,908322,908436
9886,86,40,0,5.95,36.67,908435,908521
9887,87,20,0,5.89,37.02,908520,908607
9888,85,24,0,6.02,45.98,908606,908691
9889,86,28,0,5.95,39.18,908690,908776
9890,99,45,0,5.17,45.44,908775,908874
9891,115,19,0,4.45,20.89,908873,908988
9892,93,26,0,5.51,40.51,908987,909080
9893,89,22,0,5.75,28.34,909079,909168
9894,97,19,0,5.28,25.69,909167,909264
9895,101,32,0,5.07,36.68,909263,909364
9896,105,23,0,4.88,27.58,909363,909468
9897,73,25,0,7.01,42.64,909467,909540
9898,105,24,0,4.88,31.98,909539,909644
9899,92,25,0,5.57,36.09,909643,909735
9900,104,20,0,4.92,27.21,909734,909838
9901,107,19,0,4.79,24.52,909837,909944
9902,95,19,0,5.39,24.72,909943,910038
9903,100,33,0,5.12,35.35,910037,910137
9904,68,103,0,7.53,184.66,910136,910204
9905,95,41,0,5.39,40.39,910203,910298
9906,106,28,0,4.83,35.44,910297,910403
9907,92,26,0,5.57,34.70,910402,910494
9908,95,22,0,5.39,32.83,910493,910588
9909,81,46,0,6.32,57.23,910587,910668
9910,91,23,0,5.63,33.51,910667,910758
9911,103,20,0,4.97,30.46,910757,910860
9912,78,34,0,6.56,42.14,910859,910937
9913,106,24,0,4.83,27.37,910936,911042
9914,101,22,0,5.07,30.42,911041,911142
9915,76,28,0,6.74,44.09,911141,911217
9916,110,18,0,4.65,25.04,911216,911326
9917,73,26,0,7.01,40.40,911325,911398
9918,115,38,0,4.45,39.17,911397,911512
9919,111,19,0,4.61,28.02,911512,911623
9920,87,19,0,5.89,29.14,911622,911709
9921,97,19,0,5.28,29.09,911708,911805
9922,99,20,0,5.17,24.32,911804,911903
9923,60,23,0,8.53,43.58,911903,911963
9924,97,35,0,5.28,39.25,911962,912059
9925,88,22,0,5.82,34.31,912058,912146
9926,87,27,0,5.89,38.35,912146,912233
9927,113,27,0,4.53,26.04,912232,912345
9928,95,43,0,5.39,43.63,912344,912439
9929,69,22,0,7.42,38.65,912439,912508
9930,109,30,0,4.70,27.59,912507,912616
9931,104,19,0,4.92,30.19,912615,912719
9932,110,20,0,4.65,24.81,912718,912828
9933,99,22,0,5.17,28.61,912827,912926
9934,87,24,0,5.89,29.44,912925,913012
9935,89,46,0,5.75,44.32,913011,913100
9936,97,62,0,5.28,59.21,913099,913196
9937,86,33,0,5.95,34.60,913195,913281
9938,99,19,0,5.17,23.98,913280,913379
9939,94,38,0,5.45,38.84,913378,913472
9940,78,27,0,6.56,37.19,913471,913549
9941,83,38,0,6.17,48.26,913548,913631
9942,103,24,0,4.97,26.40,913630,913733
9943,95,20,0,5.39,27.96,913732,913827
9944,118,24,0,4.34,26.36,913826,913944
9945,94,20,0,5.45,27.80,913943,914037
9946,96,23,0,5.33,31.08,914036,914132
9947,104,24,0,4.92,30.55,914132,914236
9948,86,20,0,5.95,29.63,914235,914321
9949,106,30,0,4.83,33.57,914320,914426
9950,98,25,0,5.22,30.50,914425,914523
9951,107,21,0,4.79,31.14,914522,914629
9952,101,32,0,5.07,36.84,914628,914729
9953,111,20,0,4.61,25.95,914728,914839
9954,99,28,0,5.17,28.65,914838,914937
9955,75,19,0,6.83,34.22,914937,915012
9956,101,21,0,5.07,29.99,915011,915112
9957,111,25,0,4.61,28.99,915111,915222
9958,62,213,0,8.26,718.45,915221,915283
9959,95,21,0,5.39,37.21,915282,915377
9960,96,53,0,5.33,62.47,915376,915472
9961,102,39,0,5.02,42.10,915471,915573
9962,94,20,0,5.45,33.25,915572,915666
9963,112,19,0,4.57,26.80,915665,915777
9964,103,58,0,4.97,57.83,915776,915879
9965,107,21,0,4.79,25.72,915878,915985
9966,101,31,0,5.07,31.99,915984,916085
9967,107,28,0,4.79,27.63,916084,916191
9968,88,21,0,5.82,34.63,916190,916278
9969,76,34,0,6.74,52.56,916278,916354
9970,75,26,0,5.32,33.36,916353,916428
