tile_id,n_reduce_rows_num,max_row_length,min_row_length,avg_row_length,variance,start_row,end_row
0,72,46,1,7.11,79.96,0,72
1,71,48,1,7.21,78.34,71,142
2,34,86,2,15.06,379.17,141,175
3,71,36,1,7.21,55.66,174,245
4,51,95,0,10.04,233.68,244,295
5,55,60,1,9.31,149.78,294,349
6,71,36,1,7.21,59.63,348,419
7,66,57,1,7.76,74.70,418,484
8,68,45,1,7.53,76.19,483,551
9,58,45,1,8.83,95.83,550,608
10,53,72,1,9.66,143.58,607,660
11,80,36,1,6.40,49.47,659,739
12,82,35,1,6.24,46.99,739,821
13,58,101,1,8.83,204.80,820,878
14,58,99,1,8.83,197.87,877,935
15,55,122,1,9.31,271.67,934,989
16,73,55,1,7.01,71.68,988,1061
17,70,62,1,7.31,85.02,1060,1130
18,75,36,1,6.83,41.05,1129,1204
19,62,52,1,8.26,147.58,1203,1265
20,51,99,1,10.04,252.55,1264,1315
21,61,36,1,8.39,79.29,1314,1375
22,57,47,1,8.98,82.79,1375,1432
23,64,36,1,8.00,77.12,1431,1495
24,61,53,1,8.39,110.47,1495,1556
25,50,80,1,10.24,203.02,1555,1605
26,75,36,1,6.83,37.61,1604,1679
27,68,38,1,7.53,69.75,1678,1746
28,81,44,1,6.32,50.37,1745,1826
29,73,33,1,7.01,43.49,1826,1899
30,75,36,0,6.83,57.10,1898,1973
31,63,47,1,8.13,77.70,1972,2035
32,62,96,1,8.26,209.55,2034,2096
33,78,39,1,6.56,36.48,2095,2173
34,60,35,1,8.53,63.28,2173,2233
35,66,55,1,7.76,94.97,2232,2298
36,46,149,1,11.13,496.98,2297,2343
37,49,44,1,10.45,134.74,2342,2391
38,48,89,1,10.67,326.18,2390,2438
39,63,79,1,8.13,125.86,2437,2500
40,65,44,1,7.88,59.62,2499,2564
41,67,36,1,7.64,61.90,2563,2630
42,40,211,1,12.80,1147.31,2629,2669
43,68,36,1,7.53,61.40,2668,2736
44,63,50,1,8.13,112.43,2736,2799
45,53,103,1,9.66,270.49,2799,2852
46,61,43,1,8.39,93.78,2851,2912
47,49,55,1,10.45,161.31,2911,2960
48,61,60,1,8.39,108.66,2959,3020
49,80,34,1,6.40,41.59,3019,3099
50,55,64,1,9.31,177.12,3098,3153
51,55,77,0,9.31,140.87,3152,3207
52,74,36,1,6.92,51.02,3206,3280
53,59,70,1,8.68,144.96,3279,3338
54,86,32,1,5.95,36.28,3337,3423
55,58,44,1,8.83,101.69,3422,3480
56,69,46,1,7.42,67.29,3479,3548
57,51,62,1,10.04,157.65,3548,3599
58,80,36,1,6.40,48.52,3598,3678
59,75,35,1,6.83,42.28,3677,3752
60,61,39,1,8.39,79.22,3751,3812
61,46,104,1,11.13,289.81,3811,3857
62,83,36,1,6.17,32.53,3856,3939
63,65,45,1,7.88,80.97,3938,4003
64,63,47,1,8.13,74.40,4002,4065
65,51,74,1,10.04,168.19,4064,4115
66,54,55,1,9.48,114.58,4114,4168
67,67,56,1,7.64,82.17,4167,4234
68,64,36,1,8.00,74.94,4233,4297
69,69,61,1,7.42,97.63,4296,4365
70,80,31,1,6.40,41.92,4364,4444
71,60,49,0,8.53,109.12,4443,4503
72,58,54,1,8.83,106.69,4502,4560
73,52,84,1,9.85,184.28,4559,4611
74,76,56,1,6.74,63.48,4610,4686
75,33,99,1,15.52,525.04,4685,4718
76,67,36,1,7.64,69.81,4717,4784
77,52,88,1,9.85,196.55,4783,4835
78,64,36,1,8.00,78.34,4834,4898
79,68,36,1,7.53,60.78,4897,4965
80,70,37,1,7.31,76.73,4964,5034
81,68,45,1,7.53,87.75,5033,5101
82,77,51,0,6.65,54.33,5100,5177
83,67,35,1,7.64,62.38,5176,5243
84,63,49,2,8.13,85.79,5242,5305
85,62,36,1,8.26,78.32,5304,5366
86,68,36,1,7.53,63.98,5365,5433
87,58,98,1,8.83,306.38,5432,5490
88,65,36,1,7.88,58.63,5489,5554
89,72,36,1,7.11,51.74,5553,5625
90,74,36,1,6.92,41.83,5624,5698
91,53,125,1,9.66,326.45,5697,5750
92,57,130,1,8.98,323.77,5749,5806
93,66,36,1,7.76,70.88,5805,5871
94,51,134,1,10.04,478.27,5870,5921
95,61,36,1,8.39,90.30,5920,5981
96,77,52,1,6.65,74.62,5980,6057
97,75,64,1,6.83,91.16,6056,6131
98,70,38,1,7.31,66.76,6130,6200
99,83,38,1,6.17,53.54,6199,6282
100,43,132,1,11.91,485.43,6281,6324
101,62,50,1,8.26,75.77,6323,6385
102,84,35,1,6.10,49.66,6384,6468
103,75,47,1,6.83,50.46,6467,6542
104,48,43,1,10.67,148.72,6542,6590
105,78,37,1,6.56,54.17,6589,6667
106,52,88,1,9.85,216.51,6666,6718
107,67,46,1,7.64,76.02,6717,6784
108,57,53,1,8.98,118.86,6783,6840
109,60,55,1,8.53,111.08,6839,6899
110,57,60,1,8.98,134.72,6898,6955
111,63,49,0,8.13,101.13,6954,7017
112,61,36,1,8.39,69.22,7016,7077
113,59,58,1,8.68,113.95,7076,7135
114,63,39,1,8.13,71.54,7134,7197
115,68,35,1,7.53,49.16,7196,7264
116,56,62,1,9.14,139.77,7263,7319
117,64,100,1,8.00,182.94,7318,7382
118,59,75,1,8.68,160.59,7381,7440
119,63,60,1,8.13,113.92,7439,7502
120,63,41,1,8.13,73.32,7501,7564
121,78,60,1,6.56,63.71,7563,7641
122,61,51,1,8.39,93.58,7640,7701
123,79,42,1,6.48,48.02,7700,7779
124,66,61,0,7.76,140.06,7778,7844
125,52,95,1,9.85,242.78,7843,7895
126,55,152,1,9.31,437.12,7894,7949
127,62,65,1,8.26,129.45,7948,8010
128,62,45,1,8.26,97.45,8009,8071
129,59,52,1,8.68,128.29,8070,8129
130,59,70,1,8.68,120.46,8128,8187
131,58,35,1,8.83,63.83,8186,8244
132,76,33,1,6.74,35.85,8243,8319
133,60,62,1,8.53,97.85,8318,8378
134,57,60,1,8.98,108.19,8377,8434
135,61,46,1,8.39,88.07,8433,8494
136,59,44,1,8.68,106.52,8493,8552
137,70,37,1,7.31,70.73,8551,8621
138,44,97,1,11.64,340.91,8620,8664
139,56,104,1,9.14,269.37,8663,8719
140,68,61,1,7.53,99.51,8718,8786
141,45,110,1,11.38,380.19,8786,8831
142,66,44,1,7.76,71.76,8830,8896
143,82,60,1,6.24,62.43,8895,8977
144,57,65,1,8.98,185.70,8976,9033
145,43,87,1,11.91,333.06,9032,9075
146,56,43,1,9.14,108.09,9074,9130
147,54,61,1,9.48,121.55,9129,9183
148,59,61,1,8.68,136.90,9182,9241
149,74,61,1,6.92,93.64,9240,9314
150,69,33,1,7.42,54.56,9313,9382
151,56,102,1,9.14,200.98,9381,9437
152,80,35,1,6.40,35.19,9436,9516
153,46,62,1,11.13,174.11,9515,9561
154,69,55,1,7.42,88.50,9560,9629
155,59,49,1,8.68,89.27,9628,9687
156,69,61,1,7.42,95.78,9686,9755
157,76,33,1,6.74,42.06,9754,9830
158,60,36,1,8.53,53.48,9829,9889
159,65,94,1,7.88,189.49,9888,9953
160,71,57,1,7.21,74.34,9952,10023
161,74,36,1,6.92,46.72,10022,10096
162,54,63,1,9.48,170.10,10095,10149
163,72,65,1,7.11,84.99,10148,10220
164,63,60,1,8.13,122.56,10219,10282
165,66,80,1,7.76,155.40,10281,10347
166,56,197,1,9.14,664.73,10346,10402
167,67,47,1,7.64,76.86,10402,10469
168,42,91,1,12.19,260.92,10468,10510
169,69,46,1,7.42,68.77,10509,10578
170,58,98,1,8.83,217.97,10577,10635
171,65,56,1,7.88,107.98,10634,10699
172,45,212,1,11.38,960.50,10698,10743
173,60,36,1,8.53,92.28,10742,10802
174,59,48,1,8.68,111.27,10801,10860
175,81,44,1,6.32,47.70,10859,10940
176,69,35,1,7.42,55.69,10939,11008
177,56,36,1,9.14,108.02,11007,11063
178,92,52,0,5.57,50.57,11062,11154
179,58,73,0,8.83,145.49,11154,11212
180,65,43,1,7.88,93.68,11212,11277
181,64,29,1,8.00,47.38,11276,11340
182,44,221,2,11.64,1063.96,11340,11384
183,60,62,1,8.53,102.68,11383,11443
184,72,36,1,7.11,59.71,11442,11514
185,62,60,1,8.26,108.48,11514,11576
186,66,60,1,7.76,86.43,11575,11641
187,78,32,1,6.56,39.91,11641,11719
188,66,88,1,7.76,145.67,11718,11784
189,53,65,1,9.66,154.53,11783,11836
190,56,72,1,9.14,177.84,11835,11891
191,62,50,1,8.26,84.09,11890,11952
192,85,40,1,6.02,38.68,11951,12036
193,53,36,1,9.66,89.77,12036,12089
194,79,92,1,6.48,113.69,12088,12167
195,60,54,1,8.53,109.02,12166,12226
196,53,61,1,9.66,169.02,12225,12278
197,77,50,1,6.65,74.36,12277,12354
198,81,35,1,6.32,35.50,12353,12434
199,52,98,1,9.85,227.36,12433,12485
200,60,59,1,8.53,97.38,12484,12544
201,60,43,0,8.53,100.48,12543,12603
202,74,35,1,6.92,54.18,12602,12676
203,58,60,1,8.83,112.63,12675,12733
204,63,51,1,8.13,94.97,12732,12795
205,55,49,1,9.31,113.96,12794,12849
206,83,37,1,6.17,40.07,12848,12931
207,47,55,1,10.89,170.31,12930,12977
208,56,96,1,9.14,191.27,12976,13032
209,72,35,1,7.11,59.15,13031,13103
210,55,48,1,9.31,99.52,13102,13157
211,73,36,1,7.01,53.93,13156,13229
212,68,49,1,7.53,80.04,13228,13296
213,49,51,1,10.45,121.92,13295,13344
214,66,44,1,7.76,81.70,13343,13409
215,56,65,1,9.14,167.66,13408,13464
216,70,36,1,7.31,60.84,13463,13533
217,58,76,1,8.83,135.14,13532,13590
218,58,102,1,8.83,203.18,13589,13647
219,61,62,1,8.39,136.44,13646,13707
220,75,48,1,6.83,47.82,13706,13781
221,67,49,1,7.64,70.26,13780,13847
222,73,67,1,7.01,91.99,13846,13919
223,70,54,1,7.31,72.79,13918,13988
224,59,60,1,8.68,98.66,13987,14046
225,73,42,1,7.01,67.27,14045,14118
226,55,49,1,9.31,94.58,14117,14172
227,69,42,1,7.42,78.10,14171,14240
228,62,60,1,8.26,113.90,14239,14301
229,72,36,1,7.11,61.74,14300,14372
230,64,38,1,8.00,70.38,14372,14436
231,52,61,1,9.85,176.40,14435,14487
232,56,38,1,9.14,98.30,14486,14542
233,61,63,1,8.39,118.11,14541,14602
234,42,64,1,12.19,196.92,14601,14643
235,74,35,1,6.92,38.94,14642,14716
236,72,61,1,7.11,80.77,14715,14787
237,79,36,1,6.48,49.64,14787,14866
238,63,51,1,8.13,83.48,14865,14928
239,74,37,1,6.92,60.07,14927,15001
240,45,114,1,11.38,361.44,15000,15045
241,55,80,1,9.31,158.54,15044,15099
242,72,60,1,7.11,92.40,15098,15170
243,66,77,1,7.76,124.34,15169,15235
244,68,59,1,7.53,109.87,15234,15302
245,58,49,1,8.83,68.56,15301,15359
246,60,54,1,8.53,113.22,15359,15419
247,52,60,1,9.85,176.94,15418,15470
248,53,48,1,9.66,136.00,15469,15522
249,57,94,1,8.98,188.05,15521,15578
250,68,52,1,7.53,82.01,15577,15645
251,46,72,1,11.13,168.90,15644,15690
252,55,79,1,9.31,181.96,15689,15744
253,60,95,1,8.53,175.35,15743,15803
254,44,76,1,11.64,350.14,15802,15846
255,70,52,1,7.31,88.99,15845,15915
256,54,60,0,9.48,163.03,15914,15968
257,47,60,1,10.89,177.84,15967,16014
258,62,36,0,8.26,79.80,16013,16075
259,64,41,1,8.00,85.22,16074,16138
260,80,36,1,6.40,52.09,16137,16217
261,68,47,1,7.53,81.72,16216,16284
262,67,42,0,7.64,68.17,16283,16350
263,48,167,1,10.67,583.18,16349,16397
264,75,36,1,6.83,48.09,16396,16471
265,76,36,1,6.74,52.56,16470,16546
266,65,122,1,7.88,234.11,16545,16610
267,64,100,1,8.00,210.84,16609,16673
268,67,34,1,7.64,56.56,16672,16739
269,61,120,1,8.39,249.12,16738,16799
270,92,24,1,5.57,24.31,16799,16891
271,47,154,1,10.89,528.05,16890,16937
272,48,214,1,10.67,918.01,16936,16984
273,65,60,1,7.88,108.17,16983,17048
274,54,73,1,9.48,179.43,17047,17101
275,57,114,1,8.98,286.75,17100,17157
276,60,36,1,8.53,85.45,17156,17216
277,43,82,1,11.91,220.88,17215,17258
278,68,60,1,7.53,87.75,17257,17325
279,75,32,1,6.83,45.21,17324,17399
280,58,60,1,8.83,113.94,17398,17456
281,69,60,1,7.42,105.17,17455,17524
282,67,36,1,7.64,69.69,17523,17590
283,61,54,1,8.39,103.75,17589,17650
284,45,83,1,11.38,282.55,17649,17694
285,56,64,1,9.14,136.16,17693,17749
286,58,43,1,8.83,90.35,17748,17806
287,83,30,0,6.17,36.36,17805,17888
288,43,60,1,11.91,175.62,17887,17930
289,50,83,1,10.24,191.78,17929,17979
290,56,80,1,9.14,196.77,17978,18034
291,62,71,1,8.26,116.74,18033,18095
292,67,36,1,7.64,65.24,18095,18162
293,76,30,1,6.74,41.77,18161,18237
294,69,47,1,7.42,66.10,18236,18305
295,76,48,1,6.74,56.98,18305,18381
296,60,57,1,8.53,115.18,18380,18440
297,61,35,1,8.39,82.40,18439,18500
298,54,65,1,9.48,178.03,18499,18553
299,48,51,1,10.67,166.60,18552,18600
300,74,36,1,6.92,54.91,18600,18674
301,61,56,1,8.39,100.63,18673,18734
302,56,54,1,9.14,124.98,18733,18789
303,63,36,1,8.13,81.79,18788,18851
304,66,51,1,7.76,90.21,18850,18916
305,66,48,1,7.76,83.85,18915,18981
306,57,61,1,8.98,115.00,18980,19037
307,53,62,1,9.66,136.38,19036,19089
308,55,60,1,9.31,153.05,19088,19143
309,59,64,1,8.68,110.52,19143,19202
310,72,60,1,7.11,86.18,19202,19274
311,59,61,1,8.68,111.85,19273,19332
312,67,54,1,7.64,77.90,19331,19398
313,60,60,1,8.53,109.82,19397,19457
314,70,47,1,7.31,85.16,19456,19526
315,60,54,1,8.53,135.35,19525,19585
316,47,69,1,10.89,197.58,19584,19631
317,58,74,1,8.83,183.32,19630,19688
318,70,50,1,7.31,83.56,19687,19757
319,62,62,1,8.26,96.77,19756,19818
320,75,35,1,6.83,49.64,19817,19892
321,85,29,1,6.02,30.87,19891,19976
322,50,123,1,10.24,331.62,19975,20025
323,64,46,1,8.00,72.50,20024,20088
324,69,35,0,7.42,62.45,20087,20156
325,59,48,1,8.68,87.78,20155,20214
326,63,56,1,8.13,93.22,20213,20276
327,72,56,1,7.11,100.27,20275,20347
328,71,40,1,7.21,50.31,20346,20417
329,78,37,0,6.56,56.22,20416,20494
330,69,47,1,7.42,73.08,20493,20562
331,55,109,1,9.31,410.25,20561,20616
332,66,65,1,7.76,135.58,20616,20682
333,46,190,1,11.13,758.29,20681,20727
334,87,35,0,5.89,39.09,20727,20814
335,71,38,1,7.21,51.35,20813,20884
336,71,51,1,7.21,62.84,20883,20954
337,73,33,1,7.01,54.75,20953,21026
338,58,47,1,8.83,99.49,21025,21083
339,70,76,1,7.31,108.07,21083,21153
340,42,149,1,12.19,600.39,21152,21194
341,67,60,1,7.64,117.10,21193,21260
342,61,57,1,8.39,112.83,21259,21320
343,56,115,1,9.14,276.37,21319,21375
344,81,57,1,6.32,72.79,21374,21455
345,70,40,1,7.31,67.13,21454,21524
346,74,39,1,6.92,69.78,21524,21598
347,61,66,1,8.39,119.94,21597,21658
348,77,36,1,6.65,64.31,21657,21734
349,74,37,1,6.92,54.10,21734,21808
350,62,36,1,8.26,70.09,21807,21869
351,53,60,1,9.66,160.26,21869,21922
352,70,35,1,7.31,59.64,21921,21991
353,57,143,1,8.98,362.47,21990,22047
354,68,46,1,7.53,76.10,22046,22114
355,83,57,1,6.17,71.61,22114,22197
356,61,50,1,8.39,84.83,22196,22257
357,58,62,1,8.83,131.21,22256,22314
358,64,47,1,8.00,82.47,22313,22377
359,63,62,1,8.13,131.41,22376,22439
360,66,45,1,7.76,90.34,22438,22504
361,62,52,1,8.26,101.32,22503,22565
362,42,96,1,12.19,296.77,22565,22607
363,65,51,1,7.88,76.42,22606,22671
364,66,43,1,7.76,75.67,22670,22736
365,49,64,1,10.45,208.49,22735,22784
366,62,40,1,8.26,69.19,22783,22845
367,61,36,1,8.39,88.27,22845,22906
368,61,50,1,8.39,120.47,22905,22966
369,71,56,1,7.21,79.32,22966,23037
370,48,82,1,10.67,197.06,23036,23084
371,62,51,1,8.26,95.58,23083,23145
372,48,77,1,10.67,189.47,23144,23192
373,79,48,1,6.48,52.35,23191,23270
374,73,35,1,7.01,52.26,23269,23342
375,50,116,1,10.24,311.78,23341,23391
376,56,44,1,9.14,95.77,23390,23446
377,76,35,1,6.74,57.59,23446,23522
378,57,58,1,8.98,99.81,23521,23578
379,76,44,1,6.74,59.11,23578,23654
380,49,57,1,10.45,160.86,23653,23702
381,66,57,1,7.76,69.46,23701,23767
382,65,96,1,7.88,156.88,23766,23831
383,64,29,1,8.00,58.91,23830,23894
384,68,32,1,7.53,45.84,23894,23962
385,56,51,1,9.14,111.91,23961,24017
386,61,50,1,8.39,109.94,24016,24077
387,62,37,1,8.26,85.68,24077,24139
388,76,36,1,6.74,50.22,24138,24214
389,66,36,1,7.76,61.09,24213,24279
390,67,52,1,7.64,76.17,24278,24345
391,63,36,1,8.13,91.32,24344,24407
392,74,41,1,6.92,53.29,24406,24480
393,75,34,1,6.83,38.65,24479,24554
394,63,50,1,8.13,102.94,24553,24616
395,59,106,1,8.68,265.44,24615,24674
396,63,36,1,8.13,64.05,24673,24736
397,77,67,1,6.65,82.83,24735,24812
398,54,80,1,9.48,184.47,24811,24865
399,88,24,1,5.82,20.15,24864,24952
400,72,47,0,7.11,63.65,24951,25023
401,64,36,1,8.00,74.25,25022,25086
402,70,61,1,7.31,82.76,25085,25155
403,55,36,1,9.31,88.94,25154,25209
404,63,56,1,8.13,91.79,25208,25271
405,78,33,1,6.56,39.99,25270,25348
406,67,36,1,7.64,65.66,25347,25414
407,80,34,1,6.40,46.39,25414,25494
408,62,61,1,8.26,115.32,25493,25555
409,64,35,1,8.00,65.66,25554,25618
410,33,189,0,15.52,1141.04,25617,25650
411,62,42,1,8.26,70.16,25650,25712
412,93,35,1,5.51,29.30,25711,25804
413,45,105,1,11.38,442.19,25803,25848
414,65,39,1,7.88,83.52,25847,25912
415,43,71,1,11.91,189.71,25912,25955
416,65,54,1,7.88,76.63,25954,26019
417,65,36,1,7.88,61.49,26018,26083
418,62,39,1,8.26,61.64,26082,26144
419,66,60,1,7.76,109.06,26143,26209
420,65,36,1,7.88,79.74,26208,26273
421,48,52,1,10.67,180.85,26272,26320
422,64,55,1,8.00,115.34,26319,26383
423,61,102,1,8.39,193.68,26382,26443
424,63,60,1,8.13,105.51,26442,26505
425,67,43,1,7.64,75.33,26504,26571
426,86,24,1,5.95,23.58,26570,26656
427,60,51,1,8.53,100.52,26655,26715
428,58,72,1,8.83,149.28,26715,26773
429,59,83,1,8.68,211.24,26772,26831
430,85,34,0,6.02,40.23,26830,26915
431,77,28,1,6.65,33.94,26914,26991
432,57,90,1,8.98,186.05,26990,27047
433,63,53,1,8.13,104.65,27046,27109
434,75,33,1,6.83,49.10,27108,27183
435,72,36,1,7.11,59.85,27182,27254
436,76,36,1,6.74,47.04,27253,27329
437,57,43,1,8.98,97.74,27328,27385
438,61,37,1,8.39,74.70,27384,27445
439,64,48,1,8.00,82.28,27444,27508
440,69,39,1,7.42,81.78,27507,27576
441,69,39,1,7.42,72.45,27575,27644
442,41,150,1,12.49,585.23,27643,27684
443,60,47,1,8.53,70.25,27683,27743
444,62,46,1,8.26,88.45,27742,27804
445,48,56,1,10.67,146.81,27803,27851
446,64,89,1,8.00,150.19,27850,27914
447,71,75,1,7.21,105.15,27913,27984
448,73,53,1,7.01,87.58,27983,28056
449,70,47,1,7.31,71.99,28055,28125
450,48,68,1,10.67,227.93,28124,28172
451,61,108,1,8.39,247.45,28171,28232
452,70,61,1,7.31,85.53,28231,28301
453,57,59,1,8.98,93.81,28301,28358
454,49,90,1,10.45,287.10,28357,28406
455,76,54,1,6.74,72.06,28405,28481
456,47,103,1,10.89,278.10,28481,28528
457,69,48,1,7.42,89.92,28527,28596
458,70,35,1,7.31,60.87,28596,28666
459,74,48,1,6.92,66.97,28665,28739
460,80,31,1,6.40,46.12,28738,28818
461,66,44,1,7.76,83.00,28817,28883
462,55,60,1,9.31,138.94,28882,28937
463,51,97,1,10.04,221.10,28936,28987
464,51,80,1,10.04,186.04,28986,29037
465,50,93,1,10.24,255.54,29036,29086
466,69,37,1,7.42,73.17,29085,29154
467,52,51,1,9.85,139.05,29153,29205
468,61,56,1,8.39,82.63,29205,29266
469,55,101,1,9.31,316.29,29265,29320
470,52,49,1,9.85,138.48,29320,29372
471,60,51,1,8.53,114.55,29371,29431
472,70,44,1,7.31,70.13,29430,29500
473,72,62,1,7.11,72.77,29499,29571
474,59,54,1,8.68,120.49,29571,29630
475,69,42,1,7.42,71.26,29630,29699
476,65,48,1,7.88,83.58,29698,29763
477,71,37,1,7.21,55.91,29762,29833
478,51,152,1,10.04,475.92,29832,29883
479,79,35,1,6.48,39.72,29882,29961
480,60,36,1,8.53,84.28,29960,30020
481,77,45,1,6.65,59.76,30019,30096
482,78,97,1,6.56,148.14,30095,30173
483,56,60,0,9.14,129.23,30173,30229
484,75,48,1,6.83,58.52,30228,30303
485,61,52,1,8.39,103.32,30302,30363
486,69,54,1,7.42,63.23,30362,30431
487,58,102,1,8.83,194.25,30430,30488
488,70,36,1,7.31,65.62,30487,30557
489,67,36,1,7.64,73.33,30556,30623
490,68,68,1,7.53,97.46,30623,30691
491,71,44,1,7.21,62.25,30691,30762
492,67,50,1,7.64,71.36,30761,30828
493,48,43,1,10.67,138.18,30827,30875
494,59,53,1,8.68,132.35,30874,30933
495,72,32,1,7.11,52.10,30932,31004
496,61,51,1,8.39,92.70,31003,31064
497,62,51,1,8.26,108.32,31063,31125
498,41,98,1,12.49,411.52,31124,31165
499,71,38,1,7.21,73.49,31164,31235
500,52,53,1,9.85,120.44,31234,31286
501,58,44,1,8.83,75.49,31285,31343
502,73,64,1,7.01,72.53,31342,31415
503,61,69,1,8.39,137.91,31414,31475
504,81,37,0,6.32,50.39,31474,31555
505,54,83,1,9.48,176.73,31555,31609
506,59,51,1,8.68,96.69,31608,31667
507,49,155,1,10.45,563.64,31666,31715
508,70,32,1,7.31,45.44,31714,31784
509,78,56,1,6.56,62.91,31783,31861
510,35,195,1,14.63,1117.49,31860,31895
511,51,77,1,10.04,211.29,31894,31945
512,80,36,1,6.40,38.39,31944,32024
513,62,46,1,8.26,77.93,32023,32085
514,63,60,1,8.13,95.63,32084,32147
515,70,47,1,7.31,98.73,32147,32217
516,69,50,1,7.42,77.00,32216,32285
517,85,36,1,6.02,50.54,32285,32370
518,75,39,1,6.83,54.28,32370,32445
519,51,44,1,10.04,116.39,32444,32495
520,67,60,1,7.64,76.41,32494,32561
521,53,72,1,9.66,162.07,32560,32613
522,61,50,1,8.39,96.53,32612,32673
523,72,36,1,7.11,48.40,32672,32744
524,74,59,1,6.92,69.91,32743,32817
525,83,37,1,6.17,42.45,32816,32899
526,85,38,1,6.02,45.48,32898,32983
527,65,58,1,7.88,90.38,32982,33047
528,63,38,1,8.13,59.98,33046,33109
529,54,50,1,9.48,100.95,33109,33163
530,60,57,1,8.53,100.45,33163,33223
531,65,43,1,7.88,79.34,33222,33287
532,48,156,1,10.67,512.76,33287,33335
533,41,182,1,12.49,815.08,33334,33375
534,81,29,1,6.32,38.14,33374,33455
535,59,50,1,8.68,94.56,33454,33513
536,71,34,1,7.21,59.29,33512,33583
537,73,38,1,7.01,55.60,33582,33655
538,72,50,1,7.11,59.88,33654,33726
539,66,69,1,7.76,113.06,33725,33791
540,65,50,1,7.88,97.52,33790,33855
541,66,36,1,7.76,60.09,33854,33920
542,53,100,1,9.66,272.75,33920,33973
543,76,46,1,6.74,64.14,33972,34048
544,63,65,1,8.13,101.54,34047,34110
545,92,31,1,5.57,28.12,34109,34201
546,71,60,1,7.21,83.63,34200,34271
547,76,36,1,6.74,64.48,34270,34346
548,75,34,1,6.83,47.85,34345,34420
549,69,49,1,7.42,87.49,34419,34488
550,52,60,1,9.85,135.67,34487,34539
551,59,45,1,8.68,90.46,34538,34597
552,61,83,1,8.39,179.91,34597,34658
553,69,36,1,7.42,62.19,34657,34726
554,69,85,1,7.42,121.87,34725,34794
555,78,55,1,6.56,64.27,34793,34871
556,74,49,1,6.92,75.94,34870,34944
557,44,79,1,11.64,235.28,34943,34987
558,44,61,1,11.64,168.28,34987,35031
559,55,36,1,9.31,88.65,35031,35086
560,54,44,1,9.48,101.84,35085,35139
561,55,50,1,9.31,99.70,35138,35193
562,86,35,1,5.95,25.93,35192,35278
563,57,69,1,8.98,155.32,35277,35334
564,66,49,1,7.76,93.09,35333,35399
565,72,43,1,7.11,62.90,35399,35471
566,85,54,1,6.02,61.83,35470,35555
567,49,139,1,10.45,414.33,35555,35604
568,53,61,1,9.66,195.32,35603,35656
569,59,72,1,8.68,167.57,35656,35715
570,70,35,1,7.31,51.73,35715,35785
571,63,94,1,8.13,165.76,35784,35847
572,72,92,1,7.11,138.74,35846,35918
573,73,61,1,7.01,79.38,35917,35990
574,71,35,1,7.21,40.45,35989,36060
575,56,45,1,9.14,118.48,36059,36115
576,66,36,1,7.76,65.12,36114,36180
577,56,47,1,9.14,89.30,36179,36235
578,38,234,1,13.47,1382.72,36234,36272
579,73,87,1,7.01,121.38,36271,36344
580,73,68,1,7.01,86.23,36343,36416
581,66,68,1,7.76,100.73,36415,36481
582,57,86,1,8.98,180.16,36481,36538
583,61,44,1,8.39,78.34,36537,36598
584,53,62,1,9.66,165.92,36598,36651
585,61,56,1,8.39,87.32,36650,36711
586,80,38,1,6.40,44.74,36710,36790
587,62,54,1,8.26,101.58,36789,36851
588,77,60,1,6.65,74.72,36850,36927
589,72,36,1,7.11,61.15,36926,36998
590,72,53,1,7.11,62.24,36997,37069
591,67,85,1,7.64,135.51,37069,37136
592,66,49,1,7.76,98.40,37135,37201
593,59,36,1,8.68,61.68,37200,37259
594,61,58,1,8.39,100.40,37259,37320
595,69,60,1,7.42,88.01,37319,37388
596,87,36,1,5.89,43.50,37387,37474
597,68,52,1,7.53,88.19,37473,37541
598,60,36,1,8.53,77.02,37540,37600
599,51,157,1,10.04,627.57,37599,37650
600,66,36,1,7.76,75.12,37650,37716
601,55,94,1,9.31,208.72,37715,37770
602,65,50,1,7.88,75.52,37769,37834
603,57,34,1,8.98,78.23,37833,37890
604,56,50,1,9.14,89.52,37889,37945
605,60,57,1,8.53,95.18,37944,38004
606,35,110,1,14.63,532.23,38003,38038
607,51,44,1,10.04,130.86,38037,38088
608,56,57,1,9.14,121.41,38087,38143
609,56,48,1,9.14,108.23,38142,38198
610,62,52,1,8.26,115.71,38197,38259
611,31,243,1,16.52,1833.22,38258,38289
612,75,36,1,6.83,55.10,38288,38363
613,82,35,1,6.24,31.67,38362,38444
614,61,51,1,8.39,87.19,38443,38504
615,77,54,1,6.65,56.57,38503,38580
616,54,46,1,9.48,98.40,38579,38633
617,45,65,1,11.38,204.50,38632,38677
618,68,91,0,7.53,145.01,38676,38744
619,58,101,1,8.83,202.21,38743,38801
620,83,42,1,6.17,54.36,38800,38883
621,60,103,1,8.53,200.32,38882,38942
622,43,215,1,11.91,1048.13,38941,38984
623,73,58,1,7.01,62.64,38983,39056
624,49,79,1,10.45,227.35,39055,39104
625,78,38,1,6.56,43.76,39103,39181
626,69,42,1,7.42,67.08,39180,39249
627,56,64,1,9.14,106.80,39248,39304
628,71,70,1,7.21,110.73,39303,39374
629,54,36,1,9.48,106.06,39373,39427
630,75,41,1,6.83,57.56,39426,39501
631,56,132,1,9.14,385.27,39501,39557
632,48,96,1,10.67,229.68,39556,39604
633,81,36,1,6.32,44.34,39603,39684
634,56,36,1,9.14,102.62,39683,39739
635,67,36,1,7.64,60.35,39738,39805
636,68,36,1,7.53,66.46,39804,39872
637,77,49,1,6.65,62.44,39871,39948
638,65,92,1,7.88,153.43,39947,40012
639,66,40,1,7.76,77.03,40011,40077
640,44,63,1,11.64,151.10,40077,40121
641,57,82,1,8.98,211.35,40120,40177
642,64,60,1,8.00,108.78,40176,40240
643,64,54,1,8.00,117.47,40240,40304
644,64,52,1,8.00,87.09,40303,40367
645,71,36,1,7.21,61.88,40366,40437
646,61,53,0,8.39,99.78,40436,40497
647,58,38,1,8.83,78.11,40496,40554
648,74,57,1,6.92,69.24,40553,40627
649,69,36,1,7.42,65.00,40626,40695
650,73,64,1,7.01,65.63,40694,40767
651,47,50,0,10.89,153.07,40767,40814
652,74,37,1,6.92,66.78,40813,40887
653,73,58,1,7.01,80.18,40886,40959
654,75,32,1,6.83,48.46,40958,41033
655,66,60,1,7.76,96.40,41032,41098
656,55,46,1,9.31,97.23,41097,41152
657,70,48,1,7.31,65.70,41152,41222
658,51,69,1,10.04,156.94,41221,41272
659,61,145,1,8.39,348.89,41271,41332
660,59,52,1,8.68,105.74,41331,41390
661,55,57,1,9.31,124.61,41389,41444
662,71,55,1,7.21,88.67,41443,41514
663,54,107,1,9.48,248.43,41513,41567
664,82,31,1,6.24,29.40,41566,41648
665,67,62,1,7.64,88.41,41647,41714
666,70,49,1,7.31,81.07,41713,41783
667,68,45,1,7.53,70.37,41782,41850
668,71,105,1,7.21,215.94,41849,41920
669,54,36,1,9.48,98.51,41920,41974
670,63,42,1,8.13,68.14,41973,42036
671,56,36,1,9.14,78.34,42035,42091
672,79,49,1,6.48,64.00,42090,42169
673,76,39,1,6.74,49.04,42168,42244
674,53,43,1,9.66,127.32,42243,42296
675,74,36,1,6.92,55.24,42295,42369
676,57,55,1,8.98,105.42,42368,42425
677,62,36,1,8.26,64.93,42424,42486
678,82,36,1,6.24,42.43,42485,42567
679,61,50,1,8.39,97.22,42566,42627
680,76,36,1,6.74,52.35,42627,42703
681,67,38,1,7.64,80.77,42702,42769
682,77,48,1,6.65,60.80,42768,42845
683,65,60,1,7.88,84.72,42844,42909
684,85,36,1,6.02,48.56,42908,42993
685,73,31,1,7.01,47.66,42992,43065
686,57,60,1,8.98,126.26,43064,43121
687,77,37,1,6.65,39.19,43121,43198
688,65,73,1,7.88,113.12,43197,43262
689,53,60,1,9.66,120.15,43261,43314
690,37,108,1,13.84,427.65,43313,43350
691,61,35,1,8.39,55.48,43349,43410
692,66,36,1,7.76,84.73,43409,43475
693,71,36,1,7.21,51.12,43474,43545
694,48,95,1,10.67,272.10,43544,43592
695,55,72,1,9.31,155.45,43591,43646
696,84,35,1,6.10,44.23,43646,43730
697,62,53,1,8.26,95.64,43729,43791
698,82,49,1,6.24,58.70,43790,43872
699,62,38,1,8.26,95.90,43871,43933
700,67,51,1,7.64,107.30,43932,43999
701,65,58,1,7.88,106.51,43998,44063
702,66,50,1,7.76,77.55,44062,44128
703,68,36,1,7.53,75.48,44127,44195
704,64,43,1,8.00,84.41,44194,44258
705,56,41,1,9.14,98.02,44257,44313
706,68,36,0,7.53,82.66,44312,44380
707,67,53,1,7.64,94.11,44379,44446
708,57,60,1,8.98,118.89,44445,44502
709,68,36,1,7.53,50.87,44501,44569
710,73,36,1,7.01,53.22,44569,44642
711,63,49,1,8.13,87.95,44642,44705
712,49,71,1,10.45,232.90,44705,44754
713,76,27,1,6.74,33.01,44753,44829
714,65,53,1,7.88,112.48,44828,44893
715,62,50,1,8.26,101.09,44893,44955
716,71,61,1,7.21,96.73,44955,45026
717,60,62,1,8.53,126.22,45025,45085
718,60,41,1,8.53,90.68,45085,45145
719,71,36,1,7.21,61.55,45144,45215
720,53,60,1,9.66,143.88,45214,45267
721,59,55,1,8.68,109.20,45266,45325
722,64,75,1,8.00,152.41,45324,45388
723,70,40,1,7.31,75.24,45387,45457
724,67,52,1,7.64,81.33,45456,45523
725,68,35,1,7.53,58.54,45522,45590
726,73,62,1,7.01,88.34,45589,45662
727,75,57,1,6.83,64.78,45661,45736
728,71,36,1,7.21,64.19,45736,45807
729,82,35,1,6.24,45.45,45806,45888
730,46,60,1,11.13,204.59,45888,45934
731,70,59,1,7.31,78.99,45933,46003
732,67,49,1,7.64,85.75,46002,46069
733,77,31,0,6.65,48.18,46068,46145
734,35,84,1,14.63,424.52,46144,46179
735,71,35,1,7.21,57.60,46178,46249
736,71,36,1,7.21,68.05,46248,46319
737,74,63,1,6.92,83.89,46318,46392
738,54,66,1,9.48,129.29,46391,46445
739,84,36,1,6.10,35.97,46444,46528
740,63,36,1,8.13,68.52,46527,46590
741,65,56,1,7.88,102.14,46589,46654
742,63,47,1,8.13,85.73,46653,46716
743,49,182,1,10.45,650.45,46715,46764
744,50,49,1,10.24,100.22,46763,46813
745,55,86,1,9.31,172.83,46813,46868
746,75,35,1,6.83,49.50,46867,46942
747,73,48,1,7.01,66.70,46941,47014
748,60,48,1,8.53,101.68,47013,47073
749,77,38,1,6.65,45.89,47072,47149
750,66,52,1,7.76,76.03,47148,47214
751,58,48,1,8.83,99.76,47213,47271
752,58,58,1,8.83,92.11,47270,47328
753,69,42,1,7.42,63.17,47327,47396
754,57,81,1,8.98,171.46,47395,47452
755,72,35,1,7.11,49.79,47451,47523
756,77,36,1,6.65,46.64,47522,47599
757,73,36,1,7.01,45.11,47598,47671
758,62,59,1,8.26,116.61,47670,47732
759,29,107,1,17.66,702.16,47731,47760
760,56,109,1,9.14,247.44,47759,47815
761,56,60,1,9.14,151.05,47814,47870
762,65,33,1,7.88,54.72,47869,47934
763,67,72,1,7.64,146.41,47934,48001
764,74,46,1,6.92,65.10,48000,48074
765,68,36,1,7.53,75.28,48073,48141
766,54,102,1,9.48,249.14,48140,48194
767,50,63,1,10.24,143.46,48193,48243
768,51,46,1,10.04,124.23,48242,48293
769,66,48,1,7.76,92.18,48292,48358
770,61,36,1,8.39,82.40,48357,48418
771,52,70,1,9.85,166.86,48418,48470
772,63,43,1,8.13,77.16,48469,48532
773,67,60,1,7.64,94.80,48531,48598
774,46,90,1,11.13,295.55,48597,48643
775,83,35,0,6.17,42.69,48642,48725
776,58,50,1,8.83,101.52,48724,48782
777,66,60,1,7.76,118.52,48781,48847
778,55,51,1,9.31,111.89,48846,48901
779,54,60,1,9.48,130.21,48900,48954
780,63,40,1,8.13,89.89,48953,49016
781,72,35,1,7.11,49.99,49016,49088
782,49,68,1,10.45,191.31,49087,49136
783,48,62,1,10.67,181.93,49136,49184
784,51,69,1,10.04,172.19,49183,49234
785,75,46,1,6.83,51.74,49233,49308
786,70,60,1,7.31,70.19,49307,49377
787,73,36,1,7.01,58.70,49376,49449
788,76,36,1,6.74,45.22,49448,49524
789,54,122,1,9.48,273.88,49523,49577
790,55,109,1,9.31,254.87,49576,49631
791,74,35,0,6.92,44.18,49630,49704
792,76,39,0,6.74,49.93,49703,49779
793,73,61,1,7.01,85.77,49778,49851
794,58,49,1,8.83,97.94,49850,49908
795,56,52,1,9.14,125.77,49907,49963
796,63,36,1,8.13,78.24,49962,50025
797,73,48,1,7.01,80.51,50024,50097
798,64,62,1,8.00,107.53,50096,50160
799,72,36,0,7.11,38.04,50159,50231
800,80,36,1,6.40,35.32,50230,50310
801,68,43,1,7.53,63.10,50310,50378
802,59,61,1,8.68,114.90,50377,50436
803,55,119,1,9.31,304.03,50435,50490
804,68,60,1,7.53,82.63,50489,50557
805,81,36,0,6.32,43.58,50556,50637
806,53,60,1,9.66,137.73,50636,50689
807,74,36,1,6.92,59.89,50688,50762
808,66,44,1,7.76,82.52,50762,50828
809,80,29,1,6.40,30.21,50827,50907
810,63,47,1,8.13,57.70,50907,50970
811,59,62,1,8.68,157.57,50969,51028
812,50,52,1,10.24,132.34,51027,51077
813,72,36,1,7.11,51.71,51076,51148
814,68,36,1,7.53,62.84,51147,51215
815,86,28,1,5.95,30.81,51214,51300
816,61,48,1,8.39,93.71,51299,51360
817,58,88,1,8.83,168.38,51359,51417
818,62,59,1,8.26,100.71,51416,51478
819,64,36,1,8.00,50.66,51477,51541
820,82,24,1,6.24,27.62,51540,51622
821,68,62,1,7.53,106.22,51621,51689
822,74,32,1,6.92,42.99,51688,51762
823,67,38,1,7.64,70.86,51761,51828
824,58,41,1,8.83,73.04,51827,51885
825,74,58,1,6.92,65.89,51884,51958
826,58,50,1,8.83,81.35,51957,52015
827,75,67,1,6.83,64.01,52014,52089
828,74,36,1,6.92,65.67,52088,52162
829,71,71,1,7.21,112.84,52161,52232
830,72,61,1,7.11,64.63,52231,52303
831,78,61,1,6.56,101.07,52302,52380
832,48,83,1,10.67,223.31,52379,52427
833,71,52,1,7.21,75.38,52426,52497
834,54,67,1,9.48,177.32,52496,52550
835,75,79,1,6.83,108.68,52549,52624
836,64,58,1,8.00,95.66,52623,52687
837,72,60,1,7.11,95.49,52686,52758
838,65,41,1,7.88,84.48,52758,52823
839,57,36,1,8.98,79.67,52822,52879
840,63,36,1,8.13,72.52,52878,52941
841,57,59,1,8.98,135.35,52940,52997
842,42,59,1,12.19,210.01,52996,53038
843,56,45,1,9.14,95.37,53037,53093
844,76,36,1,6.74,50.69,53092,53168
845,39,77,1,13.13,268.78,53167,53206
846,69,51,1,7.42,74.65,53205,53274
847,68,61,1,7.53,88.96,53273,53341
848,63,42,1,8.13,90.40,53340,53403
849,54,36,0,9.48,111.14,53402,53456
850,61,36,1,8.39,70.34,53455,53516
851,63,81,1,8.13,174.81,53515,53578
852,42,132,1,12.19,503.49,53577,53619
853,83,36,1,6.17,41.20,53618,53701
854,49,70,0,10.45,187.43,53700,53749
855,56,57,1,9.14,102.87,53748,53804
856,53,53,1,9.66,120.07,53803,53856
857,66,36,1,7.76,76.43,53855,53921
858,45,103,1,11.38,336.10,53920,53965
859,75,64,1,6.83,89.66,53964,54039
860,60,48,1,8.53,92.45,54038,54098
861,67,36,1,7.64,69.30,54097,54164
862,71,45,1,7.21,62.53,54163,54234
863,67,47,0,7.64,79.33,54233,54300
864,57,96,1,8.98,197.56,54299,54356
865,47,65,1,10.89,154.31,54355,54402
866,54,189,1,9.48,674.47,54401,54455
867,67,38,1,7.64,66.38,54454,54521
868,67,52,1,7.64,67.48,54520,54587
869,72,49,1,7.11,69.54,54586,54658
870,79,20,1,6.48,24.71,54657,54736
871,69,51,1,7.42,75.40,54735,54804
872,68,57,1,7.53,104.28,54803,54871
873,55,77,1,9.31,126.07,54870,54925
874,56,36,1,9.14,100.44,54925,54981
875,56,61,1,9.14,139.44,54981,55037
876,59,55,1,8.68,101.81,55036,55095
877,60,91,1,8.53,182.22,55094,55154
878,74,31,1,6.92,41.83,55153,55227
879,73,36,1,7.01,54.18,55226,55299
880,66,52,1,7.76,85.55,55298,55364
881,54,35,1,9.48,97.95,55363,55417
882,56,36,1,9.14,86.02,55416,55472
883,52,62,1,9.85,135.32,55472,55524
884,72,60,1,7.11,77.99,55523,55595
885,70,46,1,7.31,76.73,55594,55664
886,50,53,1,10.24,169.70,55663,55713
887,74,36,1,6.92,57.94,55712,55786
888,63,50,1,8.13,126.43,55785,55848
889,62,48,1,8.26,90.09,55847,55909
890,65,62,1,7.88,135.68,55908,55973
891,67,45,1,7.64,66.47,55972,56039
892,77,35,1,6.65,46.72,56038,56115
893,82,68,1,6.24,83.79,56114,56196
894,58,56,1,8.83,120.73,56196,56254
895,62,86,1,8.26,196.22,56253,56315
896,66,36,1,7.76,56.97,56314,56380
897,72,47,1,7.11,62.49,56379,56451
898,65,39,1,7.88,63.77,56450,56515
899,67,101,1,7.64,167.13,56514,56581
900,91,30,1,5.63,23.40,56580,56671
901,51,55,0,10.04,137.49,56670,56721
902,48,80,1,10.67,216.76,56720,56768
903,46,203,1,11.13,870.59,56767,56813
904,56,40,1,9.14,87.80,56812,56868
905,52,57,1,9.85,180.09,56867,56919
906,65,55,1,7.88,126.42,56918,56983
907,70,31,1,7.31,44.02,56982,57052
908,54,60,1,9.48,129.95,57051,57105
909,55,99,1,9.31,227.09,57104,57159
910,65,36,1,7.88,68.82,57158,57223
911,63,40,1,8.13,82.71,57222,57285
912,61,35,1,8.39,69.55,57284,57345
913,73,45,1,7.01,74.56,57344,57417
914,67,82,1,7.64,141.96,57416,57483
915,61,61,1,8.39,113.58,57482,57543
916,69,34,1,7.42,40.62,57542,57611
917,57,36,1,8.98,79.98,57610,57667
918,78,33,1,6.56,37.60,57666,57744
919,51,41,1,10.04,126.90,57743,57794
920,67,43,1,7.64,76.17,57793,57860
921,73,55,0,7.01,73.58,57859,57932
922,70,56,1,7.31,83.73,57931,58001
923,57,30,1,8.98,70.86,58001,58058
924,50,100,1,10.24,252.90,58057,58107
925,75,72,1,6.83,117.64,58106,58181
926,76,50,1,6.74,76.54,58180,58256
927,84,36,1,6.10,40.44,58255,58339
928,73,38,1,7.01,61.55,58338,58411
929,66,97,1,7.76,148.79,58410,58476
930,65,36,1,7.88,71.06,58475,58540
931,64,72,1,8.00,127.81,58539,58603
932,69,35,1,7.42,67.75,58602,58671
933,66,84,1,7.76,145.21,58670,58736
934,73,36,0,7.01,71.14,58735,58808
935,70,36,1,7.31,57.59,58807,58877
936,80,63,1,6.40,78.94,58876,58956
937,68,37,1,7.53,56.63,58955,59023
938,45,96,1,11.38,291.44,59023,59068
939,49,70,1,10.45,227.96,59067,59116
940,55,64,1,9.31,172.69,59115,59170
941,64,66,1,8.00,109.97,59169,59233
942,62,71,1,8.26,143.29,59233,59295
943,80,36,1,6.40,58.59,59294,59374
944,48,60,1,10.67,178.51,59373,59421
945,66,35,1,7.76,53.70,59420,59486
946,60,69,1,8.53,143.88,59485,59545
947,48,62,1,10.67,173.31,59544,59592
948,43,241,1,11.91,1287.06,59591,59634
949,60,52,1,8.53,96.52,59633,59693
950,67,36,1,7.64,61.04,59692,59759
951,76,38,1,6.74,50.54,59758,59834
952,69,53,1,7.42,90.53,59833,59902
953,59,55,1,8.68,105.74,59901,59960
954,61,53,1,8.39,106.27,59959,60020
955,55,53,1,9.31,132.07,60019,60074
956,80,33,1,6.40,27.26,60074,60154
957,74,40,1,6.92,57.56,60153,60227
958,72,36,1,7.11,63.60,60226,60298
959,58,100,1,8.83,185.38,60298,60356
960,81,58,1,6.32,59.33,60355,60436
961,63,60,1,8.13,97.16,60436,60499
962,60,47,1,8.53,88.42,60498,60558
963,90,54,1,5.69,54.08,60558,60648
964,72,31,1,7.11,56.52,60647,60719
965,62,59,0,8.26,119.97,60718,60780
966,74,40,1,6.92,75.10,60779,60853
967,83,44,1,6.17,35.13,60852,60935
968,52,48,1,9.85,113.28,60934,60986
969,75,35,1,6.83,50.33,60985,61060
970,57,57,1,8.98,123.10,61060,61117
971,52,60,1,9.85,125.55,61116,61168
972,56,36,1,9.14,97.98,61167,61223
973,65,33,1,7.88,55.55,61222,61287
974,61,63,1,8.39,124.44,61286,61347
975,64,45,0,8.00,83.75,61346,61410
976,65,56,1,7.88,97.92,61409,61474
977,75,50,1,6.83,57.96,61473,61548
978,78,36,1,6.56,52.63,61548,61626
979,79,39,0,6.48,44.38,61625,61704
980,56,75,1,9.14,139.37,61703,61759
981,54,92,1,9.48,206.36,61758,61812
982,75,36,1,6.83,54.68,61811,61886
983,68,46,1,7.53,60.51,61885,61953
984,71,55,1,7.21,86.84,61952,62023
985,61,57,1,8.39,113.75,62022,62083
986,72,50,1,7.11,64.65,62083,62155
987,67,55,1,7.64,98.56,62154,62221
988,52,53,1,9.85,125.09,62220,62272
989,61,77,1,8.39,170.93,62272,62333
990,66,29,1,7.76,47.06,62332,62398
991,51,79,1,10.04,304.19,62398,62449
992,73,55,1,7.01,79.00,62448,62521
993,64,34,1,8.00,53.53,62520,62584
994,73,34,1,7.01,53.90,62583,62656
995,64,62,1,8.00,94.50,62656,62720
996,61,49,1,8.39,106.40,62719,62780
997,49,60,1,10.45,157.43,62779,62828
998,61,60,1,8.39,134.27,62827,62888
999,80,32,1,6.40,38.49,62887,62967
1000,69,28,1,7.42,46.01,62966,63035
1001,37,143,1,13.84,579.81,63034,63071
1002,55,91,1,9.31,186.03,63070,63125
1003,68,60,1,7.53,94.46,63124,63192
1004,79,36,0,6.48,46.50,63192,63271
1005,57,52,1,8.98,104.93,63270,63327
1006,56,95,1,9.14,272.80,63326,63382
1007,45,50,1,11.38,136.68,63381,63426
1008,65,53,1,7.88,93.37,63425,63490
1009,73,35,1,7.01,64.01,63489,63562
1010,79,35,1,6.48,31.14,63561,63640
1011,53,62,1,9.66,169.09,63639,63692
1012,58,97,1,8.83,234.07,63691,63749
1013,67,36,1,7.64,49.60,63749,63816
1014,62,49,1,8.26,76.32,63815,63877
1015,66,33,1,7.76,56.09,63876,63942
1016,67,79,1,7.64,133.51,63941,64008
1017,74,35,1,6.92,52.18,64007,64081
1018,53,50,1,9.66,122.75,64080,64133
1019,58,40,1,8.83,97.32,64132,64190
1020,69,36,1,7.42,58.21,64189,64258
1021,51,60,1,10.04,134.39,64257,64308
1022,42,60,1,12.19,186.49,64308,64350
1023,75,36,1,6.83,61.21,64349,64424
1024,67,35,1,7.64,66.20,64423,64490
1025,73,46,1,7.01,59.49,64490,64563
1026,43,147,1,11.91,514.36,64562,64605
1027,67,36,1,7.64,86.02,64604,64671
1028,70,36,1,7.31,60.30,64670,64740
1029,47,63,1,10.89,231.37,64739,64786
1030,65,40,1,7.88,65.37,64785,64850
1031,54,73,1,9.48,157.14,64849,64903
1032,78,52,1,6.56,63.02,64902,64980
1033,59,61,1,8.68,147.00,64979,65038
1034,75,62,1,6.83,86.17,65037,65112
1035,65,53,1,7.88,111.31,65111,65176
1036,51,48,1,10.04,116.19,65175,65226
1037,64,94,1,8.00,173.34,65225,65289
1038,65,42,1,7.88,74.05,65288,65353
1039,59,35,1,8.68,80.83,65352,65411
1040,76,28,1,6.74,42.59,65410,65486
1041,60,59,1,8.53,120.12,65485,65545
1042,70,35,1,7.31,72.22,65544,65614
1043,47,52,1,10.89,162.61,65614,65661
1044,72,75,0,7.11,111.68,65660,65732
1045,48,83,1,10.67,219.39,65732,65780
1046,76,31,1,6.74,37.80,65779,65855
1047,52,95,1,9.85,209.90,65854,65906
1048,64,36,1,8.00,71.62,65905,65969
1049,46,78,1,11.13,260.81,65968,66014
1050,66,36,1,7.76,83.79,66013,66079
1051,62,64,1,8.26,128.97,66078,66140
1052,64,54,1,8.00,92.31,66139,66203
1053,76,33,1,6.74,49.19,66202,66278
1054,56,45,1,9.14,95.37,66278,66334
1055,60,41,1,8.53,82.72,66333,66393
1056,64,36,1,8.00,51.41,66392,66456
1057,65,56,0,7.88,97.34,66455,66520
1058,53,62,0,9.66,158.34,66519,66572
1059,51,54,1,10.04,151.53,66571,66622
1060,69,37,1,7.42,69.49,66621,66690
1061,58,52,1,8.83,146.04,66689,66747
1062,56,64,1,9.14,163.77,66746,66802
1063,48,119,1,10.67,341.14,66801,66849
1064,53,73,1,9.66,194.68,66848,66901
1065,71,60,1,7.21,80.19,66900,66971
1066,61,44,1,8.39,105.65,66970,67031
1067,71,37,1,7.21,56.65,67030,67101
1068,73,37,1,7.01,47.16,67100,67173
1069,89,26,1,5.75,27.65,67172,67261
1070,47,93,1,10.89,278.01,67260,67307
1071,58,50,1,8.83,119.04,67307,67365
1072,57,36,1,8.98,66.16,67364,67421
1073,58,110,1,8.83,229.83,67420,67478
1074,70,36,1,7.31,68.47,67477,67547
1075,32,122,1,16.00,686.31,67547,67579
1076,53,167,1,9.66,502.90,67578,67631
1077,64,68,1,8.00,133.50,67630,67694
1078,66,36,1,7.76,66.55,67694,67760
1079,76,61,1,6.74,81.88,67759,67835
1080,63,80,1,8.13,152.52,67834,67897
1081,45,81,1,11.38,264.86,67896,67941
1082,56,89,1,9.14,185.23,67940,67996
1083,62,57,1,8.26,96.22,67995,68057
1084,59,180,1,8.68,539.68,68056,68115
1085,42,231,1,12.19,1295.01,68114,68156
1086,58,97,1,8.83,185.07,68155,68213
1087,63,36,1,8.13,72.94,68213,68276
1088,66,60,1,7.76,94.55,68276,68342
1089,53,60,1,9.66,137.28,68341,68394
1090,72,51,1,7.11,94.02,68393,68465
1091,66,35,1,7.76,66.64,68464,68530
1092,59,49,1,8.68,137.47,68529,68588
1093,74,36,1,6.92,54.67,68587,68661
1094,81,36,1,6.32,44.34,68660,68741
1095,67,70,1,7.64,105.16,68740,68807
1096,61,48,1,8.39,83.68,68806,68867
1097,52,72,1,9.85,158.51,68867,68919
1098,54,71,1,9.48,137.06,68918,68972
1099,55,100,1,9.31,213.56,68971,69026
1100,58,107,0,8.83,219.97,69025,69083
1101,65,50,1,7.88,89.52,69082,69147
1102,60,100,1,8.53,174.88,69146,69206
1103,48,70,1,10.67,218.85,69205,69253
1104,57,39,1,8.98,95.56,69252,69309
1105,66,60,1,7.76,111.61,69308,69374
1106,59,47,1,8.68,108.35,69373,69432
1107,61,40,1,8.39,89.68,69431,69492
1108,76,52,1,6.74,67.06,69491,69567
1109,64,36,1,8.00,64.81,69567,69631
1110,58,60,1,8.83,158.97,69630,69688
1111,68,86,1,7.53,121.96,69687,69755
1112,60,36,1,8.53,71.82,69754,69814
1113,56,58,1,9.14,118.34,69813,69869
1114,86,57,0,5.95,56.23,69868,69954
1115,54,101,1,9.48,256.51,69954,70008
1116,53,62,1,9.66,165.36,70007,70060
1117,67,61,1,7.64,93.04,70059,70126
1118,44,75,1,11.64,248.10,70125,70169
1119,61,76,1,8.39,138.96,70168,70229
1120,78,35,1,6.56,34.81,70228,70306
1121,53,58,1,9.66,178.07,70305,70358
1122,66,34,1,7.76,53.55,70357,70423
1123,52,111,1,9.85,314.98,70422,70474
1124,47,71,1,10.89,270.10,70473,70520
1125,67,60,1,7.64,75.96,70519,70586
1126,80,34,1,6.40,31.49,70586,70666
1127,63,72,1,8.13,112.36,70665,70728
1128,45,49,1,11.38,190.24,70728,70773
1129,57,50,1,8.98,118.54,70773,70830
1130,60,60,1,8.53,129.92,70830,70890
1131,76,36,1,6.74,60.98,70889,70965
1132,64,36,1,8.00,78.50,70964,71028
1133,69,82,1,7.42,142.30,71027,71096
1134,55,101,1,9.31,217.92,71095,71150
1135,63,43,1,8.13,79.38,71149,71212
1136,60,61,1,8.53,139.35,71211,71271
1137,76,36,1,6.74,54.01,71270,71346
1138,53,77,1,9.66,220.75,71345,71398
1139,57,104,1,8.98,217.53,71397,71454
1140,66,50,1,7.76,84.76,71453,71519
1141,52,36,1,9.85,89.55,71518,71570
1142,55,105,1,9.31,241.05,71569,71624
1143,38,131,1,13.47,527.72,71623,71661
1144,63,35,1,8.13,70.84,71660,71723
1145,49,81,1,10.45,186.49,71722,71771
1146,62,51,0,8.26,98.39,71771,71833
1147,59,35,1,8.68,66.59,71832,71891
1148,61,34,1,8.39,47.03,71890,71951
1149,69,49,1,7.42,73.14,71950,72019
1150,56,36,1,9.14,99.69,72018,72074
1151,69,46,1,7.42,83.20,72073,72142
1152,49,78,1,10.45,216.78,72141,72190
1153,53,77,1,9.66,202.56,72189,72242
1154,64,38,1,8.00,79.09,72242,72306
1155,68,60,1,7.53,83.84,72305,72373
1156,68,36,1,7.53,69.37,72372,72440
1157,59,40,1,8.68,65.51,72439,72498
1158,56,44,1,9.14,86.16,72497,72553
1159,73,36,1,7.01,67.14,72552,72625
1160,65,42,1,7.88,73.68,72624,72689
1161,62,50,1,8.26,76.35,72689,72751
1162,70,41,1,7.31,72.24,72750,72820
1163,57,36,1,8.98,69.32,72819,72876
1164,65,60,0,7.88,106.26,72875,72940
1165,59,81,1,8.68,212.66,72939,72998
1166,65,37,1,7.88,69.92,72997,73062
1167,50,63,1,10.24,163.46,73061,73111
1168,54,41,1,9.48,108.88,73110,73164
1169,56,45,1,9.14,97.34,73163,73219
1170,82,35,0,6.24,36.53,73218,73300
1171,43,163,1,11.91,639.39,73299,73342
1172,36,97,1,14.22,377.73,73341,73377
1173,81,36,1,6.32,36.64,73376,73457
1174,54,36,1,9.48,90.10,73457,73511
1175,64,42,1,8.00,93.09,73510,73574
1176,60,69,1,8.53,114.32,73573,73633
1177,68,42,1,7.53,63.25,73632,73700
1178,54,50,0,9.48,148.18,73699,73753
1179,77,42,1,6.65,57.60,73752,73829
1180,58,51,1,8.83,123.07,73828,73886
1181,85,36,1,6.02,28.12,73885,73970
1182,69,36,1,7.42,73.17,73969,74038
1183,68,51,1,7.53,64.98,74037,74105
1184,68,36,1,7.53,79.48,74104,74172
1185,64,59,1,8.00,108.34,74171,74235
1186,56,143,1,9.14,366.09,74234,74290
1187,55,60,1,9.31,138.87,74289,74344
1188,62,52,1,8.26,89.55,74343,74405
1189,41,65,1,12.49,192.49,74404,74445
1190,75,60,1,6.83,72.81,74444,74519
1191,47,52,1,10.89,177.67,74518,74565
1192,58,84,1,8.83,150.25,74564,74622
1193,62,63,1,8.26,107.64,74621,74683
1194,59,57,1,8.68,95.85,74682,74741
1195,81,31,1,6.32,41.01,74740,74821
1196,64,56,1,8.00,98.81,74821,74885
1197,41,55,1,12.49,222.74,74884,74925
1198,55,100,1,9.31,208.00,74924,74979
1199,56,80,1,9.14,186.52,74978,75034
1200,45,51,1,11.38,138.24,75033,75078
1201,45,63,1,11.38,177.04,75077,75122
1202,73,32,1,7.01,44.59,75121,75194
1203,97,24,1,5.28,23.71,75194,75291
1204,63,98,1,8.13,185.38,75290,75353
1205,34,120,1,15.06,554.82,75352,75386
1206,66,43,1,7.76,73.12,75385,75451
1207,67,36,1,7.64,60.14,75450,75517
1208,89,37,1,5.75,32.30,75517,75606
1209,76,47,1,6.74,62.67,75605,75681
1210,75,30,1,6.83,47.40,75680,75755
1211,67,48,1,7.64,86.02,75754,75821
1212,59,45,1,8.68,107.98,75820,75879
1213,57,108,1,8.98,224.51,75878,75935
1214,51,122,1,10.04,309.92,75934,75985
1215,85,36,1,6.02,44.23,75984,76069
1216,45,129,1,11.38,399.84,76068,76113
1217,54,53,1,9.48,122.81,76112,76166
1218,74,52,1,6.92,65.83,76166,76240
1219,74,35,1,6.92,51.07,76239,76313
1220,74,30,1,6.92,33.02,76312,76386
1221,58,88,1,8.83,189.18,76385,76443
1222,57,60,1,8.98,124.82,76442,76499
1223,57,48,1,8.98,103.63,76498,76555
1224,61,36,1,8.39,82.47,76554,76615
1225,52,35,1,9.85,96.09,76614,76666
1226,79,32,1,6.48,38.35,76665,76744
1227,62,73,1,8.26,149.51,76743,76805
1228,64,88,1,8.00,140.25,76804,76868
1229,94,34,1,5.45,35.63,76867,76961
1230,51,109,1,10.04,393.96,76960,77011
1231,65,57,1,7.88,73.31,77010,77075
1232,84,47,1,6.10,61.04,77074,77158
1233,76,35,1,6.74,42.09,77157,77233
1234,59,122,1,8.68,291.00,77232,77291
1235,53,68,1,9.66,187.92,77290,77343
1236,48,64,1,10.67,181.97,77342,77390
1237,64,37,1,8.00,63.62,77389,77453
1238,67,48,1,7.64,78.89,77452,77519
1239,54,75,1,9.48,200.88,77518,77572
1240,70,36,0,7.31,58.84,77571,77641
1241,59,76,1,8.68,155.30,77640,77699
1242,83,47,1,6.17,41.03,77698,77781
1243,73,39,1,7.01,66.07,77780,77853
1244,71,36,1,7.21,60.93,77852,77923
1245,53,60,0,9.66,174.19,77922,77975
1246,82,56,1,6.24,68.87,77974,78056
1247,77,40,1,6.65,43.24,78055,78132
1248,70,70,1,7.31,101.82,78131,78201
1249,81,34,1,6.32,33.33,78200,78281
1250,64,36,1,8.00,73.91,78280,78344
1251,61,61,1,8.39,116.53,78343,78404
1252,50,47,1,10.24,122.26,78403,78453
1253,68,36,1,7.53,54.57,78453,78521
1254,62,53,1,8.26,106.71,78521,78583
1255,74,48,1,6.92,58.24,78582,78656
1256,66,36,1,7.76,67.00,78655,78721
1257,70,36,1,7.31,52.27,78720,78790
1258,51,74,1,10.04,171.72,78789,78840
1259,71,36,1,7.21,46.98,78839,78910
1260,61,69,1,8.39,115.32,78909,78970
1261,75,25,1,6.83,37.32,78970,79045
1262,68,54,1,7.53,85.63,79044,79112
1263,56,49,1,9.14,115.30,79111,79167
1264,63,63,1,8.13,126.81,79166,79229
1265,62,82,1,8.26,149.97,79228,79290
1266,60,54,1,8.53,109.88,79289,79349
1267,64,44,1,8.00,77.91,79348,79412
1268,69,55,1,7.42,82.82,79411,79480
1269,70,52,1,7.31,83.19,79479,79549
1270,75,66,1,6.83,114.81,79548,79623
1271,52,96,1,9.85,259.67,79622,79674
1272,55,94,1,9.31,246.32,79673,79728
1273,87,35,1,5.89,37.04,79727,79814
1274,68,63,1,7.53,101.72,79813,79881
1275,68,90,1,7.53,155.10,79880,79948
1276,74,36,1,6.92,60.24,79947,80021
1277,66,37,1,7.76,66.09,80020,80086
1278,54,60,1,9.48,180.62,80085,80139
1279,63,36,1,8.13,93.29,80138,80201
1280,70,72,1,7.31,117.93,80201,80271
1281,66,83,1,7.76,155.15,80270,80336
1282,59,93,1,8.68,178.83,80335,80394
1283,74,106,1,6.92,157.75,80393,80467
1284,50,74,1,10.24,230.70,80466,80516
1285,58,100,1,8.83,186.45,80516,80574
1286,56,67,1,9.14,162.19,80573,80629
1287,75,49,1,6.83,64.22,80629,80704
1288,62,48,0,8.26,115.06,80703,80765
1289,71,52,1,7.21,95.29,80764,80835
1290,62,36,1,8.26,83.64,80834,80896
1291,72,36,1,7.11,53.88,80895,80967
1292,59,36,1,8.68,84.32,80966,81025
1293,70,36,1,7.31,57.67,81024,81094
1294,65,35,1,7.88,67.03,81093,81158
1295,78,60,1,6.56,84.09,81157,81235
1296,68,36,1,7.53,50.28,81234,81302
1297,69,44,1,7.42,71.87,81301,81370
1298,54,59,1,9.48,132.36,81369,81423
1299,53,53,1,9.66,153.32,81422,81475
1300,51,62,0,10.04,128.39,81474,81525
1301,76,35,1,6.74,39.59,81524,81600
1302,63,69,1,8.13,117.25,81599,81662
1303,45,70,1,11.38,193.75,81661,81706
1304,50,94,1,10.24,264.46,81705,81755
1305,43,128,1,11.91,470.97,81754,81797
1306,68,84,1,7.53,144.04,81796,81864
1307,61,36,1,8.39,69.19,81863,81924
1308,75,33,1,6.83,36.86,81923,81998
1309,37,90,1,13.84,414.73,81997,82034
1310,76,40,1,6.74,56.54,82034,82110
1311,70,50,1,7.31,65.99,82109,82179
1312,61,36,1,8.39,78.99,82178,82239
1313,43,159,1,11.91,582.64,82238,82281
1314,55,49,1,9.31,124.47,82280,82335
1315,49,108,1,10.45,300.29,82334,82383
1316,59,255,1,8.68,1056.32,82382,82441
1317,75,62,1,6.83,85.48,82440,82515
1318,64,69,1,8.00,135.44,82514,82578
1319,66,30,1,7.76,39.79,82578,82644
1320,70,49,1,7.31,71.82,82643,82713
1321,66,39,1,7.76,72.27,82712,82778
1322,60,67,1,8.53,124.92,82777,82837
1323,36,247,1,14.22,1623.28,82836,82872
1324,59,34,1,8.68,80.01,82871,82930
1325,64,63,1,8.00,106.50,82929,82993
1326,43,189,1,11.91,811.85,82992,83035
1327,60,65,1,8.53,122.62,83034,83094
1328,66,37,1,7.76,74.40,83093,83159
1329,41,186,1,12.49,822.69,83158,83199
1330,35,74,1,14.63,329.38,83198,83233
1331,54,49,1,9.48,95.66,83232,83286
1332,74,35,1,6.92,47.72,83285,83359
1333,82,51,1,6.24,58.38,83358,83440
1334,78,61,1,6.56,82.66,83439,83517
1335,62,51,1,8.26,92.77,83516,83578
1336,81,35,1,6.32,38.34,83577,83658
1337,62,62,1,8.26,104.61,83657,83719
1338,58,51,1,8.83,134.66,83718,83776
1339,82,36,1,6.24,44.94,83776,83858
1340,63,35,1,8.13,57.06,83857,83920
1341,67,60,1,7.64,81.13,83919,83986
1342,64,81,1,8.00,164.28,83986,84050
1343,80,62,1,6.40,66.27,84049,84129
1344,69,78,1,7.42,140.85,84129,84198
1345,41,76,1,12.49,258.74,84197,84238
1346,76,36,1,6.74,49.30,84237,84313
1347,57,91,1,8.98,194.16,84312,84369
1348,72,36,1,7.11,60.60,84368,84440
1349,72,36,1,7.11,68.68,84439,84511
1350,66,36,1,7.76,57.58,84511,84577
1351,105,21,1,4.88,12.83,84576,84681
1352,56,51,1,9.14,120.27,84680,84736
1353,67,93,1,7.64,196.32,84735,84802
1354,60,36,1,8.53,81.58,84801,84861
1355,48,120,1,10.67,341.89,84860,84908
1356,58,51,1,8.83,106.14,84907,84965
1357,61,36,1,8.39,72.93,84964,85025
1358,48,55,1,10.67,144.51,85024,85072
1359,59,44,1,8.68,87.44,85071,85130
1360,90,36,1,5.69,30.59,85129,85219
1361,74,71,1,6.92,98.75,85218,85292
1362,56,127,1,9.14,336.27,85291,85347
1363,74,34,1,6.92,60.24,85346,85420
1364,72,35,1,7.11,56.74,85419,85491
1365,57,49,1,8.98,133.81,85490,85547
1366,62,39,1,8.26,94.87,85547,85609
1367,67,60,1,7.64,128.77,85608,85675
1368,71,60,1,7.21,91.91,85674,85745
1369,71,38,1,7.21,73.12,85744,85815
1370,81,50,0,6.32,55.97,85814,85895
1371,43,85,1,11.91,244.92,85895,85938
1372,72,36,1,7.11,56.93,85938,86010
1373,63,40,1,8.13,75.19,86009,86072
1374,63,48,1,8.13,98.30,86071,86134
1375,67,57,1,7.64,88.86,86133,86200
1376,59,36,1,8.68,63.81,86199,86258
1377,35,247,1,14.63,1711.78,86258,86293
1378,80,43,1,6.40,61.29,86293,86373
1379,61,96,1,8.39,198.01,86373,86434
1380,68,68,1,7.53,91.69,86433,86501
1381,68,32,1,7.53,54.31,86500,86568
1382,46,82,1,11.13,258.50,86567,86613
1383,41,61,1,12.49,235.52,86612,86653
1384,64,84,1,8.00,150.50,86652,86716
1385,33,231,1,15.52,1532.31,86715,86748
1386,74,41,1,6.92,61.10,86747,86821
1387,76,36,1,6.74,51.04,86820,86896
1388,70,35,1,7.31,80.02,86895,86965
1389,49,95,1,10.45,229.76,86964,87013
1390,55,82,1,9.31,161.92,87012,87067
1391,79,43,1,6.48,49.46,87066,87145
1392,47,89,1,10.89,261.33,87144,87191
1393,60,61,1,8.53,133.85,87190,87250
1394,83,34,1,6.17,38.45,87249,87332
1395,55,186,1,9.31,625.20,87331,87386
1396,55,98,1,9.31,236.03,87385,87440
1397,54,68,1,9.48,163.14,87439,87493
1398,42,165,1,12.19,657.87,87492,87534
1399,68,41,1,7.53,74.78,87533,87601
1400,68,49,1,7.53,87.98,87600,87668
1401,62,57,1,8.26,125.71,87667,87729
1402,75,35,1,6.83,58.65,87728,87803
1403,60,50,1,8.53,115.22,87802,87862
1404,46,68,1,11.13,140.16,87861,87907
1405,67,35,1,7.64,53.01,87906,87973
1406,57,53,1,8.98,117.35,87972,88029
1407,72,50,1,7.11,70.18,88028,88100
1408,61,76,1,8.39,153.12,88099,88160
1409,67,60,1,7.64,116.02,88159,88226
1410,42,106,1,12.19,408.58,88225,88267
1411,68,46,1,7.53,72.72,88266,88334
1412,66,80,1,7.76,116.88,88333,88399
1413,60,36,1,8.53,75.75,88398,88458
1414,52,53,1,9.85,119.21,88457,88509
1415,55,97,1,9.31,205.63,88508,88563
1416,59,62,1,8.68,112.59,88562,88621
1417,55,55,1,9.31,126.94,88620,88675
1418,45,77,1,11.38,204.15,88674,88719
1419,60,65,1,8.53,103.85,88719,88779
1420,60,50,1,8.53,105.65,88778,88838
1421,66,61,1,7.76,108.67,88837,88903
1422,58,55,1,8.83,85.11,88902,88960
1423,76,36,1,6.74,50.17,88959,89035
1424,53,64,1,9.66,126.56,89034,89087
1425,41,82,1,12.49,262.49,89087,89128
1426,46,49,1,11.13,157.64,89127,89173
1427,73,45,1,7.01,74.59,89172,89245
1428,71,38,1,7.21,72.50,89245,89316
1429,67,60,1,7.64,102.53,89316,89383
1430,62,99,1,8.26,193.48,89382,89444
1431,47,93,1,10.89,257.54,89443,89490
1432,60,41,1,8.53,95.12,89489,89549
1433,67,54,1,7.64,86.83,89548,89615
1434,46,55,1,11.13,170.37,89614,89660
1435,71,36,1,7.21,47.63,89659,89730
1436,66,55,1,7.76,89.49,89729,89795
1437,72,35,1,7.11,46.54,89794,89866
1438,75,36,1,6.83,38.25,89865,89940
1439,39,99,1,13.13,343.09,89939,89978
1440,61,83,1,8.39,156.80,89977,90038
1441,73,36,1,7.01,45.33,90037,90110
1442,70,69,1,7.31,112.50,90110,90180
1443,61,70,1,8.39,124.14,90179,90240
1444,70,60,1,7.31,84.22,90240,90310
1445,88,43,1,5.82,44.06,90309,90397
1446,72,53,1,7.11,70.82,90396,90468
1447,58,51,0,8.83,95.52,90467,90525
1448,74,60,0,6.92,82.91,90524,90598
1449,58,75,1,8.83,138.56,90597,90655
1450,68,57,1,7.53,96.72,90654,90722
1451,62,64,1,8.26,123.84,90721,90783
1452,61,72,1,8.39,121.55,90783,90844
1453,87,31,1,5.89,33.69,90843,90930
1454,51,99,1,10.04,320.63,90929,90980
1455,78,31,1,6.56,37.73,90979,91057
1456,37,133,1,13.84,627.43,91056,91093
1457,63,92,1,8.13,171.89,91092,91155
1458,55,89,1,9.31,186.40,91155,91210
1459,75,31,1,6.83,41.26,91209,91284
1460,73,39,1,7.01,59.11,91283,91356
1461,58,63,1,8.83,148.63,91355,91413
1462,67,41,1,7.64,74.98,91412,91479
1463,59,60,1,8.68,105.81,91478,91537
1464,62,36,1,8.26,65.32,91536,91598
1465,67,58,1,7.64,104.62,91597,91664
1466,82,60,1,6.24,55.18,91663,91745
1467,53,60,1,9.66,134.87,91744,91797
1468,76,53,1,6.74,70.80,91796,91872
1469,53,36,1,9.66,94.11,91871,91924
1470,78,37,1,6.56,55.12,91923,92001
1471,80,52,1,6.40,56.89,92000,92080
1472,59,69,1,8.68,133.71,92080,92139
1473,67,44,1,7.64,70.08,92138,92205
1474,45,101,1,11.38,252.55,92204,92249
1475,64,34,1,8.00,59.34,92248,92312
1476,82,43,1,6.24,47.57,92311,92393
1477,70,36,1,7.31,55.07,92392,92462
1478,82,54,1,6.24,46.70,92461,92543
1479,54,138,1,9.48,368.99,92543,92597
1480,64,65,1,8.00,115.75,92596,92660
1481,72,67,1,7.11,78.99,92660,92732
1482,54,54,1,9.48,170.36,92731,92785
1483,64,45,1,8.00,83.16,92784,92848
1484,75,57,1,6.83,65.56,92848,92923
1485,86,41,1,5.95,44.04,92922,93008
1486,71,33,1,7.21,51.35,93007,93078
1487,31,147,1,16.52,836.70,93077,93108
1488,73,37,1,7.01,67.99,93107,93180
1489,77,47,1,6.65,55.19,93179,93256
1490,59,99,1,8.68,232.83,93255,93314
1491,51,92,1,10.04,245.68,93313,93364
1492,77,36,1,6.65,40.64,93364,93441
1493,81,43,1,6.32,57.92,93440,93521
1494,62,64,1,8.26,143.16,93520,93582
1495,46,101,1,11.13,369.24,93581,93627
1496,45,86,0,11.38,280.72,93626,93671
1497,72,65,1,7.11,100.71,93670,93742
1498,58,46,1,8.83,79.56,93741,93799
1499,62,51,1,8.26,94.13,93798,93860
1500,61,67,1,8.39,148.24,93859,93920
1501,41,66,1,12.49,245.52,93919,93960
1502,81,69,1,6.32,72.34,93960,94041
1503,48,69,1,10.67,175.10,94040,94088
1504,53,53,1,9.66,109.09,94087,94140
1505,61,56,1,8.39,106.63,94139,94200
1506,58,43,1,8.83,105.04,94199,94257
1507,48,77,1,10.67,249.22,94256,94304
1508,69,42,1,7.42,59.63,94303,94372
1509,48,167,0,10.67,592.22,94371,94419
1510,67,36,1,7.64,53.39,94419,94486
1511,69,48,1,7.42,81.69,94485,94554
1512,36,149,1,14.22,689.28,94553,94589
1513,45,45,1,11.38,128.50,94588,94633
1514,70,45,1,7.31,62.27,94632,94702
1515,60,86,1,8.53,161.72,94701,94761
1516,30,110,1,17.07,580.66,94760,94790
1517,73,60,1,7.01,93.25,94790,94863
1518,74,36,1,6.92,63.78,94862,94936
1519,59,62,1,8.68,111.64,94935,94994
1520,68,36,1,7.53,50.07,94993,95061
1521,50,101,1,10.24,237.54,95060,95110
1522,52,54,1,9.85,145.40,95109,95161
1523,58,44,1,8.83,87.32,95160,95218
1524,44,96,0,11.64,352.87,95217,95261
1525,50,68,1,10.24,163.30,95260,95310
1526,65,39,1,7.88,81.09,95309,95374
1527,61,66,1,8.39,101.45,95373,95434
1528,75,87,1,6.83,116.62,95433,95508
1529,73,36,1,7.01,51.77,95507,95580
1530,67,50,1,7.64,90.53,95579,95646
1531,52,95,1,9.85,199.98,95645,95697
1532,58,55,1,8.83,128.59,95696,95754
1533,47,125,1,10.89,363.92,95753,95800
1534,77,25,1,6.65,26.67,95799,95876
1535,79,36,1,6.48,43.77,95875,95954
1536,67,54,1,7.64,98.53,95953,96020
1537,36,157,1,14.22,799.17,96019,96055
1538,76,53,1,6.74,71.88,96054,96130
1539,63,36,1,8.13,69.16,96129,96192
1540,65,62,1,7.88,108.66,96191,96256
1541,63,65,1,8.13,94.71,96255,96318
1542,70,34,1,7.31,51.47,96317,96387
1543,75,36,1,6.83,57.90,96386,96461
1544,63,60,1,8.13,85.51,96460,96523
1545,56,36,1,9.14,97.48,96522,96578
1546,66,60,1,7.76,109.76,96577,96643
1547,63,36,1,8.13,71.70,96643,96706
1548,66,35,1,7.76,59.76,96705,96771
1549,77,50,0,6.65,69.97,96770,96847
1550,73,36,1,7.01,50.59,96846,96919
1551,62,48,1,8.26,71.64,96919,96981
1552,51,64,1,10.04,202.67,96980,97031
1553,68,46,1,7.53,71.81,97030,97098
1554,75,55,1,6.83,63.88,97098,97173
1555,88,35,1,5.82,34.85,97172,97260
1556,36,196,1,14.22,1062.51,97260,97296
1557,49,45,1,10.45,125.19,97295,97344
1558,53,79,1,9.66,168.83,97343,97396
1559,63,46,1,8.13,91.19,97396,97459
1560,53,52,1,9.66,116.60,97458,97511
1561,72,58,1,7.11,76.63,97511,97583
1562,76,36,1,6.74,40.40,97582,97658
1563,46,225,1,11.13,1051.20,97658,97704
1564,55,72,1,9.31,159.70,97703,97758
1565,70,34,1,7.31,45.42,97757,97827
1566,57,49,1,8.98,112.23,97826,97883
1567,68,35,1,7.53,60.60,97882,97950
1568,77,39,1,6.65,49.11,97949,98026
1569,53,61,1,9.66,159.58,98025,98078
1570,65,40,1,7.88,74.26,98078,98143
1571,74,48,1,6.92,61.10,98143,98217
1572,68,35,1,7.53,51.43,98216,98284
1573,62,71,1,8.26,138.97,98283,98345
1574,87,35,1,5.89,42.49,98344,98431
1575,68,35,1,7.53,65.57,98430,98498
1576,65,36,1,7.88,76.78,98497,98562
1577,64,40,1,8.00,73.53,98562,98626
1578,59,36,1,8.68,96.73,98625,98684
1579,52,38,1,9.85,108.36,98683,98735
1580,63,35,0,8.13,65.38,98734,98797
1581,66,82,1,7.76,125.24,98796,98862
1582,56,61,1,9.14,133.27,98861,98917
1583,52,53,1,9.85,136.75,98917,98969
1584,54,36,1,9.48,100.95,98968,99022
1585,66,68,1,7.76,122.43,99021,99087
1586,77,36,1,6.65,43.53,99086,99163
1587,64,76,1,8.00,169.03,99162,99226
1588,57,101,1,8.98,269.53,99225,99282
1589,84,48,1,6.10,44.78,99281,99365
1590,69,47,1,7.42,65.06,99364,99433
1591,44,60,1,11.64,221.64,99432,99476
1592,42,100,1,12.19,412.77,99475,99517
1593,51,167,1,10.04,576.90,99516,99567
1594,56,56,1,9.14,127.02,99566,99622
1595,84,44,1,6.10,49.09,99621,99705
1596,54,45,1,9.48,122.95,99705,99759
1597,54,69,1,9.48,206.21,99758,99812
1598,44,40,1,11.64,132.55,99811,99855
1599,59,50,1,8.68,80.22,99854,99913
1600,55,49,1,9.31,89.81,99912,99967
1601,61,53,1,8.39,81.55,99966,100027
1602,63,99,1,8.13,184.59,100026,100089
1603,55,40,1,9.31,90.25,100088,100143
1604,68,66,1,7.53,111.98,100143,100211
1605,65,65,1,7.88,92.23,100210,100275
1606,67,57,1,7.64,99.21,100274,100341
1607,44,70,1,11.64,306.64,100340,100384
1608,49,62,1,10.45,174.82,100383,100432
1609,84,50,1,6.10,51.51,100431,100515
1610,66,39,1,7.76,71.18,100514,100580
1611,51,53,1,10.04,111.76,100579,100630
1612,90,34,1,5.69,31.53,100629,100719
1613,54,57,1,9.48,140.10,100718,100772
1614,44,57,1,11.64,159.73,100771,100815
1615,51,79,1,10.04,165.37,100814,100865
1616,56,36,1,9.14,74.66,100864,100920
1617,53,52,1,9.66,104.30,100919,100972
1618,70,57,1,7.31,66.87,100971,101041
1619,83,36,1,6.17,53.85,101041,101124
1620,49,111,1,10.45,316.66,101123,101172
1621,61,56,1,8.39,100.99,101171,101232
1622,56,98,0,9.14,240.52,101231,101287
1623,44,48,1,11.64,127.96,101286,101330
1624,48,98,1,10.67,271.31,101329,101377
1625,50,109,1,10.24,316.38,101376,101426
1626,51,120,1,10.04,301.14,101425,101476
1627,54,39,1,9.48,109.29,101475,101529
1628,51,99,1,10.04,277.49,101528,101579
1629,59,36,1,8.68,76.22,101578,101637
1630,65,34,1,7.88,63.22,101636,101701
1631,48,51,2,10.67,153.35,101700,101748
1632,66,50,1,7.76,100.30,101747,101813
1633,70,47,1,7.31,65.27,101813,101883
1634,70,44,1,7.31,58.87,101882,101952
1635,82,56,1,6.24,85.70,101951,102033
1636,59,101,1,8.68,233.03,102032,102091
1637,49,109,1,10.45,400.00,102090,102139
1638,60,50,1,8.53,122.28,102138,102198
1639,77,40,1,6.65,43.81,102197,102274
1640,42,74,1,12.19,203.58,102273,102315
1641,77,42,1,6.65,62.80,102314,102391
1642,56,72,1,9.14,134.44,102391,102447
1643,79,78,1,6.48,99.26,102446,102525
1644,53,81,1,9.66,167.58,102524,102577
1645,42,67,1,12.19,231.92,102576,102618
1646,78,36,1,6.56,56.66,102617,102695
1647,60,98,1,8.53,186.78,102695,102755
1648,56,106,1,9.14,221.98,102754,102810
1649,66,52,1,7.76,89.34,102809,102875
1650,68,36,1,7.53,59.48,102874,102942
1651,83,33,1,6.17,41.10,102941,103024
1652,67,54,1,7.64,86.17,103024,103091
1653,52,36,1,9.85,85.48,103091,103143
1654,65,46,1,7.88,93.71,103142,103207
1655,77,52,1,6.65,70.25,103206,103283
1656,65,60,1,7.88,93.80,103282,103347
1657,61,36,1,8.39,58.11,103346,103407
1658,59,70,1,8.68,149.40,103406,103465
1659,55,65,1,9.31,155.38,103464,103519
1660,61,37,1,8.39,80.83,103519,103580
1661,67,89,0,7.64,165.51,103579,103646
1662,67,38,1,7.64,75.45,103645,103712
1663,64,68,1,8.00,99.19,103711,103775
1664,65,43,1,7.88,78.45,103774,103839
1665,50,57,1,10.24,111.22,103838,103888
1666,63,61,1,8.13,93.13,103887,103950
1667,64,59,1,8.00,133.84,103950,104014
1668,72,45,1,7.11,52.63,104013,104085
1669,54,83,1,9.48,194.88,104084,104138
1670,66,77,1,7.76,130.30,104137,104203
1671,53,60,1,9.66,126.94,104202,104255
1672,53,49,1,9.66,113.62,104255,104308
1673,80,24,1,6.40,26.41,104307,104387
1674,60,75,1,8.53,152.15,104386,104446
1675,59,52,1,8.68,135.10,104445,104504
1676,70,56,1,7.31,75.70,104503,104573
1677,59,36,1,8.68,72.49,104573,104632
1678,62,82,1,8.26,133.06,104632,104694
1679,64,47,1,8.00,86.81,104693,104757
1680,65,70,1,7.88,139.09,104756,104821
1681,72,54,1,7.11,89.93,104820,104892
1682,50,55,1,10.24,139.42,104892,104942
1683,60,42,1,8.53,82.42,104941,105001
1684,65,108,1,7.88,199.09,105000,105065
1685,54,57,1,9.48,136.77,105064,105118
1686,63,91,1,8.13,174.71,105117,105180
1687,65,64,1,7.88,114.05,105179,105244
1688,60,43,1,8.53,77.72,105243,105303
1689,60,104,1,8.53,196.35,105303,105363
1690,70,41,1,7.31,65.39,105362,105432
1691,62,45,1,8.26,82.77,105431,105493
1692,65,54,1,7.88,93.95,105492,105557
1693,56,36,1,9.14,88.69,105557,105613
1694,72,36,1,7.11,56.90,105612,105684
1695,71,38,0,7.21,52.17,105684,105755
1696,83,49,1,6.17,46.16,105755,105838
1697,49,84,1,10.45,199.31,105837,105886
1698,81,36,1,6.32,50.71,105885,105966
1699,52,84,1,9.85,235.48,105965,106017
1700,66,47,1,7.76,74.97,106016,106082
1701,62,50,1,8.26,96.22,106081,106143
1702,81,52,1,6.32,74.74,106142,106223
1703,62,36,1,8.26,76.16,106222,106284
1704,65,57,1,7.88,97.22,106283,106348
1705,48,68,1,10.67,179.89,106347,106395
1706,77,36,1,6.65,51.37,106394,106471
1707,75,49,0,6.83,63.02,106470,106545
1708,75,52,1,6.83,67.69,106544,106619
1709,66,48,1,7.76,53.34,106618,106684
1710,77,43,0,6.65,51.63,106683,106760
1711,55,49,1,9.31,116.58,106759,106814
1712,56,103,1,9.14,209.16,106813,106869
1713,61,65,1,8.39,139.22,106868,106929
1714,60,56,1,8.53,109.35,106929,106989
1715,70,39,1,7.31,67.07,106988,107058
1716,65,50,1,7.88,96.51,107057,107122
1717,64,48,1,8.00,82.03,107121,107185
1718,67,69,1,7.64,125.75,107184,107251
1719,53,61,1,9.66,129.39,107250,107303
1720,65,62,1,7.88,84.29,107302,107367
1721,78,35,1,6.56,48.45,107366,107444
1722,43,100,0,11.91,300.27,107443,107486
1723,61,81,1,8.39,180.44,107485,107546
1724,60,52,1,8.53,100.92,107545,107605
1725,65,61,1,7.88,103.83,107604,107669
1726,68,36,1,7.53,71.90,107669,107737
1727,79,60,1,6.48,72.07,107736,107815
1728,67,65,1,7.64,115.19,107814,107881
1729,59,60,1,8.68,125.95,107880,107939
1730,82,36,1,6.24,29.26,107938,108020
1731,72,66,1,7.11,103.43,108020,108092
1732,67,50,1,7.64,87.78,108092,108159
1733,61,65,1,8.39,134.89,108158,108219
1734,59,55,1,8.68,115.88,108219,108278
1735,57,62,1,8.98,114.79,108277,108334
1736,68,44,1,7.53,60.69,108333,108401
1737,65,71,1,7.88,120.91,108400,108465
1738,61,36,1,8.39,87.32,108464,108525
1739,66,35,1,7.76,62.37,108524,108590
1740,64,42,1,8.00,64.09,108589,108653
1741,80,32,1,6.40,38.09,108652,108732
1742,70,60,0,7.31,93.70,108731,108801
1743,67,36,1,7.64,63.33,108800,108867
1744,70,61,1,7.31,113.42,108866,108936
1745,80,33,1,6.40,41.79,108935,109015
1746,54,52,1,9.48,103.99,109014,109068
1747,81,109,1,6.32,156.56,109067,109148
1748,73,36,1,7.01,49.25,109147,109220
1749,83,34,1,6.17,28.07,109219,109302
1750,59,108,1,8.68,267.85,109301,109360
1751,83,33,1,6.17,44.79,109359,109442
1752,67,36,1,7.64,59.07,109441,109508
1753,70,35,1,7.31,53.59,109507,109577
1754,48,120,1,10.67,469.60,109576,109624
1755,66,38,0,7.76,76.15,109623,109689
1756,64,46,1,8.00,81.56,109688,109752
1757,54,54,1,9.48,156.51,109751,109805
1758,53,36,1,9.66,69.81,109804,109857
1759,28,197,1,18.29,1351.92,109856,109884
1760,55,51,1,9.31,137.78,109883,109938
1761,59,77,1,8.68,149.20,109937,109996
1762,63,39,1,8.13,90.52,109995,110058
1763,61,100,1,8.39,200.57,110057,110118
1764,62,36,1,8.26,75.77,110117,110179
1765,58,95,1,8.83,193.42,110178,110236
1766,99,49,1,5.17,35.19,110235,110334
1767,51,44,1,10.04,111.88,110334,110385
1768,67,36,1,7.64,56.11,110384,110451
1769,68,41,1,7.53,71.31,110450,110518
1770,51,54,1,10.04,134.55,110518,110569
1771,65,39,1,7.88,63.22,110568,110633
1772,59,60,1,8.68,147.64,110632,110691
1773,66,45,1,7.76,81.18,110690,110756
1774,49,64,1,10.45,166.82,110755,110804
1775,44,80,1,11.64,245.50,110803,110847
1776,69,36,1,7.42,74.79,110846,110915
1777,75,36,1,6.83,44.22,110915,110990
1778,78,33,0,6.56,32.19,110989,111067
1779,79,33,1,6.48,41.67,111066,111145
1780,75,33,1,6.83,54.89,111145,111220
1781,62,100,1,8.26,182.74,111220,111282
1782,64,36,1,8.00,72.94,111281,111345
1783,57,51,1,8.98,109.46,111344,111401
1784,54,62,0,9.48,128.32,111400,111454
1785,55,36,1,9.31,84.43,111453,111508
1786,84,35,1,6.10,36.11,111507,111591
1787,67,35,1,7.64,50.68,111590,111657
1788,57,69,1,8.98,144.96,111656,111713
1789,65,54,1,7.88,101.68,111713,111778
1790,62,84,1,8.26,144.48,111777,111839
1791,63,99,1,8.13,181.25,111838,111901
1792,70,58,1,7.31,83.90,111900,111970
1793,65,36,1,7.88,64.66,111969,112034
1794,60,41,1,8.53,64.28,112033,112093
1795,57,66,1,8.98,189.49,112093,112150
1796,66,40,1,7.76,94.40,112149,112215
1797,74,57,1,6.92,79.13,112214,112288
1798,64,50,1,8.00,104.47,112287,112351
1799,70,35,1,7.31,54.73,112350,112420
1800,68,36,1,7.53,74.43,112419,112487
1801,55,55,1,9.31,154.36,112486,112541
1802,63,32,1,8.13,53.22,112540,112603
1803,59,79,1,8.68,122.42,112602,112661
1804,63,60,1,8.13,98.87,112660,112723
1805,63,49,1,8.13,97.54,112722,112785
1806,74,60,1,6.92,110.62,112784,112858
1807,61,41,1,8.39,94.89,112857,112918
1808,65,56,1,7.88,125.71,112917,112982
1809,65,34,1,7.88,59.18,112981,113046
1810,46,61,1,11.13,199.42,113045,113091
1811,66,39,1,7.76,66.79,113090,113156
1812,73,80,1,7.01,101.00,113155,113228
1813,71,38,1,7.21,63.46,113228,113299
1814,59,51,1,8.68,100.63,113299,113358
1815,49,48,1,10.45,120.12,113357,113406
1816,67,36,1,7.64,66.11,113405,113472
1817,59,64,1,8.68,130.79,113471,113530
1818,58,52,1,8.83,119.45,113529,113587
1819,67,51,1,7.64,89.21,113586,113653
1820,72,88,1,7.11,128.29,113652,113724
1821,66,43,1,7.76,82.24,113724,113790
1822,51,96,1,10.04,322.04,113789,113840
1823,60,36,1,8.53,76.85,113839,113899
1824,76,36,1,6.74,43.04,113898,113974
1825,54,166,1,9.48,505.29,113973,114027
1826,101,20,1,5.07,18.34,114026,114127
1827,56,36,1,9.14,93.84,114126,114182
1828,54,53,1,9.48,121.77,114182,114236
1829,72,36,1,7.11,59.88,114235,114307
1830,69,50,1,7.42,89.90,114306,114375
1831,56,83,1,9.14,167.59,114374,114430
1832,52,55,1,9.85,104.25,114429,114481
1833,45,60,1,11.38,196.37,114480,114525
1834,57,35,1,8.98,100.61,114524,114581
1835,57,50,1,8.98,101.25,114580,114637
1836,67,35,0,7.64,37.81,114636,114703
1837,54,88,1,9.48,239.58,114702,114756
1838,62,53,1,8.26,89.39,114755,114817
1839,67,36,1,7.64,74.65,114816,114883
1840,73,34,1,7.01,50.15,114882,114955
1841,72,50,1,7.11,87.27,114954,115026
1842,79,59,1,6.48,63.79,115025,115104
1843,64,43,1,8.00,66.19,115103,115167
1844,67,48,1,7.64,62.83,115166,115233
1845,60,62,1,8.53,150.38,115232,115292
1846,62,62,1,8.26,114.35,115291,115353
1847,71,100,1,7.21,154.42,115353,115424
1848,68,35,1,7.53,69.57,115423,115491
1849,64,36,1,8.00,80.59,115490,115554
1850,39,122,1,13.13,460.88,115554,115593
1851,52,58,1,9.85,176.75,115592,115644
1852,57,66,1,8.98,147.60,115643,115700
1853,74,37,1,6.92,51.21,115699,115773
1854,68,39,1,7.53,59.84,115772,115840
1855,63,40,1,8.13,81.38,115839,115902
1856,65,53,1,7.88,107.22,115901,115966
1857,53,122,1,9.66,318.07,115965,116018
1858,55,72,1,9.31,142.50,116017,116072
1859,72,34,1,7.11,40.65,116071,116143
1860,64,50,1,8.00,62.84,116143,116207
1861,63,43,1,8.13,100.24,116206,116269
1862,68,48,1,7.53,90.31,116268,116336
1863,61,104,1,8.39,190.86,116335,116396
1864,55,62,1,9.31,148.25,116395,116450
1865,75,65,1,6.83,86.25,116449,116524
1866,65,55,1,7.88,109.77,116523,116588
1867,52,60,1,9.85,115.59,116587,116639
1868,65,64,1,7.88,138.14,116638,116703
1869,78,48,1,6.56,55.99,116702,116780
1870,59,100,1,8.68,203.10,116779,116838
1871,55,40,1,9.31,128.61,116837,116892
1872,46,74,1,11.13,252.20,116891,116937
1873,52,76,1,9.85,185.32,116937,116989
1874,68,36,1,7.53,58.87,116988,117056
1875,70,55,1,7.31,73.82,117055,117125
1876,57,71,1,8.98,129.18,117124,117181
1877,65,50,1,7.88,94.08,117180,117245
1878,69,43,0,7.42,70.65,117244,117313
1879,79,48,1,6.48,63.01,117312,117391
1880,60,69,1,8.53,154.68,117390,117450
1881,71,56,1,7.21,82.50,117449,117520
1882,88,35,1,5.82,35.81,117519,117607
1883,79,30,1,6.48,37.03,117606,117685
1884,82,27,1,6.24,31.92,117684,117766
1885,71,52,1,7.21,100.50,117765,117836
1886,52,179,1,9.85,613.59,117835,117887
1887,68,49,1,7.53,57.60,117886,117954
1888,47,50,1,10.89,126.22,117953,118000
1889,58,59,1,8.83,123.21,117999,118057
1890,70,36,1,7.31,67.73,118056,118126
1891,74,37,1,6.92,51.67,118126,118200
1892,65,60,1,7.88,92.57,118199,118264
1893,59,49,1,8.68,122.46,118263,118322
1894,82,30,1,6.24,36.40,118321,118403
1895,80,50,1,6.40,58.59,118402,118482
1896,70,36,1,7.31,46.82,118481,118551
1897,59,36,1,8.68,74.52,118550,118609
1898,52,86,1,9.85,238.36,118608,118660
1899,70,69,1,7.31,97.27,118660,118730
1900,41,133,1,12.49,480.30,118729,118770
1901,62,48,1,8.26,109.16,118769,118831
1902,62,34,1,8.26,55.48,118830,118892
1903,74,45,1,6.92,72.62,118891,118965
1904,72,36,1,7.11,59.21,118964,119036
1905,72,36,1,7.11,66.04,119035,119107
1906,52,72,1,9.85,154.82,119106,119158
1907,59,43,1,8.68,90.29,119157,119216
1908,62,66,1,8.26,146.74,119215,119277
1909,56,69,1,9.14,140.52,119276,119332
1910,73,36,1,7.01,60.84,119331,119404
1911,62,46,1,8.26,77.16,119403,119465
1912,61,45,1,8.39,88.11,119464,119525
1913,78,51,1,6.56,75.32,119524,119602
1914,57,51,1,8.98,143.77,119601,119658
1915,41,230,0,12.49,1225.57,119657,119698
1916,79,30,1,6.48,31.57,119697,119776
1917,54,36,1,9.48,97.29,119775,119829
1918,41,36,1,12.49,155.47,119828,119869
1919,69,126,1,7.42,237.95,119868,119937
1920,55,44,1,9.31,110.03,119936,119991
1921,65,70,1,7.88,125.31,119990,120055
1922,67,59,1,7.64,118.59,120054,120121
1923,64,41,1,8.00,78.81,120120,120184
1924,65,60,0,7.88,103.15,120183,120248
1925,40,155,1,12.80,631.56,120247,120287
1926,61,45,1,8.39,76.96,120286,120347
1927,69,43,1,7.42,66.07,120346,120415
1928,64,52,1,8.00,93.06,120414,120478
1929,64,60,1,8.00,112.75,120478,120542
1930,59,68,1,8.68,120.79,120541,120600
1931,55,55,1,9.31,155.74,120599,120654
1932,61,33,1,8.39,66.14,120653,120714
1933,50,49,1,10.24,109.22,120713,120763
1934,60,53,0,8.53,124.48,120762,120822
1935,71,36,1,7.21,70.34,120821,120892
1936,67,34,1,7.64,61.13,120891,120958
1937,60,37,1,8.53,73.95,120957,121017
1938,75,37,0,6.83,60.73,121017,121092
1939,81,36,1,6.32,31.25,121091,121172
1940,65,47,1,7.88,86.42,121171,121236
1941,65,88,1,7.88,169.58,121235,121300
1942,79,62,1,6.48,84.50,121299,121378
1943,53,87,1,9.66,186.87,121377,121430
1944,67,52,1,7.64,106.50,121429,121496
1945,68,89,1,7.53,162.57,121495,121563
1946,59,50,1,8.68,113.37,121562,121621
1947,27,245,1,18.96,2341.67,121620,121647
1948,91,27,1,5.63,27.11,121646,121737
1949,62,60,1,8.26,95.61,121736,121798
1950,66,35,1,7.76,69.34,121798,121864
1951,66,36,0,7.76,83.61,121863,121929
1952,63,61,1,8.13,129.38,121929,121992
1953,69,50,1,7.42,74.77,121991,122060
1954,67,36,1,7.64,64.29,122060,122127
1955,68,55,1,7.53,67.69,122126,122194
1956,66,53,1,7.76,83.79,122193,122259
1957,68,55,1,7.53,101.13,122258,122326
1958,73,54,1,7.01,76.70,122325,122398
1959,83,29,1,6.17,32.31,122397,122480
1960,67,49,1,7.64,80.50,122480,122547
1961,61,34,1,8.39,68.24,122546,122607
1962,69,78,1,7.42,160.45,122606,122675
1963,62,44,1,8.26,70.93,122674,122736
1964,73,37,1,7.01,66.07,122735,122808
1965,53,62,1,9.66,164.41,122807,122860
1966,55,68,1,9.31,143.27,122859,122914
1967,52,76,1,9.85,208.21,122913,122965
1968,49,69,1,10.45,237.59,122964,123013
1969,43,128,1,11.91,559.06,123012,123055
1970,67,48,1,7.64,97.01,123054,123121
1971,60,48,1,8.53,112.95,123120,123180
1972,53,86,1,9.66,215.39,123179,123232
1973,58,56,1,8.83,127.76,123231,123289
1974,72,61,1,7.11,78.57,123288,123360
1975,66,88,1,7.76,174.76,123359,123425
1976,54,50,1,9.48,111.77,123424,123478
1977,61,39,1,8.39,84.40,123477,123538
1978,64,54,1,8.00,94.50,123537,123601
1979,56,64,1,9.14,145.41,123600,123656
1980,75,36,1,6.83,49.72,123655,123730
1981,54,36,1,9.48,98.36,123729,123783
1982,62,35,1,8.26,66.51,123782,123844
1983,73,43,1,7.01,59.52,123843,123916
1984,50,35,1,10.24,89.34,123915,123965
1985,64,32,1,8.00,62.66,123964,124028
1986,58,61,1,8.83,124.00,124027,124085
1987,62,60,1,8.26,102.84,124085,124147
1988,72,55,1,7.11,76.04,124146,124218
1989,65,38,1,7.88,68.88,124217,124282
1990,78,36,1,6.56,37.48,124281,124359
1991,57,132,1,8.98,347.53,124358,124415
1992,57,68,1,8.98,124.51,124414,124471
1993,63,35,1,8.13,74.05,124470,124533
1994,76,35,1,6.74,55.72,124532,124608
1995,56,36,1,9.14,75.62,124607,124663
1996,65,39,1,7.88,73.74,124663,124728
1997,75,38,1,6.83,57.13,124728,124803
1998,63,54,1,8.13,108.14,124802,124865
1999,50,70,1,10.24,173.14,124864,124914
2000,68,45,1,7.53,60.54,124913,124981
2001,63,53,1,8.13,100.75,124980,125043
2002,42,93,1,12.19,335.96,125042,125084
2003,59,70,1,8.68,115.78,125083,125142
2004,64,50,1,8.00,95.59,125141,125205
2005,57,37,1,8.98,93.18,125204,125261
2006,59,54,1,8.68,136.56,125260,125319
2007,53,70,1,9.66,145.05,125318,125371
2008,59,49,1,8.68,119.00,125370,125429
2009,66,58,1,7.76,106.64,125428,125494
2010,67,58,0,7.64,88.59,125493,125560
2011,56,119,1,9.14,276.05,125559,125615
2012,63,94,1,8.13,164.84,125614,125677
2013,74,44,1,6.92,51.78,125676,125750
2014,43,47,1,11.91,143.29,125749,125792
2015,40,64,1,12.80,229.06,125791,125831
2016,60,119,1,8.53,241.32,125830,125890
2017,70,37,1,7.31,56.50,125889,125959
2018,61,36,1,8.39,88.76,125959,126020
2019,69,53,1,7.42,91.98,126020,126089
2020,61,36,1,8.39,72.27,126088,126149
2021,62,38,0,8.26,74.39,126148,126210
2022,75,60,1,6.83,109.82,126209,126284
2023,73,45,1,7.01,91.52,126284,126357
2024,55,55,1,9.31,95.70,126356,126411
2025,71,52,1,7.21,61.66,126410,126481
2026,73,62,1,7.01,82.84,126481,126554
2027,69,32,1,7.42,48.04,126553,126622
2028,72,44,1,7.11,55.29,126621,126693
2029,66,54,1,7.76,89.09,126692,126758
2030,47,86,1,10.89,309.80,126757,126804
2031,50,105,1,10.24,332.86,126803,126853
2032,61,47,1,8.39,79.06,126852,126913
2033,54,99,1,9.48,239.95,126912,126966
2034,79,43,1,6.48,59.59,126965,127044
2035,63,36,1,8.13,72.11,127043,127106
2036,57,62,0,8.98,109.91,127105,127162
2037,71,55,1,7.21,104.05,127161,127232
2038,74,54,1,6.92,90.29,127231,127305
2039,54,61,1,9.48,144.43,127304,127358
2040,55,65,1,9.31,155.74,127357,127412
2041,62,35,1,8.26,56.00,127411,127473
2042,70,43,1,7.31,77.53,127473,127543
2043,72,36,1,7.11,71.57,127542,127614
2044,70,39,1,7.31,55.64,127613,127683
2045,52,94,1,9.85,225.32,127683,127735
2046,70,73,1,7.31,110.73,127734,127804
2047,58,50,1,8.83,100.69,127804,127862
2048,70,36,1,7.31,74.30,127861,127931
2049,54,103,1,9.48,263.03,127930,127984
2050,51,44,1,10.04,102.23,127983,128034
2051,56,54,1,9.14,133.23,128033,128089
2052,77,36,0,6.65,37.76,128088,128165
2053,66,46,1,7.76,84.67,128165,128231
2054,75,24,1,6.83,36.97,128230,128305
2055,69,61,1,7.42,92.10,128304,128373
2056,71,36,1,7.21,56.14,128372,128443
2057,67,52,1,7.64,77.99,128442,128509
2058,78,54,1,6.56,62.78,128508,128586
2059,49,61,1,10.45,128.74,128585,128634
2060,58,61,1,8.83,149.04,128633,128691
2061,79,32,1,6.48,34.91,128690,128769
2062,62,48,1,8.26,99.74,128768,128830
2063,63,46,1,8.13,102.02,128829,128892
2064,75,56,1,6.83,79.40,128891,128966
2065,53,36,1,9.66,104.41,128965,129018
2066,55,36,1,9.31,91.09,129017,129072
2067,68,46,1,7.53,65.63,129071,129139
2068,68,36,1,7.53,82.22,129138,129206
2069,66,63,1,7.76,103.21,129205,129271
2070,65,64,1,7.88,91.22,129270,129335
2071,67,34,1,7.64,53.60,129334,129401
2072,69,54,1,7.42,64.59,129400,129469
2073,58,54,1,8.83,94.52,129469,129527
2074,75,36,1,6.83,60.06,129526,129601
2075,67,59,1,7.64,105.36,129600,129667
2076,74,35,1,6.92,48.07,129667,129741
2077,75,61,1,6.83,72.14,129740,129815
2078,60,98,1,8.53,210.85,129814,129874
2079,64,69,1,8.00,134.94,129873,129937
2080,47,50,1,10.89,123.88,129936,129983
2081,60,61,1,8.53,82.78,129982,130042
2082,61,65,1,8.39,112.47,130041,130102
2083,72,45,1,7.11,54.68,130101,130173
2084,69,53,1,7.42,75.37,130172,130241
2085,64,56,1,8.00,117.91,130240,130304
2086,58,50,1,8.83,103.21,130303,130361
2087,76,38,1,6.74,52.96,130360,130436
2088,49,89,1,10.45,220.33,130435,130484
2089,68,60,1,7.53,99.13,130483,130551
2090,80,39,1,6.40,47.49,130550,130630
2091,41,83,1,12.49,300.05,130629,130670
2092,69,35,1,7.42,58.48,130669,130738
2093,77,38,1,6.65,50.93,130737,130814
2094,75,32,1,6.83,37.45,130813,130888
2095,71,49,1,7.21,67.55,130887,130958
2096,52,76,1,9.85,159.21,130957,131009
2097,56,82,1,9.14,157.73,131008,131064
2098,53,95,1,9.66,229.09,131063,131116
2099,67,55,1,7.64,61.27,131115,131182
2100,64,62,1,8.00,93.00,131181,131245
2101,59,64,1,8.68,108.56,131244,131303
2102,84,28,0,6.10,35.13,131302,131386
2103,58,57,1,8.83,111.18,131385,131443
2104,47,84,1,10.89,224.73,131442,131489
2105,69,36,1,7.42,67.06,131488,131557
2106,48,56,1,10.67,149.43,131556,131604
2107,73,36,1,7.01,63.52,131603,131676
2108,46,89,1,11.13,284.29,131675,131721
2109,69,45,1,7.42,72.42,131721,131790
2110,57,35,1,8.98,71.03,131789,131846
2111,81,33,1,6.32,42.93,131845,131926
2112,62,51,1,8.26,76.29,131926,131988
2113,53,43,1,9.66,113.55,131987,132040
2114,58,70,1,8.83,127.21,132039,132097
2115,68,56,1,7.53,97.04,132096,132164
2116,78,34,1,6.56,49.89,132163,132241
2117,64,46,1,8.00,97.84,132240,132304
2118,81,37,1,6.32,54.19,132304,132385
2119,56,53,1,9.14,114.16,132384,132440
2120,78,30,1,6.56,34.58,132439,132517
2121,55,53,1,9.31,111.52,132516,132571
2122,66,46,1,7.76,71.76,132570,132636
2123,44,76,1,11.64,289.46,132635,132679
2124,48,44,1,10.67,112.81,132678,132726
2125,66,35,1,7.76,65.15,132725,132791
2126,60,55,1,8.53,90.32,132790,132850
2127,68,107,1,7.53,185.87,132849,132917
2128,53,76,1,9.66,192.94,132916,132969
2129,79,50,1,6.48,60.53,132968,133047
2130,63,67,1,8.13,116.27,133046,133109
2131,72,52,1,7.11,89.63,133108,133180
2132,69,45,1,7.42,72.01,133179,133248
2133,54,52,1,9.48,144.43,133248,133302
2134,72,34,1,7.11,45.71,133301,133373
2135,47,76,1,10.89,215.03,133372,133419
2136,78,62,0,6.56,64.66,133418,133496
2137,67,36,1,7.64,62.35,133495,133562
2138,56,56,1,9.14,132.98,133561,133617
2139,53,47,1,9.66,122.30,133616,133669
2140,47,59,1,10.89,183.71,133668,133715
2141,46,84,1,11.13,228.59,133714,133760
2142,68,55,1,7.53,93.40,133760,133828
2143,51,82,1,10.04,197.84,133827,133878
2144,60,74,1,8.53,169.02,133877,133937
2145,70,79,1,7.31,127.73,133936,134006
2146,85,35,1,6.02,38.12,134005,134090
2147,56,37,1,9.14,96.52,134089,134145
2148,44,58,1,11.64,238.19,134144,134188
2149,66,79,1,7.76,166.12,134187,134253
2150,65,36,1,7.88,58.54,134252,134317
2151,67,35,1,7.64,58.47,134316,134383
2152,40,100,1,12.80,422.81,134382,134422
2153,75,37,1,6.83,49.98,134421,134496
2154,62,48,1,8.26,84.90,134495,134557
2155,56,64,1,9.14,115.59,134556,134612
2156,56,76,1,9.14,161.30,134611,134667
2157,56,92,1,9.14,184.59,134666,134722
2158,64,68,1,8.00,106.34,134721,134785
2159,65,52,1,7.88,97.55,134784,134849
2160,66,63,1,7.76,88.91,134848,134914
2161,72,47,1,7.11,71.99,134913,134985
2162,77,41,1,6.65,60.05,134984,135061
2163,68,56,1,7.53,97.40,135060,135128
2164,79,48,1,6.48,52.30,135128,135207
2165,81,47,1,6.32,53.92,135206,135287
2166,76,42,1,6.74,55.14,135286,135362
2167,45,54,1,11.38,151.70,135361,135406
2168,57,49,0,8.98,123.60,135405,135462
2169,58,60,1,8.83,104.04,135461,135519
2170,49,77,1,10.45,180.08,135518,135567
2171,67,43,1,7.64,87.13,135566,135633
2172,61,54,1,8.39,100.34,135633,135694
2173,52,60,1,9.85,151.63,135694,135746
2174,51,61,1,10.04,170.00,135745,135796
2175,35,129,1,14.63,678.00,135795,135830
2176,79,32,1,6.48,40.60,135829,135908
2177,56,60,1,9.14,149.59,135908,135964
2178,58,101,1,8.83,202.76,135963,136021
2179,71,36,1,7.21,54.48,136020,136091
2180,72,57,1,7.11,80.02,136090,136162
2181,76,34,1,6.74,48.61,136161,136237
2182,78,36,1,6.56,53.27,136236,136314
2183,67,38,1,7.64,59.69,136313,136380
2184,45,65,1,11.38,183.88,136379,136424
2185,59,46,1,8.68,80.42,136423,136482
2186,69,36,1,7.42,62.62,136481,136550
2187,71,53,1,7.21,107.80,136549,136620
2188,64,51,1,8.00,76.78,136620,136684
2189,66,45,1,7.76,78.61,136683,136749
2190,75,63,1,6.83,80.28,136748,136823
2191,60,36,1,8.53,59.28,136822,136882
2192,69,36,1,7.42,71.08,136881,136950
2193,66,72,1,7.76,154.43,136950,137016
2194,59,58,1,8.68,107.07,137015,137074
2195,58,138,1,8.83,331.32,137073,137131
2196,83,35,1,6.17,39.66,137130,137213
2197,58,48,1,8.83,107.87,137212,137270
2198,63,36,1,8.13,77.86,137270,137333
2199,59,74,1,8.68,160.63,137332,137391
2200,72,36,1,7.11,41.57,137390,137462
2201,84,65,1,6.10,68.73,137461,137545
2202,45,124,1,11.38,414.19,137545,137590
2203,58,57,1,8.83,118.45,137589,137647
2204,44,193,1,11.64,855.00,137646,137690
2205,68,49,1,7.53,70.07,137689,137757
2206,56,56,1,9.14,122.52,137756,137812
2207,53,57,1,9.66,127.47,137811,137864
2208,49,50,1,10.45,112.08,137864,137913
2209,89,38,1,5.75,39.04,137912,138001
2210,69,35,1,7.42,61.00,138000,138069
2211,58,41,1,8.83,96.00,138068,138126
2212,65,63,1,7.88,106.29,138125,138190
2213,54,36,1,9.48,67.84,138189,138243
2214,54,65,1,9.48,175.99,138242,138296
2215,53,64,1,9.66,160.15,138296,138349
2216,58,60,1,8.83,118.66,138348,138406
2217,87,64,1,5.89,58.91,138405,138492
2218,67,45,1,7.64,89.16,138491,138558
2219,78,56,1,6.56,57.81,138558,138636
2220,51,120,1,10.04,333.25,138635,138686
2221,69,59,1,7.42,74.45,138685,138754
2222,48,68,1,10.67,178.56,138753,138801
2223,67,51,1,7.64,87.33,138801,138868
2224,81,51,1,6.32,54.27,138867,138948
2225,55,51,1,9.31,142.94,138947,139002
2226,61,53,1,8.39,83.42,139001,139062
2227,61,61,1,8.39,105.45,139061,139122
2228,81,34,1,6.32,41.80,139121,139202
2229,73,35,1,7.01,57.08,139201,139274
2230,28,136,1,18.29,1083.13,139273,139301
2231,69,39,1,7.42,80.16,139300,139369
2232,75,41,1,6.83,59.05,139368,139443
2233,75,51,1,6.83,60.06,139442,139517
2234,52,92,1,9.85,202.55,139517,139569
2235,65,60,1,7.88,94.35,139568,139633
2236,70,37,1,7.31,69.56,139632,139702
2237,60,67,1,8.53,109.78,139702,139762
2238,72,83,1,7.11,130.74,139761,139833
2239,58,43,1,8.83,92.83,139833,139891
2240,41,56,1,12.49,201.81,139890,139931
2241,61,45,1,8.39,81.42,139930,139991
2242,70,47,1,7.31,64.24,139990,140060
2243,59,62,1,8.68,109.51,140059,140118
2244,63,36,1,8.13,76.46,140117,140180
2245,90,51,0,5.69,46.21,140179,140269
2246,55,92,1,9.31,229.70,140268,140323
2247,58,45,0,8.83,107.97,140322,140380
2248,62,36,1,8.26,84.19,140379,140441
2249,65,29,1,7.88,46.91,140440,140505
2250,64,47,1,8.00,79.16,140504,140568
2251,87,34,1,5.89,30.26,140567,140654
2252,71,56,1,7.21,115.46,140654,140725
2253,55,61,1,9.31,155.01,140724,140779
2254,52,95,1,9.85,211.63,140778,140830
2255,47,60,1,10.89,186.27,140829,140876
2256,99,36,0,5.17,42.04,140875,140974
2257,60,63,1,8.53,95.75,140973,141033
2258,55,61,1,9.31,165.74,141032,141087
2259,72,31,1,7.11,47.65,141086,141158
2260,78,71,1,6.56,83.58,141157,141235
2261,64,45,1,8.00,84.44,141234,141298
2262,47,82,1,10.89,270.86,141297,141344
2263,68,62,1,7.53,95.04,141343,141411
2264,80,31,1,6.40,40.27,141411,141491
2265,71,36,1,7.21,66.59,141490,141561
2266,64,63,1,8.00,83.91,141560,141624
2267,53,89,1,9.66,287.66,141623,141676
2268,70,50,1,7.31,70.36,141675,141745
2269,52,83,1,9.85,209.17,141744,141796
2270,52,62,1,9.85,129.32,141795,141847
2271,72,35,1,7.11,62.57,141846,141918
2272,63,66,1,8.13,107.79,141917,141980
2273,72,36,1,7.11,54.32,141979,142051
2274,69,36,1,7.42,55.84,142050,142119
2275,66,50,1,7.76,84.91,142119,142185
2276,65,35,1,7.88,49.86,142184,142249
2277,53,48,1,9.66,113.58,142248,142301
2278,81,52,1,6.32,68.34,142301,142382
2279,58,40,1,8.83,93.21,142381,142439
2280,55,69,1,9.31,159.70,142438,142493
2281,56,107,1,9.14,220.12,142492,142548
2282,83,31,1,6.17,33.10,142547,142630
2283,61,50,1,8.39,119.06,142629,142690
2284,82,39,1,6.24,54.23,142690,142772
2285,50,49,1,10.24,181.06,142772,142822
2286,50,58,1,10.24,129.86,142821,142871
2287,52,38,1,9.85,104.32,142870,142922
2288,58,35,1,8.83,68.83,142922,142980
2289,57,68,1,8.98,133.67,142979,143036
2290,49,58,1,10.45,143.88,143035,143084
2291,75,47,1,6.83,67.37,143083,143158
2292,64,45,1,8.00,96.59,143157,143221
2293,48,197,1,10.67,795.72,143220,143268
2294,66,36,1,7.76,62.49,143267,143333
2295,61,71,1,8.39,124.83,143332,143393
2296,79,56,1,6.48,75.54,143392,143471
2297,70,56,1,7.31,67.22,143471,143541
2298,43,92,1,11.91,368.46,143540,143583
2299,86,30,1,5.95,28.67,143582,143668
2300,76,36,0,6.74,50.75,143667,143743
2301,64,60,1,8.00,113.12,143742,143806
2302,83,34,1,6.17,37.56,143805,143888
2303,60,75,1,8.53,155.68,143887,143947
2304,72,55,1,7.11,74.49,143946,144018
2305,66,46,1,7.76,90.70,144017,144083
2306,70,65,1,7.31,93.36,144082,144152
2307,66,36,1,7.76,62.79,144151,144217
2308,80,36,1,6.40,35.99,144216,144296
2309,67,54,1,7.64,97.87,144295,144362
2310,57,41,1,8.98,89.56,144362,144419
2311,88,35,1,5.82,37.67,144418,144506
2312,52,51,1,9.85,137.13,144505,144557
2313,69,38,1,7.42,68.97,144556,144625
2314,55,81,1,9.31,145.23,144624,144679
2315,85,36,1,6.02,44.63,144678,144763
2316,54,68,1,9.48,143.18,144763,144817
2317,28,150,1,18.29,814.85,144816,144844
2318,61,50,1,8.39,86.50,144843,144904
2319,60,50,1,8.53,127.28,144903,144963
2320,51,61,1,10.04,161.92,144962,145013
2321,52,60,1,9.85,151.51,145012,145064
2322,73,38,1,7.01,47.36,145063,145136
2323,72,40,1,7.11,65.27,145135,145207
2324,70,52,0,7.31,68.13,145206,145276
2325,43,211,1,11.91,979.67,145275,145318
2326,72,36,1,7.11,58.04,145317,145389
2327,54,58,1,9.48,124.62,145388,145442
2328,59,36,1,8.68,69.51,145441,145500
2329,70,52,1,7.31,71.82,145499,145569
2330,68,60,1,7.53,104.60,145568,145636
2331,44,234,1,11.64,1190.28,145635,145679
2332,62,69,1,8.26,120.80,145678,145740
2333,71,36,1,7.21,63.04,145739,145810
2334,56,98,1,9.14,218.66,145809,145865
2335,86,34,1,5.95,39.16,145864,145950
2336,72,36,1,7.11,52.85,145949,146021
2337,60,45,1,8.53,95.15,146020,146080
2338,64,49,1,8.00,76.47,146079,146143
2339,61,76,1,8.39,123.75,146142,146203
2340,41,179,1,12.49,814.49,146202,146243
2341,53,63,1,9.66,154.34,146242,146295
2342,65,36,1,7.88,90.66,146294,146359
2343,57,65,1,8.98,130.09,146358,146415
2344,70,52,1,7.31,77.67,146414,146484
2345,63,36,1,8.13,55.13,146483,146546
2346,68,35,1,7.53,45.37,146545,146613
2347,70,42,1,7.31,70.96,146612,146682
2348,62,73,1,8.26,119.87,146682,146744
2349,53,52,1,9.66,98.41,146743,146796
2350,81,42,1,6.32,34.59,146795,146876
2351,65,49,1,7.88,84.20,146876,146941
2352,70,62,1,7.31,71.39,146940,147010
2353,65,60,1,7.88,91.58,147009,147074
2354,66,50,1,7.76,75.64,147073,147139
2355,51,57,1,10.04,152.86,147138,147189
2356,69,56,1,7.42,88.01,147188,147257
2357,67,36,1,7.64,66.59,147256,147323
2358,51,54,1,10.04,147.49,147322,147373
2359,56,36,1,9.14,92.27,147372,147428
2360,56,48,1,9.14,99.23,147427,147483
2361,62,53,1,8.26,87.48,147482,147544
2362,77,103,1,6.65,146.85,147544,147621
2363,66,51,1,7.76,94.27,147620,147686
2364,54,50,1,9.48,130.40,147685,147739
2365,64,61,1,8.00,98.59,147738,147802
2366,70,53,1,7.31,105.53,147801,147871
2367,62,61,1,8.26,113.19,147870,147932
2368,79,35,1,6.48,50.07,147931,148010
2369,74,46,1,6.92,72.83,148009,148083
2370,53,46,1,9.66,94.41,148082,148135
2371,77,36,1,6.65,47.63,148134,148211
2372,53,99,1,9.66,224.64,148210,148263
2373,57,53,1,8.98,161.21,148262,148319
2374,69,48,1,7.42,70.77,148318,148387
2375,67,41,1,7.64,70.11,148386,148453
2376,47,63,1,10.89,210.69,148452,148499
2377,59,51,1,8.68,120.59,148498,148557
2378,60,69,1,8.53,124.12,148556,148616
2379,61,48,1,8.39,107.29,148615,148676
2380,72,46,1,7.11,59.68,148675,148747
2381,51,93,1,10.04,263.02,148746,148797
2382,37,68,1,13.84,322.08,148796,148833
2383,48,83,1,10.67,206.06,148832,148880
2384,60,55,1,8.53,115.82,148879,148939
2385,84,29,1,6.10,28.47,148938,149022
2386,45,52,1,11.38,163.75,149021,149066
2387,71,61,1,7.21,101.29,149065,149136
2388,99,31,1,5.17,23.35,149135,149234
2389,63,100,1,8.13,194.65,149234,149297
2390,74,40,1,6.92,65.89,149296,149370
2391,71,45,1,7.21,70.67,149369,149440
2392,72,36,1,7.11,63.71,149439,149511
2393,73,60,1,7.01,113.11,149510,149583
2394,68,60,1,7.53,99.31,149583,149651
2395,63,36,1,8.13,60.97,149650,149713
2396,86,29,1,5.95,26.18,149712,149798
2397,66,55,1,7.76,80.37,149797,149863
2398,85,37,1,6.02,54.28,149862,149947
2399,37,184,0,13.84,955.92,149946,149983
2400,52,91,1,9.85,262.44,149982,150034
2401,77,35,1,6.65,53.27,150033,150110
2402,62,40,1,8.26,71.13,150109,150171
2403,72,46,1,7.11,63.85,150170,150242
2404,68,36,1,7.53,48.04,150241,150309
2405,67,96,1,7.64,143.81,150308,150375
2406,48,96,1,10.67,302.76,150374,150422
2407,60,156,1,8.53,397.55,150421,150481
2408,62,83,1,8.26,167.06,150480,150542
2409,60,61,1,8.53,111.72,150541,150601
2410,70,35,1,7.31,53.90,150600,150670
2411,73,35,1,7.01,60.23,150669,150742
2412,51,86,1,10.04,246.74,150742,150793
2413,45,69,1,11.38,201.26,150792,150837
2414,69,95,1,7.42,161.17,150836,150905
2415,69,36,1,7.42,63.37,150904,150973
2416,60,60,1,8.53,128.65,150973,151033
2417,60,35,1,8.53,82.48,151032,151092
2418,70,49,1,7.31,75.79,151091,151161
2419,67,35,1,7.64,74.23,151160,151227
2420,50,61,1,10.24,140.98,151226,151276
2421,67,44,1,7.64,69.33,151275,151342
2422,47,48,1,10.89,125.50,151341,151388
2423,71,36,1,7.21,59.88,151387,151458
2424,56,69,1,9.14,168.27,151457,151513
2425,64,80,1,8.00,173.72,151512,151576
2426,64,101,1,8.00,174.91,151575,151639
2427,59,38,1,8.68,103.00,151638,151697
2428,71,36,1,7.21,61.27,151696,151767
2429,65,55,1,7.88,95.68,151766,151831
2430,62,53,0,8.26,105.58,151830,151892
2431,70,43,1,7.31,88.36,151891,151961
2432,67,53,1,7.64,72.53,151960,152027
2433,62,99,1,8.26,177.00,152026,152088
2434,51,52,1,10.04,115.29,152087,152138
2435,57,78,1,8.98,146.75,152137,152194
2436,67,38,1,7.64,66.41,152193,152260
2437,45,86,1,11.38,271.12,152260,152305
2438,50,48,1,10.24,139.34,152304,152354
2439,82,36,1,6.24,50.70,152353,152435
2440,62,45,1,8.26,94.03,152435,152497
2441,62,53,1,8.26,82.64,152496,152558
2442,44,88,1,11.64,241.96,152557,152601
2443,75,35,1,6.83,42.73,152600,152675
2444,70,92,1,7.31,148.30,152674,152744
2445,58,62,1,8.83,143.25,152743,152801
2446,77,36,1,6.65,51.99,152801,152878
2447,56,62,1,9.14,132.77,152877,152933
2448,50,120,0,10.24,392.62,152932,152982
2449,54,49,1,9.48,128.88,152981,153035
2450,66,33,1,7.76,48.18,153034,153100
2451,79,48,1,6.48,62.63,153099,153178
2452,60,46,1,8.53,94.68,153177,153237
2453,57,53,1,8.98,137.25,153236,153293
2454,58,48,1,8.83,102.28,153292,153350
2455,64,49,1,8.00,97.12,153350,153414
2456,59,39,1,8.68,72.76,153413,153472
2457,64,51,0,8.00,88.72,153471,153535
2458,71,36,1,7.21,49.69,153534,153605
2459,75,44,1,6.83,55.29,153604,153679
2460,68,50,1,7.53,82.57,153678,153746
2461,47,99,1,10.89,326.56,153745,153792
2462,71,32,1,7.21,48.56,153791,153862
2463,47,66,1,10.89,189.12,153861,153908
2464,65,49,1,7.88,77.74,153907,153972
2465,61,60,1,8.39,128.76,153971,154032
2466,79,36,1,6.48,55.41,154031,154110
2467,70,48,1,7.31,70.76,154109,154179
2468,62,47,1,8.26,80.68,154178,154240
2469,64,60,1,8.00,111.75,154239,154303
2470,88,57,1,5.82,45.40,154302,154390
2471,77,35,1,6.65,40.90,154389,154466
2472,60,99,1,8.53,202.98,154465,154525
2473,59,92,1,8.68,230.22,154524,154583
2474,74,41,1,6.92,56.02,154582,154656
2475,74,37,1,6.92,48.07,154656,154730
2476,53,64,1,9.66,145.66,154729,154782
2477,58,38,1,8.83,89.21,154781,154839
2478,51,100,1,10.04,266.27,154838,154889
2479,57,62,1,8.98,155.60,154888,154945
2480,90,35,1,5.69,30.53,154944,155034
2481,61,84,1,8.39,177.06,155033,155094
2482,60,47,1,8.53,77.58,155093,155153
2483,75,48,1,6.83,70.76,155152,155227
2484,59,93,1,8.68,202.76,155226,155285
2485,53,69,1,9.66,186.56,155284,155337
2486,49,101,1,10.45,246.70,155336,155385
2487,76,95,1,6.74,150.27,155384,155460
2488,56,72,1,9.14,180.59,155459,155515
2489,65,36,1,7.88,90.63,155514,155579
2490,71,73,1,7.21,97.91,155578,155649
2491,59,55,1,8.68,131.20,155648,155707
2492,75,35,1,6.83,52.06,155706,155781
2493,61,50,1,8.39,86.24,155781,155842
2494,59,62,1,8.68,103.44,155841,155900
2495,48,62,1,10.67,148.72,155899,155947
2496,45,77,1,11.38,217.79,155947,155992
2497,63,56,1,8.13,98.24,155991,156054
2498,58,36,1,8.83,90.49,156053,156111
2499,63,35,1,8.13,71.29,156110,156173
2500,69,59,1,7.42,85.14,156172,156241
2501,45,50,1,11.38,161.39,156240,156285
2502,78,36,1,6.56,36.89,156284,156362
2503,68,63,1,7.53,121.98,156361,156429
2504,80,47,1,6.40,60.09,156428,156508
2505,58,95,1,8.83,194.18,156507,156565
2506,78,39,1,6.56,45.02,156564,156642
2507,66,53,1,7.76,102.52,156641,156707
2508,44,179,1,11.64,710.10,156706,156750
2509,71,36,1,7.21,73.77,156750,156821
2510,57,66,1,8.98,143.21,156820,156877
2511,58,96,1,8.83,209.14,156876,156934
2512,65,47,1,7.88,108.69,156933,156998
2513,55,47,1,9.31,105.74,156997,157052
2514,75,81,1,6.83,109.96,157051,157126
2515,56,54,0,9.14,113.73,157125,157181
2516,78,52,1,6.56,57.96,157180,157258
2517,38,178,1,13.47,908.20,157257,157295
2518,74,36,1,6.92,47.34,157294,157368
2519,59,48,1,8.68,89.81,157367,157426
2520,64,79,1,8.00,128.72,157425,157489
2521,63,47,1,8.13,69.67,157488,157551
2522,48,53,1,10.67,133.14,157550,157598
2523,78,52,1,6.56,65.53,157597,157675
2524,72,76,1,7.11,100.82,157674,157746
2525,57,36,1,8.98,103.84,157745,157802
2526,68,36,1,7.53,71.04,157801,157869
2527,61,50,1,8.39,109.22,157868,157929
2528,68,36,1,7.53,58.96,157928,157996
2529,45,131,1,11.38,436.24,157995,158040
2530,46,43,1,11.13,140.90,158039,158085
2531,84,46,1,6.10,48.40,158085,158169
2532,63,47,1,8.13,95.19,158168,158231
2533,67,43,1,7.64,90.20,158230,158297
2534,52,66,1,9.85,162.17,158296,158348
2535,63,59,1,8.13,89.67,158347,158410
2536,71,60,1,7.21,95.91,158409,158480
2537,53,59,1,9.66,153.39,158479,158532
2538,75,34,1,6.83,41.96,158531,158606
2539,48,54,1,10.67,143.31,158605,158653
2540,42,99,1,12.19,427.20,158652,158694
2541,66,59,1,7.76,95.67,158693,158759
2542,64,33,1,8.00,52.25,158758,158822
2543,46,77,1,11.13,192.20,158822,158868
2544,67,90,1,7.64,134.80,158867,158934
2545,62,42,1,8.26,70.00,158933,158995
2546,52,100,1,9.85,232.94,158994,159046
2547,60,44,1,8.53,104.95,159045,159105
2548,59,50,1,8.68,84.08,159104,159163
2549,78,36,1,6.56,50.84,159162,159240
2550,75,22,1,6.83,24.54,159239,159314
2551,66,71,1,7.76,104.15,159313,159379
2552,51,61,1,10.04,144.82,159378,159429
2553,77,36,1,6.65,32.93,159428,159505
2554,65,62,1,7.88,99.40,159504,159569
2555,47,82,1,10.89,192.86,159568,159615
2556,66,59,1,7.76,109.00,159614,159680
2557,68,61,1,7.53,86.37,159679,159747
2558,68,36,1,7.53,68.19,159746,159814
2559,68,36,1,7.53,53.34,159813,159881
2560,49,86,1,10.45,224.66,159880,159929
2561,73,35,1,7.01,47.36,159929,160002
2562,54,95,1,9.48,219.58,160001,160055
2563,65,56,1,7.88,87.40,160055,160120
2564,61,146,1,8.39,349.94,160119,160180
2565,62,103,0,8.26,215.32,160179,160241
2566,37,85,1,13.84,337.60,160240,160277
2567,53,70,1,9.66,197.81,160276,160329
2568,70,51,1,7.31,70.33,160328,160398
2569,69,36,1,7.42,55.37,160397,160466
2570,65,36,1,7.88,63.98,160465,160530
2571,48,103,1,10.67,246.89,160529,160577
2572,64,46,1,8.00,81.69,160576,160640
2573,54,62,1,9.48,162.25,160639,160693
2574,62,83,0,8.26,138.71,160692,160754
2575,57,65,1,8.98,122.54,160753,160810
2576,64,51,1,8.00,94.25,160809,160873
2577,77,34,1,6.65,57.76,160872,160949
2578,67,33,1,7.64,76.53,160948,161015
2579,86,23,1,5.95,21.90,161014,161100
2580,62,35,1,8.26,54.80,161099,161161
2581,55,79,1,9.31,152.54,161160,161215
2582,77,54,1,6.65,63.97,161214,161291
2583,62,56,1,8.26,122.13,161290,161352
2584,74,51,1,6.92,93.64,161352,161426
2585,62,61,1,8.26,104.48,161426,161488
2586,52,99,1,9.85,247.78,161488,161540
2587,54,61,1,9.48,140.81,161539,161593
2588,64,77,1,8.00,117.34,161592,161656
2589,62,69,1,8.26,123.90,161655,161717
2590,48,63,1,10.67,162.68,161716,161764
2591,66,84,1,7.76,153.46,161763,161829
2592,58,61,1,8.83,142.66,161828,161886
2593,53,54,1,9.66,114.64,161885,161938
2594,59,47,1,8.68,84.96,161937,161996
2595,54,53,1,9.48,132.99,161995,162049
2596,69,35,1,7.42,44.59,162048,162117
2597,71,54,1,7.21,73.38,162116,162187
2598,73,67,1,7.01,101.16,162186,162259
2599,60,50,1,8.53,94.35,162258,162318
2600,53,49,1,9.66,110.53,162317,162370
2601,78,34,1,6.56,41.50,162369,162447
2602,60,82,1,8.53,185.25,162446,162506
2603,61,47,1,8.39,95.65,162505,162566
2604,76,40,1,6.74,55.61,162565,162641
2605,33,167,1,15.52,882.73,162640,162673
2606,61,51,1,8.39,95.06,162672,162733
2607,61,34,1,8.39,74.89,162732,162793
2608,66,36,1,7.76,58.52,162792,162858
2609,67,48,1,7.64,79.10,162857,162924
2610,50,47,1,10.24,85.94,162923,162973
2611,61,74,1,8.39,131.78,162972,163033
2612,62,44,1,8.26,80.32,163033,163095
2613,68,36,1,7.53,66.28,163094,163162
2614,75,37,1,6.83,48.49,163161,163236
2615,57,93,1,8.98,175.88,163235,163292
2616,64,49,1,8.00,85.78,163291,163355
2617,66,49,1,7.76,83.67,163354,163420
2618,50,53,1,10.24,144.78,163419,163469
2619,56,38,1,9.14,97.98,163468,163524
2620,54,132,1,9.48,346.69,163523,163577
2621,56,82,1,9.14,159.66,163576,163632
2622,42,192,1,12.19,922.44,163631,163673
2623,80,36,1,6.40,53.12,163673,163753
2624,81,36,1,6.32,46.84,163752,163833
2625,55,69,1,9.31,190.69,163832,163887
2626,42,176,1,12.19,741.77,163886,163928
2627,48,68,1,10.67,231.56,163928,163976
2628,70,36,1,7.31,60.27,163975,164045
2629,70,36,1,7.31,67.82,164044,164114
2630,72,60,1,7.11,111.54,164114,164186
2631,39,80,1,13.13,408.27,164185,164224
2632,65,58,1,7.88,76.51,164223,164288
2633,90,34,1,5.69,28.53,164287,164377
2634,90,36,1,5.69,30.46,164376,164466
2635,75,58,1,6.83,64.20,164465,164540
2636,43,91,1,11.91,333.20,164539,164582
2637,69,36,1,7.42,42.53,164581,164650
2638,67,46,1,7.64,66.44,164649,164716
2639,67,55,1,7.64,111.60,164715,164782
2640,63,60,1,8.13,97.41,164781,164844
2641,59,57,1,8.68,109.98,164844,164903
2642,60,36,1,8.53,68.98,164902,164962
2643,62,111,1,8.26,215.61,164961,165023
2644,60,55,1,8.53,108.98,165022,165082
2645,78,36,1,6.56,56.60,165081,165159
2646,62,34,1,8.26,61.87,165159,165221
2647,73,43,1,7.01,55.08,165220,165293
2648,64,56,1,8.00,122.12,165293,165357
2649,62,55,1,8.26,111.03,165356,165418
2650,81,28,1,6.32,32.32,165417,165498
2651,81,44,1,6.32,54.54,165497,165578
2652,38,132,1,13.47,549.62,165577,165615
2653,38,60,1,13.47,255.88,165614,165652
2654,39,109,1,13.13,415.24,165651,165690
2655,62,63,1,8.26,130.45,165689,165751
2656,55,34,1,9.31,71.38,165750,165805
2657,71,36,1,7.21,70.36,165804,165875
2658,57,49,1,8.98,126.30,165874,165931
2659,63,50,1,8.13,105.86,165930,165993
2660,52,75,1,9.85,165.36,165993,166045
2661,70,51,1,7.31,100.30,166044,166114
2662,61,49,1,8.39,98.89,166114,166175
2663,55,36,1,9.31,88.29,166174,166229
2664,74,50,1,6.92,52.70,166228,166302
2665,64,64,1,8.00,104.31,166301,166365
2666,57,63,1,8.98,132.30,166365,166422
2667,66,42,1,7.76,79.09,166422,166488
2668,74,45,1,6.92,76.64,166487,166561
2669,50,71,0,10.24,205.90,166560,166610
2670,61,36,1,8.39,93.26,166609,166670
2671,53,99,1,9.66,237.36,166669,166722
2672,77,36,1,6.65,47.16,166722,166799
2673,76,54,1,6.74,68.51,166798,166874
2674,70,41,1,7.31,48.64,166873,166943
2675,48,36,1,10.67,93.68,166942,166990
2676,62,40,1,8.26,80.87,166990,167052
2677,50,61,1,10.24,159.34,167051,167101
2678,63,51,1,8.13,93.60,167100,167163
2679,66,63,1,7.76,95.61,167162,167228
2680,68,56,1,7.53,85.01,167227,167295
2681,79,52,1,6.48,65.67,167294,167373
2682,94,34,1,5.45,23.84,167372,167466
2683,77,36,0,6.65,48.25,167466,167543
2684,63,48,1,8.13,96.21,167542,167605
2685,60,57,1,8.53,105.65,167604,167664
2686,63,95,1,8.13,178.94,167663,167726
2687,35,70,1,14.63,251.66,167725,167760
2688,60,46,1,8.53,104.85,167759,167819
2689,59,37,1,8.68,94.79,167818,167877
2690,55,78,1,9.31,148.36,167877,167932
2691,82,36,1,6.24,37.60,167931,168013
2692,70,36,0,7.31,69.36,168012,168082
2693,76,46,1,6.74,63.96,168081,168157
2694,48,84,1,10.67,228.51,168156,168204
2695,71,62,1,7.21,77.72,168203,168274
2696,69,50,1,7.42,87.23,168273,168342
2697,67,71,1,7.64,128.68,168341,168408
2698,61,35,1,8.39,82.57,168408,168469
2699,69,50,1,7.42,63.43,168468,168537
2700,69,50,1,7.42,74.13,168536,168605
2701,58,62,0,8.83,117.90,168604,168662
2702,42,120,1,12.19,426.87,168661,168703
2703,64,111,1,8.00,201.25,168702,168766
2704,60,58,1,8.53,105.22,168765,168825
2705,42,212,1,12.19,1035.20,168825,168867
2706,63,60,1,8.13,107.41,168866,168929
2707,78,35,1,6.56,37.32,168929,169007
2708,63,36,1,8.13,56.46,169006,169069
2709,49,164,1,10.45,525.19,169068,169117
2710,69,37,1,7.42,70.39,169117,169186
2711,50,221,1,10.24,945.58,169185,169235
2712,42,237,1,12.19,1278.63,169234,169276
2713,59,100,1,8.68,214.52,169275,169334
2714,56,48,1,9.14,122.34,169333,169389
2715,70,36,1,7.31,47.22,169388,169458
2716,68,58,1,7.53,76.48,169457,169525
2717,58,52,1,8.83,110.59,169524,169582
2718,70,60,1,7.31,81.27,169581,169651
2719,74,57,1,6.92,64.24,169650,169724
2720,66,71,1,7.76,117.40,169723,169789
2721,56,103,1,9.14,225.12,169788,169844
2722,54,48,1,9.48,135.36,169843,169897
2723,77,64,1,6.65,64.25,169896,169973
2724,43,91,1,11.91,311.90,169972,170015
2725,60,42,1,8.53,84.55,170014,170074
2726,54,85,1,9.48,209.55,170073,170127
2727,66,60,1,7.76,110.43,170126,170192
2728,58,46,1,8.83,88.83,170191,170249
2729,72,44,1,7.11,68.68,170248,170320
2730,79,41,1,6.48,45.54,170319,170398
2731,56,52,1,9.14,104.87,170398,170454
2732,63,70,1,8.13,122.43,170453,170516
2733,60,95,1,8.53,231.75,170515,170575
2734,61,61,1,8.39,118.66,170574,170635
2735,64,37,1,8.00,77.16,170634,170698
2736,55,46,1,9.31,118.61,170697,170752
2737,50,83,1,10.24,279.10,170751,170801
2738,68,60,1,7.53,135.13,170800,170868
2739,63,36,1,8.13,80.97,170867,170930
2740,58,75,1,8.83,144.42,170929,170987
2741,60,36,1,8.53,78.28,170986,171046
2742,78,35,1,6.56,44.76,171045,171123
2743,58,46,1,8.83,112.90,171122,171180
2744,70,39,1,7.31,61.02,171179,171249
2745,68,52,1,7.53,85.90,171248,171316
2746,43,76,1,11.91,212.22,171315,171358
2747,64,54,1,8.00,96.69,171357,171421
2748,72,60,1,7.11,92.46,171420,171492
2749,62,39,1,8.26,74.93,171491,171553
2750,75,35,1,6.83,50.38,171552,171627
2751,76,62,1,6.74,74.61,171626,171702
2752,82,35,1,6.24,45.45,171701,171783
2753,66,61,1,7.76,116.12,171782,171848
2754,67,36,1,7.64,64.02,171847,171914
2755,84,53,1,6.10,67.13,171913,171997
2756,63,37,1,8.13,87.41,171996,172059
2757,75,35,1,6.83,42.01,172058,172133
2758,56,55,1,9.14,119.62,172133,172189
2759,50,100,1,10.24,256.46,172188,172238
2760,83,52,0,6.17,56.26,172237,172320
2761,56,56,1,9.14,119.09,172319,172375
2762,75,31,1,6.83,42.86,172374,172449
2763,61,60,1,8.39,102.53,172449,172510
2764,68,51,1,7.53,102.66,172509,172577
2765,65,46,1,7.88,73.12,172576,172641
2766,68,35,1,7.53,53.78,172640,172708
2767,76,36,1,6.74,50.67,172707,172783
2768,65,78,1,7.88,121.58,172782,172847
2769,59,53,1,8.68,79.44,172846,172905
2770,60,36,1,8.53,76.65,172905,172965
2771,59,49,1,8.68,86.59,172964,173023
2772,49,90,1,10.45,196.57,173022,173071
2773,62,66,1,8.26,131.90,173070,173132
2774,67,57,0,7.64,87.60,173131,173198
2775,67,38,1,7.64,76.47,173197,173264
2776,73,36,1,7.01,45.44,173263,173336
2777,67,50,1,7.64,84.05,173335,173402
2778,61,60,1,8.39,103.19,173401,173462
2779,57,50,1,8.98,115.53,173461,173518
2780,91,49,1,5.63,36.06,173517,173608
2781,70,37,1,7.31,66.39,173607,173677
2782,63,41,1,8.13,80.14,173676,173739
2783,59,71,1,8.68,162.18,173739,173798
2784,75,34,1,6.83,49.34,173797,173872
2785,66,32,1,7.76,52.88,173871,173937
2786,60,36,1,8.53,98.22,173936,173996
2787,49,51,1,10.45,104.37,173995,174044
2788,65,60,1,7.88,110.88,174043,174108
2789,67,55,1,7.64,91.01,174107,174174
2790,65,88,1,7.88,131.15,174173,174238
2791,71,65,1,7.21,91.60,174237,174308
2792,54,64,1,9.48,133.88,174307,174361
2793,70,36,1,7.31,62.47,174360,174430
2794,64,45,1,8.00,92.03,174430,174494
2795,69,35,1,7.42,58.50,174493,174562
2796,81,29,1,6.32,23.97,174561,174642
2797,48,100,1,10.67,234.43,174641,174689
2798,84,24,1,6.10,31.51,174689,174773
2799,66,94,1,7.76,182.18,174772,174838
2800,67,72,1,7.64,107.63,174837,174904
2801,49,41,1,10.45,118.08,174903,174952
2802,73,39,1,7.01,55.99,174951,175024
2803,46,73,1,11.13,188.81,175023,175069
2804,67,36,1,7.64,79.63,175068,175135
2805,44,159,1,11.64,612.05,175135,175179
2806,82,34,1,6.24,38.60,175178,175260
2807,62,63,1,8.26,98.35,175259,175321
2808,72,36,1,7.11,66.27,175320,175392
2809,55,82,1,9.31,175.52,175391,175446
2810,64,36,1,8.00,92.03,175445,175509
2811,60,60,1,8.53,131.75,175508,175568
2812,59,36,1,8.68,90.29,175567,175626
2813,57,51,1,8.98,104.12,175625,175682
2814,73,80,1,7.01,109.79,175681,175754
2815,52,76,1,9.85,162.13,175753,175805
2816,58,36,1,8.83,67.76,175805,175863
2817,49,72,1,10.45,278.49,175862,175911
2818,60,62,0,8.53,122.98,175910,175970
2819,70,37,1,7.31,62.13,175969,176039
2820,63,35,1,8.13,68.84,176038,176101
2821,78,50,1,6.56,71.66,176101,176179
2822,53,46,1,9.66,96.22,176178,176231
2823,66,36,1,7.76,76.49,176230,176296
2824,58,57,1,8.83,95.25,176295,176353
2825,61,57,1,8.39,99.62,176352,176413
2826,24,244,2,21.33,2454.89,176412,176436
2827,55,40,1,9.31,91.89,176435,176490
2828,73,40,0,7.01,64.26,176489,176562
2829,49,36,1,10.45,123.35,176562,176611
2830,63,43,1,8.13,103.06,176610,176673
2831,56,36,1,9.14,71.30,176672,176728
2832,59,35,1,8.68,90.49,176727,176786
2833,51,61,1,10.04,144.35,176785,176836
2834,54,62,1,9.48,152.92,176835,176889
2835,67,37,1,7.64,74.32,176888,176955
2836,76,37,0,6.74,60.96,176954,177030
2837,76,48,1,6.74,52.43,177029,177105
2838,60,36,1,8.53,69.08,177104,177164
2839,63,58,1,8.13,101.09,177164,177227
2840,76,34,1,6.74,50.80,177226,177302
2841,62,36,1,8.26,72.87,177301,177363
2842,70,48,1,7.31,84.10,177362,177432
2843,80,42,1,6.40,47.94,177431,177511
2844,59,56,0,8.68,117.71,177510,177569
2845,57,35,1,8.98,79.00,177568,177625
2846,66,35,1,7.76,66.88,177624,177690
2847,75,44,1,6.83,54.97,177689,177764
2848,69,28,1,7.42,46.01,177763,177832
2849,57,46,1,8.98,135.88,177831,177888
2850,56,98,1,9.14,208.41,177887,177943
2851,60,52,1,8.53,148.32,177942,178002
2852,56,41,1,9.14,111.09,178001,178057
2853,71,36,1,7.21,57.97,178056,178127
2854,57,37,1,8.98,93.84,178126,178183
2855,61,71,1,8.39,122.04,178182,178243
2856,48,83,1,10.67,290.14,178242,178290
2857,29,98,1,17.66,608.36,178289,178318
2858,71,52,1,7.21,86.84,178317,178388
2859,78,53,1,6.56,82.02,178387,178465
2860,71,51,1,7.21,77.12,178464,178535
2861,50,52,1,10.24,162.62,178534,178584
2862,62,64,1,8.26,87.97,178583,178645
2863,67,36,1,7.64,63.13,178644,178711
2864,70,54,1,7.31,95.13,178710,178780
2865,60,68,1,8.53,162.98,178780,178840
2866,85,36,1,6.02,37.86,178839,178924
2867,71,48,0,7.21,80.73,178923,178994
2868,66,42,1,7.76,79.97,178993,179059
2869,68,57,1,7.53,117.69,179058,179126
2870,71,36,1,7.21,49.63,179125,179196
2871,58,52,1,8.83,98.94,179195,179253
2872,37,235,1,13.84,1448.08,179252,179289
2873,58,63,1,8.83,137.69,179288,179346
2874,55,66,1,9.31,139.45,179345,179400
2875,65,45,1,7.88,80.05,179399,179464
2876,66,43,1,7.76,72.24,179463,179529
2877,74,36,0,6.92,50.97,179528,179602
2878,72,35,1,7.11,52.63,179602,179674
2879,57,52,1,8.98,98.02,179673,179730
2880,52,37,1,9.85,89.98,179729,179781
2881,55,66,1,9.31,163.20,179780,179835
2882,81,31,1,6.32,41.72,179834,179915
2883,45,101,1,11.38,311.75,179914,179959
2884,41,60,1,12.49,190.10,179958,179999
2885,61,80,1,8.39,129.06,179999,180060
2886,54,64,1,9.48,172.88,180059,180113
2887,77,36,1,6.65,55.03,180112,180189
2888,58,56,1,8.83,112.45,180188,180246
2889,78,36,1,6.56,54.12,180245,180323
2890,56,63,1,9.14,112.19,180322,180378
2891,64,64,1,8.00,96.41,180377,180441
2892,66,45,1,7.76,80.64,180440,180506
2893,49,82,1,10.45,187.59,180505,180554
2894,56,62,1,9.14,162.87,180553,180609
2895,30,247,1,17.07,1892.40,180608,180638
2896,72,51,1,7.11,68.27,180637,180709
2897,58,95,1,8.83,188.83,180708,180766
2898,22,231,1,23.27,2473.65,180765,180787
2899,76,62,1,6.74,78.40,180786,180862
2900,59,96,1,8.68,206.18,180861,180920
2901,69,45,1,7.42,90.27,180919,180988
2902,78,36,1,6.56,41.78,180987,181065
2903,43,81,1,11.91,284.22,181064,181107
2904,97,42,1,5.28,31.46,181106,181203
2905,48,98,1,10.67,261.31,181202,181250
2906,59,52,1,8.68,117.13,181250,181309
2907,67,36,1,7.64,70.56,181308,181375
2908,69,50,1,7.42,80.56,181374,181443
2909,70,28,1,7.31,41.07,181442,181512
2910,60,45,1,8.53,81.55,181512,181572
2911,52,60,1,9.85,131.40,181572,181624
2912,61,70,1,8.39,151.39,181623,181684
2913,75,53,1,6.83,65.08,181683,181758
2914,67,50,1,7.64,81.75,181757,181824
2915,74,72,1,6.92,107.89,181823,181897
2916,61,97,1,8.39,295.88,181896,181957
2917,63,35,1,8.13,74.02,181957,182020
2918,66,68,1,7.76,102.55,182019,182085
2919,74,36,1,6.92,47.51,182084,182158
2920,64,50,1,8.00,86.16,182158,182222
2921,65,40,1,7.88,62.26,182221,182286
2922,79,36,1,6.48,50.58,182285,182364
2923,65,40,1,7.88,86.85,182363,182428
2924,44,86,1,11.64,242.10,182428,182472
2925,67,61,1,7.64,119.36,182471,182538
2926,67,41,1,7.64,64.47,182537,182604
2927,51,75,1,10.04,210.51,182603,182654
2928,61,41,1,8.39,87.39,182653,182714
2929,75,35,1,6.83,47.74,182713,182788
2930,76,66,1,6.74,87.14,182787,182863
2931,58,48,0,8.83,91.28,182862,182920
2932,59,65,1,8.68,119.81,182919,182978
2933,59,49,1,8.68,119.88,182977,183036
2934,53,53,1,9.66,117.88,183035,183088
2935,65,55,1,7.88,93.52,183087,183152
2936,79,30,1,6.48,28.30,183151,183230
2937,66,77,1,7.76,181.91,183229,183295
2938,57,79,1,8.98,159.60,183294,183351
2939,54,87,1,9.48,183.40,183351,183405
2940,50,82,1,10.24,217.02,183404,183454
2941,52,88,1,9.85,232.82,183453,183505
2942,66,46,1,7.76,69.79,183504,183570
2943,76,71,1,6.74,123.67,183570,183646
2944,56,36,1,9.14,99.30,183645,183701
2945,51,119,1,10.04,292.70,183700,183751
2946,62,104,1,8.26,205.68,183750,183812
2947,61,92,1,8.39,165.35,183811,183872
2948,70,53,1,7.31,71.62,183871,183941
2949,50,92,1,10.24,271.98,183941,183991
2950,71,38,1,7.21,72.45,183990,184061
2951,72,36,1,7.11,51.79,184060,184132
2952,39,47,1,13.13,158.83,184131,184170
2953,75,36,1,6.83,47.58,184169,184244
2954,59,44,1,8.68,83.98,184243,184302
2955,53,62,1,9.66,169.24,184301,184354
2956,64,78,1,8.00,135.25,184353,184417
2957,70,36,1,7.31,55.56,184416,184486
2958,66,36,1,7.76,65.37,184485,184551
2959,83,36,0,6.17,39.88,184550,184633
2960,54,61,1,9.48,137.03,184632,184686
2961,51,81,1,10.04,178.08,184685,184736
2962,63,143,1,8.13,320.90,184736,184799
2963,63,41,1,8.13,86.02,184798,184861
2964,76,56,1,6.74,77.80,184860,184936
2965,64,62,1,8.00,110.50,184935,184999
2966,63,41,1,8.13,80.97,184999,185062
2967,47,49,1,10.89,140.14,185061,185108
2968,71,70,1,7.21,100.65,185107,185178
2969,68,36,1,7.53,49.54,185178,185246
2970,67,66,1,7.64,92.80,185245,185312
2971,61,61,1,8.39,108.24,185311,185372
2972,71,70,1,7.21,106.65,185371,185442
2973,83,39,1,6.17,53.97,185441,185524
2974,63,69,1,8.13,138.14,185523,185586
2975,54,211,1,9.48,822.29,185585,185639
2976,55,49,1,9.31,138.61,185638,185693
2977,75,63,1,6.83,81.80,185693,185768
2978,64,62,1,8.00,111.81,185767,185831
2979,79,36,1,6.48,46.43,185830,185909
2980,73,31,1,7.01,47.79,185908,185981
2981,67,56,1,7.64,89.30,185980,186047
2982,65,36,1,7.88,57.31,186046,186111
2983,62,68,1,8.26,106.97,186110,186172
2984,72,38,1,7.11,70.24,186171,186243
2985,51,51,1,10.04,136.31,186242,186293
2986,47,88,1,10.89,231.54,186292,186339
2987,50,56,1,10.24,144.30,186338,186388
2988,57,69,1,8.98,137.53,186388,186445
2989,58,56,1,8.83,101.38,186444,186502
2990,82,30,1,6.24,42.31,186501,186583
2991,62,88,1,8.26,163.19,186582,186644
2992,83,50,1,6.17,64.26,186643,186726
2993,38,100,1,13.47,495.83,186725,186763
2994,52,61,1,9.85,198.48,186762,186814
2995,62,52,1,8.26,85.77,186813,186875
2996,56,39,1,9.14,98.59,186874,186930
2997,76,36,0,6.74,55.38,186929,187005
2998,65,37,1,7.88,77.43,187004,187069
2999,61,57,1,8.39,102.24,187068,187129
3000,77,61,1,6.65,83.66,187128,187205
3001,55,55,1,9.31,125.60,187204,187259
3002,75,35,1,6.83,41.64,187258,187333
3003,61,64,1,8.39,123.62,187332,187393
3004,31,111,1,16.52,711.48,187392,187423
3005,68,36,1,7.53,70.07,187422,187490
3006,66,46,1,7.76,63.61,187489,187555
3007,50,61,1,10.24,151.42,187554,187604
3008,57,67,1,8.98,158.19,187604,187661
3009,68,35,1,7.53,52.93,187660,187728
3010,60,50,1,8.53,111.65,187728,187788
3011,51,56,1,10.04,160.59,187788,187839
3012,63,36,1,8.13,67.60,187838,187901
3013,55,104,1,9.31,221.45,187900,187955
3014,52,52,1,9.85,120.51,187954,188006
3015,50,61,1,10.24,194.78,188005,188055
3016,72,34,1,7.11,55.29,188054,188126
3017,70,50,1,7.31,64.87,188125,188195
3018,74,33,1,6.92,55.56,188194,188268
3019,27,217,1,18.96,1691.15,188267,188294
3020,71,53,0,7.21,76.53,188293,188364
3021,51,109,0,10.04,277.61,188363,188414
3022,68,36,1,7.53,78.51,188413,188481
3023,56,234,1,9.14,944.34,188480,188536
3024,57,66,1,8.98,150.44,188535,188592
3025,57,97,1,8.98,185.53,188591,188648
3026,78,34,1,6.56,51.17,188648,188726
3027,67,64,1,7.64,106.89,188725,188792
3028,70,27,1,7.31,37.82,188791,188861
3029,66,36,1,7.76,59.52,188860,188926
3030,53,134,1,9.66,353.62,188925,188978
3031,64,113,1,8.00,216.59,188977,189041
3032,67,45,1,7.64,67.07,189040,189107
3033,73,74,1,7.01,94.18,189106,189179
3034,55,56,0,9.31,137.49,189178,189233
3035,65,35,1,7.88,65.68,189232,189297
3036,44,140,1,11.64,467.14,189296,189340
3037,50,80,1,10.24,168.26,189339,189389
3038,66,60,1,7.76,100.46,189388,189454
3039,47,61,1,10.89,208.95,189453,189500
3040,40,63,1,12.80,247.76,189499,189539
3041,38,101,1,13.47,366.78,189538,189576
3042,85,32,1,6.02,37.69,189575,189660
3043,57,46,1,8.98,114.47,189659,189716
3044,73,42,1,7.01,57.74,189715,189788
3045,65,60,1,7.88,126.66,189788,189853
3046,56,61,1,9.14,120.87,189852,189908
3047,66,44,1,7.76,82.15,189907,189973
3048,69,39,1,7.42,73.11,189972,190041
3049,70,52,1,7.31,87.56,190040,190110
3050,50,63,1,10.24,136.90,190109,190159
3051,69,36,1,7.42,70.42,190158,190227
3052,64,36,1,8.00,63.34,190227,190291
3053,66,60,1,7.76,94.34,190290,190356
3054,69,75,1,7.42,110.68,190356,190425
3055,64,88,1,8.00,158.00,190424,190488
3056,79,36,1,6.48,53.82,190488,190567
3057,47,85,1,10.89,256.10,190567,190614
3058,75,36,1,6.83,59.24,190613,190688
3059,89,36,1,5.75,29.76,190687,190776
3060,70,63,1,7.31,111.13,190775,190845
3061,64,68,1,8.00,103.44,190844,190908
3062,64,51,1,8.00,93.78,190907,190971
3063,55,192,1,9.31,655.89,190970,191025
3064,83,36,1,6.17,50.65,191024,191107
3065,43,91,1,11.91,281.11,191106,191149
3066,68,34,1,7.53,65.48,191149,191217
3067,44,197,1,11.64,850.10,191216,191260
3068,73,47,1,7.01,61.71,191260,191333
3069,54,50,1,9.48,122.88,191332,191386
3070,80,36,1,6.40,42.84,191385,191465
3071,60,50,1,8.53,118.32,191464,191524
3072,64,61,1,8.00,101.84,191523,191587
3073,71,36,1,7.21,35.49,191587,191658
3074,60,76,1,8.53,144.02,191657,191717
3075,51,100,1,10.04,255.88,191716,191767
3076,69,40,1,7.42,65.20,191767,191836
3077,75,36,1,6.83,53.56,191835,191910
3078,65,61,1,7.88,114.60,191909,191974
3079,60,88,1,8.53,145.98,191973,192033
3080,71,36,1,7.21,58.11,192032,192103
3081,47,63,1,10.89,138.44,192102,192149
3082,84,31,1,6.10,32.28,192148,192232
3083,73,34,1,7.01,53.33,192231,192304
3084,90,36,1,5.69,34.64,192304,192394
3085,65,61,1,7.88,84.42,192393,192458
3086,71,36,1,7.21,56.45,192457,192528
3087,73,49,1,7.01,71.49,192527,192600
3088,64,36,1,8.00,70.31,192599,192663
3089,67,36,1,7.64,50.68,192662,192729
3090,60,63,1,8.53,152.22,192728,192788
3091,65,60,1,7.88,119.77,192787,192852
3092,42,45,1,12.19,140.96,192851,192893
3093,58,50,1,8.83,98.73,192893,192951
3094,69,52,1,7.42,67.17,192950,193019
3095,68,89,1,7.53,144.81,193018,193086
3096,69,52,1,7.42,85.46,193085,193154
3097,57,62,1,8.98,110.16,193153,193210
3098,60,66,1,8.53,136.98,193209,193269
3099,58,51,1,8.83,105.90,193268,193326
3100,49,57,1,10.45,165.19,193326,193375
3101,66,50,1,7.76,75.94,193374,193440
3102,60,42,1,8.53,95.42,193439,193499
3103,57,98,0,8.98,215.74,193498,193555
3104,65,55,1,7.88,95.12,193554,193619
3105,56,88,1,9.14,174.27,193618,193674
3106,58,39,1,8.83,89.45,193673,193731
3107,65,64,1,7.88,94.42,193730,193795
3108,50,56,1,10.24,117.62,193794,193844
3109,75,36,1,6.83,55.08,193843,193918
3110,60,48,1,8.53,108.95,193917,193977
3111,53,65,0,9.66,138.83,193976,194029
3112,68,73,1,7.53,115.04,194028,194096
3113,66,50,1,7.76,86.76,194095,194161
3114,73,35,1,7.01,58.73,194160,194233
3115,76,36,1,6.74,46.04,194232,194308
3116,30,155,1,17.07,1011.93,194307,194337
3117,73,82,1,7.01,104.01,194336,194409
3118,61,36,1,8.39,72.40,194408,194469
3119,54,62,1,9.48,144.43,194469,194523
3120,57,51,1,8.98,94.12,194522,194579
3121,68,56,1,7.53,77.54,194578,194646
3122,72,44,1,7.11,64.60,194645,194717
3123,82,33,1,6.24,51.53,194717,194799
3124,65,53,1,7.88,91.43,194798,194863
3125,74,56,1,6.92,72.83,194862,194936
3126,54,72,1,9.48,175.14,194935,194989
3127,80,29,1,6.40,36.17,194988,195068
3128,33,200,1,15.52,1208.73,195067,195100
3129,76,48,1,6.74,58.64,195099,195175
3130,73,46,1,7.01,65.88,195174,195247
3131,57,69,1,8.98,138.79,195246,195303
3132,53,53,1,9.66,144.60,195302,195355
3133,73,41,1,7.01,58.97,195354,195427
3134,54,100,1,9.48,251.18,195426,195480
3135,63,52,1,8.13,97.13,195479,195542
3136,64,39,1,8.00,78.56,195541,195605
3137,56,81,1,9.14,170.37,195604,195660
3138,52,39,1,9.85,76.44,195660,195712
3139,61,60,1,8.39,102.27,195711,195772
3140,70,47,1,7.31,63.47,195771,195841
3141,47,92,1,10.89,244.82,195840,195887
3142,38,211,1,13.47,1138.41,195886,195924
3143,60,52,1,8.53,101.08,195923,195983
3144,49,61,1,10.45,156.33,195982,196031
3145,87,19,1,5.89,19.87,196030,196117
3146,72,48,1,7.11,56.13,196116,196188
3147,71,32,1,7.21,48.73,196187,196258
3148,70,36,1,7.31,65.50,196257,196327
3149,55,63,1,9.31,143.38,196326,196381
3150,71,36,1,7.21,64.62,196380,196451
3151,66,36,1,7.76,69.82,196450,196516
3152,60,50,1,8.53,93.58,196515,196575
3153,53,236,1,9.66,1016.00,196574,196627
3154,70,39,1,7.31,65.13,196626,196696
3155,59,36,1,8.68,78.35,196695,196754
3156,65,61,1,7.88,101.15,196753,196818
3157,58,48,1,8.83,123.42,196818,196876
3158,60,56,1,8.53,120.45,196875,196935
3159,76,35,1,6.74,46.96,196934,197010
3160,53,73,1,9.66,153.05,197009,197062
3161,63,63,1,8.13,123.98,197062,197125
3162,70,39,1,7.31,56.53,197124,197194
3163,59,95,1,8.68,186.66,197193,197252
3164,64,60,1,8.00,93.22,197252,197316
3165,58,108,1,8.83,210.28,197315,197373
3166,66,36,1,7.76,63.82,197372,197438
3167,56,52,1,9.14,118.62,197437,197493
3168,56,89,1,9.14,165.23,197492,197548
3169,57,98,1,8.98,237.60,197548,197605
3170,59,75,1,8.68,141.71,197604,197663
3171,56,53,1,9.14,117.73,197662,197718
3172,57,64,1,8.98,146.05,197717,197774
3173,79,40,1,6.48,58.98,197773,197852
3174,70,44,1,7.31,79.02,197851,197921
3175,54,94,1,9.48,179.58,197920,197974
3176,70,52,1,7.31,83.10,197973,198043
3177,77,28,1,6.65,36.28,198042,198119
3178,63,49,0,8.13,82.17,198118,198181
3179,70,54,1,7.31,76.33,198180,198250
3180,64,52,0,8.00,79.72,198249,198313
3181,63,100,1,8.13,188.02,198312,198375
3182,88,33,1,5.82,31.97,198374,198462
3183,59,52,1,8.68,94.25,198461,198520
3184,74,35,1,6.92,41.13,198519,198593
3185,69,65,0,7.42,111.23,198592,198661
3186,59,51,1,8.68,102.29,198660,198719
3187,53,61,1,9.66,141.09,198718,198771
3188,67,51,1,7.64,82.29,198770,198837
3189,58,71,1,8.83,117.18,198836,198894
3190,57,60,1,8.98,140.02,198893,198950
3191,59,86,0,8.68,201.71,198949,199008
3192,71,56,1,7.21,89.80,199007,199078
3193,52,98,1,9.85,221.25,199077,199129
3194,56,109,1,9.14,226.66,199128,199184
3195,66,74,1,7.76,117.00,199183,199249
3196,65,40,1,7.88,72.38,199248,199313
3197,85,36,1,6.02,33.06,199312,199397
3198,80,36,1,6.40,45.34,199396,199476
3199,59,63,1,8.68,131.64,199475,199534
3200,67,62,1,7.64,96.56,199533,199600
3201,45,51,1,11.38,124.77,199599,199644
3202,63,112,0,8.13,224.87,199643,199706
3203,71,34,1,7.21,50.39,199705,199776
3204,52,104,1,9.85,331.51,199775,199827
3205,71,36,1,7.21,56.56,199826,199897
3206,52,53,1,9.85,158.63,199897,199949
3207,46,65,1,11.13,192.46,199948,199994
3208,57,53,1,8.98,117.63,199993,200050
3209,67,49,1,7.64,80.35,200049,200116
3210,65,56,1,7.88,93.95,200115,200180
3211,64,39,1,8.00,90.31,200179,200243
3212,69,36,0,7.42,55.81,200242,200311
3213,69,60,1,7.42,126.30,200311,200380
3214,66,77,0,7.76,164.49,200379,200445
3215,72,35,1,7.11,52.63,200445,200517
3216,69,48,1,7.42,82.27,200516,200585
3217,62,36,1,8.26,89.61,200584,200646
3218,61,36,1,8.39,56.44,200645,200706
3219,57,61,1,8.98,175.98,200705,200762
3220,61,36,1,8.39,57.29,200762,200823
3221,67,46,1,7.64,79.90,200822,200889
3222,72,46,1,7.11,71.07,200889,200961
3223,76,36,1,6.74,70.93,200960,201036
3224,62,29,1,8.26,61.03,201035,201097
3225,76,67,1,6.74,66.75,201096,201172
3226,66,69,1,7.76,111.88,201171,201237
3227,48,145,1,10.67,595.56,201236,201284
3228,57,61,1,8.98,120.51,201284,201341
3229,58,51,1,8.83,110.25,201341,201399
3230,55,63,2,9.31,201.41,201399,201454
3231,71,44,1,7.21,90.42,201453,201524
3232,48,107,1,10.67,337.22,201523,201571
3233,57,35,1,8.98,76.93,201571,201628
3234,69,35,1,7.42,65.49,201627,201696
3235,68,35,1,7.53,70.13,201695,201763
3236,62,73,1,8.26,126.39,201762,201824
3237,52,38,1,9.85,95.13,201823,201875
3238,73,43,1,7.01,63.88,201874,201947
3239,46,69,1,11.13,210.24,201946,201992
3240,56,68,1,9.14,147.77,201991,202047
3241,57,52,1,8.98,109.56,202046,202103
3242,61,45,1,8.39,106.80,202102,202163
3243,65,56,1,7.88,80.02,202162,202227
3244,73,72,1,7.01,103.25,202226,202299
3245,50,93,1,10.24,259.94,202298,202348
3246,80,35,1,6.40,38.39,202347,202427
3247,54,70,1,9.48,142.84,202426,202480
3248,64,60,1,8.00,115.09,202479,202543
3249,65,36,1,7.88,59.95,202542,202607
3250,55,61,1,9.31,139.41,202606,202661
3251,58,48,1,8.83,98.18,202660,202718
3252,66,62,1,7.76,91.73,202718,202784
3253,47,59,1,10.89,136.73,202783,202830
3254,71,56,1,7.21,78.03,202829,202900
3255,69,63,1,7.42,93.26,202899,202968
3256,75,43,1,6.83,55.85,202967,203042
3257,59,113,1,8.68,263.03,203041,203100
3258,70,53,1,7.31,79.24,203099,203169
3259,44,69,1,11.64,217.46,203168,203212
3260,63,35,1,8.13,65.48,203211,203274
3261,57,78,1,8.98,155.91,203273,203330
3262,47,60,1,10.89,153.20,203329,203376
3263,62,36,1,8.26,77.61,203376,203438
3264,67,34,1,7.64,60.20,203437,203504
3265,60,45,1,8.53,73.65,203503,203563
3266,74,47,1,6.92,61.05,203562,203636
3267,72,55,0,7.11,82.32,203635,203707
3268,54,45,0,9.48,111.14,203706,203760
3269,69,35,1,7.42,53.32,203759,203828
3270,59,50,1,8.68,108.83,203827,203886
3271,52,63,1,9.85,171.55,203885,203937
3272,64,52,1,8.00,119.75,203937,204001
3273,64,48,1,8.00,86.44,204000,204064
3274,50,80,1,10.24,200.90,204063,204113
3275,78,34,1,6.56,43.35,204112,204190
3276,72,38,1,7.11,54.46,204189,204261
3277,72,70,1,7.11,109.88,204260,204332
3278,53,39,1,9.66,98.75,204331,204384
3279,65,86,1,7.88,142.45,204384,204449
3280,64,54,1,8.00,82.06,204448,204512
3281,69,36,1,7.42,64.36,204511,204580
3282,60,46,1,8.53,100.28,204579,204639
3283,72,36,1,7.11,48.15,204639,204711
3284,74,49,1,6.92,69.83,204710,204784
3285,77,35,0,6.65,41.08,204784,204861
3286,60,61,1,8.53,119.25,204860,204920
3287,69,52,1,7.42,79.26,204919,204988
3288,49,60,1,10.45,163.23,204987,205036
3289,60,36,1,8.53,97.42,205035,205095
3290,62,65,1,8.26,144.32,205094,205156
3291,92,35,1,5.57,28.70,205155,205247
3292,74,52,1,6.92,84.16,205246,205320
3293,54,62,1,9.48,158.62,205319,205373
3294,58,71,1,8.83,132.80,205372,205430
3295,68,39,1,7.53,72.78,205429,205497
3296,50,156,1,10.24,487.94,205496,205546
3297,63,34,1,8.13,72.40,205545,205608
3298,61,47,1,8.39,82.66,205607,205668
3299,49,95,1,10.45,249.10,205667,205716
3300,65,32,1,7.88,59.89,205715,205780
3301,48,85,1,10.67,269.06,205779,205827
3302,64,44,1,8.00,84.50,205827,205891
3303,51,42,1,10.04,96.86,205890,205941
3304,47,62,1,10.89,162.61,205940,205987
3305,63,61,1,8.13,122.02,205986,206049
3306,51,53,1,10.04,149.84,206048,206099
3307,78,27,1,6.56,36.04,206098,206176
3308,77,44,1,6.65,55.21,206175,206252
3309,87,39,1,5.89,37.21,206251,206338
3310,52,70,1,9.85,185.17,206337,206389
3311,67,43,1,7.64,61.90,206388,206455
3312,58,43,1,8.83,87.32,206454,206512
3313,76,34,1,6.74,45.40,206512,206588
3314,50,85,1,10.24,207.86,206587,206637
3315,79,36,1,6.48,56.71,206636,206715
3316,62,55,1,8.26,105.51,206714,206776
3317,66,46,1,7.76,77.27,206775,206841
3318,75,50,1,6.83,59.85,206841,206916
3319,46,60,1,11.13,133.46,206915,206961
3320,64,36,1,8.00,71.44,206960,207024
3321,74,32,1,6.92,52.13,207023,207097
3322,71,36,1,7.21,57.07,207096,207167
3323,62,41,1,8.26,70.93,207166,207228
3324,78,36,1,6.56,41.17,207227,207305
3325,73,50,1,7.01,66.18,207304,207377
3326,55,79,1,9.31,193.49,207376,207431
3327,61,60,1,8.39,130.17,207430,207491
3328,64,55,1,8.00,79.47,207491,207555
3329,57,43,1,8.98,94.58,207554,207611
3330,72,57,1,7.11,72.18,207610,207682
3331,71,42,1,7.21,64.31,207681,207752
3332,70,49,1,7.31,81.19,207751,207821
3333,64,60,1,8.00,119.50,207820,207884
3334,66,35,1,7.76,60.09,207883,207949
3335,62,36,1,8.26,70.16,207948,208010
3336,77,35,1,6.65,47.84,208009,208086
3337,59,78,1,8.68,150.08,208085,208144
3338,55,36,1,9.31,100.00,208143,208198
3339,68,50,0,7.53,75.60,208197,208265
3340,81,36,1,6.32,51.90,208265,208346
3341,59,74,1,8.68,155.03,208345,208404
3342,68,63,1,7.53,104.22,208403,208471
3343,66,55,1,7.76,84.12,208470,208536
3344,52,61,1,9.85,135.98,208535,208587
3345,48,51,1,10.67,126.81,208586,208634
3346,56,48,1,9.14,123.23,208633,208689
3347,57,105,1,8.98,270.12,208688,208745
3348,75,46,1,6.83,74.20,208744,208819
3349,61,65,1,8.39,135.55,208818,208879
3350,65,55,1,7.88,86.94,208878,208943
3351,78,48,1,6.56,47.07,208942,209020
3352,80,36,1,6.40,38.61,209019,209099
3353,69,47,1,7.42,83.58,209098,209167
3354,64,60,1,8.00,114.03,209166,209230
3355,48,45,1,10.67,124.81,209229,209277
3356,55,49,1,9.31,132.14,209276,209331
3357,75,36,1,6.83,40.70,209330,209405
3358,63,53,1,8.13,122.05,209404,209467
3359,54,85,1,9.48,206.21,209466,209520
3360,58,108,1,8.83,225.42,209520,209578
3361,56,37,1,9.14,90.19,209577,209633
3362,76,34,1,6.74,55.77,209632,209708
3363,57,50,1,8.98,92.89,209708,209765
3364,63,62,1,8.13,98.49,209764,209827
3365,50,51,1,10.24,138.82,209827,209877
3366,94,31,1,5.45,24.95,209876,209970
3367,62,71,1,8.26,139.42,209969,210031
3368,66,80,1,7.76,103.67,210030,210096
3369,67,36,1,7.64,68.29,210095,210162
3370,67,38,1,7.64,59.39,210161,210228
3371,53,77,1,9.66,194.00,210227,210280
3372,55,98,1,9.31,235.12,210279,210334
3373,63,51,1,8.13,91.44,210333,210396
3374,60,84,1,8.53,189.95,210395,210455
3375,60,60,1,8.53,91.42,210454,210514
3376,70,80,1,7.31,144.16,210513,210583
3377,63,60,1,8.13,112.68,210582,210645
3378,65,40,1,7.88,90.91,210645,210710
3379,60,36,1,8.53,66.05,210709,210769
3380,55,92,1,9.31,198.80,210768,210823
3381,54,60,1,9.48,123.40,210823,210877
3382,59,60,1,8.68,108.83,210876,210935
3383,68,38,1,7.53,60.60,210934,211002
3384,60,50,1,8.53,82.08,211001,211061
3385,65,110,1,7.88,206.66,211060,211125
3386,62,80,1,8.26,180.35,211124,211186
3387,74,52,1,6.92,74.70,211186,211260
3388,52,50,1,9.85,163.44,211259,211311
3389,59,36,1,8.68,72.79,211310,211369
3390,46,42,1,11.13,127.24,211369,211415
3391,64,35,1,8.00,56.84,211414,211478
3392,71,40,1,7.21,61.07,211477,211548
3393,67,52,1,7.64,81.16,211547,211614
3394,61,99,1,8.39,203.09,211613,211674
3395,57,56,1,8.98,130.75,211673,211730
3396,74,60,1,6.92,65.99,211729,211803
3397,60,99,1,8.53,179.35,211802,211862
3398,46,78,1,11.13,250.77,211861,211907
3399,68,65,1,7.53,112.72,211906,211974
3400,79,27,1,6.48,29.62,211973,212052
3401,68,56,1,7.53,80.75,212051,212119
3402,69,83,1,7.42,115.23,212118,212187
3403,58,90,1,8.83,158.52,212186,212244
3404,53,56,1,9.66,130.07,212243,212296
3405,82,50,1,6.24,79.60,212295,212377
3406,56,60,1,9.14,131.12,212376,212432
3407,68,62,1,7.53,110.69,212431,212499
3408,68,34,1,7.53,46.46,212498,212566
3409,72,93,1,7.11,125.90,212565,212637
3410,71,39,1,7.21,52.08,212636,212707
3411,72,36,1,7.11,54.74,212706,212778
3412,45,68,1,11.38,207.04,212777,212822
3413,44,67,1,11.64,232.50,212821,212865
3414,53,51,1,9.66,124.56,212864,212917
3415,65,56,1,7.88,101.92,212916,212981
3416,71,36,1,7.21,68.62,212980,213051
3417,81,31,1,6.32,45.23,213050,213131
3418,44,80,1,11.64,212.19,213131,213175
3419,54,57,1,9.48,112.88,213174,213228
3420,78,54,1,6.56,58.73,213227,213305
3421,64,36,1,8.00,78.50,213304,213368
3422,67,61,1,7.64,83.10,213367,213434
3423,69,55,1,7.42,86.33,213433,213502
3424,40,166,1,12.80,687.71,213501,213541
3425,51,197,1,10.04,724.94,213540,213591
3426,65,36,1,7.88,79.31,213590,213655
3427,55,55,1,9.31,134.00,213654,213709
3428,64,60,1,8.00,109.31,213708,213772
3429,64,60,1,8.00,96.06,213771,213835
3430,74,76,1,6.92,102.59,213834,213908
3431,63,60,1,8.13,98.56,213907,213970
3432,95,58,1,5.39,51.63,213969,214064
3433,47,62,1,10.89,168.95,214063,214110
3434,58,38,1,8.83,89.97,214109,214167
3435,72,60,1,7.11,108.88,214167,214239
3436,67,48,1,7.64,82.35,214238,214305
3437,48,62,1,10.67,168.22,214304,214352
3438,43,72,1,11.91,214.41,214351,214394
3439,34,126,1,15.06,616.23,214393,214427
3440,64,78,1,8.00,132.97,214426,214490
3441,59,80,1,8.68,140.79,214489,214548
3442,69,50,1,7.42,67.87,214547,214616
3443,62,64,1,8.26,125.74,214615,214677
3444,65,29,1,7.88,50.02,214676,214741
3445,66,54,1,7.76,82.49,214740,214806
3446,73,35,1,7.01,47.90,214805,214878
3447,68,37,1,7.53,61.28,214877,214945
3448,68,35,1,7.53,76.01,214944,215012
3449,94,36,1,5.45,28.72,215011,215105
3450,54,55,1,9.48,136.47,215104,215158
3451,62,50,1,8.26,67.74,215157,215219
3452,70,72,1,7.31,102.36,215219,215289
3453,70,34,1,7.31,41.36,215288,215358
3454,70,78,1,7.31,107.42,215357,215427
3455,65,38,1,7.88,90.97,215426,215491
3456,48,60,1,10.67,213.22,215490,215538
3457,69,65,0,7.42,97.11,215537,215606
3458,55,61,1,9.31,178.76,215605,215660
3459,65,35,1,7.88,64.69,215660,215725
3460,73,51,1,7.01,75.66,215724,215797
3461,66,42,1,7.76,74.27,215796,215862
3462,56,62,1,9.14,121.84,215861,215917
3463,49,81,1,10.45,202.37,215916,215965
3464,34,103,1,15.06,516.47,215964,215998
3465,64,46,1,8.00,93.62,215997,216061
3466,76,47,1,6.74,62.83,216060,216136
3467,63,59,1,8.13,103.35,216135,216198
3468,87,36,1,5.89,31.09,216197,216284
3469,76,57,1,6.74,70.93,216283,216359
3470,72,36,1,7.11,37.54,216358,216430
3471,59,74,1,8.68,133.10,216429,216488
3472,50,56,1,10.24,122.94,216487,216537
3473,63,53,1,8.13,79.06,216536,216599
3474,61,55,1,8.39,119.35,216598,216659
3475,37,68,1,13.84,303.11,216659,216696
3476,62,72,1,8.26,135.55,216695,216757
3477,83,36,1,6.17,30.55,216756,216839
3478,61,53,1,8.39,99.58,216838,216899
3479,69,82,1,7.42,122.19,216898,216967
3480,55,61,1,9.31,147.52,216966,217021
3481,62,64,1,8.26,94.13,217020,217082
3482,43,75,1,11.91,302.69,217081,217124
3483,59,36,1,8.68,61.64,217123,217182
3484,78,36,1,6.56,45.84,217181,217259
3485,59,61,1,8.68,125.78,217258,217317
3486,54,55,1,9.48,123.66,217317,217371
3487,79,40,1,6.48,76.73,217371,217450
3488,70,36,1,7.31,50.04,217449,217519
3489,55,52,1,9.31,103.27,217518,217573
3490,70,51,1,7.31,80.44,217572,217642
3491,56,46,1,9.14,124.16,217641,217697
3492,73,61,1,7.01,73.41,217697,217770
3493,55,88,1,9.31,236.65,217770,217825
3494,72,36,1,7.11,75.29,217824,217896
3495,59,55,1,8.68,143.91,217896,217955
3496,77,35,1,6.65,50.46,217954,218031
3497,69,45,1,7.42,76.13,218031,218100
3498,53,100,1,9.66,237.24,218099,218152
3499,55,64,1,9.31,140.69,218151,218206
3500,63,89,1,8.13,153.89,218205,218268
3501,75,36,1,6.83,64.57,218267,218342
3502,80,43,1,6.40,50.72,218341,218421
3503,49,95,1,10.45,237.59,218420,218469
3504,57,70,1,8.98,142.82,218468,218525
3505,50,42,1,10.24,123.98,218524,218574
3506,51,80,1,10.04,191.61,218573,218624
3507,68,66,1,7.53,99.72,218623,218691
3508,60,81,1,8.53,137.25,218690,218750
3509,80,36,1,6.40,40.84,218749,218829
3510,61,71,0,8.39,126.01,218828,218889
3511,66,36,1,7.76,59.76,218888,218954
3512,61,137,1,8.39,318.01,218953,219014
3513,69,52,1,7.42,67.66,219013,219082
3514,75,36,1,6.83,51.45,219081,219156
3515,70,48,1,7.31,72.90,219155,219225
3516,68,50,1,7.53,89.19,219225,219293
3517,71,32,1,7.21,55.41,219292,219363
3518,68,53,1,7.53,80.13,219362,219430
3519,65,36,1,7.88,67.25,219429,219494
3520,69,42,1,7.42,71.23,219493,219562
3521,57,59,1,8.98,126.44,219561,219618
3522,77,43,0,6.65,51.53,219617,219694
3523,53,61,1,9.66,141.55,219693,219746
3524,54,135,1,9.48,340.51,219745,219799
3525,49,58,1,10.45,117.31,219798,219847
3526,52,215,1,9.85,866.82,219846,219898
3527,67,36,1,7.64,60.32,219897,219964
3528,48,111,1,10.67,326.93,219963,220011
3529,71,36,1,7.21,46.87,220010,220081
3530,40,84,1,12.80,282.31,220080,220120
3531,54,48,1,9.48,114.62,220119,220173
3532,66,62,1,7.76,87.94,220173,220239
3533,53,61,1,9.66,147.77,220238,220291
3534,38,126,1,13.47,527.09,220291,220329
3535,66,60,1,7.76,89.82,220329,220395
3536,65,100,1,7.88,179.37,220394,220459
3537,70,54,1,7.31,84.62,220458,220528
3538,75,60,1,6.83,79.29,220527,220602
3539,60,47,1,8.53,77.12,220601,220661
3540,58,49,1,8.83,113.32,220660,220718
3541,62,53,1,8.26,89.80,220718,220780
3542,62,60,1,8.26,96.39,220779,220841
3543,64,56,1,8.00,93.38,220840,220904
3544,77,36,1,6.65,47.19,220903,220980
3545,46,88,1,11.13,260.42,220979,221025
3546,61,60,1,8.39,139.32,221024,221085
3547,72,34,1,7.11,56.46,221084,221156
3548,38,111,1,13.47,495.67,221155,221193
3549,52,99,1,9.85,223.05,221192,221244
3550,80,35,1,6.40,46.04,221243,221323
3551,64,60,1,8.00,113.44,221322,221386
3552,57,88,1,8.98,155.32,221386,221443
3553,59,150,1,8.68,373.51,221442,221501
3554,76,46,1,6.74,73.11,221500,221576
3555,57,93,1,8.98,218.54,221575,221632
3556,52,61,1,9.85,125.01,221632,221684
3557,59,110,1,8.68,229.95,221683,221742
3558,62,64,1,8.26,124.51,221741,221803
3559,57,46,1,8.98,78.79,221802,221859
3560,60,60,1,8.53,133.78,221858,221918
3561,51,55,1,10.04,147.21,221917,221968
3562,82,50,1,6.24,55.67,221967,222049
3563,65,36,1,7.88,80.51,222048,222113
3564,63,66,1,8.13,93.63,222112,222175
3565,51,80,1,10.04,176.31,222175,222226
3566,70,39,1,7.31,69.56,222225,222295
3567,70,60,1,7.31,75.82,222294,222364
3568,63,53,1,8.13,133.54,222364,222427
3569,65,60,1,7.88,105.49,222426,222491
3570,60,60,1,8.53,103.55,222490,222550
3571,74,51,1,6.92,89.72,222549,222623
3572,64,74,1,8.00,142.50,222622,222686
3573,50,68,1,10.24,161.66,222686,222736
3574,70,61,1,7.31,93.76,222735,222805
3575,68,36,1,7.53,72.04,222804,222872
3576,75,35,1,6.83,52.86,222871,222946
3577,63,59,1,8.13,99.29,222945,223008
3578,83,20,1,6.17,23.63,223008,223091
3579,59,90,1,8.68,182.83,223090,223149
3580,44,112,1,11.64,364.50,223148,223192
3581,44,51,1,11.64,193.00,223191,223235
3582,71,35,1,7.21,57.94,223234,223305
3583,66,50,1,7.76,65.37,223304,223370
3584,61,53,1,8.39,96.66,223369,223430
3585,57,71,1,8.98,180.05,223429,223486
3586,69,55,1,7.42,77.29,223485,223554
3587,78,41,1,6.56,43.58,223553,223631
3588,49,48,1,10.45,128.04,223630,223679
3589,42,99,1,12.19,320.82,223678,223720
3590,86,34,1,5.95,36.67,223720,223806
3591,63,36,1,8.13,67.38,223805,223868
3592,57,71,1,8.98,159.60,223867,223924
3593,67,34,0,7.64,49.66,223923,223990
3594,53,107,1,9.66,308.71,223989,224042
3595,64,92,1,8.00,144.03,224041,224105
3596,66,61,1,7.76,90.37,224104,224170
3597,55,53,1,9.31,109.16,224170,224225
3598,64,61,1,8.00,120.28,224224,224288
3599,52,50,1,9.85,111.82,224287,224339
3600,57,43,1,8.98,83.00,224338,224395
3601,51,36,1,10.04,110.67,224394,224445
3602,48,59,1,10.67,167.10,224444,224492
3603,58,55,1,8.83,83.76,224491,224549
3604,73,52,1,7.01,57.38,224548,224621
3605,55,45,1,9.31,101.45,224620,224675
3606,67,38,1,7.64,60.53,224674,224741
3607,53,65,1,9.66,202.41,224740,224793
3608,53,35,1,9.66,68.83,224792,224845
3609,59,101,1,8.68,187.54,224845,224904
3610,64,35,0,8.00,56.78,224904,224968
3611,56,56,1,9.14,113.48,224967,225023
3612,73,50,1,7.01,79.74,225022,225095
3613,72,61,1,7.11,85.99,225094,225166
3614,57,57,1,8.98,133.28,225166,225223
3615,75,68,0,6.83,85.26,225222,225297
3616,68,68,1,7.53,106.51,225296,225364
3617,53,77,1,9.66,166.56,225363,225416
3618,68,45,1,7.53,65.84,225415,225483
3619,69,43,1,7.42,68.10,225483,225552
3620,65,60,1,7.88,92.51,225551,225616
3621,75,43,1,6.83,51.16,225615,225690
3622,69,46,1,7.42,71.92,225689,225758
3623,57,43,1,8.98,90.16,225758,225815
3624,53,86,1,9.66,173.92,225814,225867
3625,52,189,1,9.85,678.67,225866,225918
3626,42,75,1,12.19,259.20,225917,225959
3627,47,60,1,10.89,181.84,225958,226005
3628,64,43,1,8.00,83.62,226004,226068
3629,80,60,1,6.40,73.09,226067,226147
3630,88,30,1,5.82,27.38,226146,226234
3631,53,80,1,9.66,186.56,226233,226286
3632,61,35,1,8.39,63.09,226285,226346
3633,80,37,0,6.40,49.62,226345,226425
3634,36,109,1,14.22,457.17,226424,226460
3635,55,77,1,9.31,162.36,226459,226514
3636,72,36,1,7.11,64.96,226513,226585
3637,81,44,0,6.32,40.66,226584,226665
3638,70,55,1,7.31,75.16,226664,226734
3639,53,37,1,9.66,85.02,226733,226786
3640,60,62,1,8.53,146.65,226785,226845
3641,53,49,1,9.66,132.56,226844,226897
3642,58,49,1,8.83,70.25,226896,226954
3643,79,31,0,6.48,38.33,226954,227033
3644,65,40,0,7.88,87.12,227032,227097
3645,63,64,1,8.13,98.40,227096,227159
3646,66,48,1,7.76,96.49,227158,227224
3647,68,36,1,7.53,52.78,227223,227291
3648,65,65,1,7.88,130.38,227290,227355
3649,45,63,1,11.38,206.68,227354,227399
3650,66,60,1,7.76,101.85,227398,227464
3651,87,35,1,5.89,27.09,227463,227550
3652,43,49,1,11.91,161.39,227549,227592
3653,50,105,2,10.24,323.78,227591,227641
3654,72,36,1,7.11,63.63,227640,227712
3655,46,47,1,11.13,111.24,227711,227757
3656,60,36,1,8.53,64.32,227756,227816
3657,65,47,1,7.88,90.45,227815,227880
3658,79,47,1,6.48,39.14,227879,227958
3659,75,44,1,6.83,67.02,227957,228032
3660,66,41,1,7.76,74.64,228031,228097
3661,70,37,1,7.31,68.53,228096,228166
3662,72,44,1,7.11,48.77,228165,228237
3663,75,47,1,6.83,67.64,228236,228311
3664,49,49,1,10.45,116.49,228310,228359
3665,58,102,1,8.83,205.04,228358,228416
3666,81,36,1,6.32,45.13,228415,228496
3667,69,31,1,7.42,46.82,228495,228564
3668,43,60,1,11.91,174.27,228563,228606
3669,70,42,1,7.31,78.73,228605,228675
3670,73,43,1,7.01,73.08,228674,228747
3671,55,60,1,9.31,139.16,228746,228801
3672,68,45,0,7.53,89.48,228800,228868
3673,66,36,1,7.76,62.52,228867,228933
3674,68,35,1,7.53,54.78,228932,229000
3675,56,46,1,9.14,101.80,228999,229055
3676,59,83,1,8.68,184.59,229054,229113
3677,50,66,1,10.24,166.06,229112,229162
3678,74,36,1,6.92,55.67,229161,229235
3679,54,48,1,9.48,121.58,229234,229288
3680,49,94,1,10.45,365.27,229287,229336
3681,79,30,1,6.48,35.74,229335,229414
3682,91,51,1,5.63,56.78,229413,229504
3683,75,36,1,6.83,46.01,229503,229578
3684,50,53,1,10.24,156.14,229578,229628
3685,59,60,1,8.68,124.46,229628,229687
3686,63,57,1,8.13,81.51,229686,229749
3687,72,36,1,7.11,57.57,229749,229821
3688,71,89,1,7.21,120.70,229820,229891
3689,69,50,1,7.42,71.06,229891,229960
3690,44,124,1,11.64,378.37,229959,230003
3691,77,36,1,6.65,43.84,230002,230079
3692,53,145,1,9.66,402.64,230079,230132
3693,70,35,1,7.31,51.87,230131,230201
3694,58,44,1,8.83,97.90,230200,230258
3695,79,46,1,6.48,53.24,230257,230336
3696,69,57,1,7.42,91.75,230335,230404
3697,45,62,1,11.38,210.86,230403,230448
3698,73,36,1,7.01,66.15,230447,230520
3699,61,61,1,8.39,99.45,230519,230580
3700,68,39,1,7.53,73.63,230580,230648
3701,97,30,1,5.28,23.03,230647,230744
3702,49,58,1,10.45,154.86,230743,230792
3703,67,37,1,7.64,55.10,230791,230858
3704,59,63,1,8.68,108.59,230857,230916
3705,73,36,0,7.01,68.84,230915,230988
3706,66,63,1,7.76,104.94,230988,231054
3707,65,35,1,7.88,66.57,231053,231118
3708,69,47,1,7.42,69.03,231117,231186
3709,55,61,1,9.31,116.43,231185,231240
3710,54,49,1,9.48,134.32,231239,231293
3711,72,48,1,7.11,79.96,231292,231364
3712,53,97,1,9.66,215.62,231363,231416
3713,51,36,1,10.04,82.70,231415,231466
3714,64,37,1,8.00,72.47,231465,231529
3715,50,161,1,10.24,513.66,231528,231578
3716,51,197,1,10.04,751.02,231577,231628
3717,66,36,1,7.76,75.49,231627,231693
3718,35,86,1,14.63,411.55,231692,231727
3719,41,116,0,12.49,540.54,231726,231767
3720,51,69,1,10.04,152.16,231766,231817
3721,56,58,1,9.14,139.94,231816,231872
3722,68,36,1,7.53,60.57,231871,231939
3723,65,36,1,7.88,68.26,231938,232003
3724,56,57,1,9.14,106.19,232003,232059
3725,69,36,1,7.42,60.36,232058,232127
3726,61,36,1,8.39,66.53,232126,232187
3727,69,45,1,7.42,72.04,232186,232255
3728,59,54,1,8.68,137.68,232254,232313
3729,68,36,1,7.53,65.10,232312,232380
3730,56,76,1,9.14,166.05,232379,232435
3731,74,33,1,6.92,45.51,232435,232509
3732,71,34,1,7.21,53.60,232508,232579
3733,74,57,1,6.92,79.83,232578,232652
3734,65,63,1,7.88,103.80,232652,232717
3735,73,36,1,7.01,58.12,232717,232790
3736,55,64,1,9.31,151.05,232789,232844
3737,64,68,1,8.00,105.97,232843,232907
3738,75,40,1,6.83,66.52,232906,232981
3739,58,35,1,8.83,82.90,232980,233038
3740,75,58,1,6.83,66.78,233037,233112
3741,49,204,1,10.45,811.64,233111,233160
3742,81,36,1,6.32,40.39,233159,233240
3743,69,61,1,7.42,78.56,233239,233308
3744,63,35,1,8.13,70.65,233307,233370
3745,59,52,1,8.68,106.83,233369,233428
3746,66,29,1,7.76,43.09,233427,233493
3747,70,56,1,7.31,105.59,233492,233562
3748,72,54,1,7.11,79.99,233561,233633
3749,90,30,1,5.69,28.41,233632,233722
3750,80,51,1,6.40,65.59,233721,233801
3751,67,36,1,7.64,66.35,233800,233867
3752,74,61,1,6.92,93.26,233866,233940
3753,49,87,1,10.45,249.31,233939,233988
3754,52,36,1,9.85,95.17,233987,234039
3755,54,50,1,9.48,92.73,234038,234092
3756,63,51,1,8.13,91.86,234091,234154
3757,90,74,1,5.69,69.15,234153,234243
3758,71,55,1,7.21,90.90,234242,234313
3759,61,51,1,8.39,100.40,234312,234373
3760,70,35,1,7.31,57.04,234372,234442
3761,68,36,0,7.53,58.90,234441,234509
3762,76,36,1,6.74,55.19,234508,234584
3763,75,36,1,6.83,53.37,234583,234658
3764,51,61,1,10.04,161.25,234657,234708
3765,86,38,1,5.95,53.63,234708,234794
3766,79,47,1,6.48,65.97,234793,234872
3767,66,32,1,7.76,59.03,234871,234937
3768,57,84,1,8.98,174.61,234936,234993
3769,55,94,0,9.31,200.32,234992,235047
3770,73,34,1,7.01,41.11,235046,235119
3771,49,69,1,10.45,208.41,235119,235168
3772,87,35,1,5.89,36.38,235167,235254
3773,77,45,1,6.65,46.38,235253,235330
3774,72,36,1,7.11,59.07,235329,235401
3775,64,60,1,8.00,90.31,235400,235464
3776,88,35,1,5.82,37.72,235463,235551
3777,64,36,1,8.00,64.03,235550,235614
3778,74,47,1,6.92,65.45,235613,235687
3779,69,36,1,7.42,69.61,235686,235755
3780,75,31,1,6.83,46.65,235754,235829
3781,45,98,0,11.38,409.39,235828,235873
3782,62,44,1,8.26,82.16,235872,235934
3783,72,46,1,7.11,52.68,235933,236005
3784,64,53,1,8.00,86.56,236004,236068
3785,64,65,1,8.00,113.91,236067,236131
3786,44,70,1,11.64,195.00,236130,236174
3787,50,155,1,10.24,478.34,236173,236223
3788,62,79,1,8.26,138.22,236222,236284
3789,54,120,1,9.48,302.18,236284,236338
3790,57,41,1,8.98,78.68,236337,236394
3791,90,46,1,5.69,45.81,236393,236483
3792,60,48,1,8.53,102.08,236482,236542
3793,55,98,1,9.31,201.41,236541,236596
3794,52,61,1,9.85,147.86,236595,236647
3795,64,61,1,8.00,81.84,236646,236710
3796,48,187,1,10.67,726.39,236709,236757
3797,61,35,1,8.39,75.32,236756,236817
3798,50,47,1,10.24,127.78,236816,236866
3799,51,62,1,10.04,154.31,236865,236916
3800,51,86,1,10.04,226.70,236916,236967
3801,76,45,1,6.74,53.59,236967,237043
3802,76,27,1,6.74,40.09,237042,237118
3803,69,36,1,7.42,71.63,237117,237186
3804,63,62,1,8.13,144.78,237185,237248
3805,60,60,1,8.53,141.55,237247,237307
3806,59,48,1,8.68,106.01,237306,237365
3807,60,36,1,8.53,88.55,237364,237424
3808,45,99,1,11.38,309.84,237423,237468
3809,61,40,1,8.39,67.26,237467,237528
3810,62,58,1,8.26,103.61,237527,237589
3811,62,39,1,8.26,83.80,237588,237650
3812,72,70,1,7.11,100.63,237649,237721
3813,74,39,1,6.92,57.86,237720,237794
3814,58,77,0,8.83,152.07,237793,237851
3815,60,65,1,8.53,152.75,237851,237911
3816,49,167,1,10.45,569.84,237910,237959
3817,64,55,1,8.00,108.22,237958,238022
3818,61,48,1,8.39,101.16,238021,238082
3819,59,52,1,8.68,107.07,238081,238140
3820,68,33,1,7.53,47.07,238139,238207
3821,81,32,0,6.32,36.69,238206,238287
3822,72,69,1,7.11,101.18,238286,238358
3823,54,45,1,9.48,95.10,238357,238411
3824,55,80,1,9.31,169.60,238410,238465
3825,56,55,1,9.14,109.98,238464,238520
3826,65,43,1,7.88,76.85,238519,238584
3827,53,51,1,9.66,103.28,238583,238636
3828,60,68,1,8.53,167.95,238635,238695
3829,48,117,1,10.67,323.22,238694,238742
3830,50,94,1,10.24,289.46,238741,238791
3831,72,35,1,7.11,64.18,238791,238863
3832,70,37,1,7.31,69.56,238862,238932
3833,62,36,1,8.26,73.29,238931,238993
3834,49,61,1,10.45,172.70,238992,239041
3835,65,55,1,7.88,100.35,239040,239105
3836,54,68,1,9.48,146.14,239104,239158
3837,68,46,1,7.53,78.04,239157,239225
3838,65,72,1,7.88,120.51,239225,239290
3839,67,65,1,7.64,91.04,239289,239356
3840,58,61,1,8.83,134.94,239356,239414
3841,59,43,1,8.68,94.01,239413,239472
3842,53,40,1,9.66,94.87,239471,239524
3843,76,49,1,6.74,71.54,239523,239599
3844,59,50,1,8.68,117.64,239598,239657
3845,61,62,1,8.39,135.12,239656,239717
3846,61,45,1,8.39,103.98,239716,239777
3847,62,51,1,8.26,96.42,239776,239838
3848,59,136,1,8.68,328.69,239837,239896
3849,59,36,1,8.68,88.08,239896,239955
3850,58,66,1,8.83,170.83,239954,240012
3851,57,100,1,8.98,234.93,240011,240068
3852,69,52,1,7.42,78.36,240067,240136
3853,33,103,1,15.52,459.10,240135,240168
3854,71,46,1,7.21,91.35,240168,240239
3855,88,36,1,5.82,32.63,240238,240326
3856,63,36,0,8.13,72.17,240325,240388
3857,70,36,1,7.31,57.19,240387,240457
3858,75,50,1,6.83,59.82,240456,240531
3859,62,95,1,8.26,165.55,240530,240592
3860,60,62,1,8.53,135.85,240591,240651
3861,67,62,1,7.64,151.30,240650,240717
3862,72,103,1,7.11,170.79,240716,240788
3863,62,50,1,8.26,102.80,240787,240849
3864,66,48,1,7.76,85.94,240848,240914
3865,72,36,1,7.11,50.21,240913,240985
3866,74,55,1,6.92,80.83,240985,241059
3867,73,51,1,7.01,75.36,241058,241131
3868,51,61,1,10.04,135.72,241131,241182
3869,64,75,1,8.00,137.31,241181,241245
3870,73,33,1,7.01,45.74,241244,241317
3871,50,60,1,10.24,122.90,241316,241366
3872,52,61,1,9.85,167.82,241365,241417
3873,59,64,1,8.68,125.68,241416,241475
3874,52,111,1,9.85,320.25,241474,241526
3875,60,54,1,8.53,94.15,241525,241585
3876,71,50,1,7.21,66.45,241584,241655
3877,69,59,1,7.42,90.04,241654,241723
3878,70,36,1,7.31,49.90,241722,241792
3879,77,60,1,6.65,71.73,241791,241868
3880,62,60,1,8.26,106.80,241867,241929
3881,64,36,1,8.00,75.41,241928,241992
3882,77,36,1,6.65,50.77,241991,242068
3883,74,36,1,6.92,56.86,242067,242141
3884,88,32,1,5.82,29.54,242140,242228
3885,61,50,1,8.39,94.89,242227,242288
3886,61,77,1,8.39,139.98,242287,242348
3887,64,50,1,8.00,96.06,242347,242411
3888,57,89,1,8.98,175.32,242410,242467
3889,71,30,1,7.21,49.10,242467,242538
3890,58,36,1,8.83,89.18,242537,242595
3891,74,34,1,6.92,48.89,242594,242668
3892,68,36,1,7.53,77.25,242667,242735
3893,63,38,1,8.13,82.97,242734,242797
3894,58,107,1,8.83,218.97,242796,242854
3895,57,99,1,8.98,197.84,242853,242910
3896,43,80,1,11.91,238.08,242909,242952
3897,78,31,1,6.56,43.19,242952,243030
3898,72,49,1,7.11,73.27,243029,243101
3899,74,38,1,6.92,65.67,243100,243174
3900,75,36,1,6.83,48.68,243173,243248
3901,42,225,1,12.19,1174.39,243247,243289
3902,76,51,1,6.74,82.33,243288,243364
3903,40,60,1,12.80,186.51,243364,243404
3904,55,51,1,9.31,117.56,243403,243458
3905,60,93,1,8.53,165.65,243457,243517
3906,73,45,1,7.01,57.16,243516,243589
3907,67,36,1,7.64,66.26,243588,243655
3908,71,65,1,7.21,89.58,243654,243725
3909,68,36,1,7.53,65.81,243724,243792
3910,61,52,1,8.39,102.37,243791,243852
3911,63,36,1,8.13,65.73,243851,243914
3912,52,60,1,9.85,167.40,243913,243965
3913,87,35,0,5.89,36.12,243964,244051
3914,68,34,1,7.53,68.90,244050,244118
3915,46,84,1,11.13,218.55,244117,244163
3916,55,54,0,9.31,113.56,244162,244217
3917,70,58,1,7.31,109.04,244216,244286
3918,67,36,1,7.64,65.66,244285,244352
3919,66,36,1,7.76,73.15,244351,244417
3920,64,45,1,8.00,70.12,244416,244480
3921,67,61,1,7.64,94.95,244479,244546
3922,66,39,1,7.76,84.88,244545,244611
3923,72,35,1,7.11,59.43,244610,244682
3924,62,51,1,8.26,77.19,244681,244743
3925,60,100,1,8.53,213.78,244742,244802
3926,69,106,1,7.42,178.27,244801,244870
3927,68,34,1,7.53,51.66,244869,244937
3928,59,63,1,8.68,117.37,244936,244995
3929,62,51,1,8.26,104.61,244994,245056
3930,52,65,1,9.85,138.40,245055,245107
3931,81,35,1,6.32,40.59,245106,245187
3932,79,53,1,6.48,56.17,245186,245265
3933,38,79,1,13.47,312.67,245264,245302
3934,55,50,1,9.31,103.49,245301,245356
3935,52,64,1,9.85,159.98,245355,245407
3936,53,64,1,9.66,166.68,245406,245459
3937,74,36,1,6.92,61.89,245458,245532
3938,68,55,1,7.53,85.01,245532,245600
3939,71,31,1,7.21,40.56,245599,245670
3940,76,50,1,6.74,63.25,245669,245745
3941,80,38,1,6.40,52.12,245744,245824
3942,82,35,1,6.24,40.57,245823,245905
3943,67,55,1,7.64,80.11,245905,245972
3944,69,46,1,7.42,65.63,245971,246040
3945,70,37,1,7.31,45.39,246039,246109
3946,72,45,1,7.11,77.15,246108,246180
3947,71,36,1,7.21,63.41,246179,246250
3948,71,36,1,7.21,69.29,246250,246321
3949,52,56,1,9.85,145.32,246320,246372
3950,81,35,1,6.32,39.95,246371,246452
3951,71,36,1,7.21,82.76,246451,246522
3952,42,65,1,12.19,217.58,246521,246563
3953,51,122,1,10.04,402.63,246562,246613
3954,65,66,1,7.88,83.77,246612,246677
3955,78,38,1,6.56,38.53,246676,246754
3956,61,69,1,8.39,140.27,246753,246814
3957,82,29,1,6.24,34.21,246813,246895
3958,71,51,0,7.21,66.28,246894,246965
3959,52,105,1,9.85,253.25,246964,247016
3960,62,48,1,8.26,76.16,247015,247077
3961,48,116,1,10.67,331.85,247076,247124
3962,84,40,1,6.10,44.51,247123,247207
3963,55,52,0,9.31,95.12,247206,247261
3964,69,36,1,7.42,72.79,247260,247329
3965,74,54,1,6.92,72.05,247328,247402
3966,79,26,1,6.48,35.79,247401,247480
3967,39,210,1,13.13,1108.88,247480,247519
3968,60,85,1,8.53,169.45,247518,247578
3969,74,35,1,6.92,50.24,247577,247651
3970,45,97,1,11.38,245.66,247650,247695
3971,71,82,1,7.21,113.35,247694,247765
3972,82,58,1,6.24,61.06,247765,247847
3973,48,110,1,10.67,281.22,247846,247894
3974,58,64,1,8.83,123.97,247893,247951
3975,80,35,1,6.40,32.34,247950,248030
3976,55,57,1,9.31,121.49,248029,248084
3977,47,77,1,10.89,225.80,248083,248130
3978,61,50,1,8.39,91.91,248129,248190
3979,52,105,1,9.85,251.98,248189,248241
3980,51,102,1,10.04,266.23,248240,248291
3981,63,61,1,8.13,104.40,248290,248353
3982,92,36,1,5.57,31.62,248353,248445
3983,56,61,1,9.14,122.98,248444,248500
3984,72,44,1,7.11,56.77,248499,248571
3985,77,55,1,6.65,61.71,248570,248647
3986,53,55,1,9.66,131.51,248646,248699
3987,61,65,1,8.39,119.19,248698,248759
3988,75,38,1,6.83,60.06,248758,248833
3989,76,50,1,6.74,75.88,248832,248908
3990,78,48,1,6.56,59.07,248907,248985
3991,61,70,1,8.39,136.53,248984,249045
3992,75,36,1,6.83,47.58,249044,249119
3993,63,60,1,8.13,103.38,249118,249181
3994,60,43,1,8.53,81.05,249180,249240
3995,65,46,1,7.88,105.83,249239,249304
3996,57,99,1,8.98,204.58,249304,249361
3997,64,54,1,8.00,91.28,249360,249424
3998,69,36,1,7.42,42.88,249423,249492
3999,60,36,1,8.53,88.75,249491,249551
4000,72,60,1,7.11,80.49,249550,249622
4001,69,32,0,7.42,54.42,249621,249690
4002,57,60,1,8.98,107.00,249689,249746
4003,62,50,1,8.26,93.74,249745,249807
4004,76,35,1,6.74,64.17,249806,249882
4005,48,100,1,10.67,289.68,249882,249930
4006,82,40,1,6.24,40.21,249930,250012
4007,64,45,1,8.00,98.03,250012,250076
4008,79,60,1,6.48,87.26,250076,250155
4009,43,168,1,11.91,655.94,250154,250197
4010,56,72,1,9.14,198.84,250196,250252
4011,62,62,1,8.26,108.55,250251,250313
4012,72,48,1,7.11,78.15,250312,250384
4013,62,36,1,8.26,72.84,250384,250446
4014,53,48,1,9.66,120.53,250446,250499
4015,68,42,1,7.53,56.78,250499,250567
4016,57,56,1,8.98,157.18,250567,250624
4017,58,36,1,8.83,74.14,250624,250682
4018,60,36,1,8.53,67.82,250681,250741
4019,55,65,1,9.31,156.03,250741,250796
4020,61,101,1,8.39,185.91,250795,250856
4021,80,36,1,6.40,47.07,250856,250936
4022,60,36,1,8.53,77.28,250935,250995
4023,45,75,1,11.38,217.39,250994,251039
4024,52,49,0,9.85,120.51,251038,251090
4025,60,52,1,8.53,91.65,251090,251150
4026,69,35,1,7.42,49.32,251149,251218
4027,64,36,1,8.00,76.31,251217,251281
4028,60,100,1,8.53,191.45,251280,251340
4029,50,62,1,10.24,175.26,251339,251389
4030,58,49,1,8.83,87.94,251388,251446
4031,63,52,1,8.13,77.41,251445,251508
4032,80,29,1,6.40,34.09,251507,251587
4033,54,47,1,9.48,106.81,251587,251641
4034,66,79,1,7.76,149.85,251640,251706
4035,87,36,1,5.89,31.48,251705,251792
4036,65,55,1,7.88,89.46,251791,251856
4037,68,36,1,7.53,46.87,251855,251923
4038,68,56,1,7.53,81.57,251922,251990
4039,61,67,1,8.39,164.50,251989,252050
4040,72,65,1,7.11,87.52,252049,252121
4041,74,75,1,6.92,99.02,252120,252194
4042,67,69,1,7.64,109.16,252193,252260
4043,71,47,1,7.21,71.12,252259,252330
4044,70,40,1,7.31,80.13,252329,252399
4045,64,36,1,8.00,73.78,252398,252462
4046,58,37,1,8.83,92.38,252461,252519
4047,46,100,0,11.13,263.46,252518,252564
4048,44,176,1,11.64,677.41,252563,252607
4049,57,43,0,8.98,81.28,252606,252663
4050,66,101,1,7.76,180.70,252662,252728
4051,54,79,1,9.48,164.69,252727,252781
4052,53,63,1,9.66,125.13,252780,252833
4053,58,54,1,8.83,96.73,252832,252890
4054,61,62,1,8.39,127.62,252889,252950
4055,74,55,1,6.92,78.89,252949,253023
4056,54,107,1,9.48,271.58,253022,253076
4057,56,44,1,9.14,106.09,253075,253131
4058,62,60,1,8.26,112.93,253130,253192
4059,53,74,1,9.66,194.38,253191,253244
4060,57,111,1,8.98,255.07,253244,253301
4061,78,40,1,6.56,42.71,253300,253378
4062,84,36,1,6.10,41.80,253377,253461
4063,58,51,1,8.83,89.97,253460,253518
4064,36,100,1,14.22,449.67,253518,253554
4065,72,37,1,7.11,64.43,253553,253625
4066,47,85,1,10.89,229.46,253624,253671
4067,63,36,1,8.13,78.14,253670,253733
4068,76,60,0,6.74,83.06,253732,253808
4069,66,62,1,7.76,86.15,253807,253873
4070,70,37,1,7.31,57.79,253872,253942
4071,51,87,1,10.04,219.80,253941,253992
4072,68,60,1,7.53,84.96,253992,254060
4073,71,51,1,7.21,91.32,254059,254130
4074,48,73,1,10.67,176.72,254129,254177
4075,62,49,1,8.26,85.77,254176,254238
4076,77,36,1,6.65,54.72,254238,254315
4077,77,66,1,6.65,81.97,254315,254392
4078,78,28,1,6.56,37.07,254391,254469
4079,57,63,1,8.98,127.39,254468,254525
4080,72,60,1,7.11,90.15,254524,254596
4081,72,36,1,7.11,46.71,254595,254667
4082,53,44,1,9.66,94.60,254666,254719
4083,57,35,1,8.98,87.07,254718,254775
4084,60,52,1,8.53,103.68,254774,254834
4085,70,84,1,7.31,125.93,254833,254903
4086,77,48,1,6.65,55.16,254902,254979
4087,63,44,1,8.13,94.90,254978,255041
4088,67,57,1,7.64,89.21,255040,255107
4089,50,96,1,10.24,232.46,255106,255156
4090,103,36,1,4.97,24.63,255155,255258
4091,58,53,1,8.83,103.42,255257,255315
4092,49,48,1,10.45,122.25,255314,255363
4093,56,66,1,9.14,144.27,255362,255418
4094,66,72,1,7.76,105.88,255417,255483
4095,63,36,1,8.13,70.24,255482,255545
4096,65,36,1,7.88,56.57,255544,255609
4097,73,32,1,7.01,49.36,255608,255681
4098,31,215,1,16.52,1450.31,255680,255711
4099,48,65,1,10.67,187.10,255710,255758
4100,66,38,1,7.76,93.85,255757,255823
4101,71,35,1,7.21,59.07,255822,255893
4102,62,61,1,8.26,107.55,255892,255954
4103,66,34,1,7.76,56.37,255953,256019
4104,47,68,1,10.89,210.48,256019,256066
4105,81,34,1,6.32,37.58,256065,256146
4106,76,41,1,6.74,56.54,256145,256221
4107,50,47,1,10.24,149.70,256220,256270
4108,55,68,1,9.31,144.94,256269,256324
4109,78,34,1,6.56,48.60,256323,256401
4110,56,46,1,9.14,103.66,256400,256456
4111,57,76,1,8.98,185.84,256455,256512
4112,68,38,1,7.53,60.19,256511,256579
4113,71,36,1,7.21,57.41,256578,256649
4114,73,36,1,7.01,59.27,256648,256721
4115,64,84,1,8.00,142.31,256720,256784
4116,59,100,0,8.68,211.88,256783,256842
4117,51,100,1,10.04,257.76,256841,256892
4118,45,69,1,11.38,195.70,256892,256937
4119,81,36,1,6.32,43.25,256936,257017
4120,54,53,0,9.48,131.95,257016,257070
4121,68,70,1,7.53,106.16,257070,257138
4122,75,36,1,6.83,50.73,257137,257212
4123,78,36,1,6.56,34.07,257211,257289
4124,73,77,1,7.01,107.47,257289,257362
4125,66,39,1,7.76,55.61,257361,257427
4126,58,53,1,8.83,109.56,257426,257484
4127,67,56,1,7.64,86.20,257483,257550
4128,58,46,1,8.83,94.69,257550,257608
4129,75,60,1,6.83,83.90,257607,257682
4130,72,34,1,7.11,51.10,257681,257753
4131,80,36,1,6.40,34.39,257752,257832
4132,74,36,1,6.92,56.67,257831,257905
4133,71,42,1,7.21,60.70,257904,257975
4134,64,36,1,8.00,85.44,257974,258038
4135,63,44,1,8.13,74.78,258037,258100
4136,61,51,1,8.39,110.34,258099,258160
4137,65,45,1,7.88,84.66,258159,258224
4138,57,73,1,8.98,135.03,258223,258280
4139,57,68,1,8.98,119.21,258279,258336
4140,73,36,1,7.01,34.86,258335,258408
4141,61,34,1,8.39,55.48,258408,258469
4142,46,175,1,11.13,695.33,258468,258514
4143,54,60,1,9.48,138.95,258513,258567
4144,67,43,1,7.64,78.11,258566,258633
4145,53,36,1,9.66,93.55,258632,258685
4146,86,36,1,5.95,42.28,258684,258770
4147,69,52,1,7.42,80.53,258769,258838
4148,60,51,1,8.53,99.92,258837,258897
4149,43,82,1,11.91,248.97,258897,258940
4150,65,55,1,7.88,111.98,258939,259004
4151,60,101,1,8.53,211.62,259003,259063
4152,46,57,1,11.13,171.55,259062,259108
4153,81,40,1,6.32,45.33,259107,259188
4154,51,56,1,10.04,166.19,259187,259238
4155,83,24,1,6.17,25.32,259237,259320
4156,69,39,1,7.42,70.85,259319,259388
4157,55,96,0,9.31,222.00,259387,259442
4158,74,47,1,6.92,71.13,259441,259515
4159,73,37,1,7.01,59.88,259514,259587
4160,63,36,1,8.13,70.56,259586,259649
4161,71,97,1,7.21,150.17,259649,259720
4162,52,91,1,9.85,240.94,259719,259771
4163,49,57,1,10.45,163.15,259770,259819
4164,73,46,1,7.01,53.74,259818,259891
4165,51,66,1,10.04,164.90,259890,259941
4166,69,44,1,7.42,67.55,259940,260009
4167,64,100,1,8.00,178.41,260008,260072
4168,55,46,1,9.31,98.69,260071,260126
4169,69,64,1,7.42,121.00,260125,260194
4170,63,36,1,8.13,79.16,260193,260256
4171,67,56,1,7.64,74.95,260255,260322
4172,68,60,1,7.53,73.93,260321,260389
4173,50,54,1,10.24,129.10,260389,260439
4174,68,53,1,7.53,77.37,260438,260506
4175,59,43,1,8.68,91.57,260505,260564
4176,68,56,1,7.53,95.54,260563,260631
4177,79,36,1,6.48,56.96,260630,260709
4178,72,35,1,7.11,53.46,260708,260780
4179,79,35,1,6.48,55.52,260779,260858
4180,66,36,1,7.76,59.21,260857,260923
4181,50,35,1,10.24,92.34,260922,260972
4182,71,36,1,7.21,52.67,260971,261042
4183,66,50,1,7.76,71.79,261041,261107
4184,80,29,1,6.40,37.79,261106,261186
4185,64,63,1,8.00,109.25,261185,261249
4186,72,75,1,7.11,94.71,261248,261320
4187,61,39,1,8.39,92.30,261319,261380
4188,58,64,1,8.83,107.76,261379,261437
4189,58,74,1,8.83,134.00,261436,261494
4190,67,50,1,7.64,81.21,261493,261560
4191,59,48,1,8.68,78.83,261559,261618
4192,67,61,1,7.64,117.90,261617,261684
4193,52,45,1,9.85,114.67,261683,261735
4194,54,53,1,9.48,124.69,261734,261788
4195,71,33,1,7.21,54.22,261787,261858
4196,67,31,1,7.64,48.98,261857,261924
4197,58,45,1,8.83,65.97,261923,261981
4198,69,88,1,7.42,126.59,261981,262050
4199,60,43,1,8.53,96.05,262049,262109
4200,80,42,1,6.40,59.47,262108,262188
4201,77,33,1,6.65,45.37,262187,262264
4202,59,56,1,8.68,95.03,262264,262323
4203,43,69,1,11.91,213.94,262322,262365
4204,69,39,1,7.42,65.98,262364,262433
4205,61,48,1,8.39,88.80,262432,262493
4206,53,134,1,9.66,380.07,262492,262545
4207,50,61,1,10.24,161.18,262544,262594
4208,74,39,1,6.92,51.40,262593,262667
4209,59,58,1,8.68,97.13,262666,262725
4210,60,35,1,8.53,81.38,262724,262784
4211,57,101,1,8.98,255.60,262783,262840
4212,56,48,1,9.14,118.62,262840,262896
4213,71,40,1,7.21,81.04,262896,262967
4214,69,57,1,7.42,93.35,262966,263035
4215,53,61,1,9.66,166.41,263034,263087
4216,63,49,1,8.13,79.25,263086,263149
4217,72,56,1,7.11,79.35,263148,263220
4218,81,37,1,6.32,52.24,263220,263301
4219,73,62,1,7.01,85.11,263300,263373
4220,78,35,1,6.56,45.96,263372,263450
4221,81,40,1,6.32,47.45,263449,263530
4222,49,92,1,10.45,313.06,263529,263578
4223,55,61,1,9.31,146.40,263577,263632
4224,61,60,1,8.39,107.68,263631,263692
4225,60,36,1,8.53,82.32,263691,263751
4226,57,66,1,8.98,157.63,263750,263807
4227,61,51,1,8.39,102.40,263807,263868
4228,67,84,1,7.64,142.71,263867,263934
4229,66,36,1,7.76,56.82,263933,263999
4230,50,90,1,10.24,205.38,263998,264048
4231,57,44,1,8.98,83.84,264047,264104
4232,62,36,1,8.26,77.51,264103,264165
4233,59,101,1,8.68,225.64,264164,264223
4234,53,55,1,9.66,108.53,264222,264275
4235,54,189,1,9.48,635.14,264274,264328
4236,52,46,1,9.85,145.01,264327,264379
4237,61,50,1,8.39,102.01,264378,264439
4238,48,53,1,10.67,152.81,264438,264486
4239,68,42,1,7.53,81.19,264485,264553
4240,76,44,1,6.74,71.80,264552,264628
4241,56,45,1,9.14,117.12,264627,264683
4242,77,36,1,6.65,38.02,264682,264759
4243,74,44,1,6.92,66.67,264758,264832
4244,52,86,1,9.85,219.13,264831,264883
4245,55,48,1,9.31,111.67,264882,264937
4246,63,42,1,8.13,100.87,264936,264999
4247,59,95,1,8.68,165.07,264998,265057
4248,59,147,1,8.68,377.74,265057,265116
4249,68,36,1,7.53,62.51,265116,265184
4250,68,50,1,7.53,74.84,265184,265252
4251,51,48,1,10.04,122.74,265251,265302
4252,48,113,1,10.67,325.47,265301,265349
4253,69,34,1,7.42,49.20,265348,265417
4254,87,28,1,5.89,27.50,265417,265504
4255,73,49,1,7.01,78.78,265503,265576
4256,58,172,1,8.83,531.69,265575,265633
4257,77,49,1,6.65,63.76,265632,265709
4258,70,51,1,7.31,66.79,265708,265778
4259,63,49,1,8.13,88.40,265777,265840
4260,65,74,1,7.88,125.43,265839,265904
4261,61,54,1,8.39,87.68,265903,265964
4262,39,164,1,13.13,689.09,265963,266002
4263,53,60,1,9.66,142.75,266002,266055
4264,61,103,1,8.39,205.03,266054,266115
4265,56,91,1,9.14,222.41,266114,266170
4266,43,116,1,11.91,366.97,266169,266212
4267,76,49,1,6.74,64.77,266211,266287
4268,49,50,1,10.45,124.82,266286,266335
4269,55,61,1,9.31,146.32,266334,266389
4270,50,91,1,10.24,208.18,266388,266438
4271,71,47,1,7.21,73.91,266437,266508
4272,83,34,1,6.17,41.15,266508,266591
4273,47,119,1,10.89,382.31,266590,266637
4274,56,115,1,9.14,447.02,266636,266692
4275,77,80,1,6.65,97.99,266692,266769
4276,32,157,1,16.00,881.81,266768,266800
4277,63,36,1,8.13,78.97,266800,266863
4278,35,215,1,14.63,1260.00,266862,266897
4279,72,35,1,7.11,47.99,266896,266968
4280,57,68,1,8.98,127.00,266967,267024
4281,64,49,1,8.00,98.19,267023,267087
4282,82,36,1,6.24,39.53,267087,267169
4283,67,52,1,7.64,87.81,267168,267235
4284,73,68,1,7.01,89.79,267234,267307
4285,67,46,1,7.64,78.80,267306,267373
4286,85,32,1,6.02,43.41,267372,267457
4287,71,54,1,7.21,84.67,267456,267527
4288,56,36,1,9.14,77.30,267526,267582
4289,59,48,1,8.68,101.64,267581,267640
4290,65,47,1,7.88,72.35,267639,267704
4291,70,35,1,7.31,59.87,267703,267773
4292,56,84,1,9.14,178.62,267772,267828
4293,79,39,1,6.48,64.50,267827,267906
4294,54,61,1,9.48,140.40,267905,267959
4295,60,74,1,8.53,134.72,267958,268018
4296,47,111,1,10.89,328.52,268017,268064
4297,56,51,1,9.14,105.27,268063,268119
4298,57,87,1,8.98,200.68,268118,268175
4299,73,47,1,7.01,64.37,268174,268247
4300,52,105,1,9.85,256.13,268246,268298
4301,61,101,1,8.39,209.94,268297,268358
4302,74,48,1,6.92,81.43,268357,268431
4303,64,60,1,8.00,110.44,268430,268494
4304,92,35,1,5.57,30.46,268493,268585
4305,65,73,1,7.88,116.72,268584,268649
4306,68,33,1,7.53,53.81,268648,268716
4307,63,68,1,8.13,132.36,268716,268779
4308,59,61,1,8.68,130.90,268778,268837
4309,56,60,1,9.14,127.98,268836,268892
4310,57,60,1,8.98,123.60,268891,268948
4311,63,48,1,8.13,101.48,268947,269010
4312,74,43,1,6.92,49.97,269009,269083
4313,83,54,1,6.17,67.92,269082,269165
4314,78,36,1,6.56,51.68,269164,269242
4315,58,101,1,8.83,227.42,269242,269300
4316,60,55,1,8.53,107.45,269299,269359
4317,69,39,1,7.42,79.26,269358,269427
4318,69,50,0,7.42,76.65,269426,269495
4319,57,51,1,8.98,110.26,269494,269551
4320,47,48,1,10.89,136.27,269550,269597
4321,65,40,1,7.88,70.05,269596,269661
4322,67,60,1,7.64,124.47,269660,269727
4323,62,62,0,8.26,117.29,269727,269789
4324,69,37,1,7.42,66.19,269788,269857
4325,64,36,1,8.00,82.28,269857,269921
4326,59,93,1,8.68,182.96,269920,269979
4327,70,59,1,7.31,98.24,269978,270048
4328,68,50,1,7.53,87.43,270047,270115
4329,65,37,1,7.88,63.89,270114,270179
4330,70,47,1,7.31,68.96,270178,270248
4331,66,60,1,7.76,121.67,270247,270313
4332,68,35,1,7.53,61.98,270312,270380
4333,84,41,1,6.10,34.28,270379,270463
4334,70,76,1,7.31,105.22,270463,270533
4335,59,37,1,8.68,82.73,270532,270591
4336,69,60,1,7.42,135.29,270590,270659
4337,70,56,1,7.31,100.13,270658,270728
4338,48,60,1,10.67,174.43,270727,270775
4339,65,48,1,7.88,72.97,270774,270839
4340,47,105,1,10.89,257.07,270838,270885
4341,82,42,1,6.24,47.28,270884,270966
4342,69,42,1,7.42,73.81,270965,271034
4343,59,128,1,8.68,287.74,271033,271092
4344,44,129,1,11.64,479.32,271091,271135
4345,60,99,1,8.53,172.45,271134,271194
4346,65,36,1,7.88,78.60,271193,271258
4347,59,36,1,8.68,92.25,271257,271316
4348,61,54,1,8.39,145.19,271315,271376
4349,69,63,1,7.42,91.78,271375,271444
4350,60,54,1,8.53,86.72,271443,271503
4351,48,39,1,10.67,104.18,271502,271550
4352,67,82,1,7.64,133.45,271549,271616
4353,70,51,1,7.31,75.36,271615,271685
4354,81,34,1,6.32,32.27,271684,271765
4355,59,45,1,8.68,87.64,271765,271824
4356,73,31,1,7.01,38.84,271823,271896
4357,69,36,1,7.42,59.20,271895,271964
4358,56,56,1,9.14,141.52,271964,272020
4359,56,39,1,9.14,100.44,272019,272075
4360,68,56,1,7.53,86.93,272074,272142
4361,58,38,1,8.83,83.42,272141,272199
4362,56,75,1,9.14,190.94,272198,272254
4363,57,97,1,8.98,206.93,272254,272311
4364,61,60,1,8.39,104.04,272310,272371
4365,80,30,1,6.40,43.12,272370,272450
4366,70,36,1,7.31,56.79,272449,272519
4367,56,83,1,9.14,168.02,272518,272574
4368,67,56,1,7.64,102.23,272573,272640
4369,57,122,1,8.98,289.14,272639,272696
4370,70,36,1,7.31,59.79,272695,272765
4371,54,61,1,9.48,148.14,272764,272818
4372,49,100,1,10.45,291.02,272817,272866
4373,65,63,0,7.88,122.94,272865,272930
4374,91,37,1,5.63,49.75,272929,273020
4375,55,59,1,9.31,156.14,273019,273074
4376,62,49,1,8.26,92.03,273073,273135
4377,61,36,1,8.39,66.40,273134,273195
4378,74,28,1,6.92,34.05,273194,273268
4379,34,187,1,15.06,1122.88,273267,273301
4380,35,185,1,14.63,1039.15,273300,273335
4381,70,52,1,7.31,93.56,273334,273404
4382,71,49,1,7.21,59.77,273403,273474
4383,67,35,1,7.64,55.01,273473,273540
4384,70,61,0,7.31,111.62,273539,273609
4385,43,72,1,11.91,214.22,273608,273651
4386,49,62,1,10.45,165.88,273650,273699
4387,60,53,1,8.53,100.42,273698,273758
4388,79,92,1,6.48,119.34,273757,273836
4389,61,36,1,8.39,76.07,273836,273897
4390,90,52,1,5.69,47.04,273896,273986
4391,62,59,1,8.26,109.26,273985,274047
4392,59,96,1,8.68,189.95,274046,274105
4393,73,57,1,7.01,84.51,274104,274177
4394,58,57,1,8.83,100.69,274176,274234
4395,61,37,1,8.39,78.27,274233,274294
4396,85,36,1,6.02,39.43,274293,274378
4397,81,78,1,6.32,96.51,274377,274458
4398,73,54,1,7.01,72.07,274457,274530
4399,56,56,1,9.14,139.52,274529,274585
4400,70,78,1,7.31,124.33,274584,274654
4401,84,33,1,6.10,38.16,274653,274737
4402,68,36,1,7.53,65.81,274736,274804
4403,58,36,1,8.83,73.76,274803,274861
4404,67,52,0,7.64,96.86,274860,274927
4405,77,36,1,6.65,59.24,274927,275004
4406,71,41,1,7.21,60.34,275003,275074
4407,68,45,1,7.53,74.81,275073,275141
4408,69,46,1,7.42,72.88,275140,275209
4409,58,44,1,8.83,110.18,275208,275266
4410,55,46,1,9.31,116.14,275265,275320
4411,58,64,1,8.83,149.04,275319,275377
4412,54,36,1,9.48,80.81,275376,275430
4413,53,106,1,9.66,297.85,275429,275482
4414,85,36,1,6.02,38.68,275481,275566
4415,65,56,1,7.88,99.40,275565,275630
4416,60,58,1,8.53,112.05,275629,275689
4417,66,41,1,7.76,72.94,275688,275754
4418,75,48,1,6.83,61.18,275753,275828
4419,62,52,1,8.26,95.84,275827,275889
4420,56,61,1,9.14,123.27,275888,275944
4421,78,35,1,6.56,38.50,275943,276021
4422,73,46,1,7.01,60.81,276020,276093
4423,58,48,1,8.83,120.69,276092,276150
4424,49,52,1,10.45,135.92,276149,276198
4425,51,65,1,10.04,140.04,276197,276248
4426,53,51,1,9.66,105.47,276247,276300
4427,60,34,1,8.53,71.58,276299,276359
4428,68,47,1,7.53,72.25,276358,276426
4429,55,84,1,9.31,229.23,276426,276481
4430,73,57,1,7.01,89.88,276480,276553
4431,70,35,1,7.31,52.33,276552,276622
4432,62,36,1,8.26,89.00,276621,276683
4433,62,52,0,8.26,89.97,276682,276744
4434,69,48,1,7.42,101.43,276743,276812
4435,48,50,1,10.67,147.64,276811,276859
4436,86,55,1,5.95,51.09,276859,276945
4437,71,58,1,7.21,76.05,276944,277015
4438,73,60,1,7.01,80.31,277014,277087
4439,68,75,1,7.53,140.66,277086,277154
4440,41,126,2,12.49,439.71,277153,277194
4441,62,48,1,8.26,103.80,277193,277255
4442,50,45,1,10.24,106.90,277255,277305
4443,41,92,1,12.49,321.23,277304,277345
4444,45,96,1,11.38,249.21,277344,277389
4445,70,24,1,7.31,37.16,277388,277458
4446,69,48,1,7.42,91.84,277457,277526
4447,74,36,1,6.92,47.26,277525,277599
4448,62,36,1,8.26,73.26,277598,277660
4449,56,101,1,9.14,246.34,277659,277715
4450,53,50,1,9.66,93.92,277714,277767
4451,69,48,1,7.42,85.17,277766,277835
4452,63,80,1,8.13,130.90,277834,277897
4453,65,55,0,7.88,93.31,277896,277961
4454,66,60,1,7.76,104.18,277961,278027
4455,68,51,1,7.53,83.90,278026,278094
4456,65,40,1,7.88,75.62,278093,278158
4457,62,59,1,8.26,120.80,278157,278219
4458,50,225,1,10.24,966.54,278218,278268
4459,62,34,1,8.26,80.19,278267,278329
4460,57,66,1,8.98,138.30,278328,278385
4461,49,154,1,10.45,542.45,278384,278433
4462,69,35,1,7.42,71.43,278432,278501
4463,68,36,1,7.53,59.34,278500,278568
4464,59,55,1,8.68,116.63,278567,278626
4465,78,34,1,6.56,49.25,278625,278703
4466,73,87,1,7.01,116.81,278702,278775
4467,73,56,1,7.01,71.22,278774,278847
4468,73,49,1,7.01,58.67,278846,278919
4469,66,63,1,7.76,122.18,278918,278984
4470,51,53,1,10.04,178.00,278984,279035
4471,66,45,1,7.76,66.40,279034,279100
4472,49,106,1,10.45,324.45,279099,279148
4473,53,50,1,9.66,138.94,279147,279200
4474,73,77,1,7.01,110.75,279200,279273
4475,63,35,1,8.13,68.87,279272,279335
4476,53,60,1,9.66,160.79,279335,279388
4477,63,56,1,8.13,87.00,279387,279450
4478,72,53,1,7.11,65.32,279450,279522
4479,84,46,1,6.10,50.61,279521,279605
4480,61,101,1,8.39,187.91,279604,279665
4481,52,53,1,9.85,121.28,279665,279717
4482,66,36,1,7.76,75.49,279716,279782
4483,65,66,1,7.88,118.35,279781,279846
4484,70,89,1,7.31,144.62,279845,279915
4485,70,36,1,7.31,59.47,279914,279984
4486,63,36,1,8.13,85.76,279983,280046
4487,83,24,1,6.17,22.12,280045,280128
4488,70,54,1,7.31,91.02,280127,280197
4489,42,99,1,12.19,302.44,280196,280238
4490,59,53,1,8.68,110.08,280237,280296
4491,57,36,1,8.98,70.26,280295,280352
4492,63,109,1,8.13,216.71,280351,280414
4493,63,36,1,8.13,76.36,280413,280476
4494,46,35,1,11.13,99.29,280475,280521
4495,72,38,1,7.11,46.32,280520,280592
4496,71,60,1,7.21,83.01,280592,280663
4497,47,67,2,10.89,180.61,280662,280709
4498,46,75,1,11.13,220.85,280708,280754
4499,83,35,1,6.17,33.37,280753,280836
4500,67,49,1,7.64,79.33,280835,280902
4501,60,49,1,8.53,97.92,280902,280962
4502,76,49,1,6.74,66.96,280961,281037
4503,58,36,1,8.83,93.14,281036,281094
4504,77,26,1,6.65,36.18,281093,281170
4505,67,35,1,7.64,73.84,281170,281237
4506,60,49,1,8.53,113.65,281236,281296
4507,64,72,1,8.00,129.00,281295,281359
4508,80,55,1,6.40,58.02,281358,281438
4509,68,49,1,7.53,74.04,281437,281505
4510,68,39,1,7.53,72.04,281504,281572
4511,65,47,1,7.88,91.86,281571,281636
4512,74,31,1,6.92,45.34,281636,281710
4513,41,80,1,12.49,254.54,281709,281750
4514,60,65,1,8.53,134.25,281749,281809
4515,65,50,1,7.88,77.43,281808,281873
4516,31,55,1,9.84,166.14,281872,281903
